clickbait,set,char_capital,char_small,char_special,blank,numerical,letters,outlier,title
0,1,1,52,2,9,0,53,0,boy arrested murder seventeen-year-old run bus
0,2,1,48,0,6,0,49,0,canada unveils plan legalise recreational marijuana
0,2,10,44,1,8,0,54,0,martin shkreli win ruling splitting fraud trial ex-lawyer
0,2,15,63,5,15,4,78,0,"2015 mlb draft prep kit: spending strategy, potential domino picks, sleeper prospects,"
0,3,2,18,1,3,0,20,0,oscars: winner list
0,1,5,31,0,7,1,36,0,u senator ted stevens convicted 7 count
0,1,9,29,1,10,0,38,0,"vick sincere, give chance prove"
0,3,2,75,1,15,3,77,0,"israel adopting 100 syrian orphans, despite fact two country technically war"
0,1,7,37,4,7,0,44,0,"martinsville, va., potential racing hub, shift focus"
0,1,6,34,0,8,0,40,0,yankee take full lineup charitable work
0,1,2,42,0,5,0,44,0,shiite protest discrimination bahrain
0,2,7,44,1,7,0,51,0,internet blackout seriously damage country economy
0,1,6,33,0,7,0,39,0,detainee claim abuse return britain
0,3,10,79,3,20,4,89,0,"u election 2016 u election: electoral college voting next week, mean donald trump?"
0,3,12,38,0,10,0,50,0,paulson said exit aig board hedge fund sell share
0,1,8,30,2,7,0,38,0,"new filing fall, long-term job claim rise"
0,1,8,31,1,7,0,39,0,"muscle car glory faded, pontiac shrivels"
0,2,11,50,2,11,0,61,0,jimmy kimmel 'activists' ask warrior fan support team name change
0,1,2,34,0,7,0,36,0,guard rail kill ten malaysian bus crash
0,1,7,35,0,8,0,42,0,pipe made india incense illinois steel town
0,1,2,44,0,8,0,46,0,moldovan wine win three medal contest bordeaux
0,3,3,43,0,6,0,46,0,donald trump postpones news conference january
0,2,3,58,0,11,0,61,0,civilian casualty starting rise iraqi force push mosul
0,2,8,35,0,7,0,43,0,chaos macedonian border migrant storm fence
0,2,10,44,0,11,0,54,0,trump backer phoenix region fine learning curve
0,2,2,25,3,6,5,27,0,"9,500-year-old skull get 3d makeover"
0,3,3,80,2,15,0,83,0,student hit mother facebook sparking police hunt going 'missing' christmas
0,2,6,26,5,6,0,32,0,"stream ed sheeran's third studio album, ''"
0,1,4,25,0,4,0,29,0,roche name leader genentech
0,3,1,52,2,10,0,53,0,"snake hanging someone's toilet real, living nightmare"
0,2,12,48,3,12,5,60,0,"united plan reduce overbooking flights, offer $10,000 forfeit seat"
0,1,4,28,0,5,0,32,0,cocaine found kennedy space center
0,3,2,58,2,15,0,60,0,ten lucrative bus lane camera england one near you?
0,2,1,48,1,7,0,49,0,coach doesnt want department store cheapening itsimage
0,1,5,22,0,4,0,27,0,honda name new chief executive
0,1,3,38,0,6,0,41,0,fundraising keep avro vulcan flying succeeds
0,3,5,55,1,9,0,60,0,afp ordered return former senator stephen conroy's seized document
0,3,16,54,0,14,0,70,0,la la visit nyc strip club following split carmelo anthony shoot new series
0,1,2,55,1,10,0,57,0,man arrested india mid-air hijack threat domestic flight
0,2,2,66,5,12,0,68,0,democratic senator say trump major pivot foreign policy war start
0,3,12,40,0,11,0,52,0,literally bunch photo cat sitting tinychairs
0,3,17,53,2,14,0,70,0,kristen bell dax shepard typical married couple arguing la-z-boy
0,3,9,35,3,11,0,44,0,"lana del rey share new song ""lust life"" f/ weeknd"
0,2,6,22,2,5,0,28,0,"""star wars"" icon carrie fisherdies"
0,1,3,47,0,6,0,50,0,armenian president kocharyan declares state emergency
0,1,2,39,2,8,2,41,0,dubai world receive $9.5 billion government aid
0,1,6,33,3,7,2,39,0,"italy upset canada, 6-2, world baseball classic"
0,3,13,51,1,12,3,64,0,luck-seeking tourist thailand almost killed turtle feeding 915 coin
0,3,14,54,1,12,0,68,0,sexual assault survivor gather outside fox news demand bill o'reilly fired
0,1,7,22,1,4,0,29,0,third union separate afl-cio
0,2,6,68,5,15,0,74,0,bill oreilly called putin killer. kremlin say wait patiently apology.
0,1,3,28,0,4,4,31,0,australia celebrates australia day 2009
0,2,10,44,2,9,0,54,0,margaret atwood play superhero genre angel catbird
0,2,8,42,2,9,2,50,0,vegan food company fined $1.5 million hiring illegal alien
0,1,4,36,1,4,0,40,0,msn encarta introduces wiki-like enhancement
0,3,5,57,1,8,0,62,0,manchester united shun benficas victor lindelof defence improves
0,1,8,30,0,8,1,38,0,p1 pico projector stand small crowd
0,2,11,31,2,10,1,42,0,"train machine brain, pentaho's 4 pillar ai"
0,1,9,48,0,10,0,57,0,news outlet seek boost inauguration watch party planned
0,3,1,63,1,9,0,64,0,"pension change likely encourage financial risk taking, warns professor"
0,2,6,67,1,11,0,73,0,"shetland island could go independent scotland leaf uk, former chancellor claim"
0,1,3,36,0,6,0,39,0,canada keeping eye deepwater horizon spill
0,3,8,50,0,10,0,58,0,pittsburgh penguin honor memory dan rooney helmet decal
0,3,1,66,2,13,0,67,0,medium meet challenge giving proper coverage women's sport?
0,1,5,70,0,15,0,75,0,tv presenter vernon kay deny death claim wikipedia article claim dead
0,3,4,41,0,10,0,45,0,john kerry find vietnam war site killed man
0,1,8,42,0,8,0,50,0,pakistani reporter killed rally taliban truce
0,1,6,30,2,4,1,36,0,kosmos-3m launch final sar-lupe satellite
0,2,3,65,3,15,0,68,0,thief: little league teammate go war fortune made youth baseball
0,1,3,74,2,11,0,77,0,satirical website criticizes glenn beck 'hypocritical' attempt silence free speech
0,3,14,50,5,16,2,64,0,"rick ross join nipsey hussle, e40, slim thug, fat joe ""buy back block"""
0,1,7,32,0,8,0,39,0,obama poll see doubt budget health care
0,3,22,50,10,13,0,72,0,"kendrick lamar's 'damn.', pwr bttm, chris stapleton, noah cyrus more: must-hear music podcast"
0,3,2,55,0,11,0,57,0,city across globe pay tribute london terror attack victim
0,2,15,53,4,13,4,68,0,16-year-old schoolboy reject r 42-crore offer website designed bedroom!
0,2,1,42,0,5,0,43,0,ikea significantly expanding paid parental leave
0,1,7,29,0,6,0,36,0,dea raid san diego state university dorm
0,3,2,57,0,12,1,59,0,armed robber holding 7 people hostage inside paris travel agency
0,3,2,43,0,7,0,45,0,spacex get green light day scheduled launch
0,1,8,50,0,8,0,58,0,kansa governor sign bill offering ultrasound abortion
0,1,12,27,2,8,0,39,0,ubs ousts top banker served rich u.s. client
0,3,2,67,3,12,0,69,0,republican double standard come trump threat retribution
0,1,3,37,0,6,0,40,0,u indicts eleven alleged pirate somalia
0,2,7,33,1,9,0,40,0,rupert murdoch put medium empire son hand
0,2,1,53,0,12,0,54,0,tesla fan get really want company
0,3,10,43,1,9,0,53,0,earth gifted first pig-human embryo thanks science
0,1,5,39,4,8,2,44,0,gun n' roses' 'chinese democracy' released 15 year
0,2,12,62,3,14,0,74,0,"donald trump: would order military violate laws, treaty torture breitbart"
0,2,7,37,0,7,0,44,0,democrat voting neil gorsuch
0,1,3,28,0,7,2,31,0,fourth 21 july bomb suspect held rome
0,1,6,27,0,6,0,33,0,west told expect water shortfall
0,2,13,45,4,12,0,58,0,north korea missile failure wont stop kim jong un trying strike u.s.
0,2,3,82,3,18,0,85,0,four-year old appears morning speak saving mother's life distracted boat
0,1,6,38,0,8,4,44,0,bradley wiggins erases bitterness 2007 tour de france
0,1,6,23,0,6,0,29,0,jet trade draft mark sanchez
0,2,4,58,2,14,2,62,0,"fad may over, pokmon go still 65 million monthly active player"
0,2,8,41,0,9,0,49,0,indonesia keep key rate unchanged rupiah slump fed
0,1,4,36,2,6,0,40,0,"israel completes gaza strip, west bank pull-outs"
0,3,7,47,4,8,0,54,0,make-a-wish teen tj onwuanibe announce ravens' first-round pick
0,2,10,49,4,10,0,59,0,colin kaepernick's parent break silence: 'we absolutely support him'
0,2,4,56,1,10,0,60,0,obama pardon retired gen. james cartwright lying leak probe
0,1,7,34,2,8,0,41,0,"second ""red bull flugtag london"" land hyde park"
0,1,6,25,0,5,0,31,0,mets bullpen continues hard work
0,2,2,58,0,10,0,60,0,worst january transfer every year since winter window started
0,1,5,27,0,4,0,32,0,new leader overhaul ford foundation
0,3,5,25,1,5,3,30,0,carrie underwood's biggest hot 100 hit
0,2,15,49,0,14,0,64,0,tattoo artist found genius way cover rubbish pokmontattoo
0,2,8,37,0,7,0,45,0,golden gate bridge finally getting suicide barrier
0,1,2,46,0,7,0,48,0,uk study highlight child abuse humanitarian worker
0,1,3,46,1,6,0,49,0,nigerian housing minister fired anti-corruption drive
0,3,5,48,0,8,0,53,0,u custom border protection outage frustrates traveler
0,2,11,53,1,14,1,64,0,"kanye west pretend player, take control game 4 press conference mic"
0,3,3,15,0,2,0,18,0,getting hillary
0,2,3,70,5,16,0,73,0,muslim student tried meet lawmaker. first asked: beat wife?
0,2,6,69,2,13,0,75,0,"former un chief kofi annan ""deeply concerned"" alleged human right abuse myanmar"
0,3,12,57,3,12,0,69,0,george clooney remembers late cousin miguel ferrer: made world brighter
0,1,4,27,0,6,0,31,0,politics guise pure science
0,1,9,42,0,11,0,51,0,word worth thousand picture ballpark tv
0,3,10,35,6,9,1,45,0,rag'n'bone man's 'human' hit no. 1 lyricfind global chart
0,3,1,60,1,9,0,61,0,ex-treasure hunter ordered answer question missing gold coin
0,1,4,37,1,7,0,41,0,"missing boy glynn county, georgia found dead"
0,1,4,43,0,9,2,47,0,former rugby union commentator bill mclaren dy age 86
0,2,6,56,2,15,0,62,0,trump urged double tragedy congo death cutting u aid un
0,3,6,36,2,7,0,42,0,"north korea murdered kim jong-nam, say south korea"
0,1,6,30,0,6,0,36,0,obama reluctant look bush program
0,1,5,27,0,4,0,32,0,violence grip tehran amid crackdown
0,3,9,75,1,13,0,84,0,trump's america donald trump drop steve bannon chief strategist national security council
0,2,6,35,2,7,0,41,0,asx: australian share drop steeply u sell-off
0,1,2,52,2,5,0,54,0,afghanistan's parliament reject karzai's cabinet nomination
0,1,1,57,0,9,0,58,0,canadian energy company offer reward info pipeline bombing
0,2,9,28,3,8,0,37,0,"'snl' mock trump, putin tie exxon ceo"
0,2,3,67,1,13,1,70,0,8 leadership lesson book facebooks hr chief recommends new manager
0,3,6,43,0,7,0,49,0,victoria beckham film carpool karaoke james corden
0,1,3,17,1,3,0,20,0,"giving back, backpack"
0,1,3,58,1,7,0,61,0,"wikinews interview corrado giustozzi, security consultant author"
0,3,1,44,2,5,0,45,0,university warned 'snowflake' student demand
0,2,9,41,2,10,0,50,0,watch rihanna struggle watch sex scene 'bates motel'
0,1,9,47,0,10,0,56,0,homeless sacramento tent city moved state fairground
0,2,9,44,0,8,0,53,0,watch president trump announce supreme court nominee live
0,1,4,39,0,4,0,43,0,charter communication file reorganization
0,1,2,28,0,4,0,30,0,croatian singer beaten belgrade
0,1,8,40,2,10,5,48,0,"heavy rain flood sri lanka: 50,000 family affected"
0,1,6,51,1,10,0,57,0,"duke duchess cambridge move kensington palace, london"
0,1,3,37,2,6,0,40,0,u.s. senate resume debate immigration bill
0,1,2,41,0,5,0,43,0,australia hit new telstra privatization hurdle
0,1,3,25,0,4,0,28,0,australia reclaim ash perth
0,1,5,59,5,9,0,64,0,"sarkozy make clint eastwood's day; actor becomes ""lgion d'honneur"" commander"
0,3,14,43,4,12,0,57,0,"ludacris sure last laugh bill o'reilly pepsi, he?"
0,1,6,36,0,5,0,42,0,inauguration crowd test cellphone network
0,3,9,48,1,11,0,57,0,military stock rally trump prepares hike budget fox business
0,1,3,31,1,5,3,34,0,icelandic kaupthing bank earnings soar 292%
0,1,4,27,1,4,0,31,0,"floodwaters swamp cedar rapids, iowa"
0,3,10,38,5,10,0,48,0,bleachers' 'don't take money' lorde now: listen
0,1,6,27,0,6,0,33,0,robin hood event adjusts tough time
0,2,3,47,1,8,0,50,0,californian dreaming country without trump: poll
0,1,7,41,1,9,0,48,0,"son remission, family struggle find coverage"
0,1,2,32,0,6,0,34,0,series explosion hit hotel amman
0,1,2,56,0,8,0,58,0,controversy leak preliminary report spanair disaster
0,1,3,23,0,5,4,26,0,feist lead 2008 juno award winner
0,2,3,52,3,9,0,55,0,whatsapp: unsend message feature new shortcut arrive beta
0,2,1,35,0,4,0,36,0,southwest flight make emergency landing
0,2,5,53,5,13,0,58,0,"damian lewis: 'as actor educated eton, i'm still always minority'"
0,2,5,54,2,9,0,59,0,extremist sect threatens protest dalai lama uk visit
0,3,1,44,1,8,2,45,0,trump unveils tax plan giving corporation giant 20% cut
0,1,5,48,1,9,0,53,0,cricket: buderim fill half politician team australia day
0,2,1,85,1,16,0,86,0,indian wedding scammer going hungry like vegan food option available jail
0,1,4,23,0,6,0,27,0,dow chemical buy rohm haas
0,1,7,36,0,6,0,43,0,shakeout approach among real estate investor
0,1,5,42,0,11,4,47,0,cheetah blue bull meet 2006 currie cup rugby final
0,2,2,45,3,8,0,47,0,"philae, europe's comet lander, wake seven month"
0,2,12,41,4,11,0,53,0,"rebuild collapse parenting, going challenge"
0,3,3,47,3,9,2,50,0,yemen conflict: un launch $2.1bn aid appeal amid famine threat
0,3,1,57,0,15,1,58,0,man try smuggle 4 people across border trunk car
0,2,16,65,1,17,1,81,0,mulayam singh expels son akhilesh yadav samajwadi party 5 story need read today
0,1,9,24,0,6,0,33,0,maya moore help uconn roll past depaul
0,2,4,62,0,13,0,66,0,one two missing sydney crocodile found family easter sunday stroll
0,2,11,60,5,12,0,71,0,maxine waters: 'sex actions' allegation trump dossier 'absolutely true' insider
0,3,7,31,3,6,0,38,0,remember character animaniacs?
0,1,5,33,0,5,0,38,0,elizabeth ii annuls fred goodwin knighthood
0,1,5,19,0,5,0,24,0,uk pm pledge aid myanmar
0,1,7,29,0,8,0,36,0,fisher ready give open support wife
0,3,7,28,3,6,0,35,0,everything know drake's 'more life'
0,3,1,44,0,8,0,45,0,congresswoman meet discus missing woman color
0,3,1,46,0,8,0,47,0,trump plan cut funding government agency
0,2,16,52,1,11,0,68,0,watch: fire truck plunge crater section california highway collapse
0,2,2,82,3,18,1,84,0,"aaron rodgers reportedly hasnt spoken family 2 years, think throwing game"
0,1,3,26,0,5,0,29,0,u senate meet private session
0,1,2,18,0,3,0,20,0,apple unveils ipod nano
0,3,1,45,3,9,0,46,0,pictures: share photo theme 'reflect'
0,2,9,74,1,13,0,83,0,brexit brexit: uk supreme court rule government need parliamentary approval start leaving eu
0,3,10,36,4,13,5,46,0,ed sheeran's 'shape you' top hot 100; drake debut two top 10
0,2,4,77,1,13,0,81,0,french presidential candidate emmanuel macron deliver promise remake country?
0,2,6,47,2,9,0,53,0,tory mp nusrat ghani proposes bill banning 'honour killing' term
0,3,10,57,2,10,0,67,0,exclusive: new york family's story survival amid devastating house explosion
0,1,10,63,0,9,1,73,0,national oceanic atmospheric administration launch vortex2 study tornado
0,2,4,78,2,13,0,82,0,paris shooting: gunman karim cheurfi's criminal past focus police seek possible accomplice
0,3,11,38,1,10,0,49,0,"dolphin qb ryan tannehill acl, mcl sprain left knee"
0,1,12,30,2,6,0,42,0,"tamil nadu elections: dmk, aiadmk promise freebie"
0,2,5,42,1,7,0,47,0,world anti-doping agency lift ban madrid laboratory
0,3,3,63,0,13,0,66,0,antonio conte tell chelsea title race chasing pack pose threat
0,3,5,21,3,5,0,26,0,"no, really, thats travel agency"
0,3,15,69,1,14,0,84,0,video sachin tendulkar tabla maestro zakir hussain's jugalbandi winning internet
0,3,10,55,2,10,0,65,0,"lingerie store ordered remove window display plus-size, disabled model"
0,1,6,54,0,8,0,60,0,deposed mauritanian president sidi ould cheikh abdallahi released
0,3,5,30,1,4,0,35,0,president trump's full inaugural address
0,2,11,35,2,12,0,46,0,white house said draft plan u.s. break nafta
0,2,11,37,5,9,0,48,0,homeland sec. kelly: n. korea cyber attack could threaten u.s.
0,2,3,48,0,9,0,51,0,manuel becomes first african american woman win swim gold
0,3,2,80,4,15,0,82,0,'it's drunken behaviour': music industry banding together stamp sexual assault
0,1,5,29,2,6,0,34,0,green party refines 'buy kiwi made' scheme
0,3,6,77,4,19,0,83,0,"vladimir putin: 'our prostitute best world, doubt donald trump would fall them'"
0,2,4,57,0,12,0,61,0,east timor tear oil gas treaty australia hague dispute
0,1,6,39,0,6,0,45,0,rhetoric rationing health care overlook reality
0,3,2,55,1,8,0,57,0,somali elections: mogadishu traffic ban ahead presidential vote
0,3,4,52,2,8,0,56,0,united ceo say removed passenger 'disruptive belligerent'
0,2,2,60,2,11,0,62,0,serena williams writes open letter 'all woman strive excellence'
0,3,2,56,0,8,0,58,0,state department issue presidential permit keystone pipeline
0,3,16,69,1,15,0,85,0,"akshay kumar follows promise, launch platform provide financial aid family martyr"
0,1,7,29,1,6,0,36,0,"youtube blocked china, google say"
0,1,7,29,2,7,0,36,0,"economy stalled, could oil go lower?"
0,2,11,47,0,11,3,58,0,big3 announces inaugural season start june 25 barclays center
0,2,7,42,0,7,0,49,0,trump proposal would deport immigrant immediately
0,1,2,39,0,5,0,41,0,rescue effort underway china earthquake
0,3,10,34,1,11,4,44,0,1980s fx desk looking trade flow
0,2,9,50,0,11,0,59,0,star seville reward john gosden frankie dettori french oak
0,3,15,55,4,13,0,70,0,"super bowl commercials: sony/atv lead synchs, big year indie publisher"
0,3,3,54,0,11,0,57,0,briton jailed three decade u get chance prove innocence
0,1,4,38,1,5,2,42,0,emergency directive sikorsky s-92a helicopter
0,1,2,35,2,6,0,37,0,hong kong 'tutor king' applies bankruptcy
0,3,10,48,4,9,0,58,0,oscar nominee spotlight: 'fences' star viola davis's busy award season
0,3,9,36,0,8,0,45,0,man mistakenly texted former bos search hitman
0,3,9,34,3,8,0,43,0,banksy open west bank hotel world worst view
0,2,4,68,2,11,0,72,0,government 'abandons plan donald trump address parliament state visit'
0,3,5,22,1,4,0,27,0,watch live: white house briefing
0,3,2,44,1,7,0,46,0,mexico wall: trump question talk border dispute
0,1,6,21,0,4,0,27,0,business warm led lighting
0,3,2,42,0,8,4,44,0,washington monument shut least 2019 repair
0,3,6,47,2,11,0,53,0,dr xavier applying u citizenship fight trump list
0,1,4,27,0,6,2,31,0,canadian merchant ed mirvish dy 92
0,3,11,59,4,12,0,70,0,'game thrones' star nikolaj coster-waldau weighs big jaime/cersei theory
0,3,7,38,1,7,0,45,0,ukraine conflict: u condemns threat osce monitor
0,2,2,72,1,14,2,74,0,taxpayer foot 50m bill southern rail strike chaos minister prepare tighten law
0,2,12,45,0,11,0,57,0,wall street surge anew donald trump vow dismantle dodd frank
0,3,8,39,0,9,0,47,0,china revives tie african nation blow taiwan
0,2,16,56,1,14,0,72,0,"betsy devos copied line outside sources, failed cite answer senate"
0,2,11,57,6,12,0,68,0,u.s. navy veteran protest kaepernick charger game: respect leave breitbart
0,2,9,42,2,6,0,51,0,nyt: immigration hard-liners rising trump administration
0,3,12,53,2,15,0,65,0,virgil: left whip climate violence prime target donald trump
0,1,11,37,6,8,0,48,0,"virginia commonwealth, well known, gain n.c.a.a. berth"
0,1,6,28,0,5,0,34,0,court favor karzai term election
0,1,7,52,1,10,0,59,0,"explosion, steam eruption near grand central terminal new york city"
0,2,1,49,2,7,0,50,0,china praise 'tremendous' human right progress
0,3,8,57,0,7,0,65,0,multiple oregon football player hospitalized following intense workout
0,3,1,58,1,10,0,59,0,world's largest fund manager demand cut executive pay bonus
0,1,3,45,0,9,4,48,0,uk conservative party win last seat 2010 general election
0,2,4,52,0,11,0,56,0,kellyanne conway punished breaking law live tv
0,1,6,58,0,9,2,64,0,colorado college tiger win 41st annual great lake invitational tournament
0,3,13,51,2,12,0,64,0,"netanyahu purim: like ancient persia, modern iran fail destroy jew"
0,2,24,48,3,13,0,72,0,warning graphic: brutal murder linked el chapos sinaloa cartel breitbart
0,1,5,51,0,9,0,56,0,nfl star michael vick indicted running dog fighting operation
0,2,9,46,2,8,3,55,0,"trump threatens north korea, insult china 140-character snippet"
0,3,2,65,2,12,0,67,0,indian police trying identify girl found forest living monkey [video]
0,2,2,39,0,7,0,41,0,jared kushner actually speaks front ofpeople
0,1,3,39,0,7,2,42,0,british turkey tycoon bernard matthew dy aged 80
0,2,2,62,1,12,0,64,0,"trump blame democrat confirmation delays, red tape real culprit"
0,1,4,60,1,13,0,64,0,"king tonga hand power prime minister, ending era absolute monarchy"
0,2,8,60,2,8,0,68,0,exclusive: tillerson urge senate ratification montenegro nato membership
0,2,7,43,2,11,0,50,0,"nsw weather: brace third day storm activity, bom warns"
0,2,10,47,1,9,0,57,0,"four new texas zika case likely locally transmitted, official say"
0,2,7,43,1,10,0,50,0,chris christie state state focus drug epidemic
0,3,1,59,0,9,0,60,0,corbyn say relish byelections chance challenge government
0,1,6,34,1,8,0,40,0,"austin, thriving weekly art mission"
0,3,1,39,2,8,0,40,0,"fired porn past, ex-teacher want job back"
0,3,5,40,0,7,0,45,0,donald trump dismisses u sanction threat russia
0,1,7,60,1,9,0,67,0,teaching intelligent design: incumbent dover pa school board fails reelection
0,1,10,27,3,7,0,37,0,house pass stimulus plan g.o.p. vote
0,3,10,37,3,9,0,47,0,u.k. lawmaker pull fox-sky proposal bid gain support
0,1,8,43,2,8,2,51,0,downtown inbounds 3-on-3 basketball invades spokane
0,3,11,61,3,10,1,72,0,hb2 repeal: north carolina legislature vote overturn controversial bathroom bill
0,2,12,48,4,11,0,60,0,trevor noah like seeing kellyanne conway 'taste bulls**t mouth'
0,1,6,29,0,8,2,35,0,kansa shrug dayton reach round 16
0,3,4,60,0,13,4,64,0,bipartisan group senator call probe russian role 2016 u election
0,3,6,64,4,13,0,70,0,syria missile strike: bashar al-assad ally say u attack syria cross 'red lines'
0,3,2,62,3,14,3,64,0,member trump's cabinet rocked slipper cost least $495 not?
0,1,3,47,1,9,0,50,0,"serial killer suspected loose new york, body found"
0,1,5,48,0,12,0,53,0,maori flag fly along side new zealand flag waitangi day
0,1,2,31,0,4,0,33,0,journalist forbidden leave belarus
0,2,8,46,4,10,1,54,0,lumineers' 'cleopatra' climb no. 1 alternative song chart
0,2,3,47,3,9,0,50,0,"harry potter actress pose playboy, say 'naked normal'"
0,3,1,60,1,9,0,61,0,american never conflicted economy's direction
0,2,2,56,0,10,0,58,0,robert xie found guilty murdering five member extended family
0,3,5,72,1,9,0,77,0,treaty: south australian government enters historic discussion aboriginal nation
0,1,1,35,2,4,2,36,0,solar-powered plane completes 26-hour flight
0,1,4,43,0,6,0,47,0,forensic result forthcoming madeleine mccann case
0,1,6,32,2,5,0,38,0,"netanyahu, hawkish, tout pragmatism"
0,2,9,35,0,8,0,44,0,first ebola vaccine likely stop next outbreak
0,1,5,29,0,4,0,34,0,madoff never made supposed investment
0,1,4,51,0,10,2,55,0,elderly man scotland dy contracting h1n1 swine flu virus
0,3,4,55,1,9,0,59,0,wayne rooney: breaking manchester united scoring record huge honour
0,3,11,37,1,9,0,48,0,key player ongoing trump-russia saga
0,2,2,39,0,10,4,41,0,east libya ban travel aged 18 45
0,2,6,40,1,10,4,46,0,humana drop obamacare exchange 2018 breitbart
0,3,9,44,1,8,0,53,0,president donald trump say womens marcher havevoted
0,2,6,70,2,15,0,76,0,"sam willoughby, aussie bmx star, back bike continues recovery spinal injury"
0,3,15,51,2,14,4,66,0,someone kerala started petition make shashi tharoor india's pm 2019!
0,3,12,56,3,14,0,68,0,sara evans launch born fly records: 'following rule anyone else'
0,2,9,48,1,10,0,57,0,full text supreme court nominee gorsuch's remark senate panel
0,2,16,46,1,11,0,62,0,"shooting gop baseball practice seems spontaneous, fbi say"
0,1,9,77,2,15,0,86,0,wikinews interview dr. robert kelly dr. jim gill regarding joint scientific venture north korea
0,1,7,47,0,10,0,54,0,farmer clash amidst high security apec summit south korea
0,1,4,55,2,9,0,59,0,'crown fire' force resident southern california evacuate home
0,1,2,43,1,7,0,45,0,"palestinian election ends, exit poll give abbas lead"
0,2,4,26,3,4,0,30,0,five myth u.s.-china relation
0,2,2,47,1,7,0,49,0,"banging empty pots, venezuelan protest food shortage"
0,1,5,14,1,4,0,19,0,oil going next?
0,2,1,38,2,7,2,39,0,"ohio policeman help girl, 10, math homework"
0,2,3,45,0,13,2,48,0,io 9 give iphone 3 extra hour battery life
0,3,2,59,0,11,0,61,0,man critical condition taipan bite far north queensland home
0,1,2,44,0,8,0,46,0,seven million dollar iraq bank heist leaf eight dead
0,3,12,45,5,13,0,57,0,kevin durant open tell-all interview: 'i'm going real hell'
0,1,3,28,1,5,0,31,0,"avalanche vail, colorado kill one"
0,1,5,21,0,7,1,26,0,blake day 1 wimbledon
0,2,10,28,1,9,3,38,0,j.crew cut 175 job brand loses cool woman
0,2,9,40,3,9,0,49,0,"billboard dance chart upstarts: miss tara, yellow claw grey"
0,2,8,28,0,11,1,36,0,hour running may add 7 hour life
0,2,5,55,2,10,0,60,0,"eying georgia arizona, clinton campaign look narrow trump path"
0,2,13,46,6,12,2,59,0,lox return first album 16 years: 'filthy america beautiful'
0,1,7,33,0,6,0,40,0,another los angeles time promotion draw fire
0,1,4,54,0,10,3,58,0,final report blame instrument failure adam air flight 574 disaster
0,3,7,42,2,7,1,49,0,"desmond trufant, falcon agree 5-year contract extension"
0,2,4,52,1,11,4,56,0,hillary clinton 2016 campaign rally roosevelt island happened
0,2,4,64,0,12,0,68,0,former president bush moved intensive care wife barbara also hospitalized
0,2,8,36,3,9,0,44,0,"lawsuit lawsuit, everyday people v. trump"
0,3,11,40,1,11,0,51,0,yahoo eu watchdog set show teeth privacy probe wrap
0,1,5,35,0,7,4,40,0,new caledonia prepares 2011 south pacific game
0,3,3,57,2,12,6,60,0,"snapchat's first investor found snapchat less 100,000 user"
0,3,4,43,0,8,0,47,0,many american muslim fear safety trump
0,1,5,13,0,3,0,18,0,apec close sydney
0,2,12,39,1,12,0,51,0,lebron's new intel ad make fun people call crybaby
0,2,5,21,0,5,0,26,0,donald trump dog dow strategy
0,3,10,48,2,11,0,58,0,"face trump order, muslim nation conspicuously silent"
0,3,6,33,0,7,0,39,0,sugary drink tied accelerated brain aging
0,2,4,57,3,8,0,61,0,destination 'humourless nude': truth german holidaymaker
0,3,1,64,0,10,0,65,0,homeowner charged manslaughter shooting home invasion suspect
0,1,7,30,1,7,0,37,0,"hike, blazing trail phone software"
0,2,13,66,2,14,0,79,0,trump appears side assange intelligence agency conclusion new york time
0,2,8,46,0,12,1,54,0,golden state even nba final vital game 4 win cleveland
0,3,7,80,2,18,0,87,0,"arron bank declares war ukip chief reveals plan unseat douglas carswell, party's sole mp"
0,3,11,49,2,10,0,60,0,unarmed man fatally shot off-duty officer chicago's northwest side
0,3,5,54,0,10,0,59,0,chelsea clinton burn trump twitter baffling sweden remark
0,1,4,31,2,6,0,35,0,"nrma stand ""unsafe"" smash repair system"
0,2,4,49,0,11,2,53,0,andrey pavlov score nightmare 17 single hole lyoness open
0,3,5,27,1,6,0,32,0,merry christmas tree grower
0,3,8,32,3,7,0,40,0,north korea nuclear clock ticking now: expert
0,1,5,55,2,10,0,60,0,"bush backtracks legal status alleged ""dirty bomber"" jose padilla"
0,2,1,55,2,11,0,56,0,"trump say ""someone look paid for"" tax return rally"
0,3,9,64,5,13,0,73,0,"penny say u 'strongly support nato,' hold russia 'accountable' ukraine action"
0,1,1,31,0,3,0,32,0,ukraine parliament sack government
0,2,9,76,8,20,0,85,0,"yes, thats j. peterman seinfeld pitching ipo tv no, thats surprising thing"
0,3,9,43,1,10,1,52,0,saudi arabia seeking way boost 4% foreign stock ownership
0,1,2,49,1,8,0,51,0,least thirty-three dead ethiopia election clash
0,3,16,63,2,14,0,79,0,world's first fully mass-produced atlas visually impaired people made india
0,2,3,33,1,6,0,36,0,see view spacex's historic mission
0,1,3,41,0,6,0,44,0,vote sri lankan presidential election counted
0,2,13,51,4,11,0,64,0,house gop warns obama bureaucrats: reverse midnight rule breitbart
0,1,3,47,2,6,0,50,0,"australian government introduces ""fair work"" parliament"
0,1,7,44,0,8,0,51,0,chinese official protest sinking cargo ship russian
0,3,9,37,1,9,0,46,0,facebook enough keep murder site?
0,1,9,29,2,7,0,38,0,higher oil price help widen u.s. trade deficit
0,3,8,37,0,7,0,45,0,economy getting miserable year
0,2,6,29,0,6,0,35,0,twitter bot shaping election
0,1,1,40,0,8,0,41,0,study soft cheese win oddest book title award
0,2,7,36,2,6,2,43,0,samsung recall 2.8 million top-load washing machine
0,3,5,43,1,8,0,48,0,north korea nuclear: white house call senate briefing
0,3,6,77,2,15,0,83,0,politician one mexico's leftist party smashed donald trump piata christmas party
0,2,10,46,0,10,0,56,0,president barack obama join kennedy center honor last time
0,3,9,49,0,11,0,58,0,scientist say people arrived earlier thought north america
0,2,12,34,3,9,0,46,0,watch sheryl crow perform new music 'ncis: new orleans'
0,3,4,36,2,10,0,40,0,trump say u 'must paid more' defend germany
0,1,5,26,0,7,2,31,0,suicide attack kill least 15 iraq
0,3,4,63,7,13,0,67,0,"u.s. basketball player stranded dubai, unable return team iran (updated)"
0,3,8,43,2,7,0,51,0,stephen colbert mock donald trump jr.'s political ambition
0,1,6,24,0,6,0,30,0,walt disney plan lay worker
0,2,4,30,2,8,2,34,0,'perry mason' actress barbara hale dy 94
0,3,10,49,0,10,0,59,0,cult leader charles manson back prison hospitalized
0,2,3,62,4,13,2,65,0,"ms-13 gang member accused killing teen claimed satan wanted soul, police say"
0,2,7,34,2,8,0,41,0,short supply donald trump cabinet: lawyer
0,2,12,46,6,9,0,58,0,record-breaking year self-made woman billionaires. here's why.
0,1,2,34,0,6,0,36,0,polish pilgrim killed french bus crash
0,3,12,35,3,10,0,47,0,"ufc fighter jose aldo call conor mcgregor ""piece sh*t"""
0,3,7,27,0,10,4,34,0,best class 2017 new york auto show
0,1,2,48,1,7,0,50,0,"historic building moscow collapses, three people killed"
0,2,12,44,0,11,0,56,0,billy ray cyrus hinting miley liam secretly gotmarried
0,1,6,49,1,9,4,55,0,"uk chancellor exchequer, alistair darling release 2008 budget"
0,1,3,58,0,10,0,61,0,houston mayor urge evacuation hurricane rita move closer shore
0,2,19,63,2,15,0,82,0,"california dmv latest regulator stamp uber, say testing self-driving taxi illegal"
0,2,3,35,1,6,0,38,0,jury clear derrick rose gang-rapelawsuit
0,1,4,26,0,6,0,30,0,huge gay pride parade held brazil
0,1,7,32,0,9,0,39,0,sign life deal pick madison avenue
0,2,14,41,3,11,0,55,0,check first trailer espns 'this xfl' documentary
0,1,3,23,0,5,2,26,0,comedian richard pryor dy 65
0,3,11,48,5,9,2,59,0,74-year-old man arrested alleged 'massacre' kim kardashians book
0,1,5,27,0,7,2,32,0,muzak file chapter 11 refinance debt
0,1,4,26,0,5,0,30,0,court rule deportee custody
0,3,1,64,1,11,0,65,0,"tesla fatal crash driver exceeding speed limit, official report find"
0,3,17,0,1,2,0,17,0,report: ackman fold
0,3,2,76,0,13,0,78,0,lidl gravy granule found contain harmful paint thinner chemical week christmas
0,3,9,47,1,11,0,56,0,kanye west reportedly talk perform year's grammys
0,3,7,38,1,7,0,45,0,republican leader search health-care bill vote
0,2,9,45,5,9,4,54,0,monday best tv: winterwatch 2017; britain cheap clothes; halcyon
0,1,5,28,1,5,0,33,0,"municipal bond funds, starring role"
0,3,3,46,2,9,2,49,0,clippers' chris paul miss 6-8 week following thumb surgery
0,2,9,47,2,8,0,56,0,"massive texas sinkhole swallow two cars, killing sheriff's deputy"
0,1,4,54,0,9,0,58,0,eight u soldier killed afghanistan clash millitants
0,1,1,45,0,7,0,46,0,european court upholds asset freeze terrorist case
0,1,7,43,1,9,0,50,0,"myanmar ethnic group hope peace, prepare battle"
0,2,3,41,0,8,0,44,0,mlb player launching social medium app
0,1,2,31,0,4,0,33,0,new zealand policeman caught speeding
0,1,5,33,0,7,0,38,0,digital storage option worker go
0,3,1,67,0,12,0,68,0,mother invents silicon guard save rugby player curse cauliflower ear
0,2,10,53,0,13,0,63,0,man arrested assaulting pushing woman onto subway track
0,1,4,53,1,12,4,57,0,suspect 1998 bombing u embassy tanzania face death penalty
0,2,15,48,0,12,2,63,0,mma fighter leaf opponent stiff canvas floor via overhand right tko37
0,1,6,35,1,7,0,41,0,"meet intel, software maker rival microsoft"
0,2,11,51,7,11,0,62,0,"latin connection podcast: maluma u.s. tour, 'cuatro babys' controversy"
0,2,9,41,0,9,1,50,0,6 holiday finance tip help manage seasonal spending
0,1,8,37,0,7,0,45,0,lebron james help cavalier complete sweep hawk
0,1,6,56,4,12,2,62,0,"art linkletter, creator ""kids say darndest things"", dy peacefully 97"
0,2,11,44,2,9,0,55,0,painting depicting cop animal removed u.s. capitol
0,3,5,43,3,8,0,48,0,trump nemesis rosie odonnell call martial law [video]
0,3,5,43,1,9,0,48,0,"burger king, tim hortons owner adding popeyes holding"
0,3,4,57,2,12,0,61,0,rubio camp hit new york time absurd piece questioning finance
0,2,4,68,2,14,0,72,0,philippine drug enforcement agency say army play 'support' role drug war
0,1,5,17,0,6,0,22,0,one ear
0,2,3,63,1,11,0,66,0,kakenya ntaiya's mission show kenya importance educating girl
0,3,5,58,0,11,0,63,0,david sullivan hit dimitri payet completes marseille move
0,2,4,30,2,6,0,34,0,hollywood stop trump crew getsangry
0,1,5,25,0,5,0,30,0,three candidate killed iraq
0,2,3,52,0,7,0,55,0,burmese government denies ongoing genocide rohingya muslim
0,3,11,56,1,12,0,67,0,"million across plain midwest face heavy snow, deep freeze weekend"
0,2,4,24,1,4,0,28,0,china future democracy
0,3,1,46,2,10,0,47,0,here's life like world's crowded city
0,2,2,54,0,10,0,56,0,thousand tennessee hope return home rain slows wildfire
0,3,9,41,1,8,0,50,0,"retailer use augmented reality, high tech lure shopper"
0,3,1,50,1,10,0,51,0,soccer game photo proof co-parenting work fine
0,1,9,42,0,8,0,51,0,prison worker fired shocking child stun gun
0,3,7,68,0,12,0,75,0,contamination near linc energy ucg plant hopeland widespread first thought
0,1,3,82,2,13,2,85,0,17 troop killed bombing afghanistan-pakistan border; separate bombing kill dozen civilian
0,3,18,72,2,16,0,90,0,"warner music ceo stephen cooper tout market share gains, praise craig kallman year-end message staff"
0,3,1,48,0,9,0,49,0,london nightclub acid attack leaf woman blind one eye
0,1,1,59,0,9,0,60,0,venezuelan regional election win supporter opponent
0,3,11,43,0,11,0,54,0,mccain step ease tension australia trump insult
0,2,3,27,1,3,0,30,0,obama-era surgeon general replaced
0,1,3,34,0,6,2,37,0,insurgent attack south thailand injures 24
0,1,5,41,0,8,0,46,0,event take place across uk mark remembrance sunday
0,2,6,43,1,10,0,49,0,"uk block closer eu defence ties, say boris johnson"
0,3,10,56,1,12,0,66,0,what's stake berkeley trump warns university canceled speech
0,1,5,36,0,6,2,41,0,louisville top rutgers 11th straight victory
0,3,1,58,2,8,3,59,0,investigation launched 200-year-old beech tree illegally cut
0,2,5,41,0,9,0,46,0,paul mccartney sue get beatles song back sony
0,2,9,27,0,9,0,36,0,play pc game elon musk wrote preteen
0,2,11,63,2,13,1,74,0,"carolina panther cam newton benched 1st play vs. seahawks, derek anderson given start"
0,1,6,30,0,6,0,36,0,trade barrier rise slump tightens grip
0,1,2,38,0,7,0,40,0,four young girl killed zambia wall collapse
0,1,5,31,1,5,0,36,0,nasa's mar rover exceed expectation
0,2,3,36,1,5,0,39,0,anti-islamic senator control aussie senate
0,1,2,30,0,6,0,32,0,new ash flight ban ordered ireland
0,3,9,24,1,7,0,33,0,easter egg nest cake recipe nyt cooking
0,1,7,34,0,7,0,41,0,mcnamee meet prosecutor clemens case
0,2,16,58,3,15,0,74,0,"make sure goa local remain 'sanskari', state govt ban entry casino"
0,3,8,45,1,9,0,53,0,carrie fisher: hospital confirms heart attack cause death
0,2,12,42,4,9,0,54,0,"spicer criticizes fake news, denies shake-up wh comms strategy"
0,2,16,69,2,15,0,85,0,"rising pollution causing acid rain across india, plants, animal earth punished human sin"
0,2,15,37,0,11,0,52,0,lgbt center open door across mormon temple utah
0,2,15,72,0,15,0,87,0,george karl confirms spoke michael jordan possibly trading shawn kemp scottie pippen
0,1,3,73,2,9,0,76,0,ferry hijacked protest slogan assassinated turkish-armenian journalist's funeral
0,1,5,43,0,8,0,48,0,united state senator ted kennedy rushed hospital
0,1,3,36,0,7,0,39,0,seven arrested uk cruise ship drug seizure
0,1,3,26,0,3,0,29,0,journalist gebran tueni murdered
0,1,1,38,0,7,0,39,0,amsterdam pet shop owner creates beer dog
0,2,4,40,1,8,0,44,0,trump attend army-navy football game baltimore
0,2,14,25,1,7,0,39,0,watch now: lindsey graham face town hall crowd
0,2,10,45,5,10,0,55,0,"u.s., south korean warplane prepare action 'max thunder' drill"
0,1,4,54,1,8,2,58,0,winning british euromillions lottery ticket worth 56 million claimed
0,1,4,42,0,7,0,46,0,uk prime minister announces date general election
0,2,6,37,1,7,0,43,0,elena ferrantes neopolitan novel come hbo
0,1,4,46,2,8,0,50,0,"two missing severe thunderstorm st. paul, minnesota"
0,2,7,36,0,9,0,43,0,megyn kelly replaced tucker carlson fox
0,2,4,57,0,12,0,61,0,annexing crimea allowed putin claim made russia great
0,2,13,56,3,13,0,69,0,"seth rogen, lonely island hint movie musical fest go 'horribly wrong'"
0,3,17,44,2,13,0,61,0,proud mom julia louis-dreyfus cheer son ncaa b-ball game insider
0,3,12,47,0,12,0,59,0,soulja boy say chris brown scared sign boxing match contract
0,1,6,39,0,8,0,45,0,rebuilding lion challenge martin mayhew
0,1,1,21,0,4,0,22,0,oil price reach new high
0,1,1,42,1,5,0,43,0,agriculture's impact human evolution clarified
0,2,3,45,0,8,0,48,0,exxon mobil denied permission resume russian oil work
0,2,7,40,1,7,0,47,0,"jennifer hudson, brie larson announce oscar nominee"
0,3,5,39,0,7,0,44,0,tension boil democrat fbi director
0,1,10,23,0,8,7,33,0,nascar driver kyle busch win 2011 jeff byrd 500
0,1,2,34,0,4,0,36,0,strong earthquake hit northern pakistan
0,3,4,43,1,10,0,47,0,"fbi arrest ohio pastor, another man child sex charge"
0,1,4,53,2,10,2,57,0,"vyacheslav tikhonov, russian actor famous stirlitz, dy 81"
0,1,2,54,0,9,0,56,0,australia announces levy bill offset cost queensland flood
0,2,5,26,1,4,0,31,0,investor watch dollar-yen clue
0,2,17,44,1,12,0,61,0,anthony davis set new nba all-star game scoring record win mvp award
0,1,3,43,0,7,0,46,0,latvian government take majority stake parex bank
0,3,8,51,2,9,0,59,0,justice alarmed government hard-line stance citizenship case
0,2,10,53,0,9,0,63,0,melania trump defamation suit political blogger move forward
0,2,2,62,1,9,0,64,0,well-wisher raise thousand teenage asylum seeker attacked croydon
0,2,1,50,0,10,0,51,0,officer quits avoid firing shooting unarmed teen
0,3,1,61,0,12,0,62,0,woman suffering rare disease make literally stiff board
0,1,3,48,0,9,3,51,0,boeing 757 make emergency landing vnukovo airport moscow
0,1,7,30,2,6,0,37,0,treaty strengthen e.u. get another chance
0,2,4,47,1,9,0,51,0,"white house crisis, trump look increasingly isolated"
0,2,12,54,3,11,0,66,0,"people using ""nevertheless, persisted"" share example badasswomen"
0,2,3,73,3,12,0,76,0,white nationalist richard spencer ex-classmates decry raising money refugee
0,3,13,55,2,11,0,68,0,george h.w. bush resurfaces toss super bowl coin following hospitalization
0,1,3,28,0,5,0,31,0,sydney fc lose competition point
0,3,1,52,2,8,0,53,0,entertaining interview impeachment (starring kid)
0,3,3,62,0,11,0,65,0,china communist party office attacker shot dead police killing two
0,2,3,47,2,9,2,50,0,china anbang abandon $14 billion bid acquire starwood
0,2,12,45,1,11,0,57,0,bill oreilly set make first appearance since ouster fox news
0,3,7,36,1,8,0,43,0,"gretchen carlson talk join msnbc, source say"
0,1,4,25,0,6,4,29,0,wikinews visit 2008 reno air race
0,3,2,67,0,12,0,69,0,first american hoverboard fire death part federal investigation
0,2,1,57,2,11,3,58,0,"nigeria mistakenly bomb refugee camp, kill 100, official say"
0,1,3,38,0,5,0,41,0,australian pm announces public affair channel
0,1,4,23,0,5,0,27,0,nasa unveils plan moon base
0,1,2,49,1,7,0,51,0,rhode island man arrested record blood-alcohol reading
0,3,9,43,2,9,4,52,0,2017 volkswagen golf alltrack review: vws guide practical magic
0,2,4,48,3,9,2,52,0,"emmanuelle riva, oscar-nominated french actress, dy aged 89"
0,3,9,45,1,9,2,54,0,41 insanely beautiful drag queen wanna follow instagram
0,1,1,42,5,5,0,43,0,"olympic condom auctioned: ""faster, higher, stronger"""
0,2,1,25,0,5,1,26,0,6 dead quebec mosque shooting
0,3,6,31,1,8,0,37,0,cavalier lucky charm teeter six chair
0,1,3,45,0,7,0,48,0,negotiation athens skopje lead deadlock
0,2,7,54,4,10,0,61,0,make soros happy: inside clinton team mission please billionaire vip
0,1,5,38,0,7,2,43,0,discovery space shuttle launch scheduled july 13
0,3,11,62,1,10,0,73,0,environmentalist less horrified donald trump's interior pick nominee
0,1,7,27,0,8,2,34,0,least 74 miner killed china blast
0,3,7,38,2,10,2,45,0,"1 5 adult cancer-causing hpv, cdc report"
0,3,8,44,0,8,0,52,0,sumner redstone leaving viacom board february meeting
0,2,6,24,2,6,0,30,0,"skittles, hardly knew ye breitbart"
0,3,3,66,5,10,0,69,0,jerry seinfeld: politically correct student 'don't know they're talking about'
0,1,10,31,2,10,6,41,0,2007 fifa u-17 world cup: ghana beat peru quarter final
0,1,6,48,0,9,0,54,0,u free speech lawyer marc randazza discusses glenn beck parody
0,1,4,47,0,8,0,51,0,rumour suggest alonso schumacher could move ferrari
0,1,7,29,0,6,0,36,0,north korea claim border marker moved
0,3,9,44,1,11,0,53,0,"corner, president enrique pea nieto mexico punch back"
0,3,4,72,3,13,0,76,0,"worker endured long hours, low pay chinese factory used ivanka trump clothing-maker"
0,3,5,74,2,13,0,79,0,pound sterling helped donald trump healthcare defeat seven-week high u dollar
0,2,1,38,1,8,0,39,0,there better way fight morning breath
0,3,14,54,4,12,0,68,0,"'snl' rip donald trump's twitter habits, donald trump responds tweeting"
0,1,4,45,2,11,2,49,0,press conference held thursday new 'star trek 11' movie
0,2,5,30,0,9,5,35,0,ronda rousey knocked 48 second ufc 207
0,1,4,31,0,5,0,35,0,uk work secretary david blunkett resigns
0,1,7,31,2,8,0,38,0,"public, pro, rule bethpage black"
0,2,10,41,0,10,0,51,0,people outraged plan shut rikers island
0,1,2,42,1,6,0,44,0,"washington metro collision kill nine, injures many"
0,2,9,41,2,10,0,50,0,bill de blasio: im supporting keith ellison dnc chair
0,3,8,41,1,9,0,49,0,china army global homebuyers suddenly short cash
0,2,9,53,3,9,0,62,0,jubilant sander supporter jeer clinton victory speech iowa tie
0,2,7,44,3,8,0,51,0,"karnak temple luxor, egypt, targeted attackers: official"
0,3,3,54,0,10,0,57,0,nba star hurl profanity reporter outburst caught camera
0,2,16,56,3,14,0,72,0,petition call abc fire jesse williams racist bet award speech breitbart
0,2,13,50,3,14,0,63,0,eight u.s. airline win tentative approval fly havana new york time
0,2,2,10,0,1,0,12,0,program guide
0,1,3,43,0,7,0,46,0,space shuttle discovery resume rollout launch pad
0,1,10,58,1,14,0,68,0,"nod ireland, european union lift hope treaty strengthen"
0,2,10,43,1,11,0,53,0,investor peter thiel helping mold tech tie donald trump
0,1,10,64,1,13,0,74,0,"uncertain day eurovision rehearsals, ebu place sanction spain rtve"
0,1,2,29,0,6,2,31,0,poisoned liquor kill 17 kenyan slum
0,3,1,54,0,9,0,55,0,texas teacher allegedly paid student keep relationship quiet
0,2,3,49,1,8,0,52,0,"climate refugee south asia need protection, advocate say"
0,3,5,30,0,9,2,35,0,13 nfl team still never super bowl
0,2,8,36,5,10,2,44,0,"oil up, brent settle $50; u.s. crude draw offset opec"
0,3,4,59,0,9,0,63,0,one nation threatens coalition unity tearing national heartland
0,1,1,37,0,6,0,38,0,haiti might postpone election
0,1,2,38,0,7,2,40,0,30 killed mexico dynamite truck explosion
0,3,19,68,4,17,0,87,0,here's story 'white helmets' risking life save innocent civilian war-torn syria
0,1,10,49,0,10,0,59,0,outcry erupts report israel used phosphorus arm gazans
0,3,4,46,0,13,2,50,0,police find jeep buried 20 foot snow donner pas
0,1,5,34,0,6,0,39,0,loss widen american united airline
0,2,6,40,0,7,0,46,0,surprising musical preference amazon tribe
0,3,9,45,0,11,4,54,0,momentous event 2016 happened brexit trump
0,1,7,35,1,7,0,42,0,"europe, major economy shrank first quarter"
0,2,9,59,1,12,0,68,0,"meet tim ryan, ohio democrat challenging nancy pelosi lead house democrat"
0,2,9,52,1,13,0,61,0,margot robbie confirms marriage tom ackerley flip finger
0,1,2,50,2,8,0,52,0,british scientist shot dead ecuador unlawfully killed
0,2,7,39,2,7,0,46,0,topshop mannequin criticized thin [video]
0,3,2,51,1,10,0,53,0,trump son get red carpet treatment dubai golf club opening
0,2,12,40,0,9,0,52,0,john kasich critique gop health care plan medicaid cut
0,2,3,39,2,6,0,42,0,meet trump latest political enemy: fire marshal
0,1,6,63,0,11,0,69,0,new york time reporter judith miller break silence plame leak investigation
0,2,2,51,0,8,0,53,0,ukraine lawmaker met trump associate face treason probe
0,2,4,54,1,12,0,58,0,exclusive: iraq plan sell oil iran talk kurd fail
0,2,12,46,1,12,3,58,0,"200 whale stranded new zealand, heroic turn heartbreak"
0,3,8,65,3,12,0,73,0,reelly yuge catch! fisherman net bizarre looking square fish 'resembling donald trump'
0,3,8,39,7,13,0,47,0,"sen. perdue syria: 'we've got stop isis, that's job one'"
0,1,6,59,1,10,3,65,0,colombian police claim venezuelan government paid farc rebel $300 million
0,3,2,45,0,8,0,47,0,beware holiday gift exchange scam facebook
0,2,12,41,1,7,0,53,0,outfront: entrepreneur creates inclusive camp lgbtq youth
0,2,1,47,3,8,0,48,0,"good, bad, unknown marijuana's health effect"
0,2,9,45,0,10,0,54,0,florida state senator resigns using racial slur tirade
0,3,6,59,6,15,0,65,0,"new u un envoy warns allies: 'for back, we're taking names'"
0,1,1,39,0,5,0,40,0,london fire extinguisher throw suspect bailed
0,1,6,54,0,11,4,60,0,mclaren mercedes driver snatch front row 2007 hungarian grand prix
0,3,2,67,1,14,0,69,0,"queen begin sandringham break day late, delaying travel due heavy cold"
0,1,5,30,0,6,4,35,0,lewis hamilton win 2009 singapore grand prix
0,1,4,28,1,5,0,32,0,"sinkhole reported buffalo, new york"
0,3,2,39,2,8,0,41,0,australia's right strike law gone far?
0,3,19,50,0,18,0,69,0,iranian woman showing hair act protest bigdeal
0,2,1,60,0,13,1,61,0,man return home overjoyed mom biking around world 7 year
0,2,10,47,1,13,0,57,0,"indian ocean, fragment continent"
0,2,10,46,1,12,0,56,0,sean spicers quick twitter reaction job report may break rule
0,1,7,39,1,7,0,46,0,"isiah thomas resurfaces, knicks rebuild franchise"
0,1,3,36,1,7,0,39,0,"two dead car crash inverness, scotland"
0,1,6,39,0,9,0,45,0,pope concludes visit u mass yankee stadium
0,3,1,60,2,14,5,61,0,"seafood eater ingest 11,000 tiny piece plastic every year, study show"
0,3,8,72,3,18,0,80,0,compact tent ever? foldable metallic 'house' small fit pocket
0,2,13,41,4,11,2,54,0,"meet harrison bailey, 15-year-old qb made cam newton's jaw drop"
0,1,1,36,0,5,0,37,0,central bank worldwide cut interest rate
0,2,7,43,0,9,2,50,0,aaron hernandez dy 27 committing suicide prison
0,3,9,32,3,8,0,41,0,"""patriots day"" first movie trumpsamerica"
0,3,10,46,4,9,0,56,0,former 'american idol' contestant cry called 'white boy'
0,1,4,33,0,5,0,37,0,obama withdraws trinity united church
0,1,9,42,1,8,0,51,0,"fort lee, virginia adopts rapidgate fast civilian access"
0,2,3,46,2,8,4,49,0,"panama papers: europol link 3,500 name suspected criminal"
0,1,7,23,0,5,0,30,0,heavy lift delta iv rocket launch
0,3,4,51,4,11,2,55,0,vauxhall opel sold peugeot-citroen 2.2bn deal business live
0,2,2,44,1,12,1,46,0,"day 1 first foreign trip, trump seen heard"
0,1,7,23,1,6,0,30,0,n. korea say holding reporter
0,2,5,62,1,11,0,67,0,live: scene ankara following fatal shooting russian ambassador turkey
0,1,7,74,0,12,0,81,0,representative aclu tell wikinews opinion lifting wikileaks court injunction
0,1,3,31,3,5,2,34,0,"ms-13 gang threatens arizona ""minutemen"""
0,1,7,38,0,7,0,45,0,dispute armstrong french agency heat
0,3,8,61,0,14,0,69,0,twitter sue government block unmasking account critical trump
0,2,11,46,2,11,0,57,0,"new year day brings new law regulating phones, gun soft drink"
0,3,3,45,2,11,1,48,0,"kelly pease, idaho mother 5, found shot dead parking lot"
0,3,1,25,1,8,4,26,0,key point budget 2017 glance
0,3,5,52,4,10,0,57,0,vendee globe: armel le cleac'h win round-the-world race record time
0,2,3,50,1,8,0,53,0,"spurning tiffany trump, fashion world prof itshypocrisy"
0,1,2,34,0,5,0,36,0,mass poultry vaccination planned china
0,3,10,46,2,10,0,56,0,"fact-checking website snopes, bigger role brings attack"
0,3,3,38,0,5,0,41,0,epa move toward regulating airplane emission
0,1,6,36,0,6,0,42,0,head joint chief praise pakistani operation
0,1,7,33,0,7,0,40,0,mv rachel corrie seized israeli naval force
0,3,6,60,3,13,0,66,0,britain's new eu ambassador 'had nothing do' donald trump russian dossier
0,1,2,40,0,4,0,42,0,wikimedia common celebrates first anniversary
0,1,3,40,1,8,0,43,0,"man killed harbour car crash cornwall, england"
0,2,6,28,3,7,4,34,0,drake's 'more life' project coming early 2017
0,2,12,47,1,11,0,59,0,nigerian womens bobsled team superheroes need rightnow
0,3,20,67,7,19,0,87,0,"punjab 'taj mahal' called 'pul moran', memorial maharaja ranjit singh's love moran, dancer"
0,3,4,67,2,16,3,71,0,radio 2 invite brian matthew record 'goodbye' sound 60 avid listener
0,1,5,31,0,5,0,36,0,schwarzenegger get part stallone film
0,1,2,57,1,8,0,59,0,gabon court upholds presidential candidate bongo's win protest
0,1,9,25,0,8,0,34,0,bmw cut job plant make mini
0,1,7,42,2,9,0,49,0,"finland, estonia greece ratify eu's treaty lisbon"
0,1,2,59,0,10,0,61,0,thai force alert second anniversary narathiwat armoury raid
0,2,3,49,3,11,0,52,0,grief: prince harry open mental health
0,3,13,45,0,11,0,58,0,bryce harper already earning back hype failed mvp encore
0,2,9,43,3,12,0,52,0,muslim woman hijab break barriers: take good bad
0,2,2,64,6,11,0,66,0,'night cover almost always short-staffed. terrifying': doctor rota gap
0,2,4,52,0,11,0,56,0,exhibition princess diana dress open public photo
0,2,9,30,0,8,0,39,0,kris jenner totally owns plunging dress
0,3,3,56,1,10,0,59,0,"alone paris, refugee child frantic see british family"
0,3,8,50,1,11,0,58,0,extremist turn leader protect western values: vladimir putin
0,2,2,86,0,16,0,88,0,white house press secretary go lengthy rant attempt clarify change national security team
0,1,8,38,1,7,0,46,0,air france delta seal trans-atlantic joint venture
0,1,3,60,2,13,0,63,0,u say zimbabwe government long way go sanction lifted
0,3,10,56,3,11,0,66,0,"steph curry's secret success: brain training, float tank strobe goggles"
0,3,8,34,0,7,0,42,0,mike posner look really different thegrammys
0,3,10,27,0,8,0,37,0,fan suggest next nba logo
0,1,6,40,0,9,0,46,0,trial cambodia expose cog killing machine
0,3,5,21,0,5,4,26,0,best sport photography of2016
0,1,9,45,1,9,0,54,0,neda agha-soltan becomes symbol iran protest video
0,1,2,29,0,4,0,31,0,explosive found california cave
0,2,4,44,0,10,1,48,0,north dakota teen get accepted 8 ivy league school
0,2,13,45,1,14,6,58,0,"kolkata market, sell demonetised 500 rupee note r 550"
0,2,14,37,0,13,0,51,0,heroic pup jumped front bus save blindowner
0,3,8,44,2,9,0,52,0,"politicians, celebs react patriots' historic super bowl win"
0,1,6,33,1,6,0,39,0,nasa's phoenix spacecraft land safely mar
0,3,8,46,0,10,1,54,0,unilever bid follows familiar playbook warren buffett 3g
0,3,11,47,4,9,4,58,0,"ncaa women's basketball bracket 2017: results, seeds, reaction analysis"
0,3,14,59,0,14,1,73,0,new leak suggest iphone 8 may invisible front camera underneath display
0,2,1,48,2,11,1,49,0,"montana man kill wife, 3 young child self, police say"
0,3,12,38,1,11,0,50,0,"stop trashing lebron taking game off, nba blame"
0,1,4,34,0,5,0,38,0,ebay buy verisign payment service division
0,3,3,59,0,12,0,62,0,lady gaga make history first female headliner decade coachella
0,2,10,50,2,9,0,60,0,mike wileys recipe olive oil-poached cod cauliflower couscous
0,1,7,41,0,8,0,48,0,olympic champion wanjiru lead new wave marathoner
0,3,2,63,1,12,1,65,0,oklahoma home invasion shooting: charge man killed 3 intruder
0,1,4,55,1,7,0,59,0,storing ip-addresses swedish copyright infringers deemed illegal
0,3,9,42,2,8,0,51,0,matthew mcconaughey say need embrace president trump
0,2,10,49,2,9,0,59,0,indian man accused multimillion-dollar call-center swindle held
0,1,5,79,2,12,0,84,0,"australian rule football: gippsland football league heavyweight clash, maffra go two game clear"
0,1,6,38,1,5,0,44,0,"israel close medium center, upsetting palestinian"
0,2,9,51,4,9,0,60,0,preet bharara link firing trump team helter-skelter incompetence
0,2,17,52,1,13,0,69,0,ibmvoice: chatbots cloud ushering next era cognitive business
0,3,4,72,4,14,0,76,0,would use this? parent sticking decoration babies' head 'girlie glue'
0,2,12,55,2,13,0,67,0,north korea launch ballistic missile raise new worry new york time
0,3,3,56,3,12,0,59,0,"harsh scolding, spicer press avoid fisticuffs. truce?"
0,3,6,38,3,8,0,44,0,"""homeland's"" rupert friend read wwi poem gas attack"
0,2,6,53,1,11,0,59,0,gordon brown: uk life support conservative play english card
0,3,8,29,1,7,5,37,0,ncaa tournament 2017: biggest surprise day 3
0,3,11,39,1,11,6,50,0,everything need know final night 2016-17 nba season
0,1,3,21,2,2,0,24,0,"accounts, people, miscellany"
0,2,9,24,0,8,0,33,0,best podcast year made
0,1,5,31,0,6,0,36,0,china go commodity shopping spree
0,1,3,34,0,5,0,37,0,record typhoon chanchu batter south china
0,3,11,57,4,10,0,68,0,eden prince twist britney spears' 'toxic' sophisticated house groove: listen
0,2,16,70,1,13,0,86,0,"sweden ended bofors probe save rajiv gandhi embarrassment, reveal declassified cia document"
0,2,12,38,0,11,2,50,0,31 earring cheap af people always lose
0,1,6,46,0,11,0,52,0,los angeles lakers need win game six tie nba championship
0,2,18,46,2,13,0,64,0,ibmvoice: ai social good: human machine making better world
0,3,8,46,0,8,0,54,0,serena williams responds racist remark pregnancy
0,2,4,61,5,11,0,65,0,ted cruz say democrat history biggest obstructionists.
0,2,2,56,3,9,0,58,0,rolf harris 'attacks victim money-grabbing wench prison song'
0,1,6,25,1,5,0,31,0,"tiger woods, timing everything"
0,3,6,31,0,5,0,37,0,soulja boy arrested violating parole
0,2,4,31,1,7,2,35,0,"star war actress carrie fisher dies, aged 60"
0,3,12,46,1,10,0,58,0,"democrat grill trump hhs nominee stock trades, obamacare plan"
0,1,8,35,1,8,0,43,0,"australian winemakers, turn less"
0,1,4,26,1,7,2,30,0,tour de france: tom boonen win stage 12
0,3,10,60,0,9,0,70,0,philadelphia police investigate viral video showing cop repeatedly hitting teen
0,1,5,73,2,13,0,78,0,united kingdom economy triple dip recession 'to avoided' say british chamber commerce
0,1,2,47,2,10,4,49,0,uk study reveals smoking could shorten men's life 1015 year
0,3,12,34,1,8,0,46,0,iraq southern oil export hit record opec cut
0,2,2,71,1,11,0,73,0,ivanka's husband reportedly tapped senior adviser trump amid nepotism concern
0,3,5,53,0,11,0,58,0,brexit bochum haunt vauxhall new battle ellesmere port
0,1,8,44,0,10,0,52,0,tam linhas area plane crash paulo airport brazil
0,1,3,36,0,7,0,39,0,travel chaos fog descends united kingdom
0,3,2,61,2,13,4,63,0,"drug slow alzheimer's disease available 2025, expert predict"
0,2,3,57,1,10,0,60,0,trump nominate former sen. coat national intelligence director
0,3,2,58,0,10,0,60,0,donald trumpcampaigner facescourt role inforeign donor scandal
0,1,4,39,1,7,0,43,0,northern ireland's ian paisley resign retire
0,2,4,65,1,10,0,69,0,yosemite firefall: national park optical illusion make waterfall look like fire
0,1,8,40,3,8,0,48,0,"suspect death lebanese ex-premier, hariri, freed"
0,2,14,63,6,17,0,77,0,juelz santana dave east hit street 'time ticking' feat. bobby shmurda rowdy rebel: watch
0,1,4,52,0,9,0,56,0,youtube user get instant fame video defending britney spear
0,1,1,36,0,5,0,37,0,poland made software patent directive stop
0,1,4,35,3,8,2,39,0,"paul winchell, voice tigger, gargamel, dead 82"
0,1,2,78,0,13,0,80,0,general oversaw military tribunal guantanamo investigated abuse power
0,2,9,43,2,11,5,52,0,"katy perry, maroon 5, niall horan headline 2017 wango tango concert"
0,1,6,32,0,8,0,38,0,artist defies web censor rebuke china
0,2,11,44,0,10,0,55,0,stephen colbert say moby credible kellyanne conway
0,3,6,18,4,6,0,24,0,"dylan, polite? aint him, babe"
0,2,14,36,3,12,4,50,0,irs 'dirty dozen' tax scam 2017 include id theft bogus refund
0,1,2,41,1,6,0,43,0,u government shutdown averted last-minute deal
0,3,8,40,1,8,0,48,0,trump tough trade talk could damage american factory
0,2,3,83,2,17,2,86,0,time! google launch two flagship smartwatches early next year android 2.0 running show
0,3,9,46,2,10,0,55,0,"fidel castro's ash interred cuba, ending nine day mourning"
0,3,2,46,0,8,0,48,0,tillerson cross border rebuild tie mexico
0,1,3,52,2,8,0,55,0,"matthew edwards, honored michigan police officer, shot killed"
0,1,1,54,3,7,0,55,0,japan's lunar probe performing 'smoothly' successful launch
0,2,8,43,1,8,0,51,0,russian biggest steelmaker bet e-commerce boost sale
0,3,11,50,1,9,0,61,0,director ava duvernay's oscar dress sends powerful political message
0,2,5,45,4,8,0,50,0,twenty-five million reason u.s. hasnt struck north korea
0,2,15,46,2,14,0,61,0,"ryan gosling wore ruffled shirt oscar honestly, im forit"
0,1,2,44,1,7,0,46,0,"british columbia could get earthquake, survey warns"
0,1,3,42,0,8,0,45,0,google sued thousand author google print
0,3,8,43,3,9,2,51,0,toshiba expects $6.3 billion write-down loss nuclear unit
0,3,7,39,4,10,2,46,0,prince's palace toronto go market $13m [video]
0,2,3,53,4,10,3,56,0,google pledge $11.5 million racial justice innovator across u.s.
0,2,5,35,2,8,0,40,0,russian oil giant rosneft could claim u.s. oil
0,2,1,51,1,9,0,52,0,mont. police say aware planned white supremacist march
0,2,15,63,4,14,0,78,0,"ranbir-saif impress kareena karisma culinary skills, turn chef family dinner!"
0,3,2,17,4,4,0,19,0,"hey, hey, monkees!"
0,2,6,29,1,5,0,35,0,selena gomez style: fashion evolution
0,2,3,57,1,12,3,60,0,"right gave up, investigator figured look mh370"
0,3,10,48,5,10,0,58,0,"'beauty beast' review: beautiful times, still second-beast"
0,3,2,62,0,10,0,64,0,sacramento uber driver credited saving teen girl sex trafficking
0,1,4,39,0,5,0,43,0,discovery dock international space station
0,3,4,86,3,15,0,90,0,king sweden stress need serious medium source checking donald trump immigration claim
0,1,6,28,2,6,0,34,0,bush nominates alito u.s. supreme court
0,2,5,53,6,16,0,58,0,todd solondz: may line shouldnt cross dont know
0,1,7,56,0,9,0,63,0,vladimir putin dismisses head russian navy admiral vladimir kuroyedov
0,3,4,21,1,4,2,25,0,60 minute presents: behind bar
0,2,7,39,1,6,0,46,0,witnesses: gunshot explosion philippine mall
0,2,8,36,0,7,0,44,0,amazon officially made first drone delivery
0,2,16,60,1,15,0,76,0,america russia loggerhead that's real threat global security
0,3,8,39,0,7,0,47,0,latest acquisition target indie beauty brand
0,3,3,47,0,8,0,50,0,teenager break world record crushing block head
0,2,13,44,1,14,0,57,0,"bernie sander podcast now, feel bern year long"
0,1,7,24,1,6,0,31,0,"though many stalked, report"
0,1,5,51,0,8,0,56,0,rocket carrying nasa carbon dioxide satellite crash ocean
0,3,14,70,3,15,4,84,0,ivanka trump say good friend chelsea clinton havent spoken since blistering 2016 campaign
0,2,11,66,3,12,0,77,0,"christopher steele, ex-british intelligence officer, said prepared dossier trump"
0,3,2,55,0,11,0,57,0,marine vet speaks viral video supporting trump travel ban
0,3,4,46,1,7,0,50,0,"mark zuckerberg, priscilla chan expecting second baby girl"
0,1,7,51,1,9,0,58,0,"wikinews interview mike lebowitz, chairman modern whig party"
0,2,1,71,2,14,0,72,0,"majority parent child home lock prescribed opioids, study find"
0,3,5,39,2,9,3,44,0,owner vote 31-1 ok raider move; dolphin vote
0,1,4,30,0,5,0,34,0,u senate block alaska refuge drilling
0,3,5,49,0,8,0,54,0,donnelly becomes third senate democrat support neil gorsuch
0,3,5,45,7,10,0,50,0,trump say snl unwatchable. cant stop watching?
0,1,4,52,0,12,0,56,0,turkey set price lift ban youtube google service
0,3,2,20,0,5,2,22,0,charlie murphy died 57
0,2,3,42,0,9,0,45,0,humpback whale dying alarming rate east coast
0,1,2,28,0,4,0,30,0,american tourist killed beijing
0,1,1,42,0,7,0,43,0,texas wildfire push public resource limit
0,2,4,61,0,12,0,65,0,high school student tell betsy devos exactly policy would hurt
0,2,4,41,1,6,0,45,0,warrior circle saturday kevin durant's comeback
0,1,5,30,0,7,2,35,0,46 die taliban attack pakistani troop
0,3,2,66,1,11,0,68,0,government offer five-day crash course refugee expect australia
0,3,9,48,1,11,0,57,0,"charm trump, paul manafort sold affordable outsider"
0,3,12,50,2,11,0,62,0,swede disliked donald trump even 'last night sweden' remark
0,3,10,37,0,10,2,47,0,duterte say 50 time brutal terrorist
0,3,8,43,0,7,0,51,0,eric trump offer surprisingly candid thought nepotism
0,3,2,59,1,10,0,61,0,"syrian government troops, allied militiaman seize ground aleppo"
0,1,5,50,1,10,0,55,0,next shuttle flight delayed next year; iss crew begin spacewalk
0,1,5,23,0,6,0,28,0,palin sign deal write memoir
0,2,3,59,1,8,0,62,0,texas pool party incident expose mckinney's housing segregation battle
0,3,8,45,1,8,0,53,0,trump trade pick pursue stronger relationship taiwan
0,3,3,61,0,9,0,64,0,trump official monica crowley accused numerous instance plagiarism
0,3,15,57,6,15,2,72,0,"india's 'billionaire barber' add another car garage, r 3.2 crore mercedes time!"
0,2,7,24,2,6,0,31,0,rex tillersons world: word
0,1,3,49,4,6,0,52,0,"twelve-year-old schoolboy stabbed, dy brisbane, australia"
0,3,10,43,0,9,0,53,0,mike penny ignored lead contamination crisis backyard
0,3,3,9,0,3,0,12,0,keep moving
0,1,1,40,0,8,2,41,0,54 killed suicide bomber musayyib gas station
0,1,3,48,0,9,0,51,0,oxford use online voting professor poetry election
0,3,1,60,2,8,0,61,0,victoria's threatened tiger quolls prove camera-shy conservation bid
0,1,3,33,1,6,0,36,0,"vesta plant newport, england shuts"
0,2,6,57,1,11,0,63,0,"fallen navy seal get posthumous promotion, recalled devoted family man"
0,2,12,36,0,10,0,48,0,maker epipen sell generic version half price
0,2,6,74,4,15,0,80,0,russia expert: new u sanction 'clearly meant throw wrench into' trump's dealing moscow
0,1,2,27,0,3,0,29,0,fiji suspended commonwealth
0,3,10,40,2,8,0,50,0,george h.w. bush released latest houston hospital stay
0,1,3,33,0,6,0,36,0,israel begin ground assault gaza strip
0,1,1,23,0,3,0,24,0,global stock market plunge
0,2,4,45,1,6,0,49,0,protester storm nyu conservative speakersseminar
0,3,3,43,1,9,0,46,0,graham: never satisfied punish russia
0,3,10,35,1,8,0,45,0,dmx cancel several show due medical issue: report
0,2,9,41,2,11,0,50,0,watch ed sheeran love shape 'saturday night live'
0,2,12,37,0,11,0,49,0,good bill cosby good black america
0,2,3,49,1,10,0,52,0,let start telling truth supreme court
0,2,1,39,0,6,0,40,0,polish lawmaker occupy parliament protest
0,3,11,63,4,13,0,74,0,priebus: unverified report trump's alleged tie russia 'complete garbage' insider
0,1,10,33,4,8,0,43,0,"f.d.a. lax oversight trials, inquiry find"
0,2,10,30,0,8,0,40,0,black tech founder try woo investor sxsw
0,1,5,28,1,6,0,33,0,"bomb scare close time square, new york"
0,3,3,55,1,8,0,58,0,democrat invite immigrant trump's upcoming address congress
0,3,9,34,0,9,0,43,0,mile high club come drink dinner
0,2,3,43,0,8,0,46,0,meet woman allegedly slept sheldonsilver
0,1,8,39,0,8,0,47,0,report say principal put dallas student fight cage
0,2,19,42,6,15,0,61,0,"ray dalio trump: 'if havent read ayn rand lately, suggest do'"
0,1,7,22,1,4,0,29,0,ericsson's ceo tour marconi site
0,1,5,39,0,10,2,44,0,north korean military leader jo myong rok dy age 82
0,1,6,31,1,7,0,37,0,"wink dunks, player stump vote"
0,1,6,26,0,5,0,32,0,dixie chick show documentary tiff
0,2,2,28,0,6,0,30,0,tear gas fired peru toll booth
0,1,2,45,1,7,0,47,0,"north carolina terrorist ring broken up, seven arrested"
0,2,9,40,1,8,0,49,0,"deutsche borse, lse address antitrust concern"
0,3,4,57,2,8,0,61,0,syria: al qaeda-linked group claim responsibility damascus attack
0,2,9,41,4,8,2,50,0,u.k. reject 1.8 million-signature petition seeking ban trump
0,1,8,39,0,9,1,47,0,british court find 3 guilty aiding london bomber
0,3,6,63,4,17,0,69,0,ryan gosling la la land: 'the world quick shame trying' video interview
0,2,12,29,1,11,2,41,0,16 cheat sheet foodie also lazy af
0,1,1,40,1,10,6,41,0,armed conflict world 40% since early 1990s
0,2,11,48,3,9,2,59,0,"11-year-old chicago shooting victim dies, toddler gunned hour later"
0,1,4,31,0,5,0,35,0,joseph de veuster voted greatest belgian
0,3,1,47,1,8,0,48,0,dwelling problem could harm mother-child bonding
0,1,2,28,0,4,0,30,0,satellite radio approved canada
0,1,3,19,1,3,0,22,0,meddling good business?
0,2,3,39,0,7,0,42,0,trump demand obama promise pardon clinton
0,3,3,47,0,9,1,50,0,donald trump 2nd president laud unfinished intel plant
0,3,5,48,2,10,0,53,0,sadiq khan tell labour 'faff around' ken livingstone
0,3,9,58,1,10,1,67,0,brown draft rumors: cleveland considering mitch trubisky 1st overall pick
0,2,12,39,0,10,0,51,0,bob costa slam espn caitlyn jenner espy courage award
0,2,7,44,0,9,0,51,0,cbi cut uk growth forecast warning eu uncertainty
0,3,5,48,2,12,0,53,0,"military strike north korea may option, gen. keane say"
0,3,4,33,3,7,1,37,0,politics live readers' edition: friday 7 april
0,2,1,64,0,12,0,65,0,canada immediate plan deter people crossing border illegally
0,2,3,53,0,9,0,56,0,u military launch investigation strike near mosque syria
0,3,1,70,6,13,7,71,0,"australian anti-drug police seize 1,100kg cocaine worth 212m country's 'biggest ever' bust"
0,2,3,60,2,11,0,63,0,"trump move privatize america national parks, visitor cost may rise"
0,3,10,40,0,11,0,50,0,tesla top gm market value investor see musk future
0,3,7,34,0,7,2,41,0,eric church cancel 25k ticket bought scalper
0,1,7,38,1,8,0,45,0,"one moran help another, race virginia governor"
0,2,3,59,5,13,3,62,0,conway 'hannity': trump 'great record accomplishments' first 100 day
0,1,7,23,0,6,0,30,0,joe mcelderry win uk x factor final
0,1,8,46,0,8,0,54,0,south korea heightens military readiness north scrap pact
0,1,3,48,0,8,0,51,0,stock exchange merger could end san francisco stock trading
0,3,4,68,2,12,0,72,0,"secret national theatre: actor keeling over, ego clash backstage gossip"
0,1,2,48,0,9,2,50,0,microsoft release patch 64 security flaw tuesday
0,2,1,82,2,13,0,83,0,virginia lawmaker proposes bathroom bill restrict public bathroom use transgender people
0,1,3,40,0,7,0,43,0,space shuttle atlantis launch final time
0,1,4,29,0,3,0,33,0,afghan presidential election delayed
0,1,2,45,0,8,0,47,0,freshwater lake texas show sign extreme drought
0,3,2,12,0,1,0,14,0,patrice motsepe
0,3,2,38,1,6,0,40,0,world's fifth tallest skyscraper open seoul
0,1,4,35,1,7,0,39,0,mcdonald's pull sliced tomato menu u
0,1,4,9,2,3,0,13,0,john m. spratt jr.
0,1,4,29,0,6,0,33,0,nasa solar sail pass first major test
0,2,3,44,2,5,0,47,0,ex-player darryl hamilton dy apparent murder-suicide
0,2,1,51,5,9,0,52,0,flight attendant can't 'think straight' 'toxic fumes' leak
0,3,17,61,4,15,2,78,0,"meet jodie underhill, 40-year-old fighting losing battle garbage india!"
0,2,2,60,0,12,0,62,0,bishop guildford say victim barrister accused child abuse
0,2,1,23,0,3,0,24,0,amazon crushed earnings
0,2,9,51,0,9,0,60,0,wildfire near boulder force thousand coloradan home
0,2,5,23,1,6,0,28,0,drake grammy award
0,2,5,47,1,12,1,52,0,cleveland brown punter andy lee wear no. 8 honor late child
0,1,5,17,3,7,4,22,0,"abc's ""alias"" end run may 2006"
0,3,18,58,1,15,0,76,0,"karnataka girl pursue mba dream, thanks prime minister narendra modi"
0,2,13,46,0,12,0,59,0,people norway trying give finland mountain itsbirthday
0,2,1,56,1,13,0,57,0,world's advanced sex doll soon able talk think
0,1,1,43,0,6,0,44,0,australian murder victim killed different way
0,3,1,89,0,13,0,90,0,facebook launch artificial intelligence technology identify user showing sign suicide
0,2,15,57,4,16,0,72,0,clint fraziers lush locks: yankee let hair down? new york time
0,3,4,55,1,15,0,59,0,"duke, grayson allen loved ever bumpy season taking"
0,1,5,29,0,5,0,34,0,iraqi goalie killed victory shooting
0,1,7,39,0,7,0,46,0,castor pollux win madoff trading business auction
0,2,2,50,1,11,4,52,0,"digital wall aim protest trump 1,926 mile immigrant art"
0,2,2,43,1,7,0,45,0,allegation racism sessions: closer look
0,2,3,58,2,12,0,61,0,brighton long march end chris hughtons completion job well done
0,3,4,48,3,7,0,52,0,'mishandled' red sox-orioles situation far resolved
0,1,7,35,1,7,0,42,0,"many firsts, judge talent persuasion"
0,3,5,48,1,9,0,53,0,people fuming donald trump's comment john lewis
0,2,3,63,2,11,0,66,0,democracy requires trust. trump making u conspiracy theorists.
0,2,4,47,1,9,0,51,0,watch ups employee surprise teenage co-worker new car
0,2,1,56,1,10,0,57,0,"older people living alone, daily automated call mean safety"
0,1,7,35,0,9,0,42,0,columbia move game behind first place ivy
0,2,8,43,1,9,0,51,0,anne frank who? museum combat ignorance holocaust
0,3,5,52,3,12,0,57,0,new sainsburys advert: making dinner look like la la land?
0,1,3,47,1,6,0,50,0,"kangaroo knock jogger unconscious canberra, australia"
0,2,11,46,1,9,0,57,0,"older viewer conservative watching less nfl, survey find"
0,3,13,38,2,11,0,51,0,ever hear funko? plan billion-dollar toy company
0,1,5,58,0,9,0,63,0,glenbard east defeated benet academy illinois basketball sectional
0,2,8,27,3,7,0,35,0,new wave anti-semitic threat rattle u.s.
0,2,5,50,1,12,0,55,0,"cia director warns trump watch says, careful russia"
0,1,1,38,0,7,0,39,0,iraqi based war video game pulled publisher
0,2,4,31,0,7,0,35,0,apple pay uk launch could come summer
0,2,9,59,2,11,0,68,0,watch: university virginia student sign petition ban christmas breitbart
0,1,5,29,2,7,3,34,0,daimler post $1.7 billion loss 1st quarter
0,2,15,55,2,13,0,70,0,"anupam kher creates website help lonely depressed people, share e-mail id"
0,2,11,63,6,12,0,74,0,"report: hillary clinton email contained operational info, put life risk breitbart"
0,3,9,36,4,6,4,45,0,nfl combine 2017: matt miller's position-by-position primer
0,2,1,47,3,9,0,48,0,judge's warning drunk woman 'will stop reporting rape'
0,1,2,32,2,7,0,34,0,uk woman convicted 'mercy' murder son
0,1,7,43,1,5,0,50,0,princeton go international starcraft e-competition
0,1,5,30,1,6,0,35,0,stimulus financial advice?
0,2,12,27,1,9,0,39,0,might seen lebron james penis ontv
0,1,5,28,0,7,0,33,0,economy intrudes faith
0,1,8,31,0,8,0,39,0,brand name live store closed
0,3,16,56,1,14,0,72,0,gay dad write moving thank letter airline supporting same-sex marriage
0,2,5,62,2,11,0,67,0,"finally, draft obamacare repeal emerges. would defund planned parenthood"
0,3,11,42,3,9,3,53,0,6 seriously injured 14-year-old crash suv florida: police
0,3,11,35,2,7,4,46,0,sapvoice: idc 2017 predictions: birth augmented humanity
0,3,4,43,2,11,0,47,0,muppet autism welcomed soon 'sesame street'
0,2,4,40,1,7,0,44,0,aleppo syria: global show solidarity aleppo
0,3,13,56,0,12,0,69,0,undocumented student posted viral tax form selfie asks trump receipt
0,1,2,25,1,5,2,27,0,jamaica: violence kill least 30
0,1,2,37,0,6,0,39,0,sailor freed captured nigeria
0,1,3,35,1,6,0,38,0,london bombing: police search house leeds
0,1,7,37,0,7,0,44,0,iranian president asks court reconsider spy case
0,2,2,37,1,9,6,39,0,"33 startup watch 2017, according vc investor"
0,3,2,37,1,6,0,39,0,norway: explosive device found central oslo
0,2,12,61,3,10,0,73,0,devin nunes replacement arent exactly eager investigate trump-russia tie either
0,1,2,41,0,8,0,43,0,un summit result pledge mitigate food crisis
0,3,2,63,3,13,0,65,0,wont know whats republican health-care repeal plan pas
0,2,5,36,0,6,0,41,0,dallas star brilliantly troll donald trump
0,2,2,48,1,6,0,50,0,australia parliament: second dramatic protest asylum
0,1,6,43,0,8,0,49,0,florida governor jeb bush give speech hurricane wilma
0,2,8,45,1,8,0,53,0,pentagon seek avert low-ball bid development contract
0,1,6,33,0,6,0,39,0,customer give cellphone contract
0,2,11,37,0,10,0,48,0,wanda sykes get right point donald trump dis
0,1,1,21,0,3,0,22,0,jihadis still work online
0,2,12,41,1,10,0,53,0,russia uk embassy mock obama new sanction duck meme
0,2,10,55,1,13,0,65,0,"scandal roils south korea, finger point mixing politics business"
0,3,2,63,1,11,0,65,0,"gunman opened fire dallas police headquarters dead, authority say"
0,2,3,66,2,14,0,69,0,one charge america nuclear arsenal trump take office
0,2,1,44,1,9,0,45,0,economic growth job quantity andquality
0,2,9,36,1,8,0,45,0,identify major global city space?
0,1,4,39,1,8,0,43,0,"sea lion take dock moss landing, california"
0,2,8,33,4,10,2,41,0,"erin moran, played joanie happy days, dead 56"
0,1,2,47,1,6,0,49,0,pakistan's military claim capture taliban stronghold
0,1,2,27,0,4,0,29,0,barry bond guilty obstruction
0,1,2,45,0,8,0,47,0,four killed militant attack karachi military base
0,2,0,39,2,10,6,39,0,"1 4 worker less $1,000 saved retirement"
0,2,10,38,4,10,0,48,0,donald trump first six day office: here he done
0,2,5,44,2,7,0,49,0,nfl playoff picture: giant delay cowboys' clinching party
0,1,2,42,0,6,0,44,0,russia agrees construct turkish nuclear reactor
0,1,3,37,2,7,0,40,0,news world: new document suggests cover-up
0,3,11,49,0,9,0,60,0,former dnc chair endorses underdog candidate party leadership race
0,3,4,57,1,12,0,61,0,"driver shot arizona officer u illegally, investigator say"
0,1,4,32,0,7,0,36,0,tropical storm erin form gulf mexico
0,1,1,42,0,4,0,43,0,blogger investigate social networking website
0,3,7,43,4,9,0,50,0,trump name lt. gen. h.r. mcmaster national security adviser
0,3,14,40,5,14,3,54,0,solar energy created 1 50 new u.s. jobs. bracing trump cuts.
0,1,8,49,0,11,0,57,0,bernie ecclestone state formula one hard economic time
0,1,8,39,0,8,0,47,0,suit say medical firm urged unapproved use device
0,3,3,62,0,11,0,65,0,man completes london marathon gorilla suit fund great ape conservation
0,1,2,40,0,6,0,42,0,suicide bomber kill three people afghanistan
0,1,8,31,1,7,0,39,0,"violence may hinder talk iran, obama say"
0,1,5,20,0,6,3,25,0,quake death toll top 280 italy
0,2,8,35,4,7,0,43,0,mcmaster say north korea behavior cant continue
0,3,0,63,1,14,2,63,0,"9 habit highly successful people, man spent 5 year studying"
0,2,3,42,1,6,0,45,0,jerusalem lorry attack: four israeli soldier killed
0,3,3,37,1,5,0,40,0,rory cellan-jones becomes video game character
0,1,8,50,4,9,0,58,0,"vesta cowes rooftop occupiers: ""save environment, scuttle nimby"""
0,1,4,16,1,4,0,20,0,"madoff, court trust"
0,2,2,85,1,12,0,87,0,two member trump's cabinet reportedly sparred bathroom protection transgender student
0,2,11,53,1,8,0,64,0,fifa scandal: argentinian businessman alejandro burzaco arrested italy
0,3,7,58,3,12,2,65,0,ec block london stock exchange's 22bn merger deutsche brse business live
0,3,4,54,3,16,2,58,0,"game over! beat 10% rise cost tv, phone broadband"
0,3,5,52,1,12,2,57,0,"birth defect risk 20 time higher pregnant woman zika, say cdc"
0,1,1,35,0,7,2,36,0,72 hour australia wide ban horse movement
0,3,8,36,0,9,0,44,0,great nevada lithium rush fuel new economy
0,2,11,62,0,10,0,73,0,white house defends executive order barring traveler certain muslim country
0,3,3,61,2,10,0,64,0,business display racist window sign muslim 'obama toilet paper'
0,2,11,44,1,10,0,55,0,trump exactly said would: dehumanizing muslim
0,1,8,65,1,10,0,73,0,singapore slinger defeat darwin all-stars eighth singapore challenge series game
0,2,13,52,0,12,0,65,0,flight ticket delhi set become significantly cheaper
0,2,12,52,1,12,0,64,0,al west rival mariner a's trade shot spring training twitter battle
0,3,1,59,1,8,0,60,0,"scottish independence support highest ever levels, survey suggests"
0,1,8,30,4,7,0,38,0,"mrs. john l. strong, luxury stationer, closing"
0,1,4,10,0,3,0,14,0,duke upset fsu
0,1,6,38,0,9,1,44,0,7 die police militant clash southern russia
0,1,4,35,2,5,0,39,0,u.s. hurricane center director leaf position
0,2,11,42,5,14,2,53,0,"game throne season 6, episode 7: never late new york time"
0,3,8,55,3,10,0,63,0,"marvin wilson settle national signing day second thoughts, commits fsu"
0,2,2,68,3,12,0,70,0,"emirate airline change pilots, crew, passenger roster trump's order"
0,3,13,52,1,11,0,65,0,self-made woman breaking billionaire glass ceiling five chart
0,1,2,35,0,5,0,37,0,troop southern thailand trouble
0,2,13,36,1,10,4,49,0,top 2017 emerging emea pick thing russia; avoid turkey
0,1,8,35,0,7,0,43,0,sony install digital projector amc theater
0,1,4,63,0,9,0,67,0,abductor american journalist jill carroll release videotape demand
0,3,3,39,0,8,0,42,0,donald trump lash union leader twitter
0,1,5,55,0,10,0,60,0,bone marrow transplant potentially linked cure patient aid
0,2,8,40,0,10,0,48,0,fidel castro laid rest private ceremony east cuba
0,3,12,36,0,9,0,48,0,trump nominates fda head deep tie drug company
0,2,4,45,1,7,0,49,0,faa ground trump campaign jet expiredregistration
0,3,6,28,3,6,0,34,0,daily: french election explained
0,2,3,51,3,12,0,54,0,power rankings: warrior jump top spot -- real work begin
0,3,8,35,1,8,2,43,0,18 reason jess mariano still rorys best boyfriend
0,2,6,57,4,11,2,63,0,"5 thing friday, april 7: syria strikes, supreme court, russia investigation"
0,1,6,24,0,5,4,30,0,casey stoner win 2011 catalunya motogp
0,3,8,43,1,8,0,51,0,malik dime slap heckler washington loss vs. colorado
0,1,6,39,0,7,1,45,0,roadside bomb kill 2 marine southern afghanistan
0,3,2,41,1,5,0,43,0,belarus protests: government defends mass arrest
0,2,6,42,0,8,0,48,0,nfl player shocked saddened joe mcknight tragedy
0,2,12,50,2,11,0,62,0,reddit user revolt site ban fat people hate community
0,3,13,54,1,11,0,67,0,el chapo's nyc prison condition described horrific guantanamo bay
0,1,2,39,1,6,0,41,0,"france germany resume growth, exit recession"
0,3,12,36,1,11,0,48,0,ben mcadoo say geno smith could giants' qb future
0,1,2,39,0,5,0,41,0,south african former apartheid party dissolve
0,2,9,47,1,8,0,56,0,"trump defends immigration ban amid uncertainty, public outcry"
0,3,5,62,4,13,2,67,0,'here go again!': internet reacts government loses article 50 supreme court case
0,2,2,68,2,11,3,70,0,coffs harbour company fined $250k work experience student's finger crushed
0,3,12,45,4,11,1,57,0,"christina grimmie's family release 'side b' ep, full album coming june 2"
0,3,3,35,1,7,0,38,0,trump sign order take aim dodd-frank
0,1,7,17,3,4,0,24,0,lesnar defends u.f.c. title
0,3,10,59,4,11,0,69,0,"european union leaders, gathering without may, endorse guideline brexit talk"
0,1,4,63,1,9,0,67,0,fema accused misusing trained disaster worker public-relations worker
0,1,7,26,0,6,4,33,0,australia qualifies fifa world cup 2006
0,2,3,59,1,10,0,62,0,journalist: trump brought electoral map handout win interview
0,1,8,36,2,11,3,44,0,strike u.n. worker force 174 school close day
0,1,2,48,1,7,0,50,0,"nucaptcha introduces video captcha service, ad included"
0,1,6,58,3,9,0,64,0,"baseball: national get soriano ranger wilkerson, sledge, prospect"
0,2,9,30,2,9,0,39,0,"penny cost make worth,"
0,2,10,59,6,11,0,69,0,"madonna sings hits, fight 'rebellious' reputation 'carpool karaoke': watch"
0,3,9,45,4,8,0,54,0,elizabeth warren: donald trump's presidency 'feels like dog years'
0,1,6,40,0,7,0,46,0,historian richard milner performs humor darwin
0,2,4,84,4,16,0,88,0,'dictator maduro!': thousand venezuelan take street protest ban opposition leader
0,2,11,53,0,11,0,64,0,man charged intentionally killing bald eagle truck alaska
0,1,6,47,0,8,4,53,0,barcelona defeat manchester united 2009 champion league final
0,3,6,80,2,18,0,86,0,another ash cloud cause travel chaos? four iceland's volcano brink erupting
0,1,2,27,2,4,0,29,0,u.s. government hiring hacker
0,2,5,16,1,4,0,21,0,tiny hero save dad's life
0,3,19,57,2,19,8,76,0,"meet julia hawkins, 101yo competitive runner, took cycling 81 sprinting age 100"
0,1,5,39,1,7,0,44,0,exclusive report new zealand's digital tv service
0,2,8,51,2,11,0,59,0,history repeats: nixonian cover-up home stretch campaign
0,1,2,26,1,3,0,28,0,demosphere.net launch new wiki
0,1,8,58,1,11,0,66,0,australian jesse williams drafted fifth round nfl's seattle seahawks
0,3,14,54,3,14,0,68,0,"odell beckham, jr. amused antonio brown's awesome td catch dance"
0,3,9,57,2,13,0,66,0,bbc's nick robinson call philip hammond rude name? listen
0,3,3,59,1,12,3,62,0,colombia landslide: police say 112 people died heavy rain putumayo
0,2,10,50,1,11,0,60,0,mavis staple kennedy center honor fist-bumping james taylor
0,3,7,49,4,10,0,56,0,"great wall, matt damon hollywood delicate dance china"
0,1,3,24,0,5,0,27,0,u bomber train australia
0,3,5,56,2,10,0,61,0,trump's america donald trump's revised travel ban blocked hawaii court
0,3,13,63,2,12,0,76,0,"kanye west asked perform ""typically traditionally american"" inauguration"
0,2,12,53,7,11,0,65,0,milo ventimiglia recreates memorable u push-ups scene ellen [video]
0,1,5,24,2,8,7,29,0,2007 rugby world cup: argentina 33 3 georgia
0,3,4,41,1,11,0,45,0,sir michael caine old age: know day numbered
0,2,8,38,1,8,0,46,0,watch live: white house press briefing sean spicer
0,1,8,46,1,9,0,54,0,"invoking sputnik era, obama vow record outlay research"
0,3,6,75,1,17,0,81,0,melania trump remind donald national anthem internet can't handle list
0,2,7,27,2,8,0,34,0,'full house' creator buy home used show
0,2,17,50,1,15,4,67,0,"cbse announces new exam format schools, class x board exam return 2018"
0,2,1,38,1,7,0,39,0,diamond overpriced realproblem
0,2,12,68,3,15,4,80,0,"kelsea ballerini, alessia cara jordan fisher perform 2017 radio disney music awards: exclusive"
0,2,4,68,2,10,0,72,0,bruce highway crash: fatal four-vehicle collision close major road near maryborough
0,3,10,54,1,9,0,64,0,watch live: spacex launch resupply flight international space station
0,1,5,30,1,8,0,35,0,nhl: duck charge two game lead wild
0,3,10,40,5,8,0,50,0,u.s. officials: putin personally involved u.s. election hack
0,2,6,51,4,8,0,57,0,"bana alabed, aleppo's tweeting girl, meet turkey's president erdogan"
0,3,4,44,2,8,0,48,0,wall street: market unmoved trump's tax plan unveiling
0,3,4,78,1,11,0,82,0,top republican say special prosecutor investigate russian meddling trump election
0,3,3,40,2,7,0,43,0,iran issue threat u.s. bill renewing sanction
0,1,2,34,0,8,3,36,0,usain bolt set new world record 100m sprint
0,3,1,36,0,6,0,37,0,colombia outrage killing young girl
0,1,2,35,1,5,0,37,0,denmark blame al-qaeda embassy bombing
0,1,1,28,0,4,0,29,0,philippine brace next storm
0,2,2,51,0,10,0,53,0,islamophobia china rise fuelled online hate speech
0,2,18,60,1,16,0,78,0,"another setback kapil sharma, stand comedian accuses plagiarism long fb rant"
0,3,16,54,3,12,0,70,0,zac efron riding camel shirtless desert once-in-a-lifetime thirst moment
0,2,11,56,4,12,0,67,0,rep. phil roe: house healthcare bill giant step process replacing obamacare
0,2,13,19,1,7,4,32,0,2016 banner year hiv/aids research
0,3,6,46,4,13,2,52,0,"john newhouse, author war peace nuclear age, dy 87"
0,1,2,34,2,6,0,36,0,"libby, former cheney aide, pleads guilty"
0,2,3,80,2,13,0,83,0,grantchester star james norton criticises trend faith portrayed 'exorcisms cults'
0,3,4,18,3,3,0,22,0,france choice: le divorce?
0,3,13,42,1,12,0,55,0,democrat call doj look jared kushner's white house role
0,2,1,72,0,11,0,73,0,chinese activist launch armpit hair photo contest challenge gender stereotype
0,1,8,28,1,7,0,36,0,"golfer, wrong ball turn right move"
0,2,14,56,0,12,0,70,0,lebron james injured cut head colliding courtside cameraman
0,3,18,46,2,14,0,64,0,ibmvoice: dawn cognitive era: evolve analytics next level
0,3,7,42,0,8,0,49,0,suspect arrested murder missing ohio state student
0,2,13,32,4,9,0,45,0,kodak black claim d.r.a.m. lil yachty stole style
0,2,4,27,1,5,0,31,0,un peacekeeping working africa?
0,3,4,63,1,11,0,67,0,bryan robson say england's young player lack toughness european rival
0,2,9,53,0,9,4,62,0,kanye west reportedly suffering memory loss 2016 hospitalization
0,3,3,57,1,10,0,60,0,undocumented immigrant's fb post paying tax draw social medium ire
0,3,4,50,1,9,0,54,0,elon musk say tesla's upgraded autopilot might arrive next week
0,3,13,50,3,10,2,63,0,mike freeman's 10-point stance: kaepernick protest still nfl team worried
0,1,2,38,1,6,0,40,0,single-engine plane crash home cyprus
0,1,5,42,3,9,0,47,0,"u treasury secretary: ""we need ability seize firms"""
0,3,4,38,0,9,4,42,0,tech startup ipo candidate watch 2017
0,1,2,37,1,5,0,39,0,"richard becomes hurricane, threatens belize"
0,3,3,43,1,7,0,46,0,donald trump: tax reform next healthcare failure
0,3,9,41,1,8,0,50,0,chrissy teigen paid woman's beauty school tuition
0,3,13,53,1,13,0,66,0,myles garrett's mom asks warren sapp still relevant criticism son
0,2,2,61,1,15,2,63,0,could be? mystery skeleton 5ft 7in man found dangerous desert
0,1,6,30,0,8,0,36,0,iraqi woman vie vote taste power
0,2,1,48,1,7,0,49,0,manafort-linked lobbying firm register foreign agent
0,3,4,40,1,8,0,44,0,european capital ramp security new year's eve
0,1,9,46,1,11,0,55,0,"arctic soil, fossil goliath ruled jurassic sea"
0,1,4,31,0,4,0,35,0,griffin oklahoma overpower michigan
0,3,10,28,1,8,2,38,0,cftc chairman timothy massad step jan. 20
0,3,3,46,1,8,2,49,0,trump associate play twitter contact guccifer 2.0
0,2,14,59,3,12,0,73,0,"yadavs #pariwar, youngest show lamborghini huracan instagram!"
0,1,4,45,0,9,0,49,0,south korean police clamp protest u beef
0,2,6,77,2,16,0,83,0,"thing labour blamed copeland by-election loss on, jeremy corbyn list"
0,1,10,43,0,9,0,53,0,congolese rebel leader seemed untouchable caught
0,3,4,44,2,9,0,48,0,"actor dev patel spent eight month preparing ""lion"""
0,3,3,53,0,10,4,56,0,scarlett johansson top forbes list highest grossing actor 2016
0,2,8,31,2,8,0,39,0,many way buy american harm economy
0,2,15,61,3,14,0,76,0,photo harbhajan singh's toddler bonding jonty rhodes' daughter cute!
0,3,6,71,8,14,1,77,0,"enzos kitchen, london sw1: rocket knackered, basically compost restaurant review"
0,1,9,28,2,7,0,37,0,"britain, web medium law playing catch-up"
0,2,10,47,1,10,4,57,0,love parade tragedy: german court order trial 2010 festival death
0,3,14,55,0,14,0,69,0,steve kerr say stephen curry finally figured play kevin durant
0,1,1,53,1,9,0,54,0,"canadian jail inmate used nail clipper escape, report find"
0,1,2,50,1,6,0,52,0,amnesty report's criticism rejected bush administration
0,1,4,65,3,11,0,69,0,"somali piracy: kenyan navy kill three, chinese ship hijacked, british couple freed"
0,3,8,45,1,9,0,53,0,"pepsi pull ad featuring police, protester kendall jenner"
0,3,2,57,3,10,0,59,0,easter celebrations: christian leader call peace 'world pain'
0,2,8,37,1,8,0,45,0,penn state ex-officials plead guilty sandusky case
0,3,2,47,0,6,0,49,0,tornado rip mississippi killing several people
0,1,6,35,1,6,0,41,0,"humbled collapse, london ponders identity"
0,1,6,31,4,5,4,37,0,"2008 computex preview: wimax, threat? opportunity?"
0,1,6,34,0,6,0,40,0,morehead state gain berth louisville
0,2,4,68,1,15,0,72,0,"britain heading hardest hard brexits, theresa may limit damage"
0,2,7,76,6,14,0,83,0,"ko ni: murder suu kyi's political advisor intended 'destabilise' myanmar, president's office say"
0,2,20,46,2,14,2,66,0,"amd acquires ip acquihires nitero team, maker 60 ghz wireless chip vr/ar"
0,2,7,27,1,8,0,34,0,art market recovering? london may tell
0,3,1,51,0,6,0,52,0,australia considers childcare ban unvaccinated child
0,1,3,28,1,5,0,31,0,"eu, microsoft agree browser ballot"
0,3,12,59,0,11,0,71,0,first round french presidential election marked political earthquake
0,2,4,73,1,11,0,77,0,sexual harassment allegation emerge sterling jeweler pay discrimination case yahoo
0,3,3,68,0,9,0,71,0,professor perfectly illustrates difference american british academic
0,2,16,54,2,17,0,70,0,fateful flight prince: protge tell story new york time
0,3,18,57,1,17,0,75,0,need stand national anthem played film's storyline say supreme court
0,2,3,55,0,6,0,58,0,oddity wannacry ransomware puzzle cybersecurity researcher
0,2,4,75,5,16,0,79,0,"shouldnt keep saying sorry: london attack, muslim react fear anger"
0,3,11,49,4,14,0,60,0,ariana grande cashmere cat teamed third time: listen 'quit'
0,2,5,34,2,7,0,39,0,obama head nato summit inflection point
0,2,14,60,3,15,0,74,0,tom brady spent april fools' trolling 'fake news' headline claiming lost super bowl
0,1,7,34,2,10,0,41,0,"bob barker retires u host ""the price right"""
0,1,1,42,0,8,4,43,0,suspect 2001 anthrax attack dy apparent suicide
0,1,6,41,0,9,0,47,0,porsche introduces luxury sedan chinese market
0,2,7,34,1,10,2,41,0,listen episode 2 frank ocean's beat 1 show live
0,2,5,72,2,13,0,77,0,syria conflict: donald trump's statement u missile strike response chemical attack
0,1,5,32,0,6,0,37,0,sotomayor selection creates puff pride
0,3,14,72,5,16,0,86,0,"rick ross, jidenna desiigner think snoop dogg apologize donald trump 'lavender' video"
0,2,2,49,4,8,0,51,0,"lighthouse cuban migrant climbed isnt dry land, judge rule"
0,1,6,27,0,6,0,33,0,death penalty repealed new mexico
0,1,2,35,0,6,0,37,0,israeli navy fire gazan fishing vessel
0,3,9,45,1,7,0,54,0,trump-merkel meeting test odd couple leading western alliance
0,1,4,19,0,3,0,23,0,iraq bombing shatter lull
0,1,2,41,2,6,5,43,0,"tropical storm hit philippines, 45,000 people displaced"
0,2,4,39,2,8,0,43,0,"trinidad james, ben ferguson clash use n-word"
0,1,2,65,2,9,0,67,0,"air france, pilot union, victim group criticise transatlantic disaster probe"
0,2,22,69,1,19,0,91,0,"disabled daughter stripped molested villager front eyes, nri vow never come back india"
0,1,8,29,3,6,0,37,0,former i.m.f. chief see opportunity crisis
0,3,8,29,0,8,0,37,0,le pen aide fired holocaust comment
0,1,6,36,0,6,0,42,0,gunman kill iraqi cleric campaigning council
0,3,6,45,1,9,0,51,0,"bone bruise, mcl sprain keep kevin durant indefinitely"
0,1,9,49,2,11,0,58,0,"mexican tourism, already hurt violence, bear blow health scare"
0,2,3,73,5,11,0,76,0,manhunt intensifies dangerous desperate trio escape southern calif. jail
0,1,4,39,1,5,0,43,0,"intel acquires mobile linux developer, openedhand"
0,2,3,60,3,11,0,63,0,sainsbury's selling same-sex valentine's day card first time ever
0,1,5,30,1,8,0,35,0,"dance party broken police utah, usa"
0,1,1,53,2,6,3,54,0,document regarding post-9/11 prisoner transport flight released
0,2,10,42,2,8,1,52,0,"nba announces 2k eleague: latest details, comment reaction"
0,1,2,29,0,4,4,31,0,australian 1976 cabinet paper released
0,1,3,46,1,7,0,49,0,officer dy accident president bush's motorcade
0,2,10,40,3,8,0,50,0,someone created jam-filled sausage called thedausage
0,3,2,50,0,8,0,52,0,deadly ice storm creates treacherous condition midwest
0,3,6,64,1,13,0,70,0,andy murray crash australian open shock four-set defeat mischa zverev
0,3,8,55,1,8,0,63,0,jazz reportedly interested re-acquiring deron williams maverick
0,2,12,45,1,9,0,57,0,migos offset blast xxxtentacion claiming drake stole flow
0,1,2,40,1,5,1,42,0,scientist create micro-battery using 3d printing
0,3,14,48,0,13,0,62,0,sarah paulson like carry little piece marcia clark around
0,1,2,27,0,5,0,29,0,score killed flooding yemen
0,2,4,54,2,9,0,58,0,syria chemical attack: andrew wilkie question assad's role strike
0,2,9,55,2,11,0,64,0,"organization urge teachers, student skip school protest trump insider"
0,2,3,42,2,8,2,45,0,u.s. immigration arrest nearly 40 percent trump
0,2,11,31,4,9,0,42,0,u.s. baby social kid [video]
0,1,8,43,0,9,0,51,0,struggling rise suburb failing mean fitting
0,2,4,35,1,10,4,39,0,report: aging new york nuclear plant close 2021
0,2,6,45,4,11,1,51,0,"1st time since cold war, u.s. tank roll russia's backyard"
0,3,4,34,1,8,1,38,0,star trek: deep space 9 documentary work
0,2,2,45,1,9,0,47,0,"amid swirling sand sahara, music revolution"
0,3,11,30,4,10,0,41,0,jamie dimon bullish u.s. economy here's
0,3,3,39,1,6,0,42,0,oscar surprises: amy adam missing among nominee
0,3,12,60,1,11,0,72,0,"milwaukee buck spotlight spotlight, giannis antetokounmpo nba superstar"
0,2,4,40,5,7,0,44,0,aarp isnt expanding staff theyre reorganizing
0,3,11,47,4,12,0,58,0,michelle obama watch donald trump win election: 'i went bed'
0,2,3,22,0,5,4,25,0,jimmy kimmel host 2017 oscar
0,3,3,40,3,6,0,43,0,miami's little havana declared 'national treasure'
0,2,2,31,0,5,0,33,0,trump sends mixed signal obamacare
0,1,7,35,1,6,0,42,0,self-ruled region remains wary russian backer
0,2,7,46,1,13,3,53,0,super pac backing jeb bush unlikely hit $100 million end june
0,3,3,81,6,17,2,84,0,"'can biscuits, please?' asks six-year-old italian girl pulled avalanche rubble 48 hour"
0,1,3,35,2,8,1,38,0,rapper 'little kim' sentenced 1 year prison
0,3,8,39,0,9,3,47,0,airbus may shrink staircase add seat a380 superjumbo
0,1,6,38,0,6,0,44,0,blockbuster report loss restructures debt
0,3,11,46,0,10,0,57,0,kareena kapoor khan get candid baby taimur like never
0,3,1,56,1,8,0,57,0,"consumer law breach attract larger fines, review suggests"
0,3,8,43,0,8,0,51,0,kanye west officially wipe twitter trump reference
0,2,1,60,1,11,0,61,0,"germany ax attack train station leaf five injured, suspect arrested"
0,1,1,31,0,3,0,32,0,copenhagen climate conference open
0,1,4,23,0,5,2,27,0,somalia fighting kill least 15
0,3,15,63,1,14,0,78,0,"shilpa, sameksha singh also accuses bhabi ji ghar par hai producer abusive behaviour"
0,2,1,51,3,7,2,52,0,"california fault capable magnitude-7.4 earthquake, study say"
0,2,4,47,1,8,0,51,0,melania trump wear sky-blue cashmere ralph lauren ensemble
0,2,4,73,2,11,0,77,0,anthony bourdain bash fellow privileged eastern liberal making trump win possible
0,3,9,53,1,10,0,62,0,"instagram good people insecurity depression, say study"
0,2,2,83,1,12,0,85,0,session wont testify congressional budget hearing senate intelligence hearing instead
0,1,9,47,1,8,0,56,0,mets yankee season-ticket holder second thought
0,2,8,23,2,8,0,31,0,man ran mount everest twice!
0,1,7,29,1,7,0,36,0,"near end, ozark still spinning tale"
0,1,2,27,0,2,0,29,0,remembering srebrenice massacre
0,1,9,32,3,8,0,41,0,i.b.m. look sell big business cloud computing
0,2,1,23,0,5,0,24,0,mind reading veryreal
0,3,10,51,2,11,0,61,0,neil patrick harris challenge james corden broadway riff [video]
0,1,7,24,2,6,0,31,0,obama would move detainee u.s.
0,2,4,46,4,10,5,50,0,8 time 'westworld' tv show referenced 1973 'westworld' movie
0,3,15,43,2,13,0,58,0,group break man's bone offer help pay food: nypd
0,2,14,58,4,14,2,72,0,"fresh snowfall make shimla shiver -3.2 celsius, thing get chillier coming day"
0,1,2,46,0,5,0,48,0,swedish parliament pass electronic surveillance law
0,2,4,40,4,9,0,44,0,'full house' creator buy 'full house' house feel full
0,2,7,31,5,8,2,38,0,"vitaly churkin, russia u.n. ambassador, dy 64"
0,1,7,25,0,7,0,32,0,rare deep freeze warms dutch soul
0,3,8,40,2,9,0,48,0,here's chance bet india's defense spending spree
0,1,2,44,1,6,0,46,0,bc election writ drops; referendum campaign underway
0,3,8,39,1,8,0,47,0,big problem china bridge tunnel addiction
0,3,17,45,4,15,4,62,0,"according fake voter id, salman khan 64-year-old 51 thought!"
0,3,8,46,1,9,0,54,0,"pledging donate salary, trump decline release proof"
0,2,16,54,4,15,0,70,0,justice department said trump refugee ban legal. didnt say good idea.
0,3,3,43,1,9,0,46,0,judge reject roman polanskis bid end sex abuse case
0,3,2,37,0,7,0,39,0,u dog food recall euthanasia drug found
0,3,10,39,3,10,0,49,0,germany angela merkel urge trump work u.n. syria
0,2,3,57,0,10,0,60,0,facebook taking linkedin letting business post job listing
0,2,9,33,0,7,0,42,0,snap employee celebrate ipo behind closed door
0,2,9,59,0,11,0,68,0,texas democrat stick republican proposing masturbation fine men
0,1,1,56,0,9,4,57,0,killen convicted manslaughter 1964 civil right worker murder
0,3,11,46,4,12,0,57,0,trump call electoral college 'genius' close 'thank you' tour
0,1,7,40,0,8,0,47,0,syria file un security council complaint u raid
0,3,5,27,0,7,0,32,0,italy try skirt populist revolt
0,2,2,59,1,11,0,61,0,wilbur ross failed disclose he sued former businesspartner
0,3,10,37,0,11,0,47,0,paying nanny table really bad idea
0,2,10,46,3,8,0,56,0,beijing say one china policy non-negotiable trump comment
0,1,5,26,0,5,0,31,0,killing stir racial unease texas
0,2,3,25,2,5,0,28,0,macy's become canadian?
0,3,1,60,1,9,0,61,0,"crocodile casually stroll backyard, get thwarted wheelie bin"
0,2,2,53,1,10,0,55,0,donald trump approval rating lowest history one month mark
0,2,8,32,0,7,0,40,0,fashion people celebrate lunar new year
0,1,5,30,0,4,0,35,0,billion withdrawn madoff arrest
0,2,6,64,2,11,0,70,0,"jason collins, john amaechi fire back homophobic comment amarestoudemire"
0,3,14,38,1,11,0,52,0,legal ice arrest young immigrant daca status?
0,2,5,29,3,7,0,34,0,ash carter: u.s. sending troop iraq
0,1,3,44,1,8,2,47,0,pakistan arrest 35 people suspected u soldiers' death
0,1,3,40,0,10,0,43,0,foot mouth scare new zealand likely hoax
0,1,2,27,1,4,4,29,0,"polish wikinews reach 9,000 article"
0,1,7,35,0,8,0,42,0,obama face pressure strike firmer tone iran
0,1,3,29,0,6,0,32,0,two suspect killed uk bank robbery
0,3,12,53,1,12,0,65,0,ca judge allows trump supporter lawsuit city san jose continue
0,3,19,54,2,19,4,73,0,"uber driver raised 3 kids, passed class x board exam working 6 10 pm shifts!"
0,1,9,25,5,7,0,34,0,rising power challenge u.s. role i.m.f.
0,3,8,43,0,12,0,51,0,rural area brace shortage doctor due visa policy
0,3,12,42,0,11,0,54,0,expert share snag luxury gift budget christmas
0,3,2,63,3,12,3,65,0,"10 years, 4 million youtube follower meet internet's favourite mad scientist"
0,3,12,48,2,12,6,60,0,"couple canceled $350,000 wedding fight rehearsaldinner"
0,2,11,53,3,10,0,64,0,"criminal-justice reform, obama practice preaches civility"
0,3,3,43,2,7,0,46,0,"anti-trump sentiment, ad blitz motivate georgia voter"
0,1,2,51,1,8,0,53,0,shriver speaks schwarzeneggers affair love child
0,1,4,53,0,10,0,57,0,commuter chaos sydney wind damage line harbour bridge
0,3,8,51,0,8,0,59,0,richard sherman asking price seahawks trade reportedly dropping
0,1,6,28,0,8,0,34,0,sony go movie pitch brand
0,2,14,56,2,13,0,70,0,republican trying replace obamacare still idea they're
0,3,3,51,1,7,0,54,0,obama avoids partisanship first post-white house appearance
0,1,6,26,1,6,0,32,0,"nothing set stone, renegotiate"
0,2,5,58,2,10,0,63,0,michael jackson's daughter paris jackson sign modeling agency yahoo
0,1,8,39,0,9,0,47,0,human language gene change sound mouse squeak
0,3,15,50,1,17,8,65,0,30 30 science 2017: discovering new thing world new way save
0,3,1,58,0,10,0,59,0,one ten teacher taking antidepressant cope work stress
0,1,2,60,1,9,0,62,0,"finland offer helicopters, personnel assist greece forest fire"
0,2,1,34,1,4,0,35,0,world's hottest borehole nearly complete
0,2,1,37,1,7,0,38,0,baby brain scan may reveal autism risk: study
0,3,17,49,0,16,3,66,0,india home 3 lakh refugee 30 country including u uk
0,1,2,68,0,10,0,70,0,uk mountain run abandoned participant seek shelter appalling condition
0,1,5,36,0,7,0,41,0,rumor say cuban president fidel castro died
0,2,18,56,0,17,0,74,0,european winter harsh fox got frozen falling river germany
0,1,2,55,1,8,0,57,0,international conference agrees plan yemen's terror problem
0,3,7,47,0,12,1,54,0,uk prime minister theresa may call general election june 8
0,1,3,35,0,7,0,38,0,eu set date membership talk turkey
0,3,3,60,0,9,0,63,0,mike penny pressed repeatedly contact russia campaign
0,2,6,23,0,6,4,29,0,best city accountant 2017
0,1,6,25,0,6,0,31,0,atomic agency fails elect new head
0,2,12,42,2,13,0,54,0,john legend: love song bow dark shadow new york time
0,2,12,38,0,11,0,50,0,ryan reynolds getting star hollywood walk fame
0,1,7,25,0,4,0,32,0,nasa launch space shuttle atlantis
0,1,2,38,0,9,4,40,0,linux fifth searched tech word google 2004
0,1,1,47,0,7,0,48,0,british government scrap planned rule pay equality
0,2,9,54,0,11,0,63,0,royal pitcher yordano ventura dy car accident dominican republic
0,3,12,31,2,10,0,43,0,alec baldwin back donald trump 'snl' cold open
0,3,3,56,2,10,0,59,0,police department prepares brutal parking war 'game cones'
0,2,6,49,0,10,0,55,0,uk sends stress ball u scientist worried donald trump
0,3,5,43,4,9,0,48,0,kendrick lamar blast trump russia: 'ya'll somethin'
0,2,10,47,2,10,4,57,0,"8,000 uber lyft driver fail massachusetts' new background check"
0,2,2,27,2,6,3,29,0,would buy $185 pradapaperclip?
0,1,2,68,3,10,0,70,0,"abducted four-year-old missouri girl found alive, person interest shoot"
0,1,2,61,4,7,0,63,0,australia's million-dollar-a-month nauru detention centre two refugee
0,1,3,54,0,8,0,57,0,queensland election candidate gold coast back daylight saving
0,2,3,41,0,7,0,44,0,freed chibok girl return home joyful christmas
0,3,1,49,2,11,0,50,0,what's behind rare delusion loved one stranger?
0,3,10,54,0,11,0,64,0,watch bruce springsteen perform asbury park music festival new jersey
0,3,11,43,4,9,0,54,0,lebron james kevin love/carmelo anthony trade rumor: 'it's trash
0,2,6,51,0,13,0,57,0,cat owner likely bdsm everyone else list
0,1,2,50,0,10,0,52,0,quebec man found guilty shooting death laval officer
0,2,10,34,0,9,0,44,0,ecb reject monte paschi bid time capital
0,1,6,51,0,10,0,57,0,tommy thompson step secretary health human service
0,1,2,51,0,8,0,53,0,microsoft window metafiles vector computer virus
0,1,2,45,0,8,0,47,0,china surpass japan become second largest economy
0,3,3,31,2,6,0,34,0,u sending 'dozens' troop somalia
0,2,10,52,1,10,2,62,0,"11 clever, untraditional way people wrapped gift holiday season"
0,2,12,46,1,10,0,58,0,anti-poverty advocate brace trump fill policy blank
0,1,6,41,0,7,0,47,0,independent film service shopping spree sundance
0,1,8,29,3,6,0,37,0,ad campaign press bank a.i.g. investment
0,3,3,35,1,9,3,38,0,hp spectre x360 bulk add power battery
0,1,1,57,0,7,0,58,0,amazon rainforest destroyed faster previously believed
0,2,1,50,0,8,0,51,0,nurse charged ignoring bleeding patient hefell
0,2,2,54,3,11,4,56,0,"epilepsy drug 'responsible 4,100 severe birth defects' france"
0,1,5,47,3,8,0,52,0,"poll: arab discouraged u policies, back nuclear-armed iran"
0,2,10,49,1,8,0,59,0,jimmy garoppolo trade rumors: brown reportedly pursuing patriot qb
0,2,3,48,0,8,0,51,0,trump rant protester took away first amendmentrights
0,2,2,46,2,6,0,48,0,escaped inmate possibly 'cornered' near canadian border
0,3,3,70,2,16,0,73,0,fired criticizing trump. getting rid people like hurt agenda.
0,3,13,57,1,14,2,70,0,"drunk driver crashed parade crowd mardi gras, hopsitalizing least 21 people"
0,2,12,49,2,11,1,61,0,"kevin love injury update: cavalier pf underwent knee surgery, miss 6 week"
0,1,5,46,1,9,0,51,0,six indicted jet crash new jersey's teterboro airport
0,1,3,35,0,6,0,38,0,rice straw arrive unannounced baghdad
0,1,10,81,0,15,0,91,0,wikinews interview dr thomas scotto dr steve hewitt potential u military intervention syria
0,1,2,46,0,7,0,48,0,whooping cough outbreak kill ten infant california
0,1,10,39,2,9,0,49,0,u.s. reject afghan tally much lower civilian death toll
0,2,2,43,1,7,0,45,0,kashmir clashes: eight dead troop surround gunman
0,2,18,70,1,18,2,88,0,"cristiano ronaldo hero field too, save 80 dog prevents portuguese kennel closing"
0,1,3,47,0,7,2,50,0,american television producer sherwood schwartz dy aged 94
0,2,2,62,2,10,0,64,0,richard simmons 'in good spirits' returning home hospitalization
0,3,9,50,1,9,0,59,0,enormous void yordano ventura's passion laughter lived
0,2,6,40,3,8,0,46,0,surprise! 'orange new black' season released early
0,3,4,21,0,5,0,25,0,lonely town fukushima
0,1,9,39,0,9,0,48,0,iowa football coach shot high school helped rebuild
0,3,7,40,0,8,0,47,0,republican grappling repeal obamacare
0,3,2,43,2,9,0,45,0,u.s. life expectancy drop first time decade
0,2,3,51,0,10,1,54,0,7 mental trick u olympic athlete use perform pressure
0,3,13,55,2,15,9,68,0,"india fall 136th, pakistan climb 139th press freedom rankings, china 176th"
0,3,9,42,3,11,1,51,0,raekwon announces release date art 7th solo album 'the wild'
0,3,17,50,3,15,2,67,0,13-year-old girl karachi aim read book every country world!
0,1,5,45,0,9,0,50,0,nine u troop killed afghanistan taliban attack base
0,2,3,45,2,6,3,48,0,opposition protest counter president trump 100-day rally
0,3,9,53,4,10,0,62,0,charleston victim's brother call dylann roof's sentence 'hollow victory'
0,3,10,59,1,12,0,69,0,krewella denied visa perform india's sunburn fest due pakistani heritage
0,3,2,52,2,10,0,54,0,taliban leader urge afghan plant tree worldly good
0,1,7,36,1,6,0,43,0,ex-banking chief still collect perk paycheck
0,3,8,34,1,7,0,42,0,nobody know black hole's information go
0,3,6,48,0,6,0,54,0,david rockefeller overcame youthful shyness insecurity
0,1,2,35,0,6,0,37,0,north korea conduct test nuclear weapon
0,3,2,23,1,4,4,25,0,oscar 2017: best actress nominee
0,2,2,67,1,15,0,69,0,google new plan cripple iphone app-store model rule mobile world
0,3,1,51,5,6,0,52,0,think different: advertising defeat alt-right propaganda?
0,2,5,11,0,4,0,16,0,cat shred sled
0,3,14,43,1,10,0,57,0,new usps service let digitally preview day mail delivery
0,2,11,59,4,9,0,70,0,trump labor dept. pick slammed pro-american immigration reformer #neverpuzder
0,2,6,60,1,14,0,66,0,fbi hunting man poured suspicious liquid whole food buffet
0,2,17,57,0,14,0,74,0,nbc news video teen becomes first contestant wear hijab miss minnesota usa pageant
0,2,8,40,2,9,0,48,0,another bonus best friends: they're good health
0,3,10,40,1,9,0,50,0,donald trump may actually know who's running north korea
0,2,3,46,1,7,0,49,0,rebecca minnock: grandmother jailed missing mum lie
0,2,5,37,4,8,0,42,0,chiraq: spike lee film title likens chicago iraq?
0,2,2,30,0,5,0,32,0,jim gaffigan awkward winter sport
0,2,7,44,2,10,0,51,0,dana white say conor mcgregor appear 'game thrones'
0,3,2,49,2,9,0,51,0,stockholm suburb redesigning street 'feminist'
0,3,4,61,5,13,0,65,0,donald trump give 'a+' effort 'c' communication president
0,1,2,30,1,5,0,32,0,"dam indonesia bursts, dozen killed"
0,2,11,47,5,10,0,58,0,"planned parenthood's president: ""it's time ivanka stand women"""
0,3,2,45,1,9,0,47,0,yemen crisis: army chief killed missile strike camp
0,1,1,65,0,10,0,66,0,police social medium frenzy threatens prejudice alleged child killer trial
0,2,6,57,1,11,0,63,0,san francisco giant rookie pitcher throw no-hitter new york mets
0,3,7,24,0,6,0,31,0,fake news antitrust problem
0,2,8,41,2,8,0,49,0,u.s. military preparing deploy laser weapon vehicle
0,2,15,63,3,16,2,78,0,"microsoft monday: surface pro 4 price drop, patent phone fold window 7 dangerous?"
0,3,14,54,1,13,0,68,0,church scientology made whole website hating leah remini's new show
0,2,11,57,2,12,6,68,0,"nightly news nearly 200,000 forced home due calif. reservoir flooding emergency"
0,3,6,44,2,5,0,50,0,drake celebrates 'views' quadruple platinum certification
0,1,8,31,1,8,0,39,0,"british rider, realist sure thing"
0,2,2,54,3,11,4,56,0,"london terror: cop sift 2,500 item assemble killer's profile"
0,1,7,30,1,6,0,37,0,"millions, elie wiesel vent madoff"
0,2,7,43,1,9,0,50,0,bernie beating hillary iowa new hampshire breitbart
0,1,8,27,1,7,0,35,0,"recession, men losing job"
0,2,7,45,1,13,0,52,0,israeli official: proof u role un vote given trump
0,3,3,32,1,10,2,35,0,bbc look curb pay news star 80m cut
0,2,1,37,1,5,0,38,0,spicer hold rapid-fire first press briefing
0,2,11,35,1,8,0,46,0,new york city welcome drake's third ovo flagship store
0,1,2,40,0,8,0,42,0,worker swansea auto part plant vote strike
0,1,10,43,2,10,0,53,0,study see young citizen parent u.s. illegally
0,2,8,52,2,9,0,60,0,nigerian migrant arrested stabbing female refugee helper death
0,3,6,54,2,12,0,60,0,"moving on, falcons' matt ryan watched super bowl loss day day"
0,3,19,50,1,13,0,69,0,"nearly half syrian refugee kid attending school turkey, say unicef"
0,1,5,31,1,6,2,36,0,"ranger win overtime, despite 12 penalty"
0,2,7,37,0,6,0,44,0,french voting station reopens security scare
0,2,10,30,0,9,0,40,0,azerbaijan plan oil run
0,1,3,33,0,7,0,36,0,second man charged lee rigby murder case
0,3,5,83,1,14,0,88,0,london attack: british mp capture confusion panic inside ground parliament lockdown
0,2,6,64,1,13,0,70,0,manchester sea: exclusive clip prof casey affleck oscar favourite
0,1,2,49,0,6,0,51,0,arkansas democratic party chairman assassinated gunman
0,1,6,61,1,9,0,67,0,"former pennsylvania state senator vincent fumo convicted fraud, corruption"
0,3,3,59,1,11,0,62,0,dazzling wasp repel leicester fightback go three point clear top
0,3,2,46,0,6,0,48,0,republican question trump wiretapping
0,1,2,49,1,7,0,51,0,drug-resistant infection rise american hospital
0,3,9,44,0,11,0,53,0,ben carson call rich city dweller help poorer neighbor
0,2,2,63,2,12,0,65,0,"scandal, radical insurgency bet french presidency"
0,1,3,55,0,9,0,58,0,family killed palestinian boy donates organ israeli patient
0,1,2,49,0,7,0,51,0,ohio state gunman kill employee committing suicide
0,2,10,52,0,10,0,62,0,bull player partied chance rapper victory warrior
0,3,9,51,1,9,0,60,0,"u return seized artifact egyptian government, including mummy"
0,3,13,46,0,12,0,59,0,bruno mar time rock prince medley grammy tribute
0,3,11,58,3,11,0,69,0,az dem blast sessions' 'injustice dept' illegal immigration crackdown insider
0,2,1,47,2,7,0,48,0,health-care exchange sign-ups fall far short forecast
0,1,7,43,0,7,0,50,0,journal article question plan digital health record
0,3,18,58,0,14,0,76,0,ihop waiter help woman disability eat breakfast people beyond touched
0,3,6,25,0,7,6,31,0,top 20 worldwide instagram spot of2016
0,3,14,49,7,12,0,63,0,uber expands self-driving car service san francisco. d.m.v. say illegal.
0,2,2,51,0,10,0,53,0,perth man dy christmas swim two rescued rip
0,2,4,59,1,9,0,63,0,"trump, penny follow obamacare replacement rollout weekend offensive"
0,2,1,56,0,12,0,57,0,nevada close passing landmark bill tackle high drug price
0,3,2,87,0,19,0,89,0,woman jailed six year beating suffocating cousin exorcism german hotel
0,3,6,56,0,12,0,62,0,south korea prosecutor seek arrest samsung chief jay lee bribery
0,1,7,30,1,6,0,37,0,india open high-level inquiry fraud case
0,1,3,26,1,7,2,29,0,"car crash a37 near bristol, two dead"
0,1,4,31,0,6,4,35,0,poland win 2008 eurovision dance contest
0,1,7,28,1,8,2,35,0,tax haven likely target g-20 nation
0,1,7,31,0,8,0,38,0,obama try dexterity world cup
0,1,10,47,2,10,1,57,0,u.s. freeze asset 2 burmese businessmen backed military junta
0,1,7,44,0,9,0,51,0,armstrong remains third tour de france leaf pyrenees
0,1,6,29,1,6,8,35,0,ieee approves s1600 s3200 transmission standard
0,3,14,42,1,12,0,56,0,lonzo ball's dad lavar say son better stephen curry
0,2,8,31,1,8,0,39,0,goldman: trump bad news world economy
0,3,9,42,1,8,0,51,0,judge hear argument restricting nc governor's power
0,2,10,50,1,8,0,60,0,spurs' lamarcus aldridge indefinitely minor heart arrhythmia
0,1,3,19,1,4,0,22,0,"nitish win bihar, india"
0,1,6,34,0,7,2,40,0,wikinews discusses h1n1 pandemic cdc
0,3,1,36,0,6,0,37,0,zimbabwe hit deadly flood drought
0,3,8,47,0,9,1,55,0,deadmau5 spent day trolling reported old buddy glenn morrison
0,3,4,42,0,8,0,46,0,jimmy kimmel rip united airline parody vid
0,3,6,79,0,12,0,85,0,fbi release information san bernardino shooter iphone hacking vendor remains unidentified
0,3,1,64,0,10,0,65,0,canadian woman survives six day without lung waiting transplant
0,2,7,28,0,6,0,35,0,five classic rap song sample prince
0,1,5,62,0,11,0,67,0,alleged rapist file charge victim sweden hiv infection ground
0,3,16,60,1,15,0,76,0,"honda made futuristic bike balance two wheels, without kickstand"
0,2,6,27,1,7,0,33,0,davos wonder part problem
0,3,8,55,3,10,0,63,0,krauthammer reacts 'radical departure' trump's foreign policy insider
0,1,1,31,0,4,0,32,0,chinese yuan revalued dollar
0,3,5,68,1,15,0,73,0,isil hit back mortar suicide bomber iraqi force push mosul's old city
0,1,3,43,2,8,0,46,0,"ignatieff, rae say they'll run next canadian election"
0,3,4,44,3,8,0,48,0,"michael hayden say obama's russia response ""too timid"""
0,1,3,17,0,5,2,20,0,actor bob denver dy 70
0,3,12,50,2,12,1,62,0,"microsoft worth 1 trillion dollars, ahead apple, alphabet amazon"
0,2,8,45,0,7,0,53,0,first militiaman arrested connection oregon standoff
0,1,2,62,0,12,0,64,0,two nuclear leak two week trigger security safety review france
0,2,1,65,2,11,0,66,0,"neglected more: ending trachoma, infectious eye disease rooted poverty"
0,2,9,41,3,8,0,50,0,jack dorsey: twitter lacked 'focus discipline' growth
0,1,6,64,2,10,0,70,0,"presidential candidate haiti, dany toussaint, arrested united nation troop"
0,2,10,41,2,9,0,51,0,rapidly expanding snapchat angering neighbor l.a.
0,2,2,82,0,20,0,84,0,disturbing image show rabbit attached back car travel busy chinese city
0,2,6,38,2,10,6,44,0,"debbie reynolds, wholesome ingnue 1950s films, dy 84"
0,3,3,58,0,9,0,61,0,burma detains police officer caught beating rohingya muslim video
0,3,3,67,5,10,0,70,0,"bana al-abed, seven-year-old tweeted aleppo, among child evacuated safely"
0,3,7,40,0,7,2,47,0,20 democratic senator support blocking neil gorsuch
0,1,3,37,0,5,0,40,0,wikinews switch creative common license
0,2,5,46,2,8,0,51,0,"israel warms sunni powers, question u palestinian focus"
0,3,4,42,1,7,0,46,0,pakistan activist waqass goraya: state tortured
0,1,2,30,0,5,0,32,0,whole food move renewable energy
0,3,7,52,5,9,6,59,0,"cavalier vs. warriors: score, highlights, reaction 2016-17 regular season"
0,1,2,30,0,3,0,32,0,hasegawa retains bantamweight title
0,1,12,34,5,10,0,46,0,"jeremy tyler, n.b.a. prospect, groomed play way"
0,1,2,25,0,5,0,27,0,gunman loose melbourne
0,2,10,42,1,9,0,52,0,recep tayyip erdogans narrow win could end undermining
0,2,12,48,0,10,0,60,0,jeff session omits decade record ag confirmation hearing
0,2,8,39,1,7,0,47,0,fda cant distinguish eggplant tobacco
0,2,5,59,3,13,2,64,0,"peter vaughan, venerated character actor british stage, tv film, dy 93"
0,1,7,38,0,8,0,45,0,clear accord stimulus top industrial nation
0,3,1,61,3,8,0,62,0,"skin-to-skin contact safe vulnerable premature babies, research show"
0,3,8,25,2,7,0,33,0,shame grieving dog's death
0,3,10,47,1,8,0,57,0,sapvoice: build bond successful digital transformation
0,1,2,48,1,6,0,50,0,hundred arrested following pro-democratic rally nepal
0,1,5,59,1,9,0,64,0,scottish lawyer denies death lockerbie bomber abdelbaset ali al-megrahi
0,1,7,39,1,6,0,46,0,international anti-smoking treaty take effect soon
0,1,1,47,0,9,2,48,0,drunk coach driver arrested crash injures least 30
0,3,15,67,2,13,0,82,0,here's everything need know agustawestland chopper deal everyone's talking
0,1,5,26,0,5,0,31,0,tweeting becomes summer job option
0,2,11,67,4,14,0,78,0,trump campaign clinton speech: expect someone losing election breitbart
0,1,4,78,1,13,0,82,0,"resident fear environmental hazard site partially collapsed building buffalo, new york"
0,3,12,49,1,9,0,61,0,imf chief's conviction negligence raise question future
0,1,7,39,1,6,0,46,0,"israeli playground opens, hardened rocket"
0,3,10,44,1,11,0,54,0,man died riding roller coaster disney's magic kingdom
0,3,7,71,4,16,0,78,0,google got game throne star trek around greenland take google street view image
0,2,10,49,2,12,0,59,0,like cover menendez murder trial: reporter's notebook
0,2,9,55,3,12,0,64,0,"republican look reince priebus, trump chief staff, bring stability"
0,2,14,38,2,9,0,52,0,"cmo today: trump clash cnn, buzzfeed press conference"
0,1,8,40,0,10,0,48,0,drop air travel offset cheaper fuel cost american
0,1,3,23,0,3,0,26,0,russia celebrates victory day
0,1,7,27,0,7,0,34,0,eagle raven fly blue hen
0,2,18,58,4,14,0,76,0,nasa's satellite captured stunning 'northern lights' best can't stop staring
0,2,2,51,2,9,2,53,0,carnival princess pay record $40 million pollution cover-up
0,1,2,62,1,11,0,64,0,many nation offer material aid hurricane victims; bush refuse accept
0,1,4,57,0,9,0,61,0,twentieth anniversary tiananmen square protest pass china
0,2,11,57,5,10,0,68,0,anushka sharma slam media's 'bogus claims' virat kohli producing 'phillauri'
0,2,1,75,2,12,0,76,0,social worker criticised saying christening baby would 'hinder chance adoption'
0,3,1,61,5,13,0,62,0,trump say he's turning away 'billions' 'the right' business deal
0,3,6,35,1,8,0,41,0,japan school: donation row grows pm shinzo abe
0,3,11,60,2,13,0,71,0,carrie fisher debbie reynolds joint public memorial los angeles [video]
0,1,5,35,0,6,0,40,0,europe move ease tension protectionism
0,2,3,50,1,9,0,53,0,bernie sander predicts trump one-term president
0,1,2,33,1,6,2,35,0,new zealand holiday road toll: 20 fatality
0,3,9,61,3,11,0,70,0,president obama: hanukkah 'has inspired american tradition religious freedom'
0,3,8,36,0,11,0,44,0,dean take race chairman dnc
0,1,3,32,0,5,0,35,0,bart simpson used promote scientology
0,1,2,32,0,7,3,34,0,160 dead bushfires australia
0,1,1,35,0,5,0,36,0,greek police investigates murder actor
0,3,9,36,1,8,0,45,0,sort problem quantum computer good for?
0,2,2,55,1,10,0,57,0,chile forest fires: troop join fight worst fire decade
0,2,4,42,0,8,0,46,0,fcc already declining enforce net neutrality
0,2,2,42,4,8,0,44,0,donald trump blast recount ridiculous scam
0,1,2,28,1,3,0,30,0,wikimedia announces yahoo! support
0,3,9,42,2,11,0,51,0,"trump country, shock trump budget cuts, still loyalty"
0,1,6,36,2,7,0,42,0,boeing airbus prepare (again) tanker battle
0,3,11,56,3,10,0,67,0,"london terrorist attack: vehicle, knife incident show threat low-tech terror"
0,2,2,37,1,7,0,39,0,judge hear argument trump's travel ban
0,1,2,12,0,2,0,14,0,tony wilson dy
0,1,4,67,0,8,0,71,0,new australian industrial relation legislation pass house representative
0,1,3,33,1,7,0,36,0,man rip hitler waxwork's head berlin
0,1,3,28,0,4,0,31,0,jindal sign intelligent design law
0,1,8,34,0,9,0,42,0,tear old yankee stadium build bronx
0,3,5,49,3,12,3,54,0,ufc 207 give ronda rousey redemption ... send irrelevance
0,3,8,68,0,16,0,76,0,barry bond roger clemens trending toward hall fame curt schilling
0,2,2,42,1,7,0,44,0,earth second-warmest february record
0,3,10,50,3,10,0,60,0,tidal tout exclusive (but update subscribers) year-end number
0,2,15,40,0,11,4,55,0,donald trump decline fill 2017 ncaa tournament bracket espn
0,1,2,52,0,8,0,54,0,british university fall short smurf gathering world record
0,2,6,72,2,11,0,78,0,'nuclear option' expected democrat filibuster neil gorsuch supreme court nomination
0,2,6,64,1,14,0,70,0,nsw floods: local say road mum stephanie king child died closed
0,2,13,52,2,15,0,65,0,justice dept. say judge immigration case bound new york time
0,2,8,46,1,9,0,54,0,shot fired climate skeptic office march science
0,1,2,33,0,6,0,35,0,shooting finnish mall leaf four dead
0,1,2,39,1,9,3,41,0,"flash flood kill hundred india, 500 missing"
0,2,6,81,2,17,0,87,0,surgeon claiming transplant volunteer's head another body say need america's help
0,2,8,56,4,14,3,64,0,trump's america donald trump: care u president's first 100 days?
0,1,5,28,2,6,0,33,0,"ford's u auto sale spike, surpassing gm"
0,2,3,45,1,11,0,48,0,kenya's high court rule one third mp must woman
0,3,7,43,1,9,2,50,0,"53 arrested nigeria celebrating gay wedding, police say"
0,3,2,30,2,6,0,32,0,trump inauguration: get here?
0,2,6,31,0,8,0,37,0,joss whedon poised direct batgirl movie
0,3,9,48,3,9,1,57,0,"3 year later, childhood cancer survivor recreate viral photo [video]"
0,3,12,59,0,14,0,71,0,seahawks player earl thomas went buffalo wild wing disguise watch team play
0,2,9,29,4,8,0,38,0,u.s. russia clash u.n. syria sanction
0,1,8,50,0,9,0,58,0,still flourishing underground economy economy
0,3,11,52,4,12,0,63,0,sen. hatch: dems acting like 'juvenile idiots' delay trump nominee insider
0,2,3,65,0,15,0,68,0,porn site decided step state voted sex education list
0,1,5,44,0,9,0,49,0,former un head annan warns kenya future poll violence
0,1,5,43,0,8,0,48,0,iraqi airway drop flight united kingdom sweden
0,2,3,53,3,9,0,56,0,durban police search baby abducted south africa 'car-jacking'
0,1,12,52,2,10,1,64,0,"ziff davis sell 1up ugo networks/hearst, close electronic gaming monthly"
0,2,9,37,4,11,0,46,0,james corden add 'touch' little mix 'late late show'
0,2,11,38,1,12,0,49,0,"obama look adding base troop iraq, fight isi"
0,1,4,31,0,6,1,35,0,industrial output decline 4th month
0,2,1,46,0,7,0,47,0,facebook want get smarter suicide prevention
0,2,5,57,1,10,0,62,0,tony blair could work alongside lib dems anti-brexit election campaign
0,3,7,60,0,12,0,67,0,australian model ethan turnbull save new york teen icy central park pond
0,1,7,42,0,8,0,49,0,cavalier agree sell stake chinese investment group
0,2,10,58,3,11,0,68,0,universal studio adding super nintendo world japanese theme park breitbart
0,3,8,35,3,10,1,43,0,gorsuch would 8th man hold 'justice scalia's seat'
0,2,6,54,1,13,0,60,0,"al qaeda leader say group near collapse amid rise isis, report claim"
0,2,14,49,0,13,0,63,0,trump tell news anchor private lunch want treated fairly
0,1,5,55,1,8,0,60,0,frog-killing fungus spread across panama canal towards south america
0,2,8,51,8,10,0,59,0,julian assange: know wikileaks email swayed u.s. election? [video]
0,2,5,28,0,7,0,33,0,new playboy end adulthood
0,2,10,58,2,12,2,68,0,miami 'toxic tush' doctor sentenced 10 year providing lethal butt injection
0,2,3,57,2,11,0,60,0,jamie oliver close six restaurant 'tough market' brexit vote
0,2,5,34,0,8,0,39,0,observer view sending u troop syria
0,3,1,59,1,10,3,60,0,"800 australian die per year prescription drug overdoses, expert say"
0,2,8,42,0,10,0,50,0,james comey brief donald trump russian hacking friday
0,2,3,70,2,17,2,73,0,lebron james say 12-year-old son already better certain way age
0,2,9,43,0,9,3,52,0,british airway owner top air france 100 million customer
0,3,3,62,1,13,0,65,0,mexican peso strongest level since day trump's election
0,1,4,33,0,4,0,37,0,drop newspaper circulation accelerates
0,1,5,40,1,8,4,45,0,ariane 5 rocket launch superbird 7 amc-21 satellite
0,2,5,56,1,10,0,61,0,chongyi feng's detention china blunt warning chinese australian
0,3,2,59,0,10,0,61,0,theresa may scrap rule allowing minister pick private office staff
0,2,5,65,3,10,0,70,0,wonder woman director patty jenkins cracked superhero-movie glass ceiling
0,3,12,45,4,14,4,57,0,'city stars' 'la la land' win best original song 2017 golden globe
0,2,4,41,2,5,0,45,0,european leader fear austria-italy backlash?
0,1,3,45,1,8,0,48,0,dozen cat removed feces-ridden new jersey house
0,2,10,62,4,16,1,72,0,lavar ball ucla losing march madness: 'you can't win championship 3 white guys'
0,2,1,59,2,9,1,60,0,chicago grandmother guilty torture death 8-year-old granddaughter
0,3,2,42,0,6,0,44,0,german green float sex prescription disabled
0,2,1,35,0,8,0,36,0,trump indicates may sign new travel ban
0,2,7,38,1,7,0,45,0,here's happens endowment college close
0,3,1,42,0,8,0,43,0,woman ovary frozen childhood give birth
0,3,1,33,2,5,0,34,0,beijing 'trapped giant toxic cloud'
0,2,8,51,1,9,0,59,0,tech billionaire create fund prevent robot apocalypse breitbart
0,3,8,55,2,9,0,63,0,study show decline female employment entertainment industry [video]
0,1,2,36,1,6,0,38,0,"mayor baltimore indicted theft, perjury"
0,2,6,57,3,11,0,63,0,flood disaster n.c.: satellite photo hurricane matthew
0,2,11,56,4,15,1,67,0,season 2 'better call saul' might see return major 'breaking bad' character
0,3,15,55,0,13,0,70,0,speaker group supported betsy devos say hitler good reaching child
0,3,14,52,2,14,1,66,0,kane brown bow no. 1 top country albums; old dominion crown country airplay
0,3,9,42,1,11,0,51,0,"along mekong river, timeless place time march"
0,1,7,35,1,8,0,42,0,"england, royal taste alters landscape"
0,3,9,53,0,11,0,62,0,blac chyna kris jenner reportedly rush hospital rob kardashian
0,2,4,38,0,11,4,42,0,important car tech came ce 2017
0,3,11,49,0,12,0,60,0,king leon light madison square garden rock show spectacle
0,2,3,72,2,12,0,75,0,"bloodletting, voodoo opium: new orleans museum spotlight medical method past"
0,1,8,49,1,10,0,57,0,"candidate, rafsanjani try defeat ahmadinejad iran race"
0,3,2,53,3,7,0,55,0,'genderless nipples' challenging instagram's nudity policy
0,3,4,67,4,12,0,71,0,please dont get it: starbucks baristas flipping unicorn frappuccino
0,3,3,50,4,11,0,53,0,ore oduba: strictly like gladiator without lions'
0,2,2,47,1,8,0,49,0,aide scramble clarify trump's abrupt tweet nuke
0,1,1,34,0,6,0,35,0,albanian girl murdered tangle crime
0,2,12,58,2,13,4,70,0,"three worst currency 2017 show politics, economics, driving market"
0,1,7,34,0,8,0,41,0,ohio seek end interest abuse payday loan
0,3,9,38,2,15,0,47,0,"trump company plan invest taiwan, aide say"
0,1,4,25,2,7,0,29,0,u.s. man murdered wife hong kong
0,2,8,48,1,10,2,56,0,17 great book american president president day weekend
0,1,7,39,1,9,0,46,0,"seven year later, mickelson remains man people"
0,3,2,49,0,9,0,51,0,repeat offender charged arson atlanta overpass fire
0,1,6,37,1,6,0,43,0,uk elections: david cameron becomes prime minister
0,1,5,32,0,8,1,37,0,storm fire kill 8 south southwest
0,3,10,40,0,10,0,50,0,lego batman movie director take nightwing dc movie
0,1,6,37,0,8,2,43,0,u congresswoman stephanie tubbs jones dy age 58
0,1,2,39,0,6,0,41,0,execution suspended florida error
0,2,6,26,0,6,0,32,0,trump score first win congress
0,3,10,48,3,9,0,58,0,hear metallica's lars ulrich read 'the dinosaur pooped christmas'
0,1,9,42,1,9,0,51,0,michigan st. surge past louisville reach final four
0,1,5,33,0,6,0,38,0,hundred protest cut water california
0,2,1,40,2,8,0,41,0,trump pledge 'easy' health care deal defeat
0,3,2,47,0,8,0,49,0,anger brazilian team sign player convicted murder
0,3,4,62,0,11,0,66,0,marine le pen promise eurosceptic prime minister win french election
0,1,2,55,2,7,0,57,0,"hertfordshire, england police arrest armed suspect stand-off"
0,2,8,60,1,9,0,68,0,brent musburger retiring sport broadcasting: latest detail reaction
0,1,6,41,0,5,0,47,0,surviving tuskegee airman salute another trailblazer
0,2,12,42,3,11,2,54,0,charli xcx premiere 3 song new mixtape 'number 1 angel': listen
0,1,4,51,0,6,0,55,0,nottingham express transit extension get government approval
0,1,4,45,1,9,4,49,0,2008 taipei game show review: variation differ past year
0,2,6,45,4,9,4,51,0,beyonce sings 'love drought' 'sandcastles' grammy award 2017
0,1,6,57,0,9,0,63,0,class action launched australian bushfire survivor sp ausnet
0,2,9,41,3,14,0,50,0,trump budget much agenda still stuck mud
0,3,9,52,0,11,0,61,0,erdogan claim vast power turkey narrow victory referendum
0,2,4,37,0,8,0,41,0,orange new black released early netflix
0,2,12,50,3,10,0,62,0,here's something probably never knew 'golden girl' rue mcclanahan
0,3,9,42,0,9,0,51,0,nancy wilson talk heart hiatus new band roadcase royale
0,2,11,45,2,12,5,56,0,"global music industry grew 6% 2016, signaling brighter day ahead"
0,1,6,23,0,5,0,29,0,hijacked arm ship limp port
0,1,3,45,1,9,0,48,0,canadian pm vow push ahead same-sex marriage bill
0,2,2,43,0,8,0,45,0,indian red face tallest flag pakistan border
0,1,8,35,1,7,0,43,0,dustin johnson take four-shot lead pebble beach
0,1,5,19,1,3,0,24,0,germany's gun record close
0,2,13,44,0,13,2,57,0,taxman search tax return past 10 year find black money
0,1,3,27,1,8,2,30,0,"two explosion la paz kill 2, injure 6"
0,1,3,30,0,6,0,33,0,rachel weisz want botox ban actor
0,2,9,44,3,8,0,53,0,"trump's visa crackdown, indian student weigh canada, ireland"
0,1,4,41,1,8,0,45,0,uk police involved stand-off gunman raoul moat
0,2,16,58,1,15,1,74,0,india's jagadish chandra bose reason world enjoy super fast 5g internet
0,1,5,26,0,4,0,31,0,transforming carbon waste fuel
0,2,14,60,2,12,0,74,0,"trump spokesman claim president-elect sold stocks, provides evidence"
0,2,10,43,4,9,0,53,0,"everyones freaking cyrus beene week ""scandal"""
0,3,1,44,3,7,1,45,0,world's first 3-screen gaming laptop mind-blowing
0,3,6,68,1,11,0,74,0,bhp billiton share jump activist shareholder elliott management's call reform
0,3,12,54,3,15,0,66,0,new kid block back 'one night' new video: exclusive premiere
0,2,1,84,2,18,3,85,0,$31.6 billion hedge fund calling major overhaul law meant prevent another financial crisis
0,1,6,36,0,7,0,42,0,india pakistan agree fight terror together
0,1,2,44,0,6,0,46,0,witness fire vladivostok investigation
0,2,6,42,1,11,4,48,0,texas house democrat signal bid unseat sen. ted cruz 2018
0,3,2,58,0,7,0,60,0,murder investigation mysterious family disappearance france
0,3,1,64,0,12,0,65,0,high school kid becomes viral sensation refusing run hail storm
0,2,4,47,1,9,0,51,0,nba memo: rule prohibit mocking opponent social medium
0,1,6,22,0,5,0,28,0,wall street end week loss
0,3,2,62,2,15,0,64,0,anxiety numbing we're going beat trump need survival strategy
0,2,3,47,1,7,0,50,0,queen woman enslaved two south korean children:officials
0,3,13,45,0,12,0,58,0,like inside oscar weirdest thinghappened
0,3,1,56,2,12,0,57,0,"trump hope vote ""both"" spending bill health care next week"
0,3,7,36,1,7,0,43,0,aerial view show massive crowd women's rally
0,2,4,61,0,12,0,65,0,vet outraged american flag burned gym pearl harbor anniversary
0,1,2,53,1,7,0,55,0,"marathon runner address toronto, bringing attention autism"
0,1,4,34,4,8,0,38,0,delay declares 'victory' war u.s. budget fat
0,1,7,36,2,6,0,43,0,e.u. monitor report georgian forced abkhazia
0,1,8,51,0,11,0,59,0,sepp blatter pick fifa world cup draw presenter labelled sexist
0,1,5,36,0,8,0,41,0,ritual rich meet reality economy
0,1,5,52,1,9,0,57,0,grimm? mother goose cartoonist sued colombian coffee grower
0,1,6,52,0,10,0,58,0,record reveal u senator john sununu tie convicted lobbyist
0,1,1,45,0,7,0,46,0,turkey charge seven military officer coup plot
0,1,9,32,2,7,0,41,0,new objection may delay g.m. exit bankruptcy
0,1,10,41,1,9,4,51,0,2008 taispo: interview ideal bike corporation gary silva
0,1,6,35,0,6,0,41,0,cavalier dominant intriguing
0,1,6,55,3,11,0,61,0,lordi release music video finnish chart-topper 'bite like bulldog'
0,1,2,32,1,5,0,34,0,"shooting german hospital, four killed"
0,3,8,43,1,8,0,51,0,trump attack medium campaign-style rally florida
0,3,9,41,2,10,0,50,0,"noreaster could dump foot snow, disrupt travel"
0,1,9,40,3,9,1,49,0,"separate trips, kerry 2 u.s. representative visit gaza"
0,3,2,50,1,6,0,52,0,christchurch fires: home destroyed resident evacuated
0,1,8,36,1,7,0,44,0,"bank raised billion since test, geithner say"
0,3,12,48,1,12,2,60,0,"dog risk life, keep paralysed owner alive 19 hour fierce snowfall"
0,3,3,55,4,11,0,58,0,'hundreds' migrant back calais week 'jungle' camp torn
0,3,5,41,1,10,0,46,0,officials: woman shot tennessee deputy bb gun
0,3,9,47,1,12,0,56,0,sir ian mckellen sign sir patrick stewart meme women's march
0,2,2,43,3,10,0,45,0,egotist? here answer probably yes.
0,1,5,58,0,11,0,63,0,u vietnam begin talk decontaminate area affected agent orange
0,3,18,41,5,8,0,59,0,exclusive nsa whistleblower: agency absolutely tapping trump call
0,3,12,45,5,10,4,57,0,"allen iverson answer everything: 2017 mvp, rest bs...and breaking ankle"
0,1,2,37,0,8,3,39,0,report blame 747 crash brussels bird strike
0,1,3,20,0,4,0,23,0,grand theft auto fire
0,3,9,49,0,10,0,58,0,trump name pick elevated deputy national security adviser role
0,3,6,23,0,8,0,29,0,feel squeezed sky
0,3,2,24,1,5,2,26,0,u infant mortality rate 15%
0,1,6,31,0,5,0,37,0,pretax loss weakens british banking merger
0,3,4,53,0,10,0,57,0,five custody alleged christmas day terror plot melbourne
0,1,3,41,1,8,0,44,0,"car bomb buenaventura, colombia kill least six"
0,1,6,38,1,9,0,44,0,"stun gun found jetblue flight newark, new jersey"
0,2,6,50,3,10,0,56,0,eu council president donald tusk tell britain: 'we miss already'
0,2,2,47,3,10,0,49,0,aleppo battle: assad say victory city would 'huge step'
0,2,11,48,3,12,1,59,0,demi lovato say 1 percent african -- twitter absolutely loses
0,2,3,49,3,10,2,52,0,support same-sex marriage hit record high 57% marketwatch
0,3,15,58,0,11,0,73,0,hollywood getting outsized credit seriously small moment lgbt inclusivity
0,3,9,45,0,8,0,54,0,tom coughlin named jaguar executive vp football operation
0,3,1,44,1,7,2,45,0,australian economy recession-free 25 year
0,3,1,38,0,7,4,39,0,household debt dangerously close 2008 level
0,3,3,45,1,6,0,48,0,jallikattu: thousand protest india bullfighting ban
0,1,4,28,0,6,0,32,0,snow storm hit arizona new mexico
0,3,16,58,1,14,0,74,0,backstreet boys' acm award performance florida georgia line home run
0,2,4,56,2,13,0,60,0,"tale coast robson green review: seals, eel bare bum"
0,2,11,59,2,12,0,70,0,"marco rubio nikki haley endorsement, clinched second south carolina"
0,3,6,31,0,7,4,37,0,artist grammy nomination 2017
0,2,9,35,3,9,1,44,0,"ed sheeran reveals 'divide' track list, album due march 3"
0,3,2,54,2,9,3,56,0,pakistan 'kills 100 terrorists' crackdown isi shrine bombing
0,3,13,70,1,16,0,83,0,trump commerce department pick wilbur ross sever tie firm avoid financial conflict
0,3,3,71,0,11,0,74,0,china step naval patrol response unpredictable donald trump administration
0,2,3,45,1,10,0,48,0,"afar, dylan mus honor surprise nobel prize"
0,3,11,51,2,11,2,62,0,"hong kong mall escalator snap reverse, pile-up leaf 18 people injured"
0,1,6,31,0,5,0,37,0,budget obama courting fellow democrat
0,1,5,48,0,10,0,53,0,u vice president biden say iran sanction likely early may
0,3,6,30,0,7,2,36,0,viral cooking sensation auntie fee dead 59
0,2,13,48,0,13,0,61,0,united grapple pr crisis video man dragged plane
0,3,7,38,3,9,0,45,0,"democrat hone new message: economy, everyone"
0,1,3,44,1,7,0,47,0,large earthquake rattle indonesia; seventh two day
0,3,4,45,0,8,0,49,0,rex tillerson give russia stark choice syria conflict
0,3,7,36,1,10,0,43,0,"defying obama, many congress press arm ukraine"
0,2,14,54,3,15,0,68,0,thought understood american right. trump proved wrong. new york time
0,3,11,61,1,10,0,72,0,"indian company guard terrorism, training staff combat militant threat"
0,2,7,51,1,12,0,58,0,fall guy james lasdun review shade hitchcock highsmith
0,1,1,24,0,3,0,25,0,zimbabwe begin vote recount
0,3,2,41,3,5,0,43,0,"donald trump's tweet president-elect, annotated"
0,1,2,46,1,8,0,48,0,iraq electoral commission: fraud found vote recount
0,2,4,29,1,3,0,33,0,colin kaepernicks continuing protest
0,1,6,34,4,6,0,40,0,"dial-a-mattress, bankruptcy, sell rival"
0,3,10,45,0,9,0,55,0,depeche mode want absolutely nothing richard spencer
0,3,8,37,4,9,0,45,0,"'get out' star daniel kaluuya talk ""horror racism"""
0,1,5,29,0,5,0,34,0,astronaut let go refurbished hubble
0,3,4,63,2,15,6,67,0,"world cancer day 2017: effective cure happen five 10 years, say leading expert"
0,1,1,40,0,7,0,41,0,french woman admits killing eight infant
0,2,1,41,0,7,0,42,0,delaware woman killed falling zip line
0,3,1,65,1,9,0,66,0,china's economy show sign stabilising manufacturing activity expands
0,2,13,49,3,11,0,62,0,massive cover-up: nude statue italy deemed racy iran president
0,1,2,35,0,5,0,37,0,southern minnesota plane crash kill eight
0,1,2,38,1,7,2,40,0,venture capital investment ireland soar 35%
0,3,3,60,5,10,0,63,0,"u.s. awash terrible human right abuses, chinese government report claim"
0,2,10,44,1,8,0,54,0,tiny camera could give micro-drones amazing ability
0,3,18,56,2,17,0,74,0,dick van dyke say 'best five years' life spent working mary tyler moore
0,3,4,45,1,8,0,49,0,saudi arabia's king salman revers public sector pay cut
0,3,3,34,2,6,0,37,0,federer vs. nadal: top five memorable match
0,1,3,40,2,6,0,43,0,"clinton warns north korea ""provocative behavior"""
0,3,15,53,0,14,0,68,0,people promptly corrected guy telling woman simply give fake number
0,1,4,48,0,10,0,52,0,modern technology map new section great wall china
0,2,1,74,4,14,0,75,0,"trump say torture works, hell defer decision tactic defense secretary"
0,3,1,67,0,13,0,68,0,tropicana join list brand shrunk product size without cutting price
0,3,4,42,1,8,0,46,0,bid president trump's border wall due wednesday
0,1,2,41,2,9,0,43,0,"song indie artists, used small movie, win oscar"
0,1,3,32,2,4,0,35,0,regulator ban uk video-on-demand service
0,3,7,36,3,5,1,43,0,victoria beckham trademark 5-year-old harper's name
0,2,11,42,1,8,0,53,0,lebron james ether charles barkley epic post-game rant
0,2,3,56,2,8,0,59,0,kim jong-nam: malaysia expecting arrest murder investigation
0,2,3,40,2,11,3,43,0,j.c. penney list 138 store planning shutter
0,2,8,47,3,10,0,55,0,missing ex-fbi agent robert levinson: family file lawsuit vs. iran
0,3,2,61,3,12,0,63,0,"take that, dudes: female astronaut break record time spent space."
0,3,3,43,0,9,4,46,0,jesse matthew convicted 2005 sex assault case fairfax
0,3,10,37,2,9,0,47,0,james corden 'takes down' ice cube basketball court
0,2,5,58,0,10,0,63,0,american airline start flying nonstop los angeles australia
0,3,3,55,2,11,0,58,0,"time messy, democratic discussion future ai"
0,2,3,54,0,8,0,57,0,fda strengthens warning codeine tramadol child
0,3,14,74,3,15,0,88,0,"warrior coach steve kerr first round playoffs, potentially longer mysterious 'illness'"
0,2,8,45,1,10,0,53,0,trump dual role collide opening dubai vancouver
0,3,4,39,0,8,0,43,0,church bombing kill dozen egypt palm sunday
0,1,2,28,0,4,0,30,0,afghan attack kill five canadian
0,2,12,49,2,13,0,61,0,gregg popovich give tie wore craig sager's funeral craig sager jr.
0,1,12,32,7,10,0,44,0,"jailed c.i.a. mole kept spying russia, via son, u.s. say"
0,3,6,82,2,15,0,88,0,donald trump raise 'conspiracy theory' cia concludes russia intervened election help win
0,2,13,33,2,11,2,46,0,15-year-old may youngest ever found aplanet
0,2,13,44,4,12,5,57,0,"john ross run 4.22 40-yard dash nfl combine, break chris johnson's record"
0,2,13,50,0,12,0,63,0,jeff session admits grabbing woman genitals sexual assault
0,3,6,14,1,3,0,20,0,dmx enters rehab: report
0,2,3,79,4,17,0,82,0,new york city's iconic hotel closing indefinitely take look back star-studded past
0,2,5,61,1,12,0,66,0,sad youtuber find way express sorrow vr-distracted boyfriend
0,1,10,35,3,9,0,45,0,i.r.s. study try assess hospital earn tax break
0,3,1,63,1,12,0,64,0,"ofsted rating reveal best nursery children, major report show"
0,1,4,17,1,5,4,21,0,"motorola cut 4,000 job"
0,2,4,18,0,7,0,22,0,mindful gym
0,1,4,42,1,7,0,46,0,court appeal upholds ontario's talk caledonia
0,2,4,39,0,10,0,43,0,sirius xm talk minority stake inpandora
0,2,8,37,0,8,0,45,0,sia file divorce filmmaker erik anders lang
0,2,2,59,3,11,0,61,0,lawmaker say trump word matter hurt country standing abroad
0,3,11,47,0,10,0,58,0,sony entertainment ceo michael lynton stepping focus snap
0,1,8,34,1,8,0,42,0,"mexican killing rise, group take envoy task"
0,1,7,42,0,7,0,49,0,investigation senator burris illinois begun
0,2,2,52,0,9,0,54,0,lonely planet give quokka hot spot recognition deserves
0,1,7,25,3,6,2,32,0,at&t purchase t-mobile us$39 billion
0,2,2,63,1,12,0,65,0,"week tweeting, trump team face open questioning coming week"
0,2,14,59,0,14,1,73,0,8 celebrity spoke coping depression gave u important message
0,1,2,34,0,4,0,36,0,tsvangirai released zimbabwean police
0,2,5,36,2,8,0,41,0,food stamp 'snap' back debate spending
0,3,7,34,2,7,4,41,0,2017 grammy performance favorite? vote!
0,2,1,41,0,8,0,42,0,bull market dead tax reform take spotlight
0,2,1,53,0,10,0,54,0,military soon control swarm drone theirminds
0,2,8,30,0,7,2,38,0,16 old af celebrity fire twitter account
0,3,8,23,2,7,0,31,0,cardinal fan say 'i do' opening day
0,2,12,45,2,12,0,57,0,prince old band resurrects song new york time
0,3,3,51,2,9,0,54,0,"officials: suspect killed, officer wounded shooting oregon"
0,1,3,39,0,7,4,42,0,canadian court clear stephen truscott 1959 murder
0,1,2,28,0,5,0,30,0,confirmed bird flu death nigeria
0,2,11,61,2,13,0,72,0,"court temporarily block trump travel ban, airline told allow passenger"
0,2,3,46,0,8,0,49,0,hamas accuses israel killing tunisian drone expert
0,3,5,29,0,5,0,34,0,dow decline financial share tumble
0,3,10,43,1,9,0,53,0,democrat slam epa's pruitt carbon dioxide remark insider
0,2,4,50,1,11,0,54,0,nasa's new searchable library let get space fix big time
0,2,15,46,2,14,0,61,0,"destroy isis, must give victim tool fight back breitbart"
0,1,5,25,1,4,0,30,0,"cellphone, navigating life"
0,1,10,46,1,10,0,56,0,"filly champion rare, rachel alexandra ordinary filly"
0,3,11,62,0,11,0,73,0,second police officer dy shooting near georgia southwestern state university
0,3,3,35,0,5,0,38,0,pepsi pull controversial kendall jenner ad
0,1,2,28,0,4,0,30,0,israel ban nonresident gaza
0,3,6,43,1,11,0,49,0,syria conflict: u send troop help seize raqqa
0,3,1,46,0,7,0,47,0,scientist turn spinach leaf working heart tissue
0,3,3,54,3,10,0,57,0,adam silver: resting star player 'a significant issue league'
0,3,3,63,0,14,0,66,0,donald trump tax plan cut income tax wealthiest american five per cent
0,1,5,44,0,7,0,49,0,survival celebration niagara basketball team
0,1,5,32,1,7,0,37,0,"belgian king swears pm van rompuy, cabinet"
0,1,5,36,0,5,0,41,0,sharing selectively social networking site
0,1,7,28,3,4,0,35,0,u.n. anti-racism meeting reach consensus
0,2,3,49,1,7,0,52,0,clinton vetting ex-navy admiral stavridis vicepresident
0,3,14,52,1,12,0,66,0,"auburn s haley fagan, florida hc tim walton involved altercation game"
0,2,5,27,0,6,0,32,0,three simple rule eating seafood
0,3,8,41,2,9,0,49,0,"kevin gate denied bail, remains jail illinois: report"
0,1,6,30,1,5,0,36,0,ex-ernst partner guilty insider trading
0,2,1,38,0,7,0,39,0,cosby loses bid get criminal case dismissed
0,2,10,35,0,12,4,45,0,kurt angle inducted wwe hall fame class 2017
0,3,16,70,5,17,0,86,0,ashton kutcher say he's 'so proud' natalie portman speaking 'no string attached' wage gap
0,1,10,37,4,10,0,47,0,"m.i.t., large lecture going way blackboard"
0,2,6,58,1,14,0,64,0,"house gop plan two day debate, friday showdown vote obama trade agenda"
0,1,2,44,0,7,0,46,0,full video tigger incident reveals different story
0,3,10,37,0,10,3,47,0,141 stance donald trump took white house bid
0,1,3,41,1,6,0,44,0,"ngrid betancourt others rescued, say colombia"
0,3,3,49,2,10,0,52,0,appease oppose? world's nation reacting trump
0,2,11,50,3,13,3,61,0,course 'rogue one' totally smashed box office $155 million opening
0,1,7,30,1,6,0,37,0,host-country curse bear england
0,1,1,38,0,9,0,39,0,woman dy pet camel try mate
0,3,13,46,1,12,0,59,0,alabama set bar judge putting people death jury
0,3,6,84,2,12,0,90,0,donald trump russia claims: leaked document allege moscow hold compromising dossier president-elect
0,2,5,71,2,11,0,76,0,"syria missile strike: assad regime change trump administration priority, nikki haley say"
0,1,9,37,2,8,7,46,0,nascar: edward win 2010 ford 400; johnson claim championship
0,3,4,33,4,10,2,37,0,"chuck barris, creator 'gong show,' dead 87"
0,2,4,59,4,15,2,63,0,dale earnhardt jr. 'would love lot' input selecting successor no. 88
0,1,4,35,0,6,0,39,0,israeli army reoccupies tulkarem west bank
0,1,1,50,0,7,0,51,0,british military secret leaked social networking site
0,2,10,47,6,10,0,57,0,"joseph wapner, original people court judge, dy sleep: report"
0,3,13,53,2,13,1,66,0,cristiano ronaldo's $1 billion nike deal may bargain sportswear giant
0,2,11,41,2,9,0,52,0,badly ellen degeneres butcher rae sremmurd's name?
0,3,10,51,3,10,0,61,0,spicer: conway 'counseled' promoting ivanka trump brand insider
0,3,3,61,0,13,0,64,0,apple envisioned iphone ipod click wheel horrible
0,3,2,68,5,11,0,70,0,"manhattan brazen bucket-of-gold thief, famous viral video, caught ecuador"
0,3,10,50,1,12,0,60,0,story behind well-timed photo debbie reynolds carrie fisher
0,3,2,79,3,12,0,81,0,trump call hawaii judge's ruling revised travel ban 'unprecedented judicial overreach'
0,1,4,39,0,5,0,43,0,influential croat poet dragutin tadijanovi dy
0,1,4,21,3,5,4,25,0,medium round-up: april fools' day 2008
0,3,3,52,3,7,0,55,0,dark: netflix's new german-language drama series look terrifying
0,1,2,25,0,5,0,27,0,bomb blast kill several iran
0,2,11,55,2,9,0,66,0,kirk cousin reportedly sign new contract franchise-tag deadline
0,1,2,45,0,9,6,47,0,romanian visa card transaction increase 60 percent 2004
0,3,4,54,1,8,0,58,0,u aircraft carrier-led strike group headed toward korean peninsula
0,2,11,50,2,13,0,61,0,"veteran back patrol, time protect marijuana new york time"
0,1,5,29,3,6,0,34,0,u.s. rep. conyers raise bush censure issue
0,3,7,39,2,8,3,46,0,"tennessee wildfires, official estimate $500m damage"
0,2,7,31,2,4,0,38,0,true pro-life conviction non-negotiable
0,3,8,43,0,8,0,51,0,goldman sachs break government sachs immigrant ban
0,2,3,42,3,8,0,45,0,gambia election row: yahya jammeh 'should step now'
0,2,10,48,4,11,0,58,0,macklemore submit 'this unruly mess made' grammys: source
0,2,4,39,2,7,0,43,0,turkey referendum: dutch nazi remnant erdogan
0,1,2,12,1,3,2,14,0,liberty fall 0-3
0,3,5,46,0,8,0,51,0,record level cancelled urgent operation nh england
0,1,6,28,2,6,3,34,0,imf approves us$1.13 billion loan pakistan
0,2,2,59,4,9,0,61,0,"earth overdue collision 'dinosaur-killer' asteroid, nasa warns"
0,2,1,37,0,8,0,38,0,next step legal battle travel ban
0,1,4,57,0,9,0,61,0,journalist accuses algerian footballer assault world cup exit
0,2,3,29,3,10,0,32,0,look! sky! new kind cloud
0,2,7,26,3,6,0,33,0,post malone's debut album 'stoney'
0,3,15,55,6,14,0,70,0,expect new hip-hop drama 'the breaks': 'authenticity agonize over'
0,2,2,54,2,11,0,56,0,'deadliest catch' star know hope running lost colleague
0,3,8,51,2,11,1,59,0,"first major ncaa upset, no. 8 wisconsin top reigning champ villanova"
0,2,14,64,1,14,0,78,0,bernie sander battle hillary clinton within three point latest iowa poll breitbart
0,1,7,33,0,7,0,40,0,star stripe longer wave baseball
0,1,7,26,2,10,0,33,0,stock investor ask: bear bull?
0,3,8,42,1,8,0,50,0,"western digital, japan investor toshiba unit sale talk"
0,3,7,39,2,6,0,46,0,u.s. productivity advanced second straight quarter
0,3,6,49,1,10,0,55,0,uk tech industry spy opportunity donald trump's u travel ban
0,2,6,31,0,8,0,37,0,pay raise doctor czech republic
0,2,2,70,1,19,0,72,0,"city illinois realized spending lot money one drug, sued maker"
0,1,8,25,2,6,0,33,0,clinton say u.s. feed mexico drug trade
0,1,5,48,0,9,0,53,0,british airway jet make rough landing london city airport
0,2,2,58,0,8,0,60,0,johnny manziel reach agreement dismiss domestic violence charge
0,1,2,33,1,7,2,35,0,"three dead, 70 injured bangkok blast"
0,2,7,30,0,7,0,37,0,complete guide air jordan release date
0,3,12,39,2,10,0,51,0,'pokmon go' may getting actual christmas event
0,1,6,37,2,8,2,43,0,wagoner get $8.5 million executive retirement pay
0,3,12,49,1,11,0,61,0,stephen colbert real math donald trump's promised border wall
0,3,5,72,5,12,0,77,0,child refugee u-turn: children's commissioner express 'deep concern' end dub scheme
0,2,9,47,2,10,0,56,0,"berlin, grass-roots fight gentrification rent soar"
0,2,13,53,0,13,0,66,0,several gop state move block funding sanctuary city insider
0,1,5,26,1,6,2,31,0,fairfield top no. 20 marist overtime
0,3,4,63,3,12,0,67,0,"rationing nh service leaving patient pain distress, say new report"
0,2,10,57,0,11,0,67,0,sean spicer scramble correct hitler comment white house press briefing
0,2,8,46,2,12,0,54,0,cuisinart recall screwed holiday lot people
0,1,3,60,2,9,0,63,0,utah police investigate polygamist family reality show 'sister wives'
0,2,10,43,1,10,0,53,0,"bitter fight behind him, justice gorsuch start day relish"
0,3,2,48,0,8,0,50,0,trump rescind transgender bathroom rule obama era
0,2,2,56,2,8,2,58,0,"british thinktank received 25m bahraini royals, document reveal"
0,1,3,44,0,8,0,47,0,governor tokyo sued insulting french language
0,2,9,38,3,8,0,47,0,"""not president's day"" protest erupt across country"
0,1,10,41,0,12,0,51,0,yankee think latest loss red sox
0,1,3,56,1,12,0,59,0,"call aid help feed millions, east africa plunge drought"
0,1,5,35,0,5,0,40,0,space shuttle discovery photographed iss
0,1,5,42,0,7,0,47,0,usa lift remaining sanction serbia montenegro
0,1,5,35,2,5,0,40,0,al-qaeda threatens uk rushdie's knighthood
0,3,10,40,2,9,0,50,0,lonzo ball reacts lebron james 'mocking' shooting form
0,2,10,48,1,8,0,58,0,ireland's olympic rower return another hilarious tv interview
0,2,3,53,4,13,0,56,0,"played nintendos new game console, switch like"
0,2,4,42,0,11,0,46,0,could flying nonstop cuba u thisfall
0,1,9,32,2,8,0,41,0,"left d-day events, queen elizabeth fuming"
0,2,4,44,0,8,0,48,0,u considers banning laptop flight uk airport
0,1,3,45,4,8,0,48,0,"u.s. watchdog group list ""most corrupt member congress"""
0,2,5,77,1,11,0,82,0,donald trump supporter call budweiser boycott following pro-immigration super bowl advert
0,1,5,31,1,7,0,36,0,"debate spending, detour politics"
0,1,2,34,0,4,0,36,0,phoenix spacecraft launch towards mar
0,2,11,45,2,12,0,56,0,"caris levert, rookie brooklyn nets, spends sunday"
0,3,3,34,2,7,0,37,0,lena dunham confirms plan girl movie
0,2,6,48,4,12,0,54,0,emilia clarke scared talk 'han solo' 'game thrones'
0,1,6,45,0,8,0,51,0,new zealand tsunami hero receive special service medal
0,2,4,46,1,9,0,50,0,cops: heavily armed man arrested struggle va clinic
0,2,9,45,1,8,0,54,0,"grassroots, union threaten dems defeat trade support"
0,3,11,42,0,10,0,53,0,simone bile reminds internet troll happy body
0,2,2,60,3,15,2,62,0,man poured boiling water gay couple. got 40-year prison sentence.
0,2,8,38,3,8,2,46,0,trump mar-a-lago hit 13 health violation january
0,3,4,50,0,9,0,54,0,afghan family special visa detained arriving lax
0,2,1,35,0,5,0,36,0,woman critically injured highwaycrash
0,2,9,39,2,8,0,48,0,austrian court grant u.s. bid extradite dmitry firtash
0,1,7,36,1,7,0,43,0,"despite recession, demand skilled labor high"
0,1,5,72,3,15,2,77,0,"eurovision '09 competitor chiara talk current song ""what we"" past accolade"
0,3,10,48,1,10,0,58,0,twitter absolutely lit warrior all-star photo shoot
0,3,11,42,1,11,0,53,0,lebron james help open public school at-risk kid akron
0,2,2,60,0,12,0,62,0,steve ballmer want know government really spends money
0,2,3,51,1,11,0,54,0,woman halted racial abuse subway: promised would
0,1,7,51,1,9,1,58,0,telecom commission solomon island issue phone company us$1m fine
0,3,4,71,2,13,0,75,0,'tragedy' great barrier reef coral bleaching devastates second straight year
0,2,9,41,0,8,0,50,0,kasich defends comment sexual assault boozy party
0,3,4,65,2,13,2,69,0,"promote film, 20th century fox created fake news site fake anti-trump story"
0,3,6,32,0,5,0,38,0,opioid addict worry losing obamacare
0,3,2,46,0,9,4,48,0,consumer confidence soar best level since august 2001
0,2,4,46,0,12,0,50,0,jeb bush call closer tie europe berlin speech
0,1,3,30,2,7,0,33,0,price pump spike overnight u.s.
0,2,7,36,1,8,0,43,0,nevada joe heck aim keep senate republican
0,3,8,39,0,10,0,47,0,facebook start educate user spot fake news
0,3,9,33,3,8,0,42,0,android auto review: next car need [video]
0,1,2,53,1,9,0,55,0,"bittorrent tracker site sued movie studios, mount defense"
0,1,4,31,2,4,0,35,0,intergalactic representative u.n.
0,1,6,32,1,5,0,38,0,"investor ignore business plans, study find"
0,2,1,33,0,8,0,34,0,trump know fed closing
0,2,8,42,2,9,0,50,0,homeland security head pressed define 'sanctuary city'
0,2,13,41,0,12,0,54,0,liam payne one direction welcomed new son world
0,3,2,75,1,14,0,77,0,report: nearly half student college think receive federal loan forgiveness
0,2,11,61,1,11,0,72,0,philip haney: government use basic indicator prevent islamic terror attack
0,1,6,62,2,11,3,68,0,unhcr: somalia violence killed 258 civilian last month; ten thousand displaced
0,3,8,31,3,7,0,39,0,discovery's 'cash cab' trivia show coming back
0,1,3,34,0,8,0,37,0,u russia sign new arm control treaty
0,1,6,36,0,7,0,42,0,suspect ponzi scheme surrender long island
0,2,3,54,1,10,0,57,0,"u navy strike group move towards korean peninsula, official say"
0,2,3,72,1,14,0,75,0,brisbane storm: bureau meteorology warns way early morning light show
0,3,8,33,0,8,2,41,0,50 hilarious tweet parent year
0,2,9,46,2,10,0,55,0,kyrie irving show 'friends' tattoo speaking medium
0,1,4,45,2,8,0,49,0,"police officer charged double-death crash luton, uk"
0,2,3,56,3,13,0,59,0,globe's 'rogue one' ad heck tearjerker aimed inspiring courage
0,3,3,65,2,12,1,68,0,"boy, 9, dy collapsing suspected heart attack wa basketball game"
0,3,1,68,2,15,0,69,0,radicalisation happen private need open spot sign
0,3,9,48,0,8,0,57,0,suspect arrested connection jewish community bomb threat
0,3,3,57,2,12,2,60,0,"actor comedian ricky harris, worked alongside greats, dy 54"
0,2,11,59,7,12,0,70,0,"aaron diehl seek common thread space, time, continuum (exclusive album) speakeasy"
0,1,5,32,0,8,0,37,0,big change way lending student
0,2,6,42,3,8,0,48,0,"like clockwork, trump rip saturday night live ontwitter"
0,3,1,55,4,10,0,56,0,press paws: point-of-view camera reveals polar bear action video
0,2,12,46,3,11,0,58,0,"trump tough tweet reflected foreign policy, least far"
0,1,6,27,0,6,1,33,0,4 michigan city lose daily paper
0,3,11,56,1,12,0,67,0,"watch joel embiid crash meek mill performance, dab dance shirtless onstage"
0,3,2,42,1,6,2,44,0,knife-wielding man attack 11 chinese kindergarten
0,2,10,45,5,7,0,55,0,"cuban-americans, young old, celebrate castro long-awaitedend"
0,3,6,31,1,8,0,37,0,kevin love return knee injury vs. jazz
0,2,7,30,0,6,1,37,0,galaxy s8 embarrassing new problem
0,3,10,56,0,10,4,66,0,taxstone reportedly arrested connection fatal 2016 irving plaza shooting
0,1,7,51,0,11,0,58,0,former u senator ted stevens among five killed alaska plane crash
0,2,4,86,0,18,0,90,0,top russian diplomat found dead apartment athens week ambassador shot dead turkey
0,3,1,54,1,8,2,55,0,detectorists strike gold 20 year leaving field empty-handed
0,2,15,53,5,11,0,68,0,mariah carey: pro-lgbt award real musical achievement honor breitbart
0,2,12,55,3,12,0,67,0,turkish producer mahmut orhan talk hit single 'feel' signing ultra record
0,2,3,37,1,9,2,40,0,"74 body wash libyan coast, red crescent say"
0,2,6,83,3,15,0,89,0,'a body blow investigation': democrat slam gop investigator disclosure trump wiretap claim
0,1,7,40,1,6,0,47,0,"citing knee tendinitis, nadal withdraws wimbledon"
0,2,2,41,0,9,0,43,0,amazon alexa helpfully try give porn child
0,2,1,73,5,10,0,74,0,turkey's deputy prime minister say country's 'two-headed' democracy unsustainable
0,1,9,23,3,9,6,32,0,"ubs cut 7,500 job $1.8 billion loss"
0,3,6,68,3,13,0,74,0,hair stylist marla maples: free service exchange inauguration day exposure
0,2,3,56,0,13,0,59,0,news one four ryanair passenger forced put cabin bag hold
0,3,13,53,2,12,0,66,0,donald trump tweeted enlisting full potential women. fell short.
0,3,3,56,1,9,0,59,0,republican hold closely-watched kansa special house election
0,3,5,80,4,16,0,85,0,police 'speak george michael's partner fadi fawaz' officer try work singer's last movement
0,1,5,24,0,5,0,29,0,investor await move fed
0,2,10,52,2,11,6,62,0,"japan's 50 richest 2017 grow wealthier telecom, videogames technology"
0,2,4,59,3,9,0,63,0,octavia spencer buy hidden figure screening low-income family
0,2,2,45,0,7,0,47,0,putin make russia peacetime troop death state secret
0,1,3,40,0,6,0,43,0,space shuttle discovery launch indefinite hold
0,1,1,37,0,4,0,38,0,india struggle encephalitis outbreak
0,2,3,76,1,15,2,79,0,bill gates: terrorist could wipe 30 million people weaponising disease smallpox
0,1,3,38,3,9,5,41,0,riot le-de-france 70 arrested 200 car burned
0,2,19,65,4,17,0,84,0,"harpercollins india giving paid 'pawternity leave' staff get pet, adorable that!"
0,1,5,16,2,4,0,21,0,g.e. reduce dividend
0,1,3,49,2,9,2,52,0,bolivian president-elect take 50% pay cut aid social program
0,2,4,75,5,13,0,79,0,stop nonsense: percy jackson author snub invite texas lawmaker bathroom bill
0,3,1,58,0,12,0,59,0,lennar beat improving job market rising wage provide lift
0,3,9,34,2,10,0,43,0,year latin charts: juan gabriel nicky jam lead
0,1,6,29,2,7,2,35,0,gilead buy cv therapeutic $1.4 billion
0,1,3,52,1,10,0,55,0,self-defence party stay governing coalition poland
0,3,7,39,0,11,0,46,0,paul ryan listening papa roach nyt fake news
0,3,13,53,2,11,0,66,0,tech company trying affirmative action hiringbut call
0,1,3,28,0,5,0,31,0,nintendo wii sale decrease japan
0,1,2,37,0,7,0,39,0,wax hitler return museum repair
0,3,6,29,1,6,0,35,0,madonna twin attend first day school
0,1,1,77,0,14,0,78,0,florida school begin enforce new statewide ban saggy pant revealing attire
0,3,12,50,4,9,0,62,0,scarlett johansson's 'snl' monologue highlight many time hosted
0,1,5,30,3,9,0,35,0,"talk, talk, talk, austin"
0,3,16,45,0,14,2,61,0,yes bank partner ola set mobile atm across 30 location india
0,2,6,31,2,5,0,37,0,snapchat snap back ex-employee's lawsuit
0,3,2,42,0,8,0,44,0,stephen hawking making plan travel space
0,2,3,44,4,9,0,47,0,elon musk say he's 'doing good' trump's advisory council
0,2,3,59,3,12,0,62,0,"vigilante phone app alert new york user crime, police thrilled"
0,3,8,39,0,7,0,47,0,protester urge electoral college stop donald trump
0,2,7,35,9,8,0,42,0,"***live updates*** trump vs. clinton, round one breitbart"
0,2,13,39,1,12,0,52,0,"killer cop go trial, fate mostly white hand"
0,1,2,52,2,7,2,54,0,"large magnitude 7.8 earthquake, aftershock strike vanuatu region"
0,2,6,36,4,7,2,42,0,"barbara tarbuck, general hospital actress, dy 74"
0,3,6,45,2,10,0,51,0,senator demand white house review russian claim u.s. oil
0,1,4,28,2,8,3,32,0,"oldest user twitter, ivy bean, dy 104"
0,3,1,73,1,14,0,74,0,"flu pandemic plan stepped number virus strain jumps, researcher say"
0,3,5,46,0,9,0,51,0,jimmy kimmel really enjoyed dissing matt damon oscar
0,2,3,54,4,14,0,57,0,"trump world, okay use chemical weapons? find out."
0,1,4,25,0,4,0,29,0,google launch online rss reader
0,1,2,31,0,3,0,33,0,former guatemalan president arrested
0,1,2,40,0,6,0,42,0,mortar exchange kill thirteen somali capital
0,2,6,45,1,8,0,51,0,glencores reversal fortune marked return dividend
0,2,11,41,2,10,0,52,0,law enforcement warrant know youve been?
0,3,4,62,1,11,0,66,0,shia labeouf shut anti-trump protest stream report gunshot
0,3,3,51,1,11,0,54,0,"barack obama visit hawaii, hit link enjoys fine dining"
0,3,2,66,2,14,0,68,0,"clarke, autism, plan start business combining sport art"
0,3,5,62,0,14,0,67,0,marine le pen chief staff bodyguard questioned misuse eu fund probe
0,2,9,32,2,8,0,41,0,apple open new 'spaceship' campus april
0,3,2,77,3,14,0,79,0,'come try worst meatball sandwich': diner share hilarious restaurant sign menu
0,2,10,56,2,11,0,66,0,"raiders' derek carr, latavius murray kelechi osemele trade joke twitter"
0,1,5,48,0,9,0,53,0,whaler upset spirit opening game ontario hockey league
0,3,13,46,4,12,0,59,0,carrie fisher squealed joy saw princess leia rogueone
0,3,2,47,2,7,0,49,0,"obama speech: democracy need you, say outgoing president"
0,2,1,36,0,7,0,37,0,make living professionalbridesmaid
0,3,2,50,0,8,0,52,0,theresa may urged honour climate wildlife commitment
0,3,8,46,2,8,0,54,0,"amid slaughterhouse crackdown, india lion sample new cuisine"
0,2,11,37,1,10,0,48,0,"chinese port town, south china sea dispute personal"
0,1,7,65,0,14,0,72,0,former u vp al gore spearhead transport hurricane victim relief home state
0,1,3,24,0,5,0,27,0,three new jersey boy found dead
0,1,7,36,1,8,0,43,0,"gaza, weighing crime ethic urban warfare"
0,2,0,36,0,7,2,36,0,17 gorgeous planter help garden glow
0,2,12,33,3,9,0,45,0,gmo-labeling lobby take fight u.s. senate
0,2,5,20,1,4,0,25,0,nancy pelosi step down?
0,2,2,55,0,9,0,57,0,foolish thief steal priceless spruce sell christmas tree
0,2,6,30,0,6,0,36,0,melanoma rate dropped new england
0,2,13,33,1,12,3,46,0,100 year womens protest look like theus
0,3,3,46,4,7,0,49,0,alistair brownlee: mexico brought u people attention
0,1,2,40,0,8,0,42,0,suicide bomber iraqi funeral kill least six
0,1,1,22,0,3,0,23,0,first quantum byte created
0,2,11,62,1,13,2,73,0,jennifer aniston laughing jason bateman 22 years: inside friendship
0,2,6,19,1,6,0,25,0,graduate? ask big data
0,1,3,44,1,8,0,47,0,work lehman brother rescue continue weekend
0,2,3,45,0,7,0,48,0,venezuela deputy president defies u drug sanction
0,3,18,48,2,15,0,66,0,"shoe hurled delhi cm arvind kejriwal haryana, blame pm modi that."
0,3,7,32,0,10,0,39,0,uber case could watershed woman tech
0,3,13,45,1,12,0,58,0,new cover marvel queer latina superhero comic dope ashell
0,3,16,50,1,15,0,66,0,"ebro call remy liar saying slept nicki minaj, papoose fire back"
0,2,10,53,2,12,0,63,0,dad post craigslist ad sell pothead son truck punishment breitbart
0,3,9,36,2,8,0,45,0,'logan' might important superhero film ever
0,3,5,66,3,11,0,71,0,"china obligated take action 'dangerous' north korea, malcolm turnbull say"
0,1,3,50,0,8,0,53,0,german swedish foreign minister agree gaza standpoint
0,1,6,32,1,7,3,38,0,"caspian airline jet crash iran, killing 168"
0,3,4,62,3,11,0,66,0,"terragraph, aquila, tether-tenna facebook trying connect world"
0,2,9,43,1,6,0,52,0,doj launch investigation arizona election disaster
0,1,11,45,0,11,0,56,0,north korea say halt talk restart nuclear program
0,1,5,55,1,7,0,60,0,"wikinews interview kent mesplay, green party presidential candidate"
0,1,4,17,0,4,1,21,0,nevada plane crash kill 4
0,3,6,26,0,8,4,32,0,man pet parrot take best mugshot 2016
0,3,13,35,0,8,1,48,0,terrifying slam end heavyweight mma title fight nlfc6
0,3,5,45,0,8,0,50,0,nba looking incident patrick beverley fan
0,1,6,33,0,5,0,39,0,radomski testifies clemens grand jury
0,2,3,45,2,7,0,48,0,neighbor pleads guilty killing n.c. guidance counselor
0,2,3,37,2,9,2,40,0,"boy, 15, charged killing polish man harlow"
0,3,13,53,0,12,0,66,0,former beauty queen laura hunter sue fake news site stealing identity
0,3,11,40,0,12,0,51,0,teen get sweet revenge ex dumped week prom
0,3,14,38,0,13,0,52,0,commodity long may time snap
0,2,4,64,3,10,0,68,0,"debbie reynolds, carrie fisher's emotional memorial held next-door home"
0,3,1,56,2,13,5,57,0,startup's $1 million flying car officially rolling buyer 2020
0,3,7,37,0,7,0,44,0,border wall bid deadline extended another week
0,3,10,35,1,11,5,45,0,get 9 assassin creed game r 1000 humble bundle
0,2,9,30,1,10,5,39,0,"hsbc reduce head count 50,000 part overhaul"
0,2,4,67,2,12,0,71,0,"several injured car, knife attack ohio state university suspect identified"
0,3,4,55,0,9,4,59,0,malcolm turnbull remembers australian killed 2007 garuda plane crash
0,3,3,34,1,6,4,37,0,grammy nomination 2017: adele beyonc reign
0,3,14,67,0,15,0,81,0,cowboy de benson mayowa son twitter troll mistakenly accuses bandwagon
0,2,14,59,0,13,0,73,0,supreme court unhappy govt want time complete fencing bangladesh border
0,1,5,19,0,5,0,24,0,old airplane go die
0,3,18,39,3,13,0,57,0,"icymi, tyra bank allowing people age apply ""top model"""
0,2,10,45,2,8,0,55,0,milo: aquinas augustine radical progressive breitbart
0,2,3,59,4,12,0,62,0,obama: would personal insult legacy black voter dont back clinton
0,2,3,10,0,2,0,13,0,lamest duck
0,1,6,28,2,7,2,34,0,"sale fall 10%, home depot top forecast"
0,1,20,51,4,11,0,71,0,"sahtech, semi, semiconductor industry promote ""semi safety guideline"" taiwan"
0,2,3,28,2,9,5,31,0,iran seal $16.6b boeing deal buy 80 plane
0,3,7,35,0,7,0,42,0,trump invite israeli pm netanyahu washington
0,2,9,54,0,9,0,63,0,michael sam leaf montreal alouettes training camp personal reason
0,3,7,36,0,8,0,43,0,look inside abu walaa isi recruiting network
0,1,6,39,1,6,0,45,0,"third runway approved heathrow, angering critic"
0,2,12,51,1,13,0,63,0,snowden wikileaks clash disclose secret new york time
0,3,10,44,1,9,0,54,0,"queen elizabeth ii miss church again, raising health concern"
0,3,9,49,5,10,3,58,0,"fixing 401(k)s: whats done improve access, limit early withdrawal"
0,2,4,37,1,7,4,41,0,best picture international women's day 2017
0,2,2,54,1,8,1,56,0,holocaust survivors' 3d project preserve testimony future
0,3,8,37,1,9,0,45,0,gamers death push risk live streaming view
0,2,9,46,1,8,0,55,0,north carolina lawmaker introduce bill ban same-sex marriage
0,3,15,58,1,13,0,73,0,"pm modi take afghan president ashraf ghani golden temple, serf langar devotee"
0,1,8,58,1,12,0,66,0,manchester city agree big money shaun wright-phillips move chelsea fc
0,1,4,46,0,9,0,50,0,u fed chairman bernanke say recession could end year
0,2,12,56,6,12,0,68,0,"pepsi rajdhani coke shatabdi, indian railway plan brand train station"
0,2,2,46,1,9,0,48,0,la police dont body camera stickershock
0,1,6,44,0,8,1,50,0,britain prepares deport 9 terrorism suspect pakistan
0,3,2,48,1,8,0,50,0,uber's internal sexual harassment report arrive may
0,3,1,60,0,10,0,61,0,german police arrest two men suspected planning shopping mall attack
0,2,8,40,0,8,2,48,0,one breath breathalyzer diagnose 17 disease
0,2,9,59,0,15,0,68,0,chaos calais builder unearth two wwii raf bomb forced close port
0,2,3,66,4,12,0,69,0,anzac day: indigenous soldier thought 'when got back we'd treated differently'
0,2,1,52,1,9,0,53,0,california man dy injury attack neighbor's dog
0,3,8,37,0,10,1,45,0,9 death linked rare cancer breast implant
0,2,15,50,1,14,0,65,0,matt barnes' assault trial delayed possibly play nba final
0,1,6,37,2,7,0,43,0,"coast, medical trial company, agrees suspension"
0,2,4,57,2,14,0,61,0,haribo factory coming u.s. gummy bear dream come true
0,3,17,60,2,16,0,77,0,air quality level gurugram plunge 'poor' level relief rainy day
0,2,3,48,1,8,0,51,0,john glenn's ohio birthplace considered historic status
0,3,7,39,0,7,0,46,0,senate confirms neil gorsuch supreme court justice
0,1,11,39,2,11,0,50,0,venezuela push u.s. hand man tied plane bombing
0,3,17,56,0,14,0,73,0,top bjp leader scanner probe west bengal child trafficking case widens
0,1,1,48,0,7,0,49,0,british school inform parent overweight child
0,2,6,34,1,5,0,40,0,donald trump inaugural speech: full transcript
0,2,6,57,6,13,0,63,0,"hello, siri. please tell u feature-film debut lego batman movie"
0,2,3,82,8,15,0,85,0,clinton walk back deplorables comment: regret using term describe half trump supporter
0,2,7,50,2,8,0,57,0,inauguration singer jackie evancho 'disappointed' trump insider
0,1,6,38,1,7,0,44,0,ex-president argentina trail bid congress
0,3,4,51,0,8,0,55,0,egypt coptic church cut back easter celebration attack
0,2,6,63,1,13,0,69,0,series unfortunate events: count olaf reveals hilarious new interview
0,1,9,54,1,13,0,63,0,"instead glory, finder rare dinosaur fossil face charge theft"
0,3,2,26,0,5,0,28,0,hong kong prepares new leader
0,1,2,33,0,5,0,35,0,britney spear announces pregnant
0,3,5,79,0,13,0,84,0,supreme court likely overturn north carolina law prohibiting sex offender using facebook
0,1,1,51,0,6,0,52,0,egyptian military appoints committee amend constitution
0,3,4,49,0,11,2,53,0,12 ted talk teach healthy relationship
0,2,3,50,0,13,0,53,0,reason team making trip final four
0,2,7,37,3,9,0,44,0,think london hottest new hotel urban resort
0,1,5,33,2,7,0,38,0,america's cup: team new zealand win third race
0,3,14,48,2,10,0,62,0,marshawn lynch's agent say rb made decision regarding nfl comeback
0,2,3,48,1,6,0,51,0,bell-ringer survives freak accident worcester cathedral
0,2,10,62,4,13,0,72,0,"world wide web inventor tim berners-lee win turing award, ""nobel prize"" computing"
0,3,17,56,1,17,2,73,0,soldier carried mother's dead body 10 hour kashmir snow lay rest
0,2,11,53,1,11,0,64,0,italian police realize man berlin terror suspect shootout
0,1,2,47,1,10,1,49,0,thief steal 6 million worth jewel paris store
0,1,7,30,0,7,0,37,0,fan still finding value shea stadium
0,1,3,27,0,5,0,30,0,north south korea exchange fire
0,2,13,65,1,13,0,78,0,ten held brussels police raid targeting islamic state recruitment network breitbart
0,1,3,37,1,6,0,40,0,"series earthquake strike reno, nevada area"
0,3,11,46,2,11,2,57,0,"robert osborne, turner classic movie host oscar expert, dy 84"
0,2,1,42,1,6,0,43,0,"fight cyberbullying, ban cellphone fromschool"
0,3,6,24,0,6,0,30,0,kendrick lamar new reebok shoe
0,3,2,63,1,11,0,65,0,"search continues man accused stealing guns, sending manifesto trump"
0,2,3,39,1,7,0,42,0,trump fire white house first female chiefusher
0,3,4,65,1,10,0,69,0,airliner cause rare fallstreak hole cloud south australia's riverland
0,3,13,46,3,11,0,59,0,'harry potter' actor jim tavar break neck horrific head-on car crash
0,1,3,30,0,3,0,33,0,illinois house impeaches blagojevich
0,1,6,28,2,8,4,34,0,"2007 rugby world cup: fiji, tonga france win"
0,3,11,33,5,8,0,44,0,u.k. manufacturing pmi rise two-and-a-half year high
0,1,2,39,0,7,0,41,0,bali nine refused access federal police file
0,1,6,55,1,12,3,61,0,united nation request us$700 million aid east africa avoid famine
0,2,2,61,3,12,0,63,0,right version political correctness. stifling.
0,1,4,50,0,11,2,54,0,boat accident democratic republic congo kill least 73
0,3,7,40,0,7,0,47,0,moonlight star andr holland vintage obsession
0,2,4,26,3,6,0,30,0,tomi lahren: theblaze 'deeply hurt'
0,1,6,46,0,8,1,52,0,suicide bomber motorcycle kill 7 civilian afghanistan
0,1,2,31,1,7,0,33,0,geyser water one saturn's moon
0,1,6,29,0,7,0,35,0,mobile phone help fight aid africa
0,3,7,60,2,11,0,67,0,general promise d.c. national guard ready inauguration day despite furor
0,2,2,47,1,12,1,49,0,no. 1 fear investor month ago become reality
0,3,1,58,3,12,0,59,0,death diesel: one-time wonder fuel become new asbestos?
0,3,17,54,2,15,0,71,0,rgv go long rant tamil nadu south celebs protesting jallikattu ban!
0,2,7,48,2,10,0,55,0,nba power rankings: warrior pas test; sixer made sudden rise
0,3,5,46,2,10,0,51,0,u.s. wrestler compete world cup host iran relents
0,2,11,51,1,12,0,62,0,getting puppy youre pregnant could perk future baby
0,1,2,39,1,7,0,41,0,nebraska's two nuclear plant near omaha alert
0,1,5,25,0,6,1,30,0,2 auditor held india fault system
0,3,2,40,1,8,0,42,0,wendy's show handle beef twitter troll
0,1,5,25,1,5,0,30,0,"washington uighur problem,"
0,3,3,70,5,16,0,73,0,"tried sushi burrito, 'mutant food' san franciscan obsessed take look"
0,1,5,29,0,6,0,34,0,liz claiborne look mizrahian lift
0,3,10,27,3,9,0,37,0,"""girls,"" people color tohelp"
0,3,17,62,2,14,0,79,0,"fresh bread, booze takeaway howard schultz's last starbucks investor day ceo"
0,3,2,74,3,10,0,76,0,southern rail passenger 'having job application rejected' crisis-hit commuter line
0,1,7,29,0,6,3,36,0,tomtom go 740 live cellphone connectivity
0,2,3,41,1,7,0,44,0,obamas spending christmas weekend?
0,1,6,34,0,5,0,40,0,woman file complaint bernie williams
0,2,2,50,0,8,0,52,0,death toll continues rise earthquake rattlestaiwan
0,1,4,24,0,5,1,28,0,missile strike kill 4 pakistan
0,2,10,44,2,10,0,54,0,larry king: trump protester smashed car window breitbart
0,1,7,31,2,8,0,38,0,"two side border: one violent, one peaceful"
0,2,14,63,2,12,0,77,0,people noticing washington dc subway unusually empty trump inaugurationday
0,2,13,61,4,12,0,74,0,"lion ted: cruz challenge media, champion truth far-lefts smear jeff session"
0,2,8,29,1,7,0,37,0,here think pokmon would tastelike
0,3,10,43,4,13,0,53,0,"tony romo 'maverick day,' dress team's final game"
0,1,7,32,1,6,0,39,0,laid-off foreigner flee dubai spiral
0,3,13,39,4,9,0,52,0,"adpvoice: ""radical candor"" really work management tool?"
0,3,3,51,1,8,0,54,0,kyrie irving hold accountable cavs' bad stretch
0,3,5,27,3,4,0,32,0,jessica albas beauty evolution [video]
0,2,7,25,0,7,0,32,0,new york time sue fbi comeymemos
0,1,8,49,0,10,4,57,0,west indie play 2006 icc champion trophy final australia
0,3,2,55,3,8,0,57,0,petra kvitova suffers 'severe' hand injury knife-wielding burglar
0,2,7,54,1,11,0,61,0,us cole patrolling yemen iran-backed rebel attack saudi ship
0,1,6,29,0,6,0,35,0,southwest air begin flying boston
0,2,4,59,3,15,6,63,0,"ukip wars: arron bank asks money back submits invoice ukip 200,000"
0,3,11,54,2,11,2,65,0,big tobacco: reynolds agrees $49 billion takeover british american tobacco
0,1,11,34,2,8,0,45,0,"afc asian cup: iraq shock australia, japan overcome uae"
0,2,7,36,4,6,0,43,0,"remembering wham!'s ""last christmas"" christmas day"
0,2,5,63,0,11,0,68,0,state department sought land deal nigerian firm tied clinton foundation
0,3,11,60,1,12,0,71,0,study: black defendant likely wrongfully convicted murder white
0,3,4,50,1,8,0,54,0,dalai lama's visit disputed himalayan region irritates china
0,1,8,40,1,7,0,48,0,"population falling, russia beckons child home"
0,3,2,41,1,9,3,43,0,memorable moment trump's first 100 day office
0,2,1,64,1,13,0,65,0,"trump take rein early, assumes major role negotiation home abroad"
0,3,7,38,1,9,0,45,0,la puerta verde review: true mexican spirit ivy city
0,2,4,56,3,8,0,60,0,denmark awaits seoul extradition request choi soon-sils daughter
0,2,12,56,0,13,3,68,0,majority 161 people arrested recent ice raid criminal history insider
0,2,4,57,0,11,0,61,0,carrie fisher talk aftermath affair harrison ford
0,2,2,41,0,10,4,43,0,ruble surging highest level since july 2015
0,1,5,27,0,5,0,32,0,former pm thaksin return thailand
0,2,9,41,0,8,0,50,0,police investigate possible hate crime sikh man shot
0,1,2,54,0,5,0,56,0,wikimedia foundation address controversial content conflict
0,2,10,51,1,11,0,61,0,rob gronkowski david ortiz star sublime dunkin' donut music video
0,1,7,32,1,7,0,39,0,"first fan attendance, wizard top bull"
0,2,3,51,0,10,0,54,0,google assistant finally coming lot android device
0,1,3,31,0,6,0,34,0,obama budget call record u deficit
0,2,1,50,1,8,2,51,0,burglar 70-year sentence increased swearing judge
0,3,9,45,0,9,0,54,0,kyrie irving win water bottle challenge knicks game
0,1,4,59,2,9,0,63,0,agriculture department investigating possible u.s. case mad cow disease
0,2,1,41,0,7,0,42,0,snowstorm may lead blizzard heart trouble
0,1,1,39,0,7,0,40,0,first sign recovery horse flu outbreak
0,2,2,36,2,6,2,38,0,amazon canada fined $1.1m misleading pricing
0,1,8,18,3,6,0,26,0,new fund m.i.t. professor
0,1,7,37,0,8,0,44,0,translation error cost cuba use two pitcher
0,3,10,50,0,9,0,60,0,senate republican take first big step toward repealing obamacare
0,2,11,49,1,9,0,60,0,ta-nehisi coates perfectly explains racism helped donald trump win
0,1,4,28,1,5,0,32,0,twin bombing hit baghdad's green zone
0,3,2,49,2,9,1,51,0,"lexi thompson get 4-shot penalty, loses major viewer tip"
0,3,6,26,1,6,0,32,0,art infuriates removed?
0,1,4,64,0,10,0,68,0,new finding suggest aig executive bonus larger previously thought
0,2,16,63,1,16,0,79,0,ghetto becoming queen grand slam inspiring journey serena williams
0,2,8,30,4,9,0,38,0,north korea mock china dancing u.s. tune
0,2,7,45,0,8,0,52,0,steven van zandt speak rutgers university commencement
0,3,13,37,1,10,1,50,0,vmwarevoice: impact 5g major event around world
0,2,4,33,1,8,0,37,0,brexit: tusk say uk trade deal priority
0,2,2,54,2,9,0,56,0,donald trump 'blackmailed bribed' foreign government
0,1,2,34,0,7,0,36,0,expert fear health london whale
0,1,4,15,0,4,0,19,0,making lost time
0,3,9,55,4,10,0,64,0,arkansas gov. hutchinson executions: absolutely made right decision
0,1,6,38,0,7,0,44,0,new guidance issued military trial detainee
0,2,10,47,0,9,0,57,0,former olympic gymnastics doctor larry nassar hit new charge
0,3,8,23,0,7,0,31,0,follow job interview
0,2,3,44,0,10,0,47,0,lyft launch massive expansion across u
0,1,7,24,3,5,0,31,0,former governor enters debate a.i.g.
0,1,2,21,0,3,0,23,0,protester rally beirut
0,3,5,41,0,7,0,46,0,nasa satellite photo show effect california rain
0,3,17,59,3,16,2,76,0,brand boys: upstart private-equity firm make 40% year gourmet jerky vegan makeup
0,2,1,25,0,5,0,26,0,uber totally narc teen
0,1,6,29,0,7,0,35,0,fifa european union set collide
0,3,12,46,1,11,0,58,0,"month daughter died, mother received two letter fromher"
0,2,5,54,3,10,0,59,0,trump lay military plan; formally introduces james 'mad dog' mattis
0,3,4,42,0,11,0,46,0,new cookie dough shop open nyc best friend
0,3,2,46,0,10,0,48,0,yellen signal fed likely raise rate month
0,3,10,43,5,10,1,53,0,"j.j. watt surprise 8-year-old fan hospital visit, jersey"
0,3,5,47,2,8,0,52,0,khizr khan join immigration lawyer dulles airport [video]
0,1,2,65,1,9,0,67,0,"australian senate sits extra day, pass industrial relation legislation"
0,3,5,70,2,14,0,75,0,"german justice minister: need judges, prosecutor crack fake news facebook"
0,2,9,36,0,8,0,45,0,black hole caught devouring star entire decade
0,1,3,41,0,6,0,44,0,moscow celebrates victory day military parade
0,3,7,36,1,7,0,43,0,elon musk tout latest dream: underground roadway
0,2,11,40,4,8,0,51,0,"keith broomfield, american slain fighting isis, knew risk"
0,3,2,45,1,7,0,47,0,venezuela's maduro pelted protester leaving rally
0,1,3,35,0,6,0,38,0,seven canadian killed israeli air strike
0,1,2,44,0,6,0,46,0,karzai retains lead afghan presidential election
0,3,11,29,3,11,0,40,0,got gay married. got gay divorced. regret both.
0,3,7,34,1,9,2,41,0,10 key moment trump news conference
0,3,3,87,0,13,0,90,0,house democrat ask trump administration remind school must educate undocumented child
0,2,6,57,1,13,0,63,0,miley cyrus weed bar liam hemsworth wayne coyne's birthday party
0,3,7,70,2,13,0,77,0,"south china sea: chinese carrier enters northern water amid renewed tension us, taiwan"
0,2,2,78,0,17,0,80,0,walker want wisconsin first state stop dictating much time kid go school
0,2,9,31,2,9,1,40,0,song +1: devastating new film nick cave
0,2,13,52,1,13,3,65,0,ronda rousey's mother speaks defense daughter following ufc 207 loss
0,2,6,40,2,5,0,46,0,"laramie, wyoming pass lgbt anti-discrimination bill"
0,3,10,46,2,9,0,56,0,always point: remembering phife dawg's legacy lyric
0,1,2,64,0,8,0,66,0,eyewitness challenge egyptian state medium impartiality fatal protest
0,1,2,42,0,8,0,44,0,eu report favour adopting open source software
0,2,12,55,1,16,0,67,0,democrat deft firearm tightens race senate new york time
0,1,1,38,1,6,3,39,0,indian airliner crashes; nearly 160 presumed dead
0,1,4,43,0,7,0,47,0,alleged war criminal radovan karadi caught serbia
0,2,9,33,3,11,0,42,0,ignored trump news week. here learned.
0,2,6,78,5,16,0,84,0,un resolution israel doesnt include sanctions. could hurt israel economy same.
0,3,11,35,4,10,0,46,0,watch jay z tell jay electronica: 'let's put album out'
0,1,4,47,1,8,0,51,0,"child stabbed west bank arson, israeli settler retaliate"
0,2,6,52,1,10,0,58,0,oklahoma city thunder rivalry warriors? absolutely
0,3,6,59,0,13,0,65,0,john mccain tell donald trump prove obama wiretap claim else retract
0,3,13,51,2,13,4,64,0,inside forbes: we're kicking 2017 embracing next wave medium reality
0,3,7,36,0,9,1,43,0,6 shot memorial victim chicago gun violence
0,1,7,27,1,6,0,34,0,ex-apple executive named chief palm
0,3,12,23,3,8,0,35,0,"espn's nfl mvp poll: ryan, rodgers rise"
0,3,6,77,1,12,0,83,0,london terror attack: isi claim responsibility deadly rampage outside parliament building
0,2,13,55,4,12,0,68,0,former mexican president vicente fox warns donald trump: 'dont mess around us'
0,1,6,36,0,6,0,42,0,david cameron elected new uk conservative leader
0,1,14,61,1,10,4,75,0,2008 autotronics taipei: participant industry participate computex uncertainly
0,1,10,46,1,12,0,56,0,"well ahead final group masters, wood mickelson put show"
0,1,3,47,0,8,0,50,0,dutch member parliament proposes abolish cabinet
0,3,14,54,5,15,2,68,0,j. cole return 40-minute documentary titled 'eyez' two video new album
0,2,2,44,0,8,0,46,0,oil fall investor expect little doha meeting
0,1,5,19,0,5,0,24,0,job data give share lift
0,1,6,21,1,6,0,27,0,"sun, oracle see software gem"
0,2,2,30,3,7,3,32,0,biden pledge available penny 24-7
0,1,9,32,2,8,0,41,0,arab state aligned u.s. savor turmoil iran
0,2,8,29,1,6,0,37,0,imf stand greek bailout unnerves europe
0,3,13,46,3,12,0,59,0,vehicle tupac notorious b.i.g. killed auction
0,3,8,43,0,10,0,51,0,israeli minister advance plan take syrian war orphan
0,2,11,44,3,9,0,55,0,gymnastics scandal: dr. larry nassars fellow doctor rebuked msu
0,2,5,50,1,10,3,55,0,boeing 787 dreamliner show vertical takeoff| latest news video
0,2,5,36,1,10,0,41,0,go viral weibo china business insider
0,1,6,40,2,5,0,46,0,"ecuador re-elects president, preliminary result show"
0,1,5,34,0,7,0,39,0,new york city mass transit facing service cut
0,2,17,37,3,9,0,54,0,"fact check: clinton speech trump atlantic city, annotated"
0,3,1,61,0,10,0,62,0,first photo revolutionary new weather satellite gorgeous
0,3,1,60,0,10,0,61,0,baltimore police release body camera video shooting first time
0,1,6,32,0,6,0,38,0,role player mended fraying celtic
0,3,11,52,1,12,0,63,0,warrior reportedly ask tnt tell shaquille oneal lay javale mcgee
0,2,8,29,4,6,0,37,0,im courtside lebron! (in virtual reality)
0,2,3,58,3,10,0,61,0,president obama unveils last budget tomorrow. here matters.
0,3,5,37,0,7,0,42,0,byron buxton make minnesota twin debut sunday
0,2,8,38,2,8,0,46,0,turkey islamic fashion revolution new york time
0,2,3,61,3,15,2,64,0,"gunshot injury cost least $6.6 billion u eight year span, study find"
0,2,4,48,1,9,0,52,0,vince carter ejected throwing elbow devin booker head
0,3,11,58,2,11,0,69,0,"mel b claim husband beat, humiliated restraining order declaration: report"
0,1,3,35,1,6,2,38,0,canadian-born actor leslie nielsen dy aged 84
0,1,4,52,0,9,0,56,0,six afghan civilian killed explosion near u military base
0,3,3,17,0,5,0,20,0,final four set
0,1,2,65,0,11,4,67,0,spanair mechanic questioned criminal suspicion flight 5022 crash
0,1,2,30,0,8,3,32,0,many 100 civilian die afghan raid
0,1,8,31,2,8,0,39,0,george h. w. bush attend sydney ceo conference
0,1,11,31,2,10,0,42,0,"a-rod, new chapter say much word"
0,1,7,41,4,11,6,48,0,"body somali pirate, carrying $153,000 ransom, wash ashore"
0,1,6,49,2,10,0,55,0,dozen left dead caribbean hurricane dennis move toward u.s.
0,3,1,59,1,10,0,60,0,psychedelic drug found induce higher level consciousness study
0,3,6,57,2,10,0,63,0,trump sending national security adviser h.r. mcmaster afghanistan
0,2,3,48,0,8,0,51,0,american college student feel trump presidency
0,2,8,38,0,7,0,46,0,blood bank see massive response orlando attack
0,3,9,45,0,8,0,54,0,valuable india bank plan largest perpetual debt offering
0,1,4,49,1,8,0,53,0,uk mother cleared attempted murder me-suffering daughter
0,2,9,44,4,10,2,53,0,iran strike back u.s. reciprocal sanction 15 company
0,3,2,68,3,12,2,70,0,"first, 55 school faced sexual violence investigations. list quadrupled."
0,1,4,60,0,9,0,64,0,committee protect journalist call release gambian journalist
0,3,12,53,2,14,0,65,0,"carl paladino, trump ally, say racist remark obamas sent error"
0,2,2,58,1,11,0,60,0,"body seventh victim found italy hotel avalanche, court open probe"
0,3,12,39,2,13,2,51,0,disney hike u park ticket price 4.9 pct fox business
0,3,1,48,1,6,0,49,0,"immigration ban leaf child stranded, family split"
0,1,3,36,0,6,2,39,0,ira asset worth 30 million pound investigated
0,2,7,62,1,16,0,69,0,justin trudeau take aim matthew perry best rest april fools' day
0,2,1,36,0,4,0,37,0,vietnamese villager free police hostage
0,1,3,27,1,6,6,30,0,"un report 222,570 dead haiti earthquake"
0,3,5,47,3,8,0,52,0,tottenham hotspur v southampton: premier league live updates!
0,3,4,59,0,13,0,63,0,change donald trump already made since sworn president
0,2,3,55,2,9,0,58,0,pwc issue 'sincere apology' oscar best picture envelope mistake
0,3,10,40,1,8,0,50,0,"renault, fiat darken auto industry outlook vw settle"
0,1,5,53,0,9,2,58,0,remaining expedition 25 crew launch international space station
0,2,4,81,1,15,0,85,0,"samsung chief jay lee stave arrest warrant amid corruption scandal, prosecutor keep chasing"
0,2,3,51,3,13,0,54,0,'pharma bro' martin shkreli say hit face dog poop
0,3,10,46,1,9,0,56,0,watch live: josh earnest delivers final white house press briefing
0,3,16,62,3,14,0,78,0,"new york giant giants' nikita whitlock say burglar left swastika, kkk racist graffiti"
0,3,8,48,0,8,0,56,0,aaron hernandez trial aaron hernandez acquitted double murder
0,2,1,62,1,16,2,63,0,one glass white wine day raise risk developing skin cancer 13%
0,1,3,33,0,6,0,36,0,two kenyan kidnapped somalia gunman
0,2,8,32,1,7,0,40,0,new arkansas law let men block wives' abortion
0,2,7,42,0,7,0,49,0,netflix spokesperson say prince discussed reality show
0,2,6,68,3,14,6,74,0,san francisco 49ers could trade quarterback colin kaepernick 2016 -- clayton's mailbag
0,2,4,54,2,8,0,58,0,"mohammed shami, india cricketer, defends wife twitter troll"
0,3,9,72,3,12,0,81,0,mcdonald's shuts branch across u 'day without immigrants' protest donald trump
0,2,12,52,4,12,0,64,0,"trump tweet hyping judge jeanine show wasnt criticism paul ryan, aide say"
0,1,11,51,3,9,0,62,0,russian businessman viktor bout accuses d.e.a. agent extradition fight
0,3,9,33,2,7,0,42,0,indonesia cut tie j.p. morgan downgrade
0,1,6,34,0,6,0,40,0,virgin medium universal reach download deal
0,2,3,46,2,11,2,49,0,69-year-old gordie howe suited gave fan lastshow
0,3,4,50,1,9,0,54,0,wall st: u share tread water amid rising geopolitical tension
0,2,8,30,2,9,0,38,0,sean spicer say 'our intention never lie'
0,1,6,59,2,12,2,65,0,"confirmed dead kata air an-32, moldova asks russian investigatory help"
0,1,13,20,4,8,6,33,0,2007/08 uefa women's cup: ffc frankfurt vs. ume ik
0,1,8,37,0,9,0,45,0,dan savage win webby award get better project
0,3,9,45,0,9,0,54,0,china proposes deal ease tension north korean missile
0,1,5,22,1,6,4,27,0,"japan airline plan cut 1,200 job"
0,3,10,42,2,10,0,52,0,elon musk's energy storage fix australia enough
0,3,4,72,5,15,0,76,0,trump said hell totally destroy johnson amendment. people care?
0,3,4,23,2,6,1,27,0,power rankings: tight race no. 1
0,2,3,39,0,9,0,42,0,iran begin annual navy drill strait hormuz
0,2,6,26,1,7,0,32,0,next arab revolt algeria?
0,1,5,36,0,6,0,41,0,kenyan win international race silvestre
0,2,5,42,1,8,0,47,0,"uk failing syrian refugee survived torture, say mp"
0,2,8,40,0,10,0,48,0,trump deepens goldman tie build economic team
0,1,1,34,0,5,0,35,0,guinea swears civilian prime minister
0,2,12,33,1,11,0,45,0,"move white house, trump may dump dc hotel"
0,2,2,47,2,6,0,49,0,myanmar military crackdown rohingyas 'has ceased'
0,3,1,46,0,9,0,47,0,policeman rescue woman burning car nick time
0,2,9,46,0,9,0,55,0,stephen curry disagrees armour ceo donald trump
0,3,13,55,2,14,0,68,0,mike tyson promise teach chris brown 'every dirty trick' bout soulja boy
0,2,11,36,3,9,0,47,0,"u.s. ceo become optimistic outlook sales, job"
0,2,9,26,0,6,0,35,0,fan reportedly dy live wwe event
0,3,2,32,0,6,0,34,0,jewish art challenge taboo jesus
0,3,5,53,4,11,0,58,0,"george w. bush say ""we need answers"" trump team-russia connection"
0,2,2,59,4,10,0,61,0,hillary clinton's unpaid intern limbo: grassroots campaign 'free help'
0,2,10,65,1,10,0,75,0,"house republican propose rule punish broadcasting, photography chamber floor"
0,1,7,39,0,9,0,46,0,judge plead guilty scheme jail youth profit
0,1,2,54,5,10,0,56,0,"'denmark attacked' say one expert, 'denmark safe' say another"
0,3,4,49,1,10,0,53,0,turkey mourns victim new year eve nightclub attack
0,2,9,46,0,9,3,55,0,airbnb deleted nearly 100 illegal san francisco listing injanuary
0,2,12,51,0,11,0,63,0,actress yara shahidi shared beautiful post iranian andblack
0,1,2,57,1,10,0,59,0,anwar's lawsuit gay slur former malaysian premier dismissed
0,3,7,56,1,11,0,63,0,hhs nominee skirt question impact trump executive order aca
0,1,2,43,0,7,0,45,0,stone thrown protester kashmir kill civilian
0,2,1,64,3,10,0,65,0,shelf bone replacement offer life-changing help landmine victim
0,1,10,38,1,10,0,48,0,"china, pelosi talk hu wen climate change"
0,2,2,46,1,7,0,48,0,turkish-led force advance outskirt syrian city
0,3,13,59,4,14,0,72,0,"india's string pearl singapore vietnam, india train indonesian force"
0,2,8,18,2,5,4,26,0,2017 nfl mock draft: post-shrine game
0,1,3,37,0,7,2,40,0,author playwright keith waterhouse dy 80
0,3,3,47,4,13,3,50,0,fire cockpit! apollo 1 disaster 50 year later.
0,3,13,61,3,14,0,74,0,sean spicer citing atlanta terror attack never happened: 'clearly meant' orlando
0,1,4,31,0,5,0,35,0,major snowstorm sweep across eastern u
0,1,6,21,2,7,1,27,0,u.s. kill 5 afghan raid house
0,1,3,66,0,9,0,69,0,fda report criticizes condition factory produced recalled medication
0,2,3,41,0,6,0,44,0,american art museum cautiously embrace pokmon go
0,2,9,44,0,10,0,53,0,man proposes dream girl legacy brick viking stadium
0,2,3,63,1,11,0,66,0,norway: police detonate explosive device found busy oslo city centre street
0,3,2,44,1,8,3,46,0,pregnant waitress get $900 tip day christmas
0,3,8,25,0,7,0,33,0,muslim teen finally box hijab
0,3,4,67,4,14,0,71,0,stop obsessing secret trump russia. already know bad enough.
0,3,7,19,1,5,4,26,0,ranking mlb's top 2017 sleeper team
0,2,11,50,5,10,0,61,0,comic india call donald trump 'america's arranged marriage' 'conan'
0,1,5,33,0,5,0,38,0,mccartney campaign changing mind ira
0,2,9,41,2,10,0,50,0,"future brings drake, migos, ty dolla sign coachella"
0,2,13,50,5,13,0,63,0,'pretty little liars' star lucy hale hacker released nudes: 'kiss ass'
0,3,14,48,2,13,0,62,0,"jason derulo enlists nicki minaj ty dolla sign new track ""swalla"""
0,1,3,50,2,7,0,53,0,"three-car accident birmingham, england leaf eight injured"
0,2,7,50,1,10,0,57,0,salesforce invests wearable startup apx lab business insider
0,1,2,42,1,6,0,44,0,china overtakes germany world's biggest exporter
0,2,1,18,1,3,0,19,0,cuba world fantasy
0,1,5,42,1,11,3,47,0,"gladys powers, last female veteran world war dy age 109"
0,3,6,29,2,10,0,35,0,wonder woman un? real one?
0,2,6,76,0,16,0,82,0,trump administration could turn back liberal world order created world war ii
0,2,14,37,1,9,0,51,0,"tsa, dhs bar electronic device overseas flight"
0,1,1,67,0,9,0,68,0,iraq election commission refuse recount vote parliamentary election
0,3,6,50,1,10,4,56,0,australian open 2017: andy murray suffers shock defeat mischa zverev
0,1,4,28,0,7,2,32,0,suspect held killing parent 17
0,3,1,62,0,8,0,63,0,french presidential election polling station open heavy security
0,1,1,36,0,4,0,37,0,scientist confirm new superheavy element
0,2,8,39,1,9,0,47,0,"diet soda raise risk dementia stroke, study find"
0,2,8,39,0,7,0,47,0,economics transitioning america coal clean
0,2,7,77,2,15,0,84,0,"trump's america donald trump accepts russia engaged u election cyber attacks, chief staff say"
0,1,4,27,0,5,0,31,0,u first lady undergoes neck surgery
0,2,5,29,0,4,0,34,0,obsession biblical literalism
0,2,9,40,0,10,0,49,0,hanjin share surge report asset sale close next week
0,3,8,39,1,8,0,47,0,jay z's reebok deal changed sneaker industry forever
0,2,1,36,0,9,0,37,0,man dy car hit train atlevel crossing
0,2,3,58,3,13,0,61,0,soup business grown cold. inside campbell plan turn heat.
0,2,12,47,0,11,0,59,0,eating mediterranean diet could make brain shrink less age
0,1,1,39,0,5,0,40,0,japanese probe snatch first asteroid sample
0,3,11,38,4,11,0,49,0,u.k. join u.s. ban laptop cabin mideast flight
0,2,8,44,1,6,0,52,0,appeal court affirms decision blocking anthem-cigna merger
0,3,6,68,1,10,0,74,0,cybercrime: national integrated response needed say former u ambassador jeff bleich
0,2,13,51,0,13,0,64,0,paul george designing first signature sneaker since kid
0,2,3,39,1,8,2,42,0,somalia mogadishu car bomb: least 16 people killed
0,2,4,68,6,12,0,72,0,found: preserved dinosaur cell -- sadly scientist still can't build 'jurassic world'
0,1,2,65,0,9,0,67,0,voluntary sterilization poor woman proposed louisiana state legislator
0,1,4,27,0,4,0,31,0,sunni lawmaker assassinated iraq
0,2,4,34,1,7,2,38,0,crashed ww2 spitfire fly 3m refit
0,2,5,59,2,10,0,64,0,"kellyanne conway make mistakes, like oscars, say kellyanne conway"
0,2,16,63,3,14,0,79,0,"fed found rnc-related cyberattack month ago raise serious concerns, source say"
0,2,7,51,0,10,0,58,0,former wh photog pete souza troll trump contrasting obama pic
0,3,8,42,0,9,0,50,0,kim burrell fire comment gay lesbian
0,2,1,32,0,4,0,33,0,leaking toilet help jailbirdsescape
0,3,6,52,0,9,0,58,0,new british book prize bame author unveils inaugural longlist
0,1,9,45,3,8,3,54,0,"drug abuse-related government spending hit $468 billion, report say"
0,2,17,58,0,16,0,75,0,delhi high court ruled child born result rape get compensation
0,2,12,45,1,14,0,57,0,donald trump joust cry baby rally new york time
0,3,2,49,2,9,0,51,0,guardian view internet privacy: technology cant fix
0,3,4,51,1,7,0,55,0,yogi adityanath: uttar pradesh chief minister choice criticised
0,3,2,58,0,12,0,60,0,alarm bell ring charity trump pledge ax foreign aid budget
0,1,5,33,0,7,0,38,0,little room maneuver budget britain
0,3,5,45,3,9,3,50,0,"derek fisher's la home burglarized, $300k worth jewelry stolen"
0,1,3,24,0,4,0,27,0,olympic torch reach hong kong
0,2,1,45,1,6,0,46,0,"texas police chief arrested following chase, standoff"
0,2,6,30,0,6,0,36,0,fun fact american president video
0,1,7,33,0,8,0,40,0,investor said less wary german economy
0,1,2,41,0,7,0,43,0,lou piniella retires fifty year baseball
0,1,5,45,0,10,4,50,0,result announced new zealand 2005 general election
0,3,12,52,6,11,0,64,0,"ryan adam cover radiohead's 'karma police,' call trump 'a pretty awful person'"
0,1,3,35,0,6,0,38,0,man decapitated greyhound bus manitoba
0,2,11,42,0,8,0,53,0,actor judge reinhold arrested airport incident tsa
0,1,6,50,1,10,0,56,0,"africa make first draft version unccc treaty, harder goal"
0,1,4,57,1,10,0,61,0,"two santa clara, utah teen critical condition lightning strike"
0,1,1,57,1,10,3,58,0,"philippine firework factory explosion kill least 8, injures 70"
0,1,1,42,0,4,0,43,0,malawian president inaugurated reelection
0,3,3,45,0,8,0,48,0,penny try reassure european leader shaken trump
0,1,6,30,0,7,0,36,0,reporter jailed iran pass week fast
0,2,9,36,2,10,0,45,0,"bail defendant reach, cost mount"
0,2,11,53,3,13,0,64,0,judge jeanine potential voter fraud: 'dead people vote time' insider
0,3,4,70,4,12,0,74,0,fan deride arsenal's 'beyond embarrassing' new banner homage alexis sanchez's dog
0,2,2,50,0,9,0,52,0,sight plane circling manhattan cause stir social medium
0,2,13,42,2,11,0,55,0,"awards? spur could care less, kawhi leonard still might win mvp"
0,3,7,42,2,6,0,49,0,sothebys auction record-breaking diamond earring
0,2,11,55,1,11,0,66,0,critic threaten boycott simon schuster milo yiannopoulos book deal
0,2,1,66,0,12,0,67,0,million worker would eligible overtime pay new federal rule
0,2,3,71,0,14,1,74,0,9 popular job professional football player take retiring nfl
0,3,2,56,0,11,0,58,0,chrissy teigen time troll question fertility plan
0,3,7,81,0,16,0,88,0,cavs reportedly shot potential trade knicks involving kevin love carmelo anthony
0,3,3,28,1,6,0,31,0,russia's ambassador un died
0,1,5,26,0,6,0,31,0,swine flu migrates china japan
0,1,7,34,0,8,0,41,0,fiat chief warns chrysler union need cut
0,2,3,58,1,12,0,61,0,show anyone say muslim condemn terror attack list
0,2,9,54,2,9,0,63,0,mini-donald trump steal show pre-inauguration festivity insider
0,2,13,45,1,11,0,58,0,"jews, muslim indian american unite hate crime u"
0,2,8,34,2,9,0,42,0,electric car that's going trump tesla?
0,1,5,25,0,5,0,30,0,china reopen tibet tourist
0,1,6,37,0,6,0,43,0,change fred thompson u presidential campaign
0,2,4,76,1,12,0,80,0,chapecoense crash: grieving brazilian town chapeco receives body soccer plane crash
0,1,5,36,0,4,0,41,0,obama announces strategy cyberattacks
0,1,5,29,0,5,1,34,0,washington post name 2 managing editor
0,2,5,63,3,15,0,68,0,final call free g&t: ba start charging food drink short-haul economy
0,1,8,29,0,7,0,37,0,time running short cit find financing
0,3,12,52,2,11,0,64,0,final showdown resolve russell westbrook vs. james harden mvp debate?
0,2,6,21,0,7,4,27,0,dallas pd loses 99 officer 75 day
0,3,8,67,0,12,0,75,0,brendon mccullum facing suspension brisbane heat lose perth scorcher gabba
0,3,4,52,1,9,0,56,0,live updates: trump order missle strike syria military target
0,2,10,42,0,7,0,52,0,fbi investigating identity violent uc berkeley rioter
0,1,3,22,0,3,0,25,0,google planning paypal rival
0,3,17,54,0,16,0,71,0,drawing trans teen become symbol fight trans bathroomrights
0,2,8,45,1,10,0,53,0,player harrowing tale sexual abuse rock soccer britain
0,2,10,44,2,9,0,54,0,"conservative wonder, real donald trump please stand up?"
0,3,1,52,1,7,0,53,0,"gas company manufactured shortage myth, economist say"
0,3,1,62,3,15,0,63,0,gadget meant streamline life pine typewriter ping?
0,2,3,49,2,10,0,52,0,"robot take people's job pay taxes, say bill gate"
0,1,4,30,0,5,0,34,0,rocket hit u consulate afghanistan
0,1,4,53,1,7,0,57,0,canadian light aircraft stolen; wisconsin state capitol evacuated
0,1,1,41,0,10,7,42,0,cyprus charge five 2005 plane crash killed 121
0,1,2,48,0,7,0,50,0,fourteen dead passenger helicopter crash estonia
0,2,1,44,1,7,3,45,0,twitter raise 140-character limit direct message
0,1,3,37,0,8,1,40,0,bus crash spain leaf 9 finnish tourist dead
0,2,13,43,1,13,2,56,0,"17 tumblr post dad make smile, laugh maybecry"
0,2,7,35,1,6,0,42,0,charity account become hot holiday must-have
0,3,6,31,2,6,0,37,0,two charged hamilton ticket ponzi scheme
0,1,2,29,0,6,0,31,0,three killed utah coal mine rescue
0,3,5,29,2,4,0,34,0,here's rihanna's next puma collaboration
0,2,13,56,4,14,0,69,0,draymond green rip raider leaving oakland la vegas: 'you that'
0,3,9,33,0,8,0,42,0,fatal nyc crane collapse blamed operator error
0,2,4,18,1,4,0,22,0,baseball forever
0,3,10,44,3,9,0,54,0,"inauguration eve, trumpsters party 'swamp' washington"
0,2,1,71,0,16,2,72,0,rise woman age 65 getting married avoid spending long retirement alone
0,2,6,56,5,14,6,62,0,"steelworker $100,000 warren buffetts march madness pool. may lose job."
0,2,4,57,2,12,0,61,0,"redskin miss in-demand wade phillips, agrees term ram"
0,2,10,46,1,11,0,56,0,oakland cf billy burn make pair outstanding catch vs. texas
0,2,2,21,0,4,0,23,0,bidding tuna tsukiji
0,3,7,49,4,8,0,56,0,syria war: arab-kurdish fighter enter is-held deir al-zour province
0,2,1,70,3,14,0,71,0,there's evidence much exercise affect health always better
0,2,3,50,2,10,0,53,0,far 'presidential' trump uniter candidate trump
0,3,2,46,0,9,0,48,0,least five people die train explodes bulgaria
0,2,1,50,1,8,0,51,0,"trump supporter declare pride president, slam opponent"
0,3,9,37,0,8,0,46,0,armour ink first pro sport league uniform deal
0,1,4,33,3,7,0,37,0,u.k. mps' expense investigated police
0,1,5,46,2,8,0,51,0,"series earthquake hit korea, indonesia, turkey norway"
0,3,1,48,3,9,0,49,0,oslo terror alert bomb-like device found police
0,3,12,32,2,12,5,44,0,"china aim no. 1 globally evs, autonomous car 2030"
0,1,4,47,1,9,0,51,0,nigeria swears new president death umaru yar'adua
0,3,2,72,3,13,0,74,0,one apple's underappreciated business exploding chart show much
0,1,5,42,0,11,2,47,0,two time tour de france winner laurent fignon dy age 50
0,3,7,46,0,9,2,53,0,kevin gate reportedly sentenced 30 month weapon charge
0,1,6,39,0,6,0,45,0,stimulus plan encounter stiff resistance senate
0,3,1,49,0,8,0,50,0,internet data absolutely national security issue
0,1,5,23,0,7,2,28,0,u senator robert byrd dy age 92
0,1,5,31,2,7,0,36,0,"wounded, story loss, fill hospital"
0,3,6,30,1,6,0,36,0,trump revised travel ban excludes iraqi
0,3,8,44,0,7,0,52,0,trump considering crackdown welfare legal immigrant
0,1,1,60,1,9,0,61,0,"schwarzenegger head back work feeling ill, hospitalized"
0,3,5,53,2,10,0,58,0,al-qaeda's deputy leader reportedly killed u drone strike syria
0,2,3,56,0,10,0,59,0,smartphones lift samsung electronics best profit two year
0,1,6,31,0,7,0,37,0,geithner hint harder line china trade
0,1,1,32,0,5,0,33,0,largest exoplanet far discovered
0,1,6,38,0,5,0,44,0,surveillance effort draw civil liberty concern
0,1,2,30,0,6,2,32,0,suicide bomber kill 24 child iraq
0,2,8,47,0,7,0,55,0,witness come forward following facebook livestream gang rape
0,2,9,51,1,9,0,60,0,court ruling raise number legally non-binary californian seven
0,3,11,56,2,13,2,67,0,"jack johnson, norah jones phil lesh headline monterey pop 50th anniversary fest"
0,2,12,44,3,14,2,56,0,anna dewdney dy author llama llama book 50 new york time
0,3,4,60,3,11,0,64,0,"robert kennedy jr. say chair ""vaccination safety"" committee trump"
0,2,2,77,5,14,0,79,0,public policy expert: trump claim drug cheaper candy bar isnt entirely untrue
0,3,9,52,3,10,0,61,0,u.s. commando killed yemen trump first counterterrorism operation
0,2,9,37,2,8,0,46,0,biggest loser host bob harper suffers heart attack
0,1,1,33,0,4,0,34,0,togo opposition want election delayed
0,3,4,78,5,13,0,82,0,elvis impersonator 'stole collection mother-in-law's funeral singing wonder you'
0,1,13,39,2,7,0,52,0,canadavotes: ndp candidate katy austin running simcoegrey
0,3,5,56,2,9,0,61,0,county round-up: jonathan trott century warwickshire hold surrey
0,2,1,42,1,10,0,43,0,need sleep sign pending dementia?
0,2,8,23,1,8,5,31,0,nfl draft 2017: round 1 grade every pick
0,3,8,37,1,10,2,45,0,paschi seek state aid italy set $21 billion bank
0,1,3,70,5,10,0,73,0,putin's critic dismisses kremlin's accusation litvinenko's case 'science fiction'
0,2,4,58,0,14,5,62,0,britain set hotter saudi arabia warmest february 20th 160 year
0,2,7,39,3,6,0,46,0,another democrat trash elie wiesel: holocaust whore
0,3,4,52,1,9,0,56,0,ted cruzs strange prediction upcoming supreme court vacancy
0,3,3,57,1,15,0,60,0,get drone christmas? know law take sky
0,2,3,64,0,13,0,67,0,man hand st albans home raided police drug operation
0,3,11,38,1,12,0,49,0,draw line come free speech online?
0,1,7,42,0,10,0,49,0,budget pass critic say deficit detail
0,2,13,47,0,13,2,60,0,12 run throughout year fibit help stay motivated
0,1,7,32,2,6,0,39,0,japan eliminates u.s. world baseball classic
0,1,8,22,0,5,0,30,0,nasa satellite fails reach orbit
0,1,4,33,0,4,0,37,0,invoking presidential revelatory moment
0,1,7,68,1,11,0,75,0,serena williams win wimbledon women's single title defeating venus williams
0,1,4,37,0,4,0,41,0,beijing investigates transplant tourist
0,1,5,32,0,4,0,37,0,chinese dissident charged subversion
0,2,8,43,0,7,0,51,0,dion waiter share body transformation since joining heat
0,1,2,37,0,6,0,39,0,score killed bombing pakistani shrine
0,2,10,35,2,9,0,45,0,ann coulter: gop blame victim medium rape breitbart
0,3,1,66,0,12,2,67,0,new startup app let dispensary legally deliver marijuana 60 minute less
0,2,1,46,1,10,8,47,0,"initial jobless claim hold 300,000 93rd straight week"
0,1,2,50,1,9,0,52,0,released video: israeli soldier shoot bound man short range
0,2,2,54,2,11,0,56,0,"another year, another day one wearing trouser london's tube"
0,2,2,42,0,11,4,44,0,large fire burn dubai near site dramatic 2015 blaze
0,3,4,30,2,7,0,34,0,'weather bomb' named doris batter uk
0,3,15,64,1,16,0,79,0,"grilled cheese donut totally real, absolutely insane food item need life"
0,1,6,27,0,5,0,33,0,english sweep across europe
0,1,2,26,0,5,2,28,0,expedition 33 crew return earth
0,1,1,51,1,6,0,52,0,polish leader discus anti-missile shield negotiation
0,1,7,40,1,7,0,47,0,ex-state senator pennsylvania sentenced fraud
0,1,2,76,0,10,0,78,0,berlusconi proposes january election government fails gain parliamentary majority
0,3,3,87,2,16,2,90,0,duke edinburgh's award celebrates 60th anniversary first ever gold award winner admits took short-cut
0,3,5,40,0,9,0,45,0,u uk explore possibility aid airdrop syria
0,1,2,44,0,7,0,46,0,stabbing massachusetts high school leaf one dead
0,2,5,51,3,11,0,56,0,"what's angle? breaking putin, trump obama spy game"
0,3,3,51,1,6,0,54,0,iran election: ahmadinejad register despite khamenei warning
0,2,7,31,1,6,0,38,0,beyonc facetimes fan who's battling cancer
0,2,4,26,0,5,0,30,0,confession lebron james hater
0,1,4,29,0,5,0,33,0,atlantis land kennedy space center
0,1,6,28,0,6,0,34,0,truck bomb kill dozen northern iraq
0,1,2,26,0,6,0,28,0,man buy stolen camera ebay
0,1,3,44,1,6,0,47,0,prime minister thailand survives no-confidence vote
0,3,9,50,2,13,2,59,0,trump vow end 'american carnage' sworn 45th president
0,3,10,45,2,9,0,55,0,"ex-teacher wanted child porn charge kill himself, source say"
0,3,2,42,1,10,4,44,0,afcon 2017: agassa may play fan attack house
0,2,3,66,1,10,0,69,0,trump's chief strategist steve bannon stripped national security council role
0,2,4,50,4,8,0,54,0,politics!: trump slam democrat budget twitter outburst
0,1,5,78,1,12,0,83,0,france protest treatment government minister u authorities; u government admits mistake
0,2,2,64,3,13,1,66,0,trump want $1 trillion investment road bridges. drilling help?
0,1,5,31,0,6,0,36,0,justice hear case tuition disabled
0,2,2,87,2,15,0,89,0,cyprus reunification talks: everything need know one world's intractable dispute
0,2,1,43,1,6,0,44,0,delta's latest mess highlight industry weakness
0,3,8,43,0,8,0,51,0,well fargo board scrape election tough meeting
0,2,4,53,1,11,0,57,0,climate hope city: minecraft tell story climate change
0,1,6,37,0,6,0,43,0,medicare system overhaul proposed two senator
0,1,6,35,2,7,0,41,0,u.s. isps test restricting heavy internet user
0,2,3,51,2,9,0,54,0,samsung mobile recovery suffers blow galaxy note catch fire
0,2,1,76,2,9,0,77,0,breast cancer charity condemns 'disastrous' recommendation block pioneering treatment
0,1,1,42,0,7,2,43,0,23 australian arrested global child porn network
0,3,3,31,0,5,0,34,0,air china suspends flight pyongyang
0,3,12,39,2,11,0,51,0,market say inflation coming. data show isnt true
0,1,1,47,1,7,0,48,0,philippine shipwreck kill man; rescue boat also rescued
0,2,14,53,1,13,0,67,0,mehbooba mufti say there'll peace till pandits feel safe living kashmir
0,3,5,57,0,9,0,62,0,lgbtq community receives state apology parliament inequality
0,3,4,41,2,10,0,45,0,"woman duped role kim jong nam's death, police say"
0,1,6,78,1,14,0,84,0,australian rule football: six goal win move morwell second gippsland football league ladder
0,1,4,58,2,11,0,62,0,"canadian foreign affair minister accused called liberal mp ""dog"""
0,3,13,51,1,13,5,64,0,"fuel worth r 60,000 crore wasted annually due heavy traffic congestion delhi"
0,3,11,47,3,12,5,58,0,11-year-old girl hailed hero calling 911 home invasion yahoo
0,2,3,42,0,9,0,45,0,u soccer say player must stand national anthem
0,3,4,50,2,9,0,54,0,former oxford english dictionary editor explains word 'pom'
0,1,6,32,0,6,0,38,0,louisville clear another hurdle big east
0,2,2,62,3,12,0,64,0,ultra-rich scooping real estate ditching hedge fund [video]
0,3,4,48,1,10,0,52,0,glimpse history: photo young harriet tubman surface
0,2,7,39,4,10,2,46,0,"alan thicke, reassuring father growing pains, dy 69"
0,2,1,64,1,12,0,65,0,"bergdahl bear responsibility risky mission find him, judge say"
0,3,6,46,3,11,0,52,0,mccain rebuke trump: 'we bringing back torture' u
0,3,4,54,1,9,0,58,0,protester still plan march along mark zuckerberg's hawaiian wall
0,1,1,27,0,3,0,28,0,australian need bigger toilet
0,2,6,62,3,15,0,68,0,live david davis: britain 'frightened' leaving eu without deal
0,1,4,39,1,6,0,43,0,man breach security london's heathrow airport
0,3,9,35,0,8,0,44,0,drake preview new music party london
0,2,5,37,2,8,0,42,0,trump vision economy vs. actual economy
0,1,6,30,0,5,0,36,0,two nato soldier captured afghanistan
0,2,5,54,1,8,0,59,0,fox news settled sexual harassment allegation bill o'reilly
0,1,4,34,0,7,0,38,0,melbourne victory held draw perth glory
0,2,5,23,3,5,6,28,0,post-signing day way-too-early 2017 top 25
0,3,9,50,2,14,2,59,0,markelle fultz big man campus 2.0: inside making superstar
0,3,5,46,1,8,0,51,0,"trump aide boris epshteyn leaving white house, official say"
0,2,1,27,1,6,0,28,0,"lesson father, kid"
0,3,8,82,1,13,0,90,0,trump's america donald trump campaign star kellyanne conway named white house presidential counsellor
0,3,5,29,0,4,0,34,0,eurozone growth buck political unease
0,1,8,43,0,9,0,51,0,french council defangs plan crack internet piracy
0,2,3,51,0,12,2,54,0,david pogue tested 40 bluetooth earbuds find best best
0,2,4,46,1,8,0,50,0,"lawyers, others vie piece nfl concussion settlement"
0,1,2,36,0,7,0,38,0,china europe face new avian flu outbreak
0,2,11,50,3,10,0,61,0,billy bob thornton 'never trusted happiness' since brother's death
0,1,3,44,0,6,0,47,0,african union considers proposal resettle haitian
0,3,9,42,0,9,0,51,0,tim williams admits failed multiple drug test alabama
0,2,8,45,1,12,0,53,0,take peek inside apple's swanky new upper east side store nyc
0,1,5,30,3,6,3,35,0,invest another $100 madoff (hammer included)
0,3,12,46,0,13,2,58,0,texas teacher claim canned porn 16 year ago
0,2,4,59,1,12,0,63,0,theresa may's plan trigger brexit next month clear major hurdle lord
0,2,13,56,3,12,0,69,0,"'this muslim ban,' donald trump claim controversial immigration move"
0,2,1,69,0,10,0,70,0,australia lead international push protect far eastern curlew extinction
0,1,4,30,0,6,4,34,0,norway win eurovision song contest 2009
0,2,1,68,0,13,0,69,0,gambling industry find plenty political gun hire defend status quo
0,3,5,59,1,14,0,64,0,live blog: gop health care bill pulled republican leader fail get vote
0,2,9,50,5,10,0,59,0,watch niall horan's confident performance 'this town' 'tonight show'
0,2,5,33,3,8,0,38,0,"uber, lyft airbnb fare trump?"
0,3,1,51,0,8,0,52,0,dangerous wintry weather arrives road across country
0,1,5,28,2,5,0,33,0,nsa participate u.s. cybersecurity
0,2,1,71,1,13,2,72,0,paris clashes: 13 arrested scuffle break protest police brutality
0,3,5,46,3,10,1,51,0,h-1b visa mostly benefit asians. trump opposes them?
0,1,5,24,0,6,0,29,0,google decides pull plug
0,2,9,80,2,16,0,89,0,"trump's america donald trump knew week michael flynn misleading russia, white house say"
0,1,9,39,0,9,0,48,0,formula one threatens sue team seceding cost cap
0,3,2,44,1,8,0,46,0,brazil prison escape: fugitive post selfies run
0,3,9,30,1,10,0,39,0,steve nash time met trump fox business
0,2,8,48,4,11,4,56,0,pentatonix's 'christmas' album spends second week no. 1 billboard 200
0,3,3,66,2,15,4,69,0,"golden globes: red carpet glamour winner 2017 awards, happened"
0,3,2,50,0,9,0,52,0,silent march downtown chicago mark year violence
0,1,5,34,0,6,0,39,0,google remove german bmw search result
0,2,3,14,1,2,0,17,0,senator mitt romney?
0,2,9,40,3,9,0,49,0,"oreillys trouble give viewer pause, still watch"
0,3,12,34,3,11,0,46,0,watch rae sremmurd snoop dogg light new 'ggn' teaser
0,1,8,31,1,9,0,39,0,"zimbabwe, deal likely fly fail week"
0,3,2,30,3,6,2,32,0,cop tase 91-year-old man alzheimer's
0,3,9,32,3,9,0,41,0,star wars: last jedi movie trailer released
0,3,3,16,0,2,0,19,0,telegraph showing
0,3,4,49,0,8,0,53,0,rolling stone debut new music video starring kristen stewart
0,2,8,64,0,14,0,72,0,fox business host trish regan primed roger ailes replacement megyn kelly
0,2,6,42,0,7,0,48,0,trump supporter unwittingly wave russian flag atcpac
0,3,5,25,3,5,0,30,0,cleaning oceans' 'plastic soup'
0,3,2,30,1,6,2,32,0,general tso's chicken inventor dy 98
0,2,5,51,2,13,0,56,0,"chain collision pepsi, united sean spicer fail one meme"
0,3,1,29,0,7,0,30,0,live learn great loss
0,2,10,44,1,10,0,54,0,jerry falwell jr. asked lead trump higher education task force
0,2,3,72,1,13,0,75,0,fbi arrested troll sent seizure-inducing tweet journalist epilepsy
0,3,10,42,1,11,0,52,0,italy banca monte dei paschi seek time raise capital
0,3,11,54,2,10,0,65,0,white house penalize kellyanne conway plugging ivanka trump's brand
0,2,1,62,0,12,0,63,0,trudeau questioned ethic watchdog report cash access
0,2,11,51,1,14,2,62,0,bombing turkey kill 13 soldier wound dozen new york time
0,3,1,46,0,6,0,47,0,spaghetti donut latest frankenfood obsession
0,1,6,33,1,6,0,39,0,"army challenge older recruits, vice versa"
0,2,6,28,0,6,0,34,0,diageo launch new irish whiskey brand
0,1,1,50,0,7,0,51,0,romanian government strengthen law tax evasion
0,1,6,37,2,8,0,43,0,"fa cup: portsmouth defeat west brom, advance final"
0,2,14,72,1,16,0,86,0,breaking news: one dead several hurt passenger train collides freight train luxembourg
0,2,3,46,3,7,0,49,0,senate russia investigator message: adult
0,3,2,74,1,12,0,76,0,royal commission: immigration official quizzed response child sexual abuse
0,2,9,55,1,10,0,64,0,antonio brown apologizes posting video mike tomlin's postgame speech
0,2,3,53,3,9,0,56,0,erdoan brand dutch government nazi remnant fascist video
0,1,3,40,0,5,0,43,0,space shuttle atlantis landing concludes program
0,2,17,45,0,15,0,62,0,teen refused give mcnugget even threatened agun
0,3,1,47,1,9,3,48,0,"theranos shrink almost half, laying 155 employee"
0,1,8,45,1,7,0,53,0,"silicon valley, recruiting clash immigration limit"
0,1,7,50,3,8,0,57,0,"second darwin's sandwich shop open cambridge, massachusetts, usa"
0,1,6,21,0,4,4,27,0,2010 fiba world championship start
0,1,12,39,4,11,0,51,0,paula creamer feeling better aiming win l.p.g.a. tour
0,3,5,57,1,10,0,62,0,jon ossoff ride anti-trump wave potential upset republican georgia
0,2,6,51,0,9,0,57,0,beyonc reference black panther party super bowl halftime show
0,1,7,55,5,12,2,62,0,'davos man' versus 'camp igloo'; 42nd world economic forum convenes swiss alp
0,1,8,44,0,9,4,52,0,defense lawyer dismissed trial 2008 mumbai attack begin
0,2,6,27,1,5,0,33,0,president trump first hour office
0,3,8,42,4,9,0,50,0,'trainspotting' sequel hit u.s. secret sxsw screening
0,2,15,48,2,14,0,63,0,wrong j.r. smith showing inopportune time cavs nba final
0,3,8,49,0,8,0,57,0,pair behind planned parenthood sting video charged california
0,3,14,50,3,13,0,64,0,le'veon bell want dominate nfl. want revolutionize
0,1,5,29,0,4,0,34,0,international court begin first trial
0,2,12,55,2,12,0,67,0,niall horan celebrates st. patrick's day joking irishness twitter
0,3,12,49,1,10,0,61,0,adorable three-legged lamb love sweater steal yourheart
0,2,4,64,5,12,0,68,0,mexican mull response trump's wall: let migrant boycott mcdonald's?
0,3,6,55,1,10,0,61,0,"brexit britain leave european union single market, theresa may say"
0,2,2,42,0,10,2,44,0,trump want 20 percent import tax pay mexicowall
0,2,2,45,0,7,0,47,0,neighborhood cheapest rental inbrooklyn
0,1,7,30,0,8,3,37,0,sailor finish ocean race 121 day sea
0,3,8,29,3,8,0,37,0,"give straight, doc: obamacare dying?"
0,1,4,35,0,9,7,39,0,luis soltren surrender 1968 hijacking pan 281
0,1,2,35,0,5,0,37,0,new orleans police officer commits suicide
0,2,0,59,2,11,2,59,0,99 million-year-old dinosaur tail found chunk amber bought market
0,2,7,42,1,7,0,49,0,birthday burberry? luxury brand add personal service
0,3,2,54,3,11,0,56,0,republican excited trump -- worry he'll say next
0,3,1,43,0,11,1,44,0,fed hike key interest rate second time 3 month
0,1,1,30,0,4,0,31,0,nigeria destroys illegal small arm
0,3,10,42,1,9,0,52,0,kroger make new york city debut murray cheese purchase
0,1,2,34,1,5,0,36,0,astronomer find change saturn's ring
0,1,5,33,1,6,0,38,0,"stint abroad, adjustment begin"
0,1,6,38,0,8,1,44,0,2 firm accused fraud debt settlement practice
0,1,2,31,0,4,0,33,0,heavy earthquake hit philippine
0,1,6,33,0,7,0,39,0,zegna explores new market face downturn
0,1,2,56,0,10,0,58,0,un say investment agriculture needed tackle world hunger
0,1,5,49,0,9,0,54,0,tension continue rise north korea united state
0,1,1,38,2,7,2,39,0,11-year-old boy dy shot liverpool
0,3,10,41,3,8,0,51,0,kuwait extends world-topping rally trader dismiss u.s. ban
0,3,2,59,3,7,0,61,0,trump presidency open door planet-hacking geoengineer experiment
0,1,6,20,0,7,1,26,0,7 die bus crash near hoover dam
0,2,9,41,0,10,0,50,0,dead whale wash ashore end laguardia airport runway
0,1,7,30,0,7,0,37,0,u federal reserve prepares take aig
0,1,3,43,1,6,0,46,0,"tropical storm richard forms, drift towards honduras"
0,3,11,54,1,13,1,65,0,eagle fan's sign thanks viking round 1 pick received sam bradford trade
0,3,2,14,0,2,0,16,0,italy overwhelmed
0,1,11,33,3,8,0,44,0,expert compile mock n.b.a. draft
0,2,8,33,0,9,1,41,0,dreamer released 6 week ice custody
0,3,2,36,1,5,0,38,0,boko haram's female suicide bomber strategy
0,3,1,23,0,4,0,24,0,instagram live video
0,2,52,8,7,12,2,60,0,***live 10pm et*** dangerous faggot tour return california breitbart
0,3,12,59,3,13,0,71,0,bruno mar teach james corden fashion elvis 'carpool karaoke': watch
0,3,7,61,2,12,0,68,0,cambodia's water people pushed phnom penh sewer billion-dollar ing city
0,3,2,48,1,7,0,50,0,donald trump's executive order refugee immigration
0,3,7,28,2,5,3,35,0,105-year-old french cyclist set world record
0,1,5,25,0,5,0,30,0,hedge fund manager accused fraud
0,2,1,61,3,11,0,62,0,texas lawmaker four-day hunger strike protest sanctuary city bill
0,2,5,23,2,3,0,28,0,jon stewart well-timed comeback
0,1,3,69,1,13,4,72,0,"memorial unveiled mark 50th anniversary death 47 miner lanarkshire, scotland"
0,2,9,52,0,10,0,61,0,judge back charge cleveland officer killing tamir rice
0,2,3,50,3,13,0,53,0,mel b: 'you get laugh pant people delusional'
0,3,9,45,2,9,0,54,0,"early voting didnt boost overall election turnout, study show"
0,2,15,75,6,19,2,90,0,"joshua green: $62 million ad run trump, zero attack ad run clinton primary breitbart"
0,3,3,72,2,17,0,75,0,fast furious franchise became one thing world could agree
0,3,8,21,0,5,0,29,0,uber board stand embattled ceo
0,2,1,47,1,8,0,48,0,high school's quirky tradition randomly pair prom date
0,1,4,42,0,9,2,46,0,british actor comedian sir norman wisdom dy aged 95
0,2,7,49,3,9,0,56,0,"turkey, russia assassination: swirling crises, explained"
0,3,1,34,0,9,4,35,0,bitcoin may biggest winner 2017 far
0,2,8,49,0,11,0,57,0,joe root demand england fire second odi new zealand
0,1,5,22,0,6,0,27,0,volvo ocean race come close
0,1,3,33,0,7,2,36,0,blue musician pinetop perkins dy age 97
0,1,10,26,3,6,0,36,0,f.b.i. state vastly expand dna database
0,1,4,27,2,6,2,31,0,football: rom defeat inter 3-1 milan
0,3,9,38,3,8,0,47,0,justin trudeau donald trump discus u.s.-canada trade
0,2,2,47,0,8,0,49,0,jet player turn alleged pittsburgh fight
0,1,4,29,0,5,0,33,0,kahne take checkered flag richmond
0,3,3,83,4,15,0,86,0,vogue fire 'racist' photoshoot karlie kloss pose geisha issue celebrating'diversity'
0,2,7,50,2,10,3,57,0,nasa photo reveals startling 300-foot-wide rift antarctic ice shelf
0,3,3,65,2,12,0,68,0,"cartoonist take skewed view trump, putin election-hack headline"
0,1,7,30,0,6,0,37,0,new jobless claim lowest since january
0,2,8,44,2,7,0,52,0,trump administration begin deportation raid across u.s.
0,2,9,40,3,8,0,49,0,lindsey graham: house health care bill 'mortally wounded'
0,2,9,49,4,12,2,58,0,"richard adams, whose novel watership became phenomenon, dy 96"
0,1,5,31,0,6,0,36,0,obama promise world renewed america
0,2,10,46,2,11,0,56,0,"quinnipiac poll show donald trump, ted cruz tied iowa breitbart"
0,3,1,42,2,7,2,43,0,policeman raped 13-year-old jailed three year
0,3,2,48,1,8,0,50,0,"washington hot blitzing colorado, chill playoff hope"
0,2,3,15,0,3,4,18,0,baseball team value 2017
0,1,3,50,1,8,0,53,0,"truck crash british columbia wedding party, killing six"
0,2,8,45,4,8,0,53,0,putin: nothing unusual trump nuclear comment breitbart
0,2,13,39,1,11,0,52,0,long-lash look went red carpet everyday life
0,1,2,33,1,6,2,35,0,explosion kill 35 pakistan; many injured
0,2,2,46,1,9,0,48,0,chaffetz seek charge ex-clinton aide email inquiry
0,1,3,49,0,10,0,52,0,woman found guilty plotting sell coke document pepsi
0,1,5,22,0,5,0,27,0,house back ban primate sale
0,2,11,41,1,11,0,52,0,sarah paulson amanda peet kiss golden globe red carpet
0,3,7,52,1,12,0,59,0,mom reunited lost family vhs tape found florida goodwill yahoo
0,3,6,32,0,6,0,38,0,budget haggling weighs new york lawmaker
0,1,7,25,2,6,0,32,0,g.m. may offer stock bondholder
0,2,1,66,1,10,0,67,0,"amazon jungle face death spiral drought deforestation, warn scientist"
0,2,9,36,1,6,0,45,0,astrology-inspired makeup look magical af
0,2,7,30,1,6,4,37,0,highest-paying company america 2017
0,1,3,36,0,7,0,39,0,spanish tourist fatally shot rio de janeiro
0,3,1,46,0,7,0,47,0,minnesota football walkout put bowl plan jeopardy
0,3,6,64,2,12,0,70,0,"same-sex marriage free vote could find consensus, liberal wa senator dean smith say"
0,3,14,40,0,10,0,54,0,crpf man writes rajnath singh alleging torture senior
0,3,11,52,0,12,0,63,0,jerry rice make untimely cash ousside reference get roasted
0,1,5,33,1,6,0,38,0,"poodles, maintenance highest order"
0,2,9,36,4,9,0,45,0,timeline trump wiretap claim video nytimes.com
0,1,5,40,1,10,0,45,0,bp: plug underwater oil leak gulf mexico fails
0,2,2,42,1,6,0,44,0,governor reject parole ex-manson family member
0,3,1,50,2,11,3,51,0,"couple give waitress $400 tip, pay college tuition"
0,2,10,53,4,8,0,63,0,david bowie fearlessly changed rock'n'roll: billboard's special tribute
0,2,9,56,1,9,0,65,0,sacramento king ty lawson releasing sneaker-slippers time christmas
0,1,2,46,0,6,0,48,0,revenge killing follow shooting karachi politician
0,2,4,36,1,10,0,40,0,soon able start ford via amazon echo
0,2,12,53,2,11,0,65,0,priyanka chopra drank thandai jimmy fallon holi aww-dorable
0,2,5,58,0,11,0,63,0,joy villa make political statement donald trump dress grammys
0,2,8,45,4,8,0,53,0,"trump news conference, russia, facebook: evening briefing"
0,1,1,30,1,6,3,31,0,"russian tour boat sinks, killing 100"
0,1,3,45,1,8,0,48,0,uk coach driver jailed triple-death crash near london
0,3,15,61,1,15,3,76,0,here's reliance jio rallying use demonetised r 500 note mobile recharge
0,2,21,62,5,20,1,83,0,"despite getting hit six suresh raina, 6-year-old boy returned watch match fan!"
0,2,18,65,3,15,0,83,0,"delhi businessman accused mercedes hit-and-run case arrested, drunk time accident"
0,1,3,48,1,8,0,51,0,typhoon ketsana reach cambodia; eleven people killed
0,2,6,40,1,6,0,46,0,schumer: democrat attempt filibuster gorsuch
0,1,3,57,2,9,0,60,0,"highly contagious hand, foot mouth disease killing china's child"
0,2,2,31,1,6,0,33,0,warren: trump tapping real anger
0,1,2,35,1,8,4,37,0,"fear loathing campaign trail, june 2008"
0,2,2,57,1,10,0,59,0,"gunman murdered texas deputy constable killed himself, police say"
0,1,3,36,0,6,0,39,0,new zealand labour party spending question
0,1,5,49,0,10,0,54,0,ship fire kill nine greek filipino sailor caribbean sea
0,1,2,36,1,5,0,38,0,"iquique, chile struck moderate earthquake"
0,2,9,30,0,8,0,39,0,un urge eu stop sending migrant hungary
0,1,2,28,0,5,0,30,0,two killed landslide tenerife
0,2,8,38,3,9,0,46,0,"u.s. protects environment, nixon trump"
0,1,8,30,1,9,0,38,0,"get business loan, know bank think"
0,1,4,24,0,3,0,28,0,advisory visiting cave
0,1,5,32,0,4,0,37,0,american express best earnings estimate
0,1,6,39,0,9,0,45,0,eta place explosive tour de france route spain
0,1,2,38,0,6,0,40,0,ten child killed estonian orphanage fire
0,1,10,37,4,8,0,47,0,prospect n.c.a.a. bid go problematic automatic
0,2,5,73,2,17,3,78,0,premier league set announce 312m pre-tax loss light brexit new uk accounting rule
0,2,11,43,4,11,0,54,0,watching alex trebek say 'yas queen' 'jeopardy' make day
0,3,8,48,1,7,0,56,0,supreme court nominee neil gorsuchs confirmation hearing begin
0,2,4,65,4,14,0,69,0,n.c. man told police went d.c. pizzeria gun investigate conspiracy theory
0,3,12,50,0,12,3,62,0,japanese man made sick forcing sneeze 300 time
0,1,5,52,0,9,2,57,0,first libertarian party presidential nominee john hospers dy 93
0,2,8,24,1,8,4,32,0,full list: invest housing 2017
0,2,5,56,2,11,0,61,0,south korea really hired official monitor donald trump's tweets?
0,1,4,30,0,5,0,34,0,drought add hardship california
0,1,3,48,5,11,3,51,0,"five biggest u bank told raise $74.6 billion; fail ""stress tests"""
0,1,5,28,1,6,0,33,0,"tehran, mood melancholy descends"
0,2,7,39,0,8,0,46,0,vatican accepts payment blood access museum
0,1,6,29,0,6,0,35,0,nintendo release gameboy micro u
0,1,9,33,0,8,0,42,0,former nz prime minister confirmed head undp
0,2,9,42,0,10,0,51,0,trump suggests berlin attack affirms plan bar muslim
0,2,6,33,0,6,0,39,0,china near joining influential stock index
0,1,2,21,0,4,0,23,0,aid start reach myanmar
0,1,4,23,0,5,0,27,0,price crop continue fall
0,3,13,51,2,11,2,64,0,13 ordinary thing use everyday not-so-ordinary story behind
0,2,6,25,4,7,0,31,0,hbo's 'the young pope' got prayer
0,3,14,47,1,10,0,61,0,cisf jawan kill four colleague argument bihar's aurangabad
0,2,2,82,1,13,0,84,0,"ethic office director say proper vetting ultrawealthy cabinet nominee take weeks, month"
0,1,6,30,0,6,0,36,0,first woman win seat kuwait parliament
0,2,3,38,1,10,0,41,0,kong: skull island best war movie year
0,1,3,32,2,7,0,35,0,iraq plan 'baghdad eye' draw tourist
0,1,6,32,0,6,0,38,0,oman navigates iran arab nation
0,2,4,61,1,11,0,65,0,st patrick day: ireland look progressive potentially united future
0,3,6,53,3,12,3,59,0,"""the greatest show earth"" close 146 years, ringling brother say"
0,3,7,26,0,6,0,33,0,nicki minaj drop new three new single
0,3,10,70,4,14,0,80,0,saturday night live: alec baldwin return donald trump mock president's mar-a-lago trip
0,1,2,47,0,8,0,49,0,bomb explosion northeastern india kill least seven
0,3,7,81,1,14,0,88,0,theresa may could withhold intelligence sharing donald trump cia adopts torture technique
0,1,6,31,0,6,0,37,0,isle man plan unlimited music downloads
0,3,13,42,1,13,2,55,0,22 thing know youve relationship fouryears
0,1,4,32,0,7,0,36,0,hiv vaccine trial ready roll thailand
0,1,4,33,0,6,0,37,0,rebellion brazilian state prison
0,3,2,65,2,11,0,67,0,'we geopolitical environment extremely dangerous europeans'
0,1,2,42,1,6,0,44,0,champion league round sixteenfirst leg result
0,2,7,50,1,13,1,57,0,7 expensive tv show ever made: game throne friend
0,3,6,30,0,7,0,36,0,jamie foxx target racial slur croatia
0,1,8,46,1,9,0,54,0,"wie, creamer lincicome lurk behind leader sybase classic"
0,1,2,70,3,12,0,72,0,brazilian president: continuing use biofuels would 'crime humanity'
0,3,16,68,0,19,0,84,0,bull team meeting work issue dwyane wade going practice
0,2,10,42,0,10,0,52,0,victim berlin truckattack victim
0,1,3,45,0,9,0,48,0,female lawyer granted court access saudi arabia
0,2,1,41,1,6,0,42,0,cuomos odd blow accountability ingovernment
0,2,4,67,0,14,0,71,0,donald trump considers new travel ban order white house refuse rule appeal
0,2,12,49,3,13,0,61,0,state dept. say new russia sanction nothing 'time clock'
0,1,4,50,0,10,0,54,0,new zealand dollar hit new high versus united state dollar
0,2,3,50,6,11,4,53,0,"bidens brief, unofficial 2020 white house bid; fake news left?"
0,2,12,54,2,12,0,66,0,"gary sinise awarded walk fame star acting, pro-military activism insider"
0,2,2,69,0,12,4,71,0,jeff session recused investigation related 2016 campaign
0,2,17,15,1,6,0,32,0,promo: pairing good vino vuse vibe
0,1,4,30,0,5,0,34,0,pope attacked christmas eve mass
0,3,2,74,0,9,0,76,0,melbourne train operator metro investigating contractor accused underpaying guard
0,1,7,26,1,5,0,33,0,"michael brown, director fema resigns"
0,1,2,35,1,8,4,37,0,"fear loathing campaign trail, july 2008"
0,2,8,39,1,11,0,47,0,jarring image police use force texas pool party
0,1,2,34,0,8,1,36,0,fox news viewership drop half 6 month
0,1,5,35,0,6,0,40,0,south korea begin sending indictment via sm
0,3,5,63,1,12,3,68,0,"almost 500 die watercraft activity decade, royal life saving society report"
0,1,4,58,1,9,0,62,0,"bomb attack londonderry, northern ireland injures two police officer"
0,3,1,54,2,7,0,55,0,uber order 'urgent investigation' sexual harassment claim
0,3,3,48,0,9,0,51,0,referee jeff triplette appears call penalty wrong team
0,2,1,70,4,13,2,71,0,"73-year-old calif. man dementia fatally shot police carrying crucifix, gun"
0,1,5,22,0,5,0,27,0,missouri much cornell
0,1,5,30,0,5,0,35,0,unexpected increase factory order
0,1,5,33,0,5,0,38,0,regulator madoff inquiry defend action
0,3,7,62,4,14,1,69,0,here's 'guardians galaxy vol. 2' trailer marvel dropped super bowl
0,2,12,57,2,14,0,69,0,"o'reilly press trump travel ban, view putin super bowl interview insider"
0,2,10,50,3,9,0,60,0,"john legend's twitter hacked, series bizarre anti-trump tweet posted"
0,2,15,59,4,14,0,74,0,reince priebus battle nbcs chuck todd russian election hacking chuck insane
0,2,5,85,1,17,0,90,0,mystery solved! nasa engineer take selfie strange object alien hunter convinced ufo
0,1,2,63,0,7,0,65,0,torrential downpour cause significant flooding northeastern scotland
0,1,3,34,0,5,0,37,0,el salvador elect leftist president funes
0,2,9,33,2,8,0,42,0,chief keef return 'two zero one seven' mixtape
0,3,2,29,1,8,3,31,0,cuba offer rum pay $276m czech debt
0,3,10,66,2,10,0,76,0,trump dismisses argument travel ban disgraceful sheriff conference
0,1,3,56,0,11,0,59,0,u army commander afghanistan asks troop leaked report
0,3,6,34,0,8,0,40,0,watch march snowstorm hit east coast
0,3,1,47,1,7,0,48,0,gun background check help prevent school shootings?
0,1,3,25,1,4,2,28,0,earnings decline 35% halliburton
0,3,15,46,1,12,1,61,0,india express concern h-1b visa bill introduced u senate
0,1,4,37,1,7,0,41,0,"tanker crash kill two brevard county, florida"
0,1,7,32,0,8,0,39,0,shaky pakistan seen target qaeda plot
0,2,3,40,1,8,0,43,0,"gop expand school choice, target union state"
0,2,10,57,0,10,0,67,0,official share video showing shooting boston terror suspect usaamah rahim
0,3,12,45,2,10,4,57,0,charles barkley talk nirvana hotboxing 'snl' dressing room 1993
0,2,3,47,1,9,0,50,0,"tornadoes, storm damage dozen home san antonio area"
0,1,4,47,1,10,3,51,0,evidence engine fire aeroflot-nord flight 821 crash site
0,3,1,50,2,7,0,51,0,round-the-clock federal manhunt underway escaped inmate
0,2,13,43,2,14,0,56,0,"megyn kelly jump nbc fox news test her, network"
0,1,1,55,3,9,0,56,0,"facebook ""upgrades""; multiple blog suggest site hacked"
0,3,11,69,0,13,0,80,0,four correction officer held hostage inmate delaware prison treatment trump
0,2,10,50,2,11,0,60,0,watch alec baldwin compare trump finger chili 'saturday night live'
0,3,5,81,2,21,0,86,0,court ruling lesbian illegally passed job could big moment lgbt right
0,1,6,38,1,6,0,44,0,"chile tsunami first reached pichilemu, shoa report"
0,2,11,40,1,9,0,51,0,gop health care bill: visual guide republican opposition
0,2,7,40,2,7,0,47,0,penn state call immigration poster 'deeply offensive'
0,2,2,47,0,10,0,49,0,northeast dig march snowstorm ski area revel
0,1,3,28,1,8,3,31,0,"100 die riot rmqi, china"
0,1,3,35,1,7,0,38,0,"body missing student found bath, england"
0,2,9,37,1,8,0,46,0,"malfatti, dumpling became napa valley legend"
0,1,3,41,2,5,0,44,0,"highway bridge minneapolis, minnesota, collapse"
0,3,2,39,2,7,0,41,0,want reduce abortion rates? give parent money.
0,3,7,46,0,11,2,53,0,arkansas executes death penalty first time 12 year
0,2,6,36,5,5,0,42,0,"trump interest vs. americas, blind-trust edition"
0,1,4,25,1,5,0,29,0,uk ban islamist group al-shabaab
0,2,13,57,4,13,0,70,0,spicer: cnn's acosta owes trump apology 'rude' behavior news conference insider
0,1,2,37,0,7,3,39,0,rebel say 626 ethiopian troop killed clash
0,1,6,42,0,6,0,48,0,armenian journalist facing prison sentence turkey
0,2,7,36,2,6,0,43,0,america past shape native american present
0,3,6,35,3,10,4,41,0,"best music 2016: yg, beyonc, maren morris"
0,3,2,47,1,10,0,49,0,rebel-held eastern aleppo run space bury dead
0,3,4,41,5,7,0,45,0,celtics' isaiah thomas: 'they're counting u already'
0,3,8,45,1,7,0,53,0,alexei navalny: russian court convict main opposition leader
0,3,1,46,0,8,0,47,0,german nationalist elect top duo general election
0,2,8,46,1,8,0,54,0,chicago say spicer can't blame shooting epidemic immigrant
0,2,3,52,3,13,0,55,0,'no one helped her': nj woman murdered ex awaiting gun permit
0,1,2,62,0,12,0,64,0,unprecedented review held qantas third emergency two week
0,3,2,27,1,4,0,29,0,read trump's full budget blueprint
0,3,3,44,0,11,0,47,0,barack obama admired man world list
0,2,6,34,0,6,0,40,0,weed price falling thanks legalization
0,2,3,53,1,8,0,56,0,"three cheer samantha cristoforetti, smasher space record"
0,2,8,71,3,16,0,79,0,melania appears received st patrick's day memo trump fly 'southern white house'
0,1,5,28,0,4,0,33,0,germany imago suburb without car
0,2,9,50,0,9,0,59,0,police made truther video dakota access pipeline protest
0,2,2,37,1,7,0,39,0,ben franklin country first famewhore
0,3,8,42,0,9,0,50,0,manhattan office owner pay keep tenant demand fall
0,1,9,50,0,10,0,59,0,obama seek vastly expanded afghan force help stabilize nation
0,3,6,51,2,9,0,57,0,"""cajun john wayne"" clay higgins win congressional seat louisiana"
0,1,5,28,0,6,0,33,0,shuttle lift trip telescope
0,3,18,56,2,17,0,74,0,"awarding paralympians padma shri great step, take bharat ratna?"
0,1,6,34,0,8,0,40,0,china begin address coming wave elderly
0,2,12,34,4,13,0,46,0,snap said pick banker i.p.o. new york time
0,2,5,45,3,8,0,50,0,pogues basics: enable wi-fi calling perfect cell service
0,1,3,24,0,4,0,27,0,romania switch winter time
0,2,14,40,2,13,0,54,0,"mom didnt sell knitted good fair, twitter bought"
0,1,9,58,0,13,0,67,0,illinois governor urge senator quit call law special election
0,2,2,16,0,2,0,18,0,presume
0,3,4,62,1,11,0,66,0,"trump admin institute medium blackout epa, suspends social medium activity"
0,2,15,54,3,13,0,69,0,big star remembered sxsw concert film 'thank friends': watch exclusive clip
0,3,8,44,0,9,0,52,0,roof collapse czech republic sport hall captured video
0,1,3,24,0,5,0,27,0,swine flu claim first uk victim
0,3,2,46,1,5,0,48,0,disney-inspired print positively enchanting
0,1,7,30,1,7,0,37,0,"film channel name, network carrier"
0,3,3,69,0,10,0,72,0,justin trudeau investigation possible ethic violation bahamas trip
0,1,4,16,0,3,0,20,0,key hiv gene discovered
0,1,6,35,1,5,0,41,0,"syria discloses missile facility, european say"
0,3,11,40,2,11,5,51,0,"jeweler ordered pay $34,500 trashing rival fake yelp review"
0,2,4,24,0,7,3,28,0,janet jackson welcome 1st baby 50
0,3,4,47,2,9,0,51,0,guardian view putin europe: new fellow traveller
0,1,2,39,0,5,0,41,0,british electronica band faithless separate
0,1,2,23,0,4,0,25,0,uk terror suspect win appeal
0,3,14,47,5,12,0,61,0,making america 'crude' again: u.s. oil gas industry feel trump effect
0,3,8,65,1,14,0,73,0,nsw drug bust: former nrl player bondi businessman linked historic cocaine haul
0,2,1,46,0,8,0,47,0,kansa community try heal deadly bar shooting
0,1,4,50,3,9,0,54,0,who's richest entertainer australia? wiggle course!
0,1,1,25,0,5,0,26,0,light stopped second
0,2,10,36,2,12,0,46,0,like watch life work blow rocket
0,2,3,36,2,6,0,39,0,warriors' bid thwarted dion waiters' heroic
0,1,2,40,0,6,4,42,0,wikinews preview 2009 queensland state election
0,3,2,73,3,12,0,75,0,"ralph shortey, state senator charged child prostitution, plan resign, lawyer say"
0,3,7,39,1,6,0,46,0,fastest-growing type loan face political backlash
0,3,2,63,0,12,0,65,0,brexit opportunity reverse tragic decline marriage britain
0,3,3,61,1,10,0,64,0,cillizza: trump keep creating smokescreen mask russia problem
0,1,3,45,0,7,0,48,0,dalai lama visit monastery despite protest china
0,3,17,52,3,13,0,69,0,trump 'get u killed': moore blast peotus skipping intel briefing insider
0,1,2,41,0,5,0,43,0,palestinian protester killed israeli soldier
0,3,9,48,0,13,0,57,0,watch brawl break stand high school basketball game
0,3,11,39,0,10,0,50,0,oecd see lot worry global economic outlook
0,1,4,41,1,8,0,45,0,"two jockey killed fire north yorkshire, england"
0,3,2,49,0,10,0,51,0,official say hamburg airport scare likely pepper spray
0,1,3,25,0,4,0,28,0,lulzsec claim sony network hack
0,3,1,61,0,11,0,62,0,ambush fatal shooting fuel increase police death toll year
0,2,7,33,0,6,0,40,0,man arrested breaching white house complex
0,3,3,34,0,6,0,37,0,facebook messenger got like venmo
0,1,6,35,2,8,2,41,0,"quarterly earnings fall staples, sale grow 19%"
0,3,13,50,2,12,0,63,0,living small town stop people starting women's march
0,1,7,45,1,6,0,52,0,connecticut serial killer competent- waif appeal
0,1,2,48,0,10,0,50,0,least four killed bomb thrown motorcycle cairo
0,2,7,27,1,6,0,34,0,manhattan luxury co-op fall favor
0,3,2,52,3,9,0,54,0,'netflix cheaterz' relatable made-up reality show ever
0,3,17,69,3,10,0,86,0,far-right troll milo yiannopoulos disinvited conservative political action conference (update)
0,2,4,32,2,8,2,36,0,game throne actor peter vaughan dy 93
0,1,4,45,0,9,0,49,0,u army court martial soldier three afghan murder
0,3,2,71,1,13,0,73,0,trump give hard-line campaign promise moderate tone address congress
0,3,9,45,0,9,0,54,0,donald trump adviser kellyanne conway joining white house team
0,2,3,61,3,13,0,64,0,anzac day: tasmanians told war 'last resort' young flock service
0,3,8,36,1,7,0,44,0,"patton oswalt say heart condition, med killed wife"
0,1,3,41,2,7,4,44,0,"terry teen, 1960s rockabilly artist, injured collision"
0,2,11,76,3,17,0,87,0,kim jong-un big fan serie football exploit cagliari's north korean striker kwang-song han
0,3,1,61,1,10,0,62,0,"obesity pregnancy increase risk epilepsy child, study find"
0,2,7,41,1,6,0,48,0,antitrust ruling put chill health-insurance merger
0,2,8,42,3,10,1,50,0,danny gokey completes 'rise' no. 1 christian airplay chart
0,1,1,42,1,7,2,43,0,19 burmese political prisoner released; come
0,2,3,43,0,10,1,46,0,secret uk tomb found contain remains 5 archbishop
0,2,12,49,0,11,0,61,0,high school grad coming undocumented revolt againsttrump
0,1,6,32,0,7,0,38,0,rage machine top uk single chart
0,3,4,44,1,6,0,48,0,brazil senate head renan calheiros' suspension rejected
0,1,3,45,0,11,2,48,0,slipknot bassist paul gray found dead hotel room age 38
0,3,4,72,3,12,0,76,0,here vertical video disrupting filmmaking industry (paid content nespresso)
0,3,5,50,2,9,0,55,0,mark cuban go extended tweetstorm 'the trump conundrum'
0,1,1,38,1,5,0,39,0,wind-powered land vehicle break speed record
0,1,7,34,0,10,0,41,0,casino rise place fallen steel giant
0,2,5,67,0,15,1,72,0,construction worker cheat death impaled 5ft long steel rod head
0,2,2,52,2,8,0,54,0,detail revealed uber's latest self-driving car crash
0,2,17,53,4,13,0,70,0,"seth troxler, nio arbol headline first-ever black experience mexico city"
0,2,4,34,1,6,0,38,0,julia robert sign onto first-ever tv series
0,2,2,67,6,12,0,69,0,"egypt president bloodthirsty dictator. trump think he done ""fantastic job."
0,2,13,49,1,12,0,62,0,alicia key say love gwen stefani blake shelton does: watch
0,3,12,62,0,11,0,74,0,transgender sister singer trump inauguration win federal court bathroomruling
0,1,3,20,0,3,0,23,0,interview jimbo wale
0,2,4,66,1,14,0,70,0,guardian view philip hammond: honesty needed budget pain come
0,1,6,41,0,9,0,47,0,epa proposes using clean air act fight global warming
0,3,5,48,1,11,0,53,0,what's next fight supreme court nominee neil gorsuch
0,3,9,42,2,7,0,51,0,trump health-care reform uncertainty could see job shrink
0,1,7,35,0,7,0,42,0,treasury bos taking fire europe stimulus
0,3,6,29,2,6,4,35,0,demystifying obamacare 2017: gamble
0,1,8,40,0,8,0,48,0,former u president jimmy carter meet hamas leader
0,2,9,42,0,8,0,51,0,hedge fund risk treasury wipeout bearish bet soar
0,2,8,44,0,8,0,52,0,alphabet scrap plan blanket globe internet balloon
0,1,7,24,0,6,0,31,0,derby winner mine bird work
0,3,4,59,2,12,0,63,0,tottenhams dele alli score two end chelseas winning run short record
0,2,2,30,1,7,0,32,0,a-rod say retirementplan
0,2,7,42,1,7,3,49,0,starbucks barista win $900k westgate la vega supercontest
0,2,16,44,1,15,0,60,0,"drugmaker try cash opioid epidemic, one state law time"
0,2,3,19,0,5,0,22,0,adam west back batman
0,1,3,51,0,7,0,54,0,college offering admission displaced new orleans student
0,3,7,38,2,7,0,45,0,future unveils 'mask off' artwork instagram story
0,3,7,65,5,14,0,72,0,north korea accuses john mccain 'blasphemy' calling kim jong-un 'that crazy fat kid'
0,1,6,33,0,8,0,39,0,clearing fog complicated air travel
0,3,11,47,1,10,0,58,0,teenage boy fatally shoot high school student bedroom: police
0,1,7,32,0,8,0,39,0,move lift confidence money market fund
0,1,7,36,0,6,0,43,0,rambus settle european inquiry chip patent
0,1,10,40,1,11,0,50,0,"first use replay, umpire yankee stadium get right"
0,1,3,32,1,5,0,35,0,"neolithic noodle found qinghai, china"
0,2,12,52,1,10,0,64,0,chief justice john robert lauds federal district judge year-end report
0,1,6,27,0,5,0,33,0,north korea maintains tough stance
0,1,6,24,1,5,0,30,0,czech police expel ex-leader klan
0,2,1,66,4,14,0,67,0,beautiful device prove upside downside making home smart
0,2,16,59,2,13,0,75,0,hhs secretary tom price say 'nobody worse financially' obamacare repeal
0,3,9,41,2,9,2,50,0,"russian paid mike flynn $45k moscow speech, document show"
0,3,4,57,0,12,0,61,0,republican need jeff session stay senate little longer
0,3,4,46,0,8,0,50,0,donald trump protest attract million across u world
0,1,4,30,0,6,0,34,0,itv wale drop local news sign language
0,3,12,36,0,11,2,48,0,17 really funny tweet dj khaled son asahd
0,2,1,23,1,7,3,24,0,happens live 100?
0,3,10,45,5,7,0,55,0,trump 'just killed' paul ryan's obamacare repeal-and-delay strategy
0,1,4,24,0,5,0,28,0,pillow fight four season
0,1,4,28,3,6,8,32,0,2007/08 bundesliga: bayern munich vs. hannover 96
0,2,9,43,2,9,0,52,0,what's like black white-dominated weed industry
0,3,11,40,1,10,0,51,0,king hawk troll nba's new social medium policy twitter
0,3,7,63,0,12,0,70,0,nfl denies barring lady gaga talking politics ahead super bowl performance
0,1,7,25,0,7,0,32,0,senator say affair aide
0,3,8,40,2,9,0,48,0,"nighttime, rules: summertime arctic circle"
0,1,2,22,0,4,0,24,0,fire break galveston
0,3,2,72,1,11,0,74,0,watch member turkey's parliament brawl debate constitutional change
0,3,13,59,7,14,0,72,0,"watch bill paxton talk iconic parts, 'weird science' titanic [video]"
0,1,7,58,0,12,0,65,0,un secretary general release new statement un aid start reach myanmar
0,1,6,30,0,8,1,36,0,radio host arrested threat 3 judge
0,1,4,65,1,11,0,69,0,oregon running back legarrette blount's college football career end punch
0,1,2,37,3,8,0,39,0,"blair: ""labour must party change makers"""
0,3,15,70,2,17,4,85,0,rosie chiquis rivera open new jenni rivera series 2017 billboard latin music conference: watch
0,2,6,28,1,7,5,34,0,2015 nba playoffs: andre iguodala start game 4
0,1,4,35,0,8,0,39,0,aussie ignore flag ban big day festival
0,3,9,25,3,8,0,34,0,paul ryan: 'obamacare law land'
0,1,5,36,3,7,0,41,0,"terror alert delhi, mumbai, kolkata, chennai"
0,1,6,37,0,6,0,43,0,obama sign spending bill criticizes earmark
0,2,9,45,2,11,0,54,0,sean spicer scold medium lack interest susan rice story
0,3,8,47,0,9,2,55,0,firefighter save 18 duckling trapped inside storm drain insider
0,1,2,23,0,5,3,25,0,bombing kill 100 baghdad
0,2,5,14,0,3,0,19,0,help u map trumpworld
0,2,9,45,3,10,0,54,0,"terry branstad, iowa governor, trump pick china ambassador"
0,1,7,23,3,8,0,30,0,"world lingo (out world, too)"
0,2,8,40,2,9,5,48,0,"chelsea manning fundraiser garner $83,000 one week"
0,3,5,42,3,9,0,47,0,bryce harper vs. manny machado: would rather have?
0,3,17,58,2,16,0,75,0,"four year nirbhaya, delhi still report six rape case day, even crime rate fall"
0,2,13,50,1,12,0,63,0,bryan cranston steal show james corden's spoof kanye west soap opera
0,1,6,25,0,5,0,31,0,russia begin war game near georgia
0,2,3,24,3,7,0,27,0,biden trump: 'time adult'
0,2,1,49,1,10,0,50,0,startup's pillow pad aim keep head cool sleep
0,1,2,41,2,9,0,43,0,u.s. minimum wage get first federal boost decade
0,2,14,29,1,10,0,43,0,samsung launching new class tv say hello qled
0,3,3,49,1,9,2,52,0,russian plane crash: 13 body reportedly recovered black sea
0,2,10,56,1,11,0,66,0,clemson's ben boulware get national title tattoo achilles spite analyst
0,3,7,37,0,8,0,44,0,travel ban head toward supreme court transition
0,3,9,42,0,9,0,51,0,yuan leap dollar trump back currency
0,1,2,44,0,6,0,46,0,scottish football team hibernian appoint new manager
0,3,6,35,0,9,0,41,0,shopping becomes political act trump era
0,2,10,54,1,10,0,64,0,justise winslow injury: heat wing undergoes shoulder surgery torn labrum
0,1,2,74,0,10,0,76,0,violent protest break kyrgyzstan allegedly rigged parliamentary election
0,2,5,40,1,9,0,45,0,"texas flooding put cruz, gop bind climate change"
0,3,4,64,2,9,0,68,0,cyclone debbie: brisbane drenched system move south-east queensland
0,2,10,39,2,8,0,49,0,tillerson asks u.s. taxpayer care ukraine
0,1,3,53,0,10,0,56,0,canadian folk singer attacked killed coyote nova scotia
0,3,2,57,1,11,3,59,0,"taliban attacker kill least 140 soldier afghan base, official say"
0,3,3,74,0,13,0,77,0,israeli force begin evacuation west bank outpost resident barricade home
0,1,3,29,0,5,0,32,0,defense rest michael jackson case
0,1,8,31,3,9,0,39,0,"coup honduras, ghost past u.s. policy"
0,1,4,48,0,8,0,52,0,liverpool beat milan penalty champion league final
0,3,2,45,3,9,0,47,0,"conan shifting weekly show, according turner bos"
0,2,18,63,4,17,0,81,0,right slur president cnn panel heated exchange trump un intervention
0,3,8,45,0,10,0,53,0,trillion dollar stake trump speaks congress
0,2,2,27,3,4,0,29,0,san francisco us pee-proof paint
0,1,8,41,0,10,4,49,0,moto gp rider marco simoncelli dy 2011 malaysia grand prix
0,3,12,58,6,11,0,70,0,longtime trump adviser call critic 'stupid ignorant ugly b***h' since-deleted tweet
0,3,9,48,5,11,1,57,0,kanye west vibe deadmau5's 'snowcone' pete rock's studio: watch
0,2,11,39,0,10,0,50,0,study find clear link teen pot use psychosis
0,1,1,60,0,9,0,61,0,chinese chemical plant explosion threatens water supply major city
0,2,9,45,0,6,0,54,0,cbs affiliate reignites debunked pizzagate conspiracy theory
0,3,10,60,0,12,0,70,0,thousand sign petition oust professor harassment ivanka trump insider
0,1,4,35,2,6,0,39,0,dungeon dragon co-creator dave arneson dy
0,2,5,35,1,6,0,40,0,un condemns israel's west bank settlement plan
0,2,2,56,2,11,0,58,0,d.c. yoga instructor disappeared way holiday party found dead
0,1,6,31,0,6,0,37,0,home sale better expected december
0,1,8,36,0,8,0,44,0,south africa bar dalai lama peace conference
0,2,1,69,1,14,0,70,0,"talking robot might make feel better love life, new research show"
0,2,1,27,1,4,0,28,0,week hottest fashionsales
0,2,8,46,4,9,0,54,0,'training day': watch show's touching dedication bill paxton
0,1,5,43,0,7,0,48,0,mccain obama participate saddleback church forum
0,2,1,21,1,6,0,22,0,let's put sac bunt bed
0,1,6,50,2,8,0,56,0,nfl: cowboy cornerback pacman jones can't discus police incident
0,1,9,30,3,6,0,39,0,f.a.a. plan new medical helicopter safety rule
0,1,9,53,1,10,0,62,0,"steelers, cardinal win championship game advance super bowl xliii"
0,3,4,38,2,9,0,42,0,donald trump say u becoming 'one party system'
0,2,12,61,2,14,2,73,0,'american idol' season 10 winner scotty mccreery cheer patriot super bowl rally
0,2,5,30,2,6,0,35,0,google future depends trump ftcpick
0,1,3,43,0,9,1,46,0,groundhog predicts 6 week winter weather u
0,1,8,29,0,7,0,37,0,big investor fortis opposes buyout bnp
0,3,7,42,2,8,2,49,0,"vancouver home sale plunge 40%, extending string decline"
0,3,13,42,6,18,6,55,0,2016 no. 1s: iggy pop working josh homme: 'i looking no. 1 album'
0,1,1,40,0,5,0,41,0,canadian theatre producer sentenced fraud
0,2,8,22,3,7,0,30,0,trump: never realized big
0,1,1,27,0,4,0,28,0,priest charged exorcism death
0,2,14,55,3,14,2,69,0,larry ellison's net worth drop $1.9 billion day oracle miss revenue estimate
0,2,3,44,1,7,0,47,0,ex-british spy behind trump dossier identified
0,2,2,70,1,16,0,72,0,long face? study find horse use visual physical cue ask human help
0,3,3,59,0,13,0,62,0,expert find may earliest color film white house ground
0,3,7,27,3,6,0,34,0,"listen freddie gibbs' new track ""alexys"""
0,3,3,39,3,9,0,42,0,"swag, mojo, power glory mike gundy's mullet"
0,1,1,24,2,3,0,25,0,two-year-old punished dryer
0,3,1,80,4,18,0,81,0,pervert raped hen could get girlfriend court hears bird died exhaustion
0,2,4,54,0,9,0,58,0,indian professional face new challenge singapore shuts door
0,3,3,57,4,10,0,60,0,federal judge: court begging evidence support trump travel ban
0,1,1,53,2,10,5,54,0,study concludes 9/11 firefighter 19% likely develop cancer
0,3,14,42,1,11,0,56,0,took cnn second debunk donald trump's latest false claim
0,1,7,35,2,8,0,42,0,"medtronic drop dr. kuklo, accused faking study"
0,1,2,45,0,7,0,47,0,two australian charged burning flag riot
0,2,2,78,3,16,2,80,0,"second-hand tyre 23 year old putting life risk britain's roads,trading standard warn"
0,3,2,10,0,1,0,12,0,larry ellison
0,3,10,23,1,6,0,33,0,bts perform kcon mexico: exclusive
0,3,7,58,2,11,0,65,0,'snl' imago scary holiday meeting donald trump vladimir putin
0,1,6,34,0,7,1,40,0,russian official among 7 killed copter crash
0,1,5,28,0,4,0,33,0,state oregon sue oppenheimerfunds
0,1,6,41,1,9,0,47,0,u india nuclear deal sent u congress ratification
0,2,3,23,0,3,0,26,0,trumpery social darwinism
0,2,2,54,3,11,6,56,0,"vandal spill 400,000 bottle italian sparkling wine act 'sabotage'"
0,3,10,50,2,12,1,60,0,"trump inaugural concert feature 3 door down, toby keith, jon voight"
0,3,3,84,6,15,0,87,0,"tillerson, confirmation hearing, say russia pose 'danger' refuse call putin 'war criminal'"
0,2,5,60,0,11,0,65,0,tree surgeon scrambled blenheim palace cedar made famous harry potter
0,3,11,46,4,9,0,57,0,"reversing course, e.p.a. say fracking contaminate drinking water"
0,1,3,35,1,7,4,38,0,"television appeal 1984 murder bath, england"
0,2,8,51,0,10,0,59,0,ric flair reportedly kicked indiana bar insulting employee
0,2,14,24,2,10,0,38,0,"even cuts, hsbc bulk asia moneybeat"
0,3,2,44,2,6,0,46,0,breaking saturday's second-round matchup
0,2,24,48,3,13,0,72,0,exclusive watch: youtube star diamond silk destroy black life matter breitbart
0,1,2,44,1,5,0,46,0,austrian students' protest expanding europe
0,3,2,47,0,7,0,49,0,mother seek sanctuary deportation denver church
0,1,5,32,0,6,0,37,0,murder hate verdict transgender case
0,1,1,42,0,7,0,43,0,haitian migrant drown many still missing
0,1,4,36,0,9,0,40,0,french mp call ban veil muslim woman
0,3,4,34,1,8,0,38,0,islamic state: battle mosul land air
0,3,7,45,0,9,0,52,0,lebron james cooking something special nba final
0,1,6,29,1,5,0,35,0,sturm und drang pint-size neighbor
0,3,0,39,2,6,2,39,0,13-year-old boy dy suspected heroin overdose
0,2,11,62,2,13,4,73,0,tool frontman maynard james keenan compare trump america 1938 nazi germany breitbart
0,2,12,57,6,13,0,69,0,"donald trump convention, matter control (and self-control) new york time"
0,1,9,27,3,7,0,36,0,national debate g.o.p. hit home utah
0,3,3,48,3,8,0,51,0,tiger woods: master early four-time champion's return
0,2,8,41,0,9,0,49,0,singapore home sale surge highest almost four year
0,3,1,40,1,8,0,41,0,"twitter take new step curb abuse, hate speech"
0,1,6,64,2,12,5,70,0,australian rule football: 2010 gippsland football league round 2 traralgon v wonthaggi
0,3,4,41,1,8,2,45,0,"british police name london attacker khalid masood, 52"
0,2,16,60,0,15,0,76,0,govt tell restaurant let customer decide much service charge wish pay
0,1,5,53,2,8,0,58,0,"former new zealand politician, brash, officially leaf politics"
0,1,7,33,0,6,0,40,0,european military plane face even delay
0,1,4,45,0,7,0,49,0,wikinews interview author filmmaker peter john ross
0,1,4,50,0,9,0,54,0,mamdouh habib released guantanamo bay without charge
0,3,9,37,3,10,0,46,0,illegal share 'gay clown' putin meme russia
0,2,6,65,1,14,0,71,0,nsw weather: three woman hit lightning storm hail hit sydney wollongong
0,2,7,61,3,16,0,68,0,texas ag sued keep bible quote school. he troubled muslim prayers.
0,2,2,35,0,6,0,37,0,west bank violence flare recent calm
0,1,2,60,2,8,0,62,0,"skype launch ""unlimited"" monthly service change communication style"
0,3,12,52,4,11,0,64,0,"pearl jam's eddie vedder, hundred others, made family's christmas"
0,3,10,53,2,11,4,63,0,2017 billboard latin music conference announces 'the life jenni rivera' panel
0,1,7,38,1,7,0,45,0,"traveling mothers, hurdle pumping breast milk"
0,3,10,42,3,10,0,52,0,"one rocky week, trump self-inflicted chaos vivid display"
0,1,6,33,0,7,0,39,0,democrat congress ready pare budget
0,1,2,63,1,12,2,65,0,leaked poll find 45% iraqi support suicide bomber attack allied force
0,2,8,38,1,9,1,46,0,"5 dead tornado, severe weather sweep across south"
0,3,10,61,0,12,0,71,0,travis scott hinted collaboration quavo twitter appropriately lit
0,1,7,35,0,7,0,42,0,sabathia return cleveland best stuff
0,1,2,22,0,4,3,24,0,100 participate zagreb pride
0,2,8,41,3,9,0,49,0,blake griffin explains lyric fetty wap's 'trap queen'
0,3,1,50,1,9,3,51,0,trump ban already cost business travel industry $185 million
0,1,5,30,0,4,0,35,0,poland investigates deadly shelter fire
0,2,11,36,1,10,0,47,0,top anc leader said oppose zuma's plan fire gordhan
0,2,2,50,1,10,0,52,0,critic building mexico border wall effective
0,3,3,77,2,14,0,80,0,barking mad! besotted dog owner capture pet bizarre antic hilarious snapchat post
0,1,1,63,1,10,0,64,0,high school basketball star dy making game-winning shot overtime
0,2,18,62,3,16,0,80,0,"pc win second people's choice award, deepika's lungi dance james corden ent"
0,1,4,26,0,5,0,30,0,nasa plan future moon mission
0,2,2,53,1,13,0,55,0,chaos panic: deadly flood bring fear escaped zoo animal
0,2,4,66,4,15,0,70,0,"uk parliament terror attack: two people killed, cop stabbed -- dozen injured"
0,1,2,34,0,6,0,36,0,danish norwegian embassy set fire
0,1,4,39,2,5,2,43,0,"pittsburgh pirate defeat philadelphia phillies, 3-0"
0,2,8,32,0,7,0,40,0,popular high school play musical
0,1,9,20,0,5,0,29,0,nato say top taliban leader slain
0,2,7,43,0,10,0,50,0,american fighting kurd syria killed isi battle
0,1,7,37,0,8,0,44,0,washington tap potent new force diplomacy
0,3,6,81,2,14,0,87,0,trump reportedly 'yelled' cia director response report u intelligence withheld
0,3,2,48,2,8,0,50,0,surgeon general sounding alarm teens' use e-cigarettes
0,2,10,49,1,15,1,59,0,"lebron james, cavs fend late warrior rally win game 3 nba final"
0,2,9,33,0,8,0,42,0,friendship bench help chase blue away
0,2,2,44,2,8,2,46,0,bt fined 42m delay high-speed cable installation
0,3,3,33,1,4,0,36,0,inside mosul: intimidation punishment
0,1,2,27,0,3,0,29,0,earthquake shake western mexico
0,3,4,43,1,7,0,47,0,masterpiece fall classic: inside greatest game ever
0,1,9,30,0,7,0,39,0,google executive replace two fired aol
0,1,1,47,0,9,1,48,0,nebraska teacher sentenced 6 year sex student
0,1,4,27,0,4,0,31,0,hurricane earl threatens eastern u
0,1,2,48,0,8,0,50,0,treasury reveals cost carbon tax australian family
0,3,3,52,0,8,0,55,0,military lawyer sue pentagon carcinogen gitmo housing
0,2,4,58,4,13,0,62,0,"rhode island offshore wind farm, first u.s., power thousand home"
0,2,10,55,5,14,8,65,0,manafort: gop presidential nominating process system 1920s 2016 breitbart
0,1,8,72,1,12,0,80,0,missouri circuit court judge werner moentmann rule planned parenthood must repay money.
0,3,12,48,2,11,0,60,0,silicon valley dominating self-driving tech? motor city say fast
0,2,2,38,3,8,0,40,0,new york's rental market entering 'slow grind'
0,2,14,46,2,13,0,60,0,gop lawmaker ask ag session 'fresh look' lois lerner case insider
0,3,10,40,0,11,6,50,0,52 amazing photo around world sum 2016 perfectly
0,2,4,66,2,10,0,70,0,"australia's detention centre crime humanity, say submission icc"
0,1,8,40,0,8,0,48,0,cathay pacific cut cost air travel remains sluggish
0,3,6,53,2,9,0,59,0,zach galifianakis rudely interrupt john legend st. vincent's duet
0,3,7,29,0,7,0,36,0,tidal add song editing tool mobile app
0,2,2,82,1,17,0,84,0,robot human touch: optical sensor allow machine hand sense subtle shape texture
0,2,4,24,0,5,0,28,0,megacity mumbai go poll
0,1,1,25,0,4,0,26,0,rare rhino caught videotape
0,3,11,50,4,9,0,61,0,united's 'flyer friendly' ad less cheerful passenger-ejection clip
0,2,6,29,0,6,0,35,0,china struggle shake salt monopoly
0,2,5,26,1,5,0,31,0,"police shooting columbus, ohio"
0,2,3,38,0,7,0,41,0,conway tweet trump base anger romney
0,2,9,40,0,6,0,49,0,zayn malik reveals new collaboration partynextdoor
0,2,15,73,4,16,0,88,0,j scott armstrong breitbart news daily: one asks researcher follow scientific method breitbart
0,1,8,41,1,10,0,49,0,"memorable shot, final one two maryland senior"
0,1,6,27,0,7,0,33,0,art managing preserve job
0,3,6,41,0,8,2,47,0,40 turkish nato soldier requested asylum germany
0,1,8,32,1,9,0,40,0,police find suspect cold case: one
0,1,8,37,0,9,0,45,0,work stimulus package add speed train
0,2,3,51,2,11,1,54,0,mcdonald's give control china business $2 billion deal
0,1,2,17,0,3,0,19,0,exclusive look bebo
0,1,9,47,2,9,0,56,0,"upbeat, vulnerable, serena williams win wimbledon opener"
0,1,2,28,0,4,0,30,0,lindsay lohan surrender police
0,2,9,37,1,8,0,46,0,james comey hurt fbiand democratic process
0,2,13,51,3,9,0,64,0,"lavar ball's home burglarized son lamelo, liangelo's basketball game"
0,2,4,46,2,9,0,50,0,who villanovas way march madness bracket isrevealed
0,3,12,51,3,10,0,63,0,"paloma chamorro, whose tv show captured spain's cultural awakening, died"
0,3,10,61,3,10,0,71,0,quietly suffering: former california nail salon employee sue labor violation
0,3,3,62,2,13,4,65,0,"harry reid paid former staffer $7,000 campaign fund paint capitol portrait"
0,1,5,36,1,7,0,41,0,dna test confirm bone found steve fossett's
0,3,9,57,0,10,0,66,0,district attorney clear officer involved shooting black homeless man
0,3,7,36,1,8,0,43,0,era doping outrage ending america's pastime
0,2,9,46,0,10,0,55,0,angela merkel meet donald trump friday blizzard delay
0,1,8,27,0,6,0,35,0,abc interview shaped torture debate
0,2,8,45,2,10,0,53,0,"nba's chinese new year bash include jerseys, yao ming ceremony"
0,3,3,71,1,15,7,74,0,saudi arabia executed 150 prisoner 2016 breaking kingdom's strict islamic law
0,3,6,30,1,7,0,36,0,arielle gamble's year shit country town
0,3,7,83,2,19,0,90,0,that's spot! adorable moment affectionate female rhino sneak cameraman demand belly rub
0,2,3,29,1,9,0,32,0,ok jogger run cemetery?
0,1,7,28,1,6,0,35,0,e-readers come wider piracy book
0,1,1,26,0,4,1,27,0,ariane 5 rocket launch postponed
0,3,5,86,1,14,0,91,0,trident: barack obama administration asked david cameron keep failed nuclear missile test launch secret
0,2,8,35,2,9,0,43,0,check full credit drake 'more life' album
0,1,3,15,0,3,0,18,0,fenway freeze
0,3,1,63,0,8,0,64,0,ebola survivor frontline fighter dy childbirth complication
0,2,7,28,1,6,0,35,0,job program trump budget would cut
0,1,5,30,0,6,0,35,0,state city angle stimulus cash
0,3,6,30,1,7,0,36,0,barack obama: eight year white house
0,2,3,46,1,9,0,49,0,family home pension asset test: tony shepherd
0,3,10,51,1,10,0,61,0,watch madonna audition dancer rebel heart tour: exclusive video
0,2,9,37,0,9,0,46,0,trump labor nominee acosta get backup tv airwave
0,2,7,45,1,8,0,52,0,delta operation recovering; trump blame airline delay
0,1,3,31,1,6,0,34,0,john gotti jr. arrested murder charge
0,2,2,43,0,10,2,45,0,least 16 killed panama bus drive ravine
0,3,8,35,1,7,0,43,0,robo-bees may bring new fix pollination problem
0,1,3,31,0,6,0,34,0,battle bulge reenacted belgium
0,1,2,42,2,6,0,44,0,san francisco hit-and-run suspect caught lying
0,3,2,41,2,8,0,43,0,here's much legroom get america's airline
0,2,4,76,1,15,0,80,0,government looked impact tax break housing market act: foi investigation
0,1,2,18,0,2,0,20,0,valech report released
0,1,4,42,1,6,0,46,0,cyclone laila lash across india's eastern coastline
0,2,2,56,0,12,2,58,0,least 12 people dead night looting violence venezuela
0,1,5,24,1,6,0,29,0,golf injury? know rule thump
0,3,4,34,3,6,0,38,0,churchill arms: britain's festive pub?
0,2,9,37,1,5,0,46,0,youtube announces cable-free tv subscription service
0,3,2,57,0,10,0,59,0,president trump sign executive order targeting foreign work visa
0,1,2,26,1,5,0,28,0,u swimmer dy open-water race
0,3,4,65,0,12,0,69,0,donald trump offer fund planned parenthood stop helping abortion
0,2,5,34,1,9,5,39,0,"greek prepare evacuate 75,000 defuse wwii bomb"
0,3,16,57,2,14,0,73,0,"govt reject m dhoni, gurmeet ram rahim singh arnab goswami's name padma award"
0,2,8,42,0,7,0,50,0,black new england patriot player boycotting trump visit
0,1,7,25,2,6,0,32,0,free-speech case debt-ridden age
0,1,2,39,0,5,0,41,0,teenager arrested hijacking japanese bus
0,3,19,46,0,17,0,65,0,someone found old tv show con man named trump wanted build awall
0,1,8,27,0,7,0,35,0,apple cancel nbc fall tv lineup itunes
0,2,6,51,0,10,0,57,0,tom hardy returning cbeebies valentine day bedtime story
0,2,1,63,1,11,0,64,0,"revised travel ban target seven countries, exempts green card holder"
0,2,8,33,0,7,0,41,0,saturday night live hire three new cast member
0,1,2,43,0,7,0,45,0,ten killed suicide bomber southern afghanistan
0,1,6,36,0,6,0,42,0,omnifone nears broadband music service europe
0,1,1,50,0,9,0,51,0,sweden celebrates first national day public holiday
0,2,9,44,3,7,0,53,0,brookfield find solar entry point sunedison's collapse
0,3,2,50,4,8,0,52,0,"women, heavy drinking normalized. thats dangerous."
0,3,10,47,2,9,0,57,0,coalition abortion provider sue texas 'fetal burial' rule
0,3,1,34,0,6,0,35,0,adorable panda roll around thick snow
0,3,4,29,0,5,0,33,0,nicki minaj confirms meek mill breakup
0,3,4,46,2,8,0,50,0,applecare care electronics travel ban? maybe!
0,1,7,36,1,8,0,43,0,"job condition worsen area china, expert say"
0,3,3,38,0,7,0,41,0,islamic state group using human shield mosul
0,1,3,67,1,10,0,70,0,insurgent kill several people baghdad iraq's parliamentary election start
0,2,4,64,3,11,0,68,0,friend like these: china awkward position north korea missile test
0,2,12,57,0,13,0,69,0,two british police officer used taser black race relation advisor
0,2,3,45,0,10,0,48,0,nfl player combat veteran join force save life
0,2,2,37,1,4,0,39,0,subway commuter scrub anti-semitic graffiti
0,2,1,46,1,11,5,47,0,canada eye plan legalize marijuana 2018: 5 thing know
0,2,15,68,4,14,0,83,0,billie lourd thanks friend 'finding funny' carrie fisher's debbie reynolds' death
0,2,12,38,1,8,0,50,0,oil-producing country agree cut output along opec
0,2,2,44,0,8,0,46,0,trump becoming punch line french politician
0,3,12,63,5,14,0,75,0,white house: official 'sanctuary cities' 'the blood dead american hands'
0,2,6,47,2,10,0,53,0,"nike, armour, adidas interested deal lonzo ball"
0,2,9,48,1,11,1,57,0,"4 dead suspected chemical poisoning texas home, official say"
0,2,11,48,3,13,0,59,0,"batcave, graffiti landmark brooklyn, grows new york time"
0,1,4,80,1,12,0,84,0,"temporary restraining order stop demolition partially collapsed building buffalo, new york"
0,2,8,54,1,12,0,62,0,wa election: new era labor mark mcgowan elected premier landslide
0,1,7,29,2,7,0,36,0,"rays, surprising more, look improve"
0,2,14,58,2,12,0,72,0,toyota turn plug-in prius launch celebration hybrid technology's birthday
0,3,9,28,4,9,0,37,0,rick ross recruit gucci mane 'she d--k'
0,3,11,44,0,10,0,55,0,jon stewart finally went long election donald trump
0,1,4,31,0,5,0,35,0,turk caicos island premier resigns
0,3,11,34,3,10,0,45,0,"trump, japan's abe agree keep unity north korea: nhk"
0,2,7,35,0,7,0,42,0,wolf blitzer blame indiana chicago gun crime
0,3,0,75,2,16,2,75,0,90-year-old pilot crashed tree may felt pressure fly despite bad condition
0,2,3,73,0,11,0,76,0,u military investigation clear troop civilian death raid afghanistan
0,2,11,45,2,10,0,56,0,"republican cant get lawmaker, obamacare repeal may dead"
0,3,2,56,1,9,0,58,0,conservative say they're tired seeing obamacare draft via leak
0,1,3,30,1,4,0,33,0,"moderate earthquake hit crete, greece"
0,2,1,28,1,5,0,29,0,husband wifeswingwoman
0,3,7,32,0,8,0,39,0,lesson chimp mother last lifetime
0,1,1,49,0,6,0,50,0,hungarian conservative party win majority parliament
0,3,6,31,0,5,0,37,0,bella hadid address fyre festival fiasco
0,2,2,42,2,8,0,44,0,"vitamin doesnt prevent disease most, study say"
0,3,2,50,3,9,2,52,0,tenn. teacher allegedly planned take 15-year-old girl mexico
0,3,7,70,3,14,0,77,0,every country surveyed would vote remain eu referendum... including britain list
0,1,3,30,2,7,5,33,0,"un: 30,000 people affected flooding kenya"
0,1,3,37,2,5,0,40,0,source uk foot-and-mouth outbreak discovered
0,3,12,38,0,11,0,50,0,adele sends love emma stone best actress oscar win
0,3,2,83,1,11,0,85,0,"scott morrison flag budget reporting changes, allocate expenditure individual portfolio"
0,1,2,33,0,4,0,35,0,senate committee hears bailout proposal
0,3,8,33,4,9,0,41,0,world fear trump america. thats good thing.
0,1,10,54,0,13,1,64,0,gazan doctor peace advocate loses 3 daughter israeli fire asks
0,1,6,28,1,3,0,34,0,bbc director-general entwistle resigns
0,1,5,48,0,6,0,53,0,romanian pm siemens discus electroputere privatisation
0,1,5,40,2,8,2,45,0,"british liberal democrat patsy calton, 56, dy cancer"
0,2,8,56,1,10,0,64,0,"nicki minaj collection discontinued kmart, rep retailer confirms"
0,2,3,73,5,12,0,76,0,animal right activist went cross-country anti-fur rampage. final stop: federal prison.
0,2,1,60,0,9,0,61,0,belgian police break street protest attack investigation widens
0,2,10,45,1,9,0,55,0,ally brooke hernandez drop hint fifth harmony's new album
0,3,1,17,0,5,2,18,0,oil rig count jump 17
0,3,6,72,2,10,0,78,0,"csiro say red tape holding back australia's medical technology, pharmaceutical industry"
0,2,4,39,1,7,0,43,0,post jimmy garoppolo's instagram set frenzy
0,3,2,48,1,8,0,50,0,mainstream medium put call pro-trump columnist
0,1,2,56,0,11,0,58,0,large forest fire continues burn third day southern norway
0,1,6,26,1,6,0,32,0,"meet gar ryness, batting stance guy"
0,3,1,55,5,8,1,56,0,"cancer-stricken 5-year-old's photo used charity scam, family claim"
0,2,12,41,1,10,0,53,0,russia label nato move eastern europe threat: state medium
0,1,1,32,3,5,2,33,0,china's military spending increase 7.5%
0,1,1,35,0,6,0,36,0,first charge laid riot text message
0,3,4,54,0,11,0,58,0,u carrot stick approach north korea clumsy significant
0,1,4,25,0,4,0,29,0,space shuttle land california
0,1,7,46,1,9,0,53,0,tennis: justine henin defeat jelena jankovic win rogers cup
0,3,4,45,1,11,0,49,0,mama june shannon open drastic weight loss yahoo
0,1,3,29,0,4,0,32,0,white house release benghazi email
0,2,8,40,1,9,0,48,0,five new power centers: guide fractured democrat
0,2,3,56,0,9,0,59,0,one nation strike sugarcane dispute derail government agenda
0,3,16,62,1,14,0,78,0,"manohar parrikar resigns become goa cm, arun jaitley get charge defence ministry"
0,1,6,31,0,7,0,37,0,asian stock rise hope treasury plan
0,3,6,42,4,7,1,48,0,dorial green-beckham fined $6k 'yeezy foundation' cleat
0,2,11,51,4,13,0,62,0,dem rep tim ryan: democrat obligation work trump breitbart
0,2,5,45,2,11,4,50,0,"bill paxton dead: apollo 13, titanic twister actor dy aged 61"
0,1,2,39,0,7,0,41,0,armed gunman attack cruise ship somali coast
0,2,7,40,0,7,0,47,0,chris stamp tease another stampd x kith collaboration
0,2,2,58,3,10,0,60,0,coolest place planet accolade stir interest ireland wild north
0,3,11,43,5,9,0,54,0,spider-man: homecoming two black female lead itsawesome
0,2,10,44,4,12,0,54,0,"fleeing u.s. asylum, handcuffed canada new york time"
0,2,1,50,0,10,0,51,0,load animal pancake human weird
0,1,2,31,0,5,0,33,0,gazprom stop supplying gas moldova
0,2,7,39,2,9,2,46,0,"china gunman kill 4, injures 5 shooting rampage: police"
0,3,1,32,0,7,4,33,0,stock market rally could last 2018
0,3,2,46,2,9,0,48,0,donald trump's inauguration speech full read watch
0,1,3,43,1,8,1,46,0,"8 dead following road collision new brunswick, canada"
0,2,3,24,0,4,0,27,0,good riddance filibuster
0,1,2,60,1,10,0,62,0,southern sudan's defence minister among killed major plane crash
0,1,4,34,1,7,3,38,0,scotland defeat england 15-9 win calcutta cup
0,3,12,60,2,11,0,72,0,kate mckinnon brought back hilarious jeff session impression 'weekend update'
0,3,8,45,1,7,0,53,0,trump immigration ban excludes country business tie
0,3,12,50,7,13,3,62,0,"'maria' 'shake bon-bon,' listen ricky martin's billboard hot 100 hit"
0,3,15,37,3,9,0,52,0,yahoo: hacker stole data another billion account -- updated
0,1,2,41,1,7,0,43,0,one million pilgrim attend open-air mass pope
0,3,9,46,2,8,0,55,0,terrence jones burn brooklyn net fake behind-the-back move
0,3,7,46,1,8,0,53,0,key republican would vote gop's obamacare replacement
0,3,7,38,0,9,0,45,0,warren buffett naked truth dow chemical
0,3,15,64,1,15,2,79,0,"activist bela bhatia helped tribal rape victim threatened, asked leave bastar 24 hour"
0,2,9,44,2,9,1,53,0,british songwriter accuses u2 stealing song 'achtung baby'
0,2,9,32,1,8,0,41,0,shocking story cant miss thisweek
0,1,5,33,2,6,2,38,0,scottish premier league: celtic thump heart 5-0
0,1,8,40,1,7,0,48,0,"tax haven acquiesce, monaco adopts banking standard"
0,1,7,33,2,7,0,40,0,"historical trove, freed storage, get home"
0,3,9,57,1,8,0,66,0,michele robert call phil jackson's carmelo anthony comment inappropriate
0,2,1,59,3,10,2,60,0,startup that's developed anti-aging supplement raised $20 million
0,1,5,59,0,10,0,64,0,australian pm gillard pressured address human right crackdown china
0,1,12,36,5,8,0,48,0,"cleveland state, healing begin another n.c.a.a. bid"
0,1,3,63,1,8,0,66,0,uk government formally launch same-sex marriage legislation parliament
0,3,7,42,0,8,1,49,0,norwegian hockey playoff game go record 8 overtime
0,1,8,31,1,8,0,39,0,"identifying bird, much bird left"
0,1,9,49,3,9,0,58,0,"gen. petraeus, amb. crocker testify u armed service committee"
0,3,6,49,3,9,0,55,0,u ambassador samantha power: russia 'tearing down' global order
0,3,8,32,2,7,0,40,0,'serial' subject adnan syed denied bail motion
0,2,8,44,0,7,0,52,0,temptation bass player kerry turman dy performance
0,3,9,47,1,10,0,56,0,"mario lemieux sends letter, signed hockey puck child hospital"
0,2,8,53,2,10,1,61,0,"republicans, facing pressure, delay hearing 4 trump cabinet nominee"
0,1,5,44,1,9,0,49,0,"petrol pricing bathurst, nsw reduced seven day"
0,1,3,58,3,9,0,61,0,opposition leader predicts 'people's revolt' australia carbon tax
0,3,4,46,2,10,2,50,0,"u oil-rig count rise 11th straight week, baker hughes say"
0,1,3,32,1,6,0,35,0,minor tear found gordon brown's retina
0,1,8,37,0,10,0,45,0,latvia race cut deficit keep bailout deal
0,2,1,49,0,11,0,50,0,visit nearly every national park one epic road trip
0,2,3,65,3,13,2,68,0,23-year-old kid suddenly became oakland raiders' best shot championship
0,3,6,45,1,10,0,51,0,"fa powerless stop world cup expansion, say martin glenn"
0,2,3,32,7,7,0,35,0,uzzle's 'puzzles': 'you can't make stuff up'
0,2,3,43,0,11,0,46,0,one four u kid exposed weapon violence
0,2,2,58,2,9,0,60,0,pulitzer prize-winning author say thinking money wrong
0,1,8,27,2,9,0,35,0,"now, albert pujols home st. louis"
0,2,3,37,4,9,3,40,0,ex-giant open drug addiction: 125 vicodin aday
0,1,2,40,1,8,2,42,0,tonga: four guilty ferry disaster killed 74
0,2,4,51,0,10,2,55,0,moussa dembl score celtic beat hamilton 21st straight win
0,2,11,42,2,13,0,53,0,preet bharara said refuse order step u.s. attorney
0,3,4,45,3,12,0,49,0,wish could tell boss: 'you care yourself'
0,3,11,34,5,11,0,45,0,"lil uzi vert literally got animated ""p's q's"" video"
0,1,3,45,2,8,0,48,0,lost tomb 'gladiator' real life roman inspiration found
0,1,3,45,0,6,0,48,0,north korean military detains two american journalist
0,1,3,45,2,8,0,48,0,canada's leadership debate: green party take part
0,3,8,41,0,7,0,49,0,azealia bank seemingly suspended facebook
0,1,2,59,0,8,0,61,0,palestinian radio station broadcast praise london terror attack
0,2,2,35,0,7,0,37,0,trump say penny lead voter fraud panel
0,3,5,27,1,4,0,32,0,watch live: state department briefing
0,2,10,49,1,9,0,59,0,realistic recommend delaying pregnancy zika outbreak?
0,2,7,31,5,9,3,38,0,hannity: 'the left pre-9/11 mentality' insider
0,2,14,48,1,12,0,62,0,reality star ex-rapper team coach miami high school football team
0,3,12,44,3,11,0,56,0,"people losing guy's massive ""wheel fortune"" fuckup"
0,1,3,41,0,7,0,44,0,blog alliance form leaked downing street memo
0,2,9,61,0,9,0,70,0,giant alligator walk onto golf course celebrity invitational tournament
0,1,3,54,0,8,0,57,0,civil unrest iranian city ahmadinejad declares victory
0,1,8,37,0,10,0,45,0,south korea agrees call talk north korea
0,1,9,32,4,7,3,41,0,a.i.g. planning huge bonus $170 billion bailout
0,2,3,57,2,11,0,60,0,"endorsement, close; obama comment hint support clinton"
0,3,4,54,4,15,0,58,0,"fox's 'apb' next generation cop drama, apps prove"
0,3,5,39,2,8,0,44,0,'condemned' south korean dog find sanctuary u
0,2,3,50,0,11,0,53,0,iceberg size delaware break antarctica
0,3,3,34,1,6,0,37,0,heligoland: island britain tried sink
0,3,11,44,1,10,0,55,0,teen protested high school's sexist prom dress code
0,2,1,50,0,11,3,51,0,twitch streamer father 3 dy 22 hour charity stream
0,1,5,46,0,10,0,51,0,report claim uk might withdraw iraq early october
0,3,14,50,2,8,0,64,0,michael lewis: behavioral psychology explains trump's surprise victory
0,1,2,38,0,8,3,40,0,100 killed southern sudan tribal clash
0,3,1,57,1,11,2,58,0,family could lose 16% income national insurance change
0,1,8,34,0,8,0,42,0,obama tell congress agenda aid economy
0,3,5,74,2,16,0,79,0,american composer say detained hour jfk super common muslim name
0,3,3,60,0,12,1,63,0,chelsea clinton share 4 inspiring tip young activist trump era
0,2,11,59,5,11,0,70,0,krauthammer: 'pretty big violation' trump team 'improperly' surveilled insider
0,2,8,36,2,7,0,44,0,robert lighthizer named u.s. trade representative
0,3,7,35,2,7,0,42,0,emerging trump doctrine: dont follow doctrine
0,3,7,57,1,11,0,64,0,yadier molina demand apology adam jones' comment wbc party plan
0,1,7,42,0,7,0,49,0,american setting pace nordic world championship
0,1,4,37,3,7,0,41,0,india u.s.a. work toward nuclear fuel agreement
0,1,2,72,0,8,0,74,0,secret memo reveal bush administration endorsed enhanced interrogation technique
0,1,4,42,0,8,0,46,0,fiona donnison jailed murdering child uk
0,3,10,48,1,10,0,58,0,watch steve aoki's miami music week interview get crashed hardwell
0,2,14,51,3,12,0,65,0,"tired waitlists uncertainty, chinese favor u.s. visa green card"
0,3,4,48,6,10,0,52,0,putting america first isnt problem. trump version is.
0,3,5,59,0,9,0,64,0,celebrity film database imdb fight california age discrimination law
0,3,2,48,3,9,1,50,0,"boy, 5, dy stuck atlanta's rotating restaurant"
0,1,4,67,1,12,0,71,0,"passenger claim bomb, killed air marshal miami international airport"
0,2,10,45,2,11,3,55,0,600 people arrested u.s. immigration official one week
0,3,4,86,5,18,0,90,0,"weve got new detail guardian galaxy ride disneyland, apparently full secret"
0,1,3,33,0,5,0,36,0,new zealand journalist deported fiji
0,3,8,37,5,7,0,45,0,"nancy pelosi: border wall immoral, expensive, unwise"
0,3,8,49,0,8,0,57,0,derrick rose reportedly considered trade target multiple team
0,1,7,31,0,7,1,38,0,china fire 8 top regulator milk scandal
0,2,4,70,1,17,0,74,0,need stop hysterical president erdogan turkey offer
0,3,2,71,4,16,0,73,0,"army life 'boring' thats terrible soldier, say new armed force minister"
0,3,7,45,0,8,0,52,0,cleanup begin dakota access pipeline protest encampment
0,3,4,53,2,8,2,57,0,facebook host 24-hour livestream event international women's day
0,2,7,17,0,6,0,24,0,iowa straw poll
0,2,17,60,2,14,0,77,0,espn graphic show two louisville player listed citrus bowl due 'gunshot wounds'
0,2,3,44,0,9,0,47,0,phil jackson keep meddling bad look forhornacek
0,2,16,51,3,15,0,67,0,"people thanking george michael proving ""theres one right way man"""
0,2,5,54,3,11,0,59,0,"russia military say may killed leader; west, iraq skeptical"
0,3,7,27,5,6,0,34,0,"n.f.l. playoffs: schedule, matchup odds"
0,1,2,56,0,10,3,58,0,100 reported dead syrian troop move protester
0,3,3,34,0,6,0,37,0,trump decline offer white house playset
0,1,6,34,1,7,0,40,0,"grand plan moon mars, budget permitting"
0,2,16,69,6,18,0,85,0,"waters: believe trump colluded russians, havent seen evidence back breitbart"
0,2,2,62,3,16,0,64,0,oscar favorite arrival one best movie year big surprise
0,2,10,45,4,10,0,55,0,attorney smith family: 'verdict bring little peace'
0,1,1,42,1,6,0,43,0,thief force-fed fifty banana retrieve necklace
0,1,2,44,0,8,0,46,0,united state charge eleven credit card fraud case
0,3,12,51,0,13,1,63,0,lebron james reacts warrior fan spit vulgarity game 2
0,1,1,50,0,7,0,51,0,luxembourg head government resigns eighteen year
0,3,2,33,1,8,0,35,0,photo trump's war room tell u
0,1,7,38,0,8,0,45,0,permanent flood solution reach fargo
0,3,4,85,1,16,0,89,0,"housing affordability issue could helped allowing renter buy without deposit, federal mp say"
0,1,6,37,0,7,0,43,0,cavalier give cleveland shot reversing role
0,2,2,73,2,16,0,75,0,ai soon replace hundred thousand public sector worker that's good thing
0,3,9,45,2,8,0,54,0,lagarde warns u.s. targeting single nation currency
0,3,4,52,1,11,0,56,0,"new trade deal india could year away, malcolm turnbull say"
0,2,11,40,0,10,0,51,0,kendall jenner red hot latest este lauder campaign
0,3,5,48,4,9,0,53,0,academy change documentary rule o.j. made america win
0,2,8,39,2,10,4,47,0,"yahoo put 3,000 patent auction block breitbart"
0,1,3,54,0,8,0,57,0,australian tv network reprimanded breaching code practice
0,1,4,14,1,2,0,18,0,last-place standout
0,3,2,34,0,7,0,36,0,key apple supplier saw profit explode
0,2,3,37,2,7,0,40,0,china blast petty taiwan phone call trump
0,2,7,34,1,7,0,41,0,european east-west divide widens ahead brexit
0,3,8,23,0,6,0,31,0,handing award every nba team
0,1,7,63,0,11,0,70,0,concern china oil subsidiary unocal buying u energy infrastructure
0,3,12,53,6,11,0,65,0,"bolling: trump stop 'banksters', ceo 'fooling' average american insider"
0,1,2,41,1,7,0,43,0,england beat india one-day cricket series opener
0,2,16,68,5,16,2,84,0,"nice attack rerun berlin 'asylum seeker' ram truck christmas market. 12 killed, dozen injured."
0,1,7,31,3,6,0,38,0,"jonathan coulton, non-rock star, need roadie"
0,1,2,31,0,5,3,33,0,coptic christian select 118th pope
0,2,2,58,1,11,0,60,0,"banker worked russian secret agent released early, deported"
0,1,6,25,0,6,0,31,0,prince rainier iii monaco died
0,3,11,51,6,10,0,62,0,"watch kate mckinnon's re-enact ""fatal attraction"" kellyanne conway 'snl'"
0,3,1,48,2,8,0,49,0,company exist immigrant
0,1,3,55,0,7,0,58,0,former japanese prime minister hashimoto indicated retirement
0,3,3,39,0,9,2,42,0,plo name youth camp terrorist murdered 37
0,3,1,21,0,3,0,22,0,produced published
0,1,8,31,0,9,0,39,0,firm track sell data web click
0,3,12,41,0,11,0,53,0,brown ot joe thomas chime free agent qb colin kaepernick
0,2,3,58,2,12,0,61,0,grandfather died fighting hitler. make legacy?
0,2,12,50,4,11,0,62,0,"calling bos ""nasty motherfucker"" get fired, judge rule"
0,3,4,35,3,9,0,39,0,"deshaun watson left legacy (yes, capital l)"
0,1,2,27,0,3,0,29,0,minor earthquake shake illinois
0,2,6,36,3,7,0,42,0,dunkin donut private test delivery service
0,2,3,48,1,9,4,51,0,scarlett johansson named top-grossing actor 2016 forbes
0,1,4,43,1,8,0,47,0,gordon brown: lead britain economic crisis
0,3,7,45,0,7,0,52,0,australia order sale illegal foreign property purchase
0,2,7,52,0,11,0,59,0,wa government ramp pressure perth mayor lisa scaffidi resign
0,2,8,32,0,11,0,40,0,cost tesla rocket hong kong
0,2,10,39,8,12,4,49,0,"ed sheeran's 'shape' top hot 100, lady gaga's 'reasons' return no. 4"
0,2,7,63,4,17,0,70,0,thats meant sideburns! indian barber cut men hair setting fire
0,1,6,36,0,6,0,42,0,congress pass bill tighten weapon program
0,2,2,49,3,9,0,51,0,happened 'grimm' favorite series finale?
0,1,4,20,0,5,2,24,0,bombing iraq kill 11 people
0,1,6,32,1,8,0,38,0,faa: jet new york airport directed child
0,1,8,29,4,7,0,37,0,"riveting n.h.l. playoff series, come"
0,1,4,43,2,6,0,47,0,"officials: eight insurgent killed orakzai, pakistan"
0,3,5,27,1,6,0,32,0,"american dream, quantified last"
0,2,4,42,2,9,2,46,0,oman accepts 10 guantanamo detainee request u.s.
0,3,15,69,3,14,0,84,0,"united passenger's daughter say family ""horrified shocked sickened"" happened"
0,3,4,67,0,11,0,71,0,fight compensation land aboriginal war veteran herbert lovett refused
0,3,10,58,0,9,0,68,0,trump administration sued delaying endangered specie protection forbees
0,3,13,51,4,12,1,64,0,trump fl campaign rally coordinator: 'this 1st re-election rally' insider
0,2,10,42,0,9,4,52,0,lauri markkanen declares 2017 nba draft freshman season
0,3,5,62,5,12,0,67,0,know putin feel failure: bill maher blast trump health-care flop
0,2,7,40,3,9,6,47,0,"twitter glitch made 560,000 people follow trump's @potus account"
0,1,6,30,0,5,0,36,0,iraqi official expect move amid inquiry
0,3,12,55,4,10,0,67,0,"north korea, characteristic bluster, threatens sink u.s. aircraft carrier"
0,3,6,20,0,5,0,26,0,british want cup back
0,3,1,54,0,9,0,55,0,dog visit dying owner hospital give heartbreaking goodbye
0,1,2,34,0,6,0,36,0,saturn moon enceladus may salty ocean
0,2,12,54,3,11,0,66,0,white house staff drop correspondents' dinner 'solidarity' trump
0,3,11,34,2,10,0,45,0,"migos link hoodrich pablo juan new banger ""i can"""
0,2,8,45,0,8,0,53,0,wiz khalifa former manager benjy grinberg settle lawsuit
0,1,2,50,1,7,0,52,0,"equatorial guinea coup plotter pardoned, released jail"
0,2,5,52,1,9,0,57,0,internet quickly turn gop's obamacare replacement plan meme
0,1,6,37,2,5,1,43,0,kosmos-3m rocket launch fourth sar-lupe satellite
0,1,4,37,0,7,0,41,0,nyc transit asks member ratify new contract
0,1,2,56,0,7,0,58,0,police make significant progress london bombing investigation
0,1,5,36,0,6,0,41,0,tropical storm danielle form atlantic ocean
0,2,14,57,2,13,0,71,0,college lecturer punched face knocked freezing canal white
0,2,3,33,0,5,0,36,0,warren buffett almost triple applestake
0,3,9,40,0,9,0,49,0,trump offer britain quick trade accord shuns europe
0,2,5,29,0,6,0,34,0,bob dylan receives nobel prize sweden
0,1,9,27,2,9,1,36,0,"apple announces mac o x lion, io 5, icloud"
0,2,5,58,4,12,2,63,0,mental health org 'stranger things' star send warning '13 reason why'
0,1,6,42,2,7,0,48,0,"obama, caterpillar plant, lobby stimulus package"
0,3,3,60,1,10,0,63,0,donald trump make last-ditch pitch republican back healthcare bill
0,2,1,43,0,7,0,44,0,flipboard fight back major change reader
0,2,6,40,3,8,0,46,0,mad dog pitch mike francesa stephen a.replacement
0,1,4,30,0,4,0,34,0,opposition win presidency mongolia
0,3,3,58,1,15,0,61,0,great repeal bill give tory free hand. watch
0,1,5,45,2,10,0,50,0,taco bell pull green onion u.s. canadian store
0,2,3,64,0,9,0,67,0,charleston shooting survivor describe emotional pain dylann roof inflicted
0,1,7,27,1,7,0,34,0,"mexico, obama seek curb arm sale"
0,1,5,31,0,6,0,36,0,iphone upgrade counter naysayer
0,1,6,27,1,4,0,33,0,coca-cola considers buying back share
0,3,6,39,0,8,0,45,0,el salvador tv star pamela posada denies cartel link
0,2,15,52,0,14,0,67,0,twitter bot handclap emoji tweet shut becameracist
0,3,5,56,0,11,0,61,0,donald trump call individual within freedom caucus twitter
0,2,3,50,3,8,0,53,0,argentina reach settlement u.s. debt class action: mediator
0,3,10,41,2,8,0,51,0,caitlyn jenner say robert kardashian thought o.j. guilty
0,2,8,40,4,7,0,48,0,jared kushners sister woos china golden visa investor
0,1,6,39,0,5,0,45,0,julie ditty win colemanvision tennis championship
0,2,10,57,1,13,0,67,0,doris damm built business temporary staffing; fed turned insight
0,2,7,38,2,8,2,45,0,algeria sonatrach boost output 20% new project
0,2,1,40,3,6,4,41,0,"pregnancy diabetes guideline 'could miss 4,000 women'"
0,3,12,37,3,10,0,49,0,bmws u.k. worker set first strike decade brexit loom
0,2,10,41,2,9,0,51,0,ex-barclays banker leaked tip job plumber; get jail
0,3,2,52,3,11,0,54,0,state say lifting halt trump's travel ban would 'unleash chaos'
0,1,2,38,0,7,3,40,0,least 728 rescued burning indonesian ferry
0,3,10,56,1,13,0,66,0,super bowl prediction: wall street quants taking falcon point
0,3,1,40,0,7,0,41,0,american entering labor force drove
0,1,3,23,0,4,0,26,0,mass industrial walkout uk
0,3,9,45,3,7,0,54,0,peak spinning: fisher-price release high-tech bike toddler
0,2,5,55,4,11,0,60,0,ruth bader ginsburg: we're mindful enough 'what make america great'
0,3,3,76,0,16,0,79,0,former mexican governor run police month arrested guatemala
0,2,3,50,5,10,3,53,0,"san bernardino school shooting: 'i'm scared,' panicked 911 caller say"
0,1,11,26,6,10,0,37,0,u.s. see smaller g.m. future g.m.
0,2,11,35,0,9,0,46,0,deray mckesson going host crooked mediapodcast
0,3,3,71,2,10,0,74,0,doctor fight becoming 'border guards' home office immigration enforcement
0,1,4,30,0,6,2,34,0,longer unemployment 45 older
0,1,2,28,0,5,0,30,0,bomb explodes busy beirut street
0,1,5,51,2,8,0,56,0,unanimous u.s. supreme court rule file swapping company
0,3,10,40,1,9,0,50,0,britain need company like this. brexit may scare
0,1,1,36,0,5,0,37,0,canadian province brace flooding
0,1,1,37,1,5,2,38,0,6.1 magnitude aftershock earthquake hit haiti
0,1,3,50,0,10,0,53,0,saudi arabia fear hajj swine flu outbreak four pilgrim die
0,1,1,50,1,7,0,51,0,"wikipedia sister project prepare new, easier interface"
0,1,6,26,1,8,2,32,0,profit drop 95% bank new york mellon
0,3,6,84,3,16,0,90,0,specialist guerilla fighter: estonia's citizen army gear deter vladimir putin's war machine
0,1,2,27,0,5,0,29,0,car bomb defused central london
0,1,5,29,0,5,0,34,0,deepening slump seen european output
0,2,9,52,2,10,4,61,0,"severe storm batter georgia leaving 12 dead, 23 injured: emergency official"
0,2,1,46,0,9,0,47,0,white officer seeking throw fatal shooting video
0,1,1,35,0,6,0,36,0,somali pirate launch attack oil tanker
0,1,1,36,0,7,0,37,0,china sentence six death riot
0,2,10,44,1,9,0,54,0,chobani gave employee financial stake company future
0,3,5,51,0,9,0,56,0,un council endorses syria ceasefire brokered russia turkey
0,3,7,52,0,9,0,59,0,fbi warns islamic state targeting u church holiday gathering
0,3,9,42,0,9,0,51,0,trump seen paying putin sanction relief coming
0,2,3,68,2,11,0,71,0,'pangolin princess' detained china posting image online cooked wildlife
0,3,1,45,3,9,0,46,0,deep-sea 'ghost shark' caught camera first time
0,2,10,48,0,9,0,58,0,new york subway station feature gay couple groundbreaking mural
0,3,10,42,2,9,0,52,0,"transgender man outed ""survivor"" another contestant"
0,3,1,82,2,11,2,83,0,"earth's interior temperature 60 degree hotter previously thought, student accidentally find"
0,1,7,35,0,7,0,42,0,croatia court old enemy tourism spending
0,1,5,37,0,6,0,42,0,carrier sweeten deal prepaid cellphone
0,1,4,23,0,6,1,27,0,charm silliness round 1
0,3,3,51,1,9,0,54,0,"wall street post mixed finish, nasdaq hit another record close"
0,3,1,47,1,9,0,48,0,donor unite nationwide pay kids' school lunch debt
0,2,1,42,2,6,0,43,0,another woman killed cursed apartmentbuilding
0,1,3,35,1,6,1,38,0,airplane crash schiphol airport; 9 killed
0,1,1,58,0,8,0,59,0,thailand force registration prepaid phone thwart insurgency
0,3,11,47,1,10,0,58,0,dana white say floyd mayweather vs. conor mcgregor fight happen
0,2,2,60,1,9,0,62,0,rogue llama prompt comical response local georgia sheriff's office
0,2,4,46,0,9,0,50,0,oregon zoo staff infected tb exposure elephant
0,3,2,50,0,8,0,52,0,score firefighter tackle warehouse blaze east london
0,3,5,40,2,10,0,45,0,'constantine' coming back tv animated cw show
0,1,3,34,0,5,0,37,0,writer meet weekly ashland underground
0,3,11,38,0,9,0,49,0,needle cam diagnose joint injury without mri
0,2,13,50,5,14,0,63,0,"warren buffett, annual letter, offer hymn u.s. economy new york time"
0,3,5,27,1,7,0,32,0,picture betty white year
0,1,4,26,2,6,6,30,0,"english football: roundup april 25, 2009"
0,2,6,32,3,7,3,38,0,american net worth reach high $84.9 trillion
0,1,4,23,0,6,2,27,0,u novelist john updike dy age 76
0,2,10,33,2,10,0,43,0,famous mary tyler moore show house sale
0,1,2,47,2,8,0,49,0,mugabe 'prepared fight' zimbabwe elect opposition
0,1,6,34,0,6,0,40,0,special keepsake inauguration column
0,2,18,71,4,17,0,89,0,even struggling economy italian world's healthiest people. here's learn them!
0,1,8,54,2,11,0,62,0,"mayor investigation san jose, ca, usa spending without consent"
0,3,3,54,2,12,0,57,0,'worst worst' blocked obama keeping promise close gitmo
0,2,9,26,0,8,0,35,0,stylish team nba right
0,1,9,42,2,9,0,51,0,"arturo gatti, former boxing champion, found dead hotel room"
0,3,18,73,3,19,1,91,0,watch newsy season 1 web exclusive free online cancer-causing mutation might bad luck yahoo view
0,1,1,45,0,9,0,46,0,search rescue beacon soon make digital jump
0,1,4,21,0,3,0,25,0,norway slide recession
0,2,12,44,1,10,1,56,0,"president trump sign 3 presidential memorandums, pull u tpp"
0,1,1,27,0,5,2,28,0,spanish football captain dy 26
0,1,1,51,2,8,1,52,0,"canadian gasoline top $1 litre, politician consider option"
0,2,12,63,8,11,0,75,0,tim allen hammer precious snowflake microaggressions last man standing (video)
0,2,1,49,1,8,2,50,0,"pakistan shrine custodian fatally stab 20 people, police say"
0,1,4,44,0,7,0,48,0,letter regarding time square bombing sent congress
0,2,10,52,2,12,0,62,0,protest grows nowhere kennedy airport iraqi detained
0,3,2,78,2,19,0,80,0,well thats rude! cheeky chimp flip finger tourist took picture forest
0,2,5,53,2,14,0,58,0,"u data better, fed likely hold rate rise business insider"
0,2,7,38,0,11,2,45,0,13 killed texas church bus pickup truck collide
0,1,2,23,0,4,0,25,0,james brown dy pneumonia
0,2,5,23,0,5,0,28,0,appeal fellow catholic
0,1,4,26,0,4,0,30,0,retailer knockoff abound india
0,1,7,32,1,8,4,39,0,"skeleton 4,000 year old bear evidence leprosy"
0,3,9,48,1,11,0,57,0,ford bronco jeep wagoneer: classic american suv make come back
0,2,10,54,3,11,6,64,0,juda priest share live 1986 track 'turbo' 30th anniversary edition: exclusive
0,3,9,47,2,10,0,56,0,"china agrees return seized drone, ending standoff, pentagon say"
0,3,5,60,1,9,0,65,0,kellyanne conway defends donald trump's response russian hacking story
0,3,9,39,1,7,0,48,0,trump pull back obama-era protection woman worker
0,3,9,59,2,9,0,68,0,patrick ewing reportedly 'major candidate' georgetown basketball head coach
0,3,2,31,0,8,0,33,0,lib dems bid widen law revenge porn
0,3,4,23,1,4,0,27,0,happened banker bashing?
0,1,6,29,0,5,0,35,0,sharp trade contraction know border
0,2,2,54,1,10,0,56,0,transformer superyacht that's also jet plane helicopter
0,3,5,26,3,6,0,31,0,chris brown guest star 'black-ish'
0,3,5,70,0,16,0,75,0,philippine want help u china fight growing threat sea pirate
0,3,5,73,2,12,0,78,0,damian lillard blazers' elimination: trying defeat warrior became obsession
0,3,1,51,1,9,0,52,0,standing straight could help symptom depression study
0,3,1,41,2,7,0,42,0,"drunken man steal forklift, crash it, police say"
0,1,2,46,0,7,0,48,0,afghan policeman shoot kill five british soldier
0,2,1,60,0,11,0,61,0,activist using fax machine send clever protest art lawmaker
0,1,5,29,0,4,0,34,0,thailand cancel summit protest
0,1,7,24,2,6,0,31,0,concern keep u.s. talk racism
0,2,6,48,0,10,0,54,0,hedge fund spear point capital expected take salonmedia
0,3,2,61,1,11,0,63,0,future president blocking people twitter like there's tomorrow
0,2,9,44,1,9,0,53,0,erdogan's nazi comparison draw fire merkel chief staff
0,3,6,26,5,7,0,32,0,"im nobody? chance, emily dickinson"
0,1,1,38,2,6,0,39,0,morocco raise terror threat level 'maximum'
0,1,5,50,0,9,0,55,0,constitutionality dnc florida primary decided appeal
0,2,9,39,1,11,4,48,0,spring tv preview 2017: get scoop new returning show
0,3,10,46,4,11,0,56,0,former cia head 'mystified' white house claim gchq 'wiretapping'
0,1,6,33,0,6,0,39,0,china outline plan making electric car
0,2,6,31,4,10,2,37,0,ag session ms-13 gang: 'we coming you'
0,1,6,28,1,7,2,34,0,magazine ad page almost 26% quarter
0,1,2,24,0,4,0,26,0,snow cause german travel woe
0,3,6,41,3,8,0,47,0,former clinton adviser: bannon nsc show 'bad judgment'
0,1,5,17,3,6,8,22,0,critic honor 2004-2005 best u.s. tv
0,1,4,27,0,6,0,31,0,mdc may pull zimbabwe election
0,1,4,23,0,4,0,27,0,guard mutiny bangladesh end
0,3,4,64,0,11,0,68,0,oregon judge face scrutiny allegedly helping illegal immigrant escape ice
0,3,2,35,3,8,3,37,0,aging gracefully: story 103-year-old dad
0,2,4,55,3,10,0,59,0,race make money america fastest-growing sport marketwatch
0,2,11,53,1,12,4,64,0,"madonna kiss ariana grande, cover britney spear art basel miami beach 2016"
0,1,1,27,1,6,2,28,0,"greece fire, death toll exceeds 60"
0,2,3,45,4,9,0,48,0,'morale really high': lib dems scent revival south-west
0,3,5,54,3,8,0,59,0,#letlizspeak: senate's silencing warren prompt rallying support
0,3,3,44,0,7,0,47,0,senate republican take first step repeal obamacare
0,1,3,41,0,6,0,44,0,united nation pass declaration human cloning
0,2,4,62,1,10,0,66,0,"rachel dolezal identifying african american highly unusual, expert say"
0,2,10,51,1,9,0,61,0,"amber heard withdraws request spousal support, citing mediaattacks"
0,1,1,48,1,8,0,49,0,british pilot dy plane crash; nine passenger survive
0,2,1,35,1,4,0,36,0,trump destructive validation racist
0,2,1,60,1,8,0,61,0,saudi blogger's flogging reportedly delayed amid international outcry
0,2,5,49,0,11,0,54,0,internet debating peep pizza omg happening
0,2,6,34,0,7,0,40,0,child forced learn muslim prayer heart
0,3,6,45,2,12,0,51,0,eu face crisis imf warns greek debt explosive path
0,2,3,57,0,11,0,60,0,trump announces alexander acosta new pick secretary labor
0,1,5,38,0,7,0,43,0,ousted pm thaksin bemoans freezing swiss asset
0,1,6,33,0,7,0,39,0,parent unable halt cut conserve school
0,3,7,35,2,7,0,42,0,secret service: gun banned trump's nra speech
0,2,14,45,0,13,0,59,0,tom brady impersonated rock let know sent himpajamas
0,3,1,55,2,14,0,56,0,important get walk around long flight
0,3,4,71,5,15,0,75,0,"james corden host 'carpool karaoke' spin-off, ton celebrity"
0,1,6,54,4,10,0,60,0,u.s. marine accused assaulting australian freed u.s. military court
0,3,6,47,5,10,0,53,0,trump defends bill o'reilly: 'i think bill anything wrong'
0,3,7,38,0,6,0,45,0,obama celebrates world series champion chicago cub
0,2,11,54,4,12,4,65,0,"rasmussen poll show two-point race: clinton 41 percent, trump 39 percent breitbart"
0,3,12,47,2,11,0,59,0,"bindi irwin post heartfelt tribute dad, steve irwin, birthday"
0,3,1,46,3,7,0,47,0,"council tax exemption 'pooper snoopers', offer mayor"
0,2,6,63,4,14,0,69,0,"james dolan fire msg security chief, say oakley never shouldve made seat"
0,3,10,58,1,12,0,68,0,watch president trump's address joint session congress live stream
0,1,1,37,0,6,0,38,0,toronto transit worker ordered back work
0,3,4,63,2,10,0,67,0,news eight million briton opt staycation amid sterling's post-brexit slump
0,1,3,49,0,6,0,52,0,naomi campbell testifies former liberian president
0,3,9,41,1,9,0,50,0,"african giant may hold rate weak growth, high inflation"
0,2,12,65,2,14,0,77,0,prince william prince harry honor mother statue kensington palace [video]
0,2,12,46,6,11,0,58,0,novelist chris cleave brexit: weve shot foot
0,3,5,46,1,8,0,51,0,"bergdahl request pardon president obama, u official"
0,1,1,47,0,7,0,48,0,scottish judge criticises medical care murdered baby
0,3,11,48,1,10,0,59,0,treasury nominee mnuchin's defunct hedge fund trump boast
0,2,2,79,2,16,2,81,0,runaway elephant escape circus kill 65-year-old man morning stroll germany
0,3,9,47,2,12,1,56,0,"jusuf nurkic's leg injury diagnosed fracture, least 2 week"
0,2,6,85,3,15,0,91,0,berlin attack: brexit figurehead arron bank suggests angela merkel 'might well have' driven lorry
0,1,6,32,1,6,3,38,0,british airway report $595 million annual loss
0,3,5,70,0,15,0,75,0,new york time hire conservative scribe bret stephen seen move widen readership
0,1,1,45,0,7,0,46,0,israel release activist arrested flotilla raid
0,3,11,51,1,11,0,62,0,lily allen twitter asks follower dox woman criticized pop singer
0,2,11,48,3,11,0,59,0,"reversal, boston st. patrick day parade welcome gay veteran group"
0,1,2,39,1,6,0,41,0,spain's ibiza airport evacuated bomb alert
0,1,3,37,1,6,4,40,0,football: ronaldinho sign barcelona 2010
0,2,4,59,1,17,3,63,0,"1 10 pregnant woman zika fetus infant birth defects, cdc say"
0,2,3,63,3,11,0,66,0,schumer: virtually impossible avoid filibuster fight gorsuch next week
0,3,11,45,2,9,0,56,0,"scalp cooling cap help prevent chemo-related hair loss, say study"
0,3,3,17,0,2,0,20,0,weather united kingdom
0,3,7,34,3,8,0,41,0,warner bros. getting ready remake 'the matrix'
0,2,3,49,1,14,0,52,0,glenn beck want heal america divided one hug time
0,2,9,73,3,15,0,82,0,heritage foundation plan gutting epa energy department. eerily plausible.
0,2,8,33,0,7,0,41,0,great entrepreneur older think
0,3,4,63,2,12,0,67,0,u.s. defense chief arrives kabul afghan counterpart resigns disgrace
0,2,11,37,0,9,0,48,0,brave owl stop nascar cup practice auto clubspeedway
0,3,11,39,0,8,0,50,0,asahi thirsty overseas deal sabmiller buy
0,1,3,59,0,9,0,62,0,romanian foreign minister break ice bucharest chisinau
0,2,5,29,1,4,0,34,0,anthony weiners latest sexting scandal
0,2,5,60,0,13,0,65,0,florida man accused fighting isi syria could face prosecution u
0,3,1,56,1,10,0,57,0,trump rally sucker-punch case come happy ending forgiveness
0,1,1,56,1,8,0,57,0,australian man threatens shoot chopper tomato-bazooka
0,3,4,59,3,12,0,63,0,demarcus cousin totally kicked chair's ass. hope worth price.
0,1,4,62,0,10,0,66,0,tax break promised australian prime minister election fast approach
0,2,3,50,2,7,0,53,0,'fake doctor' also worked pharmaceutical giant astrazeneca
0,3,13,50,5,14,0,63,0,kevin durant's mom oklahoma city thunder fans: 'it like this'
0,2,9,46,3,10,0,55,0,'madam president' newsweek copy sale online buyer beware
0,1,7,26,3,5,4,33,0,"iran test-fires missile 1,200-mile range"
0,3,1,42,3,9,0,43,0,pictures: share photo theme 'cold'
0,3,6,56,5,12,0,62,0,"pauline hanson's one nation 'wouldn't last week without her', david marr say"
0,3,4,45,1,9,0,49,0,"eyeing trump, obama take new action ban arctic drilling"
0,2,2,55,0,10,0,57,0,higher achiever smoked weed teenager list
0,3,6,49,3,9,0,55,0,"asian american group slam ghost shell, scarlett johansson"
0,1,1,52,1,6,0,53,0,new insulin-resistance discovery may help diabetes sufferer
0,3,4,43,1,8,0,47,0,mike flynn could finally end donald trump's lucky streak
0,2,7,35,2,8,0,42,0,saturday night live air live across country
0,2,6,35,1,8,0,41,0,two thought donald trump chance fall
0,2,3,47,4,8,0,50,0,film buff cant wait tribecas godfather doublefeature
0,3,7,46,1,8,0,53,0,smoldering mound trash obstruct ukraine road recovery
0,2,7,62,2,16,3,69,0,europe's first brothel customer pay 100 hour sex doll open spain
0,1,4,33,0,4,0,37,0,commodity still attract adventurous
0,2,8,29,0,8,0,37,0,flying taxi like taking bus
0,1,6,34,1,6,0,40,0,"maliki push election gains, despite fear"
0,2,9,38,1,7,0,47,0,resurgent macbook pro hobbled intel's new technology
0,2,2,23,0,3,0,25,0,amtrak expands acela service
0,3,14,57,0,13,0,71,0,fittest couple world prof couple sweat together stay together
0,2,11,50,3,11,0,61,0,sabrina carpenter host one-take subway dance party new 'thumbs' video
0,1,2,72,0,10,0,74,0,new zealand study find correlation church attendance adolescent obesity
0,1,5,23,0,4,0,28,0,nato intensifies attack libya
0,1,3,26,2,8,5,29,0,u.s. team unveils plan f1 entry 2010
0,3,5,43,1,10,3,48,0,turkish police detain 440 people anti-isis operation
0,1,9,52,0,11,0,61,0,russian strengthen faith tradition icy water plunge
0,3,13,54,3,13,0,67,0,"two die indian bull-taming event, protester clash police india real time"
0,1,2,27,0,5,0,29,0,riot greece enter fourth night
0,2,7,39,1,6,0,46,0,north korea detains third american citizen: official
0,2,3,73,1,12,0,76,0,indonesian court sentence journalist david fox seven months' jail drug possession
0,2,5,58,1,11,1,63,0,u army responds theory claiming military owes captain america $3 million
0,3,5,57,3,12,0,62,0,words: 'invasion day' mean rural indigenous community
0,1,3,52,0,12,2,55,0,gun battle gang member police kill 12 rio de janeiro
0,1,8,46,0,7,0,54,0,european aircraft industry seek backing government
0,1,3,51,0,8,0,54,0,ontario investigator search body victoria stafford
0,2,7,38,2,9,0,45,0,billy bush leaf nbc today show trump lewd tape
0,2,10,42,1,11,0,52,0,edge: trump clinton work whole party unity thing
0,1,4,37,0,10,2,41,0,u pool player wade crane dy car accident age 66
0,1,3,38,2,7,2,41,0,16 dead u.s. helicopter crash afghanistan
0,3,8,41,0,9,0,49,0,charity turn old blanket winter coat refugee
0,3,10,43,1,10,4,53,0,mark cuban rule 2020 presedential run donald trump
0,1,2,37,0,6,0,39,0,china russia continue joint army exercise
0,3,5,70,1,12,0,75,0,casey affleck's best actor oscar spark outrage due sexual harassment allegation
0,1,7,32,1,7,0,39,0,joy cricketville; mighty texan struck
0,1,4,22,0,3,0,26,0,worker protest across france
0,3,9,47,1,10,1,56,0,activist investor jana partner take nearly 9% stake whole food
0,2,8,44,1,9,0,52,0,donald trump tap mick mulvaney budget director breitbart
0,1,3,26,0,3,0,29,0,boorishness work berlusconi
0,3,4,68,1,15,0,72,0,woman survived five day alone lost grand canyon describes ordeal yahoo
0,3,1,70,1,13,0,71,0,"fitness tracker may fall short measuring heart rate accurately, study find"
0,1,5,36,0,6,0,41,0,british pm tony blair pressured resignation
0,3,1,53,0,7,0,54,0,stellar pregnancy announcement feature dog wearing glass
0,2,6,46,2,10,0,52,0,"ted cruz spank daughter, republican a-ok"
0,3,10,47,3,9,0,57,0,ben affleck say he's finished treatment 'alcohol addiction'
0,1,10,38,0,9,1,48,0,steelers shared resource 2 team world war ii
0,3,7,72,3,16,0,79,0,"adam driver michael shannon talk blockbuster vs. indie, stage vs. screen kylo ren girl"
0,2,11,54,3,11,0,65,0,chinese investor deal chicago stock exchange clear u.s. security hurdle
0,1,5,36,0,6,0,41,0,wholesale inventory decline fifth month
0,2,7,31,2,7,0,38,0,u.s. considers opening network base iraq
0,3,4,57,1,12,0,61,0,worst-case scenario apparent nerve toxin murder kim jong nam
0,1,8,17,1,8,0,25,0,"get web, turn tv"
0,1,4,25,1,6,2,29,0,jaipur's queen gayatri devi dy 90
0,2,14,36,1,7,0,50,0,#thankyouobama flood twitter love outgoing potus
0,2,2,47,2,9,0,49,0,"cops: dad confesses killing infant, leaving body wood"
0,3,2,64,2,12,1,66,0,iphone 8 recognize owner's face: handset special laser sensor
0,2,1,54,0,10,0,55,0,married man sends hijack hoax email avoid trip girlfriend
0,1,5,24,0,5,0,29,0,derivative tug war take shape
0,2,1,18,0,3,0,19,0,coming train wreck
0,3,17,61,3,16,0,78,0,former dnc pollster: white voter saw trump great white hope get country back
0,3,11,32,3,8,0,43,0,'powerless' prof dc's tv better movie
0,2,6,47,2,8,0,53,0,ufo hunter spot flying disc near international spacestation
0,3,4,49,2,8,0,53,0,north korea's leader kim jong-un mark birthday without fanfare
0,2,5,80,3,19,0,85,0,commander u naval force implies chinese navy ship can't 'fight way wet paper bag'
0,3,3,58,1,12,1,61,0,raging blaze burn dozen storefront new york; 3 firefighter injured
0,1,4,38,1,8,1,42,0,"crane level new york city townhouse, leaving 4 dead"
0,2,8,52,1,9,0,60,0,nightclub massacre istanbul expose turkey deepening fault line
0,1,4,43,0,7,0,47,0,finnish olympic champion skier mika myllyl found dead
0,2,4,44,2,8,0,48,0,pharma bro release wu-tang song celebrate trumpswin
0,3,9,47,2,9,0,56,0,lupe fiasco skipping retirement release 'drogas light' next year
0,3,7,42,3,7,0,49,0,"howard bingham, muhammad ali's personal photographer, dy"
0,2,11,43,3,10,0,54,0,keystone pipeline wont use u.s. steel despite trump pledge
0,2,5,69,1,13,1,74,0,upscale restaurant owner pledge $1 million worth steak dinner nku upset kentucky
0,2,9,46,0,8,0,55,0,french socialist parliament leader may back party candidate
0,3,9,47,3,10,3,56,0,"yasiel puig's home reportedly burglarized la, $500k jewelry stolen"
0,1,18,59,4,9,0,77,0,canadavotes: animal alliance (aaevpc) candidate marie crawford running torontodanforth
0,1,5,36,0,5,0,41,0,clean slate youth sentenced fraudulently
0,1,1,48,4,6,0,49,0,"american getting fatter, not-for-profit's report find"
0,1,7,58,1,11,3,65,0,"us, uk investigator collaborating u 777 incident similar london crash"
0,1,7,24,1,7,0,31,0,new here? let phone show around
0,1,3,47,0,11,2,50,0,australian state queensland go poll march 21
0,2,1,50,1,9,3,51,0,pentagon reportedly buried study exposing $125 billion waste
0,2,13,48,0,13,4,61,0,utah judge rule michael jordan pushed bryon russell 1998 nba final
0,2,7,35,0,9,0,42,0,samantha bee jane pauley breaking news
0,2,5,53,1,10,0,58,0,theresa may make surprise downing street statement politics live
0,2,7,32,1,7,2,39,0,eu leader display unity bloc 60th birthday
0,1,7,46,2,7,0,53,0,interview: danny o'brien electronic frontier foundation
0,3,8,41,1,8,0,49,0,federal judge block trump latest travel ban nationwide
0,1,3,27,0,4,0,30,0,hurricane fred churn atlantic
0,1,3,41,1,7,0,44,0,u unemployment fell four-year low katrina
0,1,7,35,1,6,0,42,0,"masters, first group provide early contender"
0,1,4,35,0,6,0,39,0,imprisoned haitian priest may need u doctor
0,1,8,52,0,12,4,60,0,uefa president platini confirms euro 2012 hosted poland ukraine
0,3,10,55,1,11,0,65,0,matt bonner one strangest retirement announcement ever see
0,2,10,45,3,7,0,55,0,charles oakley versus knicks security: frame-by-frame breakdown
0,2,9,21,2,5,0,30,0,d-wade interview lebron espn video
0,3,14,35,7,12,0,49,0,louis c.k.: trump 'gross crook dirty rotten lying sack s**t'
0,2,15,45,1,11,0,60,0,ex-gop official accused dems voter fraud charged voter fraud
0,1,13,56,4,11,0,69,0,"killing linked i.r.a. factions, northern ireland defends fragile peace"
0,3,14,58,3,11,0,72,0,kolkata mcdonald's outlet serf pregnant woman french fry deep-fried lizard!
0,2,1,51,0,8,0,52,0,longtime editor diagnosed cancer land health bookdeal
0,2,21,50,0,16,0,71,0,crpf jawan lost brother sukma attack slam government viral fb live video
0,2,12,49,2,11,0,61,0,trump's plan sell insurance across state line mean lower cost
0,1,1,37,0,5,0,38,0,cuba release leading dissident prison
0,3,8,54,1,11,0,62,0,lgbtq+ video filtered youtube vloggers want answer
0,3,5,50,0,11,0,55,0,bill nye advice president trump getting mar
0,2,5,41,3,9,0,46,0,tina fey: live president trump 'with dignity'
0,3,8,30,3,9,7,38,0,un humanitarian aid agency: record $22.2b needed 2017
0,2,4,56,1,9,0,60,0,corey lewandowski say trump wont hold inaugural boycott dems
0,1,3,33,1,5,0,36,0,"four found dead leicestershire, england"
0,2,2,49,0,8,1,51,0,abundant fish draw 1 million penguin argentine peninsula
0,3,3,55,0,8,0,58,0,congressman remove capitol hill painting depicting police pig
0,3,2,63,1,9,0,65,0,south korea parliament vote impeach president corruption scandal
0,2,9,35,3,8,3,44,0,neurological disease cost u.s. $800 billion year
0,3,4,50,0,14,0,54,0,beauty beast waltz way top uk box office
0,2,3,46,0,10,0,49,0,white house colored blue sunday autism awareness
0,1,6,26,2,7,2,32,0,"siemens profit drop 81%, revenue"
0,2,9,30,1,8,0,39,0,"cancer partly caused bad luck, study find"
0,1,1,33,0,5,0,34,0,irish woman win record lottery jackpot
0,1,8,45,3,9,0,53,0,"san jose, ca, usa, city manager resigns amid norcal investigation"
0,3,12,57,2,13,0,69,0,carlos slim: clear government mexico strong negotiating position
0,2,9,48,2,9,3,57,0,business disaster: insurance firm profited $400 million sandy
0,1,4,32,0,6,0,36,0,drug website survey lsd user culture
0,2,1,53,0,10,0,54,0,microwaving tea best way brew extract health benefit
0,2,4,40,0,7,0,44,0,facebook looking scripted hollywood tvshows
0,2,3,50,3,9,0,53,0,qatar comply new u.s. airline security measures: minister
0,1,8,42,0,8,0,50,0,internet company ad agency find common ground
0,3,14,57,3,11,0,71,0,national security guard site hacked. agency suspect role pakistan's isi hackers.
0,3,9,40,0,12,2,49,0,trump said seek cutting corporate tax rate 15 percent
0,2,2,51,1,9,2,53,0,"dulles airport soar 77 degrees, crushing previous record high"
0,3,14,43,0,11,0,57,0,north carolina may lose ncaa game amid bathroom bill deadlock
0,2,3,61,1,12,0,64,0,"u abstains key israel vote, clearing way condemnation settlement"
0,2,12,52,0,11,1,64,0,lebron james reminds heckling warrior fan 3 championship ring
0,3,14,58,0,13,0,72,0,indian filmmaker running community centre istanbul help syrian refugee
0,1,4,38,0,7,0,42,0,mayor declares weather emergency new york city
0,3,16,46,2,13,0,62,0,nba commissioner say woman head coach 'sooner rather later'
0,3,9,44,3,9,0,53,0,somalia new president farmajo cheered buffalo
0,2,3,42,2,11,0,45,0,preet bharara say he done cuomo might benext
0,2,10,39,4,9,0,49,0,trump jr.: cruz win nomination bribing delegate
0,1,3,43,1,12,5,46,0,"new year fire kill least 59, injures 212 bangkok pub"
0,3,4,48,1,10,0,52,0,jay z produce trayvon martin docu-series narrative film
0,3,7,34,2,7,0,41,0,see beyonce's fierce flashy video christmas card
0,1,3,35,0,6,0,38,0,al jazeera cameraman killed eastern libya
0,1,11,51,1,9,0,62,0,"government canada okay wind mobile launch, overturning crtc decision"
0,3,1,47,2,10,1,48,0,double amputee sue access grave 2-legged cat
0,2,6,33,0,6,2,39,0,10 athlete signature sneaker
0,1,9,32,1,11,0,41,0,shot out? clue challenge call
0,3,2,47,1,9,0,49,0,attack westminster: paper reported deadly day
0,1,5,36,0,4,0,41,0,clothing maker exceed quarterly expectation
0,3,10,43,0,12,2,53,0,drake return special guest episode 39 ovo sound radio
0,3,2,48,3,8,0,50,0,harrison ford keep pilot's licence despite 'schmuck' error
0,3,9,48,5,14,0,57,0,"toe fall off, tape it: joel berry ii path ncaa legend status"
0,1,7,26,2,5,0,33,0,mountaineer 'climb up' aid funding
0,3,5,54,1,11,0,59,0,expect carrie fisher debbie reynolds' public memorial
0,3,5,50,1,8,0,55,0,sunderland jermain defoe heap misery broken crystal palace
0,1,3,30,0,8,0,33,0,karl rove named source plame leak
0,3,2,54,1,8,0,56,0,france election: fillon lawyer demand dropping payment probe
0,1,2,51,0,8,4,53,0,american samoa received eight minute warning 2009 tsunami
0,3,10,45,1,9,0,55,0,"making financial goal reality, help trusted partner"
0,1,8,45,1,9,1,53,0,spanish court weighs inquiry torture 6 bush-era official
0,3,3,49,1,10,2,52,0,"70 year dead sea scroll found, new discovery await"
0,3,17,54,4,14,0,71,0,many 'signature moments' russell westbrook need convince u he's nba mvp?
0,1,4,56,0,10,0,60,0,analysis reveals new york city tunnel susceptible attack
0,1,2,31,0,5,0,33,0,bomb blast damage building athens
0,3,13,62,1,12,0,75,0,people happy chrisette michele performing donald trump inauguration
0,2,4,49,1,8,0,53,0,u election recount: green change tactic pennsylvania bid
0,3,3,82,3,18,0,85,0,british police used taser black man thought robber. race-relations adviser.
0,3,4,86,7,17,2,90,0,"chain-smoking two-year-old, aged nine, kick 40-a-day habit becomes star pupil primary school"
0,3,4,42,3,6,0,46,0,barrie chase recall 'fred astaire's indefinable magic'
0,1,8,30,3,6,0,38,0,insider trading inquiry cite lawyer s.e.c.
0,3,8,36,1,10,1,44,0,bethel music bow no. 1 top christian album chart
0,2,4,46,3,7,0,50,0,"scott pruitt, trump's environment pick, get senate approval"
0,2,3,13,2,2,0,16,0,peoplesburger?
0,2,6,47,0,11,6,53,0,speaker ryan defends cbo estimate 24m would lose insurance 2026
0,2,2,30,1,4,2,32,0,interpol suspends 20m fifa partnership
0,3,3,57,0,11,0,60,0,matthew mcconaughey great story dad winning motorbike
0,2,8,57,1,7,0,65,0,"anthony scaramucci joining trump administration, transition team confirms"
0,2,6,55,4,11,0,61,0,"artist creates awesome lebron james, stephen curry portrait ... salt"
0,3,9,51,1,11,0,60,0,samsung heir face arrest charge bribing south korea president
0,2,10,36,0,9,0,46,0,people totally trolling new spin bike forkids
0,1,11,24,0,8,0,35,0,insurer ask whether tarp aid way
0,2,10,47,4,11,0,57,0,"toddler dress celeb golden globe looks, adorable [video]"
0,1,3,85,0,19,0,88,0,uk opposition leader call burma aid dispatched air access aid worker improve
0,2,6,45,1,11,0,51,0,donald trump ted cruzs battle iowa important
0,2,12,45,4,10,1,57,0,"5-year-old geography whiz expertly burned trump ""the ellen show"""
0,2,3,45,0,10,0,48,0,world book day give many child first chance buy one
0,3,16,51,4,14,1,67,0,3-year-old stealing pope's hat pretty much best thing see today
0,1,9,40,1,10,0,49,0,"cost college sport rise, student balk paying tab"
0,2,9,38,2,7,0,47,0,frank ocean co-signs meryl streep's golden globe speech
0,2,7,41,4,7,0,48,0,"quadruple murder-suicide wilderness, police say"
0,2,1,37,1,11,0,38,0,ask promotion pay rise live chat
0,1,8,31,0,7,0,39,0,red bull stop slide tie sounder
0,2,6,30,0,6,0,36,0,jeb bush stress military might europe
0,2,1,50,0,10,0,51,0,family edge water contamination former air base
0,1,2,59,0,9,0,61,0,black box retrieved lost indonesian airliner eight month
0,2,3,69,1,14,1,72,0,national guardsman meet baby daughter 1st time deployment yahoo
0,2,16,42,3,15,0,58,0,eric holder black life matter: see lot youngereric
0,3,9,33,2,9,2,42,0,"cast ""superbad"" look super badass 10 yearslater"
0,3,5,84,1,13,0,89,0,"israel end aid programs, order ambassador home un security council condemnation settlement"
0,2,5,33,2,6,0,38,0,john mccains cold-blooded revenge ted cruz
0,2,5,64,2,12,0,69,0,donald trump hold talk vladimir putin 'within weeks' becoming president
0,2,5,79,2,15,0,84,0,"lesbian bisexual woman incorrectly told need smear tests, lgbt charity say"
0,3,3,60,1,10,0,63,0,snowboarding santa claus go viral shred behind human-flying drone
0,1,8,22,2,7,0,30,0,red ink? wall st. paid fat bonus
0,2,10,61,8,11,0,71,0,"krauthammer: childish, pathetic hillary wont take blame election loss breitbart"
0,1,4,23,1,5,3,27,0,4 state unemployment 10%
0,3,2,49,1,8,0,51,0,north korea test newly developed high-thrust rocket engine
0,2,10,37,5,8,0,47,0,here's first look female-fronted 'ocean's eight'
0,3,8,50,0,10,0,58,0,trump nominate top maryland attorney justice department post
0,3,11,70,7,10,0,81,0,"whosay #celebsunfiltered, social celebrities, entertainment news, photos, videos, exclusive"
0,1,3,35,3,4,0,38,0,u.s. force-feeding guantanamo hunger striker
0,3,7,41,1,6,0,48,0,france national front find support among millennials
0,3,2,32,0,7,0,34,0,joy sadness returning mosul
0,3,6,52,0,11,0,58,0,ivanka trump becomes thirsty af meme faced justin trudeau
0,3,1,33,1,6,2,34,0,american facing $50 billion headwind
0,1,1,35,0,5,0,36,0,ukraine election result delayed court
0,1,6,42,0,7,0,48,0,contraceptive sponge make return pharmacy shelf
0,1,7,31,1,7,0,38,0,brave sign glavine one-year contract
0,3,11,52,1,11,0,63,0,morgan stanley ubs increase stake mainland-china joint venture
0,2,3,49,4,8,0,52,0,ten-year-olds tackle lie demeaning stereotype video
0,3,2,42,1,9,1,44,0,2 hurt gun go french president's speech
0,2,11,48,4,11,0,59,0,john oliver welcome 'original woke bae' dalai lama 'last week tonight'
0,2,6,40,0,7,0,46,0,protester endure blizzard remain standing rock
0,3,20,55,8,20,1,75,0,"myles garrett say go no. 1 nfl draft, he'll 'punish team' 'knock qb'"
0,3,4,17,2,4,0,21,0,"go inside ""a monster calls"""
0,2,3,44,1,10,0,47,0,police: death muslim girl believed hate crime
0,3,3,49,2,9,5,52,0,"thai police charge 60,000 drink-drivers horror new year period"
0,1,8,35,1,6,0,43,0,auto crisis adviser called pro-labor pragmatist
0,2,8,43,3,10,0,51,0,trump pick iowa gov. terry branstad u.s. ambassador china
0,2,7,38,1,6,0,45,0,mexican authority arrest sinaloa cartel new bos
0,3,1,54,1,10,0,55,0,"trump tap money business, raising ethic concern"
0,3,14,56,0,13,0,70,0,actual answer donald trump gave televised interview
0,3,17,50,4,18,0,67,0,"u.s. mint finally put black woman coin, probably ever see"
0,2,10,49,2,10,2,59,0,"john lynch named 49ers gm: latest contract details, comment reaction"
0,1,1,49,0,7,0,50,0,indonesian blackout caused lack generation capacity
0,1,7,32,1,10,0,39,0,"worker die work italy, call change"
0,3,3,30,0,7,0,33,0,russian spy seek white house source
0,1,3,37,0,6,0,40,0,european union train somali security force
0,3,10,46,1,9,0,56,0,"woman founder raising funds, new york prof friendliest city"
0,3,4,68,0,11,0,72,0,penalty rate senate inquiry backed former small business minister bruce billson
0,3,8,58,3,11,2,66,0,"leading dna scientist sacked, 27 criminal case doubt, wa attorney-general say"
0,2,9,28,3,7,0,37,0,j.k. rowling reveals working new book
0,1,5,33,0,7,3,38,0,cyclone kill nearly 200 bangladesh india
0,3,16,48,7,15,0,64,0,promo: check video new song man last night episode 'star'!
0,2,14,42,0,13,0,56,0,dev patel third indian actor ever receive oscar nod
0,3,4,42,1,9,0,46,0,much credit donald trump deserve dow rally?
0,2,7,44,2,8,0,51,0,zika: aerial spraying releasing bat approved breitbart
0,3,12,68,1,13,0,80,0,baylor graduate claim school paid another student's tuition discus sexual assault
0,2,1,46,0,8,1,47,0,3 arrested atlanta fire underneath interstate bridge
0,1,5,23,0,4,0,28,0,ireland reject eu lisbon treaty
0,1,5,30,1,5,0,35,0,"venting, computer visionary educates"
0,3,4,66,0,12,0,70,0,chinese professor fired making critical comment mao zedong
0,2,1,51,3,6,0,52,0,olympian officially terrified green fart-smelling water
0,1,2,39,0,6,0,41,0,north korea warns airline satellite fear
0,2,16,44,5,11,0,60,0,sarah palin: corporate culture fox news obviously change (video)
0,2,2,43,1,7,0,45,0,liberal group get together anti-trump strategy
0,1,6,29,1,6,0,35,0,"switched birth, woman find new identity"
0,3,15,61,0,17,0,76,0,myles garrett showed everyone nfl combine first pick draft
0,2,18,51,4,15,0,69,0,"meet rbi's new deputy governor, viral acharya, also music album credit!"
0,2,16,54,1,11,0,70,0,"real eu immigration figure twice high previously thought, government admits"
0,3,1,47,1,9,1,48,0,thief steal 2m rare book abseiling warehouse
0,2,9,37,2,11,4,46,0,"chinese stock soared 4,500% nasdaq one know"
0,3,8,41,2,7,4,49,0,15-year-old boston sport fan attends 10th championship parade
0,3,4,37,1,8,0,41,0,paul dacre: mail man leading brexit charge
0,2,8,36,2,8,0,44,0,"charlie rose returning ""cbs morning"" monday"
0,1,2,61,1,9,0,63,0,egyptian archaeologist find artifact may lead cleopatra's tomb
0,3,3,33,1,5,0,36,0,effectively fact-check donald trump
0,1,4,24,2,4,2,28,0,football: wigan 1-3 bolton wanderer
0,2,8,36,2,8,3,44,0,$400 billion fund manager bullish trump-proof india
0,3,3,58,3,10,0,61,0,"president obama edge president-elect trump ""most admired man"" poll"
0,1,10,49,0,10,0,59,0,world baseball classic ticket sale show rooting interest lie
0,2,4,51,2,9,0,55,0,"nike re-release original lebron james sneaker, start retro line"
0,1,2,57,0,7,0,59,0,pakistan security force airstrikes kill several taliban militant
0,3,6,36,1,7,0,42,0,trump officially taken @potus account
0,1,4,54,1,10,0,58,0,"police officer killed car bomb explodes omagh, northern ireland"
0,2,2,58,0,13,0,60,0,iraqi civilian west mosul eating day bracing worse
0,2,3,36,2,8,0,39,0,downfall michael flynn: timeline video
0,1,5,35,2,7,0,40,0,bomb threat ukegypt plane; diverted greece
0,2,3,51,2,7,0,54,0,sean spicers completely avoidable mistake friday briefing
0,1,3,49,0,10,0,52,0,search harmful asian carp chicago area turn nothing
0,2,1,61,2,12,2,62,0,"video show armless basketball player, 13, winning game last second shot"
0,1,3,39,1,8,0,42,0,al-qaeda say another bin laden tape released
0,1,2,27,0,4,0,29,0,two spanish train station bombed
0,2,7,40,2,9,0,47,0,ex-dnc chair warren sanders: mind business
0,1,2,32,0,6,0,34,0,bp report progress oil spill cleanup
0,3,11,38,4,10,0,49,0,here's happened sam's daughter 'lord rings'
0,2,6,54,2,12,0,60,0,publisher one's own: virginia leonard woolf hogarth press
0,1,5,30,0,6,4,35,0,fernando alonso win 2007 european grand prix
0,2,2,44,3,9,5,46,0,"28 pages: controversy saudi arabia 9/11, explained"
0,3,4,33,1,10,0,37,0,dirty: month life rio tinto
0,1,5,47,0,11,2,52,0,state emergency declared new york h1n1 swine flu virus
0,2,10,55,1,9,0,65,0,fallout supreme court ruling texas law abortion restriction
0,1,5,45,2,10,1,50,0,'bad language' live 8 concert trigger complaint bbc
0,3,6,40,2,8,0,46,0,sir mick jagger 'names babyson deveraux octavian basil'
0,3,8,50,0,10,2,58,0,manhunt underway shooting attack istanbul nightclub kill 39
0,1,4,33,1,6,0,37,0,"flooding close highway eastern iowa, u"
0,3,6,49,2,9,0,55,0,"uk's richest people getting special deal hmrc, warns watchdog"
0,2,14,51,1,13,0,65,0,mom secretly filmed daughter viral dance video hilarious
0,1,2,38,0,6,0,40,0,chevron pipeline nigeria attacked gunman
0,3,2,70,4,10,0,72,0,"trump's campaign tactics, troll strengthened russia's election meddling, expert say"
0,1,4,37,0,7,0,41,0,striking nyc transit worker return job
0,1,5,34,0,4,0,39,0,pope reinstates four excommunicated bishop
0,1,9,29,3,8,0,38,0,s.e.c. seek limit stock trade worker
0,2,2,49,1,10,2,51,0,le man 24-hour race technology spectacle balance
0,2,4,74,2,16,0,78,0,special warfare unit spotted flying trump flag public. navy investigating.
0,3,7,33,1,10,4,40,0,golden globe 2017: see star red carpet
0,1,3,35,2,6,0,38,0,u.s. accuses china developing space warfare
0,2,12,27,1,5,0,39,0,korea mers outbreak highlight sars lesson
0,3,5,68,2,16,0,73,0,donald trump spent almost third time office mar-a-lago resort florida
0,1,2,27,0,7,2,29,0,plane crash congo kill least 70
0,3,6,33,1,10,7,39,0,nfl draft 2017: 20 best remaining player round 2
0,1,4,22,0,4,0,26,0,nazi guard deported austria
0,3,11,47,2,12,4,58,0,"jingle ball 2016, user coded emoji thanks google: exclusive"
0,3,1,72,1,14,2,73,0,hhgregg closing 88 store profitable due collapse physical retail
0,1,11,43,3,13,0,54,0,"acquired j. j. putz trade, sean green also seen valuable mets"
0,2,12,56,4,18,3,68,0,"seeking final face 9/11 tapestry grief, loss, life joy new york time"
0,3,2,20,2,5,8,22,0,week pictures: 10-16 december 2016
0,1,8,42,2,12,0,50,0,bob barker retire host u.s. gameshow price right
0,2,9,32,0,8,2,41,0,20 likeliest nba player dealt offseason
0,3,8,47,2,9,0,55,0,"ryan grigson fired colts: latest details, comment reaction"
0,1,6,31,0,6,0,37,0,naval show feature submarine china
0,2,2,50,0,10,0,52,0,u researcher discover new way procure water thin air
0,3,12,47,4,13,0,59,0,"dean cain: celebrity need 'get it,' accept trump insider"
0,3,9,48,0,12,0,57,0,apple talk hollywood early access movie itunes
0,3,12,59,0,13,0,71,0,man shot killed former saint player smith found guilty manslaughter
0,1,6,31,0,5,0,37,0,u chief justice john robert hospitalized
0,2,5,59,4,14,0,64,0,german sexual assault lead told claim muslim immigrant u.s.
0,3,2,38,1,10,4,40,0,la man walk free he's exonerated 1984 murder
0,3,16,55,2,16,1,71,0,"wolverine's legacy come end, 8 best rated moment series"
0,2,2,54,2,8,0,56,0,twitter ripping topshop apart 'cultural appropriation'
0,2,3,52,1,7,0,55,0,suspicion soured relationship sank bouygues telecom deal
0,1,2,52,0,8,0,54,0,taliban militant kill least thirteen northwest pakistan
0,1,5,25,1,8,0,30,0,mugabe: vote mdc wasted vote
0,2,6,36,2,7,0,42,0,tippi hedren doris day sentimental journey
0,1,10,46,3,10,0,56,0,procedure bypass g.o.p. health care carry risk democrat
0,3,5,50,5,11,0,55,0,"donald trump destroyed life, say barred iraqi worked u.s."
0,3,11,46,0,12,0,57,0,conor mcgregor end tree house wild party liverpool
0,2,3,51,3,7,0,54,0,man give jail pleasantly surprised tripadvisor-style review
0,2,8,31,1,9,6,39,0,overhyped nba player end 2016-17 season
0,3,3,49,0,12,4,52,0,fleet driverless car travel london oxford 2019
0,3,12,38,1,11,0,50,0,"young thug act like jerk airport, twitter clap back"
0,1,8,31,0,10,0,39,0,big wall fall china make room mickey
0,2,7,42,0,6,0,49,0,industrious formula productive coworking space
0,3,8,80,2,19,0,88,0,islamic tv channel air hardcore porn middle day falling 'satanic trick'in senegal
0,1,2,30,0,5,0,32,0,bomb explosion kashmir kill three
0,2,13,28,2,8,0,41,0,"limited edt x sbtg x reebok instapump fury ""feline"""
0,1,7,33,2,4,0,40,0,visa post better-than-expected profit result
0,2,5,75,0,17,0,80,0,la vega airport appears using picture nick clegg maintenance poster list
0,2,4,40,1,7,0,44,0,sumner redstone: taking risk banning tom cruise
0,1,5,24,0,6,0,29,0,russia ban hunting baby seal
0,3,11,40,3,12,0,51,0,sam hunt's country hit 'body like back road' speed pop radio
0,3,9,56,3,16,0,65,0,"priebus: trump ready accept russia hacking report, cia, fbi get page"
0,2,2,55,1,10,0,57,0,salvador: city child fend street
0,2,10,46,0,11,0,56,0,net neutrality rule go effect appeal court denies stay
0,3,4,50,0,9,0,54,0,parole board recommend oscar pistorius released august
0,1,3,44,0,8,0,47,0,hp france trouble due alleged monopolist behavior
0,1,3,34,0,8,2,37,0,british voice artist roy skelton dy age 79
0,1,5,25,0,5,0,30,0,running business time
0,2,2,42,1,7,0,44,0,"athletes, fan honor stockholm truck attack victim"
0,1,9,18,3,7,6,27,0,2007 fifa u-17 world cup: ghana vs. germany
0,2,10,41,1,16,0,51,0,"man shot back, police kept dark"
0,1,8,65,1,10,0,73,0,"interview anna mikkola, finnish left alliance candidate european parliament"
0,3,1,69,2,11,0,70,0,german police arrested two people suspected 'impending' terrorist attack
0,2,13,66,1,14,0,79,0,really wish could watch expletive-filled video kevin garnett created celtic
0,1,3,56,0,8,0,59,0,putin order russian government normalize relation georgia
0,1,4,39,0,6,0,43,0,orrin hatch accidentally compare iraq vietnam
0,1,4,20,0,4,0,24,0,fema head relieved duty
0,1,1,39,0,5,0,40,0,idaho senator arrested disorderly conduct
0,1,6,25,0,6,0,31,0,ukraine russia sign deal gas
0,2,4,33,4,6,0,37,0,oprah winfrey president? 'now i'm thinking'
0,2,3,57,3,9,2,60,0,21-year-old syrian risked life oscar-nominated documentary
0,2,2,64,3,10,4,66,0,"oscar 2017: hollywood talent agency cancel party, host pro-refugee rally instead"
0,3,15,47,3,14,2,62,0,fighter plane f-16 made india? u india discussing possibility
0,2,4,27,0,6,0,31,0,throwing lifeline high sea
0,1,5,65,1,8,0,70,0,"wikinews interview juana bustamante, chilean earthquake survivor paniahue"
0,2,4,64,1,11,3,68,0,clinton foundation executive left 148 phone message hillary clinton top aide
0,2,9,47,1,8,0,56,0,ex-house speaker dennis hastert arraigned tuesday afternoon
0,1,6,33,0,5,0,39,0,hartmarx accepts buyout offer emerisque
0,1,4,59,0,12,0,63,0,wreckage plane thought missing air france flight found atlantic
0,3,11,49,2,10,0,60,0,debbie reynolds said 'greatest fear' outliving daughter
0,3,1,40,2,9,0,41,0,here's list best-selling beer world
0,2,13,37,3,12,0,50,0,george w. bush gave u donald trump. want forgiven.
0,3,9,54,1,12,0,63,0,na set perform california root music art festival: exclusive
0,2,0,61,3,8,1,61,0,7th-grader's science project find cancer-fighting chemical green tea
0,3,2,52,1,6,0,54,0,trump sign bill overturning obama-era education regulation
0,1,3,64,2,10,0,67,0,sprint nextel customer service rep. harasses client; sprint cancel account
0,2,6,44,3,10,0,50,0,venezuela president cnn: 'do put nose venezuela'
0,1,3,31,0,5,2,34,0,11 mp ejected australian parliament
0,1,1,27,0,7,4,28,0,slovakia track adopt euro 2009
0,1,4,35,2,8,0,39,0,four u.n. staff dead plane crash bolivia
0,2,12,55,9,16,0,67,0,"trump: feeling sorry hillary shes victim, enabler breitbart"
0,2,15,53,2,14,0,68,0,"blood test could soon help gauge long live, according scientist"
0,2,1,65,1,13,0,66,0,"find sound people chewing annoying, scientist worked"
0,3,12,45,3,11,0,57,0,"ajit pai, net neutrality foe, expected named fcc chairman: report"
0,1,8,40,0,9,0,48,0,hartmarx said choose london firm emerisque buyer
0,2,4,56,2,9,0,60,0,ahok: jakarta governor's blasphemy trial proceed indonesian court
0,2,6,40,1,9,0,46,0,life martin luther king jr: telegraph time tunnel
0,2,5,79,4,15,0,84,0,"anne frank: pendant 'identical' one belonging diarist found sobibor nazi camp, researcher say"
0,3,8,49,0,8,0,57,0,judge toss dakota pipeline motion seeking block construction
0,2,3,40,1,5,0,43,0,trump privately sign anti-planned parenthood law
0,2,12,62,3,15,0,74,0,chartbreaker: judah lion talk surprise chart hit opening twenty one pilot
0,2,3,61,3,11,0,64,0,tinder's in-house sociologist explains score date valentine's day
0,2,13,44,5,14,7,57,0,"week billboard chart history: 2010, kesha's 'tik tok' topped hot 100"
0,3,2,56,1,14,0,58,0,donation world save cat one wanted touch yahoo
0,1,8,56,0,14,0,64,0,white house chief staff rahm emanuel step run mayor chicago
0,1,1,40,0,4,0,41,0,guidant announces defibrillator problem
0,1,9,31,0,8,0,40,0,online ad know friend shop
0,2,1,76,1,13,0,77,0,queensland police search crocodile fisherman's body found day teen attack
0,2,9,44,1,10,5,53,0,"epic drug lab scandal result 20,000 conviction dropped"
0,3,2,47,1,11,0,49,0,"tried post fake news facebook, happened"
0,2,3,45,0,8,0,48,0,cruz beckham dropped debut christmas single
0,1,8,31,3,8,0,39,0,smart play baseball n.f.l. sirius deal
0,3,13,43,2,15,0,56,0,power small nation. wind farm china mostly idle.
0,2,1,27,0,4,0,28,0,deadly storm hit several state
0,1,8,38,0,9,0,46,0,city plan make older building refit save energy
0,2,5,17,2,4,3,22,0,360 video channel nytimes.com
0,1,6,28,1,5,0,34,0,"missing manager, mets find offense"
0,2,5,45,2,10,0,50,0,bernie sander want take back family value gop
0,2,1,50,2,10,4,51,0,"red-letter day oil spreads, market see 2017 rebalancing"
0,2,6,22,0,6,0,28,0,mlk might say donald trump
0,1,9,30,3,8,0,39,0,"first, u.s. provides pakistan drone data"
0,2,7,35,1,9,2,42,0,week 17 nfl power rankings: chief move top three
0,3,3,37,0,8,2,40,0,montenegro charge 14 alleged plot oust pm
0,3,8,45,2,9,4,53,0,"nintendo release mini-size switch 2019, citigroup predicts"
0,2,3,46,1,6,0,49,0,vladimir putin popularity soaring among republican
0,1,5,22,3,6,6,27,0,"seton hall upset no. 12 georgetown, 65-50"
0,3,10,52,0,9,0,62,0,donald trump try reassure supporter health care humiliation
0,1,4,25,0,5,0,29,0,camel rock festival held scilly
0,3,3,41,2,7,0,44,0,rachel lindsay first black 'bachelorette'
0,1,6,33,1,5,0,39,0,pakistan rehearses two-step airstrikes
0,2,13,58,7,12,0,71,0,baltimore teen death threat-laced f**k donald trump music video go viral breitbart
0,2,1,66,0,10,0,67,0,skydive accident survivor rediscovers passion life open water swimming
0,3,2,57,2,9,0,59,0,"japan, russia sign economic development pacts; stalemate territory"
0,1,8,33,3,5,0,41,0,u.s. overture find support among cuban-americans
0,3,2,52,4,6,0,54,0,u-md. president call sanctuary campus designation unnecessary
0,3,2,42,0,6,0,44,0,north korean missile explodes second launch
0,2,2,49,1,9,0,51,0,muhammad ali grace broke mold heavyweight champion
0,2,4,71,1,13,0,75,0,united ceo's response passenger dragged plane made situation even worse
0,2,13,47,0,12,0,60,0,young immigrant edge waiting see donald trump deport
0,2,8,37,6,10,0,45,0,trump saturday night live? nope. putin ansari.
0,1,7,50,1,9,0,57,0,economic opportunity woman still lagging: world bank oecd
0,2,2,53,5,10,0,55,0,"""sorry..."" nail salon sign say overweight customer need pay extra"
0,1,1,39,0,4,0,40,0,indonesian goverment ban pornographic site
0,3,10,49,1,10,0,59,0,north carolina lawmaker reach deal repeal so-called bathroom bill
0,3,22,32,1,9,0,54,0,jeremih disses partynextdoor dallas summer's tour
0,2,8,48,0,10,0,56,0,trump poised wield executive power make immigration change
0,1,1,40,0,6,0,41,0,vatican denies church shielding war criminal
0,2,2,45,0,7,0,47,0,tech industry opposition trump travel ban escalates
0,2,1,63,1,14,0,64,0,boyfriend buy girlfriend gift dreams: blanket face
0,3,8,41,0,7,0,49,0,woman make delightful taxidermy squirrel
0,1,7,33,1,5,0,40,0,murder trial test colorado hate-crime statute
0,1,2,32,0,6,0,34,0,gaza strip report first swine flu case
0,1,5,18,1,6,5,23,0,"nissan cut 20,000 job amid loss"
0,2,10,52,1,9,0,62,0,journalist describes loneliness leakiness trump white house
0,3,8,37,5,8,0,45,0,"bolling: 'russia elect trump, america did' insider"
0,2,4,60,4,11,0,64,0,shannon purser: people actually barb face tattooed body
0,1,1,38,0,4,0,39,0,moldovan parliament approves new government
0,2,9,33,2,7,0,42,0,report: corey lewandowski land cnn gig breitbart
0,3,10,46,3,9,0,56,0,canada foreign minister voice concern u.s. trade proposal
0,2,7,26,0,8,0,33,0,big short threatens big bust
0,3,2,73,0,14,0,75,0,federal judge decline immediately apply freeze first trump travel ban new order
0,3,12,51,4,12,0,63,0,lakers gm rob pelinka kobe bryant's friendship: 'what beethoven music'
0,2,17,49,7,15,0,66,0,"scott baio harsh word co-star's death: 'you drug drink, gonna die'"
0,2,11,49,2,14,0,60,0,"china, homeowner find land doubt new york time"
0,2,4,47,2,9,0,51,0,glory: michelangelo's naked christ come britain
0,1,7,33,1,8,0,40,0,"good run mutual funds, question remain"
0,1,3,50,0,6,0,53,0,u senate unanimously pass genetic nondiscrimination bill
0,3,10,43,3,11,0,53,0,ag session hawaii remark: nobody sense humor anymore
0,1,2,44,0,6,0,46,0,afghanistan suicide bomb leaf seven american dead
0,1,4,57,0,9,0,61,0,north korean military fire artillery populated south korean island
0,3,2,52,1,8,0,54,0,microneedling: beauty treatment craze available home
0,3,9,38,0,8,0,47,0,metro area largest smallest paycheck
0,2,10,59,0,10,0,69,0,american pharoah jockey victor espinoza donates belmont stake money charity
0,2,6,39,1,9,0,45,0,"adam west, burt ward promise return batman robin"
0,3,7,49,1,12,0,56,0,raid remote yemen seal death still reverberate trump
0,1,2,60,1,10,0,62,0,"eleven day later, survivor pulled rubble chinese earthquake"
0,2,8,48,1,7,0,56,0,zimbabwe: thousand storm capital demanding robert mugabe resign
0,1,3,52,0,8,0,55,0,eu budget chief claim win lithuanian presidential election
0,3,9,48,2,9,0,57,0,former president obama beat richard branson surf contest [video]
0,2,14,60,1,14,0,74,0,supreme court block north carolina restoring strict voting law new york time
0,1,7,25,2,8,4,32,0,no. 20 louisville wear no. 12 notre dame
0,3,8,53,1,11,0,61,0,game throne actor alfie allen join shane black's predator reboot
0,2,1,40,1,7,0,41,0,man acquitted rape woman scream
0,3,7,23,1,6,0,30,0,economy miss new-car smell
0,3,9,55,2,13,1,64,0,"steve kerr game 4 vs. blazer back injury, playoff status uncertain"
0,3,17,49,1,14,0,66,0,trump epa cut lead paint program going hit black people hardest
0,2,2,49,4,13,0,51,0,"trump 'repeal lot' obama's action day one, top aide say"
0,3,3,63,2,12,0,66,0,"dislike button, might get dislike reaction facebook messenger"
0,2,2,26,0,4,0,28,0,blackberry stop making phone
0,2,12,57,1,11,0,69,0,"berlin christmas market attack suspect killed shootout italy, official say"
0,2,9,45,7,9,0,54,0,"ask billboard: 'black beatles,' 'black barbies' response song"
0,3,1,56,1,10,0,57,0,chaos ensues snow tuber follow conveyor belt rule
0,1,5,48,0,9,0,53,0,bbc begin trial program allowing legal tv radio downloads
0,3,1,41,0,7,0,42,0,kenya herdsman clash police land conflict
0,3,11,38,1,10,0,49,0,"trump tweet old photo schumer putin, call probe"
0,2,2,9,0,1,0,11,0,steve kimock
0,1,4,27,0,5,0,31,0,human intrude indonesian park
0,1,6,33,2,7,0,39,0,microsoft songsmith easy (if painful hear)
0,3,6,35,1,9,0,41,0,"hiv rate lowest five year nsw, figure show"
0,3,10,37,3,10,4,47,0,"kuwait best off, nigeria worst fitch's 2017 oil break-even"
0,3,3,78,3,13,0,81,0,donald trump call halt press secretary's confusion executive order 'banning' muslim
0,2,10,34,2,8,0,44,0,demanding direct: hsbcs new chairman mark tucker
0,2,4,77,4,19,0,81,0,'i two year-old girl thought going die': witness describe terror paris attack
0,2,4,54,1,12,0,58,0,even tough time fidel castro cuba placed great value sport
0,3,2,59,1,13,0,61,0,one best low-cost airline world finally coming america
0,2,9,48,2,9,0,57,0,mar-a-lago double initiation fee membership interest swell
0,3,11,48,2,10,4,59,0,"nba slam dunk contest 2017: updated participant list, comment reaction"
0,3,3,82,5,24,7,85,0,"land 475 month dole even work: unemployed finland paid 6,000 year part social experiment"
0,1,1,53,1,8,0,54,0,"namibia struck floods, president declares state emergency"
0,1,6,19,0,6,0,25,0,shine myspace may fade bit
0,1,5,22,0,4,0,27,0,boise region grapple smog
0,3,2,50,2,10,4,52,0,"hamilton london ticket appear resale site upwards 2,000"
0,2,9,51,1,9,0,60,0,"pope francis urge peace, comfort terror victim christmas message"
0,1,4,31,0,5,0,35,0,odense sc win danish squash championship
0,1,2,55,0,7,0,57,0,obama declares tougher emission target copenhagen summit
0,1,5,46,0,8,0,51,0,injured nasa astronaut replaced crew upcoming mission
0,2,5,50,0,11,0,55,0,fda take step protect blood supply florida amid zika probe
0,1,5,35,0,6,0,40,0,number homeowner facing foreclosure rise
0,3,11,51,0,9,0,62,0,youtube star christian collins sign management deal randy jackson
0,1,5,31,0,6,0,36,0,baseball denies charge book radomski
0,1,2,61,0,8,0,63,0,iran promise retaliation israeli action nuclear facility
0,3,8,32,2,7,0,40,0,stevie nick strike 'gold' latest solo tour
0,2,5,53,1,10,0,58,0,tomahawk missiles: explaining weapon u used strike syria
0,3,10,36,2,10,0,46,0,watch far alessia cara go 'saturday night live'
0,1,1,33,0,5,0,34,0,scientist find key human language gene
0,1,5,44,0,8,0,49,0,iraqi journalist throw shoe u president george bush
0,2,4,67,2,15,0,71,0,we're six patriot player publicly said visit white house
0,3,7,70,7,17,2,77,0,meet alden ehrenreich 27-year-old actor play han solo next 'star wars' spin-off
0,1,2,28,0,6,0,30,0,u home price drop record level
0,1,10,46,1,9,0,56,0,"memphis win conference usa title, binghamton america east"
0,1,5,48,2,10,4,53,0,mt duo robot taiwan 2008: vast opportunity machinery industry
0,2,9,49,0,11,1,58,0,suspect arrested 2 officer shot traffic stop georgia
0,2,2,65,1,10,0,67,0,anti-putin protester plan next move jailed opponent considers election bid
0,1,1,45,1,7,4,46,0,"honduras deploys 8,000 troop ensure peaceful election"
0,1,10,43,1,9,0,53,0,"brown backtracks, saying iraq panel hold open hearing"
0,2,12,52,0,11,0,64,0,wpp share slide advertising giant post slowest revenue growth year
0,2,7,32,1,6,0,39,0,hawaii judge block trump's revised travel ban
0,1,1,54,0,7,0,55,0,virginia crime commission endorses tougher dog law legislation
0,3,14,58,0,13,0,72,0,govt deport rohingya muslim thrown myanmar buddhist extremist
0,3,12,59,6,10,0,71,0,harrison ford remembers carrie fisher heartfelt statement: 'one-of-a-kind'
0,2,3,45,0,9,0,48,0,taco bell using one key advantage overtake chipotle
0,3,12,40,3,12,0,52,0,marshawn lynch play villain 'call duty: black ops iii'
0,1,1,26,0,4,0,27,0,iran end nuclear cooperation
0,1,2,27,0,4,0,29,0,russia announces libyan arm deal
0,1,3,31,2,5,0,34,0,iraq approves execution 'chemical ali'
0,3,19,57,2,18,0,76,0,"virat kohli alien, batting sure make look like he's another planet"
0,2,10,39,0,9,0,49,0,al franken unleashed special counsel donald trump
0,3,5,76,0,15,0,81,0,young people would rather watch david attenborough talk animal x factor list
0,3,17,55,1,15,0,72,0,get pokmon go's holiday starter infestation event end
0,2,4,55,1,10,0,59,0,obama mounting pressure disclose russia role u election
0,1,7,23,1,6,0,30,0,anti-love drug may ticket bliss
0,3,5,79,2,14,2,84,0,gambia election: government shuts internet president yahya jammeh face threat 22-year rule
0,1,5,41,0,7,0,46,0,wikinews interview uk pro dart player kirk shepherd
0,2,3,33,0,9,0,36,0,press freedom cosh uk
0,2,11,38,5,10,0,49,0,clinton: really dont know young people dont support
0,2,10,47,2,11,0,57,0,ohio man let internet control home's christmas light yahoo
0,3,1,44,2,7,0,45,0,"antarctica's penguin trouble, new report show"
0,3,9,45,2,10,0,54,0,watch enrique iglesias film 'sbeme la radio' video havana
0,2,2,49,0,11,0,51,0,easily find significant ontinder
0,1,2,22,0,3,0,24,0,airplane crash nigeria
0,2,3,60,2,11,0,63,0,higher education awash hysteria. might helped elect trump.
0,2,6,26,0,7,4,32,0,gregg allman scrap tour date 2017
0,2,14,63,2,19,0,77,0,"orlando, son muslim immigrant rushed heal pain caused another new york time"
0,3,9,59,1,13,0,68,0,family first's lucy gichuhi set replace bob day south australian senate seat
0,3,3,70,2,12,2,73,0,"luxurious, 45-acre compound maryland shut alleged russian espionage"
0,2,14,50,1,13,0,64,0,give roy williams credit deserves: unc coach best generation
0,1,2,36,0,8,3,38,0,cypriot plane 121 board crash greece
0,3,7,44,1,8,0,51,0,charles oakley attend knicks vs. cavalier cleveland
0,3,7,42,2,10,3,49,0,rick morty vr game virtual rick-ality get 4/20 release date
0,2,6,34,1,9,0,40,0,morning brief: trump take center stage cpac
0,1,3,17,0,3,3,20,0,canjet flight 918 hijacked
0,2,10,37,0,9,0,47,0,google home beating alexa important way
0,3,6,29,0,6,0,35,0,pie fly sky high science experiment
0,2,9,39,3,7,0,48,0,watch: protester interrupt trump rnc speech breitbart
0,2,13,47,2,14,0,60,0,hiring hurdle: finding worker pas drug test new york time
0,3,1,34,0,6,0,35,0,trump find limit executive power
0,3,6,34,0,6,0,40,0,trump launch attack unnamed press source
0,3,8,33,1,7,0,41,0,fed sue nypd man's hiv discrimination claim
0,3,10,37,1,10,0,47,0,uber say keep self-driving car san francisco
0,3,5,17,0,5,0,22,0,room left behind
0,3,2,64,2,12,2,66,0,car-sharing service partner uber snatched $45 million funding
0,2,1,13,1,3,0,14,0,snow?
0,1,6,27,0,6,0,33,0,home price index fell november
0,2,3,72,1,18,0,75,0,google idea goofy hat camera brim work like snap's spectacle
0,2,5,71,5,13,0,76,0,ape heels: w.va. mayor resigns amid controversy racist comment michelle obama
0,2,1,65,2,13,0,66,0,antwerp 'text lanes' pedestrian glued mobile phone
0,2,2,56,2,9,0,58,0,jameis winston lament 'poor word choice' elementary school speech
0,1,7,41,4,9,0,48,0,"coca growth bolivia, peru, claim u.s. state department"
0,2,1,53,0,10,0,54,0,shell study green energy deal prepare future oil
0,1,2,42,1,8,2,44,0,italian police find 24 child living rome's sewer
0,2,1,51,0,12,0,52,0,app tell pregnant woman need subway seat
0,3,8,22,2,4,4,30,0,nfl1000: top overall free-agent ranking
0,2,6,71,5,15,0,77,0,bill o'reilly: media's treatment maryland high school rape 'beyond anything ever seen'
0,2,1,55,0,10,2,56,0,pakistan open investigation deadly plane crash killed 47
0,1,6,47,1,8,3,53,0,space shuttle discovery successfully lift mission sts-128
0,2,6,39,2,6,0,45,0,modern french-inspired mcdonalds arrives newyork
0,1,4,54,3,9,0,58,0,"elvish, klingon na'vi: constructed language gain foothold film"
0,1,2,27,0,6,0,29,0,mike tyson set retire loss
0,3,6,63,6,12,0,69,0,jon stewart warns america donald trump presidency: 'f***ing buckle seat belt'
0,3,2,46,2,8,2,48,0,heathrow: second day freezing fog ground 80-plus flight
0,1,9,31,3,8,0,40,0,state join e.p.a. study pathogen ohio river
0,2,13,49,0,9,0,62,0,nra employee accidently shoot nra firearm training session
0,2,2,29,0,4,0,31,0,spacex abort space station docking
0,1,5,29,0,8,2,34,0,welsh tv pioneer owen edward dy age 76
0,3,10,38,0,9,0,48,0,minnesota transgender teen sued mom speaks
0,1,1,34,0,5,0,35,0,stock market worldwide continue fall
0,3,7,63,1,15,4,70,0,mexican journalist suspected super bowl thief? turn tom brady met 2005
0,3,9,44,0,8,0,53,0,kirk cousin shove referee charity flag football game
0,3,3,39,0,7,0,42,0,nh poll find public think service getting worse
0,1,3,49,0,10,0,52,0,politician call action flood cause havoc uk
0,3,1,37,1,5,0,38,0,reader recommend playlist: song doom
0,2,1,56,4,9,2,57,0,"powerball hit $1.5 billion, largest-ever lottery jackpot one winner"
0,1,3,22,2,6,2,25,0,brazil invest u $3.6bn slum
0,2,1,51,0,10,1,52,0,border officer find nearly 2 ton weed camouflaged lime
0,1,7,36,1,6,0,43,0,"olympic rerun, wanjiru capture london marathon"
0,3,2,39,4,7,0,41,0,schumer: wish triggered 'nuclear option'
0,2,3,35,1,7,0,38,0,kim jong un sartorial power play turnsheads
0,3,15,51,3,14,6,66,0,"indian-americans raise $100,000 help man tried save indian killed kansa"
0,2,5,63,0,13,0,68,0,fox news set afghanistan bombing toby keith song outlet voice doubt
0,1,5,55,0,11,0,60,0,vitamin c help prevent cancer say national institute health
0,1,1,62,1,9,0,63,0,norwegian national assembly vote allow same-sex marriage adoption
0,1,1,40,0,4,0,41,0,gibraltar police investigate suspicious death
0,2,3,48,5,10,0,51,0,agony earth's hottest year: 'i miss cold-cold weather'
0,3,5,56,2,12,0,61,0,teacher turn 'bad boujee' educational song civil war
0,1,3,40,0,5,0,43,0,uk transport firm metronet facing administration
0,3,2,63,2,13,1,65,0,"caught video: mom, 3 kid rescued minivan plunge steep embankment"
0,2,13,48,0,10,0,61,0,appeal court shoot doj request immediately restore travel ban
0,1,1,30,0,6,2,31,0,50 dead ferry myanmar capsizes
0,3,11,38,0,11,0,49,0,hot new boyband china made entirely girl
0,2,14,62,3,17,0,76,0,beyonce drop new 'die you' video playlist tidal honor jay z wedding anniversary
0,3,4,58,2,11,0,62,0,airport protest muslim ban spread across u.s. via social medium
0,1,1,39,1,6,0,40,0,new entrance discovered world's longest cave
0,2,5,59,0,12,0,64,0,kellyanne conway join trump white house counselor president
0,1,7,62,1,11,0,69,0,"atlanta thrasher sold true north sport entertainment, moving winnipeg"
0,2,2,50,1,7,0,52,0,prosecutor pursue misconduct charge christie
0,2,13,66,0,13,0,79,0,democratic aide see possibility compromise gop modest change financial law
0,3,9,56,2,13,0,65,0,super bowl li preview: atlanta falcon face new england patriot video
0,3,8,41,3,11,6,49,0,"ray dalio make client $4.9 billion 2016 paulson, soros falter"
0,3,11,43,1,9,0,54,0,ex-la county sheriff lee baca found guilty corruption retrial
0,2,2,34,1,5,0,36,0,police: philly gunman left rambling letter
0,1,7,39,2,7,0,46,0,"jebreen, extremist saudi cleric, treated germany"
0,3,8,51,2,8,1,59,0,deadpool director ted miller address rumor surrounding 'deadpool 2'
0,2,1,32,0,4,0,33,0,brazil open first elephant sanctuary
0,3,12,46,0,9,0,58,0,constituent shame gop lawmaker ducking town hall meeting
0,1,2,54,0,8,0,56,0,former taiwanese president jailed life corruption charge
0,3,10,39,3,8,0,49,0,china's name-and-shame tv show put household brand edge
0,2,2,45,4,8,6,47,0,australia lost $4.8b 2014 tax-dodging multinationals: oxfam
0,2,2,75,3,13,4,77,0,yorkshire ripper questioned 17 unsolved crime including hammer attack 14-year-old girl
0,2,13,43,2,11,0,56,0,"wooed trump, conservative fall line ocare repeal bill"
0,2,11,38,0,12,6,49,0,10 nba free agent likely overpaid 2017 offseason
0,3,6,45,4,7,0,51,0,takk's great escape: ucla pass-rusher's remarkable journey
0,2,12,57,5,13,0,69,0,trump: didnt soften stance china trade currency manipulation breitbart
0,1,3,33,1,4,0,36,0,peru-chile rivalry erupts cyberspace
0,2,3,50,0,10,0,53,0,carmelo anthony likely sitting knicks tenure air
0,1,4,25,0,3,0,29,0,israel completes gaza withdrawal
0,3,3,51,4,7,0,54,0,destination amsterdam's cannabis 'coffee shops' closing?
0,3,1,67,1,14,0,68,0,trump's approval rating worst start president recent history
0,3,11,67,6,14,0,78,0,"mashable periscope: ""good morning downtown austin! riding #mashhouse #sxsw"""
0,1,2,16,0,6,3,18,0,xbox 360 hit japan
0,2,2,54,0,10,0,56,0,boy released another arrested killing leeds teenager
0,3,5,61,2,10,0,66,0,"wikileaks responds cia director calling ""hostile"" intelligence service"
0,1,5,52,0,12,0,57,0,uk prince william pick brother harry best man royal wedding
0,2,9,45,1,9,0,54,0,travis scott's mother jokingly dragged twitter typo
0,2,21,52,2,15,0,73,0,crpf sniffer dog 'cracker' killed ied explosion chhattisgarh laid rest
0,3,1,41,0,6,0,42,0,india announces largest solar rooftop tender
0,3,5,53,0,8,0,58,0,conservative freedom caucus back revised obamacare overhaul plan
0,2,11,67,1,12,0,78,0,congressman back libertarian presidential candidate campaign first new york time
0,2,4,58,2,14,0,62,0,north korea could missile capable striking u 'the next years'
0,1,2,29,0,4,0,31,0,pope appeal respectful sunday
0,1,5,47,0,7,0,52,0,bollywood star aishwarya rai abhishek bachchan engaged
0,2,3,87,4,18,7,90,0,"450 charter bus city parking permit inauguration. 1,800 registered womens march."
0,1,4,63,0,10,0,67,0,testimony john travolta son autistic raise scientology question
0,1,2,47,0,8,0,49,0,american war deserter given stay deportation canada
0,2,11,46,4,11,0,57,0,subdued vladimir putin call mutually beneficial tie u.s.
0,1,6,28,1,6,0,34,0,"beyond sports, lesson desmond tutu"
0,1,5,47,2,10,0,52,0,"two pilot killed head-on collision radom air show, poland"
0,1,6,50,1,10,2,56,0,baseball: former houston astros pitcher jos lima dy suddenly 37
0,3,14,45,1,12,0,59,0,waymo tap phoenix big public test google self-driving car tech
0,1,5,45,1,8,0,50,0,major league soccer: beckham miss game toronto
0,2,10,58,3,9,0,68,0,revealed: sweden migrant accommodation killer child fibbing adult somalian
0,1,5,58,0,11,2,63,0,four arrested birmingham uk connection july 21 attempted bombing
0,1,5,62,0,12,0,67,0,un observer syria fired upon report alleges u warplane readying attack
0,2,2,38,0,5,0,40,0,desperate family fleeing eastern aleppo
0,3,7,47,2,8,0,54,0,"openly testy, republican reject president wiretap claim"
0,2,6,34,0,7,0,40,0,donald trump face barrage new allegation
0,1,3,46,3,9,0,49,0,"'piano man' speaks identified, return home germany"
0,3,15,56,4,14,2,71,0,half u.s. refugee arrival last year resettled 10 state [infographic]
0,3,1,43,0,8,2,44,0,china post weakest annual economic growth 26 year
0,2,2,45,2,9,0,47,0,korean air crew 'use force' unruly passenger
0,2,3,42,1,8,1,45,0,8 important quote james comeys hearing
0,2,4,66,2,13,0,70,0,"deadly mission: kurd risk smuggling alcohol iran, even baghdad mull ban"
0,2,6,33,0,8,0,39,0,connecticut hunt fix bear problem
0,1,2,24,0,4,0,26,0,bird attack people houston
0,3,4,55,1,10,0,59,0,upgrade window vista becomes unsupported?
0,1,4,59,1,9,0,63,0,"facebook hired pr firm discredit google, reveals leaked correspondence"
0,3,4,66,0,14,0,70,0,donald trump kicked one direction hotel refusing meet daughter
0,1,5,24,3,8,7,29,0,"hedge fund make 5-10% 2009, survey find"
0,3,3,48,1,8,0,51,0,clemson-alabama rematch game college football need
0,2,2,35,1,5,0,37,0,pot ruining denver restaurantindustry
0,3,6,69,1,16,0,75,0,donald trump urged condemn white u army veteran racist murder black man new york
0,3,14,68,6,15,0,82,0,watch soul-stirring performance 'quiet' women's march choir 'full frontal samantha bee'
0,3,13,42,1,8,0,55,0,watch live: confirmation hearing scotus nominee neil gorsuch
0,1,7,39,1,7,0,46,0,"duke virginia advance, completing final four field"
0,3,4,82,3,14,0,86,0,washington redskin gm suddenly longer helping make team's decision 'dysfunction abounds'
0,2,4,45,1,8,0,49,0,support finnish anti-eu party slump local election
0,3,3,58,0,10,0,61,0,company behind dakota access pipeline another controversy
0,2,12,58,0,12,0,70,0,kendall jenner said pepsi commercial concept backlash
0,1,6,30,0,7,0,36,0,suspect held slaying chechen exile
0,2,8,48,0,11,0,56,0,lebron james writing greatest nba final story ever told
0,3,2,34,0,5,0,36,0,man arrested birmingham bus stabbing
0,1,9,39,1,8,0,48,0,"david villa scores, rich club ponder checkbook"
0,3,3,46,0,9,0,49,0,justin trudeau take trump perfectly timed photo
0,1,1,47,0,6,0,48,0,quaker website editor launch music podcast programme
0,3,9,44,2,8,0,53,0,"china yuan outflow plummet, showing capital control pay"
0,3,10,30,1,8,0,40,0,fear mers pose risk south korea economy
0,1,2,55,1,7,0,57,0,"russian peacekeeper leave transdniestria, official say"
0,2,6,59,2,15,1,65,0,"nato russia talked 3 hours, they're still divided ever ukraine"
0,1,5,25,0,5,2,30,0,baylor keep barreling big 12
0,2,7,32,1,10,0,39,0,"living girl scout law, even without home"
0,2,2,68,0,13,4,70,0,un say world face worst humanitarian crisis since 1945 ten million starving
0,2,3,79,0,15,1,82,0,nationaltrust blamed visitor urinating avebury stone deciding close loo 4pm
0,1,6,33,0,7,0,39,0,sarkozy merkel try shape european unity
0,2,7,40,2,7,4,47,0,march madness 2017 predictions: breaking experts' pick
0,1,5,21,0,4,0,26,0,rebel raid sri lankan capital
0,1,6,31,0,7,0,37,0,cross inflation long list worry
0,3,13,48,4,12,0,61,0,"future talk controversial lyrics: 'if ruffle feathers, is'"
0,3,7,46,3,10,0,53,0,"review: lemony snickets creations, cloud marvelous gloom"
0,2,8,48,0,10,0,56,0,jarring new level confrontation conflict hit washington
0,2,8,40,0,9,0,48,0,facebook push outside law firm become diverse
0,2,5,48,1,9,0,53,0,u say china return underwater drone; trump slam beijing
0,2,5,46,0,11,0,51,0,espn forced fire favoriteanchors
0,1,7,29,3,7,0,36,0,"jayant ""dr death"" patel arrested oregon, u"
0,3,2,55,4,7,3,57,0,mh370: independent expert mistrust 'confidence' plane's location
0,2,10,49,1,10,0,59,0,mexican oil auction offer first major test foreign firm interest
0,1,7,27,0,7,0,34,0,afghan woman protest new law home life
0,3,3,45,3,10,0,48,0,"madonna trump: election win like ""being dumped lover"""
0,3,3,80,1,13,0,83,0,"warned potential hacking, danish politician left smartphones home russia trip"
0,2,3,43,0,9,0,46,0,minor league baseball player fight right ot pay
0,2,12,52,2,11,0,64,0,"wwe superstar kane announces he's running mayor knox county, tennessee"
0,1,5,36,0,5,0,41,0,medvedev visit newspaper slain journalist
0,1,6,38,0,6,0,44,0,daisy dick win barbury international horse trial
0,2,2,39,0,7,0,41,0,diver search victim russian plane crash
0,2,4,45,2,9,0,49,0,"kentucky, trump stronghold, many fear losing obamacare"
0,2,3,59,0,11,0,62,0,sir bruce forsyth spends five day intensive care chest infection
0,1,2,25,0,3,0,27,0,climate change impact wyoming
0,2,14,57,6,14,0,71,0,wapo: trump stephen k. bannon hire middle finger gop establishment breitbart
0,2,3,60,4,10,0,63,0,trump nominated top boeing executive mattis second-in-command
0,1,4,41,1,10,1,45,0,u b-2 bomber crash guam caused moisture sensor
0,3,9,55,0,9,0,64,0,republican making little progress obamacare repeal strategy
0,1,8,37,1,6,0,45,0,yankee profit seventh-inning stretch
0,1,7,29,0,7,0,36,0,marlin slide past mets rally ninth
0,3,4,71,3,14,2,75,0,retired french doctor unwitting owner 'lost' leonardo da vinci drawing worth 15 million
0,1,1,28,1,4,2,29,0,6.4 magnitude earthquake hit taiwan
0,2,2,63,3,12,2,65,0,tamir rice: judge find cause murder charge police killing 12-year-old
0,2,6,58,5,11,0,64,0,"army-navy game, trump say thought leading u soldiers, sailor humbling"
0,3,10,34,2,10,4,44,0,fabolous trey songz ring 2017 'trappy new years'
0,3,10,43,2,9,0,53,0,here newspaper around world covered womensmarch
0,2,10,48,4,10,0,58,0,kevin durant vs. russell westbrook? think again: stephen curry time
0,2,8,27,5,8,0,35,0,whats stake trump proposed e.p.a. cut
0,2,2,51,0,8,0,53,0,fort lauderdale airport shooting survivor saved laptop
0,3,10,37,2,8,0,47,0,northwestern mutualvoice: rate hike way?
0,3,11,59,2,14,0,70,0,watch alec baldwin trump fail protect earth alien 'saturday night live'
0,2,14,41,1,9,0,55,0,"marriage equality delayed, lgbti people arecheering"
0,2,9,60,3,10,0,69,0,voter defeat transgender ideology north carolina bathroom debate breitbart
0,1,8,37,0,8,0,45,0,religious group seek swift ban obama torture
0,1,6,39,2,8,0,45,0,shuttle discovery given 'go' landing edward afb
0,3,15,46,1,16,2,61,0,"unable walk 16, unc lineman naz jones get drafted nfl"
0,3,10,38,2,10,0,48,0,"olympic ghost town: bill due, venue empty rio game"
0,2,3,60,1,12,0,63,0,wikileaks give tech company early access next hacking docs: assange
0,2,2,51,2,9,0,53,0,iraqi want crackdown sleeper cell huge baghdad bomb
0,2,4,53,0,10,0,57,0,barclays ceo dines hedgies wrest business unlikelyfoe
0,2,3,48,0,9,0,51,0,u avoids syria talk deadly explosion rock refugee camp
0,2,7,49,0,7,0,56,0,merkel government guard political cyberattack threat
0,2,9,42,1,10,0,51,0,"zeal china dims, global company complain boldly"
0,1,5,27,0,5,0,32,0,illinois perjury charge burris
0,2,1,53,6,15,0,54,0,girl path cost voice generation
0,1,5,54,0,9,0,59,0,natural gas discovered chile according president ricardo lagos
0,2,15,62,3,14,0,77,0,"global citizen, donald trump immigrant ban deeply affected me, say priyanka chopra"
0,1,1,42,0,5,0,43,0,australian academic study support nuclear power
0,3,7,35,2,6,0,42,0,madonna defends anti-trump speech women's march
0,3,12,46,2,9,0,58,0,crossing deadly train-bus collision history accidents: ntsb
0,2,4,42,2,11,0,46,0,stop talking lin vs. kobe lakers
0,1,2,39,0,6,0,41,0,olympic torch extinguished three time paris
0,1,3,64,0,9,0,67,0,california teamster picket orange county transit system contract dispute
0,1,5,35,0,6,0,40,0,biology technology intersect create art
0,3,7,42,2,6,0,49,0,fact-checking president donald trump's inaugural address
0,1,7,33,0,7,0,40,0,thumbtack turn ipod recording device
0,2,9,39,2,7,0,48,0,ani amri: small-time criminal turned berlin truck killer
0,3,7,48,1,8,0,55,0,senate focus price obamacare plan confirmation debate
0,1,4,43,0,8,0,47,0,banned chinese medicine still sale united kingdom
0,1,1,28,0,3,0,29,0,liberian choose president
0,1,7,27,3,6,1,34,0,g.d.p. revised slightly 4th quarter
0,1,5,24,0,4,0,29,0,french worker ratchet threat
0,1,3,48,0,8,0,51,0,authority search home owner german wikileaks domain
0,3,2,56,1,12,0,58,0,"texas police officer faked death fled mexico, say official"
0,1,6,32,1,6,0,38,0,"thai rebel recruiting schools, study say"
0,3,6,31,3,9,0,37,0,nice night surfing. beware sharks.
0,1,2,34,0,6,0,36,0,u say polar bear threatened specie
0,3,1,38,0,9,1,39,0,2 die crush massive argentine rock concert
0,3,11,36,4,10,4,47,0,76ers d-league team show r2-d2 jersey 'star wars' night
0,3,4,60,2,11,0,64,0,john key's pick new zealand's next prime minister face party challenger
0,2,2,43,0,12,2,45,0,pizza hut offer crust made 28 miniature hot dog
0,2,1,45,1,7,0,46,0,viacom bos tout value company overlookedassets
0,3,3,38,0,8,2,41,0,g20 deal setback export champion germany
0,1,2,46,0,7,0,48,0,taibu quits zimbabwe cricket team threat
0,2,5,63,6,11,0,68,0,brexit: uk's prominent ex-ministers unite theresa may's 'no deal' threat
0,3,6,29,0,7,0,35,0,petroleum jelly may reduce risk eczema
0,3,8,36,0,7,0,44,0,donald trump say dissolve trump foundation
0,2,4,83,1,18,0,87,0,bernie sander lost poor voter south carolina big margin problem political revolution
0,2,3,51,3,14,0,54,0,artist hated fearless girl statue put foot
0,3,5,16,1,6,7,21,0,100 chers best tweet from2016
0,3,3,44,2,10,0,47,0,'la la land' look set smash yet another award ceremony
0,2,7,44,2,11,0,51,0,expect miley cyrus alicia key join voice
0,3,3,59,3,10,0,62,0,'beauty beast' director reveals disney's first openly gay character
0,2,11,49,4,10,0,60,0,ryans spin: nothing havent heard comeys released testimony
0,3,3,36,0,7,0,39,0,elon musk plan provide internet space
0,3,10,47,1,8,0,57,0,stephen curry learned nothing antagonizing lebron james?
0,3,3,53,4,8,0,56,0,"trump administration drop lawsuit n.c. ""bathroom bill"""
0,1,8,40,1,8,0,48,0,"twitter, ad habitat furniture exploit iran frenzy"
0,3,9,43,2,10,0,52,0,dozen say christian leader made british boy bleed jesus
0,1,6,43,0,9,4,49,0,china detains 81 ahead 50th anniversary tibetan uprising
0,3,8,55,2,10,0,63,0,stephen colbert actually made trailer nonexistent 'hidden fences'
0,1,5,40,1,8,0,45,0,"threat ship malacca strait, say singapore navy"
0,2,12,44,0,12,4,56,0,joe biden signed viral picture hot younger self 2017
0,3,5,37,1,6,0,42,0,contradicting trump russia: russian official
0,3,1,80,2,13,0,81,0,romania's new left-wing government legalises corruption one month voted office
0,1,6,33,0,6,0,39,0,burmese nobel laureate face military trial
0,2,3,36,3,9,0,39,0,de blasio co. cant stop lying aboutschools
0,1,6,35,0,8,0,41,0,knicks getting habit beating good team
0,3,14,35,1,10,0,49,0,inside making kylie jenner tyga's nsfw short film
0,2,4,47,1,7,0,51,0,ecuador election: voting succeed president correa begin
0,1,3,54,0,8,2,57,0,australia grant temporary asylum 12 commonwealth game athlete
0,2,2,67,5,10,0,69,0,kim jong-un hail 'eventful significance' country's new high-thrust rocket engine
0,1,4,22,0,4,0,26,0,senator tough ranger
0,1,3,21,0,4,0,24,0,israel seizes west bank land
0,1,1,50,0,6,0,51,0,indonesian volcano eruption prompt thousand evacuate
0,3,12,67,9,18,4,79,0,golden globe nomination 2017: la la land lead seven; people v. o.j. simpson lead tv five
0,3,8,55,0,11,0,63,0,migos sean kingston reportedly involved altercation la vega
0,2,1,42,2,8,0,43,0,ukip supporters: party go here?
0,1,2,36,0,8,0,38,0,nine dead plane crash car mexico
0,2,12,40,1,11,2,52,0,donald trump urge senate gop scrap 60-vote rule court pick
0,2,5,58,5,11,2,63,0,"minimum wage: actu pushing $45-a-week increase, employer want lower pay rise"
0,2,2,50,0,8,0,52,0,deadly mexico firework blast hit market packed holiday
0,3,12,48,2,11,0,60,0,man 'bursting pants' arrested cocaine smuggling airport
0,2,11,54,4,11,0,65,0,"carrie fisher's death, star share memory beloved 'star wars' actress"
0,3,11,54,0,11,0,65,0,dow chemical push white house kill risk study showing pesticide danger
0,1,1,29,0,5,0,30,0,prospect space elevator rise
0,3,13,37,0,10,0,50,0,george takei take aim donald trump fbi russia probe
0,3,1,57,3,7,0,58,0,"australian condition 'favourable' mouse plague, scientist warn"
0,1,4,61,2,12,0,65,0,"two dead, seven others wounded church gunfire tennessee, united state"
0,1,3,43,0,6,0,46,0,telstra sale legislation passed australian senate
0,3,7,52,2,8,0,59,0,"ambassador's death complicates russian, turkish cooperation syria"
0,3,4,65,0,16,0,69,0,trump went wanting stay syria going obama ever
0,2,14,64,5,15,0,78,0,sen. rand paul opposes trump airstrikes syria: united state attacked breitbart
0,3,9,51,1,9,0,60,0,global finance leader grapple globalization fear fox business
0,3,3,48,1,9,0,51,0,"eye trump, ryan relationship health care defeat"
0,3,7,31,1,7,0,38,0,raven grant kid's wish announce draft pick
0,2,8,28,1,6,0,36,0,chocolate chip cooky recipe nyt cooking
0,2,10,54,2,11,0,64,0,amazon jeff bezos exploring legal challenge trump travel ban breitbart
0,2,9,43,3,9,0,52,0,"stock fall, rattled trump saying dollar getting strong"
0,3,8,48,1,9,0,56,0,"lady gaga spotted studio, tease upcoming tour announcement"
0,3,9,45,1,9,0,54,0,isolation eu summit weakens support poland's ruling party
0,3,20,53,3,12,0,73,0,"delingpole: weather channel hot fake news; attack breitbart bad science, logic"
0,1,6,33,0,6,0,39,0,farm export fall sharply global recession
0,2,10,45,2,11,0,55,0,muslim teen become first box u.s. competition wearing hijab
0,1,2,32,0,4,0,34,0,evacuated bristol family return home
0,1,6,29,0,5,0,35,0,uk retailer mfi woolworth collapse
0,2,14,71,3,10,0,85,0,billboard latin music conference announces 'industry keynote masterclass' sony/atv executive
0,3,13,64,4,14,0,77,0,"drake, mac miller, beastie boy more: kosha dillz curate jewish rapper playlist passover"
0,3,13,51,0,12,0,64,0,doj asks time house intel committee asks wiretap evidence
0,2,9,40,0,9,0,49,0,ground assault islamic state mosul slow grind
0,1,8,38,0,12,0,46,0,modern dance art bring burst color gray city
0,1,7,31,0,6,0,38,0,new york benefiting movie incentive
0,3,1,45,1,8,0,46,0,"choking grape kill young children, doctor warn"
0,3,1,61,0,8,0,62,0,hungarian camerawoman get probation kicking tripping migrant
0,1,11,58,2,15,2,69,0,ice hockey: detroit red wing beat san jose shark 7-1 fourth nhl quarter final match
0,1,5,24,2,5,1,29,0,4 u.s. soldier killed afghanistan
0,3,9,43,0,10,0,52,0,two pilot arrested week allegedly flying drunk
0,1,8,32,2,8,0,40,0,"yes pull plug, temporarily, yankee star"
0,1,4,23,0,3,0,27,0,pakistan seizes terror suspect
0,2,12,50,2,11,0,62,0,lead detected baby food samples. pediatrician say there safe level
0,3,17,72,2,16,0,89,0,world junior championship olympic final evolution pv sindhu's rivalry carolina marin
0,1,10,39,2,10,0,49,0,former ebay executive try new bid. one political.
0,2,12,44,1,13,0,56,0,white life matter declared hate group new york time
0,1,8,34,2,6,0,42,0,"united arab emirate aid debt-ridden member, dubai"
0,2,2,59,1,12,0,61,0,donald trump gave bizarre response hell court female voter
0,2,6,30,0,9,4,36,0,2017 shaping volatile year market
0,1,6,28,1,7,0,34,0,"tech industry, sign comeback"
0,1,3,33,0,5,0,36,0,bristol central library closed fire
0,3,7,38,0,9,4,45,0,social medium ad spending outweigh print revenue 2020
0,3,3,65,1,9,0,68,0,former national security adviser michael flynn's security clearance suspended
0,3,7,42,0,7,0,49,0,paralympic hopeful get new leg devastating theft
0,3,1,43,1,6,3,44,0,"nigeria church collapse onto worshippers, killing 160"
0,1,5,24,0,5,0,29,0,russian treason bill revised
0,1,11,31,1,6,0,42,0,computer giant attack aussie csiro's wlan patent
0,3,13,45,2,12,0,58,0,someone steal tom brady's super bowl li jersey game ended?
0,2,2,39,0,9,0,41,0,tarzan evolved oaf toff back
0,1,7,37,0,7,0,44,0,company pretty price win stimulus project
0,3,12,36,3,9,1,48,0,hannibal buress troll kevin durant all-star 'nba 2k' game
0,2,1,82,1,16,2,83,0,shocking video show moment drink-driving mother fly 14ft air toddler back seat
0,3,1,33,1,6,0,34,0,china issue first-ever red alert fog
0,1,10,30,1,7,0,40,0,ex-bdo partner pleads guilty tax shelter case
0,3,3,37,1,10,3,40,0,doris day 7 celebrity 90 yahoo
0,3,6,54,0,11,0,60,0,white house shared article condemning donald trump list
0,3,5,77,3,14,0,82,0,hell angels: founding member thai chapter bashed australian bikies take 'dark business'
0,3,12,41,1,11,0,53,0,girl celebrated iconic way came itsperfect
0,3,2,52,1,7,0,54,0,federal reserve raise interest rate another quarter-point
0,3,6,71,5,16,0,77,0,kimbal musk elon's brother opened shipping container farm compound new york city
0,1,7,30,2,6,0,37,0,e.u. warns internet company user privacy
0,1,5,30,2,6,1,35,0,"freedom tower renamed ""1 world trade center"""
0,2,2,39,0,7,2,41,0,konrad reuland dy 29 following brainaneurysm
0,3,6,72,1,12,0,78,0,jeremy corbyn's biggest supporter len mccluskey challenged unite union leadership
0,2,9,38,0,9,2,47,0,roddy white retires nfl 11 season falcon
0,2,9,46,4,12,1,55,0,"fate furious outraces new film box office, nears $1 billion"
0,2,2,48,0,7,0,50,0,hundred veteran gathering dakota pipeline protest
0,1,5,30,1,5,0,35,0,"investor waver, market close higher"
0,1,8,34,0,9,0,42,0,walled city tuscany cling ancient menu
0,3,7,34,0,7,0,41,0,whole food close three regional kitchen
0,2,6,44,0,9,0,50,0,lebron james plotted heat exit dwyane wade satnearby
0,3,13,70,0,15,0,83,0,suspect joe mcknight murder case previous battery charge traffic intersection
0,2,10,34,4,8,0,44,0,mariah carey reveals cover art yg-assisted 'i don't'
0,1,2,29,0,3,0,31,0,four romanian ambassador recalled
0,3,5,58,1,8,0,63,0,neymar mock paris saint-germain star stunning barcelona comeback
0,2,8,43,1,9,0,51,0,latest: indonesia search effort hampered night fall
0,2,4,80,1,17,0,84,0,left-wing dutch vegan moved switzerland denied swiss passport annoying
0,2,3,40,0,8,0,43,0,nevada veteran finally awarded medal honor
0,1,7,34,0,7,0,41,0,wall street close lower global forecast dims
0,1,6,36,1,5,0,42,0,"fearing wildfires, utility plan power shutdown"
0,1,4,22,0,4,0,26,0,eu launch channel youtube
0,3,3,31,1,7,0,34,0,anzac day: modern face military
0,3,10,48,0,10,0,58,0,emma watson amanda seyfried take legal action leaked photo
0,1,3,37,0,7,0,40,0,lift accident hong kong skyscraper kill six
0,3,1,55,0,12,0,56,0,company make food packaging bamboo cut trash
0,2,5,47,4,9,0,52,0,sen. mccain call michael flynns request immunity 'unusual'
0,1,3,45,0,6,0,48,0,john mccain denies romantic relationship lobbyist
0,1,5,45,0,7,4,50,0,spain defeat serbia 2009 european basketball championship
0,3,2,65,1,11,0,67,0,beloved grocery chain latest company face trump-related boycott
0,2,5,58,2,11,0,63,0,"clear african migrants, lega nord governor order stand-off rome"
0,3,12,45,0,9,0,57,0,vince young eyeing nfl comeback hiring agent leigh steinberg
0,3,7,71,4,12,0,78,0,park geun-hye: choi soon-sil's daughter arrested denmark amid south korea political scandal
0,2,13,62,5,12,2,75,0,refugee child sexually assault 10-year-old girl liberal parent house breitbart
0,1,5,65,1,9,0,70,0,"wikinews interview christopher beyette, prince principality vikesland"
0,2,12,69,2,16,1,81,0,crowd scientist say womens march washington 3 time many people trump inauguration
0,2,4,14,1,4,0,18,0,"live, north korea"
0,2,5,17,0,5,0,22,0,donald trump big dick
0,3,7,40,1,7,0,47,0,trump loyalist see course correction amid tumult
0,2,12,53,1,12,1,65,0,oxfam: combined wealth 5 richest nigerian could lift country poverty
0,1,4,34,0,9,0,38,0,bulk iraqi debt paris club forgiven
0,2,9,38,2,8,0,47,0,u.s. annual budget deficit smallest nearly seven year
0,3,3,36,1,6,0,39,0,here's actually happened bowling green
0,2,11,56,3,9,0,67,0,arkansas carry double-execution despite claim first death 'inhumane'
0,3,3,32,4,8,0,35,0,"india v australia: fourth test, day one live!"
0,3,12,46,0,11,0,58,0,ariel winter pose untouched shot name body positivity
0,2,5,58,3,16,0,63,0,"friday, congress could make lot harder rich people move u.s."
0,1,6,31,0,7,0,37,0,unify phone number else follows
0,1,5,26,0,4,0,31,0,police release mexican beauty queen
0,2,2,34,3,8,3,36,0,president trump's first 100 day 'by numbers'
0,3,2,39,0,9,0,41,0,perfect sport vine comedy three act
0,1,1,34,1,5,2,35,0,spain launch 11 billion stimulus package
0,3,3,33,1,7,0,36,0,pentagon: china return seized navy drone
0,1,4,47,1,9,0,51,0,"canadian ceo accused fraud, suspected fled country"
0,1,8,49,2,10,0,57,0,"corporations, tending tattered image, clip wing private jet"
0,1,8,25,1,6,0,33,0,"arab tv network, obama urge dialogue"
0,1,5,31,1,8,2,36,0,gannett report 60% fall quarterly profit
0,3,2,66,2,9,0,68,0,penalty rates: long-awaited decision likely reignite fierce political debate
0,2,11,64,2,11,0,75,0,father john misty release unnerving music video 'two wildly different perspectives'
0,2,12,73,7,16,0,85,0,"david brock: democrat bad situation, hillary loss exposed lack democratic power breitbart"
0,3,12,44,2,11,0,56,0,trey songz say new album 'tremaine' drop sometime next year
0,1,6,34,0,8,1,40,0,behind profit lie trouble 2 bank giant
0,3,15,60,1,15,1,75,0,"samsung planning sell refurbished galaxy note 7 phones, swears safe time"
0,1,8,37,1,8,0,45,0,"top pick, islander choose goal scorer tavares"
0,3,1,72,0,10,0,73,0,anesthesiologist explains biggest misconception going knife
0,2,7,64,2,10,0,71,0,south korea: president park geun-hye leaf blue house following corruption scandal
0,1,9,36,0,8,0,45,0,big insurer say quit florida property market
0,1,5,34,0,6,0,39,0,kirchner resigns party leader argentina
0,1,10,51,1,14,0,61,0,"thanks contest, putt lunch could lead united state open"
0,2,4,16,1,4,6,20,0,complete 2017-18 cbb title odds
0,3,13,36,1,10,0,49,0,"chris evans wreck kkk leader go exes,"
0,2,8,62,3,17,0,70,0,trump superfan eric bolling get new show fox news. thats win white house.
0,1,5,23,0,6,0,28,0,plan kill lion protect deer
0,3,2,33,1,5,0,35,0,"juneau, alaska avalanche caught camera"
0,3,2,49,0,9,0,51,0,california judge block trump order sanctuary city money
0,2,12,42,3,12,0,54,0,'cash ousside' girl get paid kodak black video
0,2,5,70,1,17,0,75,0,donald trump said u president harder thought could told
0,2,1,41,1,6,0,42,0,knicks explore trade another first-roundpick
0,3,8,46,0,10,4,54,0,college football team guaranteed improve win total 2017
0,3,10,58,0,9,0,68,0,florida governor replaces markeith loyd prosecutor death penalty protest
0,1,6,34,1,7,0,40,0,thinking going blond? consult kiosk first
0,2,10,55,2,10,0,65,0,kobe bryant defends russell westbrook's answer hunting assist vs. sun
0,3,6,34,4,6,0,40,0,yahoo diaries: womens march washington [video]
0,2,4,43,3,9,0,47,0,"sanders, clinton (and guest) speak la vega church"
0,3,13,61,1,12,0,74,0,iceland may become world's first democracy pirate running government
0,3,2,46,0,8,0,48,0,wake forest find radio announcer leaked game plan
0,3,9,45,1,11,0,54,0,"putin led complex cyberattack scheme aid trump, report find"
0,2,5,60,3,13,0,65,0,mlb try keep young dominican dying behind wheel. working.
0,1,4,25,1,6,0,29,0,"taxing, ritual save specie"
0,1,9,50,1,10,0,59,0,"davos forum, russia china blame capitalist economic crisis"
0,3,21,26,1,6,0,47,0,diesis video ist nicht verfgbar. venezuela undercover
0,3,6,22,0,5,0,28,0,brexit official start date
0,3,6,54,3,12,0,60,0,"sport quiz week: haye v bellew, liverpool's loss luis enrique"
0,3,1,31,0,7,2,32,0,average college degree pay age 34
0,1,6,32,1,5,1,38,0,2 somali-americans charged aiding terror
0,3,5,82,3,16,0,87,0,liberal german boycotted american burger joint trump won. right came rescue.
0,1,2,33,1,5,0,35,0,no-fly zone demanded syrian protester
0,3,13,41,4,12,0,54,0,"j. cole talking kanye west new track ""false prophets""?"
0,3,4,53,3,13,4,57,0,international women's day 2017: big gender pay gap live?
0,1,4,52,0,9,0,56,0,djibouti say war eritrea inevitable unless un intervenes
0,3,4,70,2,12,0,74,0,here's wall street saying netflix's blowout subscriber growth last quarter
0,1,7,30,0,8,0,37,0,state pinch may raise gasoline tax
0,2,8,43,1,8,0,51,0,islamic state claim new year's attack istanbul nightclub
0,2,1,54,1,14,0,55,0,human animal body part one know
0,3,4,68,1,14,0,72,0,federal court refused block fcc net neutrality rule taking effect
0,1,2,57,1,12,0,59,0,adam air hit severe financial problems; may shut three week
0,2,12,52,2,12,2,64,0,kansa city chief chief wr tyreek hill rush 68-yard touchdown vs. titan
0,3,11,22,2,9,0,33,0,"yg lil wayne keep ""trill"" new song"
0,3,6,78,3,13,0,84,0,"wikileaks release mysterious 'year zero' trove document within hours, julian assange promise"
0,1,5,38,0,7,0,43,0,vatican call apology bishop insufficient
0,3,1,32,4,6,0,33,0,enormous cost sleep deprivation
0,3,5,57,0,11,0,62,0,royal easter show competition heat annual rat mouse exhibition
0,1,4,51,1,10,0,55,0,ex-head qantas freight operation u jailed price fixing
0,3,11,44,1,13,0,55,0,gun sale might slump trump could fire industry
0,3,15,65,1,14,0,80,0,"govt begin crackdown hospital overcharging stent replacement, put price cap bill"
0,3,3,19,0,4,0,22,0,politics cowardice
0,2,9,43,1,8,0,52,0,"following earnings miss, costco plan hike membership fee"
0,1,6,43,0,8,0,49,0,u president bush meet canadian mexican leader
0,1,3,53,3,8,0,56,0,new u.s. immigration bill proposes time-limit employer scrutiny
0,1,2,34,2,7,2,36,0,hawaii spend $4.9m coqui frog eradication
0,1,8,37,1,10,0,45,0,"pay health care, obama look tax affluent"
0,1,7,37,0,8,0,44,0,intel facing large fine european antitrust case
0,3,3,18,0,6,2,21,0,actor bill paxton dead 61
0,1,5,31,0,6,1,36,0,3 red cross worker abducted philippine
0,1,7,34,0,6,0,41,0,navy secretary nominee drew notice divorce
0,1,10,48,3,9,0,58,0,"financing declines, future clean-tech start-ups uncertain"
0,1,7,28,2,8,1,35,0,kyrgyzstan give u.s. 6 month leave base
0,3,11,54,0,10,0,65,0,police search inmate reportedly escaped hole behind toilet
0,3,9,51,1,9,0,60,0,airbnb host reportedly cancel woman reservation race
0,3,5,59,5,15,0,64,0,"buzz aldrin nearly died south pole. insists worth it, really."
0,2,1,40,1,4,0,41,0,beyonc's pregnancy announcement break record
0,3,10,47,3,13,0,57,0,"syrians, looking solace, gather play risk, board game war"
0,3,12,36,3,11,0,48,0,market say 'tell u know' trump tax proposal
0,3,12,51,3,11,0,63,0,lebron james tweeted lyric drake's 'more life' month debuted
0,1,2,35,0,5,0,37,0,plane crash toronto office building
0,1,3,58,0,8,0,61,0,australian government accused hypocrisy world court statement
0,3,10,42,5,11,3,52,0,apple slash iphone 7 (plus) production 10% due sluggish sale
0,3,3,42,3,9,0,45,0,"lorde back euphoric breakup song, 'green light'"
0,2,3,46,0,8,0,49,0,trump pitch school voucher orlando catholic school
0,3,1,37,1,6,0,38,0,obamas science diaspora prepares fight
0,2,9,68,3,14,0,77,0,knife double toaster: searing hot kitchen 'lightsaber' instantly char bread
0,1,6,22,2,5,0,28,0,painful departure g.m. brand
0,3,9,44,2,7,0,53,0,nobody know fortysomethings driving u.s. productivity
0,1,4,42,0,6,0,46,0,uk denies pressuring scotland lockerbie release
0,3,11,46,0,10,0,57,0,stone temple pilot remember scott weiland one year death
0,3,1,29,3,5,0,30,0,parkinson's disease 'may start gut'
0,2,3,57,0,11,0,60,0,volleyball game appear take place north korean nuclear test site
0,2,5,25,0,7,0,30,0,everyone want shop amazon
0,3,10,61,6,12,0,71,0,'people died free speech!': pirro blast 'disingenuous' decision berkeley insider
0,1,6,34,0,7,0,40,0,mexican tradition run pageantry faith
0,3,11,55,0,13,0,66,0,michael vick rock old atlanta falcon jersey return georgia dome
0,1,6,29,0,6,0,35,0,mets show reason optimism
0,3,12,50,0,11,0,62,0,dave chappelle want comedian stop making donald trump joke
0,1,2,63,0,9,0,65,0,tourist evacuated following shootout mexican army drug hitman
0,3,9,38,2,10,6,47,0,hong kong's 50 richest 2017: gambling tycoon see luck turn
0,2,3,46,0,9,0,49,0,disabled army veteran fight intruder georgia home
0,2,9,48,0,9,0,57,0,rob gronkowski surprise sean spicer white house press briefing
0,2,3,57,1,9,0,60,0,theresa may assumption absolute power brexit spell disaster
0,3,1,46,0,8,0,47,0,museum remove every piece art created immigrant
0,1,6,21,2,7,4,27,0,toyota move ahead g.m. 2008 sale
0,1,8,27,1,8,1,35,0,"canada, 2 oil giant said near merger deal"
0,2,10,41,4,9,2,51,0,"40-year detour, squidbillies star take home diploma"
0,2,6,29,0,5,0,35,0,joe biden regret becoming president
0,1,4,36,0,6,0,40,0,new york time reporter rescued afghanistan
0,3,5,76,0,15,0,81,0,son boxer muhammad ali reportedly detained florida airport asked whether muslim
0,3,14,38,0,11,0,52,0,iowa pol pushing bill get gop prof college campus
0,2,5,52,0,8,0,57,0,bill clinton praise clinton global initiative sendoff address
0,3,8,33,0,8,0,41,0,compulsion help u manage age anxiety
0,2,9,58,3,12,0,67,0,dramatic moment plane land motorway suffering 'engine fault' mid-air
0,1,4,56,3,12,0,60,0,"custody saddam hussein given iraq, executed 'today tomorrow'"
0,2,2,51,0,9,0,53,0,latest terror attack expose real barrier mideastpeace
0,1,4,31,0,4,0,35,0,federer focus reclaiming wimbledon
0,3,1,56,2,10,1,57,0,2 'significant' arrest made investigation london attack
0,1,6,36,0,6,0,42,0,british minister suspended expense inquiry
0,1,7,36,1,5,0,43,0,myanmar press case pro-democracy leader
0,2,11,57,0,11,0,68,0,former falcon player roddy white blast atlanta coach blowing super bowl
0,2,11,55,2,14,2,66,0,$20 billion tax credit fails increase college attendance new york time
0,2,4,36,2,9,5,40,0,"rajon rondo fined $25,000 trying trip jae crowder"
0,3,3,49,2,8,0,52,0,trump try undo obama's national monument designations?
0,3,1,57,1,10,0,58,0,trump adviser son loses transition team job spreading fake news
0,1,2,49,0,7,0,51,0,former governor illinois indicted corruption charge
0,3,3,81,1,18,0,84,0,british people marching donald trump need get sense perspective problem
0,3,4,53,1,9,0,57,0,timeline jeff sessions' connection russian ambassador
0,3,9,49,3,10,0,58,0,penny warns north korea donald trump resolve nuclear standoff
0,2,1,38,2,5,0,39,0,extremist image 'fingerprinted' tech firm
0,3,3,43,0,8,0,46,0,huge robbery spark gun battle paraguay brazil
0,1,7,28,0,8,0,35,0,share begin move lower day nears end
0,3,6,26,1,5,0,32,0,watch live: white house press briefing
0,1,5,37,0,6,0,42,0,terrorism alleged policeman killing athens
0,2,1,49,2,9,0,50,0,facebook working major ad group fix metricsscrewup
0,3,3,83,3,14,0,86,0,bernie sander burst laughter trump claim nobody knew healthcare could complicated
0,2,8,31,1,8,0,39,0,cnn yank kathy griffin new year eveshow
0,1,2,51,0,8,0,53,0,thousand gather london protest government cut
0,3,8,47,1,11,0,55,0,sturgill simpson: guide surprise album year nominee
0,3,11,43,0,9,0,54,0,mma conor mcgregor issued boxing license state california
0,3,2,56,0,10,0,58,0,tasmanian man charged male fox carcass brought victoria
0,2,11,51,4,12,0,62,0,donald trump launch trade fairness: ive looking year
0,3,8,45,0,9,0,53,0,appeal court block trump bid reinstate immigration order
0,3,3,31,1,6,0,34,0,san jose flooding: dozen rescued boat
0,2,5,45,2,9,0,50,0,"tony romo retiring nfl, going broadcasting: report"
0,2,6,38,0,6,0,44,0,caitlyn jenner attend donald trump inauguration
0,1,2,39,0,7,0,41,0,manhunt gay bar attacker massachusetts
0,1,2,32,4,6,2,34,0,"hong kong's recession ends, economy grows 3.3%"
0,3,5,73,4,15,0,78,0,mexico caught cartel bos reportedly almost took 'el chapo' guzmn's mother son
0,3,4,61,1,11,0,65,0,cut out: canada bar diplomat using cardboard justin trudeau figure
0,3,6,40,1,6,0,46,0,twitter apologizes mistake around @potus account
0,2,11,46,0,10,0,57,0,trump shut journalist repressive president praisedhim
0,1,8,40,2,9,4,48,0,rodriguez identified 2003; others?
0,3,1,49,0,8,0,50,0,canadian supermarket give leftover stock food bank
0,2,5,64,0,13,0,69,0,many woman leaving hospital childbirth ptsd bad care
0,1,8,27,3,8,0,35,0,"swipe u.s., iraq build tie french"
0,2,3,72,3,16,0,75,0,"praying inaugural service: imam, rabbi, hindu priest abundance pastor"
0,3,13,67,1,16,0,80,0,future warfare? unmanned helicopter invisible radar unveiled inabu dhabi
0,2,8,31,1,7,0,39,0,"secret mariana trench, caught camera"
0,1,10,54,1,13,0,64,0,"ginsburg share view influence foreign law court, vice versa"
0,1,6,39,0,7,0,45,0,israeli president shimon peres collapse tel aviv
0,2,4,82,4,20,1,86,0,"nico rosberg announces shock f1 retirement day world title win: 'i peak, feel right'"
0,2,3,24,2,5,2,27,0,10 best twilight zoneepisodes
0,1,2,35,1,7,4,37,0,"baghdad morgue received 1,000 body july"
0,2,12,31,0,9,0,43,0,irs warns payroll scam tax season begin
0,1,6,36,3,8,0,42,0,"uk nears u cyber-crime, ahead nigeria, romania"
0,2,3,66,4,12,4,69,0,oscar 2017: celebrity react 'moonlight' actually winning best picture mix-up
0,1,2,59,1,7,0,61,0,china's premier recognises government responsibility milk incident
0,2,1,61,0,14,0,62,0,housing market grind halt number home market hit record low
0,3,3,45,1,7,0,48,0,ukraine ban russia's entrant eurovision song contest
0,1,6,24,2,7,2,30,0,u.s. soldier 11 iraqi die attack
0,3,9,47,2,11,0,56,0,"brave marathoner brain cancer, known running tutu, dy"
0,3,7,36,5,8,0,43,0,packers. patriots. steelers. falcons. edge?
0,3,6,80,3,16,0,86,0,mcdonald's call donald trump 'disgusting excuse president tiny hands' asks obama return
0,3,1,58,0,12,0,59,0,blind man put camera guide dog expose daily abuse commuter
0,1,1,34,0,6,0,35,0,afghan riot civilian die crash
0,1,3,38,1,8,3,41,0,officials: almost 100 killed air raid pakistan
0,1,5,31,0,7,0,36,0,israeli pm olmert step september
0,3,2,60,2,11,0,62,0,dem rep want senator statue removed capitol 'xenophobia' claim
0,2,4,58,0,15,0,62,0,trump erasing red line syria drawing hard line north korea
0,1,6,35,0,8,0,41,0,israeli vote brings push release soldier
0,3,1,46,0,7,0,47,0,parent still lose sleep worrying grown child
0,3,2,61,0,11,0,63,0,google map finally tell business wheelchair accessible
0,3,3,36,1,9,4,39,0,european games: need know baku 2015
0,2,11,52,2,12,0,63,0,j.r. smith wife give heartbreaking update newborn daughter
0,1,5,28,0,4,0,33,0,clean coal technology gaining favor
0,3,5,43,3,9,2,48,0,"oral history: randy savage vs. ricky steamboat, 30 year later"
0,1,5,60,0,10,0,65,0,murder charge dropped u marine admitted killing iraqi detainee
0,2,6,36,1,7,0,42,0,praise agatha christie accidental sleuth
0,1,7,30,2,7,1,37,0,"5 months, china try would-be protester"
0,1,2,48,0,9,1,50,0,renault f1 given suspended ban bos barred cheating
0,2,2,32,0,7,0,34,0,meaning tolerance trump era
0,3,3,58,0,9,0,61,0,manus island refugee charged fake passport fiji deportation
0,1,1,22,0,5,0,23,0,boston ring new year
0,2,13,36,1,11,0,49,0,trump former rival wynn take new gop money man
0,2,10,47,3,9,0,57,0,mike pence's new neighborhood get plastered 'trust women' sign
0,1,2,35,1,7,5,37,0,"number cholera case zimbabwe reach 80,000"
0,2,7,44,1,9,1,51,0,samsung's galaxy s8 arrives critical time smartphones
0,1,6,32,0,7,4,38,0,highlight 2008 taipei county jin shi marathon
0,2,14,58,5,14,0,72,0,"mike rowe flag-burning students: hate america, accept federal aid! insider"
0,3,12,59,1,11,0,71,0,death trumpcare ultimate proof obamacare's historic accomplishment
0,1,3,43,2,9,0,46,0,u.s. military covertly pay run story iraqi press
0,3,6,32,2,7,0,38,0,justin timberlake perform u.s. grand prix
0,3,12,61,0,14,0,73,0,concert hall kansa city hamburg call japanese engineer shape sound
0,2,2,53,3,9,0,55,0,"kushner center trump transition infighting, source say"
0,1,4,31,1,6,0,35,0,"fire kill six baltimore, united state"
0,3,6,34,1,8,1,40,0,5 injured high-wire accident florida circus
0,1,8,33,2,7,0,41,0,u.s. commander afghanistan given leeway
0,2,10,51,4,11,0,61,0,kim jong-nam murder: north korea blame malaysia death 'dprk citizen'
0,1,1,45,1,6,0,46,0,"calpine declares bankruptcy, cite natural gas price"
0,1,3,37,0,8,0,40,0,u may known sgrena rescue operation
0,3,4,44,0,10,0,48,0,sasha obama slays rap along chance rapper
0,3,7,48,1,9,0,55,0,meryl streep's golden globe speech spark outrage among mma fan
0,3,9,59,0,12,1,68,0,3 officer involved shooting tamir rice facing disciplinary charge
0,1,8,41,0,9,0,49,0,feud cnbc daily show continues escalate
0,1,5,26,0,5,0,31,0,fiscal crisis stall agenda obama
0,1,7,19,3,5,2,26,0,"csx results, 20%, beat forecast"
0,1,5,33,0,7,0,38,0,naoto kan elected new prime minister japan
0,1,3,48,0,9,0,51,0,black box found near crash site ethiopian airline flight
0,2,10,48,1,9,0,58,0,"video show cop slam, beat black pedestrian alleged jaywalking"
0,2,9,38,4,10,0,47,0,belly future link trippy 'frozen water' video: watch
0,1,8,50,0,9,0,58,0,official set timetable getting particle collider back track
0,2,15,54,2,12,0,69,0,bbc news used wrong subtitle donald trump inauguration itsglorious
0,3,4,67,1,11,0,71,0,sources: trump labor pick andrew puzder voiced second thought nomination
0,3,10,53,0,11,0,63,0,standing rock sioux ask court halt dakota access pipeline construction
0,1,1,19,0,4,2,20,0,nepal plane crash kill 19
0,1,2,51,1,10,0,53,0,ryan dunn twice drink-drive limit time fatal accident
0,1,2,59,1,10,0,61,0,result antiquorum's auction vintage modern timepiece
0,2,9,41,1,9,0,50,0,"cigna face anthem, escalating fight ending deal"
0,2,8,35,2,8,0,43,0,dont supreme court justice ethic code?
0,2,12,52,1,11,0,64,0,reince priebus sought fbi help refuting news report russian contact
0,1,1,35,0,4,0,36,0,chicago approves new handgun regulation
0,1,2,28,0,6,3,30,0,xbox 360 console sale surge america
0,2,13,60,4,15,0,73,0,build wall: game finally released io removing pepe frog breitbart
0,3,5,47,2,11,0,52,0,kompromat danger doubt confusion democracy
0,2,11,43,6,10,0,54,0,"nobody son: memoir childhood, immigration mother love"
0,3,11,58,2,12,0,69,0,india request information facebook user rise india real time
0,2,9,32,0,8,0,41,0,john wick action hero unhappy workaholic
0,3,1,70,5,16,0,71,0,columnist wrote trying breast-feed stranger baby see felt like
0,3,2,43,3,8,0,45,0,david pogue's search world's best air-travel app
0,1,13,52,1,8,0,65,0,canadavotes: ndp incumbent david christopherson running hamilton centre
0,1,4,41,2,6,1,45,0,"nokia issue bl-5c battery warning, offer replacement"
0,1,4,30,0,5,0,34,0,work halted helicopter president
0,3,8,45,2,9,0,53,0,wikipedia founder jimmy wale launch project fix news
0,1,4,42,1,5,0,46,0,"ukrainian president yushchenko dismisses pm, cabinet"
0,1,2,35,0,4,0,37,0,several large earthquake shake indonesia
0,2,1,77,2,14,4,78,0,"roman palace's stunning ceiling destroyed 2,000 year ago finally restored fleck paint"
0,3,8,66,0,11,0,74,0,returning wwii veteran captured extraordinary photographic record postwar nyc
0,2,8,35,2,7,0,43,0,common high-school tool thats banned college
0,1,3,30,0,5,0,33,0,rocket fired israel lebanon
0,2,5,37,3,8,3,42,0,wall st. resume selloff; s&p 500 lowest since september
0,1,4,26,1,5,0,30,0,keeping score obama vs. netanyahu
0,3,2,44,0,7,0,46,0,chile wildfire destroy score home valparaiso
0,2,9,45,1,11,0,54,0,ivanka trump powerful first daughter history?
0,3,7,40,1,7,1,47,0,sheryl sandberg donated $1 million planned parenthood
0,3,6,80,3,16,0,86,0,"facebook, whatsapp skype hit strict eu privacy rule could threaten 'entire internet'"
0,2,7,43,0,9,4,50,0,glastonbury festival could moved another location 2019
0,2,9,25,2,9,2,34,0,"dusty rhodes, wwe hall famer, dy age 69"
0,1,7,40,0,8,0,47,0,william morris endeavor become one talent agency
0,3,2,77,2,20,0,79,0,world best husband: man seen carrying pile shopping bag high see foot
0,1,7,69,2,10,0,76,0,"new south wales, queensland electorate redrawn: australian electoral commission"
0,2,10,55,2,12,0,65,0,"kanye west kim kardashian attend funeral cousin infant, avery"
0,2,14,53,5,10,0,67,0,rnc fbi re-opening clinton investigation: disqualifying breitbart
0,1,4,33,1,7,2,37,0,tour de france: michael rasmussen win stage 16
0,1,8,38,1,7,0,46,0,"chesapeake energy, shareholder act like owner"
0,1,1,32,1,3,0,33,0,flickr launch video-sharing service
0,1,1,41,1,5,0,42,0,marcinkiewicz's cabinet given vote confidence
0,1,1,30,0,4,0,31,0,schrder loses motion confidence
0,1,2,37,0,5,0,39,0,australia commits troop afghanistan
0,2,5,37,9,4,0,42,0,{{ videoentry.nbcsports$titleseo || videoentry.title }}
0,3,10,19,3,7,0,29,0,'dunk league' nba fan's wet dream
0,1,1,42,0,6,0,43,0,french worker use threat compensation demand
0,2,5,31,2,9,3,36,0,buy piece old hollywood midtown for$2.39m
0,3,4,46,0,9,0,50,0,arkansas supreme court halt two execution set monday
0,3,4,49,0,9,0,53,0,betsy devos clear another hurdle early morning senate vote
0,3,5,47,3,11,0,52,0,ruble dive trump tweet 'was obama soft russia?'
0,1,2,29,0,4,0,31,0,missing european diver found alive
0,2,1,35,1,5,0,36,0,portland dark history white supremacy
0,1,1,31,0,4,0,32,0,philippine prepares new typhoon
0,2,5,80,2,18,4,85,0,liverpool reject 30 million bid manchester city raheem sterling slap 50m price tag head
0,2,10,48,2,11,0,58,0,rick ross strike plea deal felony kidnapping assault case: report
0,2,10,51,3,11,0,61,0,video: tsunami hit near damaged nuclear plant japan coast breitbart
0,3,8,55,0,9,0,63,0,george michael prolific philanthropist publicly privately
0,1,3,46,1,9,0,49,0,"two student shot los angeles school, suspect custody"
0,3,13,61,2,11,0,74,0,mitsubishi heavy industriesvoice: emergency mobile power: lifeline time crisis
0,1,2,38,0,6,0,40,0,california senate vote allow gay marriage
0,1,4,49,1,7,0,53,0,doubt yesterday's italian lotto superenalotto drawing
0,3,1,56,0,9,0,57,0,russian investigator confirm subway bombing suicide attack
0,2,12,45,1,13,0,57,0,message trump? lebron sport safety pin si cover photo insider
0,3,6,28,1,6,3,34,0,mom blame 911 response daughter's death
0,1,7,44,1,6,0,51,0,olympic committee work resolve revenue-sharing dispute
0,3,5,42,1,7,0,47,0,super bowl li coverage: patriot complete epic comeback
0,3,4,31,0,5,2,35,0,13 habit exceptionally likeable people
0,1,3,54,2,10,2,57,0,glazer cap manchester united's player transfer spending 25m year
0,2,8,21,6,7,0,29,0,'the x-files' return fox ...
0,2,12,60,2,16,2,72,0,"30 years, world's best ceo robot claim billionaire alibaba founder jack"
0,3,1,46,0,8,0,47,0,army formally end study disputed pipeline crossing
0,1,5,30,1,6,4,35,0,tennis: andy murray win montreal master 2009
0,3,9,38,3,9,0,47,0,trade deficit u.s. narrow february four-month low
0,2,12,55,0,12,0,67,0,trevor noah sends tomi lahren cupcake grilling people pissed
0,3,5,53,0,12,0,58,0,party line drawn mp debate stupid donald trump really
0,2,2,65,2,11,0,67,0,astonishing amazon 'anumeric' people whose language word number
0,3,12,41,3,9,1,53,0,"ex-nfl player todd heap accidentally kill daughter, 3, truck"
0,3,1,35,0,7,0,36,0,share photo theme diversity
0,3,3,63,2,10,0,66,0,news cabin crew cash-strapped alitalia strike amid toilet-tidying duty
0,2,6,73,2,15,0,79,0,watch trump surrogate get shut calling trump 'martin luther king healthcare'
0,3,2,47,1,6,0,49,0,south korea opposition seek interim leader's impeachment
0,1,4,48,2,8,0,52,0,u.s. house republican continue speaking light turn
0,1,3,37,0,9,2,40,0,american singer actor al martino dy age 82
0,2,8,28,3,7,0,36,0,"sunset song, tomorrow another day"
0,1,8,37,0,8,0,45,0,civil lawsuit collapse utah mine settled
0,1,2,41,0,8,0,43,0,least eight dead drone strike pakistan
0,3,3,48,0,11,0,51,0,seth meyers call trump silence mosque attack
0,2,9,72,1,13,0,81,0,"gop preparing plan gut consumer finance protection bureau, roll back wall street regulation"
0,2,3,60,6,10,0,63,0,sessions: meeting russian envoy 'hyped beyond reason'; criticism 'unfair'
0,3,0,39,1,8,4,39,0,"6,755 postal worker attacked dog last year"
0,2,9,51,1,11,0,60,0,shooting reported white house obama golfing breitbart
0,2,12,40,4,10,0,52,0,"new special, louis c.k. say we're heading hellish dystopia"
0,1,5,36,0,6,0,41,0,asean basketball league move closer reality
0,1,8,30,0,8,0,38,0,another top law firm pay hire delay start
0,1,1,55,0,9,3,56,0,vietnamese police blamed death 100 political protester
0,3,17,67,2,17,3,84,0,"every slap jawan, kill 100 jihadis, gautam gambhir lash attack soldier kashmir"
0,1,6,58,0,9,0,64,0,barack obama accepts u presidential nomination democratic party
0,3,4,41,2,7,0,45,0,dead-eyed theresa may put tories' interest first
0,2,2,52,0,10,0,54,0,washington monument remain closed least two year
0,1,6,30,2,8,2,36,0,japanese bank raise stock sale $9.4 billion
0,1,3,40,0,6,0,43,0,chinese rioter storm japanese embassy beijing
0,2,16,36,0,11,0,52,0,bank happens give fan phone number
0,2,11,25,1,8,0,36,0,receipt tax irs? problem
0,3,15,50,3,14,0,65,0,jerry brown throw gauntlet trump: 'we live truth'
0,2,2,37,1,6,0,39,0,southern rail e-cigarette ban introduced
0,2,8,31,1,8,0,39,0,king us n-word church donald trump
0,1,5,23,0,5,0,28,0,big order lift outlook airbus
0,2,6,40,5,10,0,46,0,north korea: kim jong un 'the world's dangerous man'?
0,3,11,49,4,10,0,60,0,everyone's laughing fox news tweet trump's 'weekend working'
0,3,17,61,1,15,0,78,0,"donald trump condemns killing indian engineer kansa shooting, threat jew u"
0,3,15,62,4,13,0,77,0,"zuckerberg talk global community, cite pm modis example latest facebook post"
0,1,1,50,0,8,0,51,0,man arrested crashing motorized bar stool drunk
0,2,6,70,5,13,0,76,0,trump's america donald trump thanks malcolm turnbull 'telling truth' 'fake news'
0,3,13,52,1,11,0,65,0,let thrill harley-davidson big five accelerate love adventure
0,2,3,55,1,10,0,58,0,"pope urge mediation end north korea crisis, avert devastating war"
0,1,2,23,1,4,0,25,0,apple inc. doubled profit
0,1,2,36,0,5,0,38,0,bloomberg clinton create green alliance
0,1,1,38,1,5,0,39,0,"ugandan government, rebel agree ceasefire"
0,2,2,33,1,6,0,35,0,pope open free laundromat rome's poor
0,2,9,50,1,8,0,59,0,brutal murder india kerala state spotlight underlying malady
0,1,10,22,1,5,0,32,0,bp nominates russian oversee tnk-bp
0,1,5,38,0,6,0,43,0,guantanamo detainee david hick seek uk passport
0,3,1,66,0,11,0,67,0,physical restraint mental health unit traumatising woman
0,1,7,28,0,7,3,35,0,europe said delay decision airbus a400m
0,2,2,31,3,7,2,33,0,uk inflation stay three-year high 2.3%
0,2,9,34,4,7,0,43,0,ny times: trump deportation effort unusual
0,2,3,47,1,9,0,50,0,j.crew cut deal nordstrom sell signatureitems
0,1,4,46,0,7,0,50,0,rescuer hunt brazilian plane carrying four uk passenger
0,1,1,25,1,5,4,26,0,"estonian oil spill kill 5,000 bird"
0,3,11,37,4,12,2,48,0,17 time jack karen grace friendship goalsaf
0,2,12,46,7,12,0,58,0,stephen curry: 'it's comical people [are] saying i'm year'
0,2,2,59,1,11,0,61,0,elisabeth moss: actress whose presence guarantee quality
0,2,10,36,1,8,0,46,0,new poll show half divorcs pre-wedding jitter
0,3,9,40,0,11,0,49,0,jimmy kimmel would pay watch trump cruz eat together
0,1,3,51,1,7,0,54,0,"four injured three earthquake strike sumatra, indonesia"
0,2,5,34,4,9,2,39,0,england 2-1 mexico: women's world cup happened
0,2,5,57,1,10,0,62,0,business insider hosting instagram photo contest business insider
0,2,4,77,2,14,0,81,0,marc bartra 'several weeks' surgery injury borussia dortmund bus explosion
0,1,2,28,0,5,0,30,0,ten dead earthquake bhutan
0,3,1,35,2,4,0,36,0,pakistan pressed 'abducted activist
0,1,1,40,0,5,0,41,0,first supernova seen explosion breakout
0,1,5,24,0,6,0,29,0,lack cash sink memorial abba
0,3,1,34,0,4,0,35,0,chile battle devastating fire
0,1,6,64,2,12,6,70,0,australian rule football: 2010 gippsland football league round 11 wonthaggi v traralgon
0,1,4,26,0,4,0,30,0,republican firing blank obama
0,2,1,85,1,15,0,86,0,private school housemaster cleared abusing boy victim's father writes court defend
0,2,6,18,1,4,0,24,0,popular pro-life law
0,1,3,36,0,6,3,39,0,american philanthropist brooke astor dy 105
0,3,11,45,0,10,0,56,0,former iranian president say donald trump really charge
0,1,6,38,0,8,0,44,0,gunman kill self hostage texas nasa building
0,1,6,28,0,6,0,34,0,rocky mountain news closing denver
0,3,3,57,0,10,0,60,0,bob bradley expects crisis talk swansea fan demand sacking
0,3,13,48,1,11,0,61,0,milo yiannopouloss pedophilia comment cost cpac role book deal
0,3,2,41,0,5,0,43,0,burundi environment minister niyonkuru shot dead
0,1,9,39,1,9,0,48,0,"track tigers, software know stripe"
0,3,5,38,3,9,0,43,0,"want amazon echo christmas? sorry, sold"
0,3,3,47,1,9,0,50,0,france election: new far right leader quits holocaust row
0,1,7,30,0,7,0,37,0,getting cut way wall street
0,3,6,58,3,10,4,64,0,australian open 2017: roger federer adopts nothing-to-lose mindset v rafael nadal
0,1,6,49,1,9,0,55,0,australia's new south wale fire brigade crisis bullying
0,2,15,53,0,14,0,68,0,congress say able kill bear wolf airplane inalaska
0,1,3,22,0,4,0,25,0,delhi earns un carbon credit
0,3,13,48,1,13,2,61,0,indiana coach tom crean go nut player try alley-oop buzzer 19
0,2,8,65,4,14,0,73,0,hollywood ridicule donald trump's obamacare repeal fail: 'so much art deal'
0,1,7,43,0,10,0,50,0,perseverance paying test relativity space
0,1,8,47,0,10,0,55,0,south korean mourn former president rebuke current one
0,1,4,27,0,4,0,31,0,microsoft yahoo executive meet
0,3,12,45,2,12,0,57,0,alec baldwin go donald trump spelling gaffe 'snl' teaser
0,3,2,47,3,9,0,49,0,divorcing late life? dont let destroy retirement.
0,3,10,32,0,10,0,42,0,meet woman left wall street open bakery
0,1,1,37,1,6,5,38,0,"13,000 people participate bristol running event"
0,2,2,41,2,11,2,43,0,'butcher kabul' show face 20 year exile
0,2,20,64,2,17,0,84,0,"since suresh kalmadi abhay chautala out, sport ministry set restore ioa's power"
0,1,2,35,2,6,2,37,0,4.5-kilometre bridge link crimea russia
0,2,8,18,3,3,0,26,0,nba playoffs: cavs-warriors iii?
0,3,5,38,0,7,0,43,0,uber ceo quits trump advisory board amid criticism
0,3,1,23,3,4,0,24,0,"sorry, page doesnt exist!"
0,2,1,48,0,10,0,49,0,everyday trauma childbirth made stop one child
0,2,3,37,0,8,0,40,0,jessie j duet amazing shy girl colorado
0,3,3,44,1,9,1,47,0,record 3 million tweet sent trump's speech congress
0,2,10,32,0,9,0,42,0,bacon ice cream sandwich might theone
0,2,12,38,2,11,0,50,0,atlantic politics policy daily: boy cpac town
0,1,3,52,1,9,0,55,0,coroner say michael jackson's death due sedative overdose
0,3,16,60,2,12,0,76,0,"record world satellite launch, european space agency want collaborate isro!"
0,1,6,31,0,8,0,37,0,south down get national park status uk
0,3,7,37,1,8,0,44,0,rudy gobert leaf game vs. clipper knee injury
0,2,1,40,0,7,0,41,0,twin baby girl different skin color
0,1,3,48,0,7,0,51,0,ukranian manufacturer preparing sell adolf hitler doll
0,1,5,25,1,5,0,30,0,"ship tread water, waiting cargo"
0,3,8,62,1,14,0,70,0,"donald trump hard satirise, say south park creator trey parker matt stone"
0,3,8,29,1,6,0,37,0,in-flight movie screen going extinct
0,2,14,46,5,12,0,60,0,'screw president' kid d.c. protest apparently drew carey's son
0,2,4,53,3,10,0,57,0,"!sdrawkcab: missy elliott, beatles joy backwards lyric"
0,3,3,75,1,16,0,78,0,hilarious realist: carrie fisher person everyone would want sit next wedding
0,2,4,63,4,11,0,67,0,"adam schiff say there's direct evidence ""deception"" trump camp, russia"
0,1,1,69,2,11,2,70,0,"50 italian parliamentarian call global summit ""a new financial architecture"""
0,1,1,23,0,4,0,24,0,georgian spy plane shot
0,1,4,37,0,9,2,41,0,american alpine ski racer james heuga dy age 66
0,2,4,53,0,8,0,57,0,u national security adviser visit afghanistan moab strike
0,3,4,54,3,11,0,58,0,"star react death george michael: ""he absolute inspiration"""
0,3,8,41,2,7,0,49,0,there bipartisan ticket trade trump inauguration
0,1,7,29,0,6,0,36,0,yankee give weary rodriguez two game
0,1,2,43,0,9,2,45,0,double bombing pakistani city leaf least 22 dead
0,2,6,40,0,9,3,46,0,marc leishman convert eagle 149 yard master
0,3,2,42,0,6,0,44,0,bad weather cause lettuce shortage across europe
0,3,6,60,5,17,0,66,0,harry winks: buzz get playing tottenham dont think ever go
0,1,3,43,0,6,0,46,0,seventeen arrested party london underground
0,3,13,56,0,14,4,69,0,davos 2017 watch wsj editor chief gerard baker discus future monetary policy
0,2,1,51,0,12,4,52,0,housing market grind halt sale hit lowest level since 1978
0,2,11,44,3,12,0,55,0,lady gaga's super week: sale streaming gain big game
0,1,4,43,0,6,0,47,0,red colored eu passport worry lithuanian politician
0,2,10,49,0,11,0,59,0,mohamed sanu get sweet letter family sitting behind plane
0,1,2,33,1,7,4,35,0,second paris fire kill 16 18-story building
0,1,3,58,1,8,0,61,0,"victoria, australia police investigate suspicious fire near rural town"
0,2,21,65,4,18,2,86,0,"21-year-old kashmiri girl pelted stone police want play football india, show lost."
0,3,8,31,0,7,0,39,0,radiohead get new ant specie named
0,2,4,59,0,12,0,63,0,queen elizabeth ii attends church missing service two week row
0,1,5,28,0,4,0,33,0,nonprofit seek lobby rule exception
0,3,4,36,0,8,0,40,0,iraq begin battle free western mosul
0,1,2,36,1,8,6,38,0,"least 175 killed, 200 injured northwestern iraq"
0,1,5,41,0,7,2,46,0,former pennsylvania governor george leader dy aged 95
0,2,4,40,3,8,4,44,0,snap ipo: 21st-century firm 19th-century structure
0,1,8,46,2,9,2,54,0,france announces $8.5 billion plan help struggling auto industry
0,1,11,44,1,10,0,55,0,"time running out, giro stage victory eludes garmin team"
0,3,9,33,1,8,6,42,0,nba power ranking entering final week 2016-17 season
0,3,2,85,1,17,0,87,0,secret unforgettable smile: chinese tour guide practice perfect grin biting chopstick
0,2,2,62,0,9,0,64,0,hillary clinton rally put spotlight inequality progressive cause
0,1,3,16,0,3,0,19,0,anna nicole smith dy
0,2,11,53,1,11,0,64,0,"thrive president trump, silicon valley must get real immigration"
0,1,5,42,0,10,0,47,0,nine dead armed santa claus open fire la suburb
0,3,6,26,2,7,4,32,0,"50 cent pay $22m debtors, end bankruptcy"
0,2,4,23,1,6,8,27,0,30 30 asia 2017: consumer technology
0,2,1,60,0,13,0,61,0,one thing rich parent kid make difference
0,1,7,46,1,9,0,53,0,"armed little resolve, defending hollowed village"
0,3,3,62,4,12,0,65,0,"""we ready"": expert warn world unprepared next ebola-size outbreak"
0,1,8,42,1,9,0,50,0,"finding purpose serving needy, haute cuisine"
0,1,1,43,0,7,0,44,0,monster wave make way rare surfing competition
0,1,3,44,0,11,5,47,0,tribute paid victim july 7 2005 london bombing
0,1,6,23,1,6,0,29,0,frito-lay make new pitch woman
0,1,2,23,0,4,0,25,0,microsoft drop bid yahoo
0,3,10,37,2,10,1,47,0,8 shocking hat luke gilmore girl wear reallife
0,1,2,42,0,8,0,44,0,least eight die afghan capital suicide bombing
0,3,4,32,1,6,0,36,0,aaron rodgers saved packers' season
0,1,3,32,0,6,0,35,0,u deliver humanitarian aid georgia
0,3,14,74,0,13,0,88,0,aam aadmi party face derecognition income tax department find irregularity donation
0,3,3,41,1,7,0,44,0,four-day corpus christi water ban lifted test
0,1,6,33,0,7,1,39,0,new internet address tested world ipv6 day
0,2,3,45,0,10,0,48,0,trial involved turkey coup begun
0,1,7,35,2,7,0,42,0,congressman thad mccotter run u.s. president
0,2,3,39,1,8,4,42,0,"italy pluck 2,000 migrant mediterranean sea"
0,2,9,54,0,11,0,63,0,investor cherry picking asset fallen renewable energy giant
0,2,11,45,3,9,0,56,0,"world war i, u.s. government propaganda erased german culture"
0,2,4,51,2,9,0,55,0,football transfer rumours: radamel falcao way liverpool?
0,1,3,46,0,7,0,49,0,professional wrestler chris benoit family found dead
0,3,4,72,2,11,0,76,0,trump administration 'deeply disappointed' imminent extradition former cia agent
0,3,8,50,0,9,0,58,0,libyan jet hijacker surrender releasing passenger crew
0,3,3,65,3,11,0,68,0,"rihanna, azealia bank clash immigration ban, post others phone number"
0,3,6,36,5,10,0,42,0,i'm still standing elton john says: 'i retiring'
0,1,2,31,0,4,0,33,0,death philippine ferry accident
0,3,15,63,1,15,0,78,0,"brother osbourne, maren morris jon pardi win best new artist category acm award"
0,3,1,43,0,10,0,44,0,cushioning fancy new way cheat someone
0,2,3,40,1,9,0,43,0,one feel good trump attack syria
0,2,8,71,2,15,0,79,0,"china fly nuclear-capable bomber south china sea trump taiwan call, u official say"
0,2,10,63,1,14,0,73,0,trump campaign responds zuckerberg swipe telling move border breitbart
0,2,16,50,1,13,0,66,0,u singapore blocked visa indian professional
0,3,4,45,3,7,0,49,0,"chelsea clinton announces new picture book, persisted"
0,3,3,85,3,22,3,88,0,islamic state's chief executioner beheaded 100 people knifed death ambush iraq
0,2,4,60,2,11,0,64,0,drexel professor draw ire posting 'white genocide' tweet christmas
0,1,6,36,0,7,1,42,0,deflection overtime help capital force game 7
0,1,4,21,1,5,1,25,0,2 approved justice dept.
0,3,1,63,3,10,0,64,0,"headspace provides 'small' benefit youth mental health, report show"
0,2,2,61,4,9,0,63,0,"report: cheetahs, world's fastest land animals, racing toward extinction"
0,1,5,29,0,6,0,34,0,goldman offer loan employee
0,3,3,63,1,12,0,66,0,supreme court hear case mexican teenager killed cross-border shooting
0,2,8,51,4,10,0,59,0,donald trump hasnt changed. conservative have. cpac proved it.
0,3,11,39,2,9,0,50,0,text message car trunk help locate kidnapped n.c. woman
0,1,6,33,0,6,0,39,0,white house give upbeat forecast economy
0,3,2,55,5,10,2,57,0,there earth-like planet atmosphere 39 light-year away
0,1,6,29,0,6,0,35,0,bernanke defends role merrill sale
0,3,13,37,0,10,0,50,0,china binge africa oil like never opec cut
0,1,2,23,0,6,2,25,0,violence rio end 30 death
0,2,7,46,0,9,0,53,0,father imprisoned genital cutting deported ethiopia
0,1,6,24,0,5,0,30,0,insurer oversight yet broken
0,1,4,23,1,4,0,27,0,"starbucks coffee, instant"
0,1,1,42,0,7,0,43,0,norfolk youth banned buying egg ketchup
0,3,12,54,1,14,3,66,0,white house reporter recall vivid moment trump first 100 day
0,3,3,43,0,8,0,46,0,disney chief iger defends spot trump advisory panel
0,1,4,54,0,11,0,58,0,european go poll elect member european parliament
0,3,14,51,1,13,0,65,0,"dni chief clapper take swipe trump, assange defends russia hack intel"
0,1,3,41,0,6,2,44,0,russian novelist aleksandr solzhenitsyn dy aged 89
0,3,9,47,1,9,1,56,0,alanis morissette manager admits stealing nearly $5m singer
0,1,3,49,0,8,0,52,0,president bush claim critic rewriting iraq war history
0,2,8,76,1,17,0,84,0,phone safe? security expert say hacker attack device via dozen popular io apps
0,1,4,41,0,8,0,45,0,first snowfall season impact northeast u
0,3,3,47,1,11,0,50,0,germany: six teen dead bavaria party garden hut
0,2,4,37,1,6,0,41,0,donald trump's u healthcare bill vote withdrawn
0,2,1,55,1,7,0,56,0,baby teething toy may contain hormone-disrupting chemical
0,3,9,40,3,7,0,49,0,"dj khaled enjoying fatherhood, call son 'biggest blessing'"
0,2,14,50,2,13,0,64,0,there reason twenty one pilot didnt wear pant accept theirgrammy
0,2,9,50,3,10,1,59,0,"court extends order blocking release albert woodfox, angola 3 member"
0,1,5,33,2,7,2,38,0,basf make $4.9 billion hostile bid engelhard
0,2,6,23,0,6,4,29,0,rihanna lowkey 2017 grammys
0,1,1,32,0,5,0,33,0,iran claim airliner denied fuel
0,3,13,48,5,10,0,61,0,"ahead pro-trump rally, kkk member claim they're 'not white supremacists'"
0,1,2,30,0,4,0,32,0,lehman brother file bankruptcy
0,2,1,26,0,5,0,27,0,stem cell offer hope autism
0,2,8,54,1,7,0,62,0,kris kobach: democrat already attacking election integrity commission
0,2,5,37,0,8,0,42,0,ugly example fifa scandal set soccer kid
0,3,12,68,1,11,0,80,0,democrat delay jeff sessions' confirmation donald trump fire acting attorney general
0,1,9,34,3,8,0,43,0,"despite torture video, u.s. emirate sign key pact"
0,1,1,30,1,6,2,31,0,"europe hit storms, 45 death reported"
0,1,6,72,2,11,0,78,0,"tsunami bulletin issued pacific coast california-mexico border vancouver, canada"
0,1,1,50,1,7,0,51,0,madagascar's former opposition leader sworn president
0,2,2,78,0,11,0,80,0,terrifying moment firefighter squeeze gap search italian avalanche survivor
0,1,4,60,1,11,0,64,0,"tattoo identifying detail lead prosecution thief bristol, uk"
0,2,3,59,1,10,0,62,0,uk police say theyve arrested key player behind manchester bombing
0,1,2,39,0,6,0,41,0,fujimori intends run peruvian presidency
0,1,1,49,1,11,4,50,0,"15 killed, 30 injured attempting steal fuel train india"
0,2,18,71,12,20,0,89,0,patricia smith: hillary clinton treat like dirt im nobody -- doesnt tell truth?
0,1,7,26,0,4,0,33,0,glaad medium award nominee announced
0,1,3,27,1,6,0,30,0,inter milan's tour england back
0,2,1,31,0,4,0,32,0,teen inspires first transgender doll
0,3,16,57,4,14,0,73,0,un-baa-lievable! police find seventy-two lamb squeezed back van slovakia
0,3,19,72,3,19,0,91,0,unseen 'dirty dancing' footage make fall love patrick swayze jennifer grey
0,2,2,30,2,5,0,32,0,"heat's big, naked goofball champion"
0,3,6,82,0,17,0,88,0,bbc question time audience member steal limelight woman front asks question list
0,3,1,54,0,12,0,55,0,tow truck driver fall death trying upright big rig
0,3,5,19,0,6,0,24,0,ashamed australian
0,3,6,65,3,8,0,71,0,arnold schwarzenegger defends donald trump's involvement 'celebrity apprentice'
0,2,6,26,2,5,0,32,0,filibuster: senator best friend
0,1,10,29,1,8,0,39,0,justice dept. denies plan settle ubs tax case
0,2,1,83,2,14,3,84,0,haunting image reveal crumbling remains 152-year-old prison built hang notorious criminal
0,2,7,41,3,8,0,48,0,syria reject amnesty's report mass hanging 'untrue'
0,1,7,53,0,10,0,60,0,mastermind us cole limburg bombing escape yemeni prison
0,2,3,40,0,8,0,43,0,trump keep list white house visitor secret
0,3,2,43,0,10,0,45,0,el salvador first day without murder two year
0,3,2,45,1,10,1,47,0,"google pixel 2 might headphone jack, report say"
0,3,9,20,3,6,1,29,0,stream run jewels' new 'rtj3' album
0,3,7,48,1,8,0,55,0,"backed law enforcement, undocumented immigrant get reprieve"
0,3,5,70,5,17,0,75,0,president george w. bush say important free press: 'power addictive'
0,1,5,57,2,11,4,62,0,tersbetoni frontman j. ahola representing finland eurovision 2008
0,3,2,29,0,4,0,31,0,osborne confirms budget surplus law
0,1,10,38,1,11,3,48,0,"others run fuel, martin win lifelock 400 michigan"
0,3,8,36,1,10,0,44,0,care aged parent without going broke
0,3,12,63,2,14,0,75,0,"cash-strapped tesla back top, delivering record number vehicle first quarter"
0,1,4,29,0,7,0,33,0,four die papua new guinea plane crash
0,2,7,39,2,8,0,46,0,"trump's white house, ceo shaping economic policy"
0,1,5,28,0,4,0,33,0,australia wildfire suspect freed
0,3,4,36,4,8,2,40,0,"william peter blatty, exorcist author, dead 89"
0,2,10,46,1,9,0,56,0,juror replaced oregon occupation case; trial draw crowd
0,1,1,45,1,9,2,46,0,"30 dead baghdad bomb blasts, hundred people injured"
0,2,1,40,0,6,0,41,0,northeast gear blizzard condition
0,3,1,46,0,11,0,47,0,hate crime charge fatal attack gay man lured lake
0,2,11,50,3,13,2,61,0,"former holy cross center, 'game thrones' actor neil fingleton dy age 36"
0,2,8,72,5,18,4,80,0,"star war celebration 2017: mark hamill carrie fisher, 'i'm still thinking past tense'"
0,2,10,41,1,10,2,51,0,61 greatest sign womens march around thecountry
0,2,13,51,4,13,0,64,0,nyc mayor bill de blasio: resident 'on hook' trump security
0,1,4,32,0,8,0,36,0,turning public advice budget
0,3,4,59,3,9,0,63,0,north dakota congressman: spicer hitler comment 'not without validity'
0,2,4,59,2,13,0,63,0,marijuana advocate vow smoke pot get arrested step u.s. capitol
0,3,5,70,0,14,0,75,0,eva green play virginia woolf film lesbian love affair inspired orlando
0,3,10,49,1,11,0,59,0,italy ruling party face quandary renzi step party leader
0,3,2,49,1,11,2,51,0,article 50 letter: press reacted side channel
0,1,3,53,2,8,0,56,0,church scientology attempting block 'intolerant' german film
0,2,7,43,1,8,0,50,0,number american enrolling health-care website jump
0,1,3,52,1,10,3,55,0,report say modernizing repairing u bridge cost $140 billion
0,3,8,43,1,9,0,51,0,inspiring america: free suit men struggling find work
0,1,6,32,1,5,0,38,0,"affair, senator resigns leadership job"
0,1,4,67,0,11,0,71,0,climate campaigner scale uk parliament hang protest banner building
0,2,4,18,1,4,0,22,0,theyre trapped lie
0,2,1,33,0,8,0,34,0,maine police scoop pair pygmy goat
0,1,6,35,1,5,0,41,0,fidelity contrafund low-priced stock reopen
0,3,12,41,1,11,0,53,0,dad christmas card bi daughter show pride
0,3,13,65,1,12,0,78,0,notre dame's matt farrell emotional surprise reunion brother back afghanistan
0,1,3,30,0,4,0,33,0,explosion sink indian navy submarine
0,2,1,36,0,4,0,37,0,boy battling leukaemia conduct orchestra
0,2,18,62,2,16,0,80,0,"review: best thing ok jaanu casual approach everyday, believable love story"
0,2,11,50,6,11,0,61,0,"trump's tax plan: double standard deductions, end death tax fox business"
0,1,3,66,0,9,0,69,0,british actress natasha richardson reportedly brain dead skiing accident
0,1,1,50,0,5,0,51,0,norwegian politician face voter suppression allegation
0,3,9,36,0,12,0,45,0,new form drug fentanyl make way new york city
0,1,6,34,0,7,0,40,0,debate clean energy lead regional divide
0,3,6,32,1,6,1,38,0,amsterdam rediscovered: 6 reason visit
0,1,5,19,0,5,0,24,0,bbc dj duo break radio record
0,2,11,43,4,12,0,54,0,"better (smelly) mosquito trap, caveat new york time"
0,1,7,39,2,9,4,46,0,2008 taispo taipei cycle: reunion opportunity
0,1,3,56,1,11,0,59,0,"eight dead two missing cargo ship fire kaliningrad, russia"
0,2,11,73,0,11,0,84,0,american airline flight attendant suspended video altercation passenger surface
0,3,5,76,0,14,0,81,0,donald trump announces plan military parade major u city becomes president
0,3,1,45,1,10,4,46,0,pope's 2013 stump speech cardinal blueprint papacy
0,2,8,50,0,10,0,58,0,alistair overeem faceplants mark hunt crushing knee face
0,2,6,26,0,6,0,32,0,mark morgan border patrol chief
0,2,3,45,0,9,0,48,0,new window extraordinary life sally heming
0,3,14,49,5,13,0,63,0,'trump stump' jimmy kimmel's terrifying alternative 'elf shelf'
0,2,3,60,6,11,0,63,0,let em in? understanding bannons worldview policy follow.
0,2,5,75,4,15,0,80,0,syrian civil war: jabhat al-nusra's massacre druze villager show they're nasty isi
0,3,6,60,5,13,0,66,0,bill o'reilly's first public comment fox news exit: 'the truth come out'
0,2,5,61,2,12,0,66,0,"rex tillerson, exxonmobil chairman may become secretary state?"
0,1,5,40,1,6,0,45,0,corruption threatens brazil's olympics world cup
0,3,5,53,5,10,0,58,0,"illinois rep. mike bost compare town hall ""cleansing"" ""orientals"""
0,2,1,61,0,11,0,62,0,photo series prof trans people gender identity
0,1,7,38,0,10,0,45,0,journey ebbets field step capitol
0,3,12,68,1,13,0,80,0,"dallas cowboy ezekiel elliott score td, celebrates donating salvation army"
0,1,6,29,1,9,0,35,0,"argentina, camera blog make star"
0,2,11,35,1,10,3,46,0,mlb power rankings: 30 team stand entering week 4
0,2,1,40,0,8,0,41,0,putin celebrates woman cold eye doom
0,1,6,37,0,6,0,43,0,civilian flee pakistani force hit resistance
0,3,7,39,0,6,0,46,0,trans latina immigrant fear deportation trump
0,3,3,39,5,9,6,42,0,"'hero' kansa triple shooting honored $100,000 yahoo"
0,2,1,34,0,7,0,35,0,man changed red carpetforever
0,3,12,51,3,10,0,63,0,plus-size retailer criticized campaign casting [video]
0,1,3,59,1,8,0,62,0,american airline plane overshoot runway jamaica; injury reported
0,1,5,22,0,5,0,27,0,british union trim aid party
0,3,2,34,0,7,0,36,0,kate winslet call body shamers talk
0,1,4,26,0,4,0,30,0,russia end operation chechnya
0,3,11,34,3,7,0,45,0,"madeintyo boycott uber, plan 'lyft everywhere'"
0,2,6,50,2,10,0,56,0,group making anti-trump robocalls closely tied pro-trump pac
0,2,12,62,1,12,0,74,0,justice department open investigation russian doping scandal new york time
0,1,1,29,0,5,0,30,0,google mobile phone rumour ramp
0,3,8,47,0,9,0,55,0,monica crowley step away position trump administration
0,3,11,58,2,15,4,69,0,rock roll hall fame remains narrow 'rock' definition list 2017 inductee
0,3,3,83,1,18,0,86,0,"mexican politician demonstrated put condom mouth, people furious list"
0,2,2,42,2,7,0,44,0,israeli arab anger parliament back 'muezzin bill'
0,2,2,62,0,8,0,64,0,treasury allowing transaction russian intelligence agency
0,1,7,69,2,11,1,76,0,"supercross: stewart win 4th consecutive monster energy event san francisco, california"
0,2,10,25,8,12,3,35,0,"norway no. 1 happiness. u.s., sadly, no. 14."
0,2,1,35,0,6,0,36,0,man dy altercation caraccident
0,2,9,41,1,11,0,50,0,crunch time: obama meet house dems ahead trade vote
0,3,10,40,2,10,0,50,0,"trump vow unveil tax-cut plan next week, surprising staff"
0,1,4,20,0,5,0,24,0,argentina pay imf debt
0,1,1,50,1,9,2,51,0,madoff jailed pleading guilty $50 billion fraud scheme
0,1,5,39,0,7,0,44,0,un attack gbagbo military position ivory coast
0,1,6,31,1,7,0,37,0,"even putter, loft consideration"
0,1,1,63,1,8,0,64,0,iraqi government approves power-sharing deal eight month election
0,2,10,47,2,11,0,57,0,u.k. police arrest eight response attack near london parliament
0,1,1,39,1,7,0,40,0,"prayer help heart patients, study find"
0,3,11,40,4,10,0,51,0,"trump, buck stop 'the generals,' president"
0,3,9,44,1,11,2,53,0,klay thompson throw 1-handed dunk timofey mozgov game 3
0,3,4,35,4,7,4,39,0,they've grown! malia sasha obama: 2008-present
0,1,3,45,0,7,0,48,0,van halen singer impersonated canadian medical scare
0,1,6,28,0,5,0,34,0,time company suspends dividend
0,3,3,63,2,9,0,66,0,u.n. human right official criticizes federal relationship indian tribe
0,2,9,31,1,10,2,40,0,walt disney co. lay 80 maker studio
0,2,5,46,1,10,0,51,0,google deepmind make ai program learn like human
0,2,17,35,2,12,0,52,0,"remy take direct aim nicki minaj new dis song ""shether"""
0,3,10,36,2,10,0,46,0,cam newton say fatherhood helped better man
0,1,2,44,1,7,0,46,0,"helicopter crash kill eight, injures one louisiana"
0,2,5,35,3,9,0,40,0,isnt john mayer music weird john mayer?
0,1,2,44,0,6,0,46,0,aurora borealis caused electrical space tornado
0,2,3,67,5,10,0,70,0,"four sentenced almost indescribable kidnapping, torture n.y. college student"
0,1,2,29,0,4,0,31,0,quebec city mayor dy unexpectedly
0,3,2,47,3,9,2,49,0,pink floyd's $1.8m desk show timeless appeal analogue sound
0,2,1,49,1,8,0,50,0,suspect trooper's death shot killed encounter
0,1,6,44,0,6,0,50,0,year international herald tribune article disappear
0,1,7,31,1,9,0,38,0,"golf shoe improve style, game"
0,1,9,41,0,10,0,50,0,stone age flute found germany offer clue early music
0,2,4,85,2,20,0,89,0,trump pick national security adviser role firm co-led man tried sell material kgb
0,2,17,46,2,15,3,63,0,$200 million! much google paid salary ceo sundar pichai last year
0,3,3,71,1,13,0,74,0,starbucks already running unicorn frappuccino baristas overjoyed
0,1,6,49,1,10,0,55,0,iaea: north korea begin shutting nuclear reactor next week
0,2,3,66,3,14,0,69,0,"barry goldwater would appalled trump raising money home, widow say"
0,3,2,68,5,17,3,70,0,new jersey's expensive home back market $48.8 million take look inside
0,1,2,48,2,7,1,50,0,8th circuit court rule 'partial birth' ban unconstitutional
0,1,5,27,3,6,2,32,0,"bruin beat hurricanes, 4-0, stay alive"
0,2,15,46,1,10,0,61,0,lapd commission fault one officer fatal shooting mentally-illman
0,1,1,34,0,4,0,35,0,afghanistan begin partial vote recount
0,1,5,25,0,5,0,30,0,barack obama win nobel peace prize
0,2,1,42,0,8,4,43,0,army charge retired general raping minor 1980s
0,3,15,41,5,15,1,56,0,bruno mar earns first no. 1 hot r&b song chart 'that's like'
0,3,8,48,2,15,0,56,0,chicago white sox's jose abreu jury: ate fake passport way u
0,1,5,32,0,7,0,37,0,world food program told leave north korea
0,2,12,45,2,12,0,57,0,david frum: nra member task repelling tyrant breitbart
0,1,1,34,0,3,0,35,0,twitter announces advertising platform
0,2,8,27,2,9,4,35,0,best film 2016: cinema map
0,2,2,46,1,6,0,48,0,police cite massachusetts sixth-grader trespassing
0,3,2,48,2,6,0,50,0,"organizer promise ""soft sensuality"" trump inauguration"
0,2,4,49,3,9,0,53,0,"challenge trump, woman protester swarm street across u.s."
0,1,7,26,1,5,0,33,0,private jet lose feel-good factor
0,1,1,50,0,8,0,51,0,abbas fire security chief failure curb lawlessness
0,3,4,45,2,8,0,49,0,"woman impersonated lawmaker's wife, snuck gop retreat"
0,1,6,37,0,6,0,43,0,biotech firm liquidate investor pressure
0,1,6,54,3,9,0,60,0,"washington, d.c. sniper john allen muhammad executed lethal injection"
0,2,4,32,0,7,0,36,0,uber ceo apologizes outburst driver
0,1,5,34,0,6,0,39,0,investor find appetite tech offering
0,3,15,56,2,11,0,71,0,nasa captured saturn ring stunning level detail that's simply mesmerizing
0,2,10,23,0,6,0,33,0,four way noaa benefit life today
0,3,3,48,0,10,0,51,0,social care reviewer condemns uk system call new tax
0,2,4,56,1,11,0,60,0,"roger ailes opts secrecy, cowardice face gretchen carlson suit"
0,3,11,40,1,10,1,51,0,major proponent h-1b visa reform loses patience trump
0,3,2,67,1,15,1,69,0,"trump eye bid split 9th circuit court amid sanctuary city, travel ban dispute"
0,1,5,43,2,7,0,48,0,"saudi arabia, bahrain, kuwait recall ambassador syria"
0,1,3,44,1,8,0,47,0,ban ki-moon call zimbabwe election postponed
0,2,9,47,1,8,0,56,0,"doctors, hospital say latest trumpcare version bigger disaster"
0,2,9,49,1,8,0,58,0,"trump rally overdone, outperforming australian fund manager say"
0,3,10,44,0,10,2,54,0,literally 10 photo andrew garfield chilling paddleboat
0,2,2,57,0,13,0,59,0,devastating effect heroin ohio city want see
0,3,7,39,0,9,2,46,0,first 37 defendant fatal hazing case pleads guilty
0,1,3,55,3,7,0,58,0,michael moore's controversial new documentary 'sicko' open strongly
0,2,8,41,2,7,0,49,0,jimmy kimmel share 'alternative facts'
0,2,1,37,0,7,0,38,0,learning love secret language urine
0,1,7,30,3,7,0,37,0,"g.m. chrysler, aid tied restriction"
0,1,8,37,1,10,4,45,0,less-famous player 2004 trade joined mets
0,1,4,29,0,5,0,33,0,australian pm promise assist corby
0,1,4,20,1,5,0,24,0,"vatican, tough read"
0,2,14,56,5,17,0,70,0,woman adopt dying best friend's children: 'we love love kids' insider
0,1,2,58,0,8,0,60,0,major earthquake strike peru followed multiple large aftershock
0,3,12,42,0,13,0,54,0,mom four kid build dream home help youtube video
0,1,6,33,0,8,0,39,0,dutch stunning world classic
0,2,5,24,1,4,0,29,0,france poised pro-russia pivot
0,2,10,53,1,11,0,63,0,white house increase overtime eligibility million new york time
0,1,2,27,1,4,0,29,0,gordon brown's troubled first year
0,2,11,36,0,11,0,47,0,le pen say french bank refused meet
0,1,7,45,2,10,0,52,0,"u department defense report iraqi al qaeda ""safe house"" hit"
0,3,16,50,0,15,1,66,0,spacex wave final goodbye falcon 9 rocket never chance come home
0,2,11,53,1,11,0,64,0,paris shooting: soldier near louvre museum fire attacker idd egyptian
0,3,6,28,1,5,0,34,0,state street hurt hedge-fund outflow
0,1,1,48,2,8,1,49,0,"wale railway upgrade proposal would cost 5bn, say expert"
0,1,10,22,6,6,0,32,0,f.b.i. s.e.c. probe missing fund manager
0,1,1,50,0,8,0,51,0,google begin massive effort make book available online
0,3,11,45,0,10,0,56,0,freddie gibbs clear issue logic similar album cover
0,3,7,39,1,9,3,46,0,living dark: 240 million indian electricity
0,2,9,46,0,8,0,55,0,trump nominates obamacare critic tom price health secretary
0,2,1,40,0,8,0,41,0,ace college football bowl office pool
0,3,15,39,2,12,6,54,0,nba 10-time grammy winner john legend perform 2017 nba all-star game
0,2,12,55,4,10,0,67,0,cold blood killer never-published memoir raise question motive
0,1,1,44,0,5,0,45,0,manitoba resident receive evacuation flood alert
0,3,4,35,1,11,6,39,0,bowie solange: top 10 album 2016
0,1,10,50,0,11,0,60,0,west virginia governor urged add financing mental health care
0,3,8,52,0,13,4,60,0,donald trump bombed syria exactly 100 year u entered ww1 list
0,1,7,33,1,8,0,40,0,"hincapie jump second, nearly first"
0,3,2,61,1,12,0,63,0,"japan solve huge sex problem, according political scientist"
0,1,4,47,0,10,0,51,0,air france launch new daily flight paris bucharest
0,1,5,28,1,7,2,33,0,criminal charge filed nov. 19 nba brawl
0,2,11,42,4,10,0,53,0,everyone know holiday better love actually
0,3,5,58,2,12,1,63,0,euro jump 2% macron-le pen set french presidential election runoff
0,3,7,33,0,7,0,40,0,san bernardino school shooting leaf two dead
0,1,6,28,0,7,0,34,0,facing reality money gone
0,3,3,57,1,9,0,60,0,reeperbahn rendezvous: glorious dive bar photo anders petersen
0,2,16,61,0,14,0,77,0,andrew bogut actually trying argue lebron purposefully slammed head camera
0,3,3,43,1,9,3,46,0,union paying southern rail conductor 300 week strike
0,1,3,67,1,7,0,70,0,european commission investigate anti-competitive allegation google
0,1,6,37,0,7,0,43,0,miguel tejada get probation lying congress
0,3,9,39,2,8,0,48,0,latino see historic first new congress get started
0,1,2,37,1,6,0,39,0,polar bear knut's death linked encephalitis
0,3,4,30,1,7,0,34,0,love spectrum: meet ruth andthomas
0,1,6,33,1,5,0,39,0,"indonesia, islamist lost political ground"
0,3,9,26,2,8,4,35,0,mtv video music award returning l.a. 2017
0,1,3,43,0,9,0,46,0,party video game banned uk offensive word
0,2,3,24,4,7,4,27,0,"dear world, bad. signed, 2016"
0,2,1,48,2,10,6,49,0,"revealed: 100,000 wait two week see cancer specialist"
0,3,10,40,1,10,5,50,0,beyonce hit 100m instagram follows: see 10 popular post
0,2,8,40,3,7,0,48,0,'day without immigrants': protest close restaurant u
0,1,2,54,1,9,0,56,0,habertrk medium spark outrage woman murder photo turkey
0,3,6,58,1,11,0,64,0,"top hill republican meet bannon obamacare replacement, source say"
0,1,9,28,3,7,0,37,0,myspace cut two-thirds staff outside u.s.
0,3,14,56,4,13,0,70,0,"mark zuckerberg troll snapchat: say 'facebook everyone, high end'"
0,2,9,43,1,9,0,52,0,south park creator given satirizing donald trump
0,3,6,24,1,6,0,30,0,danger china dual debt cycle
0,1,2,39,1,10,4,41,0,"twin bomb blast 2 philippine mall kill 6, injure 38"
0,1,6,37,0,7,0,43,0,coach arrive sideline different path
0,2,8,39,0,7,0,47,0,fan create impromptu hollywood star carrie fisher
0,2,2,60,2,10,2,62,0,dc family slaughter suspect facing 20 charge especially heinouscrime
0,3,7,46,0,9,0,53,0,trump interview four security adviser candidate sunday
0,3,12,58,2,11,0,70,0,mapping president trump's travel ban vs. business interest muslim country
0,3,2,19,1,5,0,21,0,here's new fed dot plot
0,1,3,45,0,7,0,48,0,buddhist relic collection tour north america world
0,1,2,31,1,5,0,33,0,morgan tsvangirai compete run-off
0,2,4,55,0,9,0,59,0,mattis withdraws pentagon pick seen muslim brotherhood supporter
0,3,11,30,5,8,0,41,0,'rogue one' ending blow mind? (spoilers)
0,1,6,36,0,9,0,42,0,hilda solis begin new job u secretary labor
0,1,5,26,2,5,0,31,0,u.s. scramble information iran
0,2,5,53,2,7,0,58,0,nigeria chibok abductions: ex-president jonathan denies rescue snub
0,2,9,46,4,11,0,55,0,"stripped, beaten, humiliated barred trial egypt"
0,3,4,60,6,12,0,64,0,trump say making product u.s. gonna cheaper. economist disagree.
0,3,5,55,2,10,0,60,0,"sir bradley wiggins hour record illegal, claim alex dowsetts coach"
0,1,8,39,3,11,2,47,0,"tim russert, nbc news ""meet press"" moderator dy age 58"
0,1,9,49,1,10,0,58,0,"amid passion grief, reminder italy remains sleeping giant"
0,3,9,44,1,9,0,53,0,watch live: refugee agency hold news conference travel ban
0,1,6,39,0,7,2,45,0,former u representative dan rostenkowski dy aged 82
0,2,4,50,2,10,3,54,0,rupert murdoch return sky fox make 18.5bn takeover approach
0,3,2,72,2,11,0,74,0,"donald trump defends travel ban, blame computer glitches, protester airport chaos"
0,1,4,24,0,4,0,28,0,resolution obama stir debate
0,1,4,36,1,8,0,40,0,"school bus crash kill one student georgia, u"
0,1,7,51,1,9,0,58,0,prosecutor begin ny state sen. hiram monserrate felony assault case
0,3,4,34,0,8,0,38,0,fox news fine without megyn kelly
0,2,7,29,1,8,3,36,0,metric 101: ranking best bench nba
0,3,1,66,1,10,0,67,0,sudden cardiac arrest research trust established family pilot's death
0,2,3,60,0,10,0,63,0,canadian judge rule favor forcibly adopted first nation survivor
0,2,8,37,2,8,2,45,0,"kylie jenner remembers 19, crash high school prom"
0,1,7,39,2,7,0,46,0,"southern sudanese, delivering aid, killed ambush"
0,2,6,41,0,8,0,47,0,russian ambassador turkey assassinated ankara
0,2,4,46,0,13,0,50,0,murdoch said looking woman run fox news
0,2,6,77,2,13,0,83,0,donald trump tell republican 'go nuclear' stop democrat blocking supreme court nomination
0,3,11,29,7,11,0,40,0,z might a+ mypillow got rated f
0,1,2,43,1,9,0,45,0,coal mine blast ukraine kill two; ten still missing
0,2,8,41,2,11,0,49,0,melissa mccarthy back super mad sean spicer 'snl'
0,3,6,24,0,5,0,30,0,three rare metal roaring
0,3,8,26,0,8,0,34,0,new kind male birth control coming
0,3,11,36,3,10,0,47,0,may pledge put u.k. first trade-deal talk trump
0,1,3,34,0,6,0,37,0,toxic soup scenario new orleans unlikely
0,1,6,33,1,8,0,39,0,"minnesota, big moment temple hindu"
0,1,4,49,2,9,0,53,0,third day 'king taksin operation' see bangkok airport closed
0,1,6,28,0,6,0,34,0,atheist shout rooftop
0,2,13,43,3,15,0,56,0,pissed jean idea gym work 'the bar low' video: watch
0,1,5,38,0,9,0,43,0,two new case west nile virus reported indiana
0,1,7,34,0,7,0,41,0,general warns quick end afghan combat
0,1,10,45,1,8,0,55,0,nhc upgrade tropical depression four-e tropical storm carlos
0,3,5,42,2,5,0,47,0,washington d.c. prepares presidential inauguration
0,3,5,29,1,6,0,34,0,tony romo's unlikely rise changed nfl
0,3,8,44,0,9,0,52,0,facebook hire campbell brown lead news partnership team
0,1,4,28,0,6,0,32,0,ivory coast trade embargo backed u
0,3,11,25,4,8,0,36,0,check the-dream's new ep 'love death'
0,2,7,33,1,11,2,40,0,"mere 25 years, triumph west"
0,3,4,24,0,5,0,28,0,turning tide cholera
0,2,3,57,4,10,0,60,0,trump offensive wipe al-shabaab threatens pain somali
0,1,11,41,3,10,0,52,0,"daw aung san suu kyi, burmese pro-democracy leader, go trial"
0,1,6,38,0,10,0,44,0,ivan basso try rebuild career reputation
0,1,10,51,0,12,0,61,0,tormented kenyan town strike back member street gang
0,2,2,68,1,12,0,70,0,"botched drug trial leaf one person brain dead, five others hospitalized france"
0,1,8,35,0,7,0,43,0,pope admits online news provide infallible aid
0,2,2,60,0,12,0,62,0,apple seek nod open india store amid concern slowing sale growth
0,3,9,40,1,9,0,49,0,ed sheeran blast new spotify record one-day stream
0,2,1,69,1,12,1,70,0,3 official finally facing criminal charge covering flint water crisis
0,2,11,65,1,11,0,76,0,donald trump keep promise; selects constitutionalist neil gorsuch supreme court
0,2,2,60,0,13,0,62,0,new video show moment police dragged man united flight
0,2,8,54,2,12,0,62,0,hungary referendum result victory defeat prime minister?
0,1,7,32,1,6,0,39,0,elite-status flier may start feel ordinary
0,1,7,27,0,7,0,34,0,jackson said pulse found
0,3,3,49,0,8,0,52,0,judge brock turner case cleared misconduct allegation
0,3,1,40,3,8,2,41,0,trump's tax plan could cost estimated $5.5 trillion
0,1,9,33,0,9,0,42,0,bird quickly learns tell urban friend foe
0,2,12,37,4,10,0,49,0,trump say u.s. military never ever left iraq
0,3,1,60,0,9,0,61,0,new immigration crime hotline becomes target prank calling campaign
0,2,9,51,3,10,4,60,0,"shawn mendes' manager discusses breakout 2016, fan outreach grammy reaction"
0,3,3,73,0,15,2,76,0,new bishop sheffield offered support 36 female clergy following call turn post
0,1,3,54,1,11,0,57,0,"one killed, many boat damaged storm spanish island majorca"
0,2,16,56,2,17,0,72,0,"best tv show movie new netflix, amazon april nyt watching search"
0,2,2,65,3,11,0,67,0,immigrant right group brace deportation raids: 'this beginning'
0,3,4,57,1,10,0,61,0,ivanka trump sits president's chair meeting justin trudeau
0,2,5,33,1,8,0,38,0,"trump kill tpp, giving china first big win"
0,1,4,53,0,8,0,57,0,coalition talk israeli likud labour party underway
0,3,13,48,0,11,0,61,0,donald trump say refugee crisis threat uk identity drove brexit
0,2,11,58,2,10,0,69,0,"azealia bank criticizes women's march, warns woman mainstream feminism"
0,2,4,41,2,8,0,45,0,trump's trade rep: lawyer robert lighthizer top pick
0,1,2,22,0,4,0,24,0,bombing iraq kill score
0,1,7,34,1,8,0,41,0,blob phoenix lander indicate water mars?
0,3,4,34,1,10,4,38,0,stan lee turn 94: 25 best cameo marvel film
0,1,2,30,0,5,0,32,0,six killed burundi church massacre
0,3,5,34,4,5,0,39,0,"car wars, megalomania biotech revolution"
0,3,11,39,0,10,0,50,0,bat bet vaping tobacco giant battle new device
0,2,3,47,4,8,0,50,0,britain health service humanitarian crisis: red cross
0,1,3,44,2,10,0,47,0,"english ""lady lake"" killer found dead prison cell"
0,2,10,43,0,10,0,53,0,strike show america like without immigrant worker
0,3,3,47,1,7,0,50,0,french elections: beleaguered fillon hit fresh scandal
0,3,2,65,5,8,0,67,0,re-accommodate? united ridiculed corpspeak response passenger dragging.
0,3,4,29,1,7,1,33,0,"skin cancer cream killed 5 dogs, fda warns"
0,3,7,28,2,6,0,35,0,candace cameron bure quitting 'the view'
0,3,3,49,1,10,4,52,0,"1,000 people evacuated east aleppo monday morning"
0,3,16,49,3,12,0,65,0,year indian ceo 'million-dollar club' promoter
0,2,5,80,0,18,0,85,0,guy climbed outside trump tower new york held psychological evaluation
0,1,10,49,1,8,0,59,0,reflection dom dimaggio often-overlooked hitting streak
0,2,13,50,2,13,0,63,0,warrior fan told lebron changed name jordan new 'lie witness news'
0,2,13,49,5,11,0,62,0,fx announces premiere date 'x-men' series 'legion' trippy new trailer
0,1,2,36,2,7,0,38,0,indian heart disease 'more severe west'
0,2,6,38,0,10,0,44,0,naacp leader speak monday amid furor race
0,2,8,38,3,9,5,46,0,"thunder fan win $20,000 sinking half-court shot halftime"
0,1,5,26,0,4,0,31,0,earnings worry push market lower
0,2,7,23,2,6,0,30,0,peugeot set sight u.s. car market
0,1,3,31,2,6,0,34,0,u.s. superbug expected emerge canada
0,1,4,33,3,9,4,37,0,"german gdp drop 3.8%, largest decline 40 year"
0,2,6,30,1,8,0,36,0,review: smart home start garage
0,3,17,62,2,15,0,79,0,delhi man arrested hiring hitman kill ex-lover's husband injecting cocktail drug
0,1,2,43,0,6,0,45,0,pakistan turkey container train service launched
0,1,4,22,1,6,3,26,0,deere profit fell 38% 2nd quarter
0,3,3,38,1,8,0,41,0,"acl tear rise among kids, especially girl"
0,2,8,36,0,9,4,44,0,tracy mcgrady named 2017 basketball hall fame class
0,1,8,47,0,9,0,55,0,china tightens purse string guinea african nation
0,1,2,38,0,6,0,40,0,power line japanese nuclear plant completed
0,1,2,34,2,4,0,36,0,colombian rebel leader 'karina' surrender
0,3,8,33,4,11,4,41,0,graham: 2017 year kickin russia as
0,2,2,18,2,2,0,20,0,deflating deflategate
0,1,3,37,1,6,0,40,0,new york assembly pass same-sex marriage bill
0,3,8,41,2,7,0,49,0,romania ex-ruling party sweep election reclaim power
0,2,4,54,2,9,0,58,0,joe scarborough defends schmoozing trump washington way
0,3,1,47,0,8,0,48,0,liberalism suffering democracy fine
0,2,7,49,2,5,0,56,0,china's defense-spending confusion highlight strategic worry
0,2,8,47,4,7,0,55,0,"obamas high school basketball coaches, teammate remember barry"
0,2,5,62,1,10,0,67,0,amber harrison hire high-profile barrister battle seven west medium
0,1,4,35,1,7,2,39,0,ford offer us$78 million romanian auto plant
0,2,10,55,2,12,0,65,0,cleveland cavaliers' secret playoff defense smoke screen real deal?
0,3,9,40,2,7,0,49,0,"trump combative, crowd-obsessed interview abc"
0,2,18,41,2,13,0,59,0,watch: rand paul attack ted cruzs wall street tie bizarre new web ad
0,2,12,50,6,14,0,62,0,design 'rogue one': exclusive look 'star wars' film's concept art
0,3,11,37,1,10,0,48,0,"um, smith somehow look exactly like unclephil"
0,3,9,42,0,9,0,51,0,cosmopolitan fire weight loss tip cancer story
0,3,1,56,2,13,1,57,0,"trump budget plan could add $6tn public debt decade, analyst say"
0,2,9,33,3,6,0,42,0,u.s. accuses russia election year cyber-meddling
0,1,7,33,0,8,0,40,0,mugabe aide said use violence get amnesty
0,3,12,58,0,12,1,70,0,tony robbins reveals top 6 leadership blind spot cripple business success
0,1,1,44,0,8,0,45,0,australian town change name promote road safety
0,3,2,70,0,14,0,72,0,red lobster bringing back classic item fend looming restaurant recession
0,2,2,31,3,5,0,33,0,georgia storm survivor: 'we scared'
0,3,9,44,3,9,0,53,0,wiz khalifa release remix chainsmokers' hit song 'closer'
0,1,3,38,0,7,2,41,0,early canadian federal election set october 14
0,3,8,38,0,9,0,46,0,steve job taught debate workplace
0,1,1,57,1,11,2,58,0,"g20 agrees avoid currency war, also agrees reduce trade imbalance"
0,3,15,67,0,14,0,82,0,meteorologist burned daughter text weather reporter bondingonline
0,2,4,48,2,10,0,52,0,here's rep. lewis responded trump without saying name
0,3,3,58,2,7,0,61,0,"fantasia barrino cancel tennessee concert, citing second-degree burn"
0,2,11,49,1,13,0,60,0,"sonic report lower sales, project result pick back end year"
0,1,7,80,1,13,0,87,0,"president bush united state authorized nsa surveillance citizens, bypassing court warrant"
0,2,3,44,5,11,1,47,0,'beauty' still box office beast 'power rangers' open #2
0,1,4,39,1,8,0,43,0,"semi truck crash viaduct buffalo, new york"
0,1,1,55,1,9,0,56,0,"australian missing full sport coverage, medium outlet say"
0,3,1,33,4,6,4,34,0,"4,000-year-old egyptian mummy get face-lift"
0,3,12,52,2,12,2,64,0,83% america's top high school science student child immigrant
0,2,8,45,1,7,0,53,0,apple contemplating legal action trump's immigration ban
0,1,12,32,2,10,0,44,0,"make room, rich little cynics, mtv want good"
0,1,7,34,0,9,0,41,0,setback bay area add pain chronicle
0,2,4,64,2,13,1,68,0,sources: ene kanter could miss 2 month x-ray reveal fractured forearm
0,2,3,57,1,8,0,60,0,american disapprove approve trump's handling transition
0,3,13,53,1,13,4,66,0,"paris, madrid among leading capital city agree ban diesel vehicle 2025"
0,3,7,43,2,8,0,50,0,"facing trump, mexican think unthinkable: leaving nafta"
0,2,10,37,1,9,0,47,0,bill clinton say hell nix paid speech hillary win
0,3,8,43,2,8,0,51,0,tired volatility? mexico newest stock almost never move
0,2,16,54,0,13,0,70,0,iit helping indian army detect underground tunnel used pak terrorist
0,3,6,58,4,11,0,64,0,"german army probe alleged neo-nazis 'heil hitler' greeting, nazi salute"
0,3,11,50,4,10,0,61,0,trump say need daily intelligence briefing he's 'smart'
0,1,3,32,2,5,0,35,0,migrant worker domino pizza 'slavery'
0,3,2,68,3,14,4,70,0,clergy dont believe organized religion? humanist think 2017 time grow.
0,3,3,61,0,13,0,64,0,apple sued adding safety fix prevent use facetime driving
0,3,9,34,1,9,4,43,0,remember: tax return due date different 2017
0,2,5,54,1,10,0,59,0,dralo? drake jennifer lopez revive romance rumor snuggle pic
0,2,11,69,1,13,0,80,0,"csiro, energy network australia back emission trading scheme rets lower power price"
0,2,1,42,1,9,0,43,0,bull shark steal fish right fisherman's line
0,3,2,52,5,10,0,54,0,war science doesnt hurt scientists. hurt everyone.
0,3,3,54,1,10,0,57,0,gilberto nunez case: judge harsh word dentist sentencing
0,2,6,36,0,8,2,42,0,undocumented immigrant live 20 metro area
0,3,17,56,1,15,3,73,0,mass marriage 104 differently-abled couple took place mp set new world record
0,2,2,56,1,10,0,58,0,trump brexit left progressive aghast emboldened
0,1,5,32,0,7,0,37,0,dose skepticism government spending
0,2,6,45,1,6,0,51,0,trump brought special-counsel investigation
0,3,2,54,1,12,0,56,0,twitter adding pre-roll ad periscope warms profit
0,2,1,46,1,6,0,47,0,plastic surgeon often miss patients' mental disorder
0,1,1,30,1,5,2,31,0,vanuatu hit 7.2 magnitude earthquake
0,2,10,40,2,9,0,50,0,middle-income wage earner need w: cut business tax first
0,3,5,41,1,9,0,46,0,trump cabinet: rex tillerson sworn top u diplomat
0,2,15,67,1,12,0,82,0,milo speech cancelled violent north dakota pipeline protester threaten event breitbart
0,1,5,28,1,6,0,33,0,"building coalitions, one issue time"
0,3,4,63,4,9,0,67,0,world biggest dinosaur footprint discovered australia jurassic park
0,3,2,18,0,2,0,20,0,christmas homecoming
0,1,4,24,2,7,2,28,0,british author j. g. ballard dead 78
0,3,14,51,1,15,2,65,0,"catch virgil abloh guillaume berg paris, il episode 38 ovo sound radio"
0,1,2,23,2,4,0,25,0,u.s. job picture improving
0,2,12,53,2,9,0,65,0,"demonetisation government's idea ours, rbi tell parliamentary panel"
0,2,2,55,0,8,0,57,0,kyrgyzstan authority identify suspect russia subway bombing
0,2,3,57,0,11,0,60,0,wedding dress made taco bell burrito wrapper anything mild
0,1,1,29,1,3,0,30,0,canada's supercomputer go online
0,3,13,61,2,13,0,74,0,steve bannon allegedly made million 'seinfeld' larry david knew nothing
0,2,1,33,0,6,0,34,0,netflix want start selling merch
0,3,3,52,2,10,0,55,0,carhullan army: near-future struggle feel close
0,1,5,54,0,10,4,59,0,new zealand secures hosting right world netball championship 2007
0,3,4,61,1,13,0,65,0,johnny depp amber heard finalise bitter divorce actress get dog
0,2,9,47,1,11,0,56,0,police: suspect death lawrence teenager tried adult
0,2,11,50,1,11,0,61,0,chicago blackhawks close stanley cup another one-goal victory
0,1,7,45,0,8,0,52,0,baseball investigator meet alex rodriguez sunday
0,3,5,59,2,9,0,64,0,stepdaughter: ex-dodgers star pedro guerrero fighting life stroke
0,3,5,74,4,15,0,79,0,david davis's senior official 'tried block' appointment britain's ambassador eu
0,1,6,43,2,7,0,49,0,"details, little insight, craigslist killing suspect"
0,2,10,49,3,11,0,59,0,putin rouhani condemn u.s. airstrikes syria phone call: kremlin
0,3,4,38,4,7,0,42,0,timeline: evolution trump travel ban [video]
0,1,3,43,2,6,0,46,0,oculus unveils new prototype 'virtual reality' headset
0,3,2,56,0,7,0,58,0,lslamic state claim responsibility istanbul nightclub attack
0,1,5,37,2,7,0,42,0,two winner confirmed u 'mega millions' jackpot
0,3,6,28,2,5,0,34,0,brain 'superagers' shrink slowly
0,3,2,45,0,9,3,47,0,japanese fleet return antarctic hunt 333 whale
0,3,3,40,0,9,0,43,0,ai revolution may simply job destroyer
0,1,1,21,0,3,0,22,0,sudan adopts new currency
0,3,9,42,0,9,0,51,0,saudi arabia bar foreigner mall job help citizen
0,1,5,34,0,7,2,39,0,president costa rica contract h1n1 swine flu
0,1,8,37,2,9,0,45,0,"leader puerto rican people army shot, killed fbi"
0,1,5,33,0,6,0,38,0,index economic activity declined march
0,3,8,35,1,7,0,43,0,stacey dash's ouster fox news delight twitter
0,2,8,39,2,8,0,47,0,military: first-known combat death since trump office
0,3,11,44,2,10,0,55,0,house gop thwart democrat pursuit donald trump tax return
0,3,12,48,2,8,0,60,0,updated nfl division-by-division team ranking early free agency
0,2,3,44,4,8,0,47,0,madonna say f**ked donald trump election win
0,1,8,32,1,9,0,40,0,"end, henrik lundqvist come save short"
0,3,13,44,3,13,1,57,0,"spotify moving u.s. hq 4 world trade center, adding thousand new job"
0,1,9,37,1,11,1,46,0,maryland hand no. 2 north carolina third loss row
0,1,4,40,0,6,0,44,0,radical group declares tsunami punishment god
0,3,12,47,1,12,2,59,0,21 cartoon people sharing response trump refugeeban
0,2,2,43,1,7,0,45,0,trump refuse answer reporter's question russia
0,2,2,47,1,10,0,49,0,"air force face pilot shortage, training challenge"
0,1,3,36,0,8,7,39,0,taiwan cull 18000 chicken due h5n2 virus outbreak
0,2,5,54,1,9,0,59,0,"russian passenger plane crash black sea, defense ministry say"
0,2,8,42,1,7,0,50,0,right-wing equivalent political correctness
0,1,1,45,0,6,0,46,0,zimbabwe opposition claim early victory election
0,3,3,45,0,8,0,48,0,airbnb continues push trip asian country
0,3,13,46,4,12,0,59,0,joan baez tear 'future dictator' donald trump new 'nasty man' song
0,2,11,59,3,14,0,70,0,"setback sanctuary city order, trump attack messy federal court system"
0,1,15,52,2,9,0,67,0,canadavotes: ndp incumbent wayne marston running hamilton eaststoney creek
0,2,12,58,2,11,0,70,0,austria reject far-right presidential candidate norbert hofer new york time
0,3,6,39,1,9,0,45,0,trump impulse carry force presidency
0,1,7,19,3,4,0,26,0,thornton help l.s.u. edge butler
0,1,7,31,0,7,0,38,0,north korea could face new round sanction
0,2,4,49,0,12,0,53,0,tim cook era apple morality much innovation
0,3,11,47,2,9,0,58,0,cash-strapped puerto rico give rum company big tax rebates: report
0,2,7,66,1,15,0,73,0,"julie bishop call u increase role region, raise concern south china sea"
0,2,5,31,2,6,0,36,0,public supreme court: dont gut obamacare
0,1,5,32,0,6,0,37,0,tropical storm gabrielle eye u east coast
0,3,5,52,0,10,0,57,0,santa claus busy preparing christmas lapland home finland
0,1,3,48,2,7,0,51,0,cricket: india defeat england fifth one-day international
0,3,1,62,3,8,0,63,0,college apologises 'slut-shame' prom poster appropriate dress
0,1,9,35,4,5,0,44,0,finger-pointing across washington a.i.g. bonus
0,1,3,30,0,5,1,33,0,hurricane rick becomes category 5 storm
0,3,9,40,1,10,0,49,0,hell conor mcgregor wear grand national?
0,2,3,75,2,16,0,78,0,gibraltar accuses eu behaving like 'cuckolded husband taking children'
0,3,11,50,0,13,0,61,0,united take added step win back customer avoid ugly event
0,3,6,36,1,5,0,42,0,marathon petroleum accelerate asset drop-down
0,3,11,44,0,12,0,55,0,penny may break tie betsy devos confirmation vote today
0,2,1,65,1,10,0,66,0,"texas release abortion booklet debunked cancer link, suicide risk claim"
0,1,5,51,0,10,0,56,0,fox news fare poorly investigation medium edits wikipedia
0,3,2,61,0,12,0,63,0,using former player practice latest way alabama stay ahead curve
0,2,6,36,1,6,0,42,0,army public website hacked unknown intruder
0,1,3,45,0,6,0,48,0,convicted murderer leonard peltier denied parole
0,1,2,80,1,16,0,82,0,"u government report decline teen birth rate binge drinking, rise poverty drug abuse"
0,2,8,44,2,9,0,52,0,alibaba named notorious market blow overseas push
0,1,3,34,2,6,0,37,0,u.s. senate defeat bill banning gay marriage
0,2,12,43,3,11,0,55,0,mischa barton lawyer warns alleged sex video: find
0,1,6,35,0,6,0,41,0,concern rise behavioral targeting ad
0,1,4,58,1,12,2,62,0,"sugar silo centre georgia, u refinery blast killed 13 demolished"
0,1,3,45,1,9,0,48,0,"one dead bus bicycle crash hampshire, england"
0,3,1,39,0,6,0,40,0,heisman race feature plenty unexpected
0,1,8,28,2,9,2,36,0,"vote f-22 jet, panel defies veto threat"
0,2,3,67,2,13,5,70,0,"brexit: paris could lure 20,000 finance job britain move starting within week"
0,2,16,66,1,15,0,82,0,"despite innumerable petitions, china going host barbaric yulin dog meat festival june"
0,2,9,44,2,13,0,53,0,"free trade warning imf, wto world bank say must defended"
0,1,4,31,0,5,0,35,0,space shuttle discovery land florida
0,3,2,35,5,5,2,37,0,tennant creek deluged 'one-in-50-year' flood
0,3,2,39,1,7,0,41,0,trump's russia claim drive week politics
0,1,1,21,0,2,0,22,0,wikipedia suffers outage
0,2,12,42,2,12,0,54,0,study prof it: dog dont like people mean owner
0,2,10,41,8,8,0,51,0,u.s.-backed moderate syrian rebels: beheading boy mistake
0,3,4,63,1,8,0,67,0,philippine president rodrigo duterte's critic losing powerful position
0,2,12,28,2,12,5,40,0,"$85,000 gun piece statue liberty"
0,1,3,30,0,7,3,33,0,thai pm sue newspaper 500 million baht
0,2,3,45,2,9,0,48,0,church accuses mexican work trump wall 'treason'
0,1,2,29,0,5,0,31,0,ratko mladi arrested war crime
0,2,11,49,2,10,0,60,0,texas house approves strict sanctuary city ban tough jail penalty
0,2,10,37,0,8,0,47,0,fda make dangerous abortion pill even dangerous
0,1,10,33,0,9,0,43,0,npd group give perfume maker whiff sale data
0,2,3,65,3,13,0,68,0,'trumpgrets' tumblr page trump supporter can't take anymore
0,1,5,45,1,9,0,50,0,"chrysler file bankruptcy, fiat group spa run company"
0,3,12,65,2,12,0,77,0,wyclef jean reportedly handcuffed l.a. deputy mistaken robbery suspect
0,1,7,32,1,5,0,39,0,would-be parent find surrogate agency closed
0,3,3,35,2,7,0,38,0,tinie tempah 'true style' british fashion
0,3,2,85,4,17,0,87,0,"global warming speeding arctic's 'nature clock' playing havoc wildlife, expert warn"
0,1,3,60,1,9,0,63,0,tropical storm zeta becomes second cross-season tropical storm history
0,1,1,38,0,7,0,39,0,high school order shot glass prom favor
0,3,11,51,1,13,0,62,0,new l alert: tyga sued allegedly ordering crew beat process server
0,2,10,41,1,9,0,51,0,oscar actually battle trumpsamerica
0,2,3,69,3,13,0,72,0,yahoo scanned user incoming email behalf u.s. intelligence official
0,1,1,23,0,5,0,24,0,kenya peace talk put hold
0,2,5,31,1,5,0,36,0,australia's tech underground come life
0,3,4,51,2,10,0,55,0,oscar mix-up inspires cinema's genius la la land prank audience
0,1,2,48,1,11,2,50,0,"ten reported dead, 50 injured pipeline blast iran"
0,1,2,59,1,10,0,61,0,"comic relief fund allegedly invested arms, alcohol tobacco firm"
0,2,7,27,2,9,6,34,0,new year nails: 17 manicure idea ring 2017
0,2,5,53,0,9,0,58,0,south korean prosecutor call sk group official questioning
0,2,1,35,0,8,0,36,0,robot scab coming take job
0,1,2,50,1,9,0,52,0,house lord approve same-sex marriage bill third reading
0,2,8,80,1,18,0,88,0,steve bannon reince priebus made rare joint appearance cpac dispel notion dont get along
0,1,4,34,3,8,2,38,0,halifax bank: uk house price rose 0.6% july
0,2,10,53,3,9,0,63,0,"crayola retires dandelion crayon, drop hint replacement [video]"
0,1,4,62,5,11,3,66,0,"update: u.s. army intelligence detected 9/11 terrorist year before, say officer"
0,2,5,44,2,11,0,49,0,"ancient city xian, china hope restart silk road"
0,2,2,58,2,11,3,60,0,twitter celebrates trump's first 100 day savage burn expect
0,1,7,35,0,7,0,42,0,justice explore role race may play employment
0,1,2,46,0,9,2,48,0,pennsylvania man admits june 25 beating elderly woman
0,2,9,26,4,9,0,35,0,wait. hillary clinton? let go say hi.
0,3,3,58,2,11,0,61,0,'not enough coffins' deadly taliban attack afghanistan army base
0,2,8,31,0,8,0,39,0,eu leader pledge unity trump waver bloc
0,1,7,25,0,7,0,32,0,bird take cue eye human
0,2,10,23,4,9,0,33,0,"lady gagas joanne, pop stage"
0,3,9,42,2,7,0,51,0,three self-made woman overcame life's greatest obstacle
0,1,3,57,0,11,0,60,0,fan mourn death celebrate life michael jackson around world
0,2,18,65,2,21,1,83,0,watch newsy season 1 web exclusive free online border wall would bad news wild cat yahoo view
0,2,13,42,1,12,0,55,0,donald trump's fight hotel worker la vega come end
0,1,5,74,2,12,0,79,0,"australian rule football: bairnsdale join gippsland league, play first game warragul"
0,1,2,29,0,5,0,31,0,uk hold referendum voting system
0,2,2,17,3,3,0,19,0,maybe trump isnt lying
0,1,7,35,0,8,0,42,0,lawsuit madoff case add detail fraud
0,1,2,33,0,4,0,35,0,third major earthquake rock california
0,2,5,43,2,10,2,48,0,mexican official: cartel send $64b drug u annually
0,2,1,50,3,8,0,51,0,trump tax reform could depend little-known scoring panel
0,1,6,28,0,7,0,34,0,memory pat tillman life phoenix
0,2,8,72,1,15,0,80,0,twitter stock bounce bos dick costolo quits co-founder jack dorsey named interim ceo
0,1,8,36,2,7,0,44,0,"myanmar, celebrating water, letting steam"
0,2,2,61,1,13,0,63,0,patagonia pull utah trade show protest state public land grab
0,3,7,22,4,6,7,29,0,2017 ford f-350: country boy rolls-royce
0,1,1,40,1,6,2,41,0,7.0 magnitude earthquake strike haitian coast
0,2,6,27,1,6,0,33,0,confuse italy brexit trump
0,2,7,43,1,6,0,50,0,"glenn beck defends mark zuckerberg, attack conservative"
0,1,7,42,1,5,0,49,0,study reveals change among second-generation hispanic
0,3,16,64,0,15,0,80,0,bigg bos contestant swami om likely arrested denied bail molestation case
0,1,4,41,0,8,2,45,0,argentine admiral emilio eduardo massera dy age 85
0,1,2,50,2,5,0,52,0,"european commission praise ""flexicurity"" employment policy"
0,1,10,22,3,6,0,32,0,i.r.s. deems ubs executive fugitive
0,1,5,41,0,8,0,46,0,tail air france jet recovered atlantic ocean
0,1,3,58,0,10,0,61,0,least nine missing russian military plane crash pacific
0,2,14,55,1,15,0,69,0,"soulja boy appears get robbed wild ig live video, chris brown twitter react"
0,3,8,39,3,8,1,47,0,watch: 7 painfully awkward minute jerry lewis [video]
0,1,5,26,0,6,4,31,0,jenson button win 2009 monaco grand prix
0,2,3,34,1,6,0,37,0,strange cloud linger saturn's moon titan
0,2,3,39,1,6,0,42,0,washington prepares donald trump's big moment
0,3,13,47,2,11,0,60,0,dem state rep warns illegal immigrant upcoming ice 'raid' insider
0,1,3,35,1,6,4,38,0,2008 leisure taiwan: safety first sporting
0,3,3,52,3,9,0,55,0,brexit: uk carmaker 'sitting hands' rather investing
0,3,4,43,0,11,0,47,0,son u man sought nazi case want evidence released
0,2,1,54,1,10,0,55,0,brief history famous father hoops-playing son
0,1,5,22,1,5,0,27,0,n. korea issue threat uranium
0,2,2,75,3,16,0,77,0,extremely rare 'fire rainbow' make sky look like burning spotted singapore
0,3,8,32,2,7,0,40,0,"new college study advises: sleep late, learn"
0,1,1,30,0,6,3,31,0,163 dead lead poisoning nigeria
0,2,2,37,1,6,0,39,0,"kanye west released hospital, source say"
0,1,10,35,3,10,1,45,0,l.s.u. rally win game 1 college world series final
0,2,3,54,0,11,0,57,0,man saved child house fire face deportation uk
0,2,2,77,2,12,0,79,0,north korea say test launch intercontinental ballistic missile 'anytime anywhere'
0,3,10,28,2,7,0,38,0,air france-klm profit climb fuel-cost drop
0,1,8,33,2,9,3,41,0,mike rodgers carmelita jeter win u.s. title 100
0,1,3,37,1,8,0,40,0,"six people die bus crash near phoenix, arizona"
0,3,5,59,5,14,0,64,0,hard time whole foods: 'people say pretentious people. see why'
0,1,4,53,1,10,7,57,0,"bristol organic food festival 2008 lauched, 100 thousand expected attend"
0,1,5,28,0,7,1,33,0,geithner face test group 7 meeting
0,3,6,29,3,7,0,35,0,trump: 'sometimes prime pump'
0,1,11,27,2,7,0,38,0,"ucla defeat usc, end trojans' bcs title hope"
0,2,7,45,4,8,0,52,0,zombie mall bonobos: america retail transformation
0,3,11,51,4,8,2,62,0,3.6-million-year-old early human footprint discovered tanzania
0,1,4,62,0,9,0,66,0,former ecuadorian football referee byron moreno arrested drug smuggling
0,2,2,51,1,10,0,53,0,"trump greets netanyahu smiles, handshake jolt two"
0,1,4,30,0,6,0,34,0,robot zoe detects life atacama desert
0,3,11,40,1,11,0,51,0,devos tax credit vouchers: arizona show go wrong
0,2,5,60,3,12,0,65,0,syria's assad call u troop 'invaders' still hope cooperate trump
0,2,15,43,2,13,0,58,0,man led police crazy l.a. pursuit driver trained bymilitary
0,1,5,32,0,9,0,37,0,oil company bp pay gulf mexico spill
0,2,4,75,0,13,0,79,0,johnny manziel deleted twitter account offering trump advice using social medium
0,3,4,28,0,7,0,32,0,bus catch fire george st sydney
0,3,3,55,1,14,0,58,0,"day wife died, teddy roosevelt wrote diary"
0,2,2,62,5,10,0,64,0,britain's cushiest jail: super-prison inmate 'men offenders'
0,1,5,26,0,7,0,31,0,share day choppy trading
0,2,1,40,1,9,4,41,0,dollar highest since 2003; oil fall choppy trade
0,3,9,51,3,10,0,60,0,'beauty beast' introduce disney's first openly gay character
0,2,6,27,0,6,0,33,0,germany set plan rein extremist
0,2,9,56,0,9,0,65,0,california vow continue tightening air regulation despite trump order
0,3,11,35,1,13,0,46,0,cook love instant pot? bought one find
0,1,7,37,0,8,0,44,0,one bid organize nurse face setback congress
0,2,18,62,2,17,0,80,0,"government go offensive naxals, asks result next weeks!"
0,3,10,45,1,10,3,55,0,emirate say flight delayed delta withheld $300 spare part
0,3,8,29,2,8,0,37,0,online islamist cast u.s. ban war islam
0,2,7,42,1,8,0,49,0,apnewsbreak: new orleans take confederate statue
0,2,6,38,1,7,0,44,0,spacex launch rocket nasa's historic moon pad
0,3,12,50,1,11,0,62,0,"democrats, top ethic official urge gop slow confirmation process"
0,1,8,48,1,10,2,56,0,former louisiana tech university president f. jay taylor dy aged 87
0,2,1,38,0,10,4,39,0,comic book movie coming 2017
0,1,6,39,1,10,4,45,0,abel prize 2008 awarded john g. thompson jacques tit
0,3,17,61,1,13,0,78,0,troubling issue linda mcmahon's time wrestling ceo go unmentioned senate hearing
0,3,9,23,0,8,0,32,0,pop culture made love fatself
0,1,8,33,2,8,0,41,0,oil industry brace u.s. trial right abuse
0,2,11,43,2,11,2,54,0,"21 perfect tumblr post badass woman ""harry potter"""
0,2,8,33,1,8,0,41,0,iraqi troop edge deeper mosul caution
0,1,4,36,0,4,0,40,0,andalusian strawberry harvest battleground
0,3,7,29,0,6,0,36,0,three indisputable trait true leader
0,2,11,58,3,14,0,69,0,mike posner talk new mansionz project preview poetry book 'sway morning'
0,3,7,49,0,9,0,56,0,aclu file complaint jeff session russia testimony
0,1,3,27,0,5,0,30,0,white house cut hubble budget
0,3,8,42,2,9,0,50,0,'hamilton' cast member perform super bowl pregame show
0,1,4,39,1,9,0,43,0,"us, north korea form agreement search war dead"
0,3,11,53,6,14,6,64,0,"nokia 3310, everyones favourite phone back! nokia 3 5 android phone also revealed!!"
0,2,12,43,1,11,0,55,0,"jack warner responds john oliver, get upstaged music"
0,2,11,37,3,9,0,48,0,carney's new u.k. labor market theory pass first wage test
0,1,6,21,2,5,0,27,0,u.s. win provides special memory
0,2,4,60,1,11,2,64,0,u stress level highest 10 year following donald trump's election victory
0,2,7,51,0,10,0,58,0,boutique bank moelis win advisory role mammoth saudi aramco ipo
0,2,8,42,8,9,0,50,0,"deal week: intel buy mobileye; what's softbank's ""vision''?"
0,1,4,29,0,6,0,33,0,first chinese tourist arrive uk
0,1,5,31,1,6,0,36,0,"rail tunnel collapse gerrards cross, uk"
0,1,2,37,1,9,2,39,0,forest fire burn greece; death toll nears 50
0,3,9,43,1,11,0,52,0,ivanka trump new washington home belonged putin foe
0,2,4,31,2,8,6,35,0,"wall street value tesla motor $620,000 per car"
0,3,10,42,0,8,0,52,0,turkey catapulted india government revise gdp math
0,2,7,43,1,10,0,50,0,japan caught crossfire trump assault mexico
0,3,3,46,0,10,0,49,0,austria pass bill seize house adolf hitler born
0,1,1,46,0,8,0,47,0,new rocky planet discovered orbit around nearby star
0,2,8,37,4,8,2,45,0,"well fargo told rehire whistle-blower, pay $5.4 million"
0,1,8,45,1,10,0,53,0,boxer ricardo williams jr. leaf prison return ring
0,1,4,37,0,7,0,41,0,ash iceland volcano could affect uk flight
0,2,1,46,2,9,2,47,0,"60 years, nuclear fusion finally poised deliver?"
0,3,6,57,5,14,0,63,0,i'm frustrated democrat. i'm sure obama could beaten trump. here's
0,3,14,48,2,10,0,62,0,iraq launch offensive re-take western mosul isis: prime minister
0,1,6,46,4,10,2,52,0,market maker bernard l. madoff arrested $50b 'giant ponzi scheme'
0,2,2,42,0,8,0,44,0,one million google account hit malware
0,3,8,42,4,10,0,50,0,wallace: gov't shutdown would 'disaster' trump insider
0,3,3,63,0,12,0,66,0,former current fox news employee speak racial discrimination suit
0,3,2,34,4,8,1,36,0,shyamalan's 'split' still #1 box office
0,1,1,44,1,7,3,45,0,alleged 9-11 conspirator withdraw offer guilty plea
0,1,6,22,0,4,0,28,0,uk mobile data network collapse
0,3,8,44,2,9,4,52,0,"chechnya police arrest 100 suspected gays, 3 killed: russian report"
0,1,6,34,0,7,0,40,0,war hero vietnam force government listen
0,1,3,47,0,7,0,50,0,alaska senator ted stevens indicted corruption scandal
0,1,2,36,0,5,0,38,0,suicide bomber kill sixteen afghanistan
0,1,7,30,1,7,0,37,0,"year storm, subtle change myanmar"
0,2,4,87,0,15,0,91,0,key kardashian jewellery suspect cocaine smuggling ring saudi prince medellin drug cartel
0,1,4,36,1,5,3,40,0,scotland's dario franchitti win indianapolis 500
0,3,2,78,1,13,1,80,0,"san bernardino teacher, 8yo student gunned estranged husband special need classroom"
0,1,4,66,2,10,0,70,0,nearly three million contraband cigarette seized canadian u.s. authority
0,1,4,58,0,11,0,62,0,pratibha patil becomes first woman president republic india
0,1,7,58,0,9,0,65,0,justice iftikhar muhammad chaudhry reinstated chief justice pakistan
0,1,3,21,1,2,0,24,0,german president re-elected
0,2,1,63,2,15,3,64,0,law professor warning: closer oligopoly point 100 year
0,2,6,36,0,7,0,42,0,draymond green slur enraged lebronjames
0,1,9,24,3,8,0,33,0,bank east asia buy taiwan unit a.i.g.
0,3,3,55,0,9,0,58,0,woman stand together london honour westminster attack victim
0,1,1,36,1,5,2,37,0,6.0 magnitude earthquake rock eastern turkey
0,3,3,48,2,9,2,51,0,body missing 20-year-old toni anderson found submerged car
0,3,1,59,3,9,0,60,0,"university admit student 'almost illiterate', lecturer warn"
0,2,8,14,9,8,4,22,0,"6 p.m., married. 7:30 p.m., onstage."
0,1,5,50,3,7,0,55,0,england's historic weston-super-mare grand pier destroyed fire
0,1,7,31,0,8,0,38,0,data show china relies growth home
0,3,2,80,0,14,0,82,0,torrent water flood shop leaf thousand without water blackheath pipe burst
0,1,9,38,1,9,0,47,0,"myanmar close trial dissident, aung san suu kyi"
0,2,10,65,3,13,5,75,0,"border surge: apprehension decline 23,767 illegals caught border last month breitbart"
0,3,13,43,5,13,0,56,0,"trump tell g.o.p. never, demanding house vote health bill"
0,3,7,34,0,7,0,41,0,top pooch fetch prize westminster dog show
0,1,1,29,0,7,2,30,0,13 dead cargo plane crash congo
0,1,6,33,1,6,0,39,0,"many televisions, one common experience"
0,3,14,50,3,12,0,64,0,called 'filthy jew rat donald trump tiptoed around anti-semitism
0,1,2,62,2,8,0,64,0,democrat staffer obtained maryland lt. governor's credit report illegally
0,2,2,50,2,8,2,52,0,"15 official vehicle stolen state dept., prosecutor charge"
0,2,2,43,0,8,0,45,0,detroit police find body two child freezer
0,1,3,46,0,9,0,49,0,inter milan cancel tour england due safety concern
0,1,7,30,0,7,0,37,0,tibetan monk tell tale escape china
0,1,8,38,1,9,0,46,0,"missouri, free speech fight highway adoption"
0,2,12,48,2,10,0,60,0,china population crisis: new two-child policy fails yield major gain
0,2,2,29,2,4,0,31,0,"betsey johnson, fashion's free spirit"
0,3,12,52,0,12,3,64,0,meal wheel see 500 percent surge volunteer since budget cut proposed
0,2,2,33,0,6,0,35,0,debbie reynolds justbeauty
0,1,6,18,3,6,0,24,0,good (or evil) google?
0,3,13,62,1,15,0,75,0,ray lewis special guest pre-inauguration party donald trump hosted jim brown
0,2,3,46,1,7,0,49,0,celebrity chef react donald trump electoral victory
0,3,1,44,1,8,0,45,0,uninhabited island's famed swimming pig dying
0,3,10,61,1,15,2,71,0,watch residente talk future music traveling 10 country next project
0,3,6,32,1,10,7,38,0,trump wrote $100 million business loss 2005
0,1,3,46,0,9,2,49,0,man arrested connection july 21 london bomb attempt
0,3,6,58,1,11,0,64,0,marine a:sgt alexander blackman must wait wednesday bail decision
0,3,9,52,3,13,2,61,0,"james comey: nearly 70% u voter disapprove fbi director, find poll"
0,1,5,26,0,8,0,31,0,profit medco loss tenet
0,2,2,55,4,13,0,57,0,"sex doesnt sell more, activism does. dont big brand know"
0,2,17,54,5,13,0,71,0,"tv series first female mlb pitcher canned one, low-rated season breitbart"
0,1,3,51,0,9,0,54,0,brazilian call arrest uk policeman shooting death
0,3,5,33,0,6,0,38,0,state ease restriction voting felon
0,3,7,38,2,9,0,45,0,fact check: trump misleading word energy job
0,1,1,72,2,10,0,73,0,'completely irresponsible' woman called emergency service report theft snowman
0,2,12,49,4,10,0,61,0,cleveland cavalier j.r. smith injury: cavalier sg injures thumb vs. buck
0,3,5,85,4,21,0,90,0,using enough water cook rice? expert warns could risk arsenic poisoning not...
0,2,2,55,3,8,0,57,0,faceapp apologises racist filter lightens user skintone
0,2,10,30,2,8,0,40,0,cdc declares texas town 'yellow' zika virus zone
0,2,2,41,1,8,0,43,0,britain lose privileged place fifa's top table
0,1,6,31,0,8,0,37,0,qatar said pondering stake porsche
0,3,1,29,1,5,0,30,0,duck boat tour ear-bleeding fun
0,1,7,32,2,6,0,39,0,afghan villager describe chaos u.s. strike
0,3,6,52,5,12,0,58,0,"husband murdered mp jo cox: 'i'll remember dead officer, killer'"
0,3,3,31,0,7,6,34,0,2017 offseason prediction 32 nfl team
0,3,9,42,3,10,2,51,0,"kunduz attack november killed 33 civilians, u.s. military say"
0,2,6,24,0,5,0,30,0,quirky home show true color
0,2,3,54,5,11,4,57,0,"'rogue one' 2nd-best december opening weekend ever, $155 million"
0,1,4,46,3,9,0,50,0,"prime minister, police chief urge london 'get moving again'"
0,2,6,41,4,10,2,47,0,arsenal 2-1 manchester city: fa cup semi-final happened
0,3,13,54,3,9,0,67,0,"untold story kobe buffalomeat, cfb recruit-turned-social medium sensation"
0,1,5,52,2,10,0,57,0,israeli website report speculation u.s. attack iran april
0,3,5,49,4,8,0,54,0,donald trump invite press off-the-record session mar-a-lago
0,2,6,59,1,8,0,65,0,academy award retains pricewaterhousecoopers despite best picture mix-up
0,2,6,30,1,6,0,36,0,thehighprice non-intervention syria
0,3,5,58,3,13,0,63,0,trump plan move u.s. embassy jerusalem could help peace process
0,2,8,31,3,6,0,39,0,"boosted trump, europe anti-eu party unite"
0,1,2,41,0,6,0,43,0,suicide bomber kill twelve northwest pakistan
0,2,1,43,0,7,0,44,0,obama pause press conference help sick reporter
0,2,5,71,1,15,4,76,0,intriguing conspiracy theory white house would leak trump's 2005 tax list
0,1,8,28,1,8,0,36,0,"amid poor auto ad sales, reason upbeat"
0,1,4,32,0,6,0,36,0,shooting software stardom iphone
0,3,13,56,1,14,2,69,0,71 percent drop apple watch sales? cook say thanksgiving sale best ever
0,3,13,55,3,13,1,68,0,"9 quote bollywood's loved aamir khan, speak volume humility!"
0,3,2,40,0,11,0,42,0,eye tesla face biggest hurdle yet
0,3,21,69,6,19,4,90,0,"kim-ii sung's birthday, north korea allowed journalist in. charged $2,500 seven day access"
0,3,3,70,6,14,1,73,0,'i love mommy': heartbroken mother share 4-year-old son's final moment cancer battle
0,2,4,40,1,9,0,44,0,need know sunday's elite eight game
0,3,7,37,0,7,0,44,0,bodybuilder banned gym mocking older woman
0,1,12,25,3,7,1,37,0,panasonic gh1 merges s.l.r. photo hd video
0,1,6,32,0,6,0,38,0,video lead london police suspend officer
0,3,2,80,1,14,0,82,0,stunning new map show every lake around world: researcher reveal complete database yet
0,2,13,33,0,9,0,46,0,youngest kid class higher risk adhd diagnosis
0,1,7,21,2,7,5,28,0,"posting loss, bt group trim 15,000 job"
0,2,12,39,0,12,4,51,0,india set triple amount nuclear power produce 2024
0,3,8,50,3,9,0,58,0,clerical sexual abuse: pope asks forgiveness monstrosity book
0,2,6,29,1,5,0,35,0,planned parenthood doesnt need tax
0,3,10,31,4,9,0,41,0,"m.l.b. labor deal struck, averting work stoppage"
0,3,3,49,2,9,0,52,0,former google exec call trump travel ban 'enormous problem'
0,3,4,65,4,7,0,69,0,backup-dancer-turned-football-coach energizes player mc hammer dance move
0,3,8,23,1,7,0,31,0,here's keep ray dalio night
0,2,8,25,0,7,0,33,0,happiest city work right
0,2,10,50,1,10,0,60,0,nate dogg's college football playing son naijiel arrested drug sting
0,1,9,28,3,8,0,37,0,s.e.c. chief try stake role overhaul
0,3,7,51,1,9,0,58,0,uk parliament attack: isi sympathizer celebrating social medium
0,2,2,53,2,10,0,55,0,"france becomes latest target, election hack new normal?"
0,2,4,51,2,8,0,55,0,rainbow 'ziggy stardust' snake among new mekong delta discovery
0,3,1,52,1,8,0,53,0,missouri governor-elect say wife robbed gunpoint near home
0,1,7,34,0,6,0,41,0,value fund manager see big opportunity ahead
0,2,9,44,0,8,0,53,0,french vogue make history first transgender cover model
0,2,2,61,0,13,0,63,0,praying drinking urine save nun stuck rome elevator three day
0,3,2,85,3,14,0,87,0,'antacids' tackle climate change? scientist say aerosol could cool planet without ozone damage
0,3,8,43,2,9,0,51,0,"rex ryan fired bills: latest details, comment reaction"
0,2,9,45,1,11,0,54,0,russian hacking inquiry donald trump best interest
0,3,2,33,2,5,0,35,0,'smartphone toilet paper' tokyo airport
0,3,2,59,0,11,0,61,0,obama administration pay billion marine affected toxic water
0,2,2,68,2,14,0,70,0,"child autism taught us: love abandon, laugh"
0,2,7,35,0,6,0,42,0,kennedy invested alongside donald trump
0,1,5,72,3,10,0,77,0,"seismologist mario pardo rebuke notion pichilemu, chile experiencing ""seismic swarm"""
0,1,2,54,1,9,0,56,0,"crucifix displayed state schools, european court rule"
0,2,5,45,1,7,0,50,0,update: gunman hospitalized shooting near u capitol
0,3,15,57,3,14,1,72,0,"deadmau5 drop another hip-hop track shotty horroh, one way crazy: listen"
0,3,3,22,0,6,3,25,0,jcpenney close 140 store
0,1,7,40,0,8,0,47,0,taliban seize vital pakistan area closer capital
0,2,5,32,1,8,0,37,0,world oldest panda jia jia dy hong kong
0,3,12,45,2,13,0,57,0,beach boys' mike love say he's open working brian wilson
0,2,3,39,4,5,0,42,0,arrested mount kinabalu 'nudist' admits 'stupidity'
0,2,13,33,3,10,0,46,0,parent dont want know whats babysdna
0,2,1,37,1,9,0,38,0,"citi beat bottom line, miss top"
0,3,4,27,3,7,2,31,0,'allo 'allo! actor gorden kaye dy aged 75
0,2,3,37,2,6,0,40,0,donald trump's inauguration: schedule day
0,3,3,38,2,7,0,41,0,kathmandu cravings: top nepal food can't miss
0,2,7,37,0,10,4,44,0,question could reshape worried europe 2017
0,3,10,57,3,13,0,67,0,'fastlove' great choice adele's george michael tribute grammys
0,1,7,48,0,10,0,55,0,nancy pelosi named new speaker u house representative
0,3,3,61,4,15,0,64,0,pope francis: 'no point' going church really believe
0,2,3,53,0,11,0,56,0,new york jewish center reopens second bomb threat one week
0,2,4,47,1,10,0,51,0,eu regulator want know linkedin data unique: source
0,2,19,45,3,10,0,64,0,delingpole: climate change denier executed gently say eric idle
0,1,2,33,0,4,0,35,0,military storehouse explodes near sofia
0,1,5,58,2,9,0,63,0,"uk company ""seriously considering"" gps tracking device school uniform"
0,2,2,22,0,1,0,24,0,presidential inauguration
0,3,6,51,0,10,0,57,0,real australian mormon think book mormon musical
0,2,4,70,3,12,0,74,0,carlos santana suffers beyhive wrath 'out context' quote beyonce's singing
0,2,10,47,1,9,0,57,0,ikea's attempt solve annoying relationship problem
0,2,5,53,3,8,0,58,0,"chelsea handler lead defiant, star-studded women's march sundance"
0,2,12,39,3,10,4,51,0,cpac 2017: activist say trump victory solves everything
0,2,9,39,4,10,0,48,0,mike mechanic premiere 'let fly' title track: listen
0,1,5,29,0,5,0,34,0,police chief killed somalia fighting
0,1,6,38,0,7,0,44,0,abuse photo part agreement military spending
0,2,4,58,2,9,0,62,0,exclusive: reinsurer beechwood explores sale platinum woe source
0,2,4,75,2,15,0,79,0,morgan stanley goldman sachs facing question different reason
0,2,11,63,4,11,0,74,0,"santo domingo, latin america oldest colonial city, spends million rebuild, gentrify"
0,2,2,50,1,8,0,52,0,"icahn say herbalife undervalued, business create job"
0,2,6,44,2,10,0,50,0,"dna profile google manager murder prompt id, police say"
0,1,7,29,2,7,0,36,0,holder want detainee tried u.s.
0,1,3,45,3,7,0,48,0,"four-storey building collapse lagos, nigeria; two dead"
0,1,1,32,0,4,0,33,0,jackson family seeking second autopsy
0,2,4,55,4,11,3,59,0,"u.s. target 200 indian deportation, say india top diplomat"
0,3,3,67,2,14,0,70,0,chicago attorney fired trump published sobering letter 'city fire'
0,3,1,41,1,8,0,42,0,venezuela walk back move strip congress' power
0,2,12,50,2,12,0,62,0,"mitchelle blair, mom allegedly put dead kid freezer, flip court"
0,1,5,44,3,9,0,49,0,jackpot rise 'mega millions' lottery us; break record
0,3,6,29,1,9,4,35,0,battle cheapest tax prep 2017?
0,1,2,48,1,9,1,50,0,new jersey real estate investor charged $2 million theft
0,3,9,64,2,9,0,73,0,"china security regulator signal greater oversight asset managers, brokerage"
0,3,2,67,0,14,0,69,0,man becomes first briton tell police every time start relationship
0,2,5,30,1,6,2,35,0,top 10 heisman trophy candidate breitbart
0,3,15,34,3,9,4,49,0,delingpole: rule righties war-winning manifesto 2017
0,2,11,56,0,12,0,67,0,swedish tabloid ether trump referenced fake terror attack sweden
0,2,1,52,1,11,2,53,0,pregnant mother 12 accused keeping kid waste-filled home
0,2,4,40,0,8,0,44,0,child sex abuser henry clarke tracked canada
0,2,10,52,2,11,0,62,0,bill cosby trial: judge decide whether allow past accusers' testimony
0,3,9,51,0,8,0,60,0,jeff session issue ominous warning state marijuana legalization
0,3,4,49,4,9,0,53,0,'at best delusional': reader react theresa may's brexit speech
0,3,8,33,2,8,1,41,0,5 highlight japan revised gdp report briefly
0,3,4,34,0,7,0,38,0,grading rookie class every nfl team
0,3,8,43,2,8,0,51,0,erdogan say turkey face economic sabotage lira plunge
0,1,5,45,3,10,0,50,0,newcastle united's st. james' park naming right go sale
0,3,13,57,4,9,0,70,0,"sleater-kinney, stephen malkmus decemberists' colin meloy headlining aclu benefit"
0,1,6,43,0,8,0,49,0,gordon brown becomes prime minister united kingdom
0,2,14,52,2,10,0,66,0,greensboro church selling syracuse vs. unc-greensboro shirt ahead nit game
0,3,14,51,5,12,0,65,0,"hugh jackman explains 'logan' ""different universe"" x-men movie"
0,2,2,40,0,7,2,42,0,huawei p10 simultaneously good really boring
0,3,10,49,0,9,0,59,0,neutral investor sentiment rise highest level since election
0,3,8,68,2,12,0,76,0,"adam silver, michael jordan step help repair james dolan-charles oakley relationship"
0,3,4,41,2,11,0,45,0,'sham' u embassy ghana issued fake visa decade
0,3,6,25,3,6,2,31,0,"15 best chappelle show skits, ranked"
0,2,8,43,2,8,0,51,0,texas mosque destroyed early-morning blaze; cause unknown
0,3,10,57,2,11,1,67,0,kim jong-un's half brother reportedly assassinated 2 woman poison needle
0,1,4,23,0,3,0,27,0,sarkozy reshuffle cabinet
0,1,2,38,0,6,2,40,0,expedition 27 crew successfully return earth
0,2,17,62,5,16,0,79,0,"bryshere gray, woody mcclain algee smith working legend bet's 'the new edition story'"
0,3,2,61,0,10,0,63,0,sciatica medication pregabalin found effective placebo
0,1,4,48,0,8,0,52,0,lance armstrong share criticism tour de france director
0,2,3,75,0,13,0,78,0,animated map show u metropolitan area immigrant living illegally
0,2,9,51,0,10,0,60,0,beacon set mood contemplative dance jam billboard lounge
0,3,7,35,1,10,3,42,0,kraft heinz offer buy unilever $143 billion deal
0,3,10,38,1,10,0,48,0,"eu, japan forge ahead trade talk trump give impetus"
0,1,1,36,0,6,0,37,0,beijing crack manhole cover theft
0,2,1,33,1,7,1,34,0,huge gold coin worth $1m stolen museum
0,2,3,51,1,7,0,54,0,trump executive order: u judge temporarily halt deportation
0,1,11,62,2,13,0,73,0,"kathleen sebelius, kansa governor, seen top choice health human service post"
0,3,13,48,4,11,0,61,0,"disney first live-action interracial kiss ""beauty beast"""
0,1,4,28,3,7,2,32,0,int'l football: liverpool beat kaunas 3 1
0,1,3,19,0,4,0,22,0,oklahoma go triple
0,2,6,43,1,11,0,49,0,"mccain make secret trip syria meet u military, kurd"
0,3,9,38,1,10,0,47,0,apple pfizer piling taiwan bond market
0,1,3,23,0,2,0,26,0,profiting globalization
0,1,13,45,3,13,4,58,0,"long layoff, baker-finch back colonial, site first pga win 1989"
0,3,12,43,1,11,0,55,0,ousted arconic ceo sent vague threat activist hedge-fund bos
0,1,5,23,0,4,0,28,0,well fargo sweating stress test
0,1,3,42,0,7,0,45,0,newsreader natasha kaplinsky give birth baby boy
0,2,10,28,1,8,0,38,0,amd betting wi-fi open virtual reality
0,2,5,36,3,7,0,41,0,inside mosul: what's life like islamic state?
0,1,2,31,0,4,0,33,0,drought stricken somalia nears famine
0,3,8,30,3,7,0,38,0,rza directed episode netflix's 'iron fist'
0,1,1,49,0,9,0,50,0,iran announces building second nuclear power plant
0,1,5,29,0,7,1,34,0,7 bomb strike iraq violence spread
0,3,2,50,0,8,0,52,0,celebration mark opening giant floating walkway china
0,1,3,29,1,5,0,32,0,telecom new zealand bounce gay e-mail
0,1,10,20,0,6,0,30,0,opec back away new output cut
0,2,3,52,2,7,0,55,0,hillary clinton label chelsea explosion apparent terrorism
0,1,5,23,0,5,0,28,0,getting behind wheel
0,3,8,58,0,13,0,66,0,george brandis take aim penny wong question time attack one nation
0,3,10,44,0,11,0,54,0,celine dion remembers late husband nearly year death
0,2,13,56,4,13,0,69,0,astronaut mike parenting kid space dangerous day life
0,2,17,59,2,15,2,76,0,"indian navy can't wait naval lca anymore, looking 57 new fighter aircraft carrier"
0,2,2,41,2,9,0,43,0,eric gill: separate artist abuser?
0,2,15,44,1,11,0,59,0,key house gopers sign ocare repeal proposing amendment
0,2,13,38,2,10,0,51,0,'boyfriends instagram' real mvp social medium
0,1,5,20,3,4,0,25,0,bringing 'baby' rolls-royce
0,2,7,63,2,11,0,70,0,"fbi director james comey meet congressional leader wiretapping, leaks, russia"
0,1,6,25,1,6,0,31,0,"still working, making less"
0,3,9,38,3,9,0,47,0,byu vs. gonzaga: score reaction cougars' upset win
0,2,3,48,1,8,0,51,0,marshawn lynch visit raiders; source say deal could happen
0,1,6,27,0,6,0,33,0,burmese icon tends flickering flame
0,2,2,56,2,9,0,58,0,turn iconic 'seinfeld' theme song completely improvised
0,1,4,34,0,7,0,38,0,mv sirius star oil tanker released pirate
0,2,5,39,1,7,1,44,0,vimy ridge: royal commemorate defining ww1 battle
0,2,1,62,7,11,0,63,0,trump call judge halt immigration 'ridiculous;' say 'overturned!'
0,3,3,19,1,4,4,22,0,adele's biggest moment 2016
0,1,2,31,0,5,0,33,0,republic molossia host state visit
0,1,5,29,0,7,1,34,0,tartan day festivity april 6 new york
0,2,8,41,2,9,0,49,0,manufacturing u.s. kept expanding robust pace march
0,1,7,35,2,8,0,42,0,mlb: barry bond break hank aaron's home run record
0,1,4,30,0,5,2,34,0,67th annual golden globe award highlight
0,1,3,50,0,7,0,53,0,thai prime minister dissolve parliament call election
0,2,3,46,2,9,0,49,0,"friday briefing: win one, lose one labour byelections"
0,1,5,66,2,12,0,71,0,red cross reveals told u.s. official koran disrespect multiple occasion
0,2,10,50,2,14,2,60,0,"ballad big show: wrestlemania 33 climax blood, shaq tear"
0,2,2,50,4,9,0,52,0,"republican rogue low-down, dumb reply trump call forunity"
0,3,7,37,0,8,0,44,0,trump clinton aide clash election forum
0,3,3,54,0,12,0,57,0,president trump could make lot expensive drink booze
0,3,5,19,0,5,0,24,0,deal work burnout
0,1,6,49,0,9,0,55,0,chicago transit authority announces repair blue red line
0,3,3,52,2,11,0,55,0,"nigerian girl kidnapped boko haram, mother, found baby"
0,2,11,57,7,13,0,68,0,"'this populism': tucker, hume, wallace perino trump's inaugural address insider"
0,3,7,46,3,10,0,53,0,barry jenkinss underground railroad work amazon
0,2,4,68,2,16,2,72,0,"girl, 11, killed stockholm terror attack walked home named ebba kerlund"
0,3,4,55,3,10,0,59,0,"back story behind oscar's social medium sensation ""gary chicago"""
0,1,3,47,1,8,0,50,0,canadian boy killed cambodian seige; police storm school
0,1,4,56,0,10,0,60,0,strategic arm talk russia u end without declaration
0,1,3,59,1,8,0,62,0,"cnn headquarters infected computer worm, exaggerates global threat"
0,1,4,45,2,8,0,49,0,"thirteen dead, several wounded fort hood, texas shooting"
0,3,4,56,2,11,0,60,0,saudi arabia launch girls' council empower woman without girl
0,3,7,49,0,9,0,56,0,crackdown social medium account backfire driving demand
0,2,9,34,1,8,0,43,0,read live update women's march washington
0,3,8,43,1,10,0,51,0,consumer going love end net neutralityat first
0,2,8,31,0,7,0,39,0,bernie sander still raising much money
0,3,5,41,1,10,2,46,0,adrian peterson lead ranking top 10 running back nfl
0,2,7,30,1,7,0,37,0,fish cant take climate change heat
0,3,18,49,3,12,0,67,0,lavar ball blame ucla's 'slow' white player ncaa tournament loss kentucky
0,2,4,57,2,13,0,61,0,'the lego batman movie' top first strong weekend box office year
0,3,2,72,1,14,0,74,0,time grow up? millennials shunning marriage favour living parent
0,1,3,40,3,5,0,43,0,"seventeen-year-old shot dead merseyside, england"
0,1,2,50,0,8,3,52,0,john constable painting location mystery solved 195 year
0,2,5,50,3,9,0,55,0,first hamilton show without lin-manuel miranda totalletdown
0,1,5,27,1,7,0,32,0,"back camera, back making money"
0,2,11,45,4,10,0,56,0,shawn mendes drop feisty new single 'there's nothing holdin' back'
0,2,6,36,0,6,0,42,0,france open germanwings crash criminal inquiry
0,1,12,41,3,10,4,53,0,"un/who making progress treating hiv/aids, miss 2005 target"
0,2,10,42,1,11,0,52,0,demarcus cousin trade could big dealfor warrior
0,2,3,63,2,11,0,66,0,madeleine albrights defense clinton foreign policy weak merit
0,1,1,60,4,10,2,61,0,"mother, daughter accused stealing husband's $3.5 million lottery ticket"
0,1,3,30,1,5,0,33,0,"wildfire still burn oklahoma, texas"
0,3,7,59,1,14,0,66,0,rolling stones' new video see kristen stewart cut loose street la
0,3,8,45,0,10,0,53,0,paris big dig abandon chic haussmann train suburb
0,2,5,72,3,16,0,77,0,"black bernie sander delegate say doesnt luxury going ""bernie bust"""
0,3,11,52,4,11,0,63,0,lars ulrich metallica's grammys sound issues: 'you gotta keep playing'
0,2,3,49,2,7,2,52,0,leopoldo lopez: venezuela court upholds 14-year prison sentence
0,1,6,33,0,7,2,39,0,13 big equity firm pledge invest responsibly
0,1,6,34,0,7,1,40,0,spur acquire jefferson buck 3 player
0,3,8,79,3,16,0,87,0,"brexit donald trump 'squeezing refugee spotlight', warns keir starmer mp dub debate begin"
0,1,5,31,0,6,0,36,0,xstrata anglo american merger talk
0,3,1,49,1,10,0,50,0,paper book better e-reader bedtime story bonding
0,1,7,20,4,6,4,27,0,"toxic emission fell 2007, e.p.a. say"
0,2,11,31,1,8,0,42,0,new york giant seize control nfc wild-card race
0,3,4,47,1,9,2,51,0,least 20 killed blast outside afghanistan's supreme court
0,2,7,34,0,8,0,41,0,longtime gambian ruler refuse step aside
0,1,2,51,0,8,4,53,0,philippine culling 6500 hog reston ebolavirus outbreak
0,3,5,68,6,15,0,73,0,"oregon jordan bell, two missed rebound complete anguish: lost game us."
0,3,5,33,2,6,0,38,0,sanders: gop go nuclear gorsuch
0,1,8,46,0,9,0,54,0,leaked report point larger pakistani role mumbai attack
0,3,6,22,0,5,0,28,0,woman blame car crash bigfoot
0,3,16,41,6,14,2,57,0,"amazon's 'alexa' shine ces, jeff bezos get $1.3 billion richer day"
0,3,3,41,6,10,1,44,0,'like painting' apple's $5 billion campus built
0,2,6,50,3,10,0,56,0,'dangerous phenomenon': israeli man charged trying join isi
0,1,5,29,1,5,0,34,0,"loneliness, immigrant tend flock"
0,1,7,35,0,7,0,42,0,iran stepping effort quell election protest
0,1,2,40,0,5,0,42,0,estonian soldier killed southern afghanistan
0,1,6,28,0,6,0,34,0,saudi retool root terrorist risk
0,1,5,42,0,7,0,47,0,lifeline tracfone provide cellphone needy
0,2,6,80,3,14,0,86,0,pelosi punt democrat joke kellyanne conway looking familiar kneeling white house couch
0,1,7,32,0,8,1,39,0,hedge fund dissolving face 2nd inquiry
0,1,8,36,0,9,0,44,0,davey johnson soft spot dutch baseball team
0,2,14,54,3,14,0,68,0,twitter gave smith joke 'fresh prince bel-air' bungee jump
0,2,3,68,3,14,4,71,0,"eu 'leaving migrant drown' say rescuer saved 2,000 mediterranean single day"
0,1,6,28,3,7,0,34,0,korean peninsula 'brink war': dprk
0,3,7,41,1,6,0,48,0,check chrysler's futuristic minivan millennials
0,2,8,46,0,7,0,54,0,washington talk end without agreement israeli settlement
0,1,5,17,0,4,0,22,0,sears tower going green
0,1,2,66,0,10,0,68,0,australian telecomms firm telstra offer rebate affected bombing
0,2,2,64,3,18,0,66,0,texas man pay traffic fine two bucket full pennies. hero jerk?
0,2,12,54,7,16,2,66,0,"emmanuelle riva, star hiroshima mon amour amour, dy 89 new york time"
0,1,9,33,0,7,0,42,0,bmw vw reflect difficulty facing carmaker
0,1,1,40,1,4,0,41,0,manitoba's flood creating hazardous condition
0,1,5,49,1,8,0,54,0,socialist left party election initiative start norway
0,1,4,57,1,10,0,61,0,"one dead motorcycle car collision guernsey, channel island"
0,1,9,32,0,7,1,41,0,hsbc confirms possible sale 3 office building
0,1,10,54,0,15,2,64,0,arm dealer sentenced 30 year scheme sell weapon terrorist
0,3,4,54,1,9,0,58,0,donald trump ice sculpture unveiled atjapan's sapporo snow festival
0,3,2,63,5,13,0,65,0,"trump wont say hell ease sanction russia, want great relationship"
0,1,7,27,4,7,0,34,0,"israel n.b.a., missing hummus"
0,1,7,34,0,9,0,41,0,saudi arabia agrees u joining wto
0,3,16,64,1,14,0,80,0,"mizoram cm lal thanhawla say commoners, even politician across india racist"
0,3,3,71,2,13,0,74,0,unsealed search warrant reveal detail prince's drug use death yahoo
0,3,2,46,0,10,0,48,0,patriarchy sea trump shark gather
0,2,4,55,3,11,0,59,0,u.s. women's team enters world cup colorful extrovert bent revenge
0,3,11,36,2,10,0,47,0,"grow faster, whole food must beat trader joe's value"
0,1,6,22,0,5,4,28,0,casey stoner win 2011 british motogp
0,3,7,70,3,12,0,77,0,donald trump: former u ambassador jeff bleich condemns 'illegal cruel' immigration ban
0,2,11,48,0,10,0,59,0,trump blast cruz everything loan disclosure gay marriage
0,1,7,45,0,6,0,52,0,distance insulates journalist use private information
0,2,5,42,3,10,0,47,0,"north korea problem ""coming head,"" mcmaster say"
0,1,8,43,1,8,0,51,0,"without superfund tax, stimulus money help pay cleanup"
0,3,12,54,0,12,2,66,0,christie brinkley kill sport illustrated swimsuit issue return age 63
0,2,12,62,1,13,0,74,0,bernie sander gain hillary clinton loses white democratic voter breitbart
0,3,10,58,0,11,0,68,0,woman suffering endometriosis pen emotional love letter husband
0,2,1,71,0,14,0,72,0,master networker explains single interesting people event
0,1,6,35,0,8,0,41,0,six flag talk avoid filing bankruptcy
0,3,2,58,5,11,0,60,0,"mom, toddler daughter fight cancer time: they're 'warriors'"
0,3,1,84,0,17,0,85,0,vet worried rising number drunk pet owner leaving leftover tipple around house
0,1,6,28,0,6,0,34,0,obama seek accord military iraq
0,1,5,27,0,5,0,32,0,higher price popular comic book
0,2,5,42,1,8,0,47,0,strong demand soda north america boost coca-cola
0,2,5,65,1,14,0,70,0,top isi official death could major implication future group
0,3,7,36,1,7,0,43,0,donald trump message crime draw pushback
0,1,7,40,0,8,0,47,0,canada offer energy subsidy pulp paper industry
0,3,5,19,1,6,2,24,0,happy days' erin moran dead 56
0,2,11,52,0,10,0,63,0,fox news host jesse watters announces vacation amid ivanka trump comment
0,1,1,43,1,8,3,44,0,japanese tourist travel 37 country $2
0,1,6,30,0,7,0,36,0,mets send reyes church disabled list
0,3,4,57,3,12,0,61,0,'yes did': barack obama lift america one last time emotional farewell
0,1,3,35,0,7,0,38,0,gunman shoot gambler la vega casino
0,1,8,34,3,8,0,42,0,bush nominates john g. robert u.s. supreme court
0,1,1,51,1,8,0,52,0,illinois man named person interest wife's disappearance
0,2,3,62,2,10,0,65,0,"arsne wengers arsenal future mutually decided, say chief executive"
0,1,2,48,2,8,0,50,0,"chad declares border sudan ""military operation zone"""
0,1,9,31,2,8,0,40,0,u.n. right official fear war crime sri lanka
0,3,8,41,1,9,0,49,0,elon musk awkward problem tesla: employee parking
0,1,4,38,0,7,0,42,0,sarkozy end french job ban eastern european
0,1,4,60,0,12,0,64,0,u south korea conduct naval exercise response warship sinking
0,1,6,41,1,9,2,47,0,former lebanese prime minister amin al-hafez dy age 83
0,2,5,41,0,10,0,46,0,least five dead shooting bpm festival mexico
0,3,7,61,3,12,2,68,0,poll: 49% scot want second scottish independence referendum brexit
0,3,14,58,1,15,0,72,0,steph curry explains gave pelican coach high-five sinking tough shot
0,1,5,63,0,11,0,68,0,six thousand gather celebrate birthday yugoslavian leader josip broz tito
0,3,14,42,3,10,0,56,0,"brock lesnar, john cena lead list wwe's highest-paid wrestler"
0,3,6,51,5,11,2,57,0,"muslim congress, democrat blast new trump travel ban: 'muslim ban 2.0'"
0,3,9,39,2,11,2,48,0,u.s. return largest tract okinawa land japan 44 year
0,3,1,50,1,8,3,51,0,"grandmother found decapitated boy flees attack, call 911"
0,1,2,41,1,6,0,43,0,orioles' palmeiro get mixed baseball fan greeting
0,1,6,25,1,4,0,31,0,kansa hold upset-minded bison
0,3,5,72,4,14,0,77,0,frank sinatra advice george michael complaining fame: talent must wasted
0,1,1,34,1,5,2,35,0,6.9 magnitude earthquake hit western china
0,2,9,11,2,5,0,20,0,cnn quiz show cnn.com
0,3,3,62,2,10,0,65,0,"final detainee transfer, obamas guantanamo policy take last breath"
0,1,10,41,3,9,0,51,0,virginia tech earns shot north carolina a.c.c. tournament
0,1,3,15,0,4,1,18,0,sony may cut ps3 price
0,3,2,45,2,7,0,47,0,north carolina man pleads guilty 'pizzagate' shooting
0,1,4,73,2,11,0,77,0,wikinews interview dr. michael mazilu creating world's fastest spinning manmade object
0,3,2,23,0,4,0,25,0,resilience resistance
0,2,2,39,0,6,0,41,0,mattis confirmed defense secretary senate
0,2,4,37,1,8,0,41,0,house speaker ryan say hasnt decided trump
0,1,2,31,0,7,2,33,0,65th human bird flu case reported egypt
0,3,4,51,2,11,0,55,0,snapchat's april fools' joke show copy facebook change
0,3,8,47,0,8,0,55,0,rumored supreme x lacoste collaboration really happening
0,2,12,52,5,11,0,64,0,make america mexico again: warned america-hating mob breitbart
0,2,11,46,3,9,0,57,0,sander adviser say campaign may re-evaluate tuesday
0,3,8,46,0,8,0,54,0,billion dollar industry professional video game battle
0,1,9,29,2,9,6,38,0,"wwe raw result memphis, tn september 15, 2008"
0,3,10,50,1,11,0,60,0,"trump seems retreat shutdown, secret spending bill still loom"
0,1,2,33,0,5,0,35,0,british airway cabin crew begin strike
0,3,9,58,3,13,2,67,0,"ncaa bubble watch: could syracuse, vanderbilt georgia tech get 15 losses?"
0,2,9,61,4,10,0,70,0,ciccotta: guest speaker call violence reveals bucknells radicalism breitbart
0,2,13,66,7,14,0,79,0,"mike penny charlotte: believe forgiveness trump showed heart, humility, fought back"
0,3,5,45,0,11,0,50,0,march science stretched way north pole
0,3,5,19,0,5,2,24,0,biggest nfl injury week 14
0,3,4,37,2,7,0,41,0,fact check: much president trump achieved?
0,1,5,27,1,5,3,32,0,nato: 130 militant killed afghanistan
0,2,10,43,1,10,0,53,0,america war isi evolving invasion syria
0,2,4,42,0,11,2,46,0,trump revers course 24 hour nato china fed
0,1,2,37,1,5,0,39,0,puerto rico's election governer contested
0,1,3,59,1,8,0,62,0,space shuttle endeavour's launchpad struck lightning delaying launch
0,3,3,50,2,8,0,53,0,world's longest non-stop commercial flight land new zealand
0,1,3,48,1,5,0,51,0,wikimedia foundation answers.com announce partnership
0,3,3,38,0,7,0,41,0,decision loom assange extradition sweden
0,3,5,50,0,8,0,55,0,united airline ceo offer softer apology stock nosedive
0,3,1,71,1,10,0,72,0,australia's cherry season predicted expensive unseasonably cold weather
0,1,8,32,0,8,0,40,0,phil mickelson halt play ailing wife
0,2,11,44,3,11,0,55,0,#grammyssowhite came life. award face race problem?
0,2,1,39,0,7,0,40,0,scientist want make robot humanflesh
0,3,8,62,3,12,0,70,0,isi leader abu bakr al-baghdadi 'critically injured air strike northern iraq'
0,3,3,45,0,6,0,48,0,philadelphia da indicted federal corruption charge
0,3,5,62,1,12,2,67,0,suspected ms-13 gang member arrested connection long island teen murder
0,2,9,72,0,19,0,81,0,gregg popovich compared becky hammon steve kerr say take nba coach
0,1,4,24,0,6,0,28,0,uk submarine hit rock red sea
0,3,2,60,2,10,3,62,0,science journal retracts 107 'fabricated' research paper chinese author
0,2,13,68,1,14,0,81,0,"jay z shuns donald trump question, recall meeting kalief browder sundance film festival"
0,3,6,71,0,10,0,77,0,prime minister malcolm turnbull dance jewish community amid hanukkah celebration
0,1,4,56,1,11,1,60,0,swine flu outbreak appear globally; raise pandemic alert level 5
0,1,6,23,2,4,0,29,0,senior u.s. diplomat visit myanmar
0,2,3,35,0,8,3,38,0,un fear 200 died coalition airstrike mosul
0,2,5,20,1,4,0,25,0,trump's global web partner
0,2,8,35,2,6,0,43,0,cnn: democrat face powerlessness breitbart
0,2,1,36,0,5,0,37,0,millennials killing moviebusiness
0,2,16,54,2,15,0,70,0,"sony planning scrap kapil sharma show, might offer sunil grover show!"
0,1,8,37,1,7,0,45,0,athlete say drug-test rule violates right privacy
0,3,8,25,2,7,2,33,0,18 funny-ass post panic! thedisco
0,3,18,64,2,17,0,82,0,"story india woman ice hockey team, struggle survival hope support"
0,2,5,59,2,13,0,64,0,trump want fda move faster. action opposite effect.
0,3,11,41,4,8,0,52,0,richardson: trump foreign policy tweet help isi recruit
0,2,10,42,0,9,0,52,0,janet jackson share adorable first photo baby boy eissa
0,1,10,28,1,6,0,38,0,"opec keep output goal unchanged, saudi say"
0,1,1,43,1,8,0,44,0,"welsh air route difficulties, call funding cut"
0,3,11,44,0,8,0,55,0,stephen colbert shred gop scrapping internet privacy rule
0,2,13,45,1,9,0,58,0,sapvoice: blockchain brings trust supply chain every industry
0,3,9,44,1,10,0,53,0,chinese luxury home demand city post world's best gain
0,1,3,39,1,7,1,42,0,"bomb blast kill 5 policeman islamabad, pakistan"
0,2,8,43,0,8,2,51,0,desperate search launched 22 seaman capsized freighter
0,3,9,51,0,9,0,60,0,gadget could save life disabling phone distraction driving
0,2,3,21,0,3,0,24,0,confronting racist object
0,1,8,33,1,8,0,41,0,"oil gas price plunge, drilling frenzy end"
0,3,15,52,1,11,0,67,0,accuweather: major storm could smack united state christmas weekend
0,1,6,34,0,7,0,40,0,mauritanian see chance break cycle coup
0,1,1,34,0,6,2,35,0,44 worshipper shot dead nigerian mosque
0,1,7,24,0,6,0,31,0,seton hall center lead leg
0,2,9,46,1,8,0,55,0,thousand shut ireland street legal abortion protest
0,1,1,43,0,6,0,44,0,swift mission measure distance star explosion
0,3,2,57,0,9,0,59,0,federal judge baltimore approves sweeping plan police reform
0,3,4,59,3,12,0,63,0,donald trump's visit uk 'will rescheduled' avoid embarrassing
0,2,12,52,0,11,0,64,0,joshua field millburn minimalist life deliberate life less
0,3,6,55,3,11,1,61,0,premier league fan half-time verdict part 2: manchester united west ham
0,3,3,71,1,13,0,74,0,wikipedia cofounder jimmy wales's quest fill internet real fact story
0,1,0,30,0,8,1,30,0,3 dead man trial rape escape
0,2,5,45,3,10,0,50,0,ross kemp: libya migrant hell review deeply powerful plea
0,3,10,41,1,8,0,51,0,"eu need london financial services, merkel lawmaker say"
0,3,2,51,2,9,0,53,0,energy tracking 'numen' device could help slash home power bill
0,3,16,63,4,16,0,79,0,camila cabello look ahead post-fifth harmony solo career: 'my fan really going know me'
0,2,7,33,4,9,0,40,0,"watch travis scott's ""beibs trap"" video f/ nav"
0,2,11,22,3,7,0,33,0,frank bruni: trump want loved
0,2,15,29,3,7,0,44,0,"fact check: clinton speech economy, annotated"
0,2,6,54,2,8,0,60,0,diesis video ist nicht verfgbar. political barflies: christmas cheer
0,1,4,57,3,10,0,61,0,"obama, romney battle foreign policy final u.s. presidential debate"
0,2,3,64,3,11,0,67,0,here's centrelink win back australians' trust robo-debt debacle
0,1,3,35,1,6,2,38,0,13 drug-resistant tb case reported thailand
0,1,2,20,0,3,0,22,0,fall sweep texas
0,2,8,18,1,7,0,26,0,let hug dog
0,1,5,35,0,8,1,40,0,2 uighur troubled region killed police
0,1,4,41,1,10,3,45,0,italian petrol price rocket record eur 1.30 per litre
0,1,5,24,0,6,2,29,0,iran hang 22 execution week
0,2,8,38,1,8,0,46,0,samsung's lee face arrest warrant graft probe
0,3,8,37,1,7,0,45,0,gaza barber's blowtorch haircut literally fire
0,1,6,35,1,5,0,41,0,"indian outsourcing changed, satyam hesitated"
0,1,7,39,1,6,0,46,0,incentive attract healthier food low-income area
0,3,7,43,1,10,0,50,0,lincoln city make history amid fa cup drama football weekly
0,3,13,53,2,12,0,66,0,census say u.s. population grew lowest rate since great depression year
0,3,2,56,2,10,1,58,0,here's mighty 5-storey pregnant beyonc portrait needed see
0,3,11,41,2,10,0,52,0,amy schumer goldie hawn wild first 'snatched' trailer
0,3,4,31,1,7,0,35,0,"putin turn japanese dog gift, mp say"
0,2,4,33,0,8,0,37,0,best moment gop debate
0,2,4,48,2,9,0,52,0,"majority woman u ugly, say ex-pennsylvaniagovernor"
0,3,9,40,3,10,0,49,0,donald trump choosing cabinet. here latest list.
0,3,11,45,0,13,0,56,0,executive order may enough trump build border wall
0,1,2,31,1,4,2,33,0,massive 7.5 earthquake strike indonesia
0,2,1,60,2,11,0,61,0,trump tell supporters: nasty vicious campaign video
0,2,9,38,0,8,0,47,0,black teacher leaving profession due racism
0,2,4,38,3,7,0,42,0,"u.s. underwater drone seized china, pentagon say"
0,2,15,62,6,14,0,77,0,"u.s. presidential race, syria, william bratton: friday evening briefing new york time"
0,3,10,50,1,10,1,60,0,fed go concession company shorted senate worker $1 million
0,3,7,57,3,11,0,64,0,aquaman justice league writer promise they'll finally make dceu 'fun'
0,2,11,40,2,11,1,51,0,5 lesson martin luther king jr. apply trump's america
0,3,11,45,1,11,2,56,0,18 terrible design choice make walk away screen
0,1,2,32,0,6,0,34,0,u stock market soar bailout plan
0,1,2,41,0,6,0,43,0,artist erect giant bunny italian mountainside
0,2,11,60,0,10,0,71,0,california state senator removed criticizing late lawmaker vietnam war
0,1,5,28,1,6,2,33,0,lamoureux twin give minnesota 1-2 punch
0,3,7,47,0,9,0,54,0,model unite combat eating disorder fashion industry
0,2,13,50,1,16,0,63,0,"man custody turkey firing gun front u embassy, one harmed"
0,3,8,24,0,7,0,32,0,rickles always best man
0,1,1,59,2,5,0,60,0,california county's corporate anti-electioneering measure abandoned
0,3,11,56,0,10,0,67,0,chris martin performs beautiful tribute george michael homeless shelter
0,2,9,55,2,8,0,64,0,"yiannopoulos quits breitbart, apologizes uproar year-old comment"
0,3,12,48,1,11,0,60,0,cinnabon decided use carrie fisher death hawk cinnamon roll
0,2,6,41,2,8,0,47,0,fbi: white supremacist talked dylann roof-type attack
0,1,2,26,1,7,4,28,0,"bomb blast delhi kill 12, injures 62"
0,2,4,31,0,7,0,35,0,nyc travel ban lifted sundaymorning
0,3,3,50,4,11,0,53,0,trump called press enemy. reince priebus say meant it.
0,2,1,59,1,10,0,60,0,"netflix crushed subscriber growth targets, stock soaring"
0,2,3,78,1,16,0,81,0,eu: country detain migrant case asylum prevent running away
0,2,15,50,6,15,0,65,0,oreilly: tell im confident truth come breitbart
0,3,8,48,0,7,0,56,0,bipartisan coalition controlling new york senate gain strength
0,1,2,37,0,6,0,39,0,dozen dead bus accident philippine
0,1,4,48,0,9,0,52,0,canadian team vie spot world curling championship
0,2,2,51,2,10,4,53,0,"obama alters afghanistan exit plan more, leave 8,400 troop"
0,2,2,51,0,10,1,53,0,uk ban laptop big smartphones airline 6 country
0,1,3,39,1,6,0,42,0,"wall collapse kill twelve chhattisgarh, india"
0,3,10,68,0,11,0,78,0,canadian schoolteacher allegedly gave student instruction inject crystal meth
0,2,6,40,2,7,0,46,0,wooden watch: everyone chasing villanova's josh hart
0,1,3,46,0,7,0,49,0,national guard mobilized kentucky ice storm aftermath
0,1,7,31,0,8,0,38,0,cuomo may want talk private equity firm
0,3,13,67,1,18,4,80,0,"donald glover win best performance actor tv series, comedy musical 2017 golden globe"
0,2,10,44,8,13,0,54,0,mark levin: build damn wall time roll schumer breitbart
0,3,3,80,0,15,0,83,0,florida supreme court say hundred death row inmate may get new sentence avoid execution
0,2,13,53,0,12,0,66,0,sacramento police tried run homeless man fatally shootinghim
0,2,4,42,0,8,0,46,0,vogue india cover land kendall jenner trouble
0,1,5,27,0,5,0,32,0,rebuilding begin upon wobbly truce
0,3,5,60,1,14,0,65,0,republic ireland women's team could go strike row treatment fai
0,1,5,25,0,7,0,30,0,sign hope emerge west bank
0,3,23,54,2,20,0,77,0,two-year-old got new lease live bit liver dad kidney grandma
0,2,5,51,3,10,0,56,0,'jurassic world' dinosaur looked real life business insider
0,1,0,25,2,3,0,25,0,.tel top-level domain launched
0,3,1,70,1,13,0,71,0,world's tallest men gene traced back prehistoric mammoth hunter
0,1,7,40,1,7,2,47,0,soyuz tma-15 launch crew international space station
0,1,4,35,2,6,0,39,0,r&b singer dangelo sentenced cocaine charge
0,2,3,17,0,4,0,20,0,last birthers
0,3,9,39,1,7,0,48,0,kansa cop feed baby helping seizure-stricken mom
0,2,15,59,7,14,0,74,0,"brexit prompt many british c.e.o.s consider relocating, survey find new york time"
0,3,8,38,1,7,0,46,0,russia say broadcast eurovision song contest
0,2,5,43,1,9,2,48,0,man fulfills dream becoming fdny probie 18-yearbid
0,2,1,45,0,8,0,46,0,everybody need get used businessman president
0,3,3,45,1,8,5,48,0,"united nation estimate 20,000 refugee affected trump ban"
0,1,10,51,2,10,0,61,0,"helping hand keep alberto arroyo, jogging pioneer central park, going"
0,3,4,38,1,8,0,42,0,uttar pradesh: indian state running meat
0,1,5,28,0,8,0,33,0,new look field death jew
0,3,3,33,0,8,0,36,0,obamas quietly move trump move
0,1,3,63,2,8,0,66,0,"fred thompson campaign staffer leaves, thompson's political past scrutinized"
0,1,3,35,1,6,0,38,0,"eight killed dagestan, russia ambush"
0,1,9,52,1,10,0,61,0,"interview, republican chairman stray party line abortion"
0,3,5,25,3,6,0,30,0,best (single) valentine day
0,2,3,58,1,13,0,61,0,uk severe weather: relief east coast tidal wave fails wreak chaos
0,3,4,48,4,10,0,52,0,gregg popovich: 'nobody's going rest' spur close season
0,1,3,39,0,8,0,42,0,hamas begin use force release alan johnston
0,3,9,35,1,8,0,44,0,"much sugar linked reduced memory, brain volume"
0,1,4,35,0,5,0,39,0,pacific island forum condemns fiji takeover
0,3,3,70,0,14,0,73,0,penalty rate protester bill shorten press conference lose cent cut
0,1,4,41,1,8,0,45,0,"woman killed house fire south yorkshire, england"
0,2,4,33,4,3,0,37,0,concealed-carry reciprocity vs. federalism
0,3,7,45,4,11,0,52,0,trump threatens 'send feds' chicago 'carnage'
0,1,7,32,2,6,0,39,0,premier casting u.s. withdrawal iraq victory
0,3,12,54,0,11,0,66,0,new footage show tense moment passenger dragged united flight
0,2,5,50,1,10,0,55,0,"nato approves keeping expanded afghan basing, nod long fight"
0,2,2,41,0,7,0,43,0,singapore sings return terrex army vehicle
0,2,8,33,2,7,0,41,0,"voting machine hacked, would anyone know?"
0,2,2,86,0,21,0,88,0,wife child look horror tiger drag husband enclosure maul death chinese zoo
0,1,2,50,0,7,0,52,0,afghan presidential candidate karzai win majority vote
0,2,3,53,0,11,0,56,0,bumblebee first bee continental u listed endangered
0,2,2,61,2,11,2,63,0,eight execution 11 days: arkansas order may endanger staff's mental health
0,1,6,34,0,7,0,40,0,share blackstone group fall ipo price
0,3,7,47,1,7,0,54,0,trump's camp denies struggling find inauguration performer
0,2,9,45,7,12,2,54,0,"'nashville' season 5, ep. 1 recap: three chords, truth concept album"
0,1,2,50,0,7,0,52,0,search continues victim indonesian volcano eruption
0,1,8,28,3,6,0,36,0,"state cut delay u.s. benefits, official say"
0,1,3,25,0,6,2,28,0,inventor ronald howe dy age 83
0,2,2,62,1,13,0,64,0,"pinned ground, florida deputy begged passerby shoot attacker"
0,3,8,40,0,8,0,48,0,central banker discover limit tough year
0,2,14,56,0,16,0,70,0,guy court traffic ticket end behind bar cocaine fall hat
0,1,5,10,2,4,1,15,0,u.s. open day 1 report
0,1,2,43,1,6,1,45,0,"9 months, belgian coalition delivers government"
0,2,3,62,1,13,0,65,0,"anne frank may betrayed nazi occupiers, captured chance"
0,3,4,83,3,15,0,87,0,live whitehall incident: terror attack westminster foiled man arrested 'with backpack knives'
0,2,2,45,4,7,1,47,0,johnny depp's money worry blamed $2m-a-month lifestyle
0,2,3,40,0,8,0,43,0,lawyer jump death park avenuebuilding
0,2,15,46,3,12,0,61,0,house dems: flynn didnt report saudi trip work us-russia nuclear deal
0,3,14,53,3,13,0,67,0,jeff session tell al franken truth. franken new questions.
0,1,4,63,1,12,0,67,0,"pressure france, chad sudan open door possible troop deployment"
0,1,3,42,1,9,0,45,0,macy's flagship store new york evacuated due fire
0,3,4,46,2,8,0,50,0,viola davis: donald trump know anything acting
0,2,2,69,1,13,0,71,0,trafficker get life prison india torture chopping labourers' hand
0,3,7,63,2,16,2,70,0,"actress carrie fisher, best known role princess leia star wars, dy aged 60"
0,3,6,32,2,7,0,38,0,perform inaugural ball? vote!
0,2,11,46,0,10,0,57,0,drake spoke president trump last night aconcert
0,1,8,45,0,7,0,53,0,esa launch herschel space observatory planck satellite
0,3,3,54,3,8,0,57,0,jacqui lambie: australian senator weeps 'shameful' welfare cut
0,2,3,70,0,9,0,73,0,israeli parliament retroactively legalizes thousand west bank settlement home
0,3,12,49,0,10,0,61,0,impassioned green day ready revolution kroq almost acoustic xmas
0,2,12,44,2,11,0,56,0,zach lavine hilarious story playing dad one-on-one
0,2,3,73,2,19,0,76,0,new york city get hit massive blizzard here could affect commute
0,1,2,38,1,5,2,40,0,7.2 magnitude earthquake strike mariana island
0,3,9,28,0,5,0,37,0,berlin attack echo isi propaganda shift
0,2,8,45,0,7,0,53,0,atlanta police admit beyonce pregnancy tweet backfired
0,2,7,29,2,6,0,36,0,legion murked every comic book show moving
0,2,1,47,0,9,0,48,0,board upholds suspension teacher stepped flag
0,3,2,43,1,6,0,45,0,thailand floods: twelve killed record rainfall
0,1,0,29,0,4,2,29,0,40 million credit card compromised
0,2,8,28,4,10,3,36,0,would spend $425 jean fake mud? [video]
0,2,10,33,3,7,0,43,0,"phase full-time job part-time, retirement"
0,2,1,58,2,12,0,59,0,calf adopted horse (adorable) case mistaken identity
0,1,3,58,3,12,0,61,0,officer accused framing men murder uk's 'biggest' trial police
0,1,3,41,0,7,0,44,0,train accident kill three girl central florida
0,3,4,46,2,10,2,50,0,suns' devin booker score 70 point losing effort vs. celtic
0,3,5,20,3,8,3,25,0,week pictures: feb. 24 march 3
0,2,4,47,0,8,0,51,0,family leaf heartwarming note nfl player flight
0,3,7,57,3,15,0,64,0,that's ill right now: sudden drop temperature make sick
0,2,3,53,3,9,0,56,0,anger corrupt politician could open door bulgaria trump
0,1,5,36,0,5,0,41,0,pakistani rejoice restoration justice
0,2,7,25,1,6,0,32,0,apple critic right time
0,1,6,36,0,7,0,42,0,palestinian press war crime inquiry gaza
0,1,3,38,1,6,0,41,0,long island-sized iceberg ram antarctic coast
0,1,1,17,0,3,0,18,0,euro reach new low
0,2,12,59,3,11,0,71,0,"peter buffett talk creativity, music, philanthropy, life dad warren buffett"
0,2,3,40,1,7,0,43,0,india conduct fourth test launch agni-v missile
0,3,3,77,2,14,1,80,0,refugee must repay u government flight 7 surprising fact resettlement
0,1,2,32,0,7,0,34,0,junk food banned english school
0,1,2,48,0,7,0,50,0,former iraqi police commander working insurgent
0,1,6,32,1,6,0,38,0,st. louis batter hernandez complete sweep
0,3,6,85,0,16,0,91,0,ghana president accused plagiarising speech george w bush bill clinton inaugural address
0,2,8,36,2,7,3,44,0,100-mile-long crack antarctic ice shelf keep growing
0,1,6,35,0,6,0,41,0,universal remote dormant smartphone
0,1,6,53,2,9,0,59,0,soldier question u.s. defense secretary issue kuwait visit
0,2,9,43,0,9,0,52,0,sylvester stallone suggests would decline trump art role
0,2,8,45,2,7,0,53,0,austin area becomes immigrant 'sanctuary' trump inaugurated
0,2,2,47,2,8,0,49,0,young girl diagnosed 'tree man' syndrome bangladesh
0,2,4,40,1,5,0,44,0,priebus reportedly considering rnc re-election bid
0,3,7,45,0,7,0,52,0,adele apologizes swearing george michael tribute
0,3,2,28,2,6,0,30,0,buying yankees' hot start?
0,1,4,55,1,9,4,59,0,australian rule football: 2010 gippsland football league final week one
0,2,5,63,1,11,5,68,0,"petition sack kay burley following alton tower interview pass 50,000 signature"
0,1,3,49,0,7,0,52,0,wikipedia feature encyclopdia britannica main page
0,2,11,55,1,10,0,66,0,knicks' dysfunction never clear following charles oakley arrest
0,2,9,42,3,9,0,51,0,rouhani say iran wont bullied rally criticise trump
0,1,3,31,0,6,3,34,0,uk military death afghanistan reach 327
0,3,2,54,3,11,0,56,0,"white student hold 'trump' sign, turn back black basketball team"
0,2,8,37,4,9,0,45,0,"marshall, va., support donald trump hasnt wavered"
0,2,6,32,2,5,0,38,0,"peter thiel, trump silicon valley surrogate"
0,2,4,57,2,10,0,61,0,soas student call white philosopher dropped curriculum
0,3,7,42,1,9,0,49,0,latest: governor declares state emergency fulton
0,3,3,86,2,13,2,89,0,solomon islander escape tsunami warning without major damage 7.7-magnitude pacific earthquake hit
0,1,7,44,1,8,0,51,0,"desperate child flee zimbabwe, life desolate"
0,3,9,40,1,7,0,49,0,dave chappelle roast trump supporter stand-up set
0,2,1,47,0,5,0,48,0,facebook artificial intelligence spot suicidal user
0,1,5,45,0,7,0,50,0,nato airstrike kill seven afghan security force member
0,2,8,32,4,7,0,40,0,"first watch: avett brothers, hard feeling"
0,3,2,42,1,6,0,44,0,romney back trump's choice education secretary
0,2,12,40,1,9,0,52,0,aacta awards: mel gibson win best direction hacksaw ridge
0,2,8,42,3,7,0,50,0,michael jackson's daughter say 'absolutely' murdered
0,2,10,30,1,10,2,40,0,pew poll: 44 percent household gun
0,1,4,51,2,7,3,55,0,400 attend scottish singer-songwriter gerry rafferty's funeral
0,3,9,69,5,12,0,78,0,"inspiration behind 'the scream' may rare mother-of-pearl clouds, scientist claim"
0,2,2,52,3,13,0,54,0,"take look making hit scam email prank show, 'scamalot'"
0,1,6,33,0,7,0,39,0,investor see glimmer send share higher
0,1,5,23,0,4,0,28,0,past corruption taint new india
0,3,6,44,0,7,0,50,0,trump propose significant increase defense spending
0,2,10,40,5,9,0,50,0,'screw president!': anti-trump protest erupt dc insider
0,1,2,33,0,5,0,35,0,southern ocean whale slaughter resume
0,1,3,55,2,11,0,58,0,"fiji ""running patience"" vanuatu ban fijian biscuit"
0,1,2,39,0,6,2,41,0,politician protester prepare g20 summit
0,1,1,29,0,2,0,30,0,glastonbury headliner announced
0,1,5,34,0,5,0,39,0,another killing region bordering chechnya
0,2,9,48,1,9,0,57,0,ivanka trump's boot getting interesting review amazon
0,3,6,28,2,6,4,34,0,favorite gadgets: best tech gift 2016.com
0,3,2,69,0,11,0,71,0,declassified intelligence report russian hacking made available public
0,1,5,65,1,12,0,70,0,human right watch: israel used white phosphorus densely populated area gaza
0,1,9,35,2,7,0,44,0,assertive donovan drive u.s. soccer ambition
0,1,2,24,0,4,0,26,0,emir qatar abdicates throne
0,2,10,35,1,11,0,45,0,much would put avoid united airlines?
0,1,6,52,3,9,0,58,0,"city planning board postpones decision buffalo, n.y. hotel proposal"
0,3,9,43,2,8,0,52,0,there novel strategy behind calvin harris single release
0,3,12,34,3,9,0,46,0,u.s. idd russian gave hacked email wikileaks
0,3,5,63,3,13,0,68,0,"garcia, rodriguez hispanic surname among popular u.s."
0,1,5,28,1,4,0,33,0,"korea come through, joining semifinal"
0,3,7,64,3,14,0,71,0,"heavy snow likely d.c. area monday night, paralyzing blizzard new york boston"
0,1,3,60,1,9,0,63,0,"sixteen policeman killed suspected terrorist attack xinjiang, china"
0,1,4,33,1,5,0,37,0,"gun scare concordia university, montreal"
0,3,4,50,2,8,0,54,0,hollywood feel force electrifying 'rogue one' premiere
0,3,5,47,2,9,0,52,0,south korea: critic call arrest impeached park geun-hye
0,1,2,49,0,9,0,51,0,u declares public health emergency spread swine flu
0,1,4,30,0,6,0,34,0,sony face class action lawsuit drm
0,1,4,37,0,5,0,41,0,basque separatist group eta declares ceasefire
0,3,2,53,1,11,0,55,0,"redskin great shape make playoffs, thanks cowboy"
0,3,8,44,0,10,1,52,0,south korea presidential race narrow election set may 9
0,2,4,77,1,16,0,81,0,trump cia pick seen fierce partisan serious student national security issue
0,3,9,37,0,8,0,46,0,truck plow crowd near christmas market berlin
0,3,5,25,0,7,0,30,0,dubai put taxi drone sky
0,2,7,57,2,11,0,64,0,"hang time: disneyland, knicks life america kristaps porzingis"
0,2,12,52,1,13,1,64,0,bruno mar tie justin timberlake pop song no. 1 among male soloist
0,1,10,57,2,11,0,67,0,u.s. military express concern perception iraqi crackdown sunni
0,2,12,55,2,15,3,67,0,case accusing bush official 9/11 abuse head supreme court new york time
0,3,4,64,2,14,0,68,0,isi offensive may picked surface-to-air missile system
0,3,3,63,1,10,0,66,0,child sex abuse royal commission: data reveals extent catholic allegation
0,2,5,63,0,14,2,68,0,shinzo abe become first japanese prime minister visit pearl harbor 65 year
0,2,6,57,1,12,0,63,0,saving moribund la lakers could magic johnson greatest trick
0,2,1,67,0,14,2,68,0,postman collected pebble every day 33 year created astounding
0,1,8,35,0,9,4,43,0,fehr say union called 2003 drug test destroyed
0,1,4,23,0,5,2,27,0,nfl europa cease 15 season
0,3,16,58,1,16,4,74,0,2017 super bowl spread pick: new england patriot v atlanta falcon odds advice pro
0,1,6,36,0,6,0,42,0,court order california cut prison population
0,3,2,39,1,10,6,41,0,deportation mexico 79% first four month 2015
0,1,7,40,0,7,0,47,0,keeping pitcher thumb world baseball classic
0,3,6,51,1,8,0,57,0,mitchell trubisky booed united center bulls-celtics game
0,2,16,62,5,16,0,78,0,"aamir khan's 'dangal' get big nod approval raj thackeray, sachin tendulkar phogats"
0,1,7,17,0,6,0,24,0,cit post eighth loss row
0,1,2,32,1,4,0,34,0,somali pirate release greek-owned ship
0,3,8,40,2,10,0,48,0,"obama, final christmas tribute troop he's led"
0,2,3,60,1,14,0,63,0,donald trump threatened toyota look like got fact wrong
0,1,5,32,0,5,0,37,0,conservative ponder way wilderness
0,3,13,41,2,13,0,54,0,tension dnc chair race come outside inside party
0,3,1,50,1,8,0,51,0,"trump plot big hotel expansion, political problem loom"
0,1,1,25,0,3,0,26,0,melbourne gunman missed court
0,2,8,36,2,12,4,44,0,gang member told steal $5000 gun per day breitbart
0,1,5,31,0,6,0,36,0,surge surfer online classified ad
0,3,9,36,1,10,2,45,0,softbank fund said draw $15 billion mubadala
0,2,4,65,2,16,3,69,0,facebook ordered pay $500 million oculus vr lawsuit still come winner
0,3,2,36,0,5,0,38,0,iceberg tourist flock newfoundland town
0,3,13,45,4,10,0,58,0,"zayn malik drop new single partynextdoor, 'still got time': listen"
0,3,7,46,1,8,0,53,0,"blaxploitation movie ready stream, nostalgia included"
0,2,4,61,3,10,0,65,0,"channeling steve jobs, apple seek design perfection new spaceship campus"
0,2,6,19,4,6,3,25,0,trump time capsule #140: lock
0,3,15,43,0,12,0,58,0,rihanna prince harry get tested hiv advocate world aid day
0,2,8,48,0,12,4,56,0,alex rodriguez agrees contract fox sport analyst 2017
0,2,3,51,1,12,0,54,0,womens march may start serious social movement
0,1,4,51,0,7,0,55,0,former cia agent indicted leaking classified information
0,3,13,41,2,8,0,54,0,sec reject bitcoin etfs: reject bitcoin investments?
0,2,4,40,0,10,0,44,0,greg oden back ohio state trying find
0,2,10,36,1,8,0,46,0,disney channel aired first ever same-sexsmooch
0,3,3,86,0,15,0,89,0,marine le pen say illegal migrant child banned accessing free education healthcare
0,3,14,40,0,12,0,54,0,adorable pup named biden got meet former vp joe biden
0,2,7,37,1,6,0,44,0,france tense presidential election get way
0,3,5,59,5,12,0,64,0,morning brief: trump give 'fox friends' exclusive preview tonight's speech
0,2,3,47,2,9,2,50,0,"nobel laureate, poet playwright derek walcott dead, aged 87"
0,3,0,49,0,10,2,49,0,10 thing every driver know driving snow
0,1,6,45,0,9,0,51,0,issue execution retarded return supreme court
0,2,9,22,0,5,0,31,0,nfc beat afc dodgeball challenge
0,3,4,84,6,16,0,88,0,malaysia expects arrest murder kim jong un's half-brother including 'important person'
0,3,5,60,4,11,4,65,0,"child dental benefit scheme: government responds backlash, keep rebate $1,000"
0,1,2,29,0,6,0,31,0,two arrest made zotob worm attack
0,2,2,53,0,8,4,55,0,hillary clinton give first major 2016 presidential campaign speech
0,1,2,27,0,4,0,29,0,new legal british tender revealed
0,3,2,37,0,9,4,39,0,china say launch first mar probe 2020
0,1,1,41,0,5,0,42,0,indonesian passenger plane crash mountain
0,2,1,34,1,5,0,35,0,eco guide female-friendly shopping
0,3,8,43,4,11,0,51,0,"what's new netflix, itunes, hulu amazon january yahoo"
0,3,4,30,0,6,0,34,0,vw pleads guilty u emission charge
0,3,10,45,0,10,0,55,0,fired ohio state band director drop claim sexism dispute
0,2,8,43,2,9,0,51,0,kate mckinnon slays 'snl' cristiano ronaldo joke
0,3,7,26,3,5,0,33,0,trump u.k. interest go beyond politics
0,2,8,40,3,8,0,48,0,"joey bada$$ reveals title, release date sophomore album"
0,2,2,44,1,8,0,46,0,comic tackling last taboo: holocausthumor
0,2,8,82,1,19,0,90,0,stop looking me! confused rooster staring contest reflection try attack
0,2,4,44,5,11,0,48,0,cavs' kyrie irving belief 'they lie us' 'earth flat'
0,2,9,39,0,11,2,48,0,bombing near shiite place worship kill 22 nw pakistan
0,3,14,65,1,18,2,79,0,breaking news: three killed bus carrying 50 school child flip road northern sweden
0,2,11,65,5,13,0,76,0,flashback: rev. jesse jackson praise trump reaching inclusive breitbart
0,3,11,35,1,7,0,46,0,a&e cancel upcoming kkk docuseries cash payment
0,2,7,54,4,12,0,61,0,elena delle donne half knot first same-sex dream wedding couple
0,1,7,32,0,7,0,39,0,detroit face critic anger tear
0,3,8,59,2,9,0,67,0,"anti-semitic joke cause youtube, disney distance pewdiepie"
0,3,14,64,4,18,0,78,0,mariah carey talk collaborating yg 'i don't' wanting burn wedding dress video
0,3,1,56,0,10,2,57,0,germany see nearly 10 attack refugee migrant day
0,2,8,39,4,9,0,47,0,lavoy allen writes 'go pacers!' cavaliers' home court
0,3,20,54,2,17,0,74,0,"farmer ip officer, man's story inspire chase dream"
0,1,8,49,3,9,0,57,0,"website bill o'reilly, fox news commentator, hacked retribution"
0,2,1,63,2,10,0,64,0,bitcoins murkier rival line displace cybercriminals favourite
0,3,3,44,2,9,0,47,0,four 'supersized' prison built england wale
0,2,8,36,0,8,0,44,0,donald trump pick ben carson head housing agency
0,3,13,57,4,16,1,70,0,twenty one pilots' 'heathens' break record week no. 1 hot rock song chart
0,1,6,31,0,6,0,37,0,hartmarx win court approval sell
0,1,2,30,0,6,4,32,0,earth day 2009 celebrated around globe
0,3,6,30,0,7,0,36,0,russia seek backing new talk syria
0,3,4,31,2,8,0,35,0,'om telolet om' meme bizarre origin
0,1,5,16,0,4,0,21,0,air time playtime
0,1,2,59,3,9,0,61,0,police: austrian child kept dungeon 'oppressive' condition
0,1,4,22,0,4,0,26,0,libya free foreign hiv medic
0,1,3,16,0,2,0,19,0,unwinding fed support
0,1,2,36,0,5,0,38,0,south australian educational blog shut
0,2,3,9,0,4,0,12,0,see seen
0,1,1,41,0,6,0,42,0,bangladesh mutiny leaf score officer dead
0,3,4,28,0,7,2,32,0,hollywood star zsa zsa gabor dy aged 99
0,1,8,27,2,8,0,35,0,clinton say u.s. ready lead climate
0,1,6,35,0,7,0,41,0,sydney opera house listed world heritage list
0,2,14,66,3,16,2,80,0,"michael hubbard, alabama house speaker, convicted 12 felony ethic charge new york time"
0,1,7,45,3,9,4,52,0,super tuesday 2012: 'joe plumber' win gop congressional primary
0,3,2,48,0,8,0,50,0,seven charged attempted murder berlin homeless man
0,1,3,44,1,7,0,47,0,man arrested prostitutes' murder great britain
0,1,9,29,3,7,0,38,0,s.e.c. seek ruling reserve primary fund case
0,3,5,54,0,11,0,59,0,jeff session asks dozen u attorney appointed obama resign
0,3,16,62,2,14,0,78,0,indian doctor's quick action helped save life air-hostess onboard malaysian flight
0,2,1,35,0,7,0,36,0,instagram changing comment big way
0,2,7,32,0,7,0,39,0,janet jackson share first photo baby eissa
0,1,6,27,0,8,0,33,0,find hope shift drug policy
0,2,3,51,5,13,0,54,0,d.c. mayor personal travel office wont say
0,1,3,33,0,6,2,36,0,mexican cartoonist gabriel vargas dy 95
0,1,7,38,0,7,0,45,0,u senate confirms supreme court nominee elena kagan
0,1,2,19,0,4,2,21,0,nelson mandela dy aged 95
0,3,2,59,0,12,0,61,0,afghan family visa held california attorney asking
0,2,6,31,3,10,2,37,0,real madrid 2-1 real betis: la liga happened
0,1,5,56,0,10,0,61,0,three football world cup journalist robbed gunpoint south africa
0,1,8,55,3,12,2,63,0,a.j. pierzynski lead chicago white sox narrow 5-4 win detroit tiger
0,3,4,58,0,10,0,62,0,emma stone ryan gosling describe spectacular dancing fail
0,2,9,47,0,10,0,56,0,iraqi city mosul transformed year islamic state capture
0,2,2,52,2,8,0,54,0,government planning possible take-over southern rail report
0,3,13,47,3,13,0,60,0,option market worried retail woe -- maybe
0,3,5,29,0,5,0,34,0,marine corp statement photo scandal
0,2,8,38,3,8,0,46,0,halle berry wild free oscar curl divide twitter
0,1,8,31,0,7,0,39,0,mybook disk drive handle lot easy backup
0,3,10,61,0,12,0,71,0,newborn dying stroke survives doctor perform surgery designed adult
0,1,7,31,0,7,0,38,0,mother waco sect leader fatally stabbed
0,2,9,44,2,10,0,53,0,report: dem staffer boo trump unity baseball game breitbart
0,2,1,65,1,11,0,66,0,"primary school unisex bathroom first time, council reveals"
0,2,4,51,0,12,0,55,0,u woman likely outperform men olympics
0,2,1,53,2,8,0,54,0,tinder in-house sociologist help user like findlove
0,3,2,73,3,13,0,75,0,"ivanka trump's clothing selling poorly, company making secretly re-labelled"
0,2,1,35,0,5,0,36,0,uber driver charged rapingpassenger
0,2,10,42,1,11,0,52,0,"donald trump sworn president, capping swift ascent"
0,3,7,35,1,11,0,42,0,delta struggle recover last week storm
0,3,3,69,0,16,2,72,0,ugandan football player fan drown lake albert 30 die party boat capsizes
0,1,6,40,0,5,0,46,0,philadelphia mayor proposes temporary tax increase
0,3,5,45,2,10,0,50,0,td celebration 'jerry maguire' would look like
0,3,1,51,1,11,4,52,0,man wrongly imprisoned 31 year get $75 compensation
0,3,4,37,1,8,2,41,0,general tso's chicken creator dy taiwan aged 98
0,3,2,55,0,10,0,57,0,kremlin reportedly ordered state medium tone trump coverage
0,2,1,40,1,11,5,41,0,somalia: 110 dead hunger past 48 hour drought
0,1,1,54,1,8,0,55,0,"schiphol airliner crash blamed altimeter failure, pilot error"
0,2,7,40,1,7,2,47,0,miranda lambert's top 10 memorable live performance
0,2,10,45,1,11,0,55,0,cherry blossom washington could peak early new york time
0,3,8,46,1,12,0,54,0,"u troop may needed fight isi syria, commander say"
0,2,13,48,0,12,0,61,0,eric holder rip republican trying make difficult vote
0,3,3,62,6,12,0,65,0,"brilliant, bold, bisexual, boss: author 'goodnight moon' time"
0,2,16,63,4,17,0,79,0,limbaugh flynn resignation: question barack obama know know it?
0,3,3,44,2,10,1,47,0,"woman say iphone 6 plus ""burst flames"" slept"
0,3,12,57,0,11,0,69,0,starbucks baristas totally hate unicorn frappuccino losing online
0,1,3,18,0,3,0,21,0,generic tamiflu india
0,2,2,62,1,10,0,64,0,christopher lee: actor muscular intelligence staggering career
0,1,6,34,0,7,0,40,0,swap meet continues jet maneuver greene
0,1,8,35,0,7,0,43,0,ronald moore lift siena carrying burden
0,2,14,52,4,15,0,66,0,"j. cole, fetty wap nicki minaj spotify editors' new music friday pick"
0,2,2,47,2,6,0,49,0,prison suicides: warning segregating at-risk inmate
0,2,4,45,1,9,0,49,0,"senate act week obamacare repeal, mcconnell say"
0,1,9,36,1,9,0,45,0,"amid new faces, alissa czisny first short program"
0,3,7,43,1,8,0,50,0,lenin moreno slightly ahead ecuador presidential vote
0,3,5,43,1,8,0,48,0,trump relaxes u policy middle east two-state solution
0,2,2,35,2,5,0,37,0,"houston shooting: nine injured, suspect dead"
0,2,1,42,1,7,0,43,0,small-town store fire racist sign display
0,2,16,49,2,11,0,65,0,kpmgvoice: much power president trump actually trade deals?
0,2,15,74,8,15,0,89,0,"immigration attorneys: industry push foreign labor, claiming u.s. student cant hack tech breitbart"
0,2,4,43,6,8,0,47,0,u.n. right chief decries bigotry u.s. presidential race
0,2,14,49,2,10,0,63,0,pakistan building 'first missile warship' would protect cpec route
0,1,8,37,1,8,0,45,0,family dr. king charged group building monument
0,1,3,22,0,5,4,25,0,viewed win 2008 melbourne cup
0,3,10,47,1,12,0,57,0,obama watchdog congress new target trump era: postal reform
0,2,4,39,1,8,0,43,0,kelly rowland want find next destinyschild
0,2,3,53,1,10,0,56,0,member congress learning play trump ethical blame game
0,2,8,30,1,7,0,38,0,armour admits still cool enough
0,1,5,36,0,6,0,41,0,cost borrowing zoom higher corporation
0,1,3,53,0,10,0,56,0,republican leader u want tax relief economic stimulus
0,2,16,56,4,17,1,72,0,"chilling new trailer got season 7 finally cersei, jon snow daenerys take arena!"
0,1,6,36,0,6,0,42,0,plan fight illegal downloads face opposition
0,3,2,46,1,5,0,48,0,joe biden accidentally reveals post-inauguration plan
0,2,2,58,2,12,0,60,0,mr. sander need come clean funding health-care plan
0,3,8,34,2,13,6,42,0,"rae sremmurd return no. 1 hot 100, migos soar top 10"
0,3,5,62,3,12,0,67,0,"uk region could become 'cash deserts' free atm disappear, industry body warns"
0,2,10,62,2,9,0,72,0,twitter temporarily censored drudge report tweet behind sensitive content filter
0,3,4,45,4,10,0,49,0,"fake news 'killing people's minds', say apple bos tim cook"
0,1,8,41,0,8,0,49,0,steve stricker jump contention personal best
0,1,5,28,0,5,0,33,0,congress reach deal stimulus plan
0,3,9,31,0,9,0,40,0,new bionic leg learn predict move
0,2,5,30,0,5,0,35,0,corporate japan look outside advice
0,3,5,52,7,7,0,57,0,'anti-democratic un-american': bruce springsteen slam 'muslim ban'
0,1,2,42,0,7,0,44,0,algerian driver released hostage taker niger
0,1,7,31,2,5,0,38,0,suspected arm dealer challenge u.s. tactic
0,3,9,34,4,7,0,43,0,"china jetliner dream built u.s., european part"
0,3,3,53,2,8,0,56,0,"trump lawyer pushed pro-russia deal ukraine, politician claim"
0,1,6,35,0,6,0,41,0,australia end ban shorting financial stock
0,2,7,40,0,9,0,47,0,republican grappling repeal obamacare
0,3,7,47,1,6,0,54,0,twitter blast kendall jenner's cringeworthy pepsi commercial
0,2,10,59,0,13,2,69,0,north pole temperature expected soar 50 degree normal christmas nears
0,1,7,27,1,6,0,34,0,mrs. obama speaks household
0,2,5,35,5,7,0,40,0,turning back: pm may trigger historic brexit
0,1,3,54,0,9,0,57,0,mass protest grows kudankulam nuclear power plant india
0,1,4,54,0,8,0,58,0,duke edinburgh leaf uk hospital following exploratory surgery
0,2,4,43,1,10,0,47,0,captain planet return take superhero tv zero
0,3,10,39,2,10,0,49,0,ed sheeran debated giving rihanna new song 'shape you'
0,3,2,78,4,11,3,80,0,instant awesome: 101-year-old veteran sings national anthem women's military appreciation night
0,1,6,30,0,8,0,36,0,wall street stumble day nears end
0,1,7,36,1,7,0,43,0,"factory close, graduate focus college"
0,2,10,55,2,9,0,65,0,alleged 'hollyweed' mastermind explains vandalized hollywood sign
0,3,9,37,1,8,0,46,0,spotify host podcast hip-hop exec chris lighty
0,1,4,55,1,9,0,59,0,ralph nader: obama likely face challenge democratic primary
0,1,9,62,3,12,0,71,0,"rancagua, chile servicio mdico legal boss, juan daz, suspended juanita carey case"
0,1,4,61,0,10,0,65,0,bomb destroys spanish police barrack kill policeman basque country
0,1,8,31,3,7,6,39,0,2007/08 bundesliga: bayern munich vs. hertha bsc berlin
0,2,2,69,3,15,0,71,0,ferguson fed agreement policing reform. here might work.
0,1,4,38,0,5,0,42,0,brazilian president meet president colombia
0,3,14,66,1,18,0,80,0,"every year, droz family scour america best road sign make perfect new year card"
0,2,2,70,0,14,0,72,0,dude troll starbucks baristas bunch weird container fill coffee
0,1,7,77,2,13,0,84,0,'bloody sunday inquiry' publishes report british army killing activist northern ireland
0,2,3,56,0,11,0,59,0,adam mcquaid cleared play stitch close neck wound
0,3,3,53,0,9,0,56,0,japan recall ambassador south korea comfort woman statue
0,1,3,54,1,10,2,57,0,study suggests 48% u soda fountain machine coliform bacteria
0,2,7,49,3,10,0,56,0,"paul millsap hawks' loss: played basketball, played mma"
0,3,4,51,1,11,2,55,0,destination norwegian offer flight new york less 60
0,2,3,53,1,10,0,56,0,obamas visit come american business rushing back cuba
0,1,3,42,1,7,0,45,0,"explosion san francisco injures one, cause unknown"
0,2,13,39,2,13,2,52,0,18 thing youll get youre best worst person youknow
0,3,4,45,0,8,0,49,0,donald trump defends u immigration ban backlash grows
0,3,2,56,1,12,2,58,0,kathrine switzer: 50 year ago woman allowed run themarathon
0,2,8,47,4,8,0,55,0,oregon shakespeare festival season includes same-sex oklahoma!
0,2,4,51,3,7,0,55,0,"princess charlotte 'sleeps night', report prince charles"
0,1,8,31,0,8,0,39,0,new york post carry news jerusalem post
0,3,10,26,0,10,4,36,0,viral photo paving way ballet 2017
0,3,15,52,2,13,0,67,0,attorney general rohatgi blast 'sit ac room criticise army'
0,2,16,57,0,15,0,73,0,high school boy sued share bathroom transgenderstudent
0,2,9,37,1,10,4,46,0,europe expanding clo market build record year 2017
0,2,1,49,1,10,0,50,0,trump's devastating new travel ban built harmful myth
0,2,6,71,2,12,0,77,0,kansa move expand medicaid gop legislature face pressure trumpcare failure
0,3,4,50,1,11,4,54,0,"amp post first full year loss since 2003, suncorp profit edge higher"
0,1,6,34,0,9,0,40,0,criticism afghan war rise britain
0,1,2,26,2,5,0,28,0,uk threat level reduced 'severe'
0,1,3,46,0,6,0,49,0,uae launch national authority scientific research
0,2,1,37,1,6,0,38,0,trump circle looking outside legal team
0,3,2,45,1,9,0,47,0,"u life expectancy falls, many kind death increase"
0,1,3,64,2,11,1,67,0,al gore-owned cable news channel relaunch august 1 viewer-created content
0,2,2,41,0,10,0,43,0,critical coal plant trump may able tosave
0,1,3,44,2,9,0,47,0,un: world hunger all-time high due economic slowdown
0,2,1,59,2,9,0,60,0,nettle 'thuggish' plant forcing endangered wildflower
0,1,5,33,0,6,0,38,0,william morris endeavor explore merger
0,1,5,44,0,11,0,49,0,new york man pleads guilty new york city subway bomb plot
0,2,15,57,6,15,0,72,0,"comedian ahsaan qureshi slam sunil grover, asks stop 'this nautanki' 'grow spine'"
0,3,5,32,0,8,0,37,0,rb eddie lacy agrees deal join seahawks
0,2,3,42,3,7,0,45,0,"capt. kidd treasure found madagascar, report say"
0,2,9,53,2,11,0,62,0,nation islam louis farrakhan offer protect beyonc police wont
0,3,1,57,1,11,0,58,0,trump signal press human right ahead key diplomatic week
0,2,17,44,9,14,0,61,0,geno auriemma: many woman want coach. daughter: dad. walk back.
0,1,7,26,3,7,4,33,0,"fine recession wear, $7,000 suit saks"
0,2,3,87,3,17,0,90,0,"despite setback job cuts, google promising big update race amazon delivery drone"
0,3,8,43,2,11,0,51,0,debate night: read watch sander vs. cruz cnn
0,1,1,45,1,6,0,46,0,swiss finish drilling world's longest overland tunnel
0,3,3,22,0,4,0,25,0,snowstorm hit northeast
0,1,4,84,1,16,0,88,0,"judge order resident city come agreement partially collapsed building buffalo, new york"
0,2,10,42,4,9,0,52,0,fault: researcher confirm cancer often random
0,1,9,52,2,10,0,61,0,"polish ex-premier lead european parliament, first eastern europe"
0,3,12,51,3,12,2,63,0,"india's kanika tekriwal, 28, revving private jet helicopter market"
0,1,5,34,0,6,0,39,0,matchmaking first mate rachel alexandra
0,2,1,44,0,8,0,45,0,finally stop feeling guilty eating quinoa
0,1,7,34,1,9,0,41,0,practice round golf? think
0,3,2,51,1,8,0,53,0,thousand academic sign letter opposing trump's travel ban
0,1,2,21,0,6,0,23,0,end era winfrey
0,3,2,51,1,9,0,53,0,medical mystery: cluster patient struck rare amnesia
0,3,4,56,0,11,0,60,0,london underground advert causing massive sexism row list
0,2,6,39,0,8,0,45,0,south korea race limit economic fallout mers
0,2,9,40,0,9,0,49,0,berlin market attack mar square three era coexist
0,1,7,34,2,5,0,41,0,vermont hold hearing same-sex-marriage bill
0,1,2,41,2,6,4,43,0,re-creation 1919 cross-atlantic flight successful
0,2,11,53,0,12,0,64,0,princeton latest ivy league school suspend team vulgar material
0,2,3,56,1,8,0,59,0,eleanor hawkins' father relieved malaysian court free tourist
0,2,4,60,3,10,0,64,0,republican slam democratic woman wearing white trump speech [video]
0,2,10,52,0,11,0,62,0,young men senegal join migrant wave despite growing prosperity home
0,1,6,36,1,6,0,42,0,"despite profit decline, optimistic word nokia"
0,3,14,45,4,13,0,59,0,nfl star ben watson march life: 'the pre-born important' insider
0,2,13,39,2,12,0,52,0,michael moore take donald trump 'at word'
0,1,2,38,0,6,0,40,0,two injured explosion toronto fairground
0,1,3,47,2,7,0,50,0,"five killed mid-air collision warwickshire, england"
0,1,2,57,0,10,0,59,0,cuban athlete banned life attack referee olympics
0,1,2,36,0,8,0,38,0,fifteen flu sufferer die wale one week
0,2,2,56,3,6,0,58,0,"sanders, citing email controversy, question clinton electability"
0,3,2,41,0,8,0,43,0,brazil police reach accord end strike vitoria
0,1,6,32,0,7,0,38,0,american apparel sell stake buyout firm
0,1,9,45,1,11,0,54,0,"east west pull moldova, loyalty division run deep"
0,2,0,23,1,6,3,23,0,7 show mattered '70s
0,3,8,58,2,12,0,66,0,"""real housewife beverly hills"" star kim richards say dated donald trump"
0,2,14,65,6,13,0,79,0,"mark steyn back #dumpkelloggs: kellogg real target trump supporters, breitbart"
0,2,12,51,0,11,0,63,0,watermelon ceviche recipe hit perfect balance salty sweet
0,3,1,35,1,7,0,36,0,london terrorist attack: know far
0,3,5,25,0,6,2,30,0,28 way take better vacation photo
0,2,11,55,1,10,0,66,0,cleveland man make awesome cry jordan-themed uniform league team
0,2,11,47,4,8,0,58,0,u.n. security council approves syrian cease-fire plan russia-turkey
0,2,5,29,1,4,0,34,0,putin quashes japan territorial hope
0,2,13,55,1,11,0,68,0,jewish human right group call special probe anti-semitic bomb threat
0,2,3,40,2,9,2,43,0,"75 year ago, japan never attacked pearl harbor?"
0,1,2,37,0,4,0,39,0,suspected iraqi bomber murder investigator
0,2,1,62,0,13,0,63,0,queen appears public first time month suffering heavy cold
0,1,8,29,0,8,0,37,0,time heal wound ailing mets
0,3,10,58,2,13,0,68,0,spotify develop hardware 'affect way world experience music'
0,2,12,56,5,12,0,68,0,kiesza discusses 'immense tragedy' preceding second album: 'i let heal'
0,3,8,43,0,9,1,51,0,tim tebow single marlin 1st spring training hit
0,3,12,39,9,13,3,51,0,"tyga recruit lil wayne 'act ghetto,' tap chief keef a.e. '100's'"
0,1,3,72,0,10,0,75,0,blown good author discusses life inside international headquarters scientology
0,1,7,31,0,6,0,38,0,kosher label missing girl scout cooky
0,1,5,31,0,6,0,36,0,american accused stealing fuel iraq
0,3,4,46,0,8,0,50,0,chris pratt keep cropping jennifer lawrence photo
0,3,1,29,0,4,3,30,0,netflix nears 100 million subscriber
0,2,11,42,1,10,0,53,0,oprah aha! moment rethinking running president
0,1,7,37,0,6,0,44,0,wisconsin score overtime upset florida state
0,1,5,48,2,8,0,53,0,"large hoard anglo-saxon gold found staffordshire, england"
0,2,4,53,5,12,0,57,0,"report: ""big bang theory"" star take pay cut raise female co-stars' pay"
0,1,2,36,1,6,5,38,0,"13,500 evacuated wildfire california"
0,1,3,31,0,6,0,34,0,ice shelf break free canadian arctic
0,2,1,48,1,8,4,49,0,"clinton skipped special cyber briefing 2011, document show"
0,1,4,19,1,3,2,23,0,soyuz tma-11 spacecraft land
0,3,7,34,2,8,0,41,0,kyrie irving play 'uncle drew' upcoming movie
0,1,6,32,0,6,0,38,0,bruney look explain continued elbow pain
0,3,5,47,2,11,0,52,0,south korean demand leader's removal new year's eve protest
0,2,1,49,0,8,3,50,0,northampton couple convicted nearly 100 child sex offence
0,3,8,35,3,8,0,43,0,jennifer lopez tease new show 'world dance': watch
0,3,7,35,1,10,6,42,0,leaked return show trump paid $38 million tax 2005
0,1,6,42,0,9,2,48,0,former prime minister finland harri holkeri dy aged 74
0,3,4,76,1,16,1,80,0,ghost shell top international box office beaty beast nears $1 billion worldwide
0,1,9,41,1,12,0,50,0,"male mouse sing woo, female answer first call"
0,1,3,44,2,8,2,47,0,new poll indicates barack obama's approval rating 50%
0,3,9,48,1,8,0,57,0,trump's hiring freeze could imperil breakthrough discovery bee
0,3,7,41,0,10,4,48,0,ranking best potential landing spot tony romo 2017
0,1,8,31,1,8,0,39,0,"feeling secure, bank want left alone"
0,1,7,44,0,9,0,51,0,court photo show flds leader warren jeffs child bride
0,1,3,55,1,7,0,58,0,national museum scotland reopens three-year redevelopment
0,3,7,32,2,11,2,39,0,"eugene cernan, last human walk moon, dy 82"
0,1,3,53,1,5,0,56,0,colombian constitutional court pass presidential re-election
0,1,2,33,0,7,0,35,0,least ten dead clash nigeria
0,1,5,62,0,9,0,67,0,british isps restrict access wikipedia amid child pornography allegation
0,1,4,55,0,11,3,59,0,salvage operation begin retrieve black box adam air flight 574
0,1,1,44,0,7,0,45,0,islamabad red alert possible terrorist attack
0,3,1,52,2,12,0,53,0,migrant told 'when put rubbish queue'
0,1,3,63,2,9,0,66,0,"guantanamo detainee david hick pleads guilty providing ""material support"""
0,3,3,49,3,9,1,52,0,syria war: g7 reject sanction russia 'chemical attack'
0,1,2,22,0,4,0,24,0,hamas end truce israel
0,3,4,58,3,11,0,62,0,k-pop band six bomb 'celebrate' plastic surgery video
0,2,10,58,2,11,4,68,0,"world anti-doping agency report implicates least 1,000 russian athlete scandal"
0,3,3,53,0,8,0,56,0,nicola sturgeon give backing westminster terror row minister
0,3,3,49,1,7,0,52,0,venezuela's president maduro call talk opposition
0,1,1,36,0,5,0,37,0,hurricane may associated sunspot
0,3,7,48,1,11,0,55,0,"ram hire sean mcvay, making youngest head coach nfl history"
0,2,7,38,0,6,0,45,0,north korea launched another ballistic missiletest
0,1,5,27,1,5,0,32,0,hugo chavez meet iran's imam khamenei
0,1,3,27,0,6,0,30,0,u student reveals book visit hoax
0,2,2,47,2,8,0,49,0,"boot, wheelbarrow, thimble ousted monopoly board game"
0,2,8,56,2,11,0,64,0,"suns' lineup youngest nba history, younger several ncaa tourney team"
0,2,5,67,8,11,0,72,0,minute-by-minute breakdown shocking moonlight/la la land best picture mix-up
0,1,6,40,0,6,0,46,0,trade minister quits iraq investigates corruption
0,3,12,43,0,10,0,55,0,people ticked rory mcilroy played golf donald trump
0,1,4,49,0,7,0,53,0,new south wale premier criticised government structure
0,2,4,60,2,11,0,64,0,"new york man arrested bringing knives, firework trump tower, police say"
0,1,10,31,2,7,0,41,0,german bnd claim u.s. exaggerated iraq wmd claim
0,1,5,44,0,6,0,49,0,hurricane adrian strike central america thursday night
0,3,8,37,0,8,0,45,0,trump push voter fraud claim citing fringe blogger
0,1,1,27,0,7,8,28,0,romania adopt euro 2012 2014
0,1,6,33,1,6,0,39,0,afghan taleban attack nato base; several dead
0,2,3,59,1,11,0,62,0,host valentine's day dinner local refugee digital toolkit
0,2,4,69,1,15,0,73,0,syrian war: fear civilian life side syrian army take control aleppo
0,2,7,43,1,10,0,50,0,"house health bill doa unless major changes, gop senator say"
0,3,5,53,1,8,0,58,0,"grammys producer address justin bieber, kanye west boycott rumor"
0,3,9,38,0,8,0,47,0,china think figured online grocery shopping
0,1,7,32,0,6,0,39,0,tv paparazzo turn camera corporate titan
0,3,13,62,4,12,0,75,0,congressman's teen son 'grounded' dabbing swearing-in photo speaker ryan
0,1,1,38,1,7,2,39,0,6.5 magnitude earthquake hit coast taiwan
0,3,13,59,2,12,0,72,0,study suggests people 'accidentally' smashing phone upgrade
0,2,11,56,1,9,0,67,0,mitsubishi heavy industriesvoice: evolution impact online shopping
0,3,12,24,3,8,1,36,0,future score fourth no. 1 album 'future'
0,2,15,60,5,15,0,75,0,"wednesday evening briefing: donald trump, j. dennis hastert, ted cruz new york time"
0,2,1,15,0,4,0,16,0,racist badday
0,2,14,44,6,10,0,58,0,"post-brexit, thing could change u.k. sports, pet duty-free booze"
0,3,14,46,0,11,0,60,0,plan cbs viacom merger called redstones pull support
0,3,1,60,2,13,0,61,0,sexism row estate agent advert call woman 'modern extension'
0,3,16,57,4,14,0,73,0,"mike made-it link kendrick lamar, gucci mane rae sremmurd ""perfect pint"""
0,1,7,26,2,6,2,33,0,18-year-old son need elbow surgery
0,1,2,44,1,7,0,46,0,zimbabwean cargo plane crash shanghai; three dead
0,3,14,61,0,13,0,75,0,mumbai cop reveal famous bollywood name used underworld mafia dealing drug
0,1,4,42,0,9,0,46,0,family amanda knox plan appeal italian court
0,2,7,34,1,8,0,41,0,meryl streep wont wearing chanel oscar
0,2,6,56,1,16,6,62,0,kitkat maker nestl remove 10% sugar chocolate uk ireland 2018
0,1,3,70,2,13,0,73,0,"australian labor party leader urge supporter ""take cold shower"" poll result"
0,3,2,49,0,9,0,51,0,shrine believed house cave jesus buried reopens
0,3,1,46,3,12,4,47,0,"trump 3,000 website say rise power"
0,2,17,52,9,13,0,69,0,pittsburgh steeler le'veon bell (a.k.a. juice) unleashes new rap cut 'get wit it': premiere
0,2,1,46,0,8,4,47,0,somali pirate suspected first ship hijacking since 2012
0,1,3,49,1,9,0,52,0,nine killed protest spread kandahar qur'an burning
0,1,9,48,2,11,4,57,0,2008 taste taiwan cuisine: complex redefine taiwan's mouse industry
0,3,9,45,2,10,0,54,0,chrissy teigens latest tweet prof shes queen clap back
0,2,9,46,2,8,0,55,0,bloomberg launch new london-based trading platform moneybeat
0,1,7,33,0,7,0,40,0,obama toughens lighting rule cut energy use
0,1,5,23,0,5,0,28,0,bomb blast kill tourist cairo
0,2,14,47,1,10,0,61,0,watch: little girl wow amazing taylor swift impersonation insider
0,3,13,43,0,13,2,56,0,soulja boy dropped new dis track targeted 50 cent chris brown
0,3,4,65,0,9,0,69,0,arnold schwarzenegger terminates troll question need special olympics
0,2,6,40,1,12,4,46,0,fifa crisis: uk look head world cup 2022 row qatar
0,2,8,60,3,10,0,68,0,"david guttenfelder, photojournalist, answer reader question north korea"
0,2,8,39,1,7,0,47,0,"trump proposes slashing medical research year,"
0,2,4,48,3,9,0,52,0,hidden figures: nasa hired first black woman 'computers'
0,3,2,54,2,10,0,56,0,film production company behind 'her' getting video game
0,3,2,54,0,8,0,56,0,queen elizabeth miss second holiday church service season
0,1,2,48,2,8,0,50,0,"china: heavy flooding displaces million, kill dozen"
0,1,4,54,1,14,8,58,0,"downing street memo forum held june 16th response petition 500,000"
0,3,4,79,4,16,4,83,0,"'the casualty figure staggering': nearly 2,000 iraqi fighter killed battle mosul"
0,3,1,83,2,14,0,84,0,"global carbon dioxide emission steady three years, raising hope long-term trend downwards"
0,2,3,28,0,7,0,31,0,look court gorsuch joining
0,2,6,44,1,8,0,50,0,pope francis lead easter celebration st peter's square
0,1,3,45,0,8,0,48,0,suspended letterbox sale new zealand auction site
0,3,14,50,5,14,0,64,0,"zara larsson wow 'the late late show' acoustic version ""so good"": watch"
0,3,4,80,1,13,0,84,0,james packer wanted questioning israeli police netanyahu corruption probe: medium report
0,1,4,42,1,9,3,46,0,9/11 health care bill passed u house representative
0,1,1,68,0,8,0,69,0,documentary suggests nun excommunicated exposing paedophilic priest
0,3,9,39,1,9,1,48,0,finance titan face $5 trillion london gold market
0,3,10,36,1,9,2,46,0,china slap gm $29 million fine amid growing tension
0,1,7,26,2,7,0,33,0,u.n. warns refugee crisis gaza strip
0,3,4,69,1,13,0,73,0,jailed navy sailor's family hopeful trump tell hannity considering pardon
0,2,4,54,3,10,0,58,0,ex-nfl player suffering memory loss writes love letter family
0,3,4,58,3,11,0,62,0,"israel denies human right watch work visa due 'extreme, hostile agenda'"
0,1,2,32,0,5,0,34,0,two death unreported natrecor study
0,1,6,35,0,6,0,41,0,concrete remixed environment mind
0,2,16,62,3,13,0,78,0,"srk's tribute mumbai, sylvester stallone's message dog entertainment"
0,1,6,27,1,5,0,33,0,"somalia, chaos breed religious war"
0,2,12,56,5,13,0,68,0,netanyahu: obama failed protect israel gang-up un breitbart
0,2,7,46,0,9,2,53,0,35 expelled russian diplomat family arrive back moscow
0,1,6,32,0,5,0,38,0,quake fear stall energy extraction project
0,1,2,66,0,11,0,68,0,bus driver convicted killing eleven falling asleep california crash
0,3,8,39,0,9,0,47,0,internet freaking price guacamole
0,2,3,43,2,9,0,46,0,mississippi church member charged 'vote trump' arson
0,2,10,59,2,9,0,69,0,"blake griffin trade rumors: celtics, clipper reportedly discussed possible deal"
0,1,7,32,1,7,0,39,0,"secure enough sin, baghdad revisits old way"
0,2,12,37,2,11,0,49,0,taylor swift didnt go womens march people aremad
0,2,9,39,1,10,3,48,0,turner said win champion league tv right $180 million
0,3,10,48,1,10,0,58,0,ted cruz tweet uncanny resemblance duke's grayson allen
0,1,6,35,0,6,0,41,0,chinese question police absence ethnic riot
0,1,2,17,0,4,2,19,0,ephraim kishon dy 80
0,2,11,44,3,10,0,55,0,witness describes fatal crash berlin market video nytimes.com
0,3,12,52,4,12,0,64,0,"minnesota gov. mark dayton 'doing great' fainting speech, son say"
0,3,4,71,0,14,0,75,0,former nsa contractor accused stealing top secret document say hoarder
0,2,15,26,2,11,0,41,0,"asap ferg remy rep ""east coast"" new song"
0,1,3,36,2,5,0,39,0,"erica powell, nkrumah's private secretary dy"
0,3,2,48,1,9,1,50,0,daughter late iran president get 6-month prison sentence
0,3,13,43,2,14,6,56,0,india become world's youngest nation 2020 average age 29!
0,2,17,55,5,11,4,72,0,"revealed: washington post uncovers 1,100 hidden foreign clinton cash donation breitbart"
0,3,4,48,3,11,1,52,0,brexit: 1m eu citizen britain 'could risk deportation'
0,2,4,20,0,5,4,24,0,best carpool karaoke 2016
0,2,13,69,4,13,0,82,0,"billboard dance chart upstarts: kris kross amsterdam, rain man remixed summer/streisand classic"
0,2,8,42,1,9,0,50,0,constant threat war shaped israel tech industry
0,3,9,35,3,9,0,44,0,drake tell fan he's finishing 'more life' new video
0,2,13,47,2,14,3,60,0,"jon jones vs. daniel cormier fight likely happen ufc 214, say dana white"
0,2,2,57,1,13,0,59,0,firing federal worker isnt easy trump make seem budget
0,2,1,48,3,9,0,49,0,"brexit's mixed bag: good scotch, bad washing machine"
0,2,7,72,2,14,0,79,0,cia concluded russia worked elect trump. republican face impossible choice.
0,3,9,59,1,9,0,68,0,clemson's christian wilkins break dance move championship celebration
0,2,5,25,0,6,0,30,0,big sean receives key detroit
0,1,5,32,2,6,0,37,0,thousand protest iraq war washington d.c.
0,1,7,29,1,7,0,36,0,"without gas, bulgarian turn icy old ally"
0,2,15,53,1,13,0,68,0,congressman lost seat anti-gay remark tapped trump big agency job
0,1,5,32,1,6,0,37,0,fancy footwork audition knicks?
0,2,16,58,0,15,0,74,0,donald trump clear question tie russia releasing tax return
0,1,7,38,0,8,0,45,0,finder oldest baseball card score one mother
0,2,11,51,0,11,0,62,0,nightly news thousand travel see firefly put dazzling light show
0,2,5,47,2,10,0,52,0,latest jane austen riff pride prejudice andyawning
0,1,6,31,0,7,0,37,0,mets remain unbeaten replay booth
0,3,10,59,2,11,0,69,0,n.j. legislature pass bill require presidential candidate disclose tax
0,3,2,34,2,9,4,36,0,budget 2017: mean video analysis
0,2,14,71,1,13,0,85,0,discrimination lawsuit alleges black fox news employee forced arm wrestle white co-worker
0,2,6,34,3,7,0,40,0,pokemon go cause stampede taiwan breitbart
0,2,4,48,3,12,0,52,0,uber say 'no surprises' fare new year's eve
0,3,4,76,2,13,0,80,0,"donation tribe daniel snyders redskin foundation plummet second year, record show"
0,1,6,35,0,8,0,41,0,fresh paint flower iraqi house horror
0,2,2,67,1,15,2,69,0,"kansa left early big 12 tournament, might might mean anything"
0,1,6,38,2,7,0,44,0,congressman thad mccotter end bid u.s. president
0,2,2,15,0,1,0,17,0,bloomberg daybreak
0,3,3,70,3,14,0,73,0,mike penny say advocate free press. here shaky history transparency.
0,3,7,27,0,9,0,34,0,gas attack said kill dozen syria
0,3,5,54,5,11,0,59,0,aziz ansari's 'snl' monologue blistering attack 'lowercase kkk'
0,2,10,27,1,9,0,37,0,like grow bestfriend
0,2,4,56,1,10,0,60,0,mannequin challenge expertly show need parkinson's cure
0,3,11,54,2,11,0,65,0,louisiana senate race: foster campbell democrats' last hope nabbing seat
0,1,7,35,0,7,0,42,0,chicagoans lament willis name sears tower
0,2,7,30,2,8,4,37,0,grammy award 2017: james corden sing host
0,1,8,39,2,9,3,47,0,"christina mchale, ranked 374th, ready australian open"
0,2,11,59,2,10,0,70,0,'late show' imago candidate donald trump running president donald trump
0,3,8,44,6,12,5,52,0,"dota 2, counter-strike repeat played game steam 2016"
0,1,7,44,2,10,5,51,0,"israel open gaza border 25,000 carnations, bound europe"
0,3,5,46,5,9,0,51,0,depeche mode's martin gore: 'the alt-right liking u baffling'
0,2,4,85,2,19,3,89,0,chechen police round 100 gay men killing three following clamp putin's hard-man ally razman kadyrov
0,1,2,42,0,7,4,44,0,wikimania 2007 exhibition show culture freedom
0,3,9,53,1,10,0,62,0,serena williams responds ilie nastase's racist comment unborn baby
0,2,5,50,0,10,0,55,0,house democrat think donald trump deliver big gain
0,1,2,27,0,4,0,29,0,massive power failure hit brazil
0,2,9,66,5,13,0,75,0,"transfer news: radamel falcao, david de gea raheem sterling: let money-go-round begin"
0,3,13,39,1,10,2,52,0,samsung offer dream package r 78 lakh iit-madras student
0,1,6,39,0,7,0,45,0,persian station britain rattle official iran
0,3,5,49,0,9,0,54,0,man drowns swimming wattamolla lagoon christmas day
0,1,5,30,4,7,2,35,0,"u.s. vice president biden's mother dies, aged 92"
0,2,14,38,4,9,0,52,0,never again!: scott baio swears nordstrom ivanka snub
0,2,4,44,0,8,4,48,0,2016 formula one champion nico rosberg announces retirement
0,3,15,61,2,14,0,76,0,"walmart website show arunachal pradesh part china, indian losing shit!"
0,2,17,58,3,17,0,75,0,destroyed sparrow's habitat here's save bird lived amongst u
0,2,1,46,1,8,0,47,0,"sears owner milked iconic retailer dry, analystssay"
0,1,7,34,0,8,0,41,0,debated home run recall moment yankee lore
0,3,3,65,0,12,2,68,0,car bomb turkey kill 13 soldier amid growing resistance separatist kurd
0,3,13,66,1,13,0,79,0,"accused orlando cop killer markeith loyd make first court appearance, go profane tirade"
0,3,11,44,2,11,0,55,0,man wants: valentine day gift dude gaining ground
0,2,4,40,2,8,0,44,0,elon musk: tesla unveil semi-truck september
0,3,9,29,3,7,0,38,0,j. cole sign atlanta rapper j.i.d dreamville
0,3,2,38,1,7,0,40,0,aleppo battle: rebel brink amid rapid loss
0,2,10,39,1,11,0,49,0,"fed raise rates, credit card holder feel first"
0,1,3,61,0,10,0,64,0,indian foreign minister criticized reading wrong speech un summit
0,3,5,46,2,10,1,51,0,expert: 2 escaped convict likely still together cnn video
0,3,9,37,4,8,0,46,0,"oscar nomination in: la la land, diversity dominate"
0,1,7,23,4,7,4,30,0,"g.m. said pick michigan, saving 5,000 job"
0,2,8,48,1,8,1,56,0,bill gate launch $1 billion breakthrough energy investment fund
0,3,9,29,1,7,0,38,0,stock market impact trump-ryan tax cut
0,2,8,44,1,8,0,52,0,world breathtaking pub crawl requires helicopter
0,2,2,37,0,9,0,39,0,iran vow let trump destroy nuclear deal
0,2,3,41,1,7,0,44,0,twitter's dick costolo step chief executive
0,1,5,52,2,9,0,57,0,four jackpot winner confirmed u 'mega millions' lottery drawing
0,3,4,43,0,8,0,47,0,alaska airline killing virgin america brand
0,1,6,21,1,5,0,27,0,"sixth try, endeavour lift"
0,3,2,74,0,13,0,76,0,police kill suspect fatal shooting delaware state trooper hourslong standoff
0,1,3,34,0,8,3,37,0,stewart battle rain win pepsi 400 daytona
0,1,5,39,0,8,0,44,0,prince william harry host concert diana
0,1,3,57,3,9,3,60,0,eu fine microsoft $1.35 billion non-compliance antitrust decision
0,2,3,49,1,11,1,52,0,cam newton sat panthers' 1st play due dress code violation
0,1,6,43,0,8,0,49,0,taliban pakistan capture convoy bound nato troop
0,3,5,21,0,5,0,26,0,pink air jordan girl
0,3,5,52,3,10,0,57,0,sky's elena delle donne likely agree sign-and-trade mystic
0,3,8,40,2,7,2,48,0,ohio's 20-week abortion ban signal restriction ahead
0,1,4,36,0,8,0,40,0,ford pull ad gay medium facing afa boycott
0,1,2,41,0,6,0,43,0,violence erupts guadeloupe labor dispute
0,3,3,34,3,7,0,37,0,sean spicer: trump 'has heart' immigration
0,1,1,55,0,8,0,56,0,solar powered plane completes first leg transcontinental trip
0,1,1,34,2,5,0,35,0,new 'failed state index' report published
0,2,5,46,1,9,0,51,0,ayodhya dispute: india top court order trial bjp leader
0,3,11,48,1,11,3,59,0,man caught stealing 100 iphones coachella music festival!
0,2,2,37,0,7,0,39,0,dennis hastert pleads guilty count
0,3,3,67,0,13,0,70,0,collection letter jackie kennedy friend proposed hit auction block
0,2,7,34,0,8,0,41,0,prince harry meet lady gaga royal albert hall
0,2,5,67,1,11,0,72,0,"terrorist may seek target anzac day commemoration gallipoli, government say"
0,2,4,49,2,10,0,53,0,"storm chaser find unique way honor ""twister"" star bill paxton"
0,1,3,34,0,5,0,37,0,golfer tiger wood delivers apology speech
0,3,12,43,5,12,0,55,0,"g.o.p. lawmakers, skeptical obama plan hit syria, back trump"
0,1,2,35,0,6,0,37,0,dozen dead school collapse haiti
0,3,5,75,4,17,4,80,0,"former linkedin vp who's hired 3,000 people say hate networking, probably wrong"
0,1,4,44,0,9,2,48,0,tnt blamed chinese karaoke bar explosion killed 25
0,2,6,82,4,21,0,88,0,adidas armour locked bitter battle nike top u competitor here who likely win
0,3,4,58,0,11,0,62,0,theresa may face rebellion mp foreign student number
0,2,10,42,1,10,2,52,0,los angeles city council give final approval $15 minimum wage
0,1,5,25,0,4,0,30,0,bishop denied holocaust ousted
0,2,10,40,2,11,0,50,0,migos 'ready' perform super bowl petition pan
0,1,7,42,2,8,0,49,0,"hincapie armstrong, former teammates, take new role"
0,3,8,45,0,10,0,53,0,democrat ally wage fight derail labor secretary pick
0,3,5,62,0,14,0,67,0,jeremy corbyn much blame theresa may scottish referendum
0,1,4,20,1,5,0,24,0,next french meteor?
0,3,1,49,0,10,0,50,0,new drone owner urged read rule first flight
0,3,3,29,4,8,0,32,0,"billy joel admits, 'it's time slow down'"
0,3,15,55,9,14,0,70,0,"april fools' day: 'impractical jokers' star brian 'q' quinn talk wu-tang clan, prank"
0,3,8,71,3,15,0,79,0,baby born three legs: doctor remove protruding extra limb six-day-old indian girl
0,2,6,47,2,9,0,53,0,u.s. considers whether isi wife playing key role operation
0,3,8,54,1,7,0,62,0,"trump administration plan expanded immigrant detention, document say"
0,2,3,38,0,7,0,41,0,canadian two italian taken hostage libya
0,1,2,30,0,4,0,32,0,nigeria bill taylor implication
0,1,2,64,0,9,0,66,0,canadian loses health benefit company find joyful facebook picture
0,1,6,42,2,5,0,48,0,layoff prize-winning bullet-taking journalist
0,3,7,51,0,12,2,58,0,bipartisan group 46 lawmaker call paul ryan revive aumf debate
0,1,1,34,0,5,0,35,0,china launch first private airline
0,1,6,39,0,6,0,45,0,new mexico legislature pass cap contribution
0,3,16,64,3,14,0,80,0,supervolcano naples blow? campi flegrei crater show sign 'reawakening'
0,3,9,37,1,10,0,46,0,tribe live coal hold tight trump promise
0,2,5,21,0,5,0,26,0,come next never trump
0,1,2,31,0,4,0,33,0,standoff remain mumbai attack
0,1,8,43,2,7,0,51,0,merck-schering merger awaits reaction johnson johnson
0,3,2,55,1,10,0,57,0,hong kong protester pop champagne leader say he'll step
0,2,11,36,3,7,0,47,0,rnc: fbi prof hillary deliberately lying email
0,1,4,40,1,7,0,44,0,first execution post-saddam iraq held baghdad
0,3,3,64,1,14,3,67,0,"sears sell craftsman tool brand close 150 stores, many kmart location"
0,2,1,67,0,12,0,68,0,texas police officer seen pushing teen ground controversial video resigns
0,1,4,46,2,9,0,50,0,"car bomb ciudad jurez, mexico kill several, many injured"
0,1,2,42,0,6,0,44,0,new zealand political party destroys leaked email
0,2,5,46,0,9,0,51,0,alabama lb reuben foster invited draft incident
0,1,2,37,1,5,0,39,0,canada's conservative launch new ad campaign
0,1,7,31,2,7,2,38,0,madoff trustee seek $3.2 billion hedge fund
0,3,10,26,5,10,0,36,0,"so, um, you, like, stop using filler words?"
0,1,8,59,1,9,0,67,0,australian rule football: west gippsland latrobe football league grand final
0,1,5,59,0,11,0,64,0,england wale director public prosecution seek bomb plot retrial
0,1,1,53,0,8,0,54,0,florida suffers summerlike condition ahead cold front
0,2,13,47,5,12,0,60,0,"billboard dance chart upstarts: mura masa charli xcx, rasmus faber adult."
0,1,1,39,0,6,0,40,0,finland claim second world record karaoke
0,2,5,64,1,13,0,69,0,jeremy corbyn: arrest protesting apartheid show ready lead britain
0,2,13,59,3,15,0,72,0,"ellen degeneres post 'lgbt thank president obama' star film, music tv"
0,2,1,32,0,6,0,33,0,china find new love wildlife film
0,2,15,61,3,14,0,76,0,"bright lights, big sales: expensive home sold america's biggest city year"
0,2,6,58,3,10,0,64,0,internet point irony trump screening 'finding dory' #muslimban
0,2,12,62,0,13,0,74,0,little girl adorably blame elf shelf getting caught playing lipstick
0,3,11,48,2,12,0,59,0,"bill oreilly thrives fox news, even harassment settlement add"
0,1,9,28,4,6,0,37,0,f.d.i.c. increase fee insure bank deposit
0,2,10,51,1,10,1,61,0,apple iphone 8 rumor titillating enough entice android loyalists?
0,1,8,36,0,9,0,44,0,switch digital tv broadcast work progress
0,3,15,49,3,13,0,64,0,"""top chef"" alum trolling trump pro-immigrant message hisreceipts"
0,3,2,61,1,10,0,63,0,"thousand able escape aleppo, evacuation stall fighting"
0,3,11,51,1,13,0,62,0,nh worker eu threatened theresa may's brexit bill list
0,1,6,41,0,6,0,47,0,rapid decline manufacturing spread global anxiety
0,3,7,38,1,8,0,45,0,"safely clean dirty, disgusting smartphone"
0,1,3,27,1,6,0,30,0,"seven die bombing falluja, iraq"
0,2,8,43,0,7,0,51,0,college student crowdfunds custom cancer treatment
0,3,10,46,4,9,0,56,0,u.k. label google partner anti-piracy measure: removing link
0,2,10,43,0,11,0,53,0,merkel whip party action rival schulz turn heat
0,2,12,35,2,9,0,47,0,"colombia farc rebel put guns, pick baby bottle"
0,2,14,55,0,10,0,69,0,naacp chapter president rachel dolezal plan address race controversy monday
0,2,7,43,3,14,2,50,0,"charmian carr liesl von trapp sound music dies, aged 73"
0,1,2,46,0,8,0,48,0,amazon dip memory hole retrieve orwellian work
0,2,2,70,2,16,0,72,0,endangered animal already cut border wall. trump want much bigger.
0,3,3,55,1,12,4,58,0,brexit latest: uk economy grows expected final quarter 2016
0,3,11,39,2,10,0,50,0,dubai put autonomous taxi drone sky 'thissummer'
0,3,10,48,2,13,2,58,0,fracking 2.0: shale drillers pioneer new way profit era cheap oil
0,2,10,49,0,11,0,59,0,netherlands home run hit world baseball classic fan painful spot
0,2,4,23,1,3,0,27,0,rube grief counseling session
0,3,1,69,2,14,0,70,0,office 'cake culture' fueling obesity crisis treat swapped hug
0,2,6,50,0,13,0,56,0,sec might wade war wall street trader
0,2,3,51,5,12,0,54,0,"trump, bannon call medium 'opposition party': go far?"
0,2,14,44,2,11,0,58,0,morning brief: trump set undo obama's action global warming
0,2,1,42,1,7,3,43,0,facebook share jump 15.5 percent strong result
0,3,6,37,4,9,0,43,0,"wikileaks dump made u 'less safe', say ex-cia bos"
0,1,7,41,1,8,2,48,0,"violence across iraq kill 13, including sunni politician"
0,2,4,57,2,14,3,61,0,utah teen give chocolate 537 girl school valentine's day yahoo
0,1,8,34,1,8,0,42,0,"rodriguez went pro, teammate went college"
0,2,3,67,5,14,0,70,0,amber heard abuse victim supposed do. people still didnt believe her.
0,2,9,47,1,8,0,56,0,case republican consider merrick garland nomination
0,3,3,29,1,6,0,32,0,groundhog day: six week winter
0,1,6,28,0,7,0,34,0,clear channel face crisis cash flow
0,1,8,30,3,6,0,38,0,i.r.s. suspicion grow secret swiss account
0,2,5,66,2,12,0,71,0,two dead ousting south korea's disgraced president park geun-hye spark clash
0,3,5,63,2,13,0,68,0,"marc bartra, player injured borussia dortmund team bus explosion?"
0,3,1,67,1,9,0,68,0,germany ban internet-connected doll fear hacker could target child
0,2,2,47,2,9,0,49,0,manchester sea plotline 'inspired couple kill son'
0,1,1,33,0,4,2,34,0,wikipedia publishes 10 millionth article
0,2,10,36,5,11,5,46,0,'deadpool 2' two new 'x-men' movie got 2018 release date
0,1,1,47,1,8,0,48,0,iran say ready standoff nuclear activity
0,3,3,45,0,10,0,48,0,black muslim aim unity challenging time islam
0,2,12,51,2,9,0,63,0,russian adventurer seek break record round-the-world balloon flight
0,3,2,76,0,12,0,78,0,skirmish pot legalization massachusetts making progressive paranoid
0,2,10,42,1,10,2,52,0,"23, hong kong lawmaker promise feisty protest aimed china"
0,1,8,29,4,5,0,37,0,"lending locked, u.s. try trillion-dollar key"
0,2,4,53,2,10,0,57,0,dear mr. president: federal funding university work
0,1,4,62,2,11,2,66,0,"myron cope, pittsburgh steelers color commentator, retires 35 year career"
0,1,2,39,0,6,0,41,0,explosion yemen weapon factory kill dozen
0,3,3,59,3,13,0,62,0,bill gates' wicked sense humor really shine reddit see
0,2,2,62,2,11,0,64,0,"shannon matthew timeline pictures: search, trial evidence"
0,2,3,49,1,8,0,52,0,south korea corruption: choi ordered appear hearing
0,2,4,15,0,3,0,19,0,getting brutal
0,3,1,42,0,6,0,43,0,delaware officer held hostage prison standoff
0,2,12,37,0,11,0,49,0,saudi arabia bulk asia boost appeal oil ipo
0,2,10,57,1,10,0,67,0,quick-thinking pedestrian extinguish lorry fire throwing snowball
0,2,2,54,2,9,0,56,0,"indonesia, australia agree free trade, closer naval cooperation"
0,2,7,51,0,9,0,58,0,raf typhoon jet scrambled intercept russian bomber circling uk
0,1,7,35,0,9,0,42,0,pastor invite flock bring gun church
0,3,2,39,2,9,0,41,0,sister slopes: rise women's ski camp
0,2,4,67,0,12,0,71,0,parent reject claim aboriginal man jordan anderson tried kill prison
0,3,13,53,2,12,0,66,0,"cat find way onto marlin park field, evades security, climb outfield wall"
0,2,2,42,5,9,0,44,0,"trump rip 'all talk,' 'no action' civil right icon lewis"
0,3,11,42,2,9,0,53,0,joe biden hold back final swearing-in ceremony
0,1,4,33,0,5,0,37,0,greater manchester police chief found dead
0,1,6,31,0,7,0,37,0,jacob want see burress return giant
0,1,1,43,0,6,0,44,0,afghanistan suicide attack wound twenty
0,2,2,64,1,11,0,66,0,theresa may's new economic adviser supported tax increase pay deficit
0,3,2,40,3,5,0,42,0,starbucks unveils whiskey barrel-aged coffee. yum!
0,1,6,64,2,12,5,70,0,australian rule football: 2010 gippsland football league round 1 wonthaggi v leongatha
0,3,0,60,3,11,2,60,0,88-year-old man honor wife's legacy making blanket child need
0,2,7,53,3,12,0,60,0,canadian pm trudeau say 'lecture' trump u immigration policy
0,2,2,31,0,6,0,33,0,new year celebration around world
0,2,6,28,0,6,4,34,0,best economic forecaster lay 2017 call
0,2,11,46,3,13,0,57,0,"joyous african take rails, china help new york time"
0,2,4,22,1,6,4,26,0,pictures: art building 2016
0,2,11,51,2,11,0,62,0,watch alec baldwin break record 'saturday night live' hosting gig
0,2,5,52,5,12,1,57,0,katniss make final stand 'hunger games: mockingjay -- part 2' trailer
0,3,2,63,0,9,3,65,0,turkish terrorism watch list includes 400 suspected australian jihadist
0,3,12,72,1,11,0,84,0,chilling report indicate record-breaking temperature high hit city across northeast
0,3,14,55,2,16,4,69,0,"lady gaga legacy artist now, legacy: super bowl 2017 halftime show analysis"
0,1,5,48,0,10,0,53,0,gulf air launch direct flight middle east dublin
0,3,3,26,2,5,0,29,0,eu set 'phased' brexit strategy
0,2,8,34,1,6,0,42,0,unintentional self-parody always best kind
0,3,5,36,0,6,0,41,0,nba fine patrick beverley fan altercation
0,2,11,52,1,8,0,63,0,"proposed nyc teacher evaluation plan emphasizes classroom work, project"
0,2,8,50,0,9,0,58,0,texas legislator duped bathroom bill lefty progressive donor
0,1,2,36,0,5,0,38,0,suicide bomber strike israeli coastal town
0,2,11,28,8,6,0,39,0,stream joey bada$$' new album 'all-amerikkkan bada$$'
0,2,4,63,2,14,0,67,0,debate sensation ken bone say famous red sweater actually plan b
0,3,4,19,0,3,0,23,0,white house press briefing
0,2,10,46,4,10,0,56,0,"islamophobia still problem: kansas, another case study"
0,3,12,62,1,12,0,74,0,nightly news inspiring america: stuffed toy doctor put child ease surgery
0,3,3,60,2,14,0,63,0,whats like frontline brexit culture wars? ask comedian
0,3,6,30,1,6,4,36,0,"woman trapped 1,500 pound boulder rescued"
0,3,8,53,2,11,4,61,0,novak djokovic vs. denis istomin: score reaction 2017 australian open
0,1,8,28,4,6,0,36,0,ex-leader liberia cite c.i.a. jailbreak
0,2,8,43,3,10,0,51,0,martin solveig new single 'places' returning house music
0,3,2,46,1,8,0,48,0,judge block release orlando nightclub gunman's widow
0,2,15,54,4,15,3,69,0,google doodle hail fazlur rahman khan -- here's $500m future famous design
0,3,3,48,3,6,0,51,0,el salvador zoo: prosecutor investigate 'suspicious deaths'
0,2,2,58,1,10,0,60,0,northern irish police raid women's home crackdown abortion pill
0,1,2,36,0,5,0,38,0,british columbia avalanche death toll rise
0,1,4,21,0,3,0,25,0,profit plummet blackrock
0,3,1,38,0,7,0,39,0,oakland sport team donating fire victim
0,3,3,41,0,8,0,44,0,schumer democrat preparing fight
0,2,6,56,3,8,1,62,0,#strike4repeal: ireland protest abortion ban international women's day
0,2,4,45,1,8,0,49,0,"american indian protest trump, pipeline washington"
0,2,5,55,1,9,0,60,0,republican john kennedy louisiana's runoff election senate
0,2,7,39,1,9,0,46,0,leaving paris: one half cheer president trump
0,1,6,76,3,12,0,82,0,michigan student california engineer sue amazon remote deletion 'nineteen eighty-four'
0,1,9,25,4,7,0,34,0,"can-do u.s. team, time complacency"
0,1,6,41,0,7,0,47,0,rem koolhaas win golden lion lifetime achievement
0,1,6,30,2,7,0,36,0,"scotland, closer: golf nova scotia"
0,3,7,52,2,10,0,59,0,malala yousafzai's un speech set music international women's day
0,1,2,31,0,5,0,33,0,three yemeni troop killed shooting
0,1,2,36,1,7,0,38,0,"fire kill six, badly injures seven croatia"
0,3,3,46,2,10,0,49,0,force strong homemade 'star wars' cat parody
0,3,3,43,0,9,0,46,0,le pen aide taken french police custody
0,3,15,51,2,14,0,66,0,trump tap jared kushner lead team aim run government like company
0,2,3,87,3,14,0,90,0,"pakistan prime minister, survived supreme court corruption ruling, face pressure step"
0,2,1,51,1,10,0,52,0,"scottish higher education all, gilded"
0,3,8,54,0,11,0,62,0,marvel ceo kevin feige confirms huge fan theory regarding stan lee cameo
0,2,4,55,2,9,0,59,0,le enfants terribles: cocteau's scandalous sibling dance edge
0,3,3,52,2,10,0,55,0,country style: tip take countryside's best dressed set
0,2,8,40,2,9,0,48,0,"jeff bezoss new rocket, built carry payload people"
0,1,3,49,0,7,0,52,0,phone without internet access join facebook revolution
0,1,6,33,0,7,0,39,0,washington see excess fund jobless
0,2,6,47,3,8,0,53,0,"fan boo chargers' logo, jeff cumberland lakers-clippers game"
0,2,8,38,2,9,0,46,0,rat boy responds kendrick lamar sampling 'lust'
0,3,2,52,0,9,0,54,0,aerial footage show avalanche mud deadly colombia flood
0,3,4,57,0,12,0,61,0,trump ready address north korea nuclear program without china
0,3,6,59,5,11,0,65,0,'walking dead' star play marvel favorite punisher netflix's 'daredevil'
0,1,1,43,1,5,0,44,0,pakistan test fire nuclear-capable cruise missile
0,1,8,42,0,8,0,50,0,north carolina beat radford first round without lawson
0,3,8,32,0,8,2,40,0,26 amazing picture first super bowlever
0,2,9,28,0,8,0,37,0,coolest electric bus world
0,3,5,67,2,15,0,72,0,donald trump used term easy internet relentlessly mocking list
0,1,6,27,0,6,4,33,0,collingwood win 2010 afl grand final replay
0,2,4,56,1,9,0,60,0,anti-trump protester gear weekend demonstration across u
0,2,7,47,1,8,0,54,0,brawl erupts turkey's parliament constitutional reform
0,1,5,33,0,7,0,38,0,chief independent news medium resign
0,1,9,62,1,11,0,71,0,wimax forum: wimax usage anticipated increase significantly next four year
0,3,7,48,4,8,0,55,0,"avoid, sidestep, retreat: justice advice confirmation tactic"
0,3,9,57,0,10,0,66,0,charles oakley arrested madison square garden altercation stand
0,1,6,52,5,9,0,58,0,"iraq: shootings, bombing kill dozen baghdad, baquba, qiyara, madaen"
0,2,10,44,1,11,1,54,0,brain scan detect sign autism high-risk baby age 1
0,3,5,26,0,6,4,31,0,megadeth win first grammy 2017 award
0,3,3,49,0,9,0,52,0,donald trump supporter moscow sanction fight heat
0,1,5,31,3,6,0,36,0,u.s. army court-martial abu ghraib officer
0,3,3,45,1,6,0,48,0,trump's supreme court justice shortlist narrow
0,3,1,38,3,7,0,39,0,"granddad, world's oldest aquarium fish, dy"
0,1,10,50,0,10,4,60,0,u university penn state win 2009 ncaa division volleyball championship
0,1,7,72,1,12,0,79,0,halliburton's kbr awarded half billion dollar repair contract gulf coast navy facility
0,1,5,25,3,6,9,30,0,"aid pledge rise; japan promise 500,000,000 usd"
0,1,5,26,0,5,0,31,0,army end delay lightweight armor
0,3,9,44,1,9,0,53,0,donald trump nominee likely face heavy senate vetting
0,2,3,41,0,9,3,44,0,french cyclist robert marchand set world record 105
0,3,7,34,0,7,2,41,0,chicago see 56 people shot christmas holiday
0,2,4,60,6,14,0,64,0,politics divisive. beer not: home-brewing key harmony hill?
0,3,15,63,1,13,0,78,0,northwestern mutualvoice: help employee find better fit within organization
0,3,3,54,0,13,0,57,0,sign progress first full day syria peace talk geneva
0,2,10,56,0,12,0,66,0,carrie fisher fan launch petition make leia official disney princess
0,1,7,35,1,9,3,42,0,hedge fund agree return $235 million madoff case
0,3,1,74,0,14,0,75,0,baby two month old already sexism surround parenting overwhelming
0,2,8,34,1,8,3,42,0,ringling bros. circus shutting 146years
0,2,6,46,0,14,0,52,0,nato russia game cat mouse baltic sky
0,3,11,37,1,10,0,48,0,guy aaron rodgers making look like stars?
0,3,3,65,1,7,0,68,0,growing anti-muslim rhetoric permeates french presidential election campaign
0,2,4,46,0,8,0,50,0,jean charles de menezes family european court challenge
0,2,16,55,2,15,0,71,0,"wrong, please mix alcohol energy drink"
0,1,3,29,0,7,0,32,0,north south korea meet next week
0,1,8,39,1,9,0,47,0,"paris air show, little flash lot introspection"
0,2,11,51,4,11,0,62,0,ab-soul break inspiration revelation behind 'do thou wilt'
0,1,3,30,0,5,0,33,0,bush meet president guatemala
0,1,3,32,0,6,0,35,0,france sends special envoy north korea
0,1,3,57,1,11,0,60,0,haitian priest jean-juste held relation murder journalist
0,2,8,32,0,8,2,40,0,iconic new york columnist jimmy breslin dead 88
0,2,4,52,1,9,0,56,0,guardian view david beckham: embarrassed harassed
0,2,11,46,3,11,0,57,0,emerging trump doctrine: dont follow doctrine new york time
0,3,5,54,0,9,0,59,0,orkney explore independence scotland uk following brexit
0,1,5,23,0,7,4,28,0,look past 2008 star gain bond
0,1,4,54,0,8,0,58,0,former louisiana governor buddy roemer announces run president
0,2,1,34,0,5,0,35,0,millennials toughcustomers
0,1,7,33,0,7,0,40,0,transition hold clue obama govern
0,3,9,45,1,8,0,54,0,"postal worker rescue gift burning truck, save christmas"
0,1,7,38,2,6,0,45,0,"hadoop, analytical software, find us beyond search"
0,1,8,34,1,7,0,42,0,"icy kentucky, thousand still without power"
0,1,8,34,2,11,1,42,0,3 u.s. soldier die attack base southern iraq
0,3,6,53,3,10,0,59,0,top house democrat: state department cut 'an absolute disaster'
0,1,2,66,3,9,0,68,0,bolivian president announces legal action obama's 'crimes humanity'
0,3,11,42,1,11,0,53,0,faith hill tim mcgraw weigh fellow famous musical couple
0,3,7,40,0,9,0,47,0,national geographic put young trans girl cover
0,2,6,48,1,8,0,54,0,dunkirk: new christopher nolan film stuns audience cinemacon
0,2,6,51,0,11,0,57,0,penny visit military camp near korean dmz amid tension north
0,3,8,39,2,9,0,47,0,"border patrol chief, agency outsider, stepping"
0,2,11,43,4,11,0,54,0,ted cruz: course would fire trump campaign manager breitbart
0,1,4,23,1,6,4,27,0,"bird flu confirmed 1,000 uk turkey"
0,1,1,36,2,8,2,37,0,london bombing death toll rise 'more 50'
0,1,2,49,0,8,4,51,0,united state confirms first military death sentence since 1957
0,1,6,49,1,7,0,55,0,serbian parliament member accuse ngo anti-serbian campaign
0,2,2,46,1,7,0,48,0,facebooks zuckerberg discloses step fight fake news
0,1,6,29,1,6,0,35,0,innocent googling? thing tehran
0,2,5,27,1,5,0,32,0,reader favorite romantic movie
0,3,1,37,1,9,0,38,0,sea plate: plastic got fish
0,2,3,56,2,12,0,59,0,iceland airwave festival day four bjrks star home country
0,1,2,41,1,6,0,43,0,"google double gmail storage, add text formatting"
0,2,8,36,0,8,0,44,0,sad irony bill cosby finally prosecuted
0,2,1,41,2,12,0,42,0,"looking used car, time buy"
0,3,2,54,2,11,0,56,0,'fate furious' race biggest global box office opening ever
0,1,5,28,0,6,0,33,0,ecamm offer wireless webcam mac
0,2,3,30,4,4,0,33,0,pokemon go: exercise impact 'short-lived'
0,1,4,44,2,8,5,48,0,40th ariane 5 rocket launch protostar-1 badr-6 satellite
0,2,9,41,0,9,1,50,0,tennis star maria sharapova suspended 2 year doping
0,2,4,38,0,8,0,42,0,retail rent new york city actuallyfalling
0,1,4,26,0,5,0,30,0,race florida governorship
0,2,13,66,0,13,1,79,0,3 argument republican using rebut prediction obamacare repeal would mean
0,3,4,43,1,7,0,47,0,germany election: martin schulz stand merkel
0,1,3,36,0,8,0,39,0,bomb hurt seven police basque city bilbao
0,2,4,60,1,11,0,64,0,calif. man carrying mace arrested white house ground scaling fence
0,1,11,36,0,10,0,47,0,polymer coating heal thanks uv light
0,3,11,47,0,10,0,58,0,meryl streep go donald trump powerful golden globe speech
0,3,8,37,1,11,0,45,0,"american agree paid leave, pay"
0,1,5,32,1,6,2,37,0,"bomber hit checkpoint pakistan, killing 20"
0,3,3,59,3,11,0,62,0,boris johnson's decision pull moscow trip 'gross miscalculation'
0,3,8,44,2,8,0,52,0,"treasury slump, oil slide stock fluctuate: market wrap"
0,3,4,58,1,12,0,62,0,"watch nba game courtside views, thanks virtual reality"
0,1,3,40,0,7,0,43,0,arung samudera refloated tow brisbane
0,3,11,53,3,9,0,64,0,"pre-election surge, apprehension southern border hit five-year low"
0,3,3,63,0,11,0,66,0,grammy winning singer richard marx help take unruly passenger flight
0,3,4,47,1,9,0,51,0,yahoo's marissa mayer resign board verizon deal
0,3,1,65,1,14,0,66,0,"dad text daughter reason love mom, internet sobbing"
0,3,11,43,0,10,0,54,0,hawk gm wes wilcox make racially insensitive joke fan event
0,3,6,58,0,10,0,64,0,jimmy fallon address infamous donald trump interview seth meyers chat
0,2,8,51,0,10,0,59,0,iman shumpert rumored trade target minnesota timberwolves
0,1,4,52,0,7,0,56,0,english footballer beckham visit british troop afghanistan
0,2,4,20,1,5,0,24,0,beware zombie bowl games!
0,2,1,59,2,8,0,60,0,thirteen-year-old girl rescue four younger sibling burning home
0,2,9,39,0,8,0,48,0,floyd mayweather would school conor mcgregor ring
0,2,2,43,1,7,0,45,0,mover begin loading obamas' belonging new home
0,1,9,41,1,10,0,50,0,"nashville, ballot measure may quiet english"
0,2,13,67,4,19,0,80,0,joe biden obama: president history many novel crisis land desk breitbart
0,3,5,59,1,10,0,64,0,semi-pro english soccer team roast trump inauguration crowd twitter
0,3,8,22,5,5,0,30,0,"adele, drake lead u.k.'s year-end chart"
0,2,14,52,1,13,3,66,0,tyson launch $150 million vc fund could help hedge meatless future
0,1,5,27,1,5,1,32,0,consumer confidence hit 9-month high
0,2,11,33,0,9,2,44,0,rupert murdoch stepping ceo 21st century fox
0,3,11,42,1,11,0,53,0,elon musk say steered friday white house talk travel ban
0,1,10,47,1,9,0,57,0,"trevor hoffman keep low profile, savoring fresh start brewer"
0,3,4,52,1,11,0,56,0,"every marvel tv show ranked worst best, according critic"
0,3,5,39,1,9,0,44,0,"ford ceo meeting trump, economy border tax"
0,1,8,29,0,6,0,37,0,new blackberry curve loaded feature
0,2,6,15,2,3,0,21,0,trump bff: rosy scenario
0,2,8,38,0,11,0,46,0,america second chance right thing iraq
0,2,1,54,0,8,0,55,0,two woman given suspended sentence blackmailing rugby star
0,3,8,30,2,7,0,38,0,dj khaled confirms nicki minaj 'grateful'
0,1,3,42,0,8,0,45,0,nine killed russian cargo plane crash siberia
0,3,10,48,2,11,0,58,0,refugee hoop dream come trueright middle trump's america
0,2,8,45,0,7,0,53,0,iheartradio release beta version new streaming service
0,1,5,32,0,5,0,37,0,oracle top forecast declares dividend
0,1,8,41,0,11,0,49,0,yankee grab share first place everyone lends hand
0,1,1,42,0,6,0,43,0,illinois tollway worker jailed stealing fine
0,2,4,55,0,10,0,59,0,donald trump endorses paul ryan previously refusing back
0,1,3,39,1,8,0,42,0,"british gemstone expert killed mob voi, kenya"
0,1,7,29,1,6,0,36,0,sri lanka reject tamil call cease-fire
0,2,3,52,0,10,0,55,0,u official keep watchful eye yellow fever outbreak brazil
0,2,9,50,0,9,0,59,0,clemson coach brad brownell confronts roy williams handshake line
0,1,2,36,0,5,0,38,0,sesame street promote healthy lifestyle
0,2,3,54,3,8,0,57,0,"donald trump tweet obamacare, promising ""far better"" alternative"
0,1,3,69,0,9,0,72,0,outgoing australian democrat leader predicts new party amidst double dissolution
0,2,12,59,2,14,0,71,0,samsung heir arrest south korea intensifies call cleanup new york time
0,1,9,40,1,12,0,49,0,"many try run president iran, allowed"
0,1,8,31,2,7,0,39,0,b.p. scale back investment drop profit
0,2,3,57,3,10,0,60,0,'idol' contestant besieged pro-trump twitter user name
0,2,13,51,2,16,3,64,0,"playlist: 18 holiday songs, 1 surprise mixtape dark new nine inch nail ep"
0,2,9,46,5,8,0,55,0,richard dreyfuss: idiot donald trump lack simple common decency
0,1,4,57,2,12,6,61,0,"mobile operator orange bill french doctor 160,000 one month internet use"
0,3,3,40,0,9,0,43,0,glenn beck defends muslim wake new travel ban
0,1,10,55,0,12,0,65,0,white house change term campaign pledge posting bill online
0,2,11,34,1,12,0,45,0,trump asked ceo plan; agree one
0,1,3,58,0,13,0,61,0,new jersey jury convict florida man claimed fat murder
0,2,4,63,5,14,1,67,0,'guardians galaxy vol. 2' guardians' big adventure summer
0,3,3,47,0,8,0,50,0,trump voter think obamacare replacement fight
0,1,3,30,3,8,4,33,0,"time magazine's 2006 person year ""you"""
0,1,7,33,0,6,0,40,0,foreigner filling job iraqi often shun
0,2,4,57,2,13,2,61,0,"stem enrolment hit 20-year low, scientist idea stop slide"
0,1,3,37,0,9,0,40,0,golf rugby set return olympic game
0,2,12,44,3,11,0,56,0,"ohio state's tyvis powell think he's cutting grass, mom say"
0,1,1,18,0,2,0,19,0,global market plunge
0,3,5,65,2,12,2,70,0,battlestar galactica star richard 'apollo' hatch dy aged 71 battle cancer
0,3,17,53,1,14,0,70,0,"srk flirt old lady leaf blushing, prof magic floor everyone"
0,1,2,53,0,8,0,55,0,united kingdom introduce graphic image cigarette packet
0,3,5,37,0,6,0,42,0,patriot te martellus bennett really like bacon
0,2,18,47,1,17,0,65,0,"adding bit zinc diet help keep infection bay, say new study"
0,1,7,35,0,6,0,42,0,hotel service employee feel economic pain early
0,2,9,20,1,6,0,29,0,nbc really ready megyn kelly?
0,2,12,59,3,11,0,71,0,hillary clinton said putin personal beef contributed electionloss
0,1,7,31,2,7,0,38,0,"iraqi journalists, free press vs. free land"
0,1,8,33,0,8,0,41,0,huntsman win right sue bank failed deal
0,3,4,60,4,13,0,64,0,nicole kidman trump: country need support whoevers president
0,1,4,28,3,6,1,32,0,u.s. housing price 9% since february
0,2,7,45,0,8,0,52,0,gorsuch defends adherence law senate committee hearing
0,3,10,54,0,10,0,64,0,college basketball player slap opposing fan heckling game
0,2,11,53,0,12,0,64,0,white house proposes new rule steady insurance market health law
0,1,2,49,0,9,0,51,0,twelve injured washington ride fair topples
0,3,1,78,1,15,0,79,0,"ohio police officer admits fabricating shooting story cover suicide attempt, cop say"
0,1,4,39,0,8,0,43,0,fire alpine road tunnel italy france
0,3,8,33,5,10,5,41,0,almost dow 20000: wheres party? hats?
0,3,7,52,5,9,0,59,0,gop congressman: reforming dodd-frank 'this-year priority' trump
0,3,15,53,1,14,0,68,0,"python swallow man indonesia, villager slice open snake find body"
0,3,10,47,0,9,0,57,0,tesla autopilot appears predict crash moment happens
0,2,10,47,1,10,4,57,0,nfl combine 2017: full sunday schedule prediction top prospect
0,1,10,46,2,8,0,56,0,departing u.s. ambassador warns quick withdrawal iraq
0,1,7,32,0,7,0,39,0,irish win leinster take european cup
0,3,4,40,0,7,0,44,0,david cameron enjoys ride winter wonderland
0,2,10,42,1,10,2,52,0,explosion st. petersburg metro system kill least 10 people
0,1,1,63,3,7,0,64,0,california's same-sex marriage ban ruled unconstitutional; appeal expected
0,1,2,34,0,6,0,36,0,fresh flood india claim sixteen life
0,1,7,45,1,8,0,52,0,"chelsea clinton marries marc mezvinsky rhinebeck, new york"
0,2,1,54,3,6,0,55,0,brazil's overcrowded prison experience massacre 'almost daily'
0,3,6,28,3,5,0,34,0,lawyer burying america living dead
0,1,8,31,0,9,0,39,0,roku get access larger film library
0,2,13,48,2,10,0,61,0,hp inc.voice: three way reinvent fourth industrial revolution
0,2,3,16,1,3,0,19,0,yahoo movie facebook
0,3,14,56,2,15,3,70,0,"florida man arrested allegedly sex 100 time dog ""baby girl"""
0,1,5,50,0,8,0,55,0,corpse former president cyprus tasso papadopoulos stolen
0,2,9,62,2,8,0,71,0,conservative christian grapple whether religious freedom includes muslim
0,1,3,23,0,5,4,26,0,hurdle voting persisted 2008
0,3,3,33,2,6,2,36,0,25-year-old mlb pitcher killed car accident
0,3,6,84,2,13,0,90,0,"libyan plane: passengers, crew released hijacked afriqiyah airway flight malta international"
0,3,8,47,0,8,0,55,0,trump corporate tax shakeup put housing developer tailspin
0,3,9,48,2,10,0,57,0,inside baghdad music ballet school iraqi call immoral
0,3,6,42,6,8,0,48,0,huge 'logan' opening might beat 'x-men origins: wolverine'
0,2,3,15,1,2,0,18,0,"john oliver, activist"
0,3,4,67,0,14,0,71,0,elderly couple charm viewer find love sweet episode first date hotel
0,1,3,54,1,8,1,57,0,undercover investigation protest planned july's g8 summit
0,1,5,40,1,6,0,45,0,"apple release iphone sdk, announces upcoming update"
0,3,8,45,0,8,0,53,0,trump get inaugural timepiece ailing swiss watchmaker
0,1,6,28,0,6,0,34,0,british bank chief see deep recession
0,1,7,39,0,10,4,46,0,ntsb say pilot error caused crash colgan air flight 3407
0,1,1,16,1,2,0,17,0,haiti's bank reopen
0,3,7,56,0,12,0,63,0,isi leader planned istanbul nightclub attack killed u ground raid
0,2,3,47,1,8,0,50,0,"nh staff stressed public sector workers, survey find"
0,3,13,39,0,12,0,52,0,female gladiator part lure roman arena
0,3,10,35,5,12,0,45,0,republican win kansas. still loss g.o.p.
0,1,9,33,1,8,0,42,0,"one day epic, syracuse reach big east final"
0,2,15,62,3,15,0,77,0,cricketer dropping like domino come marriage starting twitter!
0,3,4,58,0,15,0,62,0,barack obama cracked joke left oval office last time
0,1,3,36,1,5,0,39,0,"gas explosion reported hammersmith, london"
0,1,4,32,2,6,2,36,0,ford motor post us$2.7 billion annual profit
0,1,4,25,0,3,0,29,0,cattle rustling plague rancher
0,1,4,67,0,10,4,71,0,2008 taiwan tourism exposition encourage tourism industry sichuan earthquake
0,2,2,47,1,9,4,49,0,"nearly 6,000 flight canceled major blizzard hit northeast"
0,1,6,30,2,6,0,36,0,hewlett-packard need dose anarchy?
0,3,1,26,0,4,0,27,0,first smartwatch gamers
0,1,7,49,0,9,0,56,0,question apathy surround shooting officer miami beach
0,1,4,37,0,7,0,41,0,ronnie lee gardner executed utah firing squad
0,2,4,56,4,13,0,60,0,"donald trump feuding courts. state it, too."
0,2,14,51,4,14,0,65,0,"here's nicki let kanye appear ""right thru me"" even though begged"
0,3,13,58,6,14,0,71,0,"heckler capture video demarcus cousin yelling 'suck d*ck, b*tch!' game"
0,1,4,58,0,11,2,62,0,man charged following bomb threat closed 14 tesco supermarket uk
0,1,5,27,0,4,0,32,0,china disables google function
0,1,3,36,0,7,0,39,0,u automaker bailout deal fails pas senate
0,3,4,31,0,5,0,35,0,victoria wood remembered melvyn bragg
0,1,2,34,0,7,0,36,0,call bottled water ban grow canada
0,2,1,33,1,7,0,34,0,rihanna cant get enough racylook
0,3,3,41,0,8,0,44,0,another silicon valley guy lock escape plan
0,1,7,29,3,8,0,36,0,"effort save flint, mich., shrinking"
0,2,1,54,0,9,2,55,0,texas man sentenced 15 year assaulting pregnant girlfriend
0,3,5,57,2,9,0,62,0,civilian death us-led airstrikes hit record-high donald trump
0,2,10,28,1,10,2,38,0,"17 dog deserve pet want,dammit"
0,2,1,48,0,11,0,49,0,clever physic trick reveal egg hard boiled
0,3,3,56,3,9,0,59,0,donald trump accuses obama 'wire-tapping' office election
0,2,12,57,3,13,0,69,0,grieving sister say 'rude' flight attendant led removal flight yahoo
0,1,7,32,1,7,0,39,0,"uconn nears perfection, room improve"
0,3,10,43,1,10,0,53,0,"booming iceland need sober up, governor warns rate cut"
0,2,8,31,1,6,0,39,0,new study show anti-semitism soared last year
0,2,5,31,5,8,2,36,0,"u.s. woman beat australia, 3-1, world cup opener"
0,2,4,60,1,12,0,64,0,baton rouge murders: killing cop becomes new normal america doomed
0,3,11,50,3,10,0,61,0,travis scott's love portland go beyond 'more life' collaboration
0,3,4,42,1,9,2,46,0,homeland season 6: channel 4 confirmed uk release date
0,1,4,42,1,9,0,46,0,david blunkett father kimberly quinn's son
0,3,18,45,0,15,0,63,0,homeless delhi girl poster child ngo run school bus
0,1,3,39,0,6,0,42,0,australian bureau statistic face budget cut
0,1,3,54,0,9,0,57,0,official admit china faked part olympics opening ceremony
0,1,8,31,0,9,0,39,0,next big film premiere living room
0,1,5,32,0,4,0,37,0,citigroup considering reverse stock split
0,1,1,42,0,7,0,43,0,togo unanimously vote abolish death penalty
0,2,5,60,2,11,0,65,0,donald trump's inauguration cake look similar barack obama's list
0,2,10,46,2,11,0,56,0,'the fate furious' already smashing global record
0,2,12,17,3,8,0,29,0,ny goper cruz: go back rock
0,1,3,55,2,11,2,58,0,"jack kilby, nobel laureate inventor integrated circuit, dy 81"
0,2,17,67,2,15,2,84,0,11-year-old leg amputated brutally beaten warden malaysian islamic school
0,2,15,55,2,12,0,70,0,first make-in-india artillery gun showcased republic day parade year
0,1,2,41,0,6,0,43,0,guatemalan news reporter killed pacaya volcano
0,3,4,57,1,11,0,61,0,end bible classes? west virginia school seek dismiss atheist lawsuit
0,2,11,56,5,11,0,67,0,f*ck israel graffiti discovered uk campus ambassador visit breitbart
0,3,5,26,0,6,4,31,0,comedian jimmy kimmel host 2017 oscar
0,3,6,67,0,15,0,73,0,iraqi force take mosul airport isi troop reclaim western side city
0,2,1,39,2,9,0,40,0,trump say profiling worst thing
0,1,6,31,0,7,0,37,0,netanyahu gain bid israeli premier
0,3,7,40,2,9,2,47,0,hack survive 20-hour flightwithout laptop tablet
0,2,7,44,1,7,0,51,0,blake livelys cherokee heritage questioned social medium
0,2,8,44,3,9,0,52,0,twitter reveals new feature combat hate speech breitbart
0,1,1,49,0,8,0,50,0,nokia scale back prediction global mobile phone sale
0,3,2,64,3,10,0,66,0,"humble, spiritual armed motorist saved trooper attack arizona highway"
0,3,6,64,2,12,0,70,0,alec baldwin mock donald trump russian 'make america great again' baseball cap
0,2,3,45,0,9,0,48,0,muslim world failed syria long anyone else
0,1,3,40,0,6,0,43,0,controversial wind farm approved u government
0,3,10,43,1,10,0,53,0,obamacare's popularity rise gop move repeal law
0,1,4,32,0,7,0,36,0,french worker stay home whit monday
0,1,2,33,0,6,0,35,0,wreckage crashed plane africa found
0,3,5,84,2,15,3,89,0,forty-footpeter rabbit statue built markbeatrix potter 150th anniversary burnt suspected arson
0,2,2,76,2,12,0,78,0,"jordan attack: foreign tourist among nine killed medieval castle attack, nearby shooting"
0,3,14,64,4,14,0,78,0,"whoopi goldberg, samuel l. jackson, emma stone, read mean tweet oscar ceremony"
0,3,1,51,1,10,3,52,0,historian say president first 100 day useless benchmark
0,3,6,40,5,9,0,46,0,"trump team: who president cabinet, white house"
0,3,13,34,0,10,0,47,0,facebook debut video app apple tv amazon fire tv
0,1,5,28,0,6,0,33,0,office go vacant fannie freddie
0,2,4,51,0,11,0,55,0,obama say trump claim ordered trump tower wiretapped false
0,3,2,77,3,11,4,79,0,"student use 2,000-year-old art iconography recreate stunning christian themed masterpiece"
0,2,14,42,3,10,1,56,0,"joe thornton played torn acl, mcl sharks' 1st-round series"
0,1,3,22,0,5,2,25,0,comedian dave allen dy aged 68
0,2,2,40,0,9,0,42,0,meet woman iconic rage intro scream
0,2,10,52,6,13,0,62,0,red carpet flashback! emma watson 'harry potter' 'beauty beast'
0,3,2,66,2,11,0,68,0,here's everyone paying attention china's ambitious space program
0,3,10,40,0,9,0,50,0,shredding iran nuclear deal may harder trump think
0,3,1,46,0,10,0,47,0,idaho woman say crashed saw sasquatch
0,3,8,49,2,11,0,57,0,u.s. navy deploys guided missile destroyer us cole coast yemen
0,2,11,62,1,13,0,73,0,pennsylvania attorney general quits heel perjury conviction new york time
0,1,1,45,1,5,0,46,0,indonesian anti-corruption chief convicted murder
0,2,15,38,3,11,0,53,0,"first trailer new ""ducktales"" itsgooooood"
0,2,12,37,3,9,0,49,0,apple fbi iphone request: founder would appalled
0,2,12,69,4,20,2,81,0,whale found dead 30 plastic bag stomach expert say 'not surprising'
0,1,6,38,1,5,0,44,0,goalie make difference rangers-capitals series
0,3,12,46,3,11,0,58,0,alec baldwin fire one 'hell' zinger donald trump's inauguration
0,2,4,19,0,4,0,23,0,woe washington metro
0,2,8,38,1,7,0,46,0,sarah palins oldest son charged domesticassault
0,1,4,32,0,4,0,36,0,protester thailand challenge premier
0,1,1,31,0,3,0,32,0,syria affirms withdrawal intention
0,1,4,35,0,7,2,39,0,italian judge convict 23 cia kidnapping case
0,2,12,52,2,11,0,64,0,benedict cumberbatch bit frazzled deleted 'doctor strange' scene
0,2,9,51,5,12,0,60,0,"beatles, aerosmith godsmack: history 'come together' chart"
0,1,5,32,0,6,4,37,0,rubens barrichello win 2009 italian grand prix
0,2,1,77,2,13,0,78,0,lawmaker called pregnant woman host push bill requiring father approve abortion
0,1,9,39,3,9,0,48,0,drake relays: big-time meet small-town atmosphere
0,1,4,54,0,8,0,58,0,gift football united state offends afghan inadvertently
0,1,1,40,2,5,0,41,0,seattle's oldest newspaper become online-only
0,2,9,48,3,10,0,57,0,bill murray vs. president obama oval office putting contest [video]
0,2,10,44,3,10,1,54,0,"woman accused killing 8-month-old boy, hiding remains shed"
0,2,5,58,1,9,0,63,0,defense secretary jim mattis distance trump's medium bashing
0,3,9,45,2,9,0,54,0,south korean cargo ship stellar daisy missing south atlantic
0,2,3,38,2,8,0,41,0,use all: anna jones's recipe waste nothing
0,1,6,28,0,6,0,34,0,one side make offer honduran impasse
0,1,2,21,0,3,0,23,0,major storm batter europe
0,2,2,28,1,6,2,30,0,apple fight back $14b taxbill
0,3,9,47,2,8,0,56,0,princeton swim team suspended 'misogynistic racist' email
0,1,5,39,0,7,0,44,0,preparing flood energy efficiency spending
0,3,10,42,3,10,0,52,0,lorde's coachella set proved back better
0,3,8,44,3,12,0,52,0,"dark crossing, former soldier get close enemy"
0,1,2,34,1,6,0,36,0,"venezuela buy weapons, spain"
0,1,5,23,1,5,0,28,0,"recession pain, even palm beach"
0,3,9,46,0,8,0,55,0,radioactive boar hunted taking town near fukushima
0,3,7,55,0,9,0,62,0,protester interrupt nominee ambassador israel senate hearing
0,1,7,34,0,6,0,41,0,australian marcos ambrose rising nascar star
0,2,2,62,3,10,0,64,0,"far-right party still leading dutch polls, despite leader criminal guilt"
0,3,3,29,0,5,0,32,0,uk help australian gay couple marry
0,1,7,36,2,6,0,43,0,"hollywood, easy-money generation toughens"
0,1,3,32,1,3,0,35,0,president guinea-bissau assassinated
0,2,1,43,0,6,0,44,0,christchurch fire halted resident count loss
0,3,3,50,1,9,0,53,0,trump immediately appeal travel ban halt supreme court
0,1,7,43,0,7,0,50,0,nevada senate override veto domestic partner measure
0,2,11,56,5,10,0,67,0,politico: reagan insurgent gop establishment breitbart
0,3,8,47,0,7,0,55,0,video capture massive green fireball streaking across midwest
0,1,7,30,0,7,0,37,0,rahlves fails retain winter x game title
0,1,6,25,1,5,0,31,0,"despite good news, stock tumble"
0,1,3,54,1,8,0,57,0,"firefighter killed tackling pub blaze edinburgh, scotland"
0,3,14,47,2,12,0,61,0,"one pull nfl's string like greatest puppet master, jerry jones"
0,2,3,78,2,10,0,81,0,"rudy giuliani withdraws name consideration trump administration, president-elect say"
0,1,8,39,0,9,0,47,0,floyd landis road detour attention
0,2,2,62,2,7,0,64,0,facebooks zuckerberg questioned trial virtual-reality technology
0,3,3,70,2,13,0,73,0,ivanka trump passionate political advocate businesswoman building brand?
0,2,8,51,3,11,0,59,0,"trump hotel washington, champagne toast ethical minefield"
0,2,1,60,0,11,0,61,0,apple restructuring way work lead advertising agency
0,2,10,46,0,11,4,56,0,italy prime minister matteo renzi step 2017 budget pass
0,1,5,37,0,9,0,42,0,wall microscope bronx
0,1,7,42,0,7,0,49,0,boston mayor opposes assault weapon patrol officer
0,1,6,33,0,6,0,39,0,woman sentenced trial gripped france
0,3,15,64,1,14,0,79,0,pakistan international airline sacrifice goat runway safe landing plane!
0,1,5,55,0,9,0,60,0,alleged anthrax killer bruce ivins reportedly made edits wikipedia
0,3,1,66,0,9,0,67,0,scrutiny terrorism funding hamper charitable work ravaged country
0,2,5,82,5,16,0,87,0,thats kind goofy question: paul ryan wont answer whether obamacare replacement bill pas house
0,1,7,32,1,7,0,39,0,"others fled venezuela, stanford saw chance"
0,3,3,38,0,8,0,41,0,nine die india coal mine collapse jharkhand
0,1,3,33,1,6,0,36,0,euro reach one-year low u dollar
0,1,5,32,2,7,8,37,0,basketball: uaap open 2008-2009 season new rule
0,1,8,29,0,6,0,37,0,former sa deputy president appears court
0,2,10,46,2,10,0,56,0,video show school resource officer throwing n.c. girl ground
0,2,2,43,2,7,0,45,0,toni erdmann review talk embarrassing parent
0,3,2,53,1,11,0,55,0,judge: dad accused dropping girl bridge ready stand trial
0,1,2,59,3,9,0,61,0,"wikileaks release afghan ""war logs"" co-operation mainstream medium"
0,1,4,25,0,6,0,29,0,taking chance reverse merger
0,2,3,39,2,8,0,42,0,iran strike back u 'reciprocal' sanction
0,2,1,39,2,9,0,40,0,islander new coach isnt sure want thejob
0,2,2,51,0,10,0,53,0,gatwick hotel owner say pressured close
0,2,7,32,1,7,0,39,0,kim jong nams corpse unclaimed kuala lumpur
0,1,6,28,0,6,0,34,0,food brand compete stretch buck
0,3,1,60,0,10,0,61,0,police launch murder inquiry two men die unrelated shooting
0,2,9,61,0,16,2,70,0,trump missed main target yemen raid killed 30 civilian one u navy seal
0,3,8,56,2,14,2,64,0,cbo: 14m american health insurance next year gop plan adopted
0,2,6,48,3,10,2,54,0,"king deal demarcus cousin feb. 23 deadline, divac say"
0,3,12,58,2,16,1,70,0,'games thrones' fan forced watch ice melt learn season 7 premiere date insider
0,3,4,59,0,11,0,63,0,oxford english dictionary offer definition brexit add new word
0,2,7,36,1,10,0,43,0,mike mullen sam nunn: deal north korea
0,2,8,50,0,9,0,58,0,serena williams say revealed pregnancy snapchat accident
0,2,2,54,0,13,0,56,0,big difference way trump signed new travel ban
0,2,5,56,2,11,0,61,0,"no, trump's victory biggest electoral college win since reagan"
0,3,9,48,1,9,0,57,0,french election monitor: dutch rebuff populism gamechanger
0,3,8,44,1,8,0,52,0,chainsmokers announce album title release date: watch
0,1,2,66,0,12,0,68,0,death candidate delay final result german federal election week
0,1,7,29,1,8,1,36,0,"expected, canada cut key rate 1 percent"
0,2,2,84,3,20,0,86,0,price admission press: can't riot working expect pas protect
0,1,7,32,1,6,0,39,0,"security shuffle, white house merges staff"
0,3,5,55,3,9,0,60,0,classified u.s. intel report: russia gathered compromising info trump
0,3,12,39,3,12,0,51,0,"rebuke trump policy, ge chief say climate change real"
0,1,3,34,2,7,1,37,0,"man attack people, kill 7 akihabara, tokyo"
0,3,7,72,0,17,5,79,0,live ftse 100 struggle direction first g20 finance meeting trump era get underway
0,3,3,54,0,9,0,57,0,israel longer return body palestinian hamas militant
0,1,5,28,1,6,2,33,0,who: h1n1 influenza virus still pandemic
0,1,5,29,0,5,0,34,0,house heavyweight feel threat power
0,3,6,66,4,13,0,72,0,"renamed shamed: taking britain's slave-trade past, colston hall penny lane"
0,2,3,64,3,12,1,67,0,"supreme court justice show support church, gorsuch's 1st high-profile case"
0,3,7,48,3,13,3,55,0,walking dead season 7 episode 13: watch trailer 'bury here'
0,3,10,45,4,9,0,55,0,missing richard simmons best mystery podcast sinceserial
0,2,3,34,2,7,1,37,0,green light swansea bay's 1bn tidal lagoon
0,2,6,36,2,7,0,42,0,"anti-semitism, brought united nation"
0,3,11,32,1,8,0,43,0,nasa bold plan save earth killer asteroid
0,1,4,45,0,6,0,49,0,u congressional panel claim turkey committed genocide
0,1,2,32,0,6,0,34,0,bomb explosion kill two nepal church
0,2,4,64,2,10,0,68,0,"anzac day: large crowds, boosted police presence expected queensland service"
0,2,6,65,1,13,0,71,0,"tampa bay lightning avoids penalty box, let army captain resell stanley cup ticket"
0,3,1,57,3,13,1,58,0,"rape girl, allegedly 2 teens, one illegally, offer new detail"
0,3,2,42,1,10,0,44,0,deadly tenn. school bus crash case head grand jury
0,2,6,26,0,4,0,32,0,youtube twin embrace natural beauty
0,1,3,23,1,3,0,26,0,"explosion hyderabad, india"
0,2,11,56,3,12,0,67,0,"man steal dead trooper's identity, buy washing machine day funeral: police"
0,3,15,68,7,14,0,83,0,msnbcs reid: bread circus trump base includes persecution muslim immigrant
0,1,6,32,0,7,1,38,0,3 lawmaker return money tied lobbyist
0,1,5,25,0,5,0,30,0,pakistani court lift ban sharif
0,2,14,55,4,13,0,69,0,mel b celebrates final 'chicago' broadway show spice girl shout-out: watch
0,2,4,45,0,11,0,49,0,neil gorsuch regret inform senate god
0,1,3,37,1,5,0,40,0,"hurricane katrina strike florida, kill seven"
0,3,6,31,3,12,2,37,0,low volatility stock plunged 85% hour
0,2,8,41,1,9,1,49,0,hunger stalk world youngest capital war nears 4th year
0,2,6,46,0,11,0,52,0,diana statue erected ground kensington palace
0,2,6,40,1,8,3,46,0,500-lb unexploded german wwii bomb found english harbor
0,2,2,49,2,11,0,51,0,u.s. make new arrest fraud probe bankrupt video tech firm
0,3,13,58,0,12,0,71,0,congressman say trump could impeached overstepped authority travelban
0,2,13,41,1,11,0,54,0,spicer: trump meet today martin luther king iii insider
0,1,6,37,0,6,0,43,0,detroit court vie host potential bankruptcy
0,3,15,65,1,15,2,80,0,"25 year babri demolition, muslim men writing new chapter religious tolerance"
0,3,13,60,2,14,0,73,0,"video show thief break restaurant, steal grip bananas, fall asleep floor"
0,2,13,51,1,14,0,64,0,man held london knife attack killed american new york time
0,1,4,46,2,8,0,50,0,teen charged 'bomb attempt' u christmas celebration
0,1,3,52,2,7,0,55,0,u.s. accidentally delivered nuclear missile component taiwan
0,3,6,49,3,9,0,55,0,tillerson meet putin amid u.s.-russia disagreement syria
0,3,8,48,0,10,2,56,0,south prepares snow 73 million nationwide face brutal weather
0,3,8,61,3,15,0,69,0,john prescott perfect smack ukip mp trump muslim ban list
0,3,13,44,2,11,0,57,0,salt bae salted leonardo dicaprios meat alive witnessit
0,1,6,34,0,8,0,40,0,creator web cartoon xkcd writing paper book
0,2,1,50,0,12,0,51,0,cat hanging boy took best selfie time
0,3,3,61,3,10,0,64,0,torture secret prisons: dark side china's anti-corruption crackdown
0,3,3,16,2,5,6,19,0,"today trump: january 30, 2017"
0,2,4,9,0,3,0,13,0,inbox zero isbs
0,3,3,55,0,10,0,58,0,russian diplomat expelled connection cyber hack depart u
0,1,10,43,5,8,0,53,0,"author, author: a.w. tillinghast really design bethpage black?"
0,3,4,83,2,12,0,87,0,"rodrigo duterte's drug war could constitute crime humanity, amnesty international report say"
0,3,9,42,4,8,0,51,0,india's central bank chief say cash ban's effect transitory
0,1,1,33,0,5,0,34,0,pakistani journalist found dead home
0,1,8,52,0,10,0,60,0,egypt accuses hezbollah plotting attack arm smuggling gaza
0,2,2,56,1,12,2,58,0,twin explosion kill least 40 near religious site syria's capital
0,2,2,58,3,10,0,60,0,forecast wont budge rain seems inevitable trump inauguration
0,2,7,44,2,8,3,51,0,blackstone spend $500 million remaking chicago willis tower
0,2,1,56,0,10,0,57,0,tree changer swapping city life regional rural lifestyle
0,1,8,40,3,7,0,48,0,rival accuse i.b.m. stifling competition mainframe
0,2,9,37,1,10,0,46,0,fox sport live game streaming video fox sport go
0,2,5,49,3,11,0,54,0,"qatar vow surrender gulf crisis u.s., kuwait seek solution"
0,2,3,39,0,11,0,42,0,uk voted guy national bird
0,2,12,38,2,8,0,50,0,russian government agrees trump nato obsolete
0,1,9,37,0,10,0,46,0,geffen said still interested new york time
0,2,10,43,2,12,0,53,0,"indonesian taste dog meat growing, even others shun"
0,1,7,34,3,5,1,41,0,"sure-footed, boonen capture 3rd paris-roubaix"
0,3,9,41,1,10,0,50,0,richard sherman say want traded seahawks
0,3,17,56,1,16,1,73,0,bsf allegedly torturing soldier speaking 5 story need read
0,2,4,51,2,7,0,55,0,turkey-netherlands row: dutch warn citizen erdogan threat
0,1,2,24,0,5,0,26,0,five dead attack pakistan
0,2,5,28,0,6,0,33,0,scott walker speak gop convention
0,3,6,38,0,6,0,44,0,vehicle becoming favored terrorist attack weapon
0,1,2,61,1,7,0,63,0,belgrade: demonstration independent kosovo escalates riot
0,3,8,20,1,6,0,28,0,lsd saved one woman marriage
0,2,2,52,0,13,2,54,0,donald trump yet make nomination 94 per cent federal role
0,2,5,62,2,11,0,67,0,green party accuses jeremy corbyn capitulating tory immigration
0,3,9,53,2,9,0,62,0,unique futuristic building could change india's skyline forever
0,1,4,42,0,8,0,46,0,two un peacekeeper killed attack darfur
0,3,1,55,2,10,2,56,0,unemployment rise 5.8pc despite third month full-time job gain
0,3,3,47,1,9,0,50,0,dems invite immigrant trump's first address congress
0,1,7,27,2,6,0,34,0,g.e. build research center near detroit
0,1,4,29,0,5,0,33,0,california warns layoff school
0,2,4,61,0,9,0,65,0,longtime hillary clinton staffer mull lieutenant governor run virginia
0,1,6,29,1,6,0,35,0,woman linked sanford comment e-mail
0,3,1,43,3,7,0,44,0,facebook let send festive cards...to
0,2,1,21,0,4,0,22,0,trump sank occasion
0,3,2,62,2,11,0,64,0,cassini sent back image first-ever dive saturn ring
0,2,10,50,2,10,0,60,0,israel approves mixed-sex jewish prayer site western wall breitbart
0,3,3,49,4,11,0,52,0,"call me, maybe? trump reach china president letter."
0,2,1,52,2,11,0,53,0,cash outside girl pissed people using catchphrase
0,3,1,66,4,13,0,67,0,"dads, like moms, risk depression child birth, researcher report"
0,3,9,33,3,10,3,42,0,"vista buy dh corp $2.03 billion, combine misys"
0,2,2,47,2,7,0,49,0,"california governor: drought over, conservation must go"
0,2,4,47,3,11,4,51,0,californian foot $25g bill 40 hour holder's anti-trump time
0,2,8,38,3,9,0,46,0,watch travis scott latest short film 'birds trap'
0,1,6,35,1,5,0,41,0,"unitedhealth settle suit, objection raised"
0,2,4,50,0,9,0,54,0,unknown poem katherine mansfield found chicago library
0,3,5,48,1,9,0,53,0,un's rima khalaf quits report accusing israel apartheid
0,3,1,65,1,12,0,66,0,"paris terror attack halt presidential campaign, loom large vote nears"
0,2,2,40,2,6,0,42,0,carwoola fire: resident return burnt-out home
0,3,3,64,0,10,0,67,0,east timor punished changing birth certificate hire brazilian player
0,2,3,30,1,6,1,33,0,quinnipiac poll: clinton lead trump 7
0,2,1,62,4,9,0,63,0,"e-waste: happens discarded televisions, computer mobile phones?"
0,2,3,44,0,7,0,47,0,spain mourns first woman defence minister carme chacn
0,1,5,37,3,8,0,42,0,"tropical storm irene intensify, may hit u.s. coast"
0,3,1,61,0,10,0,62,0,jewish center targeted bomb threat day cemetery vandalized
0,2,5,28,2,5,0,33,0,isi message call trump foolish idiot
0,3,8,64,5,11,4,72,0,"revealed: 1,900-year-old roman house covered penis-shaped amulet discovered israel"
0,2,1,51,2,10,0,52,0,"top student likely smoke pot, drink alcohol, study say"
0,2,9,46,0,9,0,55,0,social security check reduced unpaid student debt
0,2,13,57,2,14,3,70,0,"another avalanche hit army post kupwara, 5 soldier go missing, death toll cross 20"
0,1,4,32,3,7,4,36,0,"u.s. automaker gm plan close 1,100 dealership"
0,3,12,66,0,15,0,78,0,lo bosworth reveals struggle anxiety depression led worst year ever
0,2,13,47,2,12,0,60,0,"emma watson confused backlash ""vanity fair""shoot"
0,2,2,60,4,8,0,62,0,"absolutely false, trump say defiantly womens groping allegation"
0,3,4,19,2,3,0,23,0,qualcomm 'tax' rebellion
0,3,13,48,3,10,0,61,0,hip-hop's biggest artist made appearance nba all-star weekend
0,1,5,32,0,5,0,37,0,california asks removal prison overseer
0,3,18,56,4,17,0,74,0,country best worst gender pay gap expectation -- u.s. stack
0,2,5,26,0,5,0,31,0,morality using military power
0,3,9,52,2,14,5,61,0,"special ops chief: u troop killed 60,000 isi militant past two year"
0,1,2,38,1,7,0,40,0,"bus bombing myanmar kill man, wound another"
0,1,2,23,0,3,0,25,0,bombing reported bangkok
0,1,4,32,0,5,0,36,0,rna journal submits article wikipedia
0,2,13,47,2,14,3,60,0,meet rekha mishra railway cop saved 434 runaway child one year!
0,1,5,51,0,8,0,56,0,freman hendrix eclipse kwame kilpatrick detroit mayoral race
0,1,3,40,1,7,0,43,0,"crossing guard killed truck glasgow, scotland"
0,2,6,48,1,10,0,54,0,tech company creates facial image help id unc student killer
0,1,7,43,1,8,0,50,0,boxing: joshua clottey ghana win ibf welterweight title
0,1,5,29,0,6,0,34,0,tower perrin watson wyatt merger
0,2,8,38,1,7,0,46,0,terror strike champs-lyses day french vote
0,2,11,45,6,10,0,56,0,"big sean reveals fourth album 'i decided,' unleashes new 'moves': listen"
0,2,9,40,3,8,0,49,0,john lewis blast steve king's 'bigoted racist' comment
0,2,1,38,1,10,3,39,0,"4 dead, 15 injured series shooting kansa"
0,1,2,47,1,6,0,49,0,"heat wave, industrial action cripple melbourne railway"
0,2,1,71,3,14,0,72,0,"hershey announced major change chocolate, probably good plan"
0,1,7,32,0,8,0,39,0,fan praise net center help highway
0,3,10,56,3,10,0,66,0,california democrat take 'boldest step nation' toward debt-free college
0,1,5,21,0,4,0,26,0,another way lead kill condor
0,2,5,56,5,14,0,61,0,"'so far god, close us': mexico's troubled past neighbour"
0,1,2,36,2,6,0,38,0,"indigenous australian told ""wash fuel"""
0,1,5,34,0,4,0,39,0,financial crisis sting british expatriate
0,2,8,51,1,11,0,59,0,new zealand trent boult ruled final three odis england
0,2,7,49,3,11,8,56,0,"record 25,984,000 immigrant employed united state july breitbart"
0,3,7,42,0,7,0,49,0,trump spokesman blast medium inauguration coverage
0,2,9,33,2,11,0,42,0,"spring, wont rich picasso"
0,1,5,67,2,13,0,72,0,'top model' winner caridee english modeling career battle psoriasis
0,1,3,29,0,4,0,32,0,police detain tsvangirai zimbabwe
0,3,2,65,4,12,0,67,0,met police officer sacked lying 'on-duty' late-night parking red route
0,2,2,22,0,4,0,24,0,trump change mind nato
0,1,3,42,2,9,2,45,0,tour de france: cancellara win 7.9 km time trial prologue
0,3,7,80,2,15,0,87,0,robot learning racist sexist: scientist reveal ai program exhibit human-like bias
0,3,8,44,1,11,1,52,0,"british woman held 2 month raped, australian police say"
0,2,10,36,1,9,1,46,0,percy harvin plan retire nfl 8-year career
0,1,3,53,0,9,0,56,0,australian senator arrives parliament dressed beer bottle
0,2,16,66,2,15,0,82,0,"moment lose, urge shakira getting humanitarian award world economic forum"
0,1,6,35,1,9,0,41,0,plate speaking driver state?
0,3,11,43,0,10,0,54,0,kim kardashian kanye west releasing kid clothingline
0,1,2,32,4,5,0,34,0,"'apple's data dirtiest,' say greenpeace"
0,1,6,32,1,7,0,38,0,"hand space history, superpower spar"
0,1,6,33,3,8,2,39,0,stock slump corporate woes; index fall 3.4%
0,1,2,37,1,7,0,39,0,"nine dead, score injured bombing iran"
0,1,4,45,0,9,0,49,0,body found crash site u helicopter afghanistan
0,3,11,62,4,12,0,73,0,bill belichick responds typical fashion mike tomlin calling patriot 'a**holes'
0,2,6,28,2,7,0,34,0,time warner chief: justhbo
0,2,6,34,0,5,0,40,0,another obamacare bailout declared illegal
0,3,2,68,3,10,2,70,0,51-year-old bernard hopkins championship boxing career end flying rope
0,2,17,45,1,14,0,62,0,sneak peek: jesse watters take tour historic reagan ranch insider
0,2,3,63,2,12,0,66,0,photo show obamas inauguration crowd bigger trump
0,1,7,46,1,9,0,53,0,wikinews interview mr. orange iwl taiwan wrestling
0,1,3,54,2,7,0,57,0,australia's governor-general cut trip short looming election
0,2,3,44,0,8,0,47,0,prince charles show dance move christmas party
0,3,3,62,0,14,4,65,0,democrat use obscure 1920s law try force donald trump release tax return
0,1,3,44,0,8,1,47,0,felix becomes category 1 hurricane threatens aruba
0,3,9,35,0,10,2,44,0,10 ugly holiday sweater wear next party
0,2,10,51,2,8,0,61,0,shaquille o'neal compare westbrook-durant situation free agency
0,1,2,34,0,7,0,36,0,blast mexico rip gas oil pipeline
0,2,1,31,1,8,3,32,0,"lyft launch 40 new cities, 3 new state"
0,3,7,33,0,7,0,40,0,car crash roof north carolina home
0,1,3,28,0,4,0,31,0,former libyan leader gaddafi killed
0,1,3,51,1,8,0,54,0,california supreme court defers ruling same-sex marriage ban
0,1,5,26,0,7,2,31,0,u actor patrick mcgoohan dead age 80
0,1,3,43,0,7,0,46,0,plane make emergency water landing darwin harbour
0,3,7,69,2,10,0,76,0,trump-russia hearing live: fbi director comey confirms investigation trump campaign
0,3,1,46,1,6,0,47,0,tunisia attack survivor reacts coroner's conclusion
0,1,3,54,1,9,0,57,0,quebec appeal long-gun registry destruction supreme court
0,1,4,37,0,6,0,41,0,michael jackson doctor post message youtube
0,2,2,59,0,12,0,61,0,time magazine asks trump remove fake cover display golf club
0,1,6,31,0,8,0,37,0,urine sample said link bond steroid
0,1,1,33,0,4,0,34,0,thousand demand climate change action
0,2,10,42,2,9,0,52,0,brexit migration cap get backing former u.k. tory minister
0,1,7,34,0,7,0,41,0,cleric led militant pakistan released
0,2,8,36,2,6,0,44,0,new women-only salon caters hijab-wearing client
0,3,12,68,0,14,0,80,0,russell westbrook steph curry speak scuffle broke thunder warrior
0,2,7,44,2,8,0,51,0,'scotus bladder' question defuses tension gorsuch hearing
0,3,9,44,0,9,0,53,0,fed official leaning toward bigger better balance sheet
0,2,8,41,4,9,2,49,0,murdoch twenty-first century fox bid $14 billion uk sky
0,1,4,22,0,3,0,26,0,senate scrap automatic raise
0,2,13,56,7,14,0,69,0,fox reportedly using trump grab em p***y tape sexual harassment seminar
0,1,3,53,0,10,0,56,0,u charge homeless man plane stolen crashed maryland
0,1,2,33,1,4,0,35,0,same-sex marriage legalized argentina
0,3,8,62,1,13,0,70,0,barack obama ivanka trump going neighbour washington dc's kalorama
0,3,14,60,1,13,0,74,0,facebook messenger's new group payment feature make going dutch meal insanely easy
0,2,1,48,2,7,0,49,0,botched castle restoration deemed heritage massacre
0,1,2,44,1,6,0,46,0,new zealand's worst behaved politician list released
0,1,2,29,0,5,0,31,0,u alter aviation security policy
0,1,1,45,1,8,0,46,0,scientist sequence small genome pest: spider mite
0,2,9,44,0,9,1,53,0,4 question hillary clinton face heading first debate
0,2,2,59,5,15,0,61,0,trump said cant find country actually well. did.
0,1,3,27,0,4,0,30,0,apple executive steve job resigns
0,1,6,25,0,7,0,31,0,top sunni survives attack iraq
0,3,2,50,0,10,0,52,0,shot ring ferguson protest sparked new documentary
0,1,3,30,0,5,0,33,0,dam removal proposal klamath river
0,1,3,48,0,7,0,51,0,christian science monitor cease daily print publication
0,2,14,68,4,15,0,82,0,voted trump! shock video show white man viciously beaten chicago election breitbart
0,3,8,48,0,8,0,56,0,sweeping federal review could affect consent decree nationwide
0,3,10,56,1,9,0,66,0,genius browser extension turn donald trump's tweet childish scribble
0,2,2,41,1,7,0,43,0,"wall street end higher technology, energy boost"
0,2,16,50,3,17,5,66,0,"tonight earth hour, here's help save 7,618 tonne coal 1 hour"
0,2,2,52,1,13,0,54,0,"new zealand vow kill every weasel, rat feral cat soil"
0,2,5,51,0,11,0,56,0,world without carrie fisher mean star war universe
0,3,8,42,3,10,0,50,0,"phew! bingeing tv show bad you, researcher claim"
0,3,2,37,1,8,0,39,0,"corpus christi tap water ban over, mayor say"
0,1,3,49,0,8,0,52,0,man take armoured vehicle rampage western sydney
0,1,2,41,0,7,0,43,0,bush crash bike scottish police officer
0,1,2,52,0,7,0,54,0,mathematics summer school turkey threatened authority
0,3,14,56,0,13,0,70,0,greenpeace literally brought marco rubio spine mock vote rex tillerson
0,2,5,51,4,9,0,56,0,yanis varoufakis: 'people confused support brexit'
0,2,5,25,1,5,0,30,0,"german really, really love euro"
0,2,16,48,1,15,0,64,0,"lady gaga perfect platform send message trump, failed u"
0,1,5,27,3,6,2,32,0,"mlb: twin defeat oriole 7-2, sweep series"
0,1,1,44,0,11,4,45,0,eurozone economy grow last quarter 2009
0,2,7,45,0,8,0,52,0,belgian man convicted funding brussels terrorism suspect
0,2,10,63,3,12,0,73,0,climate scientist urge president trump cave ivankas climate change madness
0,3,11,56,1,10,0,67,0,flight attendant's secret bathroom note saved teen girl human trafficking
0,1,6,48,3,8,0,54,0,"prada, ""illusionist"" among screen adaptation usc scripter"
0,2,5,79,0,16,2,84,0,johanna konta claim biggest title british woman 40 year defeat caroline wozniacki
0,2,8,40,0,11,2,48,0,20th century fox give real apology fake news campaign
0,2,8,42,2,7,0,50,0,nigeria botched airstrike show boko haram isnt defeated
0,1,3,40,0,5,0,43,0,new zealand parliament reconvenes election
0,1,6,61,0,10,0,67,0,spain danger eurovision disqualification scheduling snafu rtve
0,1,9,37,1,9,0,46,0,"youtube hulu, viewer settle longer video"
0,2,11,37,3,10,0,48,0,street artist america: 'my womanhood debate'
0,2,8,49,1,10,0,57,0,"mom told stop breastfeeding mall, record incident facebook"
0,2,20,66,2,19,0,86,0,went turkey interview president (almost) got meeting conspiracy theorist
0,3,5,20,0,7,1,25,0,9 way improve love life
0,1,5,35,0,7,2,40,0,former flemish minister paul akkermans dy 83
0,3,8,37,1,8,0,45,0,nintendo's making biggest bet year switch
0,2,1,28,1,5,2,29,0,america's oldest gorilla dy aged 60
0,2,11,51,3,12,0,62,0,mccain: lot medium coverage obama 'borderline propaganda' insider
0,3,8,43,4,8,0,51,0,"here's kendrick lamar rihanna's ""loyalty"" came together"
0,1,6,30,3,7,4,36,0,alcoa lost $1.19 billion 4th-quarter sale fell
0,2,8,54,2,8,0,62,0,"pension funds, foundation criticize southern co. executive compensation"
0,3,9,49,2,8,0,58,0,'walking dead' star ross marquand absolutely killer impression
0,1,4,48,0,6,0,52,0,mccain clinch republican nomination huckabee concedes
0,3,8,49,0,7,0,57,0,japan see chinese group backing okinawa independence activist
0,1,5,29,0,5,0,34,0,trade group meet curb protectionism
0,1,4,68,2,9,0,72,0,"president peruvian truth commission report death threats, anti-semitic hatemail"
0,3,8,41,3,10,0,49,0,"hollywood writer strike looming, here know"
0,1,9,49,2,10,0,58,0,human error management decision faulted w. va. bayer explosion
0,3,14,57,5,15,0,71,0,"john oliver interest letting 'last week tonight' become 'all trump, time'"
0,3,6,50,0,10,0,56,0,trump summons entire senate white house briefing north korea
0,3,12,47,2,11,0,59,0,someone isolated lady gagas super bowl vocal theyll blow youaway
0,3,10,50,2,13,0,60,0,"sarah palin, kid rock, ted nugent visit president trump white house"
0,2,2,36,2,8,0,38,0,north korea want country mushroom
0,3,1,33,0,7,3,34,0,clingy panda video rack 163m hit online
0,1,5,33,0,9,0,38,0,six error path financial crisis
0,3,2,25,1,4,0,27,0,marco rubio's chance revenge
0,3,8,30,2,8,1,38,0,"nov. 9, hillary clinton voter ate grief"
0,2,4,38,0,6,0,42,0,marissa mayer spends money like marieantoinette
0,1,6,33,1,7,0,39,0,"hurt economy, european vent anger"
0,3,6,44,1,9,0,50,0,drug screening can't wait kawhi leonard boost mvp bid
0,2,7,82,2,20,0,89,0,there wild theory ucla star lonzo ball quirky shot may affected type basketball us
0,2,5,46,1,12,0,51,0,"russia, state tv internet tell tale two protest"
0,3,11,47,0,11,0,58,0,man sends birthday card every year dog shared estranged wife
0,3,8,44,0,7,0,52,0,good samaritan rescue arizona state trooper shooting
0,3,5,62,3,11,0,67,0,"tyrion lannister fans, assemble! peter dinklage talk next avenger movie."
0,2,9,37,1,11,0,46,0,"cost debated, meal wheel get result"
0,1,3,28,0,4,0,31,0,canadian pm cabinet shuffle result
0,1,6,32,0,7,2,38,0,helen alfredsson shoot 62 set sybase record
0,3,7,33,0,8,0,40,0,republican health plan could affect
0,2,5,44,1,10,3,49,0,lg electronics build $250 million home appliance plant u
0,3,11,50,2,11,0,61,0,trump look report flynn discussed sanction russia
0,2,8,45,2,8,0,53,0,trump washington hotel draw protester ethic concern
0,1,4,30,0,6,0,34,0,spain advance first world cup final
0,3,2,32,1,9,2,34,0,"house fire ohio kill 2 adults, 2 child"
0,3,2,33,3,6,0,35,0,'how built india's biggest robot company'
0,3,1,37,1,6,0,38,0,paris close park major anti-rat campaign
0,2,4,21,0,6,0,25,0,death red carpet reporter
0,2,2,49,2,8,0,51,0,"warming lithium-ion, toyota charge battery option"
0,1,8,33,2,5,0,41,0,pay-per-click web advertiser fight costly fraud
0,3,7,46,0,8,0,53,0,california governor get prostate cancer treatment
0,2,3,55,2,10,0,58,0,toasting others health post-match pint lambrini bianco
0,1,5,62,2,11,4,67,0,"2008 taipei international book exhibition: events, visitor weekend"
0,3,5,48,6,11,0,53,0,"yes, donald trump lies. lot. news organization say so."
0,3,10,43,2,11,0,53,0,exxon mobil seek u.s. sanction waiver oil project russia
0,3,12,49,5,13,0,61,0,'mr. march' fire: oregon's tyler dorsey proving doubter wrong big way
0,3,16,59,4,14,0,75,0,"posting j&k easier smoother part anti-maoist operations, say survivor"
0,1,9,37,2,9,0,46,0,u.s. russia begin arm talk december deadline
0,2,1,51,0,10,3,52,0,cumbrian zoo almost 500 animal died refused new licence
0,3,10,44,0,10,2,54,0,player honor jackie robinson 70th anniversary mlb debut
0,1,6,30,0,6,0,36,0,former indian pm narasimha rao pass away
0,1,4,72,1,12,0,76,0,rossi continue legal appeal failed bid washington state governorship
0,2,4,75,3,15,0,79,0,live night: ben affleck's description film's sex scene leave scratching head
0,3,3,50,3,9,0,53,0,"besieged aleppo, resident show resilience. end nears."
0,3,3,62,1,13,0,65,0,nuclear option? roadmap gorsuch confirmation could play
0,3,13,56,2,12,0,69,0,man shot dead sentence commuted obama; fed move halfway-house inmate
0,1,10,43,3,9,0,53,0,g.o.p. force delay confirming eric holder attorney general
0,2,10,23,0,7,0,33,0,every nhl team fire coach
0,2,1,59,2,10,0,60,0,trump would join motley crew nepotist appointment son-in-law
0,2,5,58,0,13,0,63,0,donald trump undermined democracy soon sworn u president
0,3,1,53,2,10,0,54,0,"x-ray image useful viewed smartphone, study find"
0,2,9,37,0,9,0,46,0,kkk imperial wizard found dead missouri riverbank
0,1,7,67,0,12,0,74,0,u department housing urban development provide housing katrina refugee
0,1,2,53,1,9,6,55,0,"lordi horror movie receives 300,000 euro finnish government funding"
0,2,8,53,0,9,0,61,0,mark zuckerberg manifesto blueprint destroying journalism
0,1,4,15,1,4,0,19,0,apple fill void?
0,3,10,47,6,13,0,57,0,dakota meyer: 'mother bombs' drop win 'america's team' insider
0,1,8,52,0,10,0,60,0,english cricket team get uneven treatment everywhere field
0,1,2,60,0,8,0,62,0,bill gate release mosquito conference malaria awareness
0,1,4,40,2,9,0,44,0,uk study claim men higher average i.q. woman
0,3,4,27,5,5,0,31,0,u yemen raid: bomb-making video 'mix-up'
0,3,1,61,3,10,0,62,0,yale grad students' 'hunger strike' apparently involves eating hungry
0,2,1,51,1,9,0,52,0,"hedge fund stoop new low mishandling fees,accounts"
0,1,3,44,1,9,0,47,0,number breach new zealand's end year exam
0,2,2,51,0,10,0,53,0,david price force manager put fire mediaoutburst
0,1,7,40,1,9,0,47,0,"mets shut redding, candidate rotation"
0,3,9,50,3,11,0,59,0,trump first week leave washington white house staffpanting
0,2,10,26,3,8,0,36,0,here like plus-sizeathlete
0,1,3,25,0,5,0,28,0,u senate pass housing aid bill
0,1,2,40,0,6,0,42,0,historic scottish island castle win lottery
0,1,7,50,1,9,0,57,0,scottish singer jai mcdowall win fifth britain's got talent series
0,3,11,58,2,11,0,69,0,"colbert, obama's wh photographer mock conway microwave spying comment insider"
0,3,2,44,2,7,0,46,0,dr. price marvelous medicine stock portfolio
0,1,5,33,1,8,0,38,0,cn health safety plan planned cancelled
0,3,14,59,5,15,0,73,0,"watch prince royce give sneak peek new album 'five,' featuring zendaya, chris brown"
0,1,2,49,2,11,2,51,0,least 71 death mexico 'likely linked' swine flu outbreak
0,1,3,25,0,4,0,28,0,woodcraft folk loses subsidy
0,3,3,48,0,10,0,51,0,jewish centre evacuated u new wave bomb threat
0,1,5,48,0,10,9,53,0,australian treasury related agency spend 17000 aud massage 2004
0,3,10,41,3,9,3,51,0,"gett buy juno $200 million, uniting would-be uber competitor"
0,1,10,34,1,6,0,44,0,jpmorgan pulled cash early madoff-linked fund
0,1,3,33,0,6,0,36,0,bush call u offshore oil exploration
0,1,4,25,0,4,0,29,0,worth magazine reinvent
0,3,17,52,3,15,0,69,0,watch john legend slam donald trump pga awards: 'america better that'
0,1,4,35,0,6,0,39,0,suicide bomber attack u base afghanistan
0,1,8,45,2,9,0,53,0,"england, italy spain, champion crowned without victory"
0,2,2,39,0,8,0,41,0,turning pebble picture war syria
0,1,2,32,0,5,0,34,0,father mourn slain child arizona
0,3,9,51,0,10,0,60,0,lindsay lohan claim racially profiled wearing headscarf
0,3,3,53,4,11,0,56,0,russia urged ban 'beauty beast' remake gay 'propaganda'
0,1,3,20,0,4,0,23,0,turkey lift ban youtube
0,1,3,38,0,7,0,41,0,rolling stone unleash new song critical bush
0,1,5,25,2,5,2,30,0,deutsche bank post $1.6 billion profit
0,1,1,29,0,3,0,30,0,police raid filesharing resource
0,1,2,41,0,7,0,43,0,fox news movie reviewer fired downloading film
0,3,2,52,2,9,0,54,0,"racist email sent mich. student forged, university say"
0,1,6,41,2,7,2,47,0,"6 olympians, including 2 medalists, fail doping reanalysis"
0,2,10,57,0,9,0,67,0,millennials choose join corporate america becoming entrepreneur
0,1,4,73,4,13,0,77,0,"school australia's sunshine coast make staff redundant, request apply 'new' job"
0,3,9,30,3,8,0,39,0,u.s. border agent ask cellphone?
0,3,10,60,2,12,2,70,0,georgia middle school teacher arrested massive $6.2 million cocaine heroin bust
0,2,3,14,0,3,0,17,0,good time gun
0,1,3,17,0,2,0,20,0,turkish premier ailing
0,3,13,56,1,12,0,69,0,well happened again: people tried criticize chrissy teigen parenting
0,3,10,50,1,10,0,60,0,"campaign exit, manafort borrowed business trump tie"
0,1,7,29,0,8,0,36,0,rebellion range cattle id plan
0,2,1,60,1,14,0,61,0,ticketmaster want know far youre willing go see cover band
0,2,3,70,0,14,3,73,0,u reviewing airstrike corresponds site 200 iraqi civilian allegedly died
0,3,1,49,0,11,0,50,0,mom carry baby without brain full term donate organ
0,3,1,56,3,11,0,57,0,"growth pay ""majority"" tax reform, treasury secretary say"
0,2,1,63,1,13,2,64,0,"diesel car emit 10 time toxic pollution truck buses, data show"
0,2,5,47,0,10,0,52,0,apple taking chipmaker qualcomm u chinese court
0,2,2,50,1,8,0,52,0,"job interview utterly pointless, research show list"
0,3,14,51,1,13,0,65,0,sofa meatballs: ikea may next player restaurant business
0,2,8,43,2,11,0,51,0,entire u.s. senate go white house north korea briefing
0,2,4,42,1,8,0,46,0,hi-tech financial firm flee uk amid doubt brexit
0,2,1,64,1,10,0,65,0,"trained dolphin recruited locate, save elusive porpoise extinction"
0,3,3,55,0,10,0,58,0,toronto wolfpack take leap muddy unknown rural yorkshire
0,3,9,58,0,10,0,67,0,jim harbaugh reprimanded italian mall security guard throwing football
0,3,9,41,3,8,0,50,0,"selena quintanillas widower watched ""selena"" wasreal"
0,1,4,51,2,9,0,55,0,japan's air self-defense chief fired essay wartime history
0,3,2,53,3,9,0,55,0,jerusalem attack eyewitness: 'i saw truck hitting soldiers'
0,3,9,41,4,11,0,50,0,whats big deal? ask trump voter russia hacking report
0,1,10,43,1,10,4,53,0,"nascar driver kyle busch win 2011 spring race richmond, virginia"
0,1,5,24,0,5,0,29,0,france pay nuclear test victim
0,2,12,58,6,12,0,70,0,"shia labeouf complete meltdown bowling alley, call bartender 'f**king racist!'"
0,1,7,42,0,6,0,49,0,iranian overture might complicate relation israel
0,2,16,41,0,12,0,57,0,cbse tell school ensure insult national flag
0,2,8,52,1,10,0,60,0,mark zuckerberg call universal basic income america breitbart
0,1,5,54,0,12,4,59,0,u faa make airliner fuel tank inertion mandatory 1996 air disaster
0,1,1,35,1,5,0,36,0,sweden reaffirms aim oil-free economy
0,1,1,56,0,7,0,57,0,oil leaking container ship might cause environmental catastrophe
0,2,3,48,0,10,0,51,0,manhunt escaped murderer focus small new york town
0,2,10,42,0,10,4,52,0,identifying ideal 2017 nba trade deadline target team
0,3,1,66,6,16,0,67,0,"could lost life, too, say driver hit shamed girl jumped bridge"
0,3,8,40,0,9,0,48,0,syrian troop take control water facility rebel
0,3,11,31,2,11,6,42,0,"city pay $885,000 family whose dog killed police"
0,2,3,45,2,8,0,48,0,celebs descend washington anti-trump mega-rally
0,3,9,38,3,12,6,47,0,"obama cash in: set take $400,000 speech wall street firm"
0,1,1,47,0,7,0,48,0,afghan provincial governor killed mosque bomb attack
0,3,4,41,2,9,1,45,0,"officials: man killed, 2 officer wounded sc shootout"
0,1,7,31,4,8,4,38,0,u.s. epa submits 2003 greenhouse gas inventory u.n.
0,1,4,44,0,9,0,48,0,microsoft yahoo team make im client compatible
0,1,3,34,0,5,0,37,0,dinosaur track found arabian peninsula
0,2,12,43,7,11,0,55,0,"wale responds j. cole's ""false prophets"" new song ""groundhog's day"""
0,1,3,50,1,9,0,53,0,myanmar dissident suu kyi run parliament by-election
0,3,8,41,5,8,0,49,0,yahoo! finance #dumpkelloggs: cereal need agnostic
0,1,1,40,0,7,1,41,0,japanese court plan seize control 2channel
0,3,2,67,1,15,0,69,0,md. teen shoot buck stormed living room trashed christmas tree
0,2,2,45,1,8,0,47,0,"trump talk taiwanese leader, break precedent"
0,2,6,39,0,7,4,45,0,ed sheeran announced final glastonbury 2017 headliner
0,3,3,56,1,9,0,59,0,negative gearing: scott morrison reject fresh call change policy
0,2,5,31,0,5,0,36,0,ten unanswered question donald trump
0,3,11,48,0,10,0,59,0,foot snow expected storm barreling across northeast
0,1,6,32,0,7,1,38,0,3 officer dead shooting oakland
0,1,5,47,1,7,0,52,0,italian chocolatemaker ferrero rule buying uk's cadbury
0,2,2,43,1,8,0,45,0,politics policing making chicago crime wave worse?
0,2,5,37,2,8,0,42,0,mike dantoni come clean: quit ofcarmelo
0,1,8,32,0,7,0,40,0,yahoo revers web strategy new video
0,1,3,42,1,6,0,45,0,"several large explosion reported xinjiang, china"
0,3,3,14,0,6,2,17,0,zsa zsa gabor dead 99
0,2,13,49,6,17,4,62,0,"trump 2016: 'if guilty crime, need immunity for?' insider"
0,2,8,44,1,9,0,52,0,orlando manhunt: two officer die pursuit murder suspect
0,2,2,55,1,7,0,57,0,garden strimmers causing havoc britain's hedgehog population
0,2,1,81,1,16,0,82,0,uber officially resuming self-driving car test big accident weekend
0,2,2,75,4,15,0,77,0,"warned leave, kansa shooting victim refused abandon country loved, wife said"
0,1,1,48,2,10,4,49,0,scientist recreating 1918 flu virus say 'it came birds'
0,2,10,44,2,9,0,54,0,anonymous bomb threat rattle jewish center across eastern u.s.
0,3,10,51,2,11,0,61,0,innocent photo one skinny woman one curvy woman stir controversy
0,2,6,22,1,5,1,28,0,see spacex's falcon 9 rocket launch
0,2,8,45,5,11,0,53,0,"taraji p. henson: talking cookie, impact hidden figure"
0,1,7,29,1,9,0,36,0,time co. talk sell part building
0,1,6,31,0,7,1,37,0,8 team threaten splinter formula one
0,3,14,28,2,9,0,42,0,kpmgvoice: staff used right way?
0,2,6,29,0,5,0,35,0,automation actually create job
0,3,7,65,0,18,0,72,0,j k rowling took mike penny proved queen twitter list
0,3,1,49,0,12,0,50,0,doe unborn baby injured car saved rescuer
0,2,4,46,3,7,0,50,0,remember nixon? there's history behind trump's press attack
0,3,3,54,0,10,0,57,0,mal peet line posthumous win carnegie shortlist announced
0,3,14,56,1,15,2,70,0,13 survivor share memory sexual assault word describe feel
0,2,4,61,0,14,0,65,0,marine veteran lost leg afghanistan sworn ny police officer
0,3,8,34,3,7,0,42,0,"italy mount etna erupting, magnificent"
0,2,4,53,5,11,0,57,0,pressed time ash wednesday? there's 'drive-thru' church
0,3,3,39,1,10,2,42,0,trump vow 35% tax u firm move job overseas
0,1,7,27,1,8,0,34,0,"stork involved, mom dad help"
0,3,6,83,1,15,0,89,0,istanbul attack: cctv footage show gunman killing man outside reina nightclub firing street
0,3,12,60,1,11,0,72,0,lawyer russian whistleblower's family fall building one day hearing
0,2,3,48,2,10,0,51,0,"mom stole pricey stroller disney world, sold online:cops"
0,2,8,54,0,9,0,62,0,italian astronaut samantha cristoforetti set record woman space
0,1,4,46,1,10,0,50,0,recall thomas tank engine toy due lead-paint fear
0,3,10,60,1,9,0,70,0,bengals' adam jones arrested following alleged outburst outside cincinnati hotel
0,3,14,53,1,13,0,67,0,ga gas station ban sale sam adam falcons-patriots super bowl insider
0,3,1,69,0,11,0,70,0,congressional bill could allow veteran deemed mentally incompetent gun
0,2,9,41,1,8,0,50,0,barbie's surprising comeback everything race
0,3,5,62,0,13,0,67,0,scottish thing ever started trending twitter troll trump list
0,3,4,56,1,14,1,60,0,flashy $2 billion stadium raider want build la vega
0,2,4,50,1,8,0,54,0,syria conflict: u coalition admits killing civilian manbij
0,3,3,62,1,14,2,65,0,article 50 bill substantially altered delayed house lords?
0,3,11,34,1,10,0,45,0,waymo's uber lawsuit may start google patent war
0,3,12,41,1,11,0,53,0,mark twain's personal library open write novel
0,2,12,47,1,10,1,59,0,florida tourism ceo step pitbull tweet $1 million contract
0,2,12,47,1,10,0,59,0,"charles oakley, james dolan meet adam silver regarding msg arrest"
0,1,7,37,0,9,0,44,0,rickey henderson jim rice elected hall fame
0,2,8,41,3,8,0,49,0,putin loudest critic challenge him. kremlin happy
0,2,12,43,1,12,5,55,0,2017 nfl free agents: best player available every position post day 2
0,1,4,43,0,7,0,47,0,ralph nader enters u presidential race independent
0,2,1,48,0,12,5,49,0,38 dead 155 wounded twin bomb attack near istanbul stadium
0,3,8,38,0,11,0,46,0,man convicted murder hot car death sentenced
0,3,5,26,1,6,0,31,0,mystery japan stagnant wage
0,1,1,77,1,12,0,78,0,"jordanian king dissolve parliament, call general election two year ahead schedule"
0,1,5,28,1,6,4,33,0,i'll another win 2012 preakness stake
0,3,18,59,1,17,0,77,0,here's twenty one pilot took pant going stage accept award
0,1,4,28,2,6,0,32,0,u.s. postal service running money
0,2,6,45,1,10,4,51,0,ex-nfl star aaron hernandez found guilty 2012 double murder
0,1,1,42,1,4,0,43,0,palestinian gunman assassinate ex-security chief
0,1,3,58,0,11,0,61,0,airbus offer funding search black box air france disaster
0,1,12,54,2,14,0,66,0,forget cigarette lighter adapter. dock ipod car radio.
0,3,9,56,1,9,0,65,0,melania trump denies report first couple sleeping arrangement
0,3,8,34,0,9,0,42,0,iran bar american wrestling team world cup
0,3,11,56,0,12,0,67,0,texas officer placed leave video show teenage girl wrestled ground
0,2,2,18,1,3,0,20,0,italy's vote matter
0,1,2,62,0,10,0,64,0,mubarak refused permission leave egypt treatment heart attack
0,1,1,35,0,6,0,36,0,flexible display soon production
0,3,5,31,0,8,0,36,0,american health care act good start
0,3,15,58,4,12,0,73,0,promo: exclusivejacob latimore pure magic thrilling full trailer 'sleight'
0,3,10,44,2,9,0,54,0,"joyce mitchell, helped new york inmate escape, denied parole"
0,1,7,28,1,6,0,35,0,taiwan voter move away chen's agenda
0,1,3,60,0,11,0,63,0,philippine supreme court probe leak draft judgment election case
0,2,11,36,5,8,0,47,0,nbc's 'hairspray live!': watch live tv performance
0,1,7,70,1,11,0,77,0,australian rule football: west gippsland latrobe football league final week one result
0,3,8,53,0,14,2,61,0,ne classic edition back stock best buy store december 20th
0,3,10,52,1,11,0,62,0,"jabrill pepper role brown offense, according hue jackson"
0,1,4,52,0,11,0,56,0,verizon say customer phone record handed nsa
0,3,14,53,4,14,0,67,0,here's untold story sindhudesh 'country' sindhi people lost pakistan
0,2,10,42,2,10,0,52,0,china roar back lift global outlook u.s. consumer weakens
0,3,1,30,0,6,0,31,0,trump ditch press pool play golf
0,2,14,40,3,12,0,54,0,big sean tease 'snl' debut promo aziz ansari kate mckinnon
0,1,6,37,0,7,0,43,0,state reluctantly move raise tax cigarette
0,1,8,47,3,9,0,55,0,"azerbaijan, donkey suit provokes laugh and, possibly, arrest"
0,2,4,46,1,8,0,50,0,trump praise exxon's rex tillerson tipped top diplomat
0,3,5,53,1,10,0,58,0,"nfl revers course allowing titans, brown wear special cleat"
0,3,8,47,1,8,2,55,0,diver capture underwater video sudden 5.6 magnitude earthquake
0,1,6,31,0,8,0,37,0,murray meet nadal final indian well
0,2,2,25,0,4,0,27,0,canadian dollar climbing
0,3,13,51,0,14,0,64,0,brutal powerbomb mma fight end worst way possible guy losing end
0,1,5,33,1,8,0,38,0,winner loser uk's east coast rail line
0,2,1,56,7,9,0,57,0,racist headteacher called parent 'b-----s' banned classroom
0,1,6,54,1,11,0,60,0,"poll held u state local elections, incomplete gop success"
0,2,5,63,0,11,0,68,0,british cycling accused covering bullying culture misleading uk sport
0,3,8,42,3,7,0,50,0,oscar-winning syrian group hope award stop 'massacres'
0,2,2,49,2,16,4,51,0,mean british 2017? join live look week
0,2,4,50,4,10,0,54,0,"king: donald trump 'shocked world,' help negotiate peace"
0,3,9,54,1,9,0,63,0,russian army flagship store give american discount celebrate trump
0,1,5,43,0,7,0,48,0,un security council imposes sanction iran
0,1,1,59,0,9,0,60,0,iranian opposition group declares act current government void
0,3,9,45,0,9,0,54,0,trump revives auto efficiency debate pledge slash rule
0,3,4,56,1,10,0,60,0,harry redknapp: tottenham major disappointment since left
0,3,5,27,1,5,0,32,0,consumer take credit-card breather
0,2,3,62,0,10,0,65,0,conservative hope trump victory gorsuch breed success
0,3,2,47,0,8,0,49,0,critic warn trump budget cut could hurt terrorism fight
0,1,2,35,0,8,3,37,0,oil spill alaska close 800 mile pipeline
0,2,2,64,2,12,0,66,0,"hillary clinton's back spotlight, decidedly campaign trail"
0,1,7,30,1,6,0,37,0,"seeking dollars, nascar go beyond logo"
0,3,5,40,1,7,0,45,0,"ivanka trump, jared kushner inch closer washington"
0,1,5,22,1,4,0,27,0,"across asia, dalliance news"
0,2,15,26,2,7,0,41,0,breaking: trump saudi arm deal actually fake
0,2,3,44,0,8,2,47,0,professional wrestling legend dusty rhodes dy age 69
0,3,12,52,2,11,0,64,0,"female railway clerk refuse sing duet manager, get transfer notice!"
0,1,1,41,0,4,0,42,0,egyptian voter approve constitutional change
0,2,8,44,1,9,0,52,0,hiring employee's buddy fueling major workplace crisis
0,3,5,21,0,4,0,26,0,beware beautiful resume
0,2,2,39,2,7,0,41,0,fixer upper star become big name inpublishing
0,3,6,26,0,6,0,32,0,europe waving goodbye sugar cane
0,3,19,53,2,15,0,72,0,"ibmvoice: world water day, make difference lack water resource"
0,3,12,51,3,9,0,63,0,cpacs organizer explains invited (and disinvited) milo yiannopoulos
0,2,9,40,4,10,0,49,0,"trump tweet new year's wishes, 'including many enemies'"
0,1,1,58,1,9,0,59,0,"copenhagen hotel explosion may terror attack, say official"
0,2,3,51,5,11,0,54,0,trump want restock guantnamo. who worst worst now?
0,3,1,42,0,5,0,43,0,iraq gunman kidnap campaigning female journalist
0,1,6,19,0,7,0,25,0,end banking know
0,3,15,65,4,14,0,80,0,"state union alphabet, larry page gloss setbacks, eye 'amazing opportunities'"
0,3,11,45,2,10,0,56,0,"dog engagement photo shoot, ridiculously cute"
0,3,6,36,2,11,4,42,0,"girls, 11 12, shot head separate chicago attack"
0,1,3,30,0,5,0,33,0,volcano erupts aleutian island
0,1,9,28,3,7,0,37,0,police chief play i.r.a. group ulster
0,3,11,51,4,12,0,62,0,"adrian peterson rumors: rb explore options, reportedly 'no rush' sign"
0,3,10,53,1,11,0,63,0,shaquille o'neal pay funeral teen accidentally killed
0,2,13,46,0,9,0,59,0,lapd chief recommends criminal charge officer fatalshooting
0,2,8,35,2,8,2,43,0,take amazon: walmart buy moosejaw $51 million
0,1,1,51,0,9,0,52,0,job unveils new product cloud secrecy lawsuit
0,1,4,39,0,7,0,43,0,red cresent worker kidnapped blair visit iraq
0,3,2,60,2,11,2,62,0,adam johnson secretly filmed saying wished raped 15-year-old victim
0,2,12,53,1,14,0,65,0,trump may give pentagon authority conduct raid new york time
0,1,7,71,1,13,0,78,0,"u president obama, congress call blocking executive bonus aig insurance company"
0,2,11,48,0,13,0,59,0,trump travel dover air force base honor navy seal killed yemen
0,2,11,44,2,12,3,55,0,wall street week ahead: optimism among s&p 500 ceo trump take power
0,3,5,60,3,13,0,65,0,gov. joe piscopo? candidate two state try use lesson learned trump.
0,2,2,65,0,12,0,67,0,fatal airstrike hit syrian town day deadly chemical attack citizen
0,3,10,32,2,9,0,42,0,report: hudson's bay talk buy neiman marcus
0,1,4,27,0,5,0,31,0,obama voice optimism economy
0,2,13,36,1,11,2,49,0,brett favre say could still make nfl-level throw age 47
0,1,6,33,1,6,0,39,0,"recession waxes, business meeting wane"
0,3,2,51,3,10,2,53,0,high school junior take 93-year-old grandmother prom yahoo
0,2,13,39,3,7,0,52,0,billboard twitter live streaming #revolvefestival: watch
0,1,8,41,4,9,0,49,0,emma's imagination declared winner uk's 'must music'
0,2,3,44,1,11,2,47,0,samsung unveils first new galaxy 8 phone since note 7 video
0,3,16,45,5,13,0,61,0,u.s. women's soccer team agrees new cba u.s. soccer labor dispute
0,3,7,39,0,9,4,46,0,ghost 1990s haunting dollar slowing gain
0,3,6,29,1,6,4,35,0,college football's 2017 final four dark horse
0,1,3,68,0,8,0,71,0,nz government pass bill legalise controversial electioneering overspending
0,2,3,74,0,11,0,77,0,dakota access pipeline protester meet authority emergency evacuation order
0,2,5,59,2,10,0,64,0,"white house defends jared kushner, expert question back-channel move"
0,1,5,39,0,6,0,44,0,looking add diversity environmental movement
0,3,3,57,0,11,0,60,0,plan hand control st petersburg cathedral church spark outcry
0,1,5,28,3,5,0,33,0,"halema`uma`u crater erupts hawaii, usa"
0,2,2,44,0,8,0,46,0,obama leave troop planned afghanistan
0,1,5,51,0,7,0,56,0,u congresswoman gabrielle giffords shot arizona supermarket
0,3,7,29,1,8,0,36,0,hate laundry? robot
0,3,16,68,6,19,0,84,0,"natasha lyonne meeting nicki minaj, preparing orange new black hate spanx [video]"
0,1,5,36,2,8,6,41,0,"plan magazine sold 300,000 commercial medium group"
0,2,4,46,1,6,0,50,0,gennifer flower attending first clinton-trumpdebate
0,2,7,24,3,7,0,31,0,"listen lady gaga's new song ""the cure"""
0,2,11,46,0,14,5,57,0,brian westbrook responds drew pearson start day 3 2017 nfl draft
0,3,1,54,2,10,0,55,0,soldier could 'shut justice' combat immunity plan
0,1,3,35,1,5,0,38,0,anti-bush protest turn violent argentina
0,1,2,53,0,7,0,55,0,chinese hunger strike continues australian detention centre
0,3,4,44,3,11,0,48,0,jill stein: al gore need 'step up' climate change fight
0,1,2,43,0,6,0,45,0,u federal judge dismisses targeted killing lawsuit
0,3,11,58,1,10,0,69,0,neil gorsuch's supreme court nomination clear senate committee partisan vote
0,3,2,56,3,11,0,58,0,artist doesnt see vagina sculpture versailles problem
0,1,4,34,0,6,4,38,0,nasa considers continuing shuttle use 2010
0,2,2,59,1,11,0,61,0,question trust? anderson report lay test surveillance law
0,3,2,75,2,13,0,77,0,superannuation: first-home buyer able use compulsory saving deposit
0,1,7,28,0,7,0,35,0,british report urge new rule bank pay
0,1,4,48,0,6,0,52,0,suicide attack hit iranian revolutionary guard commander
0,1,3,57,2,11,0,60,0,"false dawn air france flight; debris crash, search continues"
0,2,6,34,8,7,4,40,0,"mashable periscope: ""#sxsw 2017 recap (airport 'scope!)"""
0,2,3,34,1,9,0,37,0,could pas test become u citizen?
0,2,9,45,3,10,0,54,0,nancy pelosi balancing act fast-track power trade deal
0,2,8,40,3,7,0,48,0,taika waititi co-direct michael jackson movie 'bubbles'
0,2,10,46,2,12,0,56,0,u.k. police identify suspect probe child abuse soccer team
0,2,9,35,1,8,2,44,0,17 reality everyone child-free choice know
0,3,11,38,4,13,2,49,0,"al jarreau, singer spanned jazz, pop r&b worlds, dy 76"
0,3,3,62,0,14,0,65,0,ben carson got stuck lift everyone mercilessly mocking list
0,3,6,33,1,6,0,39,0,syrian activists: isi recaptured palmyra
0,3,3,40,4,9,0,43,0,michelle obama: 'i run office' child
0,3,8,48,1,10,0,56,0,jerry sandusky's son jeffrey arrested sexual assault child
0,1,8,45,0,7,0,53,0,tool leave wildlife unbothered widen research horizon
0,1,3,10,0,2,2,13,0,h5n1 hit britain
0,1,7,41,0,8,1,48,0,roadside bomb kill 3 aid worker northern afghanistan
0,1,7,26,2,6,0,33,0,u.s. market spend day treading water
0,3,12,34,1,9,0,46,0,nasa say one saturn's moon could support alien life
0,1,6,46,1,8,0,52,0,assisted-suicide doctor jack kevorkian run u congress
0,3,11,45,2,10,0,56,0,husband claim 'bad dream' wife cheating led fierce assault
0,2,8,82,2,16,0,90,0,"trump's america rex tillerson make first official visit china, look breakthrough south china sea"
0,2,13,52,1,13,0,65,0,lebron james tease new track meek mill nipsey hussle snapchat?
0,1,4,50,0,7,0,54,0,chris hughton appointed permanent manager newcastle united
0,2,3,37,1,9,0,40,0,u break cycle gun control failure?
0,2,3,24,0,6,2,27,0,soul singer sharon jones dead 60
0,3,6,15,0,5,0,21,0,snapchat new tv
0,3,8,40,0,9,0,48,0,nestl cutting almost half sugar chocolate
0,1,8,35,1,6,0,43,0,mets produce late-inning frustration
0,2,11,73,2,16,2,84,0,super bowl 51: new england patriots' martellus bennett skip white house visit donald trump protest
0,3,9,39,1,9,0,48,0,"remote indian village, cannabis livelihood"
0,3,15,52,1,13,0,67,0,jamie foxx roasted nba fan removing kobe bryant all-time great list
0,1,2,36,1,7,0,38,0,"boat bangladesh sinks, least twelve dead"
0,1,6,43,0,10,4,49,0,french author le clzio win 2008 nobel prize literature
0,3,4,76,2,17,0,80,0,danny dyer take break eastenders 'sort life out' struggling give alcohol
0,2,1,63,3,12,0,64,0,"trump wont release tax return people dont care, top adviser say"
0,1,2,51,0,7,0,53,0,associated press go blogger copyright violation
0,1,3,11,0,4,3,14,0,300 laid sears
0,1,3,28,1,4,0,31,0,"brush fire threatens molokai, hawaii"
0,2,10,30,0,9,0,40,0,closest thing home hospital bed
0,1,5,27,0,6,0,32,0,fiat nearing deal chrysler stake
0,1,3,63,0,10,0,66,0,proposed united state doctrine would expand possible use nuclear weapon
0,3,9,50,4,9,0,59,0,trump vetting order wouldnt prevented majority past attack
0,2,4,62,2,11,0,66,0,thousand flee aleppo assads force move split syrian rebel stronghold
0,1,4,31,0,5,0,35,0,congo press extradition warlord
0,1,2,61,0,10,0,63,0,israel rule victim jewish terrorist entitled lifelong support
0,3,3,33,1,9,2,36,0,afghan official: u bomb death toll rise 94
0,1,7,39,1,8,0,46,0,"uncertain economy, charity try retain donor"
0,3,15,33,2,10,0,48,0,remy already performing shether tour lil kim
0,3,3,64,0,11,0,67,0,italian cyclist michele scarponi killed hit van training
0,1,1,28,0,4,0,29,0,apple plan another special event
0,3,10,60,5,12,0,70,0,rory mcilroy: golfing trump 'endorsement' 'political statement' insider
0,3,5,24,0,5,2,29,0,serena williams 20 week pregnant
0,3,12,35,2,10,0,47,0,lady orange new black slayed orangecon
0,2,2,55,2,10,0,57,0,jeremy corbyn make election pledge bust 'cosy cartel' politics
0,3,1,43,1,7,0,44,0,hacker hold hotel's key hostage bitcoin ransom
0,1,2,65,3,13,3,67,0,blair: g8 leader announce $50 billion aid increase; talk trade climate change
0,1,4,28,3,5,0,32,0,"fda recall ""mama's"" brand smoked salmon"
0,2,6,29,3,8,0,35,0,daily: making sense gorsuch pick
0,2,3,77,4,14,0,80,0,made question sanity every day': michael wardian set record seven-marathon challenge
0,1,5,55,0,11,6,60,0,president obama name 16 recipient 2009 presidential medal freedom
0,1,5,30,0,6,0,35,0,home video capture alleged ufo haiti
0,3,3,45,2,7,0,48,0,brutal holiday blizzard wreaks havoc across northern u.s.
0,2,3,61,3,12,0,64,0,lawyer: mckinney police officer allowed emotion get better
0,3,4,47,0,7,0,51,0,venus williams make history australian open semifinal
0,2,10,42,0,10,0,52,0,adidas revisting history make next great sneaker
0,2,8,40,2,11,0,48,0,"lady gaga super bowl: controversy, lot glitter"
0,2,2,50,0,8,0,52,0,trump move agenda forward even russia controversy swirl
0,3,4,73,1,16,0,77,0,new york city creating america's biggest book club picking one book everyone read
0,2,0,86,8,11,2,86,0,13-year-old new pinball world champion switch-check switch-x switch-check switch-x switch-check switch-x
0,3,3,40,0,6,0,43,0,telstra outage across australia sydney fire
0,3,11,48,0,10,0,59,0,kid gave class goldfish burning viking longshipburial
0,2,6,53,0,6,0,59,0,israel approves legislation retroactively legalizing settlement
0,3,3,69,3,10,0,72,0,illicit-photo scandal touch military branch besides marines: report yahoo
0,1,4,27,1,7,2,31,0,"boat dr congo capsizes, 80 feared dead"
0,3,8,37,0,8,0,45,0,dog better machine guarding border
0,2,12,60,2,12,0,72,0,anti-mass migration party barred tv debate ahead german election breitbart
0,1,3,44,0,8,0,47,0,first female boxing death occurs u sanctioned match
0,1,5,44,0,7,0,49,0,north queensland fury sign former liverpool great fowler
0,1,6,37,0,6,0,43,0,medical student indicted craigslist killing
0,1,5,28,0,6,4,33,0,kimi rikknen win 2008 spanish grand prix
0,3,2,53,4,12,2,55,0,"facebook would 'love' acquire snap share drop $14, say analyst"
0,3,1,32,1,5,0,33,0,turkish cabin crew deliver mid-air baby
0,3,10,37,2,11,0,47,0,'la la land' live concert tour kick hollywood bowl
0,2,7,31,0,9,4,38,0,watch 2017 oscar red carpet live stream
0,3,1,51,0,8,0,52,0,congo disappearance raise alarm political tension grow
0,2,3,50,1,8,0,53,0,"enormous purple sea blob invading east bay beaches, waterway"
0,1,5,66,1,11,0,71,0,reports: parent missing girl madeleine mccann suspect disappearance
0,1,1,24,1,5,2,25,0,google worth $80 billion
0,2,4,33,0,7,0,37,0,ranking mlb team ahead offseason
0,2,4,64,1,15,0,68,0,"woman kill grim portrait female prisoner divided america, review"
0,2,15,39,0,10,0,54,0,naacp president call donald trump apologize john lewis
0,3,10,39,0,12,0,49,0,trump may need second term see fruit trade deal
0,3,3,56,3,13,0,59,0,"trump asks john brennan source ""fake news,"" cite evidence"
0,2,15,45,1,14,0,60,0,lot people pissed amy adam didnt get nominated anoscar
0,3,8,47,1,10,0,55,0,"ge, siemens vie reinvent manufacturing harnessing cloud"
0,1,7,52,1,12,0,59,0,"local officer claim seen ufo charlotte, north carolina"
0,3,12,51,4,11,0,63,0,conor mcgregor declares 'stop floyd' mayweather 'take boxing'
0,1,3,32,1,5,0,35,0,guinea-bissau hold election june
0,3,4,45,2,7,0,49,0,significance dale earnhardt jr.'s immigration tweet
0,3,2,29,0,5,0,31,0,violinist brings music back mosul
0,1,8,33,1,7,0,41,0,voice-activated ilane sort mail drive
0,3,2,14,0,3,4,16,0,top influencers 2017
0,2,2,43,1,7,0,45,0,senate vote undo obama-era internet privacy rule
0,1,3,44,0,7,0,47,0,russian embassy attacked molotov cocktail minsk
0,1,4,26,0,6,0,30,0,bringing order chaos note
0,3,8,76,2,13,0,84,0,report: german vice chancellor sigmar gabriel challenge angela merkel year's election
0,1,5,51,0,7,0,56,0,resignation jetblue flight attendant steven slater announced
0,3,14,52,0,13,0,66,0,people coming new united airline motto straight fire
0,3,8,37,2,8,0,45,0,supporter flock d.c. pizzeria targeted fake news
0,2,2,72,1,12,0,74,0,"gulf mexico water freakishly warm, could mean explosive springtime storm"
0,3,13,64,5,16,0,77,0,"gen. keane: trump sent 'loud, clear message' adversary airstrikes syria insider"
0,2,2,54,1,9,0,56,0,trump downplays bannon's campaign role amid report infighting
0,1,2,75,2,13,0,77,0,"past eurovision contestant give advice year's performers, speculate win"
0,1,7,50,0,10,0,57,0,sectarian politics iraq stall effort govern province
0,1,1,45,0,5,0,46,0,scotland suffers severe flooding following downpour
0,2,2,53,1,9,0,55,0,"scientist erupt protest, volcanologist run congress"
0,2,3,67,1,12,0,70,0,next week arctic blast could mean two bout wintry precipitation washington
0,2,14,41,2,13,0,55,0,"airport now, laptop ban could goglobal"
0,3,7,32,0,9,0,39,0,cheaper rival eat away apple sale china
0,1,4,31,1,7,2,35,0,tour de france: daniele bennati win stage 17
0,2,3,39,1,10,0,42,0,democratic party lost mind itssoul
0,3,4,67,1,14,0,71,0,"diesel car phased stop pollution deaths, say chief medical officer"
0,3,11,27,2,8,0,38,0,china hna group offer buy singapore cwt
0,1,5,32,2,7,4,37,0,"jzef rotblat, 1995 nobel peace prize winner, dy"
0,3,1,65,1,12,1,66,0,oklahoma home invasion shooting: 3 victim broke property earlier day
0,3,2,30,1,7,0,32,0,nazi's son return looted art poland
0,2,7,35,0,9,2,42,0,21st century fox reach preliminary deal buy sky
0,2,9,45,1,12,0,54,0,"lincoln obama, crowd capitol counted"
0,1,3,32,2,5,0,35,0,peace activist propose 'fast freedom'
0,1,5,27,0,5,0,32,0,nine killed tornado rake oklahoma
0,1,2,55,2,9,2,57,0,fox news security hole expose 1.5 million users' personal information
0,1,8,27,3,8,0,35,0,"one genome, many type cells. how?"
0,1,7,30,1,7,0,37,0,"student stand called upon,"
0,2,2,57,0,8,0,59,0,madonna confirms adoption twin heartwarming instagram post
0,1,5,30,1,7,0,35,0,"post europe, renaissance admiral"
0,1,8,38,1,8,0,46,0,"bullfighter gain honor, peer perceive grave loss"
0,3,2,46,1,6,0,48,0,france election: fillon apologises family payment
0,3,15,59,0,14,0,74,0,kerala police chief post apology facebook video moral policing go viral
0,3,1,43,1,7,0,44,0,britain's classic red telephone box get makeover
0,3,6,29,1,6,0,35,0,go everest base campjust breakfast
0,2,9,48,2,10,4,57,0,"tiger wood miss cut 2017 farmer insurance open: comments, reaction"
0,3,9,31,3,11,2,40,0,shes 17 need birth control. turn backs?
0,2,10,47,1,11,0,57,0,samantha power watched half million arab die slammed israel
0,2,8,37,0,9,0,45,0,prom date assigned lottery high school
0,2,11,56,6,10,0,67,0,lt. col. shaffer: potential obama wiretapping 'soviet-level wrongdoing' insider
0,2,12,45,1,11,0,57,0,barack obama's pearl harbor speech seen rebuke trump world view
0,3,2,53,1,10,0,55,0,lena dunham apologizes saying wish she'd abortion
0,2,4,23,0,5,0,27,0,meet donald trump europe
0,2,4,53,0,11,1,57,0,4 scenario could still put merrick garland supreme court
0,2,3,18,1,2,0,21,0,arm length transaction!
0,3,2,60,1,7,0,62,0,evgenia medvedeva retains world title record-smashing performance
0,3,5,23,1,4,0,28,0,golden state almost-warriors
0,1,6,30,0,7,0,36,0,walk crop electronic reader
0,2,6,25,0,6,0,31,0,iran back taliban cash arm
0,2,1,39,1,6,0,40,0,celeb-favorite boot selling outfast
0,3,9,38,3,9,2,47,0,japan post take $3.6 billion write-down toll holding
0,1,6,43,0,7,1,49,0,4 english club advance champion league quarterfinal
0,1,2,79,0,15,0,81,0,least four dead hundred home destroyed week wildfire rage throughout texas
0,3,17,68,3,17,2,85,0,"12 company around world, including uber airbus, racing build world's first flying car"
0,1,7,30,2,10,1,37,0,"fuse fear, lit china, victim 2 side"
0,2,12,49,2,10,2,61,0,24 million people stand lose insurance gop obamacare 'replacement'
0,1,8,34,2,7,0,42,0,u.s. hold recent advantage meeting mexico
0,2,9,39,1,12,2,48,0,bullish bet crude cut ever price fall $50
0,3,3,42,0,10,0,45,0,u ally used patriot missile shoot small drone
0,2,10,59,3,11,0,69,0,"'high likelihood' berlin terror suspect perpetrator, german authority say"
0,3,1,48,1,7,0,49,0,"immediate intervention pension firms, say minister"
0,3,7,49,3,10,0,56,0,chelsea handler lead 'women's march' sundance film festival
0,3,9,36,4,9,0,45,0,fyre festival organizer: 'lets legends'
0,3,11,36,5,11,0,47,0,alan thickes dr. seaver didnt know best. charm.
0,3,6,29,2,7,4,35,0,best rock/alternative album 2016?
0,3,17,57,4,15,0,74,0,virat-anushka dancing 'dhol jageero da' best thing see internet today
0,1,1,38,0,6,0,39,0,dolphin dy performance theme park
0,2,15,62,3,16,0,77,0,kevin durant talk initially thinking season: 'i burst crying'
0,2,10,50,2,10,0,60,0,"mike bloomberg would lose landside trump, sander breitbart"
0,1,2,40,0,6,0,42,0,charles manson release album free license
0,3,1,71,2,15,2,72,0,"tourist, 60, left serious facial injury rejecting man tried chat"
0,1,7,41,0,7,0,48,0,judge allows katrina lawsuit corp engineer
0,1,6,37,0,6,0,43,0,employment contract viewed rewritable
0,3,3,45,0,7,0,48,0,israel arafat street sign dropped netanyahu anger
0,2,8,38,0,9,0,46,0,man posed justin bieber online extort nude photo
0,3,2,56,1,8,0,58,0,photograph show alaska volcano's eruption changed island
0,2,10,57,2,12,0,67,0,sean spicer appeal conservative ryancare: chance breitbart
0,2,5,23,0,5,0,28,0,new insight prince charles
0,2,2,64,0,12,2,66,0,two juvenile charged arson tennessee wildfire left 14 people dead
0,1,10,26,4,9,0,36,0,"beckham m.l.s., breaking hard"
0,2,8,42,0,9,0,50,0,dave chappelle john mayer pay tribute charlie murphy
0,1,9,34,1,8,0,43,0,consumer cut back: object lesson japan
0,2,1,57,0,11,1,58,0,chattanooga bus driver arraigned crash killed 6 child
0,3,6,53,4,14,0,59,0,sen. cory booker asks mindy kaling dinner twitter; say 'yes'
0,3,1,40,2,9,4,41,0,2017 'polar bear plunge' pic give chill
0,1,4,30,0,5,0,34,0,hundred thousand protest france
0,3,4,60,0,12,0,64,0,chuck grassley say expects supreme court justice resign summer
0,3,17,63,1,16,0,80,0,"despite davis cup loss, leander paes announces shall always india need"
0,2,5,53,1,8,0,58,0,"donald trump suspends u refugee program, indefinitely bar syrian"
0,2,11,41,2,11,0,52,0,"carson wentz throw td pas vs. cowboys, give ball mike trout"
0,2,3,39,2,8,1,42,0,ap: trump's voter fraud expert registered 3 state
0,1,4,41,1,7,0,45,0,tour de france: alexander vinokourov fails blood test
0,2,8,35,1,7,0,43,0,great leader speak ill predecessor
0,3,1,43,0,9,0,44,0,pipeline protester set fire ahead camp closing
0,3,10,43,1,10,0,53,0,un brace trump detente russia upset balance power
0,1,9,18,5,6,0,27,0,"day, player rule l.p.g.a."
0,3,13,40,2,12,0,53,0,"buy weed flower crown coachella, not?"
0,2,1,60,4,12,5,61,0,"trump energy plan doesnt mention solar, industry added 51,000 job"
0,3,17,71,4,16,2,88,0,"bengaluru's 1.5 million two-wheeler rider choose go helmetless, cop plan provide free headgear"
0,1,3,78,2,13,0,81,0,"british government apologises suggesting pope could create brand ""benedict"" condom"
0,1,1,37,0,4,0,38,0,philippine impeachment unlikely succeed
0,3,10,36,3,7,0,46,0,"kendrick lamar's ""dna"" hit ridiculous biting claim"
0,1,2,25,0,6,4,27,0,gm post first annual loss since 1992
0,3,1,39,0,7,0,40,0,letter carrier accused dumping mail wood
0,2,10,28,4,10,0,38,0,tech group trump: u.s. cant take china alone
0,1,8,29,1,8,0,37,0,"billy may gone, infomercial go"
0,3,2,37,0,5,0,39,0,white house video showcase family residence
0,3,10,41,2,11,1,51,0,"evidence kendrick subbing drake ""the heart part 4"""
0,1,2,34,0,3,0,36,0,california class commemorates holocaust
0,3,5,54,1,14,1,59,0,h1-b critic urge trump reform visa say take job u worker
0,2,4,60,2,12,0,64,0,tale two speeches: comparing trump's inaugural address congress
0,2,3,46,2,8,0,49,0,moth 'golden flake hairstyle' named donald trump
0,2,12,44,3,11,0,56,0,inside camila cabello's fifth harmony exit: go wrong?
0,2,10,48,2,13,0,58,0,bob diaco uconn husky -- need ucf knight consent rivalry
0,2,7,44,0,8,0,51,0,homeless across country fall victim synthetic marijuana
0,1,5,57,2,10,0,62,0,"sherpa mountaineer nawang gombu, first summit mount everest twice, dy"
0,2,2,42,2,8,2,44,0,obamas $65 million book advance actually mean
0,1,2,44,1,6,0,46,0,"eight killed virginia shooting, suspect surrender"
0,3,8,39,1,7,2,47,0,devin booker score team-record 70 point celtic
0,1,11,40,4,12,0,51,0,"billups back denver, fan dreaming n.b.a. title"
0,1,6,37,0,6,0,43,0,lyricist javed akhtar awarded indira gandhi prize
0,1,3,76,2,12,0,79,0,u.s. military denies report helicopter opened fire libyan civilian rescue mission
0,3,9,40,1,11,0,49,0,latest: tear shed miami exile castro funeral
0,2,3,23,0,5,0,26,0,jeff fisher fired ram coach
0,3,6,50,3,10,1,56,0,j.k. rowling slam international women's day troll 1 perfect tweet
0,2,4,36,5,8,0,40,0,"okay, lost. dont sabotage obamacare. fix it."
0,1,10,60,0,10,0,70,0,iraqi official concerned absence shiite pilgrim could affect election
0,1,3,40,2,8,0,43,0,"attack occurs stavropol, russia; least six dead"
0,2,2,48,0,6,0,50,0,republican already jittery quick obamacare repeal
0,1,3,26,0,6,4,29,0,festival 2007 take place poland
0,2,2,48,0,9,1,50,0,activist spend 6 hour suspended shell ship protest
0,1,2,36,1,8,2,38,0,"gold mine tanzania collapses, least 20 dead"
0,2,2,48,1,11,8,50,0,"1764 census reveals st kilda resident feasted 1,600 seabird day"
0,3,3,51,1,8,0,54,0,judge cleared misconduct brock turner sexual-assault case
0,3,2,54,0,8,0,56,0,defeat trumpism take extraordinary popular resistance
0,3,8,38,0,10,4,46,0,swedish stock pay best dividend 2017
0,1,5,36,2,6,0,41,0,u.s. republican party television ad bash canada
0,2,12,39,3,12,0,51,0,john cena's muscular frame made poor game show host 'snl'
0,1,6,21,0,7,0,27,0,son said rise north korea
0,2,2,45,0,7,0,47,0,united airline lift ground stop domestic flight
0,2,1,49,0,9,1,50,0,5 thing trump liberal probably actually like
0,1,2,53,0,10,0,55,0,man cleared belfast bomb attempt retrial eleven year
0,3,10,33,1,10,2,43,0,nokia phone early 00s making comeback
0,2,9,63,0,11,0,72,0,seven injured chapel hill celebration north carolina win ncaa tournament
0,1,8,38,0,7,0,46,0,southwest inspects jet hole force landing
0,2,10,20,2,7,0,30,0,hiv trap: woman lack control
0,1,1,46,0,7,0,47,0,israel install missile defense system airliner
0,3,2,41,1,7,0,43,0,trump's rapid rapprochement plan russia fade
0,2,7,39,3,10,3,46,0,"global fund raise $12.9 billion fight aids, tb malaria"
0,3,5,66,1,12,2,71,0,"gastro outbreak hit 90 passenger sun princess cruise ship, queensland health say"
0,1,7,28,0,6,0,35,0,mar rover well memory glitch
0,3,1,57,1,9,2,58,0,"definitive, scientific answer 20 health question everyone"
0,2,15,51,2,15,5,66,0,"india injects r 20,000 crore urgent arm deals, want keep force ready war"
0,3,1,47,0,7,0,48,0,arkansas conduct first execution nearly dozen year
0,2,3,49,0,9,0,52,0,pakistan singer atif aslam stop show rescue harassed girl
0,2,13,67,2,14,0,80,0,"three suicide bomber strike saudi arabia, one near muslim pilgrimage site medina breitbart"
0,1,3,52,1,10,1,55,0,somali pirate demand $2 million ransom u captain held hostage
0,3,1,49,2,9,0,50,0,turkey vote expand president's powers; critic cry fraud
0,3,1,48,0,7,0,49,0,hungary put migrant converted shipping container
0,2,9,45,2,8,0,54,0,weak federal power could limit trump climate-policy rollback
0,1,2,25,0,5,4,27,0,2008 olympic torch arrives london
0,3,8,36,1,9,2,44,0,new year's attack packed istanbul club leaf 39 dead
0,3,6,48,2,9,0,54,0,trump aide sean spicer question u.s. response russian hacking
0,2,7,34,1,6,0,41,0,study: drug use among saudi teenager skyrocket
0,3,3,62,5,12,0,65,0,far right turned muslim woman monster online. thats despicable.
0,1,3,50,2,10,0,53,0,eu regulation prevents sale 'small' kiwi fruit bristol shop
0,3,4,57,1,12,0,61,0,first-time vr user open new reality christmas start freaking
0,2,15,48,3,12,0,63,0,drunk men yelling donald trump attempt remove woman hijab nycsubway
0,2,5,59,0,8,0,64,0,nicola sturgeon say margaret thatcher inspired scottish nationalism
0,2,8,39,0,7,0,47,0,study build argument infection may cause autism
0,2,11,54,2,13,4,65,0,grammys return los angeles' staple center 2018 new york show: exclusive
0,2,5,57,4,12,0,62,0,lavar ball claim 'would kill michael jordan one-on-one' back heyday
0,2,9,45,0,8,0,54,0,trump aide steve bannon removed national security council
0,3,2,83,4,20,0,85,0,"'i told men abusers, woman victims': two male rape survivor battle heard"
0,1,3,42,0,7,0,45,0,two nuclear submarine collide atlantic ocean
0,3,15,60,4,15,0,75,0,chaffetz flynn's 'story tell': congress give immunity amid fbi probe insider
0,2,1,49,2,9,0,50,0,ohio prison inmate 'built computer hid ceiling'
0,2,2,65,3,11,0,67,0,britain surveillance agency slap claim involved trump wiretap
0,3,2,58,1,10,0,60,0,dallas office shooting: man fatally shoot bos killing
0,2,4,82,1,13,0,86,0,men quietly losing weight-loss battle focus remains woman featured story additional story
0,2,9,40,4,10,0,49,0,lorde best 'green light'? vote favorite!
0,3,4,55,4,11,0,59,0,luke walton: 'frustrating' effort team worst loss lakers' history
0,1,6,44,0,8,0,50,0,helicopter crash kill sixteen nato base afghanistan
0,1,1,57,1,7,0,58,0,australian refugee activist plan protest minister's speech
0,3,5,46,5,11,0,51,0,whats future roe v. wade trump administration? [video]
0,1,7,25,3,6,0,32,0,"america summit, leader press u.s."
0,2,3,39,3,8,0,42,0,'orange new black' cast rock red-carpet look
0,1,6,28,2,7,3,34,0,time co. raise $225 million building deal
0,1,9,46,0,11,0,55,0,expert watch sign obama move appeal court left
0,3,3,27,0,6,0,30,0,tony romo released onthursday
0,3,3,54,0,12,0,57,0,need know susan rice unmasking controversy
0,3,4,50,0,10,0,54,0,stowaway snake fly brisbane new zealand private jet
0,3,14,58,1,12,0,72,0,northwestern mutualvoice: take finance next level money rule
0,3,11,35,2,9,0,46,0,obama say america ok final press conference
0,1,6,49,4,12,2,55,0,"actor john fiedler, voice piglet ""bob newhart"" regular, dead 80"
0,2,14,65,3,13,0,79,0,police investigating photo officer laughing muslim mother hijab rippedoff
0,1,3,59,1,8,0,62,0,bernie ecclestone attacked outside london headquarters; arrest made
0,1,3,11,1,3,2,14,0,sun unveils java 6.0
0,1,5,47,0,10,0,52,0,sandra fluke nominated time magazine person year
0,2,4,40,1,9,0,44,0,ed sheeran's new brit award emoji damn adorable
0,2,7,32,1,10,0,39,0,"men higher rate hpv women, cdc say"
0,1,9,37,0,10,0,46,0,john maine latest mets starter shaky outing
0,1,5,34,0,7,0,39,0,brazil threatens break patent aid drug
0,1,2,66,0,11,0,68,0,australian government welfare recipient forced pay bill
0,3,10,35,2,9,0,45,0,let take look kirsten dunsts engagementring
0,3,10,50,5,10,0,60,0,trump intensifies attack journalist condemns f.b.i. leaker
0,2,6,34,0,6,0,40,0,conservative learn gary johnson
0,1,3,27,0,5,0,30,0,usa pressure climate talk
0,1,9,40,0,8,0,49,0,detained aid activist phyu phyu thin released myanmar
0,2,2,67,0,15,0,69,0,paris attack put security top agenda two day french election
0,1,10,48,1,10,0,58,0,"book, radomski talk dealing drug dealing mitchell"
0,1,2,45,0,7,0,47,0,nine rescued roof blazing taiwanese skyscraper
0,1,3,39,0,6,0,42,0,un report rwandan refugee repatriated force
0,1,3,29,0,7,0,32,0,man becomes first swim north pole
0,3,1,47,3,7,0,48,0,voice control finally started speaking language?
0,3,3,59,0,11,0,62,0,trump cited nonexistent incident sweden rally saturday
0,3,12,60,0,15,0,72,0,nick kroll john mulaney slam mel gibson steve bannon indie spirit award
0,1,8,53,0,12,0,61,0,shoe thrown chinese pm speech cambridge university uk
0,2,3,41,2,8,0,44,0,u.s. new talk venezuela amid worsening crisis
0,2,8,39,0,9,4,47,0,meryl streep slam donald trump golden globe 2017 speech
0,1,7,36,0,7,0,43,0,gowanus canal brooklyn may get superfund status
0,3,7,45,2,9,0,52,0,ufc president dana white think ronda rousey 'probably done'
0,2,10,34,0,9,0,44,0,keystone pipeline risky bet higher oil price
0,3,1,59,3,10,1,60,0,"mich. man accused fatally stabbing stepdaughter, 5; setting body aflame"
0,2,8,44,1,9,2,52,0,oscar pistorius likely leave prison august 21: official
0,3,4,45,1,10,0,49,0,"bbc focus middle aged middle class, say ofcom chief"
0,2,3,81,3,12,0,84,0,"university speak trump travel ban, commit defending international student [video]"
0,1,3,36,0,6,0,39,0,julian assange held sweden appeal bail
0,2,5,27,1,5,0,32,0,atlantic daily: hacking hatred
0,3,8,31,2,6,0,39,0,woman's epic anti-trump twitter rant go viral
0,3,1,51,0,7,0,52,0,gambian army chief pledge allegiance defeated president
0,2,8,47,3,9,0,55,0,army leaker chelsea manning obamas short list commutation
0,3,2,50,0,8,0,52,0,michigan state suspends coach linked sex abuse complaint
0,1,5,59,1,9,0,64,0,high court strike australian capital territory same-sex marriage law
0,1,2,37,0,7,0,39,0,research motion launch new tablet device
0,1,3,33,1,6,2,36,0,7.4 earthquake strike bonin island japan
0,2,11,54,4,11,2,65,0,wealth snapshot: breaking jared kushner family's $1.8 billion fortune
0,2,3,55,4,11,0,58,0,international women's day: support global strike? video
0,3,2,43,1,7,0,45,0,bill paxton's death certificate reveals heart defect
0,1,3,45,1,7,0,48,0,thousand attend anti-war protest london glasgow
0,2,1,55,1,14,0,56,0,"autism could caused lack protein brain, study find"
0,3,9,61,1,11,0,70,0,"trump overrules tillerson, rejecting elliott abrams deputy secretary state"
0,2,1,58,0,10,0,59,0,adani facing growing pressure fear investor may misled
0,3,5,83,6,16,0,88,0,live 'petulant child' 'protozoan capacity intellect' mp debate withdrawing trump's state visit
0,1,5,32,0,4,0,37,0,exxon mobil shareholder reject proposal
0,3,2,43,1,9,0,45,0,cat v dogs: study reveals pet cost owner
0,1,6,41,1,10,0,47,0,"middling start wang, losing effort yankee"
0,2,5,37,0,8,0,42,0,secret cia effort syria face large funding cut
0,2,3,44,2,9,0,47,0,"u banning kratom, virtually harmless herb?"
0,1,5,60,1,11,4,65,0,"2008 secutech expo start taipei, taiwan grasping global security industry"
0,1,3,26,2,4,0,29,0,foot-and-mouth confirmed uk farm
0,1,8,51,0,8,0,59,0,isiah thomas take coaching job florida international university
0,3,4,41,4,9,0,45,0,joanna trollope: sexist call novel 'aga sagas'
0,1,7,39,0,9,0,46,0,coughlin still waiting make decision burress
0,3,2,53,2,9,3,55,0,republican float health care compromise trump's 100-day mark
0,2,10,54,0,10,0,64,0,ecuador election could determine fate wikileaks founder julian assange
0,1,4,22,0,5,1,26,0,3 body found military crash
0,3,2,69,0,13,4,71,0,ambitious young photographer captured chaos beauty greyhound bus 1943
0,1,4,17,0,3,0,21,0,streaky phil mickelson
0,2,3,63,2,15,0,66,0,obama changed mind wont allow oil drilling atlantic
0,2,1,61,0,8,0,62,0,trump administration signal change policy transgender student
0,1,4,30,0,8,0,34,0,banker point rule problem
0,2,2,75,3,12,0,77,0,"trump national security adviser want avoid term radical islamic terrorism, source say"
0,1,1,38,0,5,0,39,0,mexican helicopter crash leaf soldier dead
0,1,3,31,0,6,2,34,0,portuguese writer jos saramago dy 87
0,3,10,42,4,11,0,52,0,donald trump 'email person' 'knows thing hacking'
0,1,1,41,0,6,0,42,0,russian journalist beaten police officer dy
0,3,2,53,2,8,0,55,0,david bowie terminal cancer diagnosis 'three month death'
0,3,4,61,4,12,0,65,0,company set tough test job applicants: 'convince u james blunt awful'
0,2,6,34,0,6,0,40,0,south korea talk tougher china retaliation
0,2,2,66,0,10,0,68,0,federal government program hope keep medical specialist regional area
0,2,14,49,4,12,0,63,0,"watch alec baldwin pull double duty, interview trump bill o'reilly 'snl'"
0,1,7,36,0,7,0,43,0,marist basketball player find time two dream
0,1,9,38,1,10,0,47,0,red bull let win slip away final minute vs. revolution
0,2,6,52,2,12,0,58,0,guardian view michael flynns resignation: whoop wow
0,1,2,46,0,6,0,48,0,nz opposition leader admits fundamentalist contact
0,2,1,50,1,7,0,51,0,comcast expand streaming service amid cord-cutting trend
0,2,14,52,0,13,0,66,0,every political party france using trump example follower
0,2,5,53,0,10,2,58,0,racing 92 president jacky lorenzetti say stade francais merger
0,1,4,49,1,8,0,53,0,emaar property claim burj dubai world's tallest building
0,2,2,42,1,8,3,44,0,sa heatwave: 100 flying fox die extreme weather
0,1,2,22,0,4,0,24,0,mass graf found lebanon
0,2,5,60,0,11,0,65,0,tough talk penny demilitarized zone separating north south korea
0,3,1,44,0,8,0,45,0,please help u help child refugee survive winter
0,2,3,48,4,12,0,51,0,donald trump promised wipe isi perhaps already ...
0,2,14,52,1,12,0,66,0,"cam newton surgery repair shoulder injury, miss panther otas"
0,2,14,47,2,13,0,61,0,internet today? website lagged didnt load many
0,2,4,41,2,8,0,45,0,cpac sell young conservative 'hip cool' swag
0,1,7,36,0,5,0,43,0,german manufacturer man bribery investigation
0,1,5,32,0,5,0,37,0,industry ignored scientist climate
0,2,2,19,3,4,0,21,0,make trump take time-out
0,2,1,40,1,5,0,41,0,trump foreign policy dangerously impulsive
0,2,4,52,4,9,0,56,0,"u.s. cant ignore russia, increasingly horrendous behavior"
0,3,1,19,2,4,4,20,0,3m report revenue jump 11.3%
0,2,6,27,3,8,4,33,0,katy vs. britney: either redeem pop 2016?
0,3,10,46,1,11,0,56,0,mom fight back cruel meme terminally ill toddler yahoo
0,1,4,35,0,7,0,39,0,reining revelry preakness stake
0,3,20,55,0,14,2,75,0,one indian among 36 isi militant killed america dropped moab afghanistan
0,3,10,50,1,11,0,60,0,"goldman sachs name david solomon, harvey schwartz succeed gary cohn"
0,1,5,47,0,9,4,52,0,coroner find australian prime minister holt drowned 1967
0,2,10,45,3,9,0,55,0,"sen. jeff session blamed culture, guns, columbine massacre"
0,3,8,44,3,9,0,52,0,schaeuble's 'wrong message' barb greece cause spat berlin
0,3,12,53,1,11,0,65,0,judge decline release dreamer swept trump's new deportation wave
0,3,4,36,2,6,0,40,0,detroit lions' late td double sportsbook's loss
0,3,7,62,2,10,0,69,0,thomas gainsborough painting 'the morning walk' slashed twice national gallery
0,2,8,41,0,8,0,49,0,benedict cumberbatch wife sophie hunter baby boy
0,3,4,70,0,15,0,74,0,jeremy corbyn dodge key question use labour party whip brexit vote three time
0,2,6,67,2,16,0,73,0,everything football: best ad super bowl sunday lady gaga happened
0,2,6,34,1,6,0,40,0,calculated rise france emmanuel macron
0,2,4,57,1,11,0,61,0,john clarke's final curtain call last clarke dawe episode released
0,1,7,37,0,6,0,44,0,southern hemisphere rugby trounces north yet
0,2,9,34,1,8,0,43,0,"gunman zurich mosque shooting dead, police say"
0,3,3,12,0,5,4,15,0,best movie 2016
0,1,1,41,2,9,6,42,0,venezuelan economy shrank 5.8% fourth quarter 2009
0,1,5,13,0,2,0,18,0,itms canada launched
0,1,5,47,2,8,0,52,0,syrian official lebanese president accused u.n. report
0,3,3,38,1,8,0,41,0,"trump sow chaos, canada pick piece"
0,3,2,49,1,9,0,51,0,google go uber court self-driving car secret
0,3,10,44,3,11,0,54,0,"mac miller release epic new video ""cinderella"" f/ ty dolla sign"
0,1,10,31,0,9,0,41,0,tv land try spice thing reality show
0,3,2,82,2,13,0,84,0,transgender woman stopped seeing child 'incompatible' jewish faith
0,3,9,42,4,9,0,51,0,"iggy azalea's music video ranked, worst best: critic's pick"
0,3,29,33,2,11,4,62,0,meet youtube millionaires: highest-paid youtube star 2016
0,3,13,38,3,13,0,51,0,"yes, women's march still starting location"
0,2,4,34,1,8,1,38,0,mila kunis ashton kutcher welcome baby no. 2
0,1,3,43,0,6,0,46,0,israeli military launch airstrikes gaza strip
0,3,9,32,1,7,0,41,0,future uber might self-driving mercedes
0,3,6,50,1,12,0,56,0,"donald trump malcolm turnbull speak phone, u deal go ahead"
0,2,19,60,0,16,0,79,0,hyderabad blast prime accused riyaz bhatkal life life luxury karachi thanks isi
0,3,1,50,2,7,0,51,0,"shark-inspired drug may help treat fibrosis, researcher say"
0,3,8,21,1,7,6,29,0,nyc real estate lending dropped 17% 2016
0,2,11,49,6,12,3,60,0,'despicable 3' trailer introduces gru's new villain (and '80s dance moves)
0,1,5,32,0,5,0,37,0,oakland seeking answer police killing
0,3,2,50,0,11,0,52,0,joe biden ended tenure vice president perfect way
0,2,8,42,2,7,0,50,0,melenchon crash front-runner party french risk rise
0,2,5,35,2,8,0,40,0,there catch opec plan cut production
0,2,1,41,1,8,2,42,0,"egypt church bombing kill least 37, injure dozen"
0,2,8,41,0,7,0,49,0,pepsi pull controversial kendall jenner ad outcry
0,1,4,45,0,7,0,49,0,landless worker movement march brasilia protest
0,3,6,34,1,6,0,40,0,ta-nehisi coates creating black superheroes
0,3,3,51,0,10,0,54,0,news limit put place stop tourist ruining angkor sunset
0,2,11,49,1,11,0,60,0,"understand white working class voted trump, see hacksaw ridge"
0,2,9,45,0,13,2,54,0,instagram let make slideshows 10 photo video
0,2,3,54,0,11,0,57,0,sky pull broadcast show cast white actor michael jackson
0,1,9,48,2,10,0,57,0,"coyote attacks, denver suburb turn gun-wielding trapper"
0,2,5,51,5,11,0,56,0,mrk.tv-diese website steht zum verkauf!-informationen zum thema mrk.
0,2,3,32,2,6,2,35,0,symantec acquire lifelock $2.3 billion
0,2,3,48,0,8,2,51,0,study reveals whopping 48m twitter account actually bot
0,1,2,40,0,7,0,42,0,twelve dead suicide bomb attack pakistan
0,1,5,43,3,8,0,48,0,"sit-in washington university, st. louis enters ninth day"
0,3,2,50,1,8,0,52,0,"welcoming migrants, austria taking tougher stance"
0,1,7,24,2,6,0,31,0,u.n. say thousand killed sri lanka
0,1,6,36,0,6,0,42,0,lender challenge delphi plan exit bankruptcy
0,1,8,33,5,9,6,41,0,"2008 tour de taiwan, taispo, taipei cycle: 3-in-1 preview"
0,3,1,53,1,9,0,54,0,high school student sends powerful message simple t-shirt
0,1,8,34,2,7,0,42,0,"new jobless filing fall, long-term claim rise"
0,2,7,43,1,8,0,50,0,parent use retirement saving college tuition?
0,3,4,43,0,8,0,47,0,tinder troll ce pitching regular reality headset
0,1,1,52,2,9,0,53,0,"study: cognitive therapy good medication, last longer"
0,1,5,26,0,5,0,31,0,knicks may lose gallinari season
0,3,8,41,1,10,0,49,0,france's hard left face center left primary
0,1,1,36,0,6,0,37,0,wife missing soldier receives green card
0,1,4,32,1,8,2,36,0,cricket: india beat west indie 16 run
0,3,2,60,0,11,0,62,0,supreme court return case transgender bathroom access lower court
0,1,2,50,0,7,0,52,0,american console sale continue decline throughout april
0,2,6,38,3,6,0,44,0,facebooks sandberg unveils startup garage paris
0,2,10,58,0,9,0,68,0,paul manafort volunteer testify congress amid russia investigation
0,3,21,66,3,17,0,87,0,watch nbc today show excerpt free online hospital throw gatsby-themed prom teen patient yahoo view
0,2,12,60,5,13,0,72,0,judge alex: miami-dade dropping sanctuary status 'harbinger' what's come insider
0,1,2,38,1,7,4,40,0,argentina defeat scotland 21-15 rugby test match
0,2,13,58,2,12,0,71,0,obamas' last white house christmas address reminds u americans' shared value
0,2,5,62,4,14,4,67,0,"trump rally black life matter protests, 2016 year lame re-enactments"
0,3,1,59,0,9,0,60,0,black judge claim discriminated disciplinary panel
0,1,7,37,2,7,1,44,0,daily mail: scotland yard offered menezes family us$1m
0,1,3,35,1,6,0,38,0,f. scott fitzgerald house struck lightning
0,1,3,70,2,9,0,73,0,u.s. government proposes removing yellowstone grizzly endangered specie list
0,2,10,36,3,8,0,46,0,g.o.p. health bill face revolt conservative force
0,1,7,33,1,6,0,40,0,amazon right error tweet-rage twitter
0,3,11,42,0,11,0,53,0,trump week away missing chance reform work visa
0,2,10,47,1,10,2,57,0,official! 45 new city flight connectivity september
0,3,7,38,1,7,0,45,0,watch live: biden delivers address nuclear weapon
0,3,15,46,3,11,0,61,0,"nbc sxsw: meet man behind pope francis's twitter, instagram account"
0,1,1,26,0,5,2,27,0,china school flood claim 91 life
0,1,6,62,2,12,5,68,0,australian rule football: 2010 gippsland football league round 3 morwell v traralgon
0,2,2,50,4,6,0,52,0,democratic tracker fired stalking republicancandidate
0,2,6,25,2,5,0,31,0,polite often get womenkilled
0,1,2,47,0,6,0,49,0,zimbabwe prime minister tsvangirai end cabinet boycott
0,1,5,22,0,4,0,27,0,even forbes pinching penny
0,1,2,22,1,3,0,24,0,hong kong by-election start
0,3,6,57,1,10,2,63,0,f-35 joint strike fighter program concern dismissed lockheed martin bos
0,3,7,33,1,8,0,40,0,"privacy shield seems safe, backup plan"
0,3,2,58,3,11,0,60,0,'mastermind' bangladesh cafe siege shot dead police pre-dawn raid
0,2,6,40,3,9,0,46,0,"lee daniels, queen latifah bring star power foxdrama"
0,2,10,47,0,9,0,57,0,heems awkwafina totally uncensored conversation tawk
0,1,6,46,2,10,0,52,0,american war hero congressman want u.s. troop iraq soon
0,2,4,44,2,10,0,48,0,north korea say ready strike u.s. aircraft carrier
0,2,13,52,2,12,0,65,0,muslim woman swimmer earned right compete 'burkinis' england
0,1,2,42,0,7,0,44,0,mubarak arrested egypt ahead corruption probe
0,3,14,41,3,14,0,55,0,"jeremih drop new track ""i think you"" f/ big sean chris brown"
0,3,3,51,0,11,0,54,0,eu urged clarify state funding mass execution iran
0,1,4,59,1,10,4,63,0,"2009 worst year airlines, say international air transport association"
0,3,8,38,2,8,0,46,0,ubers clash regulator move self-driving car
0,3,3,72,3,14,0,75,0,"beaver walk md. store, find artificial christmas trees, proceeds trash"
0,3,3,63,3,12,0,66,0,same: woman assaulted speaking swahili forgives attacker
0,1,4,52,0,9,0,56,0,body victim typhoon fengshen appear philippine shore
0,2,1,40,6,9,0,41,0,defeating cancer war; moonshot
0,1,5,34,2,6,0,39,0,u.s. senate release version healthcare bill
0,2,1,19,0,7,6,20,0,top 11 song 2016
0,2,2,36,2,4,0,38,0,arkansas execution: judge order post-mortem
0,2,8,45,0,9,4,53,0,jarvis landry predicts dolphin sweep patriot 2017 season
0,1,5,34,0,7,2,39,0,comedian jon stewart host 78th academy award
0,3,12,43,0,11,0,55,0,bunch asian superheroes teaming people areexcited
0,1,8,21,5,4,0,29,0,obama speaks n.a.a.c.p. celebration
0,3,3,37,3,13,5,40,0,9 thing d.c. area weekend march 10-12
0,3,10,33,1,10,0,43,0,bright-eyed talking doll might spy
0,3,7,84,5,17,2,91,0,that's one way induce labour! mother-to-be becomes online sensation pull-up 41 week pregnant
0,1,6,36,0,6,0,42,0,uk mathematician nick higham win frhlich prize
0,1,5,29,0,5,0,34,0,louisville brings syracuse knee
0,2,3,27,1,6,3,30,0,magna carta: still relevant 800 year
0,3,13,36,1,10,0,49,0,lebron james nba star really hate steph curry?
0,2,15,51,3,16,3,66,0,memo steven mnuchin: trump's tax plan would add $7 trillion debt 10 year
0,3,6,63,3,10,0,69,0,deploraball celebrate victory media-bashing trump national press club
0,3,17,50,1,14,1,67,0,"2 year sanskrit education, compulsory board exam new face cbse"
0,1,9,40,0,8,0,49,0,angel mccoughtry lead louisville first final four
0,3,7,39,1,8,0,46,0,morgan stanley exploring move manhattan west side
0,3,13,34,2,13,4,47,0,new car could required 'talk' soon 2020
0,3,2,43,1,10,5,45,0,report: least 368 youth gymnast abused last 20 year
0,2,2,53,0,11,0,55,0,spacex successfully landed rocket barge ocean
0,1,3,36,0,8,0,39,0,world leader react death osama bin laden
0,3,1,43,0,8,0,44,0,israeli nurse dy set alight patient
0,2,7,68,6,13,0,75,0,"rajon rondo rip jimmy butler, dwyane wade: 'if anything questionable, leadership'"
0,3,11,51,3,13,0,62,0,"fake u embassy ghana operated 'about decade,' state department say"
0,2,1,46,1,5,0,47,0,"kentucky abortion bill signed, effective immediately"
0,3,5,26,1,5,1,31,0,5 thing china-taiwan relation
0,3,12,32,0,9,0,44,0,fight cfpb chief heat democrat fire back
0,2,16,41,3,12,0,57,0,president trump told cia u.s. stolen iraq's oil
0,3,12,57,2,11,0,69,0,swiss affiliate led thursday's federal raid caterpillar's headquarters
0,1,3,48,1,7,0,51,0,afghanistan: suicide attacker kill several people kabul
0,3,1,49,1,10,0,50,0,obese father may harm child ability make friend
0,1,5,31,0,6,0,36,0,pakistan taliban battling key city
0,3,3,67,5,12,1,70,0,"sydney high school student show martin shkreli, recreating price-hiked pill $2"
0,1,2,48,0,6,0,50,0,france confirms deportation illegal afghan immigrant
0,3,1,41,1,11,4,42,0,biden say could've ran president 2016
0,3,4,29,2,5,2,33,0,axa participates insurtech's $20m round
0,1,1,33,1,4,0,34,0,australia proposes new anti-terror law
0,1,8,39,1,10,0,47,0,"election loom japan, easy answer winner"
0,1,6,34,1,5,0,40,0,"microsoft office dropped massachusetts, usa"
0,3,2,31,4,7,2,33,0,u.s. economy grew strong 3.5% third quarter
0,3,1,60,3,11,0,61,0,unroll.me head 'heartbroken' user found sell inbox data
0,3,4,60,2,11,0,64,0,queen elizabeth forced miss christmas day church service 'heavy cold'
0,3,12,42,0,10,0,54,0,fbi say gymnastics doctor larry nassar recorded abuse go pro
0,1,5,38,1,9,2,43,0,"bobby murcer, former new york yankee player dead 62"
0,1,3,73,2,9,0,76,0,"televangelist pat robertson compare same-sex marriage child molestation, pedophilia"
0,2,7,34,2,7,0,41,0,"kendrick lamar drop video new single ""humble"""
0,1,3,52,2,9,0,55,0,"school edinburgh, scotland sealed off; put radioactive alert"
0,2,8,60,1,9,0,68,0,nothing redeem ruined reputation trump republican collaborator
0,2,1,56,3,9,0,57,0,trump sign executive order help remove 'job-killing regulations'
0,1,6,39,0,6,0,45,0,british regulator criticizes culture bank board
0,2,3,35,3,9,0,38,0,yoga? asked google here answer
0,3,4,50,6,10,0,54,0,stephen colbert rip apart 'trumpcare' plan: 'we're gonna die'
0,1,2,32,0,5,0,34,0,three killed tennessee vehicle crash
0,1,1,42,1,7,3,43,0,obama sign healthcare bill 9/11 emergency worker
0,3,10,37,3,9,0,47,0,wind power get leg-up biggest u.s. electricity market
0,2,8,47,2,9,0,55,0,poll show huge opposition ryancares medicaid cut breitbart
0,2,5,45,3,10,0,50,0,aleppo battle: raid syria city 'probably war crime' un say
0,1,2,22,1,2,0,24,0,strauss-kahn case dismissed
0,3,1,43,2,9,0,44,0,"eternime want live forever digital ""ghost"""
0,1,8,39,0,11,2,47,0,swine flu confirmed 67 cadet air force academy
0,1,3,38,2,7,1,41,0,"4 year-old suspended kindergarten texas, u"
0,3,1,46,1,7,0,47,0,nike finally release plus-size clothing line woman
0,3,16,62,2,14,0,78,0,"expected, virender sehwag randeep hooda join troll du's gurmehar kaur"
0,2,9,48,0,10,0,57,0,sounder reserve player get red card kicking opponent groin
0,1,4,23,0,5,0,27,0,taking wheel toyota skid
0,2,10,37,1,9,0,47,0,trump's tax reform plan worsen trade deficit
0,2,9,52,5,10,0,61,0,"california today: lawmaker silencing, cry persisted"
0,3,5,55,1,9,0,60,0,nick kyrgios court controversy abusive donald trump t-shirt
0,1,5,24,1,5,2,29,0,17-point play waved california
0,2,9,25,1,8,0,34,0,youve never met prom queen like one
0,3,17,62,4,15,0,79,0,"pakistani journalist aamir liaquat go nuts, say pm modi, ajit doval behind om puri's death."
0,1,6,32,0,7,0,38,0,france open first military base gulf
0,1,3,48,2,8,0,51,0,"bomb explodes central athens, greece; injury reported"
0,1,10,51,0,11,0,61,0,formula one running final race legendary silverstone track
0,2,4,42,0,8,0,46,0,electoral college voting unfold monday
0,2,11,47,5,8,0,58,0,mlk's daughter praise meryl streep's speech trump's 'disrespect'
0,3,4,52,0,10,0,56,0,marine le pen establishes lead first round french election poll
0,3,9,34,0,8,0,43,0,red state home luring young blue buyer inland
0,1,3,40,2,6,0,43,0,canada considers trade retaliation u.s.
0,3,4,48,2,8,0,52,0,donald trump brand democrat hypocrite russian link
0,3,7,84,3,15,0,91,0,sean spicer say british intelligence could involved barack obama's 'wiretapping trump tower'
0,2,3,38,0,8,0,41,0,trump aide lash freedom caucus lawmaker
0,3,10,51,6,11,0,61,0,"skillet upcoming tour, 'feel invincible' success new 'classic rock' sound"
0,2,5,45,1,9,0,50,0,inside mosul: resident recount took life
0,2,12,54,4,11,0,66,0,smuggler use uber-registered driver move migrant u.s. border breitbart
0,1,3,51,1,8,0,54,0,myanmar criticised hampering aid; un resume relief effort
0,3,15,53,1,14,0,68,0,twitter think american girl new boy doll look like hipster ghost
0,2,3,13,1,2,0,16,0,obamas last lament
0,1,5,39,0,7,0,44,0,twitter popular myspace united kingdom
0,2,1,42,2,7,0,43,0,"teen escape father's killing rampage, call police"
0,1,1,41,1,7,0,42,0,market rally world's central bank infuse cash
0,3,1,59,0,10,0,60,0,democrat open border security money avoid funding standoff
0,2,5,66,0,13,0,71,0,rebecca ferguson say play trump inauguration sing strange fruit
0,1,8,29,1,9,1,37,0,2 money manager held new wall st. fraud case
0,2,2,39,0,8,0,41,0,south korea show world democracy done
0,2,2,56,1,10,0,58,0,"tourist strip, sacred mountain shake malaysia get angry"
0,2,9,55,2,9,2,64,0,"jahlil okafor trade rumors: latest news, speculation surrounding 76ers center"
0,1,5,25,1,4,0,30,0,stake high armenia-turkey talk
0,1,2,27,0,7,2,29,0,least 41 killed bombing iraq
0,3,11,40,0,11,4,51,0,con ed settle new york fatal 2014 east harlem explosion
0,1,7,35,2,8,0,42,0,"rodriguez offer apology, whole truth?"
0,2,1,54,0,7,0,55,0,caring grandchild linked surprising health benefit
0,3,6,31,1,9,1,37,0,florence machine first no. 1 album
0,2,4,33,2,8,2,37,0,"walking dead season 7: 8 episodes, ranked"
0,3,9,44,1,12,0,53,0,"chicago, witness violence turn first aid save life"
0,2,1,32,0,7,0,33,0,astronaut set spend one year space
0,2,1,36,1,8,0,37,0,congress avoided shutdown one week
0,1,6,31,0,5,0,37,0,smartphone debut help palm beat estimate
0,3,5,13,0,3,0,18,0,trump demotes aba
0,2,12,51,3,12,0,63,0,robot deliver food near futureheres theyll look like
0,1,3,53,1,9,0,56,0,olympic gold medalist evan lysacek get hero's welcome hometown
0,3,9,32,4,9,0,41,0,"watch wale's new video ""running back"" f/ lil wayne"
0,3,3,48,0,10,0,51,0,sunshine bringing radio remote part south sudan
0,1,7,36,0,10,1,43,0,3 beijing set car fire apparent protest
0,2,5,20,0,5,2,25,0,singer george michael dy at53
0,1,7,37,0,9,0,44,0,textile capital china hobbled downturn
0,2,3,49,0,9,0,52,0,filipino troop kill notorious abu sayyaf kidnapper clash
0,2,3,39,3,8,0,42,0,trump's 'irish proverb' appears nigerian poem
0,2,9,40,4,9,2,49,0,"kanye west settle $2.5 million lawsuit ""new slaves"" sample"
0,2,9,41,0,12,0,50,0,swiss police ready blast drone sky davos
0,3,3,63,0,9,0,66,0,crosscountry allows passenger change advance ticket without paying fee
0,3,2,34,1,6,4,36,0,eurovision 2017: organising team quits en masse
0,2,9,44,0,10,0,53,0,uaw asks volkswagen accept nlrb order tennessee plant row
0,1,4,62,1,10,2,66,0,two winning british euromillions lottery ticket worth 45 million claimed
0,2,14,41,6,11,0,55,0,steve king: nikki haley could face gop shes beautiful
0,2,1,50,0,10,0,51,0,california police use fire hose man fatal shooting
0,1,3,51,0,9,0,54,0,irish government sends team official hunt journalist
0,1,8,28,3,5,0,36,0,canada drop w.t.o. complaint europe
0,3,15,51,4,13,2,66,0,"sweet gesture, mumbai cop surprise 83-year-old woman birthday cake!"
0,3,6,57,4,14,0,63,0,watch 'shark tank' star kevin oleary cook creative deal toy company
0,2,4,45,2,7,0,49,0,mlb spring training unnecessarily long. blame pitchers.
0,3,14,48,1,12,1,62,0,sun pg eric bledsoe unloads 1-handed dunk nugget f kenneth faried
0,3,2,41,0,7,0,43,0,syrian rebel begin evacuation besieged homs
0,3,3,42,1,11,2,45,0,april giraffe ny calf 1.2 million online
0,3,3,69,5,14,0,72,0,"chilling: serial animal killer may loose canada, mutilating pets, wildlife"
0,2,8,51,1,10,1,59,0,"latavius murray, viking agree contract 4 season raider"
0,1,3,46,0,6,0,49,0,canadian conservative vow defend arctic sovereignty
0,3,2,87,5,19,2,89,0,"model, 22, dy heart attack undergoing liposuction guatemala surgeon 'vanished'"
0,3,7,36,2,9,4,43,0,'mean girls' musical track fall 2017 world premiere
0,3,7,31,1,8,3,38,0,"9 dead, 20 missing fire engulfs oakland rave"
0,1,3,33,0,5,0,36,0,oil spill spotted along mississippi river
0,1,5,47,0,7,0,52,0,funeral held former zambian president frederick chiluba
0,1,2,46,0,7,0,48,0,gunman charged killing three wisconsin shooting
0,1,6,32,1,6,0,38,0,football: fulham fc sack coach chris coleman
0,2,5,45,2,12,0,50,0,sampha run jewels: week best uk rock pop gig
0,2,3,39,1,8,0,42,0,reclusive designer met gala nextmuse
0,3,1,60,1,9,0,61,0,"rare whale captured video, sparking curiosity mysterious specie"
0,3,10,46,2,9,2,56,0,13-year-old entrepreneur changing face business detroit
0,3,5,47,1,9,0,52,0,rick perry criticizes election gay texas a&m student leader
0,3,10,49,3,10,0,59,0,"border officer nearly double search electronic devices, u.s. say"
0,1,8,44,0,11,1,52,0,pick protocol post corrects failure file tax 2 year
0,3,5,23,3,4,0,28,0,stream drake's 'more life' playlist
0,1,5,34,0,4,0,39,0,zimbabwe opposition party official arrested
0,3,7,38,2,7,0,45,0,montblanc launched smartwatch. here matter
0,3,2,41,0,10,0,43,0,man space suit message earthling
0,1,10,37,3,8,0,47,0,s.e.c. face fresh scrutiny trading inquiry lehman
0,3,7,45,0,9,0,52,0,police charge suspect stabbing death nursing student
0,3,2,44,2,7,0,46,0,'russia hacking code' found vermont utility computer
0,1,3,43,0,9,0,46,0,new horizon probe bound pluto nine year journey
0,1,3,43,1,8,0,46,0,u drone strike kill eight pakistan's tribal region
0,1,5,29,0,5,0,34,0,ask bailout unconstitutional
0,3,8,36,2,8,0,44,0,traveler stopped transit u.s. trump order
0,2,1,41,1,10,4,42,0,"man jailed 1957 murder freed, granted newtrial"
0,3,4,71,1,15,0,75,0,buried box photo reveals jewish photographer's chronicle life lodz ghetto
0,3,9,41,2,9,0,50,0,'barack obama day' could newest illinois state holiday
0,1,4,34,0,4,0,38,0,rabobank contacted doping investigator
0,3,7,43,1,7,0,50,0,"amazon discloses iranian business ties, warns penalty"
0,2,8,37,5,10,0,45,0,watch joey bada$$' powerful new video 'land free'
0,2,15,67,3,14,1,82,0,'crazy ex-girlfriend' star rachel bloom break four standout song new season 2 soundtrack
0,1,3,36,1,6,0,39,0,"two dead earthquake strike ktahya, turkey"
0,2,8,49,0,8,0,57,0,trump plan technology conference silicon valley executive
0,1,5,25,0,4,0,30,0,reported zimbabwe deal disputed
0,2,8,42,2,9,0,50,0,dwyane wade injury: update bull star's wrist return
0,1,5,46,0,9,0,51,0,one dead super typhoon megi make landfall philippine
0,2,13,42,3,13,4,55,0,'fearless girl' statue stay wall street till 2018 women's day
0,2,3,57,1,10,0,60,0,first amendment controversy brew texas high school's prayer room
0,1,1,32,0,4,0,33,0,google announces new operating system
0,2,3,81,3,19,0,84,0,'they going lie down': boxing day hunt crowd remain strong amid fight scrap fox hunting ban
0,2,1,63,0,12,0,64,0,tech company must avoid using mineral tainted right abuse
0,1,4,44,0,8,0,48,0,baghdad tv station shut showing saddam mourner
0,3,10,31,2,8,0,41,0,saudi know u.s. power bring lasting peace
0,2,2,15,3,1,0,17,0,everythings rigged
0,3,2,51,1,6,0,53,0,youtube restores influential conservative website's channel
0,1,3,40,0,7,0,43,0,olympic flame beijing game lit amidst protest
0,1,6,57,0,10,4,63,0,athlete prepare 2012 summer paralympics paralympic fitness centre
0,3,5,49,1,10,1,54,0,"6 shot mount vernon, new york nightclub early christmas morning"
0,1,3,32,0,6,0,35,0,mobile ringtone top uk single chart
0,1,1,19,0,2,0,20,0,polaroid go bankrupt
0,1,6,34,1,6,0,40,0,change union may re-energize hollywood talk
0,3,12,71,4,15,0,83,0,juan gabriel hologram debut tribute concert mexico: 'what we've put together unbelievable'
0,2,2,54,3,10,0,56,0,official say cuomos tuition catch try deter freeloader
0,3,9,43,2,9,0,52,0,"trump, citing evidence, suggests susan rice committed crime"
0,1,3,24,0,3,0,27,0,england remembers bobby robson
0,3,2,66,1,10,0,68,0,"multiple fatality reported church bus crash texas, authority say"
0,2,2,27,0,5,0,29,0,fire florida mosque ruled arson
0,2,9,41,1,12,2,50,0,suicide bombing kill least 20 somalia new york time
0,1,5,26,0,4,0,31,0,nato expand afghanistan presence
0,1,4,14,0,4,0,18,0,night frozen time
0,1,1,52,0,8,0,53,0,paris rail terminus temporarily shut unplanned strike
0,3,5,43,2,10,0,48,0,u military drop 'mother bomb is' afghanistan
0,2,2,49,0,11,0,51,0,rise new case show ebola released deadly grip
0,1,1,24,0,4,0,25,0,global market surge value
0,3,5,23,0,5,0,28,0,bitcoin escapist safe
0,3,4,63,3,16,5,67,0,"chief investment officer $490 billion fund manager trump, dow 20k, big data"
0,3,2,55,2,12,2,57,0,pat eddery snub four child leave 1.3m estate stable girl lover
0,1,8,35,4,10,0,43,0,"first, awful year mutual funds. now, tax bill."
0,1,3,21,0,3,0,24,0,japan weather typhoon nabi
0,2,12,67,2,11,0,79,0,focusing women's advancement blind company real problem: overworking everyone
0,2,9,40,0,10,0,49,0,mark hamill returned joker read trump tweet
0,1,9,55,2,12,0,64,0,"military planners, nod obama, preparing faster iraq withdrawal"
0,3,5,45,0,8,0,50,0,german prosecutor say convicted isi member hid killing
0,2,3,42,0,8,0,45,0,indian engineer named saddam hussain cannot get job
0,2,5,57,5,13,0,62,0,penny said michael flynn jr. involvement transition. did.
0,2,9,44,2,9,0,53,0,donald trump: wont let politician disarm american people
0,1,5,30,0,6,0,35,0,delphi talk emerge bankruptcy
0,2,5,52,3,8,0,57,0,quentin tarantino remembers reservoir dogs: 'i counted walkouts'
0,1,6,27,0,6,0,33,0,wall street falter late trading day
0,3,6,29,0,6,0,35,0,campus rapist repeat offender
0,1,5,25,1,5,1,30,0,"storm cut midwest, killing 5"
0,2,3,60,1,8,0,63,0,washington-area clinic carafem barred advertising metro station
0,2,3,53,0,11,0,56,0,u launch strike syria air base chemical weapon attack
0,3,16,40,3,13,0,56,0,"listen: there's new, pc remix classic christmas song insider"
0,2,4,28,1,6,0,32,0,elon musk spacex nail landing sea
0,2,11,57,2,13,0,68,0,portrait cuba president lebanon: week global-affairs writing
0,2,9,43,1,9,0,52,0,"fitbit aim hook consumer news feed, new partnership"
0,1,4,62,0,9,0,66,0,u supreme court relaxes strict interpretation self incrimination ruling
0,1,3,31,0,6,0,34,0,suspect charged murder lauren burk
0,1,7,32,0,7,0,39,0,palestinian rival say attacked hamas
0,1,2,55,1,6,0,57,0,texas executes mexican-born killer despite international appeal
0,3,13,61,3,13,0,74,0,panteon rococo antidoping cancel l.a. skanking reggae fest appearance due visa issue
0,3,7,44,0,8,0,51,0,trump name michael glassner oversee campaign committee
0,3,8,33,0,9,0,41,0,donald trump museum could open atlantic city
0,3,15,59,3,15,2,74,0,"bengaluru engineer begin testing give india first jet engine, it'll take 24 weeks!"
0,3,3,62,0,11,0,65,0,white house lot alternative fact troublesome former adviser
0,3,4,55,1,11,0,59,0,oil price hit one-month high u launch missile strike syria
0,1,4,49,0,7,0,53,0,comprehensive immigration bill fails united state senate
0,2,3,53,0,10,0,56,0,justice department asks appeal court restore trump travel ban
0,2,1,49,1,9,0,50,0,ohio fetal heartbeat abortion bill head governor's desk
0,1,5,31,1,9,0,36,0,"gene hereford, essence cow"
0,2,3,41,3,10,0,44,0,first trailer next 'star wars' movie here!
0,3,18,33,0,8,0,51,0,partynextdoor tweeted deleted response nicki minaj
0,3,3,62,5,14,0,65,0,"mysterious hedge maze 's-town' falling apart, sad handle"
0,1,1,35,0,4,0,36,0,turkish shopkeeper save falling toddler
0,2,3,50,2,9,0,53,0,u.s. try stop feuding ally unraveling syria strategy
0,3,5,27,0,6,0,32,0,columbia unearths tie slavery
0,3,10,31,0,9,0,41,0,bernie sander plan win back trump voter
0,2,13,40,3,12,0,53,0,want wicket smart? there app cricket many rule
0,1,5,31,0,6,0,36,0,president poland sanguine economy
0,3,9,34,1,11,5,43,0,"ed sheeran stay atop hot 100, clean bandit bound top 10"
0,2,2,37,2,6,0,39,0,boeing's iran deal prevent production cut
0,3,5,50,0,10,0,55,0,naacp move ahead call moratorium charter school
0,3,14,51,2,13,0,65,0,trump honeymoon over: market scared promise wont come true
0,2,3,38,1,7,4,41,0,international womens day 2016 take gender parity
0,1,1,42,1,7,0,43,0,canada revisit same-sex marriage issue next week
0,2,2,61,0,14,0,63,0,judge rule keep virginia man jail trial aiding terror charge
0,1,2,24,0,3,0,26,0,russia withdraws georgia
0,3,4,13,0,3,0,17,0,best new fiction
0,1,1,39,0,7,2,40,0,30 people die bombing northwestern pakistan
0,3,12,73,2,16,0,85,0,"standing straight could treat depression, study claims: posture direct impact mood"
0,3,3,45,2,6,0,48,0,ex-navy secretary: facebook group scandal inexcusable
0,3,11,48,1,11,0,59,0,facebook's new feature make timeline way colorful
0,2,8,40,2,8,0,48,0,cnns wolf blitzer grill mike penny trump birtherism
0,1,7,33,1,9,0,40,0,"hot day, dash spice palmer invitational"
0,2,2,47,1,9,0,49,0,fearless florida diver pull metal hook shark's belly
0,3,10,38,0,10,0,48,0,trump presides first white house easter egg roll
0,2,13,37,4,11,0,50,0,umg's deal spotify: grainge ek (finally) got done
0,3,6,43,1,10,0,49,0,"afghanistan want u help fight taliban,"
0,2,4,37,1,5,0,41,0,homeland security targeting dreamers: kelly
0,3,2,36,2,7,4,38,0,snake: play classic nokia 3310 time-waster
0,2,5,49,2,6,0,54,0,palmer luckey: trump-supporting oculus founder leaf facebook
0,3,10,41,4,12,0,51,0,mary j. blige share 'strength woman' release date cover art
0,3,1,48,1,8,0,49,0,"elephant herd attack group park employees, killing one"
0,1,6,69,2,10,0,75,0,"wikinews interview donald k. allen, independent candidate u presidential election"
0,3,13,47,5,12,2,60,0,"bol bol, manute bol's 17-year-old son, dominates mater dei high school debut"
0,1,3,40,0,5,0,43,0,malaysian home ministry ban approved documentary
0,3,8,58,1,8,0,66,0,aldon smith's involvement domestic violence incident investigation
0,3,2,45,3,8,2,47,0,tooth infection lead 26-year-old california dad's death
0,1,6,62,0,11,0,68,0,department defense report lambasts communication failure u war terror
0,3,3,45,3,8,4,48,0,"child suffer lead poisoning 3,000 u.s. neighborhood"
0,1,5,27,0,5,1,32,0,federal regulator close 3 small bank
0,1,4,52,2,11,0,56,0,argentina: tv channel taken air mendoza rival request
0,2,14,67,3,16,0,81,0,"pop shop podcast: martin garrix music taking around world, plus grammy nomination"
0,1,4,25,0,6,0,29,0,curlin repeat horse year
0,3,4,66,1,11,0,70,0,fiji floods: flood threat continues major concern rewa river community
0,1,3,41,0,6,1,44,0,microsoft release window phone 7 manufacturing
0,1,7,41,0,6,0,48,0,atomic agency examines candidate replace elbaradei
0,1,6,35,1,8,0,41,0,"sensational crime, trial marked quiet"
0,3,9,25,0,8,2,34,0,former sara lee ceo brenda barnes dy 63
0,1,5,53,3,11,0,58,0,china: 'the dalai lama scheming take beijing olympics hostage'
0,1,3,33,0,7,0,36,0,north south korea hold second summit
0,2,10,41,2,12,2,51,0,"one nation, fox: 18 hour network shape america"
0,3,3,80,2,14,0,83,0,queen thanks military helped bring 'peace' iraq afghanistan national memorial service
0,2,9,47,6,11,0,56,0,"today, acted like politician: voter reaction trump speech"
0,2,11,38,0,11,0,49,0,le pen win woman voter feel left behind france
0,1,3,38,0,6,0,41,0,obama support middle east protester speech
0,3,9,32,1,7,0,41,0,haley: un constantly bias israel
0,3,12,59,0,12,0,71,0,two people poisoned drinking herbal tea chinatown store san francisco
0,1,2,19,0,4,0,21,0,heat get worse canada
0,3,15,59,3,14,0,74,0,trailer out! salman khan give bollywood tadka animated movie 'hanuman da damdaar'
0,2,8,58,1,11,0,66,0,"coming election, netherlands considers new relationship muslim"
0,2,10,55,1,11,0,65,0,"autistic woman kept backyard cage forced prostitution, say police"
0,2,12,36,3,9,4,48,0,2017 nfl draft big board: matt miller's post-super bowl ranking
0,3,6,26,5,7,0,32,0,moonlight: year best movie?
0,1,7,38,0,6,0,45,0,american woman freed philippine abduction
0,2,8,36,4,11,0,44,0,"review: come away, canadian embrace grim day"
0,1,6,43,0,11,0,49,0,new zealand mp present state funeral gerald ford
0,2,11,39,0,13,0,50,0,amber rose new owner ace diamond strip club la
0,3,9,40,2,8,4,49,0,natural gas 2016s best-performing commodity amid cold blast
0,3,7,57,2,11,0,64,0,us-backed force syria isolated isis's last stronghold country
0,1,2,63,0,9,0,65,0,four british energy supplier face investigation claim misselling
0,2,3,51,0,11,0,54,0,obama trade push run aground house democrat derail key bill
0,3,4,37,0,9,0,41,0,james corden goal host grammy award
0,1,2,40,1,7,0,42,0,"militants, pirate may fight saudi oil tanker"
0,1,2,36,3,7,2,38,0,"shelby foote, 88, noted historian author, dy"
0,1,7,28,1,6,0,35,0,south korea keep record-low rate hold
0,1,4,31,0,5,0,35,0,spanish airline lte suspends flight
0,1,8,41,2,8,2,49,0,express script buy wellpoint pharmacy unit $4.7 billion
0,3,4,50,1,6,0,54,0,sartorial inspiration star #christmasjumperday
0,2,11,46,2,10,0,57,0,forest official watch 'fox jallikattu' organised tamil nadu
0,3,10,54,1,10,0,64,0,patrick patterson prank raptor teammate post-it note car
0,2,5,57,3,10,0,62,0,k.j. lawson apologizes profane comment directed ex-coach tubby smith
0,3,2,64,1,11,0,66,0,french citizen vote uncertain race could determine europe future
0,2,15,43,7,13,0,58,0,dunking no-names? n.b.a. fan havent minded yet new york time
0,2,7,36,5,8,0,43,0,"china xi mar-a-lago, trump forget taiwan?"
0,1,6,40,0,8,0,46,0,report outline high life advocate avocadoes
0,3,6,50,2,12,0,56,0,arrest 'dreamer' immigrant could first trump defy daca
0,2,11,47,3,10,0,58,0,"carmelo anthony say trade rumors, knicks losing 'testing will'"
0,3,3,55,3,9,0,58,0,"carnival princess cruise pay record fine pollution, cover-up"
0,2,12,64,2,14,0,76,0,pat buchanan: trump still win republican come together defeat hillary breitbart
0,2,7,37,3,7,0,44,0,post malone announces new album 'beerbongs bentleys'
0,3,6,65,2,13,2,71,0,watch 81-year-old retired educator rap lgbtq right city council meeting
0,2,4,52,1,11,0,56,0,trump face major diplomatic test summit china's xi jinping
0,2,1,38,1,5,0,39,0,hawaii see spike brain-infecting parasite
0,1,3,30,1,5,0,33,0,new yorker's obama cover spark outrage
0,1,8,29,1,8,2,37,0,depaul edge no. 21 rutgers strong finish
0,2,2,35,2,7,4,37,0,tube strike 2017: service affected?
0,2,7,67,0,16,0,74,0,ceo arconic stepped ugly battle hedge fund titan paul singer
0,1,5,28,0,6,0,33,0,usa upset canada olympic ice hockey
0,3,17,63,3,16,0,80,0,"order discourage cash transactions, bank revise charges. here much pay"
0,3,11,57,2,11,2,68,0,exclusive: actress jane fonda list modernist beverly hill mansion $13 million
0,2,2,79,2,15,0,81,0,ethiopia boast economic progress. body count garbage dump tell another story.
0,1,2,40,0,9,3,42,0,200 skier trapped lift break maine resort
0,1,3,36,0,6,0,39,0,u official warns hezbollah missile threat
0,3,1,65,1,16,0,66,0,zoo prison animal one need see depressed penguin flesh
0,3,9,41,1,8,0,50,0,trump push help small-town worker leaf farmer behind
0,2,10,42,0,11,0,52,0,lesson trump health care may come danish guest
0,1,6,29,0,7,0,35,0,brandon jennings slow start italy
0,3,4,52,2,13,0,56,0,used shame people buying fake christmas trees. one.
0,2,2,60,1,12,0,62,0,navy commodore relieved command iran capture sailor
0,3,7,39,1,8,0,46,0,prince's revolution hit road memorial tour
0,1,1,52,0,9,0,53,0,canadian victim terrorism able sue perpetrator
0,1,2,46,0,7,0,48,0,british army bomb disposal expert killed afghanistan
0,2,10,34,3,11,0,44,0,lady gaga star tiffany co.'s first super bowl ad
0,1,8,61,3,14,3,69,0,"interview vicky dhillon, city council candidate ward 9 10 brampton, canada"
0,3,2,51,0,9,0,53,0,riot grip paris suburb teen allegedly sodomized cop
0,3,10,34,4,11,4,44,0,nokia's classic 3310 phone life 'snake'
0,2,9,41,2,11,0,50,0,fda warns abbotts st. jude pacemaker defibrillator
0,3,11,42,2,13,0,53,0,story dress might win 'la la land' costume oscar
0,3,1,35,2,8,5,36,0,"rare penny circulation could worth $85,000"
0,2,11,44,2,12,4,55,0,wwe hall fame 2018: early projection next year's class legend
0,1,7,58,1,11,0,65,0,ed wed: uk labour leader miliband announces engagement justine thornton
0,1,1,18,0,3,0,19,0,pope medical crisis
0,3,7,30,3,6,0,37,0,"chrisette michele: ""my family disowned me"""
0,3,10,52,1,9,0,62,0,"german drugmaker stada support takeover offer bain capital, cinven"
0,1,4,57,0,10,0,61,0,court ruling upholds expulsion new york senator convicted assault
0,2,2,62,3,15,0,64,0,bitcoin isnt future money either ponzi scheme pyramid scheme
0,3,10,51,2,10,0,61,0,small-business owner split raising minimum wage real time economics
0,3,2,61,0,12,0,63,0,wa shark attack beach remain closed teen surfer dy injury
0,1,7,32,0,8,4,39,0,mark webber win 2009 german formula one grand prix
0,2,10,32,0,9,0,42,0,hollywood reacts death icon zsa zsagabor
0,3,12,38,0,11,0,50,0,irs say student aid tool removed data used thief
0,3,8,38,2,7,0,46,0,billy joel announces dodger stadium performance l.a.
0,1,8,42,1,10,2,50,0,unlikely 1-2 finish brawn team formula one season opener
0,2,3,49,2,12,3,52,0,"100 days, donald trump new world order look like old one"
0,1,2,34,1,7,5,36,0,"least 10,000 reported dead burma cyclone"
0,1,8,30,1,9,6,38,0,violence erupts game 2007 fifa u-20 world cup
0,3,11,52,3,11,0,63,0,"demarcus cousin 'very happy' kings, want sign contract extension"
0,1,2,34,0,4,0,36,0,squirrel banned finnish supermarket
0,2,13,36,1,10,0,49,0,oil trade showing opec cut starting bite
0,2,11,49,5,11,0,60,0,head china's people's choice award trash matt damon's 'the great wall'
0,1,1,36,1,4,0,37,0,musharraf's rape comment spur controversy
0,3,15,49,0,15,0,64,0,dj drama cannon say lil uzi vert signed generation label
0,1,3,45,1,7,0,48,0,scotland's first minister comedy sketch charity
0,3,4,44,1,10,0,48,0,report: mlb umpire may soon take mic explain replay
0,1,7,40,1,7,0,47,0,new status africa empowers ever-eccentric qaddafi
0,1,3,47,0,8,0,50,0,police warn sydneysiders stay away eastern beach
0,1,7,28,1,7,0,35,0,"pause, wall street pay bounce back"
0,3,8,43,2,8,0,51,0,chelsea manning call compromise fatal flaw obama legacy
0,2,7,16,2,5,0,23,0,u.s. talent pool frozen
0,2,14,58,3,14,0,72,0,"brit co's brit morin creativity, digital generation best business advice"
0,1,4,22,1,4,0,26,0,"hold eulogies, kennedy say"
0,3,12,29,2,6,0,41,0,adpvoice: adopting hcm: impact integration
0,1,5,29,0,7,1,34,0,farmer lead bid create 2 california
0,3,4,44,3,11,2,48,0,"nigerian girl, 10, used suicide bomb attack new year's eve"
0,3,4,45,1,8,0,49,0,"westinghouse trouble loom sc, georgia nuke project"
0,1,6,26,1,4,0,32,0,fbi investigates at&t security breach
0,1,9,20,4,6,0,29,0,new bid find missing ex-f.b.i. agent
0,2,6,22,2,6,0,28,0,ronda rousey loses again; now?
0,1,2,19,1,4,0,21,0,india's flag land moon
0,2,3,45,2,10,0,48,0,dnc chair candidate want 'shut white people down'
0,3,7,40,1,6,0,47,0,ford executive condemn donald trump immigration ban
0,2,1,67,1,12,6,68,0,government announce $300m training fund amid 457 visa change skill shortage concern
0,2,7,65,3,15,0,72,0,brexit brexit: short-term damage uk leaf eu single market?
0,3,1,40,0,8,0,41,0,powerful lobby dig ahead health care vote
0,1,2,22,0,4,2,24,0,explosion injures 11 beirut
0,1,4,15,0,4,0,19,0,goalie step
0,2,4,53,4,11,3,57,0,"espns 100-person round layoff brutal, network isnt doomed"
0,2,3,20,2,3,2,23,0,bannon/navarro 0; auslanders 1
0,2,4,52,1,12,0,56,0,"uk naive expect easy ride brexit trade talks, say lord report"
0,2,2,48,1,9,0,50,0,scientist seek holy grail climate change oman's hill
0,2,8,41,7,8,0,49,0,"cruz: trump utterly amoral, pathological liar breitbart"
0,2,13,64,4,16,0,77,0,peter king: brussels prof islamic state willing able strike time breitbart
0,2,7,34,0,7,0,41,0,lauryn hill blame snow pittsburgh late show
0,2,3,64,4,11,4,67,0,"oklahoma joe mixon apologizes, take full responsibility hitting woman 2014"
0,2,14,45,6,15,0,59,0,"womens world cup, tie leaf u.s. solid footing, need goals,"
0,2,1,47,2,11,2,48,0,"4 dead, including 2 children, small plane crash missouri"
0,3,3,34,0,5,0,37,0,massive fire engulfs u apartment building
0,1,2,42,1,6,0,44,0,"amazon server outage affect reddit, website"
0,1,2,41,0,9,0,43,0,judge gambian court warns medium cover case
0,2,1,58,0,12,0,59,0,people disability want better tech know build
0,1,8,33,0,7,0,41,0,evidence mouse produce egg cell birth
0,3,9,43,4,12,5,52,0,chainsmokers' 'closer' tie record week hot 100's top 10
0,3,7,77,3,16,2,84,0,brexit bill rebellion: row erupts eurosceptic claim 27 tory mp poised back wrecking amendment
0,3,10,40,0,10,4,50,0,complex staff list favourite song album 2016
0,2,7,43,0,6,0,50,0,seven business leadership lesson dwight eisenhower
0,3,3,42,0,6,0,45,0,well fargo scandal spread prudential insurance
0,2,14,46,6,14,0,60,0,listen zedd's must-hear remix dj snake justin bieber's 'let love you'
0,1,3,22,0,3,0,25,0,actor robert blake acquitted
0,1,8,34,0,8,0,42,0,liberty mutual make point family drama
0,2,2,57,5,11,0,59,0,president bully pulpit way overrated. trade vote proved it.
0,1,8,37,0,9,0,45,0,telling twin apart take new meaning berlin heist
0,3,7,40,2,9,0,47,0,facebook move curtail fake news trending feature
0,1,4,84,4,16,0,88,0,al-qaeda say bin laden death 'not wasted'; pentagon release video terrorist leader compound
0,2,12,46,1,10,3,58,0,jim ross reveals 2-year wwe contract appearance wrestlemania 33
0,1,4,24,0,5,0,28,0,lender need financial help
0,1,6,32,0,6,0,38,0,falling price japan feed deflation fear
0,2,12,60,1,11,0,72,0,everything need know hong kong's curiously undemocratic leadership vote
0,2,8,76,2,14,0,84,0,"fbi director james comey asked justice department refute trump's wiretapping claims, source say"
0,3,6,26,2,6,0,32,0,candace cameron bure leave view
0,2,11,45,0,10,0,56,0,utah attorney general vow sue obama new national monument
0,3,8,35,2,7,0,43,0,martian volcano different earth's?
0,3,5,64,3,8,0,69,0,"malcolm turnbull dissolve indigenous advisory council, 'commitment remains'"
0,1,5,32,0,6,0,37,0,settlement clear way aid sacramento
0,3,8,37,1,10,1,45,0,5 tech issue donald trump face president yahoo
0,2,4,33,2,5,0,37,0,revenge discouraged deplorables
0,3,1,33,0,5,0,34,0,undercover video human organ trader
0,1,11,45,2,11,0,56,0,"israeli vote, two party nearly tied, winner gridlock"
0,2,3,68,0,12,0,71,0,refugee take shelter rocky italian seafront turned away france
0,3,3,61,0,13,0,64,0,resident part corpus christi cleared resume using tap water
0,1,1,70,2,10,0,71,0,study suggests 'sleeping sickness' parasite mutated evade immune system defence
0,2,7,50,0,10,0,57,0,obama option protect dreamer trump take office
0,1,4,39,3,8,0,43,0,"mari luz, missing child huelva, spain, found dead"
0,2,3,39,1,5,0,42,0,valentine's day celebration banned islamabad
0,3,2,70,1,14,0,72,0,interior dept. agency change website family visiting park giant pile coal
0,1,7,38,0,8,0,45,0,mickelson loses quirky day accenture match play
0,2,1,59,3,12,2,60,0,knife crime 14% gang warfare becoming 'embedded culture'
0,2,4,72,4,14,0,76,0,"europe migrant crisis: un alarmed asylum seeker dying cold, 'dire' situation greece"
0,2,10,50,3,9,2,60,0,"10 year later, britney spears' head-shaving moment still unforgettable"
0,1,6,37,0,7,0,43,0,ally ponder plan election afghanistan
0,2,11,42,2,10,0,53,0,"born sudan, based brooklyn. singer remixes identity"
0,2,12,54,2,11,0,66,0,"anuradha paudwal, original singer tamma tamma isnt pleased remixes"
0,1,6,21,2,4,0,27,0,u.s. sue railroad smuggler
0,1,3,54,0,8,0,57,0,australian prime minister denies striking deal predecessor
0,1,2,46,0,8,0,48,0,russian military cargo jet crash kill eleven siberia
0,1,2,48,1,10,0,50,0,"second turk dy bird flu, suspected infected"
0,1,4,43,0,11,3,47,0,toyota suspend sale lexus gx 460 new safety fear
0,2,4,39,1,6,0,43,0,obama made anti-trump republican jealous
0,2,2,56,1,11,0,58,0,lawyer killed lover dog blame lone jew boardingschool
0,3,1,49,2,10,2,50,0,"harrod keep 75% restaurant service charge, union say"
0,3,1,50,2,5,0,51,0,all-timber apartment assembled like flat-packed furniture
0,2,8,41,0,8,0,49,0,syrian activist say dozen dead idlib chemical attack
0,2,6,49,2,10,0,55,0,king v. burwell: one supreme court case could unravel obamacare
0,1,2,61,0,10,0,63,0,french police ban public meeting increase security measure paris
0,3,3,51,1,9,0,54,0,senate democrat press trump's wealthy pick financial data
0,3,5,80,2,22,0,85,0,family buy cadaver bury dead son 'ghost bride' come back life coffin
0,1,9,39,4,9,0,48,0,"mindful violence, n.f.l. rule wedge formation"
0,3,6,63,1,11,0,69,0,report: white house reporter accuses trump aide omarosa manigault bullying
0,1,6,32,0,6,0,38,0,advertiser change game plan super bowl
0,3,3,49,2,10,0,52,0,trump meet 'great guy' carlos slim disparaged
0,3,15,56,2,14,0,71,0,"j. cole explains moved away pursuing fame, preview new documentary"
0,2,2,80,1,12,0,82,0,"coast guard suspends practice shooting, stabbing dismembering animal trauma training"
0,2,19,52,4,15,1,71,0,"lawsuit, new jersey allows driver get 8theist license plate new york time"
0,1,7,39,0,7,0,46,0,new version malicious computer program released
0,3,8,41,1,6,0,49,0,#alternativefacts spreading like wildfire twitter
0,1,4,36,2,6,0,40,0,u.s. force settle afghan taliban heartland
0,3,6,56,0,11,0,62,0,brain disease battering nfl may killed ernest hemingway
0,2,4,52,0,9,0,56,0,newtown leader call trump denounce sandy hook conspiracy
0,3,5,50,1,10,0,55,0,fear civilian mosul us-backed iraqi offensive ramp
0,2,3,13,0,4,2,16,0,alan thicke dy 69
0,1,4,50,0,7,0,54,0,russia launch progress spacecraft resupply space station
0,3,3,56,1,13,2,59,0,50 shade phoenix: arizona gov candidate spill spicy sex life detail
0,1,3,56,0,9,3,59,0,unauthorised autobiography julian assange sell less 700 copy
0,1,2,51,0,7,0,53,0,election moldova instigates rioting mob demanding recount
0,1,9,47,1,9,0,56,0,side await court decision same-sex marriage california
0,2,5,53,3,12,0,58,0,"exclusive: telecom italia, oi talk brazil may ease rule source"
0,3,4,58,3,12,2,62,0,brexit debate: labour hit backbench revolt article 50 'tory trap' fear
0,2,1,38,0,8,0,39,0,live video changing way witness crime
0,2,1,16,0,2,0,17,0,capturing swarm
0,2,5,28,0,5,0,33,0,donald trump tweet holiday greeting
0,3,4,40,1,7,0,44,0,democrat aim block trump's supreme court nominee
0,2,2,26,0,4,4,28,0,portugal crowned euro 2016 champion
0,1,5,35,0,6,0,40,0,texas rancher farmer struggle drought
0,2,5,68,2,11,4,73,0,budget 2017: tax increase announced self-employed worker chancellor philip hammond
0,1,1,36,0,8,0,37,0,australian sport may cusp change
0,2,8,44,3,6,0,52,0,"adele, rihanna, beyonce headline highest-paid grammy nominee"
0,1,7,32,0,8,0,39,0,golfer test limit good sense golf cart
0,2,3,54,1,8,0,57,0,centrelink debt letter harming australians' mental health
0,3,2,49,0,9,0,51,0,south korea prosecutor question ousted leader next week
0,3,5,39,2,8,2,44,0,faa: 27 airspace violation near trump's florida estate
0,3,12,50,1,13,1,62,0,internet mock floyd mayweather jr. wearing jorts game 2 nba final
0,2,1,56,0,12,0,57,0,human leg found attached cinder block search missing woman
0,2,17,56,2,16,0,73,0,"jaime lannister almost spoiled major ""game thrones"" plot point kinda wish"
0,2,5,56,0,8,0,61,0,newspaper apologizes mistaking alec baldwin president trump
0,1,5,40,2,8,0,45,0,"two small plane collide wyoming, usa, killing three"
0,2,3,58,2,12,0,61,0,liam neeson: silence star wasting particular set skills?
0,3,2,64,1,11,0,66,0,total stranger pay woman's christmas present card declined
0,2,3,49,1,9,0,52,0,second man arrested death ex-navy officer mike samwell
0,1,5,27,0,4,0,32,0,latest precocious teenager loses
0,1,2,43,0,8,0,45,0,suicide bomber kill least twenty pakistan town
0,2,10,60,0,9,0,70,0,new witness account undermines mexican government narrative missing student
0,1,3,32,1,6,2,35,0,6.3 magnitude quake strike papua new guinea
0,1,3,28,0,5,0,31,0,u senate pass new bankruptcy bill
0,3,11,56,0,12,0,67,0,donald trump reportedly planned meet putin ally suspected mob tie
0,1,4,48,4,5,0,52,0,"anti-censorship developer targeting china's ""great firewall"""
0,3,10,50,1,9,0,60,0,sinead oconnor apologizes claiming arsenio hall gave prince drug
0,1,6,29,0,6,0,35,0,world bank see slump russia worsening
0,2,2,49,2,9,0,51,0,de blasios self-serving solution problem justcreated
0,1,3,40,1,7,4,43,0,deaflympics 2013: u swimmer break second world record
0,1,1,78,0,10,0,79,0,wikileaks claim news organisation pressured remove article billionaire fraudster
0,1,7,39,0,9,0,46,0,letting marbury go celtic could backfire knicks
0,3,3,44,1,9,2,47,0,u consumer confidence climbed 15-year high december
0,2,3,67,3,12,0,70,0,"dania beach, florida, shooting kill boy walking home birthday party, police say"
0,3,7,37,0,9,0,44,0,new york review book editor robert b silver dy
0,3,10,28,5,10,2,38,0,bob hope's 'ufo house' sold $13 million yahoo
0,3,1,52,0,10,0,53,0,start day watching roadside bomb disarmed
0,1,6,37,0,7,0,43,0,knicks acquire hughes wilcox deadline deal
0,1,6,38,0,6,0,44,0,china intent requiring internet censor software
0,2,10,39,1,11,2,49,0,china win big stake $22 billion abu dhabi oil venture
0,1,3,61,0,12,0,64,0,toxic wetland may cause thousand bird death western australia
0,1,5,24,2,5,0,29,0,"knicks, without lee, fall orlando"
0,3,13,26,3,8,1,39,0,2-time mvp stephen curry get mvp calls?
0,3,4,52,3,10,0,56,0,samantha bee: republican 'lie' massive voter fraud started
0,2,2,56,0,8,0,58,0,marco rubio reveals presidential campaign staffer hacked
0,3,1,23,0,8,6,24,0,top 10 dog breed 2016
0,1,3,48,2,7,0,51,0,"somali pirate attack us-flagged ship, vessel evades capture"
0,3,8,43,1,8,0,51,0,jain join cantor president post-deutsche bank restart
0,3,9,44,0,8,0,53,0,white house open door crackdown recreational marijuana
0,3,1,65,1,8,0,66,0,"greyhound passenger beheaded, cannibalized passenger granted freedom"
0,2,3,69,3,13,4,72,0,"aldi become highest-paying supermarket uk pay rise 3,000-strong workforce"
0,3,11,61,2,11,2,72,0,"andy summer premiere west african-inspired song, talk 40th anniversary police"
0,3,2,54,1,13,0,56,0,inside pub came back dead named britain's best
0,2,15,47,2,11,0,62,0,"nato speech, trump scold leader doesnt recommit defense pledge"
0,3,3,51,1,8,0,54,0,"ben carson gain senate approval, inch closer confirmation"
0,1,1,36,0,4,0,37,0,stock market worldwide fall dramatically
0,1,8,34,0,7,0,42,0,janus chief resigns shaking fund manager
0,1,7,34,0,7,0,41,0,new search technology mine web deeply
0,3,3,67,1,11,0,70,0,"police brutality class project divide students, administrator nj high school"
0,3,8,52,0,9,0,60,0,official urge caution quake aftershock hit southern philippine
0,2,4,87,8,15,0,91,0,never trump presidential candidate: source told trump hide apartment theyre frustrated
0,3,10,48,1,10,0,58,0,"cyclist superman planking pose bike, surge past rider"
0,3,1,42,0,7,0,43,0,trump facing historic delay confirmation push
0,3,5,54,1,13,2,59,0,cheltenham festival: douvan make 14 win row willie mullins
0,2,14,43,2,10,0,57,0,gop lawmaker straight-up asks group teenager theyre virgin
0,1,2,33,0,5,0,35,0,serbian firefighter shot kosovo
0,2,6,37,0,8,0,43,0,megyn kelly press alex jones sandy hookdenial
0,3,4,61,1,13,0,65,0,"north korea fire missiles, japan want ability launch strike"
0,3,1,87,1,13,0,88,0,"wolf spider distinct personality formed experience past mates, researcher find"
0,3,10,43,2,9,0,53,0,"chance are, using reward credit card correctly"
0,2,10,40,0,10,0,50,0,intellectual case donald trump ted cruz
0,2,10,40,1,12,0,50,0,"bp well alaska stop leaking oil, continues release gas"
0,3,6,43,3,12,3,49,0,tom sietsemas top 10 new restaurants: fish jos andrs no. 8
0,1,3,40,1,6,0,43,0,new orleanians caught political crossfire?
0,2,9,42,1,10,0,51,0,san francisco set ban navy blue angel flyover breitbart
0,3,1,52,3,13,0,53,0,'drop bears' one town named street them?
0,2,9,42,3,10,0,51,0,donald trump discus personal health regimen dr. oz show
0,1,2,28,0,4,0,30,0,russian pilot crash lithuania
0,1,3,50,0,7,0,53,0,bbc newsreader sacked conviction wounding teenager
0,1,5,26,0,5,0,31,0,death sentence chinese milk case
0,2,12,43,4,9,0,55,0,"bet's 'the new edition story' brings back memories, inspires dancing"
0,3,7,40,2,6,0,47,0,trump's pipeline executive orders: proceed caution
0,1,1,56,0,9,0,57,0,candle knocked voodoo sex ritual cause apartment fire
0,1,2,26,0,4,0,28,0,alex sanchez suspended drug
0,3,8,43,2,8,3,51,0,"honda, government unveil c$492 million canada plant upgrade"
0,2,9,39,4,10,3,48,0,"5 strange 'simpsons' thing seen, even 30 year"
0,1,4,30,0,6,0,34,0,eta bomb kill soldier northern spain
0,3,4,87,4,18,0,91,0,'i think president owns bathrobe': trump team dispute report bizarre behavior white house
0,3,2,41,1,11,2,43,0,taiwan bike: cycle around island 12 day
0,3,11,23,8,9,0,34,0,"u.s., u.k. may lose luster m.b.a. destination"
0,2,4,48,1,10,0,52,0,james blunt return time added carrie fisher gossip
0,2,10,54,1,10,0,64,0,"trump field call several foreign leaders, including putin merkel"
0,1,7,51,2,9,0,58,0,"u senate majority leader harry reid criticized ""negro"" comment"
0,3,3,64,2,13,0,67,0,congressman plan block d.c. law let terminally ill patient end life
0,1,2,35,0,7,0,37,0,riot england continue fourth night
0,2,1,37,1,7,0,38,0,"diet soda study look dementia, heart risk"
0,1,5,61,2,8,0,66,0,bush epa nominee abandon insecticide-on-children study senate hearing
0,1,2,37,0,5,0,39,0,ethiopian fighter jet attack somalian town
0,2,4,48,0,8,0,52,0,dna evidence family secret snare italian child murderer
0,3,2,30,1,6,0,32,0,"love, hate supporting great cause"
0,1,4,39,1,7,0,43,0,cricket: england draw test series opener india
0,2,1,58,1,11,0,59,0,male survivor sex assault often fear wont taken seriously
0,1,7,45,2,9,4,52,0,aclu: gen. sanchez possibly perjured 2004 senate inquiry
0,3,5,20,0,5,0,25,0,slightly frugal google
0,3,3,41,4,10,0,44,0,ivanka trump: 'i know mean complicit'
0,1,4,37,0,6,0,41,0,avalanche canadian rocky mountain kill two
0,2,6,55,2,9,0,61,0,jrgen klopp hail pep guardiola choosing difficult premier league
0,3,6,46,1,11,2,52,0,u navy ground t-45 training jet fleet following fox news report
0,2,5,54,4,14,0,59,0,rubio want let gun onto d.c. streets. let capitol?
0,2,3,42,1,8,0,45,0,"get set december supermoon, geminid meteor shower"
0,3,1,31,1,8,4,32,0,"minimum wage going 21 states, 22 city"
0,1,6,40,1,6,0,46,0,singapore's economy stage comeback second quarter
0,1,2,81,3,13,0,83,0,"teacher australian school shocked warning redundancies, apply 'externals'"
0,3,1,53,2,10,5,54,0,trump's 25 executive order 100 days: cosmetic substantive
0,3,13,56,4,12,0,69,0,"'preschool politics' trump think split democrats, black lawmaker say"
0,1,2,47,2,9,0,49,0,news crew kidnapped tortured slum 'militia' brazil
0,1,2,36,0,7,0,38,0,major new bird flu outbreak reported asia
0,2,14,59,1,13,0,73,0,someone made trump sandwich reality match personality perfectly!
0,3,2,46,1,7,0,48,0,video show passerby shooting florida deputy's attacker
0,3,1,75,4,12,0,76,0,e-cigarette smoker 'may exposing high level cancer-causing chemicals'
0,3,9,44,0,9,0,53,0,pub banning christmas sweater kill vibe
0,3,2,69,1,11,0,71,0,report: miami officer fired joking target practice black neighborhood
0,1,2,32,0,8,2,34,0,least 24 dead clash central kenya
0,1,7,42,0,9,0,49,0,pope expected address role church canadian abuse
0,2,13,44,0,12,0,57,0,game taking back seat player video game streaming site
0,1,8,36,1,9,2,44,0,"income rebound, saving hit highest rate 15 year"
0,3,4,60,3,15,0,64,0,pauline hanson's one nation party rise who's voting why?
0,3,8,32,2,4,0,40,0,nba playoff bracket round-by-round prediction
0,1,6,29,0,5,0,35,0,italian opposition leader say failed
0,2,1,29,3,2,0,30,0,hungary recruiting 'border-hunters'
0,3,3,68,2,13,3,71,0,u.s. military acknowledges strike mosul site 100 allegedly killed
0,2,2,45,1,10,0,47,0,dashing home: teen shoot deer living room
0,1,3,18,0,3,0,21,0,reprieve newcastle
0,3,9,45,2,8,0,54,0,pro-refugee protester assad gassed syrians?
0,2,9,49,3,9,0,58,0,netflix film 'barry' offer portrait president obama's college day
0,1,6,31,0,6,0,37,0,group sound alarm european bee industry
0,2,3,40,3,6,0,43,0,u.s. judge dismisses euribor-rigging lawsuit
0,3,8,43,1,6,0,51,0,seth meyers hilariously explains holiday-themed teen slang
0,3,3,62,3,15,0,65,0,trump tell merkel: 'at least something common' nod wiretap claim
0,3,6,60,3,11,0,66,0,newspaper bill donald trump's inauguration episode 'the twilight zone'
0,2,2,50,3,9,4,52,0,"macys, kohl slash 2016 profit forecast citing weak holiday sale"
0,2,8,37,1,10,0,45,0,gorsuch join justice time matter term?
0,1,3,35,0,6,0,38,0,english hard rock band darkness reunites
0,2,2,77,2,14,0,79,0,alexis sanchez display fat lip 'embarrassing' reaction ball thrown face
0,2,3,30,0,7,2,33,0,legendary musician chuck berry dead 90
0,2,11,55,1,13,0,66,0,top opposition leader cambodia resigns election nears new york time
0,1,3,44,0,6,0,47,0,icelandic landsbanki slands earnings increase
0,1,2,48,2,6,0,50,0,wikinews interview contribution open-source: opera
0,2,18,52,1,18,3,70,0,"woman find r 100 cr jan dhan account, writes modi bank refuse help"
0,2,7,37,0,8,1,44,0,yahoo discloses new breach 1 billion user account
0,2,5,36,0,9,0,41,0,singer joy villa wear trump dress grammys
0,2,1,59,0,9,0,60,0,festive holiday card perfect typography enthusiast
0,2,1,83,2,16,1,84,0,"trump's doctor grant interview, 5 day later issue brazen threat reporter publish"
0,1,6,31,0,6,0,37,0,massachusetts sued cost health care
0,1,5,33,1,4,0,38,0,stronger recovery emerging-market fund
0,2,9,55,0,8,0,64,0,muslim girl design culturally appropriate basketball uniform
0,1,1,34,0,4,0,35,0,egypt court sentence opposition leader
0,1,6,34,1,6,0,40,0,"back hill, automaker defend dealer closing"
0,2,15,54,1,12,0,69,0,breaking news: dozen killed twin bomb attack target shia pilgrim damascus
0,3,9,56,1,9,0,65,0,runner admits cheating half-marathon investigator uncovers data
0,3,8,45,1,9,0,53,0,"fed, economist investor show rare harmony rate outlook"
0,1,3,78,3,16,0,81,0,"claim british quake may run ""low ten million pounds"" insurance association rep"
0,1,8,40,1,9,0,48,0,ocean: illustrated atlas map sea mystery
0,3,2,39,0,6,0,41,0,adorable cat brother reunited thanks tinder
0,1,10,54,1,11,2,64,0,critic assail british police harsh tactic g-20 summit meeting
0,3,5,79,1,14,0,84,0,"u ban laptops, ipads electronic device flight certain middle eastern airport"
0,3,3,66,4,9,0,69,0,centrelink: debt-recovery 'monumental mess' investigated senate committee
0,1,6,53,1,7,0,59,0,"wikinews interview jeremy hanke, editor microfilmmaker magazine"
0,3,10,44,2,10,4,54,0,2015 nba playoffs: shaun livingston's difficult trek nba final
0,1,2,41,2,5,0,43,0,judge continues injunction 'expelled' film
0,2,6,36,2,9,0,42,0,bare-handed line drive catch view espn video
0,3,6,49,2,11,0,55,0,un chief ban ki-moon hint could run south korea's presidency
0,1,5,60,2,9,0,65,0,"four indonesian airline allowed back europe; zambia, kazakhstan banned"
0,2,12,50,3,14,0,62,0,"lady gaga talk super bowl, say sister lobbied 'suspend' air"
0,3,6,38,0,6,0,44,0,michael flynn resigns national security adviser
0,3,12,60,3,10,2,72,0,forbes' next billion-dollar startup procore reach unicorn status $50m fundraise
0,2,5,43,1,6,0,48,0,trump defends under-fire attorney general jeff session
0,3,19,56,2,16,0,75,0,"plan convert in viraat museum fails, india oldest warship may sold scrap"
0,1,2,32,0,8,3,34,0,air france jet 228 board go missing
0,3,14,62,1,13,0,76,0,mystery solved! sachin tendulkar making singing debut alongside sonu nigam
0,2,1,53,2,8,0,54,0,trump executive order turned hilarious meme
0,1,7,35,0,7,0,42,0,abitibibowater said making progress debt
0,3,7,36,2,7,3,43,0,sony boost full-year earnings estimate $430 million
0,2,12,35,0,10,0,47,0,trump protester reminds u yg got robbed grammy
0,2,12,41,4,10,0,53,0,trump pick lt. gen. h.r. mcmaster new national security adviser
0,2,1,32,2,7,0,33,0,well know fast-foodfries?
0,1,6,27,0,5,0,33,0,candace parker putting family first
0,3,3,62,3,11,0,65,0,trump u.n. ambassador emerges fierce unnuanced voice foreign policy
0,1,3,41,2,8,0,44,0,disney high hope new 'ferb' christmas special
0,1,6,32,2,5,2,38,0,astronaut replace 16-year-old camera hubble
0,3,5,27,0,5,0,32,0,wrestler make best employee
0,3,14,45,1,11,0,59,0,bronco cb aqib talib rip raider wr michael crabtree's gold chain
0,2,1,37,0,5,0,38,0,washington shooting suspect arraigned
0,2,4,16,0,4,0,20,0,wild child take charge
0,3,10,46,1,11,4,56,0,"jim harbaugh meet usher michelle obama event, name 2017 captain"
0,1,7,36,1,6,0,43,0,"citing cost, state consider halting death penalty"
0,3,2,47,4,11,0,49,0,texas feral pigs: time 'hog apocalypse' begin
0,1,3,54,1,11,3,57,0,"six year old girl five others killed, hamas arrest 200 palestinian"
0,3,7,38,2,8,0,45,0,"verizon, first time, loses core wireless customer"
0,3,11,60,3,10,0,71,0,watch bruce springsteen tell australian crowd he's joining 'new american resistance'
0,2,7,56,2,15,0,63,0,m dhu's death custody case focus new song cat empire's felix riebl
0,2,4,42,2,13,0,46,0,came america: chasing dream man loved
0,1,7,47,1,10,0,54,0,"even support rider, armstrong receives attention"
0,2,3,63,2,10,0,66,0,david fahrenthold tell behind-the-scenes story year covering trump
0,1,6,39,0,9,1,45,0,3 die turkey shootout police militant
0,3,14,46,2,12,2,60,0,34-year-old hedge fund manager bet everything stock tanked
0,2,5,63,0,14,0,68,0,priority usa position center gravity left trump era
0,2,6,44,1,9,0,50,0,hhs doctor publicly come gop health care bill
0,3,13,48,5,9,0,61,0,"kendrick lamar's 'damn.' cover art inspires conspiracy theories, fire meme"
0,1,8,28,0,7,0,36,0,latest citigroup rescue may last
0,3,8,36,3,6,0,44,0,"bond buying surges, tightening u.s. corporate spread"
0,2,5,53,1,8,0,58,0,"charles oakley arrested, charged assault msg altercation"
0,1,7,35,2,10,6,42,0,serie 200809: inter milan hire mourinho new head coach
0,1,5,31,0,6,0,36,0,revolving door editor publisher
0,2,16,36,1,12,0,52,0,dark day over: bruce arena making usmnt fun
0,2,7,29,3,6,0,36,0,adele's 'hello' calling congress
0,3,8,44,1,9,0,52,0,republican warn trump divide unless he tougher russia
0,3,1,43,0,10,0,44,0,boxer refuse cash beating champion
0,2,1,52,1,8,1,53,0,"7 baltimore officer accused abusing power, robbing citizen"
0,3,2,32,0,8,4,34,0,look 2017 grammys red carpet
0,2,4,43,2,11,3,47,0,100-day watch: every white house meeting seems leak
0,3,4,61,1,10,0,65,0,swedish ex-glamour model becomes princess wedding prince carl philip
0,2,3,60,4,9,0,63,0,george michael: initial autopsy find singer's cause death 'inconclusive'
0,1,5,29,0,5,0,34,0,consumer confidence rose sharply may
0,1,2,29,0,4,0,31,0,mexico city legalises gay marriage
0,1,3,57,0,10,0,60,0,un call international community increase aid iraqi refugee
0,1,5,28,0,6,0,33,0,sensor chip trained serve pet
0,2,5,68,2,15,0,73,0,d.c. watchdog group call fed probe alleged election tax law violation nra
0,3,3,37,1,6,0,40,0,cambodia activist kem ley's murder trial begin
0,1,5,52,0,7,0,57,0,californian governor denies clemency stanley tookie williams
0,3,2,48,1,8,0,50,0,southern california rain eases; north facing renewed storm
0,3,7,19,3,5,0,26,0,mila j drop 'dopamine' ep: listen
0,2,1,71,0,14,3,72,0,colombia landslide death toll rise 250 massive rescue effort launched
0,2,9,45,0,10,0,54,0,jaguar push cool car automaker seek answer trade war
0,1,3,24,0,6,2,27,0,earth day founder nelson dy 89
0,1,8,48,1,7,0,56,0,double-amputee sprinter oscar pistorius hurt boating accident
0,2,9,47,2,11,4,56,0,emmy 2015: john stamos uzo aduba announce year's nomination
0,3,10,45,3,11,0,55,0,woody harrelson eyed play han solo's mentor 'star wars' spinoff
0,1,6,35,2,9,1,41,0,"gap posted profit, sale declined 8% quarter"
0,1,2,40,0,6,4,42,0,new zealand citizenship requirement tighten 2006
0,1,3,40,1,8,3,43,0,"100 shiite rebel killed yemen, government say"
0,3,16,43,3,12,0,59,0,carrie fisher grace big screen 'star wars: episode viii'
0,1,3,41,0,7,0,44,0,death toll tsunami southeast asia increase
0,2,10,60,1,11,0,70,0,wallace push lewandowski whether medium attack affect trump's agenda insider
0,3,6,58,0,16,1,64,0,eat legume every day reduce risk type 2 diabetes third
0,3,8,37,1,13,0,45,0,oil price fall saudi minister view output deal
0,1,6,29,0,7,0,35,0,judge allows madoff remain free bail
0,1,5,31,0,4,0,36,0,incredible shrinking baseball player
0,3,3,42,0,7,0,45,0,frozen michigan lighthouse straight narnia
0,3,6,19,1,6,0,25,0,take seat with: salah el brogy
0,1,4,52,0,7,0,56,0,emergency spacewalks planned fix international space station
0,3,10,42,2,7,0,52,0,"ubs profit surges, beat forecast wealth-management gain"
0,1,6,55,2,8,0,61,0,controversy spread libertarian u.s. presidential nominee bob barr
0,1,5,22,0,4,0,27,0,bankruptcy could costly
0,1,6,52,1,11,4,58,0,"jamaica, 2012 report gender equality development focus men"
0,1,7,24,5,7,2,31,0,"yogi berra, 83: one-of-a-kind common man"
0,1,1,65,0,10,0,66,0,washington state lawmaker look outlaw handheld cell phone driving
0,3,2,44,4,7,3,46,0,row historic 125-year-old windmill turned 'dalek'
0,1,6,37,1,6,0,43,0,"singapore, progressive islamic education"
0,3,2,36,3,5,0,38,0,north korea 'conducts high-thrust engine test'
0,3,2,54,0,12,0,56,0,trump capping pen tiny hand get huge photoshop battle
0,2,2,35,0,6,0,37,0,mckinney pool party incident race
0,1,6,40,2,10,1,46,0,fan os/2 want ibm release open-source software
0,3,22,40,2,10,0,62,0,nicki minaj squahes rumor partynextdoor wrote 'regret tears'
0,3,1,45,1,8,0,46,0,"poorest pay higher tax richest, new figure show"
0,2,4,37,2,8,2,41,0,"saudi arabia, u company reach $55 billion deal"
0,1,9,40,1,10,0,49,0,"cost soar iraq fall behind training plan, audit say"
0,3,7,42,2,9,2,49,0,ben simmons injury: update 76ers forward's foot return
0,1,9,30,3,6,0,39,0,i.b.m. affirms earnings goal despite sale slide
0,2,5,47,0,9,2,52,0,arsenal drawn bayern munich champion league last 16
0,2,1,30,1,5,0,31,0,fast food worker save toddler's life
0,3,4,59,1,9,0,63,0,showtime's new documentary explore jihadism inside united state
0,3,9,53,4,8,0,62,0,draymond green clarifies comment james dolan's 'slave-owner mentality'
0,2,2,25,0,6,0,27,0,trump love hate medium
0,1,4,71,3,12,4,75,0,dibabas comeback: long-distance track star win first world championship title since 2007
0,3,17,61,2,16,0,78,0,"aamir khan shed serious persona, show naughty side promo koffee karan!"
0,1,5,29,0,6,3,34,0,250 feared dead indonesia ferry disaster
0,3,12,48,4,11,0,60,0,little girl went bald alopecia celebrates crazy hair day [video]
0,2,3,56,0,11,0,59,0,arsne wenger arsenal enjoy rare day happiness fraught time
0,1,4,35,0,3,0,39,0,philadelphia newspaper seeking bankruptcy
0,2,2,43,2,9,0,45,0,theo 'rape' case fuel clash police paris area
0,1,5,18,1,3,0,23,0,texas a&m president resigns
0,1,7,37,1,8,0,44,0,nba: minnesota ready trade kevin garnett boston
0,1,8,48,0,9,0,56,0,tax proposal draw critic talk financing health insurance
0,3,4,58,2,12,0,62,0,donald trump tell immigrant brought u child 'rest easy'
0,3,7,82,5,14,0,89,0,"brexit: 'thousands' briton asking remain eu citizens, say european parliament's chief negotiator"
0,2,4,70,1,11,2,74,0,section 18c: political debate prompt australian share experience racism
0,1,8,60,0,12,0,68,0,mother detroit tiger baseball player urbina kidnapped farc leader
0,3,2,26,0,6,4,28,0,humana pull obamacare 2018
0,1,3,61,1,8,0,64,0,european parliament committee back visa-free travel balkan country
0,2,3,12,0,3,0,15,0,time face fact
0,1,3,36,0,6,0,39,0,three child taken new mexico compound
0,1,1,44,0,6,0,45,0,dublin travel agent occupy office closure
0,1,5,28,0,5,0,33,0,professor tied shooting found dead
0,3,11,41,2,13,0,52,0,"rape india, four year delhi gang rape case number"
0,1,4,57,1,11,0,61,0,swine flu reported countries; warns possible pandemic risk
0,3,1,48,1,10,2,49,0,chile's worst wildfire destroy town death toll rise 11
0,3,5,83,4,15,0,88,0,legs-it: politician others tweet leg 'sexist' reaction theresa may nicola sturgeon
0,2,13,53,2,11,0,66,0,vega experts: raiders' move show goodell nfl could embrace sport betting
0,1,2,28,0,5,0,30,0,curfew imposed part thailand
0,1,4,50,0,9,0,54,0,fiji loses right host world netball championship next year
0,3,14,63,0,10,0,77,0,intelligence input hyderabad helped police arresting suspected isi terrorist
0,1,5,25,0,5,0,30,0,georgian leader face call quit
0,1,3,40,0,10,2,43,0,welsh soap opera pobol cwm celebrates 35 year air
0,1,2,44,0,6,0,46,0,catholic church prepares papal election conclave
0,3,7,36,0,8,0,43,0,billionaire murky trust issue
0,1,11,53,0,12,0,64,0,killing away combat deal sharper blow family five military men
0,1,6,19,0,8,0,25,0,strong week end note
0,1,7,40,1,8,1,47,0,would-be olympic protester sentenced 3 year prison
0,3,13,34,4,9,0,47,0,aziz ansari slated 'snl's' first-ever south asian host
0,2,2,52,1,10,0,54,0,"even though bash anonymous sources, trump us"
0,2,1,31,0,6,0,32,0,day designer vaginashowcase
0,3,1,45,1,8,2,46,0,humanitarian crisis: 20m risk famine starvation
0,3,11,58,3,9,0,69,0,exclusive: scott pruitt promise epa originalism donald trump administration
0,2,3,63,0,13,0,66,0,obamas begin moving possession luxury new home ahead white house exit
0,3,6,66,3,18,0,72,0,'zeke effect' plus strong nfl draft class make cool running back again?
0,3,9,57,2,9,1,66,0,"malaysia arrest 7, including immigration officer, alleging islamic state tie"
0,2,7,23,0,7,0,30,0,climate change
0,2,9,30,1,8,0,39,0,punk dead: fan slam sex pistol credit card
0,2,2,53,0,10,0,55,0,dc mayor announces new initiative help find missing child
0,3,1,43,0,9,0,44,0,existing home sale surge fastest rate decade
0,3,9,41,0,12,0,50,0,charger said moving los angeles next season
0,3,8,45,2,11,0,53,0,dreamed africa author conservationist shot kenya
0,1,6,24,0,5,0,30,0,tony dungy step away coaching
0,1,1,23,0,2,0,24,0,iraqi accept constitution
0,3,10,39,3,9,0,49,0,foxconns gou say 'very serious' toshiba chip unit bid
0,2,10,46,3,10,0,56,0,rush limbaugh defends marco rubio: he right obama breitbart
0,3,5,73,3,15,3,78,0,us-led coalition mosul air strike killed 240 iraqi civilian 'because isi sniper used roof'
0,2,1,28,0,6,0,29,0,taiwan ban eating dog cat meat
0,1,7,31,2,7,0,38,0,"rampage, hush returns, filled pain"
0,3,3,57,3,13,0,60,0,'you cannot eat here': hawaii caf riles resident ban trump voter
0,1,2,29,0,5,0,31,0,five kidnapped nigerian oil rig
0,1,3,52,0,8,0,55,0,u national arrested alleged abduction haitian child
0,3,12,47,4,10,0,59,0,alan thicke's wife say feel 'gut-wrenching sadness' death
0,1,3,57,0,11,0,60,0,death michael jackson cause last minute change film drama
0,3,1,21,1,4,4,22,0,tesla's biggest moment 2016
0,3,9,43,1,9,0,52,0,"sex video, south korea accused targeting gay soldier"
0,3,14,52,3,12,0,66,0,"sxm festival release full lineup, add jamie jones, martinez brother"
0,3,8,40,0,7,0,48,0,federal appeal court upholds strict texas abortion law
0,1,6,21,0,4,0,27,0,israeli general refused nz visa
0,2,8,43,1,8,0,51,0,"trump aide reassures canada trade talks, isolating mexico"
0,1,5,37,0,5,0,42,0,british mp reveals fred goodwin superinjunction
0,1,6,27,0,7,1,33,0,maryland pull away duke 2nd half
0,2,2,49,3,9,2,51,0,"'trainspotting' cast recreate iconic film poster, 20 year"
0,2,6,36,2,7,3,42,0,"brian hoyer, 49ers reportedly agree 2-year contract"
0,1,6,29,2,6,0,35,0,justice retain oversight u.s. voting
0,3,9,47,5,12,0,56,0,"wounded fearless girl, creator charging bull want move"
0,1,4,40,0,8,3,44,0,study estimate first human hiv infection 100 year ago
0,3,14,69,6,17,2,83,0,"draymond green warrior blowing 24-point lead, losing grizzlies: 'i'm kind thrilled lost'"
0,2,4,49,0,10,4,53,0,amazing insight u intelligence knew hitler 1943
0,1,5,38,0,7,0,43,0,nadal criticizes prying testing program
0,3,1,30,0,5,0,31,0,assad denies use chemical weapon
0,2,9,42,1,9,0,51,0,chinese baby bonus may delay india population title: chart
0,1,4,26,2,5,0,30,0,"british man fully ""recovers"" hiv"
0,3,7,37,2,7,0,44,0,inside fed march meeting: annotated minute
0,1,6,24,0,7,0,30,0,moderate said pick court
0,2,3,64,2,14,0,67,0,know fear immigrant school oversee. undocumented myself.
0,1,6,42,0,9,0,48,0,u air force colonel claim spotted ufo arkansas
0,2,5,72,2,18,0,77,0,theresa may warns snp 'politics game' pledge keep country united
0,2,14,43,3,13,0,57,0,"biden talk trump, faith fate front live fresh air audience"
0,1,2,35,0,6,0,37,0,european oil company stop trade iran
0,3,14,49,3,12,0,63,0,prime minister theresa may say u.k. wont seek membership eu single market
0,3,13,51,3,12,0,64,0,"prison worker joyce mitchell planned move escaped killers, da say"
0,1,4,27,0,6,0,31,0,luxembourg vote yes eu treaty
0,1,6,33,0,7,0,39,0,luke harangody decides return notre dame
0,3,4,65,3,12,0,69,0,michelle obama's reaction melania trump's gift everyone's today
0,2,3,46,2,9,0,49,0,"mark sanchez agrees one-year deal bears, source say"
0,3,3,54,4,10,2,57,0,"section i-20 buckle atlanta, ""catapults"" motorcyclist air"
0,3,9,40,0,9,0,49,0,eu show support tough brexit stance work continues
0,1,2,61,2,9,0,63,0,"australia: indian doctor released bail, detained immigration law"
0,2,14,47,2,9,0,61,0,kobe bryant defends lebron james' high-volume shooting nba final
0,1,8,43,0,9,0,51,0,u president barack obama test drive chevy volt michigan
0,2,11,49,5,11,0,60,0,iran supreme leader downgrade u great satan great false idol
0,2,5,28,1,9,0,33,0,fox news poll: trump carrier deal
0,1,5,33,0,7,0,38,0,u supreme court hear guantanamo bay case
0,1,7,31,1,6,0,38,0,"russia facing long recession, world bank say"
0,2,1,46,1,8,1,47,0,treasure hunter vanishes searching $2 million gold
0,3,12,49,0,11,0,61,0,master top list private aviation travel sporting event
0,1,2,25,0,3,0,27,0,journalist deported fiji
0,2,4,36,1,7,3,40,0,u bank well fargo agrees $110m lawsuit settlement
0,2,7,66,2,17,0,73,0,caitlyn jenner life like today watch video yahoo good morning america
0,1,4,41,0,9,0,45,0,arrest made murder uk gemstone expert kenya
0,2,10,49,2,11,0,59,0,"parent welcome new year's twin born minute apart, different year"
0,1,6,56,2,10,0,62,0,"big brown victorious kentucky derby, runner-up eight belle break"
0,2,3,66,2,9,0,69,0,"beyonc's coachella performance pretty interesting, according twitter"
0,1,1,27,1,3,0,28,0,chilean earthquakes: picture
0,1,3,77,1,10,0,80,0,baseball player manny ramirez retires testing positive performance-enhancing drug
0,2,3,66,3,11,0,69,0,"netflix shareholder vote, angry bird fly 'wife bonus' book controversy"
0,2,1,34,1,6,0,35,0,naked woman lead cop high-speedchase
0,1,5,32,0,7,0,37,0,study measure chatter news cycle
0,3,9,35,2,7,0,44,0,espn expert predictions: another mvp honor trout?
0,3,5,29,0,8,4,34,0,find biggest market move 2017
0,1,4,42,5,7,0,46,0,"philippine hit typhoon ""kiko"" (morakot), dozen killed"
0,3,7,77,2,21,0,84,0,ee aw-lways that! donkey show brain using teeth remove fence getting way
0,1,3,36,0,8,2,39,0,american film director john hughes dy age 59
0,3,20,57,3,17,0,77,0,"isro's annual budget even less combined loss flipkart, amazon snapdeal year"
0,3,8,40,2,9,0,48,0,justin trudeau attend broadway musical come away
0,3,9,43,2,8,0,52,0,u.s. supreme court denies arkansas request begin execution
0,2,8,51,2,10,1,59,0,"driver melbourne, fleeing police stabbing, kill 4 pedestrian"
0,1,6,23,0,6,0,29,0,empty shop window new york
0,3,1,47,0,8,0,48,0,microsoft sends invite big spring product event
0,1,2,39,0,6,0,41,0,seven civilian killed afghan police mistake
0,3,3,60,0,11,0,63,0,custody row mother rebecca minnock hand fleeing son
0,1,3,34,1,6,3,37,0,"runners, fan prepare 109th boston marathon"
0,1,2,48,0,6,0,50,0,indianapolis remains undefeated win jacksonville
0,3,5,69,3,13,0,74,0,"florals, feather glitz: see everyone's wearing grand national aintree"
0,1,1,34,3,6,0,35,0,bush loses power 'fast-track' trade deal
0,3,4,41,1,8,0,45,0,house speaker get firsthand look us-mexico border
0,1,1,32,0,4,0,33,0,edmonton prison conflict wound eight
0,3,1,61,0,11,0,62,0,falcon offense come alive score first touchdown huge strip
0,3,3,60,2,11,0,63,0,"boxing day sale rush hit pre-christmas discounting, survey find"
0,1,6,29,0,6,0,35,0,corporate jet sitting super bowl
0,3,5,45,3,10,0,50,0,could happen trump move u.s. embassy jerusalem?
0,1,1,53,1,9,0,54,0,"zimbabwe may face famine due wilting crops, organisation say"
0,2,3,33,1,4,0,36,0,obama commute chelsea manning's sentence
0,1,4,49,1,11,0,53,0,"two dead two light aircraft crash isle wight, england"
0,3,12,45,0,9,0,57,0,college football lane kiffin reportedly become fau head coach
0,1,8,39,0,9,0,47,0,elf cup kick turkish republic northern cyprus
0,1,3,68,0,12,1,71,0,officer killed polish dissident communist era sentenced 4 year prison
0,1,4,31,0,4,0,35,0,downturn hurt expectation portland
0,2,12,60,7,14,4,72,0,billboard 200 chart moves: pentatonix's 'that's christmas me' surpasses 2 million sold u.s.
0,2,1,64,2,11,0,65,0,japanese court rule paedophile 'right forgotten' online case
0,2,5,50,0,10,0,55,0,gm blow away expectation suv boom continues drive profit
0,3,2,86,4,17,0,88,0,woman think marching trump necessary 'not second class citizen'
0,3,10,43,4,9,0,53,0,"dwyane wade: latest news, rumors, speculation bull sg's future"
0,2,5,74,3,14,0,79,0,saturday night live: aziz ansari explains rise 'lowercase kkk' scorching monologue
0,3,2,49,0,10,0,51,0,sri lankans vent anger toll rise rubbish dump collapse
0,2,4,45,3,9,0,49,0,here saturday night fever house look liketoday
0,2,3,71,2,10,0,74,0,"venezuela protests: looter electrocuted caracas unrest, food shortage continue"
0,2,5,41,0,7,0,46,0,firefighter honor fallen fdny chief outside hishome
0,2,9,27,3,7,0,36,0,hsbcs global overhaul number briefly
0,1,5,22,0,6,2,27,0,least 34 dead baghdad bombing
0,1,3,46,2,7,0,49,0,fireball generated u.s. laboratory resembles black hole
0,1,7,28,1,8,0,35,0,"new york, sotomayor put focus poor"
0,1,5,26,1,5,0,31,0,n. korean missile reportedly place
0,3,3,30,0,8,2,33,0,oldest known living gorilla u turn 60
0,1,4,23,0,5,0,27,0,gas price surge northeast u
0,3,4,48,2,7,0,52,0,"alexei navalny, russian opposition leader, arrested moscow"
0,1,5,27,0,4,0,32,0,security measure increasing iraq
0,1,1,35,0,7,0,36,0,china name new head coach swimming
0,1,8,31,2,8,0,39,0,sony expansion u.s. foreign tv business
0,1,10,58,0,12,0,68,0,israel let reporter see devastated gaza site image confident military
0,2,3,47,1,9,0,50,0,"u service member killed blast near mosul, coalition say"
0,3,10,46,2,8,0,56,0,trevor noah: barack obama spending last day baby-proofing america
0,2,3,25,1,6,0,28,0,life picture george michael
0,2,14,45,3,11,0,59,0,end two-a-days? ncaa push less demanding practice schedule
0,2,4,51,1,8,0,55,0,"throw homeopathic teething tablet belladonna, fda say"
0,1,6,32,0,7,0,38,0,duhon finish style relief knicks
0,1,2,30,1,5,0,32,0,world leader react obama's victory
0,1,5,35,0,6,0,40,0,discount internet cut telephone cost
0,1,9,44,1,9,0,53,0,"palin putting personal ambition ahead alaska, critic say"
0,3,1,43,0,6,0,44,0,scottish lawmaker back call independence vote
0,1,4,30,1,4,0,34,0,football: pfa release award nomination
0,1,3,54,0,10,0,57,0,woman south africa advancing field science technology
0,1,5,30,0,5,0,35,0,cablevision customer grab clicker
0,3,7,22,1,7,0,29,0,amy schumer buy back dad's farm
0,3,2,40,1,8,2,42,0,"carnival parade float crash brazil, injuring 20"
0,1,3,31,1,5,0,34,0,"migrant train derails tabasco, mexico"
0,1,5,18,0,5,0,23,0,knight leave nike top job
0,1,6,37,0,8,0,43,0,tension grow georgia accusation plot
0,1,3,28,1,6,0,31,0,rumor oprah winfrey's death hoax
0,1,9,42,2,9,0,51,0,a.p. deal share investigative work nonprofit group
0,3,4,71,0,14,0,75,0,science news feathered dinosaur tail discovered lump amber market myanmar
0,2,9,43,2,10,0,52,0,high court back president use jerusalem u.s. passport
0,3,14,62,4,13,0,76,0,breitbart news john carney v cnns brian stelter: american panic donald trump?
0,1,5,60,0,11,0,65,0,many u tv station preparing make digital switch despite new legislation
0,3,7,55,0,11,0,62,0,fbi sued role donald trump u presidential election victory
0,3,7,36,2,10,0,43,0,"bud selig, apostle equity, reach hall fame"
0,3,3,41,0,8,0,44,0,merkel head north africa reduce migrant flow
0,3,16,62,2,15,0,78,0,"men reddit claim they'd wear dresses, feminine stuff society accepting"
0,3,2,50,0,9,0,52,0,u banking stock record worst trading session three week
0,1,3,39,0,8,0,42,0,jury find two men guilty liam aitchison murder
0,2,9,42,0,7,0,51,0,nypd captain apologizes controversial comment rape
0,3,6,42,0,10,0,48,0,fox news pick tucker carlson take megyn kelly
0,2,3,55,1,9,1,58,0,here happens company actually track co2 emission
0,1,2,45,2,7,0,47,0,"turkey recall ambassador sweden ""genocide"" vote"
0,2,4,65,1,10,0,69,0,sistagirls mardi gras: indigenous trans community crowdfunds pride parade
0,1,2,34,1,6,2,36,0,"somali pirate release greek ship, 19 sailor"
0,1,4,57,1,10,0,61,0,"elizabeth ii begin state visit ireland amid protests, security fear"
0,1,6,59,2,9,0,65,0,"wikinews interview donald k. allen, independent candidate u presidency"
0,1,2,20,0,3,0,22,0,blair denies iraq pullout
0,3,3,63,1,11,0,66,0,"churchill bust take center stage trump, may reaffirm special relationship"
0,1,7,34,2,6,0,41,0,toyota said weigh reorganizing u.s. operation
0,3,1,58,0,11,0,59,0,mosul civilian death toll rise resident face threat two front
0,1,3,45,3,8,0,48,0,st paul's cathedral shut following 'occupy' protest
0,1,10,80,1,14,0,90,0,scientology tie new village leadership academy stir controversy smith jada pinkett-smith
0,1,2,33,0,6,2,35,0,man claim 84 percent ownership facebook
0,2,3,60,1,12,2,63,0,surrey county council announces referendum 15% tax hike fund social care
0,1,1,48,0,9,0,49,0,somali interior minister killed bomb attack home
0,3,1,61,0,9,0,62,0,washington state ready defend booming marijuana business fed
0,1,13,40,3,12,0,53,0,donald brown n.f.l. prospect mind draft
0,1,7,48,1,6,0,55,0,"xenophobia threatens italy, president giorgio napolitano warns"
0,3,4,42,0,9,0,46,0,trump son tell new york time avoid conflict
0,2,3,68,2,14,0,71,0,"trump becomes president, global elite davos wonder people dont like"
0,1,2,39,1,5,0,41,0,germany's july unemployment rate fall slightly
0,2,12,41,0,11,0,53,0,lufthansa say fare slide slow ceo seek cost cut
0,2,12,37,1,11,0,49,0,"carmax, others settle u action ad used car safety"
0,2,3,72,2,17,3,75,0,anger mp bow peers' pressure end 500-year old tradition printing new law vellum
0,3,6,77,1,16,0,83,0,donald trump's state visit uk may moved london brexit heartland amid security concern
0,2,8,43,3,8,0,51,0,trump promise great management need limited government
0,2,3,51,2,9,0,54,0,future politics: austra review glossy sound soaring vocal
0,1,2,44,0,7,0,46,0,nepali capital kathmandu shut rebel strike
0,1,5,53,2,8,0,58,0,montel williams show breached standard 'psychic' sylvia browne
0,2,1,72,0,15,4,73,0,strange 1917 photo supposed teach businessmen get shape success
0,2,1,55,0,11,0,56,0,georgia student police beating video say feared life
0,1,4,29,0,4,0,33,0,french british submarine collide
0,1,2,25,0,5,0,27,0,eight killed flooding fiji
0,1,3,29,0,5,0,32,0,u healthcare bill pass senate vote
0,2,7,36,0,6,0,43,0,president trump vow start renegotiating nafta
0,3,8,33,4,8,2,41,0,"ricky harris, 'everybody hate chris' actor, dead 54"
0,2,2,47,0,8,2,49,0,iranian airline finalizes deal purchase 60 boeingplanes
0,3,9,51,0,10,0,60,0,federal agency keep american dark crime statistic
0,2,1,67,5,22,10,68,0,"dad quit job paid $50,000 debt, thanks side job earns $23,000 month"
0,1,6,34,0,7,0,40,0,shiseido count personal touch hard time
0,2,9,47,2,8,0,56,0,victoria beckham tease 'carpool karaoke' sketch james corden
0,1,6,24,4,6,3,30,0,aerodynamics land: aiming 800 m.p.h.
0,1,2,39,1,8,0,41,0,"country around world send aid, help haiti"
0,3,6,65,2,13,0,71,0,"mattis syria: isi remains priority, chemical weapon tolerated"
0,2,4,39,3,8,0,43,0,"backstreet boy named new baby 'lyric,' obviously"
0,2,3,60,4,10,0,63,0,russia's military want teenager 'storm' replica berlin's parliament
0,1,1,70,1,11,2,71,0,zimbabwe cancel education year 4.5 million political economic trouble
0,2,10,61,1,11,2,71,0,grammy producer year nominee nineteen85 reveals story behind drake's smash
0,2,15,53,0,15,0,68,0,k man win super bowl ticket life finding golden bud light insider
0,3,6,44,1,9,2,50,0,central michigan's marcus keene enters top 20 wooden award
0,1,1,32,0,5,0,33,0,kuwait parliament give woman vote
0,1,7,49,0,10,0,56,0,former u congressman tom delay sentenced three year prison
0,2,7,47,4,13,0,54,0,love jay-z beyonc? bar called 'the carter' might
0,3,10,53,1,11,0,63,0,hawk use retro logo throwback game; fan balk seahawks similarity
0,1,5,27,0,5,0,32,0,german economy shrank last quarter
0,1,12,60,1,14,0,72,0,combative trial colorado controversial ex-professor seek win back job
0,3,13,40,3,12,0,53,0,"kenny g, god sax, tweeted best valentine daycards"
0,2,6,21,2,5,0,27,0,heroin use spike fivefold u.s.
0,3,2,58,1,11,0,60,0,"trump considering four secretary state, conway say"
0,2,7,41,0,7,0,48,0,bomb threat force emergency airplane landing prague
0,3,8,44,1,9,0,52,0,drunken brawl end conviction south korean tycoon son
0,1,1,27,0,4,0,28,0,tory candidate election gaffe
0,3,17,69,1,16,0,86,0,"pakistan release kulbhushan jadhav, say india islamabad failed prove spy"
0,1,4,14,1,5,3,18,0,barnes noble lay 100
0,1,5,56,0,9,0,61,0,u presidential race tied democratic national convention start
0,1,4,17,1,4,5,21,0,"anglo american cut 19,000 job"
0,2,2,58,0,13,2,60,0,richard branson offer new dad 12 month paternity leave full pay
0,3,3,55,0,7,0,58,0,nicola sturgeon reject speculation snap scottish election
0,1,5,27,0,4,0,32,0,dictionary defines inside baseball
0,2,13,45,5,12,0,58,0,cliven bundys wife reid: tell face domestic terrorist
0,3,4,60,1,13,2,64,0,carrie fisher dy 60: actor acclaimed writer best known princess leia
0,3,9,36,2,9,6,45,0,"kodak black reportedly lost $300,000 since locked"
0,2,1,46,3,9,0,47,0,viewer's guide (and least) entertaining bowl
0,1,7,30,2,5,0,37,0,u.s. bancorp report steep quarterly decline
0,1,7,24,2,6,0,31,0,u.s. arm bazaar mexican cartel
0,3,6,82,4,12,0,88,0,malcolm turnbull take aim united nation 'one-sided resolutions' israeli-palestinian conflict
0,1,2,37,0,6,0,39,0,militant attack kashmir bus route safe house
0,3,3,53,3,10,0,56,0,north korea missile test: latest launch 'blew almost immediately'
0,1,6,26,1,7,0,32,0,"law lag iraq, patience wear thin"
0,1,5,46,0,10,0,51,0,red cross urge sri lanka respect life tamil civilian
0,2,4,35,2,5,0,39,0,wonder woman serena beat navratilova record
0,1,6,32,0,7,0,38,0,urban battle loom ahead pakistan swat
0,2,11,46,1,8,0,57,0,wh invokes leak brennan confirms trump camp-russia contact
0,2,11,46,1,11,3,57,0,stephen curry pass kobe bryant 11th 3-pointers nba history
0,1,6,42,1,9,0,48,0,"russia stockpile gems, awaiting return demand"
0,3,9,54,3,10,0,63,0,tory burch's 'embrace ambition' campaign push gender equality insider
0,2,2,50,1,12,0,52,0,guide way trump transition like reality show
0,2,3,56,1,12,0,59,0,"one four young woman uk report mental health problems, study show"
0,1,6,20,0,6,0,26,0,town reborn face new threat
0,2,13,46,0,12,0,59,0,stephen colbert bash trump nixon time one glorious bit
0,1,5,23,0,4,0,28,0,freddie mac executive found dead
0,2,2,45,6,10,0,47,0,kate moss 'kicked flight calling pilot basic b----'
0,1,8,35,0,8,0,43,0,california get federal help ease water woe
0,2,9,40,4,10,0,49,0,beauty beast: live-action remake roar box office
0,2,7,43,2,8,2,50,0,taylor swift surprise 96-year-old wwii veteran christmas
0,2,14,61,3,16,0,75,0,danny gokey talk move country christian music 'the divide country'
0,1,7,40,0,9,0,47,0,modest start fed plan revive security market
0,1,8,25,2,8,0,33,0,g.m. try new tack win government aid
0,3,13,47,7,14,0,60,0,'get out' star daniel kaluuya character chris: 'he's kind like j. cole'
0,1,6,32,1,7,0,38,0,worst misstep: geithner added doubt
0,3,1,76,0,15,0,77,0,muslim woman spat eating restaurant say female race hate victim must speak
0,2,10,45,4,9,0,55,0,growing number g.o.p. lawmaker criticize trump refugee policy
0,3,7,41,1,8,4,48,0,"russia subway explosion reportedly leaf 10 dead, 50 injured"
0,2,9,34,2,8,1,43,0,paul richardson make wild 1-handed td catch vs. lion
0,1,9,42,1,8,0,51,0,animatronic obama going disney world high-tech style
0,3,11,49,2,10,0,60,0,kentucky police stop using 'punisher' logo realizing mean
0,1,4,39,0,6,0,43,0,tropical storm dolly kill seventeen guatemala
0,3,11,54,2,13,0,65,0,"kawhi leonard cross victor oladipo, go layup vs. thunder"
0,1,1,32,0,4,0,33,0,iraqi violence may restrict election
0,3,2,52,1,7,0,54,0,poll: trump approval transition lower predecessor
0,3,12,60,5,13,0,72,0,"watch katy perry's theme park-inspired video ""chained rhythm"" feat. skip marley"
0,2,6,30,0,6,0,36,0,general motor lost billion europe
0,2,4,54,3,10,0,58,0,"hitler valentine's day card mistake, college's republican group say"
0,3,5,24,0,4,0,29,0,stock fall amid weak commodity
0,3,7,81,5,19,0,88,0,"'my first leg, dad!': two junior doctor sacked posing severed foot amputation mexico"
0,2,9,66,4,15,0,75,0,jimmy kimmel test knowledge warrior fan -- fake question sportsnation espn
0,2,3,42,1,9,0,45,0,"thordis elva forgave rapist, broke curse"
0,2,4,38,0,6,0,42,0,melania trump hire white house social secretary
0,3,3,71,2,13,0,74,0,"same-sex marriage taiwan set debated parliament, country appears evenly split"
0,2,13,57,4,14,4,70,0,"number festival 2017 lineup includes young thug, jauz, louis child more: exclusive"
0,2,10,44,3,11,0,54,0,lizz winstead: fear punished speaking trump
0,3,7,45,0,7,0,52,0,pharrell williams wife helen lasichanh welcome triplet
0,3,6,48,4,9,0,54,0,theresa may election power grab slammed eu guy verhofstadt
0,3,8,65,6,15,0,73,0,obama michelle obama white house parenting: earth babies?
0,2,2,44,1,9,3,46,0,flight 804: egypt fails pull data damaged recorder
0,3,4,24,0,6,0,28,0,nba playoff bracket set
0,2,2,37,0,9,0,39,0,italian design duo sex yourhome
0,1,5,37,0,6,0,42,0,home refinancing hobbled variety obstacle
0,2,3,51,2,9,0,54,0,u.s. judge order unsealing clinton email probe search warrant
0,2,11,46,3,12,0,57,0,u.s. list detained trump travel ban called incomplete
0,1,6,36,0,7,0,42,0,fifa make change thierry henry handball
0,2,11,39,1,11,4,50,0,netmarble look set score south korea biggest ipo since 2010
0,2,4,47,1,9,0,51,0,"isi manufacturing arm industrial scale, report find"
0,2,10,40,3,10,1,50,0,watch 2 new action-packed 'rogue one' clip ahead release
0,1,6,61,4,13,2,67,0,'george davis innocent ok': uk court partially vindicates campaign 36 year
0,2,3,54,1,8,0,57,0,"apple end deal imagination technologies, share price tumble"
0,1,3,40,0,10,2,43,0,21 july bombing suspect extradited back uk
0,2,5,38,0,8,0,43,0,john biggs elected labour mayor tower hamlet
0,2,20,49,4,13,0,69,0,mississippi city called mlk day 'great american day' twitter went nut (update)
0,1,8,17,0,7,0,25,0,income gap may lose tv
0,3,16,50,1,13,0,66,0,"rbi give indian holi gift, remove limit cash withdrawal bank"
0,3,2,52,1,10,1,54,0,5 takeaway new book hillary clinton's failed campaign
0,1,7,32,0,8,0,39,0,obama auto adviser tie industry fund
0,2,10,61,0,10,0,71,0,russian opposition leader alexei navalny detained police moscow protest
0,2,6,36,1,5,0,42,0,detroit resurgence brings new housing concern
0,1,6,34,0,9,1,40,0,howard magic defeat celtic force game 7
0,3,26,63,3,21,0,89,0,"here's story soldier ran away u army, lived naga tribe married naga girl ww-ii"
0,2,9,38,1,8,0,47,0,people antarctica holding womensmarch
0,2,11,63,3,12,4,74,0,1960s activist say offensive equate transgender claim racial equality breitbart
0,3,3,54,2,11,0,57,0,trump predicts paris attack 'big effect' french election
0,2,3,51,2,10,0,54,0,"whole food workers, fear robots, drone culture clash"
0,2,11,39,4,9,0,50,0,"china would outlast u.s. trade war, billion-dollar fund say"
0,3,22,68,1,20,0,90,0,"rohit sharma, given opening slot limited over m dhoni turning point career"
0,1,1,40,0,8,2,41,0,cambodian woman found 19 year jungle life
0,2,1,62,0,12,0,63,0,subway crowding easy solution country figured
0,2,2,46,2,8,3,48,0,boeing's new 787 dreamliner lift near-vertical ascent
0,3,3,49,2,9,0,52,0,"plan seven-day gps thought out, say spending watchdog"
0,1,3,26,0,4,0,29,0,tropical storm dolores active
0,3,11,46,6,10,0,57,0,"lorde tease next, 'favourite' song, promise 'so much cool stuff coming'"
0,2,2,41,0,8,2,43,0,gallup poll find trump approval rating 37 percent
0,2,7,36,0,9,0,43,0,police use pepper spray trump protester ohio
0,2,2,23,1,4,0,25,0,march sadness: face defeat
0,1,3,33,2,5,0,36,0,british court 'threatened' united state
0,3,9,32,0,7,0,41,0,house approves bill overturn fcc privacy rule
0,1,0,38,1,7,2,38,0,$20 million prize offered lunar rover contest
0,2,6,71,5,17,0,77,0,"sarah palins treatment fox news: ailes called hot, wallace hoped would sit lap"
0,1,1,27,0,4,0,28,0,somali pirate capture two ship
0,2,11,43,0,10,0,54,0,gina rodriguez reminds u fierceness nothing size
0,2,1,54,0,11,0,55,0,retail sale fall second straight month auto sale tumble
0,2,6,36,0,8,0,42,0,apple debut red iphone fuel fight aid
0,2,13,64,0,12,0,77,0,american airline drop charter flight six nfl team including dolphin steelers
0,3,7,32,1,8,0,39,0,hooray hollyweed? iconic sign altered
0,2,8,31,0,7,0,39,0,dolphin fear acl injury qb ryan tannehill
0,1,1,50,0,6,0,51,0,california judge disqualified predatory lending case
0,1,10,40,3,10,2,50,0,second-half defensive stand help no. 2 oklahoma top no. 5 baylor
0,1,7,30,1,6,0,37,0,go-between linked pension fund carlyle
0,2,13,65,2,12,0,78,0,carrie underwood surprised husband's nhl team unannounced national anthem: watch
0,3,3,61,1,14,0,64,0,"boot camps, victim conferencing expanded nt bid curb youth crime"
0,1,1,20,0,2,0,21,0,asexual ant discovered
0,2,1,52,0,12,4,53,0,best time buy airline ticket travel advice 2017
0,2,11,69,10,11,0,80,0,"director paul feig: ghostbusters hater misogynistic, right-wing radio monster breitbart"
0,3,10,36,2,11,0,46,0,"snap, maker teen social app snapchat, file ipo"
0,3,10,46,3,9,0,56,0,plan samantha bee: late night comedian host alternative nerd prom
0,1,9,33,1,9,0,42,0,argentine man said source sanford e-mail
0,1,2,48,0,8,0,50,0,suicide bomber kill least eight eastern afghanistan
0,3,18,51,0,17,0,69,0,gigi hadid wore hijab cover vogue arabia people happy aboutit
0,3,13,39,2,12,0,52,0,"smith reunites cast ""the fresh prince bel air"""
0,3,17,41,3,14,0,58,0,trump say u wont go syria (even though u already there)
0,2,4,65,4,12,0,69,0,cillizza: here's easy way understand president trump's recent flip-flop
0,1,3,36,0,5,0,39,0,mormon church warns wikileaks document
0,3,1,48,1,8,0,49,0,umbrella save boy jump ten-storey building
0,3,4,46,0,9,0,50,0,look like jpmorgan building roboadviser
0,2,14,61,0,13,0,75,0,anthony morrow changed chicago bull jersey number derrick rose fan went nut
0,1,1,23,1,4,5,24,0,"asian earthquake toll nears 60,000"
0,1,2,27,0,3,0,29,0,eurozone approves greece bailout
0,1,7,31,1,7,0,38,0,"reading beijing, noted writer stabbed"
0,2,16,51,6,16,4,67,0,"james oneill, officer since 1983, step police dept.s top job new york time"
0,1,6,46,0,7,0,52,0,electronic frontier foundation sue sony cd technology
0,2,10,54,2,10,1,64,0,"5 mega tuesday takeaways: trump, clinton building broad party coalition"
0,3,3,26,0,5,0,29,0,mlb betting preview every team
0,3,10,43,1,8,0,53,0,pro-kremlin politician warn trump could unleash new arm race
0,2,9,43,4,9,0,52,0,"boddhi satva, bilal offer hope 'love will:' exclusive premiere"
0,1,3,40,1,7,2,43,0,assisted-suicide doctor jack kevorkian dy age 83
0,3,2,46,5,10,3,48,0,tried dyson's $400 supersonic hair dryer here's verdict
0,3,10,28,0,8,0,38,0,donald trump tap david shulkin head va
0,3,1,30,1,8,4,31,0,future sounds: best pop rock 2017
0,1,5,19,0,6,0,24,0,box cash yield mystery
0,3,4,64,3,13,0,68,0,"usc grad student fatally stabbed mentor personal dispute, police say"
0,3,2,50,2,11,0,52,0,"woman cheat men house chores, french survey find"
0,3,4,58,1,7,0,62,0,donald trump bench ex-washington senator announcer inauguration
0,1,7,36,0,8,0,43,0,pope benedict xvi visit united state begin
0,1,5,42,1,6,0,47,0,"horse racing nsw, queensland cancelled indefinitely"
0,3,8,40,1,9,0,48,0,sessions: racist caricature accurate
0,1,10,31,2,7,0,41,0,"pocketfinder: gps find people, direction"
0,1,3,41,0,6,0,44,0,israeli police palestinian clash jerusalem
0,2,5,59,2,12,0,64,0,reports: allman brothers' butch truck committed suicide front wife
0,3,3,40,2,9,1,43,0,mexican teen's family get $1m death u custody
0,2,12,30,5,9,0,42,0,"politician man: edgar whitcomb, r.i.p."
0,2,5,48,0,10,0,53,0,black life matter rally hundred second uk day protest
0,3,3,45,2,9,0,48,0,"apple cut price lower-end ipads, release red iphones"
0,1,5,19,0,5,1,24,0,new bbc radio 2 bos announced
0,3,6,77,0,17,2,83,0,minister urged sack lord heseltine vow join brexit rebellion lord article 50
0,1,2,37,0,7,0,39,0,princess kiko give birth imperial baby boy
0,3,2,50,0,9,0,52,0,chris hemsworth go full beast mode intense workout video
0,2,11,42,1,9,0,53,0,"uber board full confidence ceo kalanick, huffington say"
0,2,8,44,0,9,0,52,0,trump suggests using bedrock china policy bargaining chip
0,2,2,46,1,9,0,48,0,trump nominee ambassador israel unfit serve
0,1,3,38,0,6,0,41,0,tropical storm otto move central atlantic
0,3,4,75,4,17,7,79,0,"1,500 people, two mercedes benzes, 459tonnes luggage golden escalator: saudi king travel"
0,1,6,36,0,6,0,42,0,pakistani offensive put truce shakier ground
0,3,1,54,0,10,0,55,0,depression probably much harder heart realised
0,2,1,68,3,14,0,69,0,"research show young girl less likely think woman really, really smart"
0,3,7,31,0,9,0,38,0,push restrict child marriage new york
0,2,3,9,1,3,0,12,0,hawaii?
0,3,5,64,0,12,0,69,0,u authority refuse reveal russian ambassador united nation died
0,1,2,23,0,4,0,25,0,oklahoma city suburb fire
0,3,11,55,2,11,0,66,0,real-life dr. mcdreamy performs lifesaving brain surgery child peru
0,1,2,29,0,5,0,31,0,helicopter crash turkey kill six
0,3,7,62,1,14,0,69,0,france election: marine le pen emmanuel macron hold lyon rally race hots
0,1,6,26,0,6,0,32,0,flat finish take polish victory
0,1,6,63,0,10,0,69,0,afghan president hamid karzai open new terminal kabul international airport
0,2,2,68,0,11,0,70,0,libyan hijacker surrender release hostage plane diverted malta
0,1,8,41,1,7,0,49,0,"europe, microsoft fight antitrust charge browser"
0,3,6,36,1,7,0,42,0,china xi position ally transition battle
0,3,5,37,1,7,0,42,0,"plenty oscar drama, disappointing rating"
0,2,11,45,4,12,0,56,0,"donald loses november, wont #nevertrump thats blame"
0,1,4,59,0,8,0,63,0,uk electoral commission asked investigate news international payoff
0,3,8,37,1,8,0,45,0,get lady gaga's mesmerizing eye coachella
0,2,10,58,4,10,0,68,0,"boxing gennady golovkin vs. danny jacobs: fight date announced, comments, reaction"
0,1,6,24,0,5,0,30,0,stock drop amid swine flu concern
0,2,9,43,4,8,0,52,0,disney's live-action 'aladdin' hold open casting call lead
0,1,7,34,0,10,0,41,0,forging hot link farmer grows food
0,2,5,39,2,6,0,44,0,malaysia vulnerability exposed dollar ascent
0,3,14,60,2,16,0,74,0,"weeknd brings kendrick lamar, show style heart vevo concert los angeles"
0,3,3,57,1,8,0,60,0,venezuela seizes general motor plant amid anti-government protest
0,3,15,42,1,9,0,57,0,president obama know better complain flotus' outfit
0,1,2,42,0,8,0,44,0,uk court jail man trolling online tribute page
0,3,5,56,5,12,0,61,0,rep. luis gutierrez trump sanctuary city order: 'we're going fight'
0,1,1,40,0,7,2,41,0,spanish police arrest 66 child pornography raid
0,2,2,46,0,8,0,48,0,tension flare serb nationalist train halt border
0,2,9,47,3,8,2,56,0,scientist see sign dinosaur blood 75-million-year-old fossil
0,1,7,37,0,7,0,44,0,pressure building myanmar decline asean chair
0,2,9,32,2,9,0,41,0,"tim lee: trump focus tax cuts, deficit"
0,2,3,73,0,12,2,76,0,least 10 drown boat carrying suspected indonesian migrant capsizes near malaysia
0,2,10,43,1,10,0,53,0,michael jackson's son prince pay tribute dad new tattoo
0,3,3,50,0,10,0,53,0,georgia woman dead shot south carolina gun range
0,3,14,56,1,13,0,70,0,katy perry orlando bloom dress spread holiday cheer children's hospital
0,2,8,49,5,11,0,57,0,j.j. watt tell steelers' antonio brown treat brother t.j. like rookie
0,1,9,21,3,10,2,30,0,never mind costs. get 70 off?
0,2,10,36,2,9,0,46,0,larry bird say paul george trade rumor 'fake news'
0,2,11,49,3,9,0,60,0,u.n. official accuses syria blocking aid delivery cease-fire
0,2,5,77,3,20,1,82,0,"grand tour episode 5 review: moroccan roll gave u generic, grumpy fun better"
0,2,6,40,1,5,0,46,0,opening ceremony presented protest-inspired ballet
0,1,5,24,2,4,0,29,0,gentle questioning u.n. nominee
0,2,1,36,0,7,0,37,0,mom impress son impromptu car rap
0,1,6,27,0,6,0,33,0,screen actor guild take strike vote
0,3,1,45,2,13,2,46,0,"texas man, 85, us cane help save woman car crash"
0,1,5,37,0,6,0,42,0,crackdown protester drape tehran silence
0,3,14,45,0,13,0,59,0,beautiful family photo prove one way make family
0,2,12,58,3,11,0,70,0,"wyoming, new mexico climb forbes american dream index; georgia, pennsylvania fall"
0,2,8,44,3,9,0,52,0,"george st-pierre face michael bisping; date, venue still tbd"
0,2,14,34,2,11,1,48,0,exid score first top 5 entry world album 'eclipse' ep
0,2,13,56,0,12,0,69,0,people taking frustration united airline trolling hard
0,1,3,36,0,4,0,39,0,opera singer luciano pavarotti hospitalized
0,3,13,70,2,14,0,83,0,watch india ambitious aadhaar identification program often fails deliver india real time
0,1,3,35,2,6,0,38,0,canada increase oil production assist u.s.
0,3,6,51,2,10,0,57,0,spark flew night oarhe akhigbe nicole battle met. literally.
0,3,5,48,1,8,0,53,0,"group allegedly behind dnc hack targeted ukraine,report find"
0,2,10,34,3,9,0,44,0,"big show let ""fat shaq"" ruin last wrestlemania"
0,2,13,40,0,11,1,53,0,senate gop leader push health care vote july 4th
0,1,11,41,3,10,0,52,0,texas beat l.s.u. force deciding game college world series
0,2,5,47,0,10,0,52,0,new york bomb plot mastermind omar abdel rahman dy prison
0,1,2,59,1,9,0,61,0,"australian treasurer hand budget, announces two year deficit"
0,3,4,48,0,9,0,52,0,trump meet congressional leader monday white house
0,1,6,29,0,6,0,35,0,lloyd chairman victor blank step
0,1,5,27,0,6,4,32,0,lewis hamilton win 2008 german grand prix
0,2,11,58,1,12,2,69,0,"death toll tennessee wildfire hit 13, official insist evacuation order went"
0,3,1,41,0,9,0,42,0,hearing test may able identify concussion
0,3,9,42,0,9,2,51,0,19 mouthwatering recipe idea try favorite person
0,3,10,37,3,10,0,47,0,"forget love: china, ill marry license plate"
0,2,4,47,2,11,3,51,0,executive order 101: president use them?
0,3,2,74,1,11,0,76,0,victoria's desalination plant finally delivers government place order water
0,3,5,58,2,12,0,63,0,congress respond budget office's analysis gop health bill?
0,2,14,55,1,13,0,69,0,karnataka govt pass bill ban cheater appearing exam three years!
0,3,4,47,6,9,0,51,0,trump womens march protesters: didnt people vote?
0,3,5,73,3,13,0,78,0,president trump attended private mar-a-lago event saturday night without telling medium
0,3,16,58,4,15,0,74,0,adele restarts touching george michael tribute grammys: 'i can't mess him'
0,2,8,40,1,7,0,48,0,expert agree: deplorables really deplorable
0,1,8,26,2,7,0,34,0,test loom u.s. track north korean ship
0,1,7,30,3,8,0,37,0,lesson (or not) start-up miss mark
0,3,11,52,7,12,0,63,0,alyx ander premiere 'memories you' feat. srey davi (alyx's day mix): exclusive
0,3,4,57,1,13,0,61,0,uconn's streak come end wild controversial loss final four
0,1,10,53,0,9,0,63,0,detroit mayoral candidate admits making false claim education
0,2,10,31,2,9,0,41,0,bill moyers: time two democrat go
0,1,4,46,1,7,0,50,0,john kerry's military record yale transcript released
0,2,10,42,0,11,0,52,0,new york city end contract rikers health care provider
0,1,5,34,0,6,0,39,0,prosecutor plan attack financial fraud
0,1,6,26,1,6,0,32,0,"again, ruling class stir revolt"
0,2,16,70,6,18,0,86,0,ed klein dnc/media collusion: cover circus cant sleep elephant breitbart
0,2,4,39,0,8,0,43,0,super bowl li ticket price spike early slump
0,1,6,33,0,6,0,39,0,qantas reduces commitment new boeing plane
0,3,11,43,3,11,0,54,0,war coal over: donald trump sign energy executive order
0,3,14,54,0,14,2,68,0,people paying tribute legendary british actor john hurt died aged77
0,1,5,41,5,10,0,46,0,glasgow's common weal launch; 'not first. u first'
0,2,3,52,3,7,0,55,0,pope condemns myanmar's treatment 'peaceful' rohingya refugee
0,3,11,41,4,8,0,52,0,gop senator: trump's immigration order 'was properly vetted'
0,1,6,36,1,7,0,42,0,"loss smithfield foods, pork price stabilize"
0,1,3,38,0,7,0,41,0,sierra leone rebel convict sent rwandan jail
0,1,3,35,0,6,0,38,0,illinois jury sentence brian dugan death
0,1,6,28,0,5,0,34,0,memphis mural go beyond stereotype
0,1,6,30,0,6,0,36,0,argentina decides move election
0,3,9,52,3,11,0,61,0,"wielding claim fake news, conservative take aim mainstream medium"
0,2,3,41,0,11,0,44,0,trump set u botch global health crisis
0,2,10,37,1,9,0,47,0,everyone doesnt know liam payne andcheryl
0,3,11,57,1,10,0,68,0,beyonce pregnancy photo break selena gomez record most-liked instagram pic
0,2,1,51,1,9,0,52,0,meet parent wont let child study literature
0,2,14,48,5,13,7,62,0,"vesna vulovic, survivor mid-air plane explosion 33,000-foot fall, dy age 66"
0,2,7,34,0,6,0,41,0,trump contradicts state department iran deal
0,2,12,34,1,11,2,46,0,"17 essay tv, music film read rightnow"
0,2,11,52,4,10,0,63,0,"zoe saldana: trump hollywood got cocky, became arrogant bully"
0,3,4,52,1,7,0,56,0,francois fillon: pressure pile french conservative candidate
0,2,3,37,1,9,0,40,0,google ad fiasco could boon tvnetworks
0,1,3,65,0,12,4,68,0,u military carry review following wikileaks release classified 2007 video
0,1,3,46,0,6,0,49,0,scholastic sued harry potter copyright infringement
0,1,2,64,0,9,0,66,0,libyan government accuses three dutch helicopter crew transporting spy
0,2,13,57,2,14,1,70,0,6 powerful documentary need see understand importance l.a. riot
0,1,1,46,0,8,0,47,0,fake impotence drug linked low blood sugar outbreak
0,2,2,71,1,11,0,73,0,"senate probe election hacking review possible link russia, campaign"
0,1,3,46,0,5,0,49,0,asbestos controversy aboard scientology ship freewinds
0,2,13,44,4,14,0,57,0,dave east beanie sigel team gritty video 'the real back': watch
0,3,17,54,5,14,0,71,0,"abram dad srk's adorable moment made internet wonderful place, here's proof!"
0,3,9,39,0,9,0,48,0,christian hackenberg taking redshirt year nfl
0,2,7,50,0,10,0,57,0,chris evans latest hollywood star read cbeebies bedtime story
0,2,9,48,1,7,0,57,0,democrat criticize supreme court nominee gorsuch pro-business
0,2,18,67,6,20,1,85,0,emma stone ryan gosling get 8-bit makeover funny still star-crossed 'la la land' video game spoof
0,1,10,38,0,10,0,48,0,youtube said close video deal william morris
0,2,15,73,1,20,0,88,0,"german secret service spied journalist bbc, new york time reuters decade"
0,3,10,78,2,14,0,88,0,jeff sessions: donald trump attorney general likely met russian ambassador sergey kislyak third time
0,3,1,37,2,7,0,38,0,morocco 'bans sale production' burka
0,3,8,22,0,7,0,30,0,trump chooses ben carson lead hud
0,3,5,44,2,10,0,49,0,see two new skin 'overwatch' chinese new year event
0,3,4,46,1,8,0,50,0,donald trump accuses women's march protester voting
0,2,14,61,2,12,0,75,0,jonah hill trash 'stupid' skateboard ad hilarious palace video announcing nyc store
0,2,2,53,2,12,0,55,0,"adani plan export low quality, high ash coal india, court told"
0,2,2,53,0,9,0,55,0,soldier accused attempted parachute murder travel paris
0,1,4,50,1,7,0,54,0,google's gphone postponed awaiting android modification
0,3,13,36,1,8,0,49,0,kpmgvoice: health plan access standard need update
0,3,13,54,3,13,0,67,0,"donald trump talk vladimir putin, voter fraud claims, bill reilly"
0,1,8,33,1,11,0,41,0,"placid man land, caught pirate drama sea"
0,3,9,32,0,8,0,41,0,amazon grapple outage aws cloud service
0,1,3,23,2,8,2,26,0,"woman, 87, raped home uk"
0,3,3,53,1,9,0,56,0,sources: russia tried use trump adviser infiltrate campaign
0,1,2,35,0,5,0,37,0,malawi president pardon jailed gay couple
0,3,5,50,2,10,1,55,0,sprucing robert bruce: scottish king's face get 3d treatment
0,2,4,22,0,6,0,26,0,say goodbye toll gate innyc
0,1,4,29,0,5,0,33,0,cleric silent turbulent election
0,3,21,66,3,19,0,87,0,"man wife's skull, lost families, tn farmer protesting loan waiver"
0,2,8,35,0,8,3,43,0,earnhardt make nascar return daytona 500 practice
0,3,7,22,2,7,1,29,0,"vodafone, no. 2 could best"
0,1,6,33,2,5,0,39,0,"investor retreat, fearing slow, late recovery"
0,3,14,58,5,12,0,72,0,"cargillvoice: india's burgeoning 'corn bowl,' technology optimism rage"
0,2,12,60,2,13,0,72,0,nate silver: donald trump chance locking nomination appear dwindling
0,1,6,38,0,7,0,44,0,counseling ordered soldier iraq shooting
0,3,7,56,3,9,0,63,0,exxon ceo rex tillerson emerges trump top secretary-of-state candidate
0,3,9,51,1,11,2,60,0,christopher lee dy 93; actor breathed life nightmarish villain
0,1,9,47,0,8,0,56,0,chinese city bolster scant consumer spending free voucher
0,1,10,34,0,10,6,44,0,bayern munich starlet win award 2007 fifa u17 world cup
0,2,10,41,2,10,0,51,0,trump weary defender face fresh worry new york time
0,1,5,43,0,8,0,48,0,wail siren mark holocaust remembrance day israel
0,1,1,34,0,5,0,35,0,european airspace closed volcanic ash
0,3,2,51,1,8,0,53,0,"flynn saga shift balance power president, congress"
0,2,3,57,1,10,0,60,0,"defying uncaring image, new york subway rider erase swastika car"
0,1,3,34,0,6,0,37,0,condoleezza rice iraq surprise visit
0,1,3,42,1,7,0,45,0,"girl found dead truck northamptonshire, england"
0,3,2,40,1,8,0,42,0,sack ageing sexists? send rehab instead
0,3,10,49,7,10,0,59,0,"msnbc, abc host deem trump inaugural address 'militant,' 'anti-semitic'"
0,2,4,41,1,7,0,45,0,alton tower crash: leah washington leg amputated
0,3,1,31,0,5,0,32,0,german trial refugee attack
0,2,9,46,1,9,0,55,0,oral history michael jordan's minor league baseball career
0,3,9,47,1,12,3,56,0,last car line: death chrysler 200 signal massive change
0,3,4,68,6,14,0,72,0,megan mullally regret helping trump 'landslide' win: 'i'm giving points'
0,2,12,57,5,10,0,69,0,here's every artist defended snoop dogg's trump-referencing 'lavender' video
0,1,5,26,0,5,0,31,0,apple introduces iphone apple tv
0,3,13,52,3,13,1,65,0,obama donated $1 million charity president. here's money went
0,3,10,44,3,9,0,54,0,"bentleys first-ever, electric concept car luxury fever dream"
0,2,4,45,4,8,0,49,0,'where began': photographing trump's return alabama
0,1,6,36,0,6,0,42,0,popular newsweekly becomes lonely category
0,2,4,49,3,10,0,53,0,katy perry's 'chained rhythm' cotton candy political pop
0,1,3,35,0,7,2,38,0,english actress elizabeth taylor dy age 79
0,1,4,47,0,8,0,51,0,parajet skycar expedition take london timbuktu
0,1,7,51,0,9,0,58,0,altercation erupts rock musician mtv music video award
0,1,3,39,0,8,0,42,0,u drone strike kill least fifteen pakistan
0,1,8,34,1,7,0,42,0,burnett humbles rays; nady leaf game injury
0,1,1,26,0,5,0,27,0,zeus botnet trojan horse back
0,1,6,25,0,6,0,31,0,cost cut qwest help profit climb
0,3,11,50,0,11,0,61,0,donald trump spent sunday morning beefing mark cuban twitter
0,1,3,35,5,10,1,38,0,"we, two-headed snake, dy u.s. museum age 8"
0,1,6,35,0,6,0,41,0,good time remember investment fundamental
0,2,8,39,0,7,0,47,0,draymond green express displeasure nba cba deal
0,2,4,51,2,9,0,55,0,exclusive: possible early north korean nuclear site found report
0,3,5,50,0,12,0,55,0,castle house saved plan relocate new south wale
0,3,10,57,2,12,0,67,0,luxury fyre festival bahamas 'fully postponed' amid report total chaos
0,2,5,60,3,12,0,65,0,super mario's creator explains 'super mario run' reach new generation
0,2,5,73,4,14,0,78,0,"peter mansoor, right-hand man gen. petraeus, say would never serve trump administration"
0,1,7,30,1,8,0,37,0,"man everything, including lot flee"
0,3,4,51,2,7,0,55,0,destination la fallas: valencia's spectacular festival fire
0,1,4,26,0,4,0,30,0,businessman convicted arm plot
0,3,6,21,3,4,0,27,0,"u.s. stock climb, extending rally"
0,3,3,38,2,6,0,41,0,kim jong-nam: arrest airport poisoning
0,3,9,45,3,10,0,54,0,sage gemini release electrifying video track 'now later'
0,1,5,26,0,5,0,31,0,honduran president ousted coup
0,3,2,63,3,15,0,65,0,heatwave: keep cool weekend even struck power blackout
0,1,4,43,1,7,2,47,0,india win gavaskar border trophy defeating australia 2-0
0,3,6,51,2,13,0,57,0,expert: watch see kim jong-un go hiding syria strike
0,1,6,32,0,7,0,38,0,juventus putting pressure inter serie
0,1,6,19,2,5,0,25,0,'daybreak' launch itv uk
0,3,9,42,2,9,0,51,0,'wonder woman' love story explored new footage cinemacon
0,1,5,29,1,5,0,34,0,"exposed solvent, worker face hurdle"
0,2,1,46,0,7,0,47,0,facebook tackle fake news educational campaign
0,2,9,42,1,11,0,51,0,trump reversal hint wall street wing sway white house
0,2,5,22,0,6,0,27,0,binary bet bitcoin twin
0,1,3,45,1,8,2,48,0,"blast kill 12 people, including senior sri lankan minister"
0,3,11,50,4,11,0,61,0,watch emma stone relive 'high school' 'saturday night live' monologue
0,2,10,34,1,10,2,44,0,22 powerful woman youll want daughter look upto
0,3,8,38,2,9,0,46,0,hacker release new episode 'orange new black'
0,3,5,53,2,9,0,58,0,"economic result wake-up call, prime minister malcolm turnbull say"
0,1,2,37,1,9,4,39,0,owner want $10 million flight 93 crash site land
0,3,12,50,3,11,0,62,0,sell coachella ticket yet; beyonc's show reportedly still
0,2,3,46,4,8,5,49,0,"men catch 15-foot-long, 144-pound python florida everglades"
0,3,9,36,2,11,0,45,0,would buy car vending machine? fox business
0,3,1,32,4,8,6,33,0,"barclays took 440,000 put hell"
0,3,7,62,3,12,0,69,0,top ceo: bringing money back overseas could help rebuild 'crumbling nation'
0,3,9,51,0,10,0,60,0,art briles denies covering accusation sexual violence baylor
0,2,6,36,1,6,0,42,0,human right watch alarmist stance toward trump
0,2,3,55,0,10,1,58,0,trump administration sends mixed signal syria ahead g7 meeting
0,1,6,68,0,11,0,74,0,investigates outbreak unidentified illness democratic republic congo
0,1,2,46,0,6,0,48,0,passenger rescued stranded antarctic cruise ship
0,2,9,62,4,11,0,71,0,philippine proposes gentleman agreement china south china sea breitbart
0,1,11,37,1,10,0,48,0,blue coat at&t take part fosi internet security
0,1,4,46,0,7,0,50,0,excessive surgery swell medicare cost united state
0,2,14,38,1,13,0,52,0,"andy puzder ropes, may first trump nominee go"
0,3,5,56,0,14,0,61,0,trump beat press feud cia alliance assange
0,2,4,57,2,11,0,61,0,gorsuch face question supreme court hearing's second day: watch live
0,2,1,54,0,14,1,55,0,twitter planning cut much 8 percent staff week
0,3,14,50,0,13,0,64,0,millie bobby brown opened exhaustion mature way
0,2,5,38,2,8,0,43,0,ufc: rouseys comeback halted first round nunes
0,2,5,28,1,5,3,33,0,aerosmith's biggest billboard hot 100 hit
0,2,1,73,1,13,0,74,0,asia's richest family abandoning hedge fund due mediocre return high fee
0,1,3,51,0,9,0,54,0,eight people dead shooting north carolina nursing home
0,3,20,49,0,17,0,69,0,tedx speaker called people made rude meme polite way
0,2,3,40,0,7,0,43,0,derek hannah jeter expecting first child
0,2,7,20,2,5,0,27,0,bill oreillys exit fox news
0,2,8,55,2,10,2,63,0,clinton foundation discloses $40 million wall street donation breitbart
0,2,6,64,1,12,0,70,0,tourist andreea cristea hurt terror attack london's house parliament dy
0,3,9,34,3,10,0,43,0,pelosi: border wall sign weakness trump
0,3,4,16,2,7,8,20,0,30 30 europe 2017: law policy
0,1,6,29,0,7,0,35,0,lovelorn iraqi men call wartime skill
0,1,6,56,2,7,0,62,0,wikinews interview u.s. libertarian presidential candidate bob jackson
0,1,5,38,1,8,2,43,0,pakistan win fortune cup defeating west indie 3-0
0,3,5,38,1,7,0,43,0,"i, daniel blake sweep evening standard film award"
0,1,6,36,2,6,0,42,0,"investors, mindful negative data, sell holding"
0,1,7,24,3,5,0,31,0,f.d.a. consolidates former navy site
0,1,5,33,1,6,0,38,0,"magic survives, cavalier teeter brink"
0,3,11,51,1,11,0,62,0,wall street strategist taking different tone trump's win
0,1,5,22,0,5,0,27,0,downturn draw veil islam
0,2,9,38,5,11,0,47,0,moby open letter america: f*ck wrong you?
0,1,6,67,0,11,0,73,0,kay hull cross floor australian house representative telstra legislation
0,1,8,36,3,8,0,44,0,"stunning spain soccer world, u.s. advance final"
0,3,3,33,1,6,0,36,0,"man accuses justin bieber assault, theft"
0,3,4,23,0,4,0,27,0,brain science conformity
0,1,7,48,0,9,0,55,0,fox announces overhaul top entertainment division
0,2,12,50,2,9,0,62,0,"fbi: bombing suspect bought material online, left fingerprint device"
0,1,4,31,3,6,0,35,0,north korean leader kim jong-il 'has cancer'
0,1,2,44,2,7,0,46,0,"earthquake reported near rome's coast, damage caused"
0,2,3,38,0,9,2,41,0,oscar pistorius released prison aug 21
0,1,3,50,0,6,0,53,0,taiz ecumenical community founder frre roger assassinated
0,2,8,26,0,8,0,34,0,miley cyrus get new tattoo dog emu
0,1,3,27,2,5,0,30,0,o.j. simpson named suspect robbery
0,3,7,59,2,14,3,66,0,"save $900 escorted trip germany, switzerland austria go ahead tour"
0,2,9,44,2,8,0,53,0,devos block embattled student loan giant's expansion?
0,1,2,57,2,10,2,59,0,"5.9 magnitude earthquake pichilemu, chile revives fear new tragedy"
0,1,3,33,0,5,0,36,0,colombian journalist denied entry u
0,3,8,41,0,9,0,49,0,russian cyberforgers steal million day fake site
0,3,1,10,1,3,0,11,0,that?
0,1,3,59,1,9,0,62,0,major snow disruption britain; wikinews report affected village
0,2,12,35,6,11,2,47,0,a-trak murder beat new 74-minute mix 'cut out!': listen
0,1,3,39,0,6,0,42,0,sixteen killed pakistan taliban ambush
0,1,5,57,1,12,4,62,0,stan lai: volunteer play greatest key role 2009 summer deaflympics
0,1,3,48,0,8,0,51,0,tamil party drop commitment independence sri lanka
0,1,6,39,0,7,0,45,0,missouri step forward marquette cross line
0,1,4,35,1,8,0,39,0,report: annan failed fix oil food program
0,2,10,54,3,11,0,64,0,obama spox: allegation wiretapping trump tower 'simply false' insider
0,2,15,58,2,15,5,73,0,"bank benefit demonetisation loan worth r 80,000 crore repaid old notes!"
0,3,2,50,3,7,0,52,0,berlin attack: tunisian fugitive 'had surveillance'
0,1,5,30,0,7,1,35,0,table turn transaction 2 auto giant
0,2,6,47,2,10,2,53,0,"cambodia's deputy pm sok dy aged 66, government spokesman say"
0,2,14,50,0,13,0,64,0,mumbai police rolled badass road safety message year
0,1,4,21,0,5,1,25,0,blast iraq kill 3 american
0,1,2,43,0,5,0,45,0,north american citizen dealt passport requirement
0,3,9,35,0,9,3,44,0,100 people saved chinese grandma trapped beneath abus
0,1,5,44,1,11,0,49,0,"man dy north uist, outer hebrides hit car"
0,2,11,52,0,10,0,63,0,lebron james beat damon jones shooting contest wearing backpack
0,2,3,39,0,9,0,42,0,family fear british girl went syria dead
0,2,6,35,3,6,0,41,0,breitbart news daily: obamas farewell breitbart
0,3,9,40,1,10,0,49,0,"brazil hail victory china, chile egypt lift meat ban"
0,3,6,53,0,11,0,59,0,two democrat vote confirm supreme court nominee neil gorsuch
0,2,10,51,2,10,0,61,0,kourtney kardashian got dragged twitter tweeting 'get out'
0,1,1,32,0,4,0,33,0,bottled water concern health expert
0,3,8,49,2,7,0,57,0,trump draw hilariously mock president signing executive order
0,1,2,36,0,4,0,38,0,kidnapped romanian journalist return home
0,3,10,65,1,14,0,75,0,ewan mcgregor snub good morning britain due pier morgan comment womens march
0,1,5,36,2,7,0,41,0,u president george bush discusses 'war terror'
0,2,2,45,0,8,0,47,0,medium outlet report bogus news tweet abouttrump
0,3,13,42,2,9,0,55,0,ufc tease ronda rousey's return music promo featuring g-eazy
0,1,4,36,0,7,0,40,0,david ahenakew removed order canada
0,2,2,38,2,6,0,40,0,lingering baby weight? blame pregnancy
0,2,6,53,2,11,2,59,0,firefighter attends graduation baby rescued 17 year ago [video]
0,3,4,21,1,4,0,25,0,making d'angelo russell
0,3,4,37,0,8,4,41,0,ultimate guide navigating 2017 mlb season
0,1,3,23,0,6,2,26,0,senator ted kennedy dy age 77
0,2,2,27,4,5,0,29,0,finally. someone think like me.
0,3,9,43,0,9,0,52,0,north korea ban malaysian leaving murder spat grows
0,2,10,19,2,7,0,29,0,"wait, rob lowe new kfc colonel?"
0,1,2,29,0,4,0,31,0,two strong earthquake rock vanuatu
0,2,4,29,1,7,0,33,0,what's next syria u airstrikes
0,1,2,62,1,8,0,64,0,"international board fix soccer field size, halt technology experiment"
0,3,1,56,0,8,0,57,0,canadian province take major step towards universal basic income
0,1,2,37,0,7,0,39,0,uk student protest second time month
0,1,5,31,0,7,0,36,0,president paraguay child bishop
0,1,3,51,0,8,0,54,0,ren prval leading haitian election according opinion poll
0,1,5,35,0,5,0,40,0,delaware legalizes betting sporting event
0,1,2,23,0,4,0,25,0,egypt recall envoy israel
0,1,6,36,2,7,0,42,0,canada's astral medium inc. aquire standard radio
0,2,9,46,1,11,2,55,0,early john lennon bandmate childhood friend pete shotton dy 75
0,2,6,39,1,8,0,45,0,predict gentrification: look falling crime
0,2,5,40,1,11,0,45,0,rory feek post new photo late wife joey feek yahoo
0,2,3,34,1,8,0,37,0,like cover beau bidens funeral
0,2,11,30,0,10,0,41,0,ted cruz standing way flint water deal
0,2,5,51,2,10,0,56,0,donald trump used presidential power advertise l.l. bean
0,2,6,29,1,5,0,35,0,meet president trump outside legal team
0,2,10,42,0,11,0,52,0,paul ryan reject call devin nunes step aside probe
0,2,10,43,1,13,1,53,0,1 million rally women's march u around world
0,3,1,59,1,13,1,60,0,nonprofit selling tiny $6 hijab child put doll
0,2,8,42,0,8,0,50,0,trump supporter cheer combative stance medium
0,3,10,39,0,9,0,49,0,trans activist whose epic trump rant went viral speaks
0,2,7,68,0,12,0,75,0,white house chief strategist stephen bannon longer part national security council
0,1,1,39,1,8,1,40,0,"loss almost double 3, mobile phone company"
0,1,1,59,4,8,0,60,0,"indian activist begin ""fast-unto-death"" hunger strike end corruption"
0,1,3,44,0,7,0,47,0,thailand begin repatriation hmong migrant lao
0,1,4,52,0,8,0,56,0,united airline flight make emergency landing newark airport
0,3,2,64,5,10,0,66,0,"trump promised unpredictable foreign policy. allies, look incoherent."
0,1,7,38,2,7,0,45,0,u.s. agency advised release information public
0,2,6,32,0,9,0,38,0,cbo release new score gop health care bill
0,1,6,34,0,7,0,40,0,philadelphia find reality show hard watch
0,2,13,56,4,13,0,69,0,president obama give final weekly address: cant take democracy granted
0,1,1,76,1,13,0,77,0,japan raise severity level crisis; effort cool damaged nuclear power plant continue
0,2,10,58,2,11,0,68,0,curt schilling video game studio cleared criminal wrongdoing breitbart
0,1,7,37,0,7,0,44,0,u secretary homeland security tom ridge resigns
0,3,3,40,2,9,1,43,0,"u economic growth slowed q4, there's hope ahead"
0,1,11,46,5,10,0,57,0,"obama, visiting g.o.p. lawmakers, open compromise stimulus"
0,3,3,62,2,10,0,65,0,world's first custom-built floating city rise french polynesian water
0,1,4,46,3,9,0,50,0,u.n. condemns lack due process american-run iraq prison
0,3,1,85,1,17,0,86,0,mammoth suffered osteoporosis arthritis like human may went extinct
0,1,7,34,1,6,0,41,0,"europe, difference crisis exit strategy"
0,3,5,58,2,9,0,63,0,instagram snapshots: pdhraic mulholland's christmas dip norway fjord
0,3,5,79,2,16,0,84,0,former patriot assistant floated rumor brown try 'hard' trade jimmy garoppolo
0,2,12,69,3,12,0,81,0,christopher nolan's war epic 'dunkirk' unveils new trailer featuring harry style explosion
0,2,6,28,0,7,0,34,0,fake freedom american health care
0,2,2,42,1,7,0,44,0,here republican stand nuclear option
0,3,13,58,7,16,2,71,0,10 shakira song prove hopeless romantic: 'te necesito' 'me enamore'
0,2,12,39,1,10,0,51,0,megyn kelly doesnt deny report leaving fox news cnn
0,3,4,69,1,15,0,73,0,gop proposal would trigger fine unapproved video house chamber wake sit-in
0,1,4,48,0,10,3,52,0,aviation expert suggest air france flight 447 broke midair
0,1,1,58,0,9,0,59,0,sunday school teacher arrested suspicion kidnapping murder
0,2,4,36,1,7,0,40,0,avison young greg kraut take developergig
0,3,4,69,0,13,0,73,0,armed police storm tube train bank station report passenger wielding knife
0,2,9,37,1,8,0,46,0,"everyone pay hefty price segregation, study say"
0,3,8,33,0,7,0,41,0,donald trump poised become misstater chief
0,3,3,52,0,9,0,55,0,silicon valley prepares take trump immigration agenda
0,1,6,38,2,7,2,44,0,"katharine close, 13, win scripps national spelling bee"
0,1,6,26,0,8,0,32,0,blagojevich make day way
0,2,1,69,0,12,0,70,0,texas county hope cash filling empty jail undocumented immigrant
0,1,5,23,0,5,0,28,0,happy gilmore something
0,3,8,31,0,8,0,39,0,gop lawmaker struggle unite health bill
0,1,2,70,0,10,0,72,0,sweden suspends commercial flight iraq amid allegation attempted shootdown
0,2,11,58,1,13,0,69,0,everyone trying guess gender beyoncs twin latest instagram
0,3,4,73,0,11,0,77,0,flooding cyclone debbie leaf town reeling rockhampton prepares inundation
0,1,5,44,2,10,0,49,0,timekeeping pause new year 'leap second'
0,3,3,30,1,7,0,33,0,"eagle chick hatches, live webcam u"
0,3,3,47,1,10,2,50,0,tory mp 90-minute attempt talk domestic violence bill
0,3,2,51,1,10,0,53,0,want help northern child? become pushy southern parent
0,3,6,65,4,9,0,71,0,"emmanuel macron: underestimate youth inexperience, bernard-henri levy say"
0,2,14,54,2,12,0,68,0,chainsmokers teamed sony first 'lost music' vr festival experience
0,3,14,53,1,14,0,67,0,"wife pulse nightclub gunman omar mateen knew would attack, u attorney say"
0,3,1,36,0,5,0,37,0,kabul military hospital come attack
0,3,2,39,6,9,0,41,0,"planes, trains, cars, bus what's best earth?"
0,3,2,55,3,12,0,57,0,trump tough talk leak one thing. action tell another tale.
0,2,14,56,2,13,2,70,0,"cult beauty brand glossier raise $24m series b open retail stores, go international"
0,1,2,74,1,10,0,76,0,"pittsburgh playwright pen furry musical, invite anthrocon attendee observe reading"
0,2,16,54,2,15,0,70,0,coral bleaching ravaged great barrier reef. may hit another wave.
0,1,6,35,0,7,0,41,0,intel invest despite drop quarterly income
0,1,5,29,0,5,0,34,0,afghan legislator killed bomb attack
0,1,3,35,2,6,4,38,0,eurovision 2008: first semi-final held belgrade
0,1,7,30,0,9,0,37,0,bad time spur flight job viewed safe
0,1,6,42,0,8,0,48,0,british pop star leona lewis break u billboard record
0,1,3,54,0,9,4,57,0,australia name squad remaining 2010 football world cup qualifier
0,3,3,45,3,7,0,48,0,democrat post-election playbook: stay big california
0,2,9,46,2,7,0,55,0,report: islamic state commander omar al-shishani clinically dead
0,1,7,48,0,8,0,55,0,cindy sheehan arrested inside rayburn building washington dc
0,2,8,75,1,16,2,83,0,france allow under-18s watch film featuring real sex loosens movie classification law
0,3,9,42,3,8,0,51,0,uber slayer: china didi beat ride-hailing superpower
0,1,3,25,0,4,0,28,0,typhoon megi head towards china
0,1,6,69,0,10,0,75,0,wikinews interview spanish paralympic track field athlete elena congost mohedano
0,1,9,38,1,8,0,47,0,foul ball leaf wright limping; hobbled youkilis
0,1,1,26,0,4,0,27,0,mayor back global warming pact
0,3,14,51,2,14,2,65,0,20 acre chennai lake dumping ground city's metro rail project!
0,1,5,59,1,9,0,64,0,"eurovision win, norwegian show patriotism constitution day"
0,2,3,52,3,10,0,55,0,u scientist prepare fight back trump's 'war science'
0,1,3,64,0,10,2,67,0,greek newspaper report british spy involved torturing 28 pakistani citizen
0,2,3,44,0,9,0,47,0,squid may become favourite uk meal sea become warmer
0,3,1,60,0,11,0,61,0,people paid migrant worker stand line overnight barbecue pork
0,2,8,46,1,10,0,54,0,beer diplomacy: another investment follows visit xi jinping
0,2,2,30,0,6,0,32,0,man jailed shooting cat surrey
0,3,10,51,1,10,0,61,0,uber share unbelievable list outrageous sh*t people left behind
0,1,7,29,0,7,0,36,0,subsidy plan seek cut malaria drug cost
0,1,2,23,0,6,3,25,0,250 young quaker light lake
0,3,1,49,0,7,0,50,0,crew search toddler missing amid tornado destruction
0,3,10,62,1,11,0,72,0,zacks: twitter struggle convince advertiser return following bot scandal
0,1,3,17,0,3,0,20,0,paid handsomely stay
0,1,2,50,0,7,0,52,0,australian opposition vow disrupt parliament friday
0,2,3,52,2,10,0,55,0,parent angered 'jojo bows' banned school across country
0,2,4,51,1,9,0,55,0,chaos theory donald trump: sowing confusion tweet
0,2,8,36,1,7,0,44,0,health company think fat-freezing new botox
0,1,3,27,0,6,0,30,0,chad call un troop withdraw
0,1,6,33,0,6,0,39,0,democrat qualm war afghanistan
0,1,7,47,1,8,0,54,0,basketball-playing brother together apart court
0,3,7,41,0,8,0,48,0,cnn spanish service move youtube venezuela ban
0,1,2,34,0,6,0,36,0,osama bin laden praise martyrdom video
0,3,8,47,1,10,0,55,0,"boy pull gun classmate demand chicken mcnugget, nypd say"
0,2,9,82,3,15,0,91,0,anti-donald trump protester try set fire outside trump international hotel washington dc
0,2,14,45,0,11,0,59,0,republican think donald trump changed gop better
0,2,5,80,0,12,0,85,0,bbc investigating whether sherlock series finale leaked office russian state broadcaster
0,1,5,56,0,12,0,61,0,felipe massa take pole first night formula one race singapore
0,1,6,33,0,8,3,39,0,trustee madoff case processing 100 case week
0,3,4,68,2,13,0,72,0,thousand demonstrated trump philly. new era perpetual protest?
0,1,2,34,1,5,0,36,0,netanyahu quits israel's pullout plan
0,2,4,62,4,13,0,66,0,shocked donald trump's 'travel ban'? israel similar policy decade
0,3,18,56,2,16,0,74,0,mohamed el-erian see economy fork road; president trump picking path
0,2,10,53,2,9,2,63,0,pakistani singer-turned-preacher junaid jamshed among 48 dead plane crash
0,3,2,37,0,6,0,39,0,amputated foot get instagram account
0,2,11,57,0,10,0,68,0,former trump aide join conservative broadcasting group political analyst
0,1,3,53,0,9,0,56,0,queensland premier aim move australian federal politics
0,3,11,58,1,13,0,69,0,new michael bay movie show america ruin aftermath trump-like president
0,1,10,53,2,12,0,63,0,"north korean leader, thin limping, return assembly gain new term"
0,1,3,50,2,8,0,53,0,thailand's fugitive ex-pm sentenced two year corruption
0,1,2,32,0,4,2,34,0,israel release 26 palestinian prisoner
0,3,7,36,0,9,0,43,0,trump name rick perry pick energy secretary
0,3,11,46,5,11,0,57,0,ricky martin talk la vega residency 'tonight show': 'i cannot wait'
0,1,2,42,1,6,0,44,0,"truck carrying explosive crashes, explodes utah"
0,3,6,39,0,6,0,45,0,thousand still trapped aleppo evacuation stall
0,2,8,44,4,9,0,52,0,"nhl, mlb player union support u.s. woman hockey playersboycott"
0,1,2,54,0,9,0,56,0,seven dead gunman open fire netherlands shopping centre
0,3,8,43,1,8,4,51,0,forbes name scarlett johansson 2016's highest grossing actor
0,2,15,46,0,14,0,61,0,puppy striking pose front dog statue leaving peopleshook
0,2,5,27,1,6,0,32,0,austerity? saudi itinerary
0,3,2,43,0,8,0,45,0,germany spends defence miss nato target
0,2,4,47,6,12,0,51,0,first 'honest' oscar ballot in: 'i hated arrival sucked'
0,2,3,65,0,14,0,68,0,internet want bring rare picture harriet tubman back homestead
0,3,3,43,1,6,0,46,0,police taking statement george michael death
0,1,5,22,0,6,3,27,0,doctor report 378 dead sri lanka
0,2,9,46,1,9,2,55,0,hydraulic press obliterating furby give 90 kid nightmare
0,3,1,64,1,10,0,65,0,deadly calls: domestic dispute among dangerous assignment police
0,1,8,35,1,10,1,43,0,two editor share no. 2 spot associated press
0,1,8,59,1,12,4,67,0,"mark webber win 2009 brazilian grand prix, jenson button brawn win championship"
0,1,2,50,0,8,0,52,0,finland scramble fighter jet respond russian aircraft
0,1,1,46,0,6,0,47,0,american soldier accused desecrating enemy body
0,3,8,39,0,8,2,47,0,11 arrested protesting conservative speaker nyu
0,3,4,66,2,11,0,70,0,"spain north africa enclave, authority find migrant stashed inside suitcase"
0,3,2,57,0,11,0,59,0,whatsapp letting handful startup test business chat tool
0,2,6,46,2,10,0,52,0,"alex ovechkin say he's going olympics, despite nhl say"
0,3,12,30,0,7,0,42,0,aol ceo tim armstrong optimistic yahoo deal
0,3,2,56,0,9,0,58,0,jimmy greave leaf hospital month suffering severe stroke
0,1,3,30,2,5,0,33,0,u.n. denied access guantanamo inmate
0,1,5,52,0,10,0,57,0,polish president lech kaczyski dy plane crash russia
0,1,6,35,0,9,2,41,0,renowned indian guru r satya sai baba dy aged 84
0,2,8,61,1,13,3,69,0,clinton family foundation donated $100g nyt group year paper endorsed hillary
0,3,9,47,2,10,0,56,0,"there's upside australian dollar yet, deutsche bank say"
0,3,3,42,3,9,6,45,0,"tara palmer-tomkinson almost 200,000 debt died"
0,1,4,67,1,14,0,71,0,"one shop defies court order, one shop return work dublin thomas cook occupation"
0,2,5,53,2,12,0,58,0,"here's blizzard forecast fizzled sleety mess nyc, philly"
0,3,2,62,2,9,0,64,0,trump hardline immigration rhetoric run obstacle including trump
0,2,7,66,2,14,0,73,0,'going clear' director making documentary ousted fox news bos roger ailes
0,2,1,67,1,11,0,68,0,"grammar school giving priority disadvantaged pupils, new study show"
0,2,6,57,0,11,0,63,0,new cat evie ossie join westminster moggies cabinet office mouser
0,1,3,50,0,7,0,53,0,former serbian president milutinovic acquitted war crime
0,3,6,15,0,4,0,21,0,good luck killing epa
0,3,8,40,0,11,0,48,0,rebel ukraine say commander killed car bombing
0,1,3,41,2,7,0,44,0,south african police probe 'racist' image facebook
0,2,2,84,5,17,5,86,0,"high school teacher auctioning 1,100-item toy collection help boy, 4, get special off-road wheelchair"
0,2,8,32,2,7,0,40,0,watch alec baldwin turn trump 'the bachelor'
0,3,9,44,0,9,0,53,0,copper rally gain pace china boost inspires chart watcher
0,2,5,57,4,11,0,62,0,"duterte philippine president, death squad mayor"
0,3,13,54,1,12,0,67,0,grad lifevoice: video sharing help hone interviewing skill
0,3,1,56,2,8,0,57,0,"bushfire-ravaged town rebuilt, planning expert warns"
0,2,4,57,4,11,0,61,0,'im looking forward getting home': eleanor hawkins fly back britain
0,1,8,28,1,9,0,36,0,student boston u. may tied third case
0,3,8,49,1,9,0,57,0,"jeff session confirmed attorney general, capping bitter battle"
0,1,6,32,1,6,0,38,0,survivor high-seas drama return france
0,1,10,30,0,10,1,40,0,abc merge 2 tv unit streamline cut cost
0,3,13,50,1,12,0,63,0,"honour victim quebec city mosque shooting, eiffel tower go dark"
0,1,9,46,1,8,0,55,0,lehman one-shot lead goosen transition championship
0,2,4,64,2,9,0,68,0,"candidate crisscross wisconsin, leader trump, clinton stare upset"
0,3,18,58,1,17,0,76,0,watch news anchor fidgeting pen realising live air
0,2,5,40,5,7,0,45,0,trump: smooth transition obama roadblock
0,3,11,49,0,13,0,60,0,kevin durant laugh viral meme draymond green giving pep talk
0,2,11,49,1,11,0,60,0,"spacex chief elon musk set benefits, challenge reusing rocket"
0,2,2,62,0,10,0,64,0,brazil police use pepper spray austerity protest outside rio parliament
0,2,12,50,5,10,2,62,0,misdirected airstrike u.s.-led coalition kill 18 allied fighter syria
0,2,8,44,0,8,0,52,0,apple want original programming expand music service
0,1,1,29,0,4,0,30,0,first fertilised fish fossil found
0,2,13,40,3,10,0,53,0,j. cole share footage swat team raid inspired neighbor
0,1,2,35,0,4,0,37,0,presidential election held afghanistan
0,2,1,26,0,6,8,27,0,oscar 2017 rating lowest since 2008
0,2,7,50,1,9,0,57,0,"caroline kennedy, ambassador whose role transcended embassy"
0,1,5,36,1,6,6,41,0,2007 twenty20 world championship: england v australia
0,3,19,60,2,18,0,79,0,"foodie, baba sehgals latest rap chilli chizza top playlist"
0,3,8,49,0,7,0,57,0,california tattoo removal business surge amid deportation fear
0,3,14,49,0,13,0,63,0,china pakistan use biryani take friendship whole new level
0,1,8,33,2,8,0,41,0,pedro martinez sign phillies go d.l.
0,2,11,50,1,13,0,61,0,tegla loroupe give refugee olympian lesson hope new york time
0,3,15,60,1,13,0,75,0,post demonetisation shortage dollar make way indo-pak diplomatic row delhi
0,1,7,27,1,7,0,34,0,"star twitter, ghost may lurking"
0,3,9,38,2,8,0,47,0,womens march organizer calling womensstrike
0,2,5,29,1,6,0,34,0,history henry mancini's moon river
0,2,8,52,4,8,0,60,0,syrian american offer measured praise airstrikes: bittersweet
0,2,9,38,1,9,0,47,0,congress confirmed mattis heed advice
0,1,4,22,0,4,0,26,0,space shuttle land florida
0,1,4,21,0,4,0,25,0,trial put spotlight merck
0,2,5,40,3,11,0,45,0,"sxsw over, was, sure, favorite part"
0,1,8,47,0,12,0,55,0,pope benedict xvi confirms visit scotland part uk tour
0,1,1,52,0,10,3,53,0,dow fall 340 point amid unemployment retail sale rate news
0,3,9,37,1,11,2,46,0,"slender can 40 ounces, fine wine get ready party"
0,3,4,44,1,9,0,48,0,"bellagio catch fire, causing closure la vega strip"
0,2,3,47,0,9,0,50,0,hundred whale dead mass stranding new zealand
0,3,2,73,2,12,0,75,0,trump call chicago violence easily fixable blame political correctness
0,3,6,44,3,9,1,50,0,jets' brandon marshall: pain pill killed memory 3-td game
0,2,4,39,2,10,2,43,0,"john glenn, first american orbit earth, dy 95"
0,3,3,66,0,12,0,69,0,elector promised vote donald trump receives death rape threat
0,1,8,40,0,8,0,48,0,second accident two day strike delhi subway project
0,1,7,40,1,7,0,47,0,conference tournament help hurt? theory abound
0,1,2,33,0,6,0,35,0,three rebel indonesia killed raid
0,1,2,45,0,6,0,47,0,first television channel esperanto launch online
0,3,16,60,1,16,2,76,0,"la la land bag 14 oscar nominations, dev patel becomes third indian actor get nominated"
0,3,8,52,0,8,0,60,0,tiffany trump brings college boyfriend ross mechanic inauguration
0,2,1,63,0,8,0,64,0,footprint suggest possibility surprisingly tall early human ancestor
0,3,6,43,0,11,0,49,0,obama ban drilling part atlantic arctic
0,3,12,66,4,12,0,78,0,"comey confirms f.b.i. investigation russian election interference, link trump campaign"
0,1,7,33,0,9,4,40,0,gate group plan give 2009 despite loss
0,2,4,52,0,9,0,56,0,archbishop tory mp criticise closure child refugee scheme
0,1,2,41,0,6,0,43,0,parent arrested putting baby craigslist
0,1,2,39,0,5,1,41,0,english wikipedia publishes 3 millionth article
0,2,2,56,2,9,0,58,0,cops: ex-soldier kill service dog boyfriend videotape
0,3,3,64,0,11,0,67,0,harvard researcher say bring woolly mammoth back extinction
0,2,11,44,1,10,0,55,0,prince posthumous year business full weirdo chaos
0,2,2,48,0,11,0,50,0,lazy self order takeout yelling alexa
0,2,3,42,0,9,0,45,0,devon leah still celebrate two year remission
0,2,8,31,4,8,0,39,0,wall: life along u.s.-mexico border
0,2,14,68,4,14,0,82,0,peruvian cardinal slam un modern-day herod pushing abortion zika crisis breitbart
0,3,12,57,4,12,0,69,0,"geraldo rivera responds kendrick lamar's 'damn,' say rap damaging young people"
0,1,6,23,1,5,0,29,0,"uconn, trouble ahead behind"
0,2,15,50,1,17,4,65,0,contra turn 30 year old today 90 kid obsessed video game
0,1,10,40,1,11,2,50,0,no. 11 syracuse stay unbeaten big east win rutgers
0,2,13,65,0,13,0,78,0,rusty patched bumble bee put endangered specie list trump administration delay
0,3,12,35,0,11,0,47,0,sure look like selena gomez weeknd item
0,3,9,43,0,11,0,52,0,star shine light immigration inclusion sag award
0,1,7,34,0,7,0,41,0,north carolina win fourth straight game duke
0,2,9,40,3,10,0,49,0,pelosi: course democrat abortion
0,3,7,67,0,13,0,74,0,terrorist killed philippine gun battle security step amid asean trade talk
0,3,10,45,2,10,0,55,0,adult legally smoke potbut kid interested
0,3,5,54,2,9,0,59,0,laura muir praise brilliant london marathon run joshua griffith
0,1,1,25,1,4,0,26,0,postal worker save baby's life
0,1,10,37,1,11,0,47,0,"reunion next, bush eas back public eye"
0,3,8,25,0,8,0,33,0,theresa may seek clean brexit eu
0,2,3,60,0,12,0,63,0,arriva rail north staff consider strike action role train guard
0,2,4,48,3,8,0,52,0,"u.s. sanction companies, people russia action ukraine"
0,3,11,33,1,11,0,44,0,man dressed spider-man robbery spree nyc
0,3,2,47,1,10,0,49,0,navy: jet modified determines oxygen problem
0,2,12,44,3,10,0,56,0,gauge tell story: lasting u.s. wage growth remains elusive
0,1,6,28,0,6,0,34,0,japan act contain swine flu outbreak
0,3,10,50,0,10,0,60,0,apple moved one step closer featuring wireless iphone charging
0,3,3,42,1,9,3,45,0,ringling bros. circus shutting 146 year
0,1,1,53,0,8,0,54,0,sydney council pay investigator sex prostitute
0,3,4,53,1,13,0,57,0,peace cyprus possible. cypriot decide want
0,3,9,49,3,10,0,58,0,"elton john remembers george michael 'kindest, generous man'"
0,3,10,54,2,10,0,64,0,teddy bridgewater injury: update viking qb's recovery knee surgery
0,2,2,49,0,13,3,51,0,death toll bomb attack syrian evacuee risen 112
0,3,3,88,3,17,0,91,0,donald trump accuses jewish reporter lying tell 'sit down' response anti-semitism question
0,1,8,31,0,8,0,39,0,ebay plan spin skype public offering
0,2,4,59,2,12,0,63,0,photo 'superman' henry cavill holding tree baffling internet
0,2,12,43,3,9,0,55,0,improved u.s.-cuba relation creating surge cuban migrant
0,3,3,44,1,7,0,47,0,bmw's chief designer reportedly quitting company
0,2,1,44,1,9,0,45,0,"northeast brace another blast snow, high wind"
0,1,6,31,2,5,0,37,0,"nhl: penguin defeat thrashers, catch devil"
0,3,4,41,4,10,0,45,0,china new 'sweet spot' cruise industry (ccl)
0,2,7,39,0,7,0,46,0,trump campaign manager conway lead christmas parade
0,1,3,72,0,14,2,75,0,lostprophets singer ian watkins sentenced 29 year prison attempting rape baby
0,3,1,59,1,10,0,60,0,fire survivor teach child fire-safety tool saved family
0,1,2,47,0,8,2,49,0,46 illegal afghan immigrant suffocate truck pakistan
0,2,9,42,1,9,0,51,0,caviar infusion pernod's paris lab aim refresh vodka
0,3,2,79,0,13,0,81,0,russian marine smash bottle burning plank philippine charm offensive
0,2,12,48,2,11,0,60,0,watch 'nurse jackie' cast recall favorite moment show
0,2,4,42,3,9,0,46,0,"year je suis charlie, divided france struggle"
0,2,13,43,1,12,2,56,0,trump-clinton gender gap could largest 60 year
0,2,12,60,2,14,0,72,0,"north dakotans reconsider corporate farming ban, value new york time"
0,2,6,46,1,8,0,52,0,"holiday shipping deadline ups, fedex major retailer"
0,1,7,17,0,4,0,24,0,miss california usa fired
0,3,3,34,1,6,0,37,0,dick's sporting good jump earnings beat
0,2,6,32,2,8,2,38,0,"theranos lay 41% workforce, company say"
0,1,9,27,4,6,0,36,0,insurance giant a.i.g. take ex-chief court
0,1,4,50,0,11,0,54,0,discriminatory job ad central bank turkey asks men
0,2,2,58,0,12,0,60,0,student competitive likely anxious list
0,2,7,30,2,6,0,37,0,recipe dream-come-true french veal stew
0,1,3,25,2,4,0,28,0,u.s. postal rate increase proposed
0,2,8,26,2,7,4,34,0,#askforbes chat: best career advice 2016
0,1,2,52,0,6,0,54,0,michael jackson doctor charged involuntary manslaughter
0,2,11,44,1,9,0,55,0,hometown kid pj dozier guiding south carolina's cinderella run
0,1,2,55,1,8,0,57,0,bush address nation economic crisis; congress debate bailout
0,1,9,46,1,10,0,55,0,last-place cyclist fighting avoid broom wagon tour de france
0,3,6,81,0,17,2,87,0,police reveal cctv three croydon suspect emerges 20 people watched asylum seeker attacked
0,2,7,48,1,8,3,55,0,"indonesia earthquake kill almost 100, team scramble survivor"
0,2,5,38,5,9,2,43,0,"'rocky', 'raging bull' producer robert chartoff dy 81"
0,1,9,43,1,9,0,52,0,"ecuador, resentment ooze long oil company departs"
0,3,5,43,3,10,0,48,0,surprise: beijing's pick lam chosen hong kong's leader
0,2,8,45,1,9,0,53,0,retired miner lament trump silence imperiled health plan
0,2,7,41,0,7,0,48,0,airport boost security fort lauderdale shooting
0,3,1,47,2,11,0,48,0,housing dead: happens city run space?
0,1,9,41,1,12,2,50,0,"17, mets prospect wilmer flores fast track major"
0,1,7,31,1,6,0,38,0,cast bbc's strictly come dancing announced
0,1,5,26,2,7,0,31,0,u.s. gdp see worst drop five decade
0,1,9,47,3,9,0,56,0,"runoff, sometimes blight, aid egyptian fisheries, study say"
0,1,10,45,1,7,0,55,0,canadavotes: liberal incumbent susan kadis running thornhill
0,2,8,37,2,7,0,45,0,'rolling stone' settle lawsuit campus rape story
0,2,7,34,0,9,0,41,0,facebook mount effort limit tide fake news
0,2,2,39,1,8,2,41,0,poll: trump approval bump slightly 40 percent
0,2,4,42,0,8,0,46,0,british royal zara tindall husband mike lose baby
0,3,6,36,5,10,6,42,0,"'sunless sea' wild 350,000-word literary rpg, ipad"
0,2,14,53,3,13,0,67,0,hannity: gop must unite obamacare replacement risk party 'civil war' insider
0,2,6,38,1,6,0,44,0,"sheriff issue statement bundys, white militant"
0,2,11,39,4,9,0,50,0,"nintendos super mario run score revenue, ceo want"
0,1,5,38,1,9,0,43,0,"family five killed staten island, ny house fire"
0,3,9,35,1,8,0,44,0,one direction's member ruling pop news week
0,2,9,46,0,9,0,55,0,carney keep cool inflation surprise slack discovery
0,1,5,54,3,9,0,59,0,"pirate bay case: internet group attack website ""operation baylout"""
0,3,10,50,3,9,0,60,0,charleston victim kin say trial revealed radical truth racism
0,2,7,35,1,7,0,42,0,rio christ statue asking alms amid recession
0,2,14,49,2,14,4,63,0,nba move 2017 all-star game north carolina keep anti-lgbtq law
0,3,1,57,0,10,0,58,0,orphan find happiness mission make stranger smile
0,3,2,44,3,11,0,46,0,hillary clinton say 'ready come woods'
0,2,5,23,2,7,0,28,0,"actually, let moment"
0,3,12,44,2,9,0,56,0,amd ready fight intel 'innovation starved' data center
0,1,1,35,0,7,1,36,0,7th heaven television series come end
0,3,8,35,2,9,0,43,0,"mexico's drug war mark decade amid doubts, change"
0,2,5,30,1,4,0,35,0,"caterpillar turn corner, boost outlook"
0,3,2,53,0,9,0,55,0,woman accused choking girl blocking disney firework view
0,2,2,68,1,13,0,70,0,rhode island man get prison time fatally beating neighbor's small dog cane
0,2,4,44,0,11,1,48,0,tesla blog post declares model superior model 3
0,1,4,28,0,4,0,32,0,another insurgency gain pakistan
0,2,5,46,4,10,0,51,0,notice sarah palins sweater? good. supposed to.
0,2,2,69,2,12,0,71,0,trump offer 'destroy' career texas state senator sheriff complained
0,2,4,53,3,11,0,57,0,what's next hillary? latest move indicate clinton fade away
0,1,4,26,0,5,0,30,0,george bush meet u governor
0,2,6,27,0,8,4,33,0,home buyer backed offer 2016
0,1,2,54,1,9,0,56,0,"north korea confirms receipt funds, nuclear shutdown proceed"
0,3,6,27,1,4,0,33,0,understand #deleteuber
0,1,2,64,0,11,0,66,0,australian health worker close intensive care unit victoria next week
0,1,3,58,0,10,0,61,0,british conductor edward downes wife die double assisted suicide
0,1,7,35,0,8,0,42,0,case could open border doping fight cycling
0,3,9,45,1,11,1,54,0,jazz escape game 1 win vs. clipper despite rudy gobert injury
0,3,3,43,5,10,2,46,0,kim jong-nam killing: suspect 'was paid $90 baby oil prank'
0,2,4,37,1,6,0,41,0,jonny dymond track president trump's third week
0,1,2,59,2,9,0,61,0,monday's no-confidence vote may signal end current canadian goverment
0,2,1,19,1,5,3,20,0,robot healed 9/11hero
0,2,2,67,0,11,1,69,0,2 including teacher reported dead shooting san bernardino elementary school
0,3,3,56,3,13,2,59,0,"missing woman, 20, found dead car pulled missouri river, report say"
0,3,2,31,1,5,0,33,0,gambian vote first post-jammeh poll
0,2,7,30,0,7,0,37,0,night locked smartphones
0,1,4,35,3,9,0,39,0,czech pm call obama's rescue plan 'road hell'
0,2,12,40,0,11,0,52,0,cable news sure could talk muslim muslim ban
0,2,11,44,1,10,0,55,0,white house continues insist prove trump's wiretap claim
0,2,8,33,0,9,0,41,0,using sens age obsessed sight
0,3,8,35,3,10,4,43,0,"earnings, donald trump, stock best friend 2017"
0,1,2,37,0,6,0,39,0,thirteen dead ethnic clash nigeria
0,1,2,41,3,8,2,43,0,"12-year-old school boy sex change sussex, england"
0,1,1,38,0,7,4,39,0,australian copyright law overhauled 2006
0,1,1,34,1,6,2,35,0,6.8 earthquake strike coast colombia
0,2,1,51,1,10,0,52,0,mom spends holiday teen received son's donated heart
0,3,12,43,2,7,0,55,0,report: record number company lgbtq-inclusive policy
0,1,6,48,1,10,4,54,0,film travis county da's investigation texas election 2002
0,1,5,29,0,4,0,34,0,australian rage arson suspect
0,3,3,54,3,9,0,57,0,michael moore call protester 'disrupt' trump's inauguration
0,1,4,47,0,7,0,51,0,european space agency seek volunteer mar simulation
0,1,3,29,0,3,0,32,0,google launch google spreadsheet
0,3,4,47,2,10,0,51,0,"season end super bowl, cowboy primed future"
0,1,8,33,1,7,0,41,0,"wyoming, debate rage elk feeding program"
0,3,2,76,3,15,0,78,0,ohio youngest death row inmate never touched murder weapon. sentenced death?
0,1,4,15,0,4,0,19,0,chance get outside
0,3,2,32,1,5,0,34,0,deadly attack near egypt's old monastery
0,1,8,43,0,8,0,51,0,new afghanistan commander rethink measure success
0,3,15,38,3,13,0,53,0,tempted move u.s.? new zealand want help escape
0,3,10,34,1,9,0,44,0,analysis: president trump prep war base
0,1,2,50,0,9,0,52,0,nuclear leak japan quake worse first reported
0,3,5,50,3,7,0,55,0,"austrian presidential campaign echo donald trump, u.s. election"
0,3,11,42,2,11,2,53,0,"biloxi crash: four killed, 30 hurt train hit charter bus"
0,1,7,27,2,6,0,34,0,blackrock draw scrutiny u.s. adviser
0,3,8,36,0,7,0,44,0,kim kardashian planning third child kanye west
0,1,1,68,1,12,0,69,0,"plant may adapt faster climate change previously thought, new study show"
0,1,2,41,0,6,0,43,0,two british serviceman killed roadside bombing
0,3,8,45,3,9,0,53,0,draymond green star parody kendrick lamar's 'humble' video
0,1,4,49,0,7,0,53,0,bush authorizes oil release strategic petroleum reserve
0,1,1,43,0,6,0,44,0,canadian military host first gay military wedding
0,1,5,26,0,5,0,31,0,taliban attack nato base repelled
0,1,8,30,0,7,0,38,0,ubs given short window release document
0,1,2,18,0,5,2,20,0,bomb blast kill 27 iraq
0,2,12,61,3,13,0,73,0,"carrie fisher 'out emergency room' suffering heart attack plane, say brother"
0,2,10,44,0,9,0,54,0,trump decline publicly declare support steve bannon
0,3,13,35,2,11,4,48,0,"gaby moreno, chamanas perform annual 2017 fimpro"
0,1,8,26,2,8,0,34,0,derosa never position u.s.
0,1,6,30,1,8,5,36,0,$112 million caterpillar loss first 17 year
0,2,1,56,0,11,0,57,0,bank told protect customer money transfer scam
0,2,2,45,2,9,0,47,0,"nj comic movie bit part backfires, result gun charge"
0,1,2,43,0,7,2,45,0,activist claim police harrassment g20 summit nears
0,1,3,21,0,2,0,24,0,ira weapon decommissioned
0,3,2,67,3,12,0,69,0,"obama warns ""history cast harsh judgment"" guantanamo facility closed"
0,1,2,34,0,5,0,36,0,north korea missile launch look imminent
0,2,12,44,2,11,0,56,0,james mcbride discusses kill mockingbird wsj book club
0,3,1,17,2,1,0,18,0,'trumpcare' collapse
0,1,5,38,3,8,0,43,0,"israeli pm, ariel sharon, woken coma, move limb"
0,1,3,32,0,6,0,35,0,coal miner trapped west virginia mine
0,3,11,35,4,11,2,46,0,"donald trump made dollar rise 5.6%, he's making fall"
0,1,4,31,1,6,0,35,0,"peacekeeping, muddling mission"
0,3,10,39,5,11,0,49,0,'andre drummond guest verse rap song: 'im rapper'
0,1,5,30,0,5,0,35,0,consumer price remained steady april
0,3,10,54,1,11,0,64,0,carmelo anthony trade rumors: celtic interested deal knicks star
0,1,4,37,0,8,0,41,0,india win first cricket test south africa
0,3,4,51,0,11,0,55,0,chart show chinese missile could target u
0,1,4,30,2,7,2,34,0,apple inc. co-founder steve job dy aged 56
0,3,14,56,3,14,2,70,0,kanpur's 'calculator girl' dilpreet kaur set 11 national two world record year
0,1,5,25,0,5,0,30,0,china said harass right lawyer
0,1,3,48,0,8,0,51,0,serbian goal keeper debut croatian football club rijeka
0,1,5,48,0,9,0,53,0,ipcc claim himalayan glacier based science
0,1,4,66,1,11,0,70,0,scott brown win special election massachusetts's senate seat upset victory
0,1,2,49,0,6,0,51,0,canadian government apologizes deportation victim arar
0,1,4,63,3,10,0,67,0,"imperial college london geology student fined china ""illegal map-making"""
0,3,8,39,3,9,0,47,0,"mall america, nation's biggest, hire first black santa"
0,1,1,24,0,4,0,25,0,drinking habit tied gene
0,2,4,44,1,8,0,48,0,gynaecologist rob jones: hundred woman legal claim
0,1,1,44,0,6,0,45,0,greek government face censure motion opposition
0,3,2,47,2,8,0,49,0,uber us 'secret program' greyball hide regulator
0,3,5,55,2,11,0,60,0,vice president penny declares end 'strategic patience' north korea
0,3,8,46,0,7,0,54,0,undocumented immigrant commit crime face tougher policy
0,2,1,54,1,9,0,55,0,gorgeous iridescent umbrella tell supposed rain
0,2,12,38,5,13,0,50,0,"listen mike made-it's new track ""on come up"" f/ big sean"
0,3,2,51,1,11,5,53,0,downed power line trap 75-100 people portland light rail hour
0,2,12,59,0,11,0,71,0,nobel prizewinners show immigration important americanscience
0,3,7,41,1,6,0,48,0,spicer: expect new transgender student policy wednesday
0,1,7,43,0,9,0,50,0,injury force meissner hughes pull national
0,3,8,34,3,7,0,42,0,female founders: we're joining women's march
0,3,6,47,0,8,0,53,0,expert split effectiveness previous russian sanction
0,1,2,48,0,7,0,50,0,contestant seriously injured live german game show
0,2,3,65,3,13,0,68,0,vpns getting extremely popular here's everything need know
0,2,3,40,4,7,2,43,0,"al jarreau, seven-time grammy-winning singer, dy 76"
0,2,10,52,4,10,0,62,0,clapper: institution assault president trump breitbart
0,1,2,43,1,6,0,45,0,"russian troop advance georgia, violating truce"
0,1,2,54,1,10,2,56,0,philadelphia break 80 year old building lease; move evict scout
0,2,1,64,1,8,0,65,0,gravitational waves: breakthrough discovery century expectation
0,2,12,70,4,14,0,82,0,president trump first weekly address: administration hit ground running record pace
0,1,2,78,2,10,4,80,0,2008 taiwan presidential election: first official debate citizen journalists' participation
0,1,9,37,2,9,0,46,0,"season nears end, soccer's giant stay trophy chase"
0,2,1,52,1,10,0,53,0,unlimited editions: music box set managed survive
0,3,17,56,0,16,0,73,0,people saying teen best babysitter dressed mermaid
0,1,2,28,0,5,0,30,0,tiger kill handler shanghai zoo
0,2,5,46,2,11,0,51,0,"preview: daryl hall john oates, duo joined gunfight"
0,2,8,40,0,9,0,48,0,pentagon say civilian likely killed yemen raid
0,2,4,37,1,9,4,41,0,uconn fire bob diaco 11-26 mark three season
0,1,1,56,2,8,0,57,0,"pennsylvania father kill two daughters, wife, commits suicide"
0,2,8,46,1,9,0,54,0,political world reacting trump immigration order
0,1,4,57,1,12,0,61,0,end era: space shuttle atlantis launch final mission program
0,3,6,33,0,6,0,39,0,duterte iconic jeepneys crosshairs
0,1,5,20,0,5,0,25,0,making case ge capital
0,1,5,33,0,6,0,38,0,proposal raise income tax pennsylvania
0,1,4,27,0,4,3,31,0,peirsol reclaims 200 backstroke record
0,1,4,29,0,4,0,33,0,moderate elected president somalia
0,1,6,24,1,6,0,30,0,smart move letting pick price?
0,2,2,68,0,13,0,70,0,east aleppo resident flee life airstrikes continue pound city
0,3,14,69,8,13,0,83,0,'harry potter' alum help preview london studio tour's new 'forbidden forest' attraction (spider alert!)
0,1,6,29,1,6,0,35,0,yet another vogue iphones: video game
0,1,3,36,0,5,0,39,0,small earthquake reported solomon island
0,3,2,72,2,17,0,74,0,un kick talk global nuclear weapon ban major nuclear power oppose
0,1,1,59,0,8,0,60,0,oklahoma trooper leave altercation ambulance personnel
0,2,6,63,3,11,0,69,0,"glastonbury line-up leak? ed sheeran, diana ross lorde among alleged performer"
0,3,9,53,5,13,0,62,0,emma stone call b.s. warren beatty: 'i holding best actress envelope'
0,3,4,46,2,10,2,50,0,"nyc's rikers jail slated closure within 10 years, mayor say"
0,1,7,31,0,8,0,38,0,blog geared woman yield new site slate
0,1,2,41,0,9,0,43,0,rebel leader say run president haiti
0,2,4,21,1,5,0,25,0,mexico city policy?
0,1,5,37,0,5,0,42,0,sadc call transparent mozambique election
0,1,12,28,4,9,0,40,0,l.p.g.a. seek new leader chart future
0,1,1,54,0,8,0,55,0,large particle accelerator explore frontier physic
0,2,5,26,0,4,0,31,0,camila cabello leaf fifth harmony
0,3,8,23,1,6,0,31,0,isis: life commerce mosul
0,1,2,34,0,6,0,36,0,man kill five police officer shanghai
0,1,2,44,0,6,0,46,0,warning colombia possible volcanic eruption
0,2,5,31,0,3,0,36,0,situation roomverifizierter account
0,2,8,45,1,12,3,53,0,falcon getting roasted blowing 28-3 lead super bowl
0,2,1,50,0,7,0,51,0,philly construction crew find coffin colonial time
0,3,9,39,1,11,0,48,0,take spin lapland! car buyer get exotic pitch
0,1,7,44,2,7,0,51,0,"synthes, medical device maker, accused improper marketing"
0,2,11,47,2,12,0,58,0,u navy destroyer fire 'burst' warning shot iranian small craft
0,1,6,30,1,7,4,36,0,"union membership sharply 2008, report say"
0,3,10,57,5,9,0,67,0,joe biden: 'there's something really wrong' we're celebrating bipartisanship
0,2,3,41,1,7,0,44,0,david sweat: grew frustrated breakout partner
0,1,3,42,0,7,0,45,0,kurmanbek bakiev sworn president kyrgyzstan
0,1,5,48,1,8,0,53,0,top two aide quit u presidential candidate mccain's campaign
0,2,2,32,1,6,3,34,0,weight-loss surgery 500kg woman india
0,2,3,31,2,10,0,34,0,act donald trump really pig
0,2,2,36,2,5,0,38,0,liberal get behind marriage (opinion)
0,2,9,47,1,12,4,56,0,china see presumptive winner 2022 olympics china real time report
0,1,4,37,1,4,0,41,0,pentagon's quadrennial defense review released
0,2,6,53,6,11,0,59,0,'onsen summit': vladimir putin meet japan's shinzo abe 'heal rifts'
0,2,9,25,2,8,1,34,0,debt dirty 4-letter word
0,2,6,48,0,10,0,54,0,mike penny widens u rift europe nato defence spending
0,3,9,42,1,8,0,51,0,china-led development bank add member status boost
0,3,4,31,1,7,0,35,0,"savings, longevity year fitness"
0,3,10,47,0,9,0,57,0,native american ready battle trump dakota access pipeline
0,1,2,37,3,7,1,39,0,"4-year-old boy killed dog liverpool, england"
0,3,14,42,3,11,0,56,0,maybe time stop calling gop obamacare plan 'replacement'
0,1,1,36,1,7,0,37,0,"study say clean sponge, microwave"
0,1,2,34,0,6,0,36,0,thirteen people died london bus bombing
0,1,1,43,0,5,0,44,0,canberra central business district trial urinal
0,1,2,32,0,6,0,34,0,power outage affect many area chile
0,1,3,61,1,11,2,64,0,"japanese survivor hiroshima nagasaki atomic bombing dies, aged 93"
0,2,10,53,1,9,0,63,0,"richard sherman think antonio cromartie grateful, critical"
0,3,15,60,3,14,0,75,0,"angelina jolie get emotional talking divorce brad pitt, say family"
0,2,8,41,1,7,0,49,0,school-voucher rule trip student success louisiana
0,1,6,31,0,7,3,37,0,chicago link street camera 911 network
0,2,2,45,0,10,0,47,0,island nation palau want rich tourist visit
0,2,4,54,2,10,0,58,0,princess paris jackson say dad michael treated like royalty
0,3,6,41,1,8,0,47,0,palm sunday: pope francis celebrates mass vatican
0,3,9,77,1,18,2,86,0,national organization woman call fox news fire bill o'reilly 12 company pull ad
0,3,13,58,0,11,0,71,0,emotional steve smith confirms retirement interview following final nfl game
0,1,2,32,0,6,0,34,0,gunman kill seventeen party mexico
0,1,6,40,1,7,0,46,0,"asian hispanic minority growing, slowly"
0,2,11,53,1,10,0,64,0,"new york, activist prepare bystander take action harassment"
0,1,6,34,0,7,0,40,0,astronomer find planet closer size earth
0,2,2,27,2,5,0,29,0,trump say nato 'no longer obsolete'
0,2,2,32,0,6,0,34,0,ghent library move home via human chain
0,2,1,49,1,9,1,50,0,once-conjoined twin going rehab 9 week separation
0,1,2,34,1,5,2,36,0,major 7.3 magnitude earthquake hit honduras
0,1,6,26,0,6,0,32,0,lennar say home sale rose quarter
0,2,6,36,1,8,0,42,0,picture oakland mourns victim warehouse fire
0,3,2,45,2,8,3,47,0,police: man streamed 114-mph drive suspended license
0,2,11,57,3,10,0,68,0,trentemller savages' jehnny beth share intimate studio session video: watch
0,1,6,35,0,7,1,41,0,moderate cleric among 9 killed pakistan blast
0,1,8,31,1,8,0,39,0,"ruling intel, unlikely drag"
0,3,2,49,1,9,0,51,0,"month tinder date, threatened commit suicide"
0,3,6,32,2,6,0,38,0,detained turkey: journal reporter story
0,2,4,32,1,9,0,36,0,curse putney general store?
0,3,11,50,4,10,0,61,0,oscars: mexican actor gael garcia bernal bash trump border wall (video)
0,2,3,58,0,12,0,61,0,former police chief face retrial death black man south carolina
0,1,2,27,0,5,2,29,0,explosion baghdad claim 28 life
0,1,6,30,1,6,0,36,0,"cash hand, technology giant go shopping"
0,3,3,15,0,2,0,18,0,old hollywood easter
0,3,4,70,0,12,0,74,0,teenager westminster bridge london terror attack describes moment hit
0,3,15,56,3,12,0,71,0,behind x ambassador tom morello's espn college football theme song: exclusive video
0,3,13,65,0,14,0,78,0,woman seemingly convinced husband adopted coyote actually believed
0,2,11,49,2,10,0,60,0,"comcast xfinity truck block traffic, sends car careening icy road"
0,3,2,63,1,9,0,65,0,audience getting increasingly hostile republicans' town hall event
0,2,2,55,2,8,2,57,0,"australian economy grows 1.1pc december quarter, recession averted"
0,3,10,48,1,13,2,58,0,italian cop arrest 34 race foil plot steal enzo ferraris corpse
0,1,5,49,0,8,0,54,0,crime new orleans sharply increase hurricane katrina
0,3,11,51,2,11,0,62,0,"ubers asian rival race ahead service like manicures, home cleaning"
0,2,4,42,0,6,0,46,0,mylan allegedly overcharged pentagon forepipens
0,1,4,52,1,8,0,56,0,russian minister: south ossetia reporting biased western medium
0,1,2,42,0,6,0,44,0,donkey blogger facing jail sentence azerbaijan
0,2,12,47,2,11,0,59,0,republican still mad health care 'right' blame reagan
0,1,8,47,2,7,0,55,0,security council recommends ban ki-moon un secretary-general
0,2,13,49,1,13,2,62,0,"11 stunning photo iconic stars, story behind taken"
0,3,7,29,0,6,0,36,0,shea moisture nix ad huge backlash
0,2,2,73,0,15,6,75,0,un say world face largest humanitarian crisis since 1945 20 million risk starvation
0,3,5,30,3,7,0,35,0,west brom v liverpool: premier league live!
0,1,2,32,0,5,0,34,0,russia void border treaty estonia
0,3,8,34,1,6,0,42,0,special immigrant visa worth billion face d-day
0,1,6,33,0,7,1,39,0,5 child presumed dead houston flash flood
0,3,7,30,0,6,0,37,0,sean spicer cause uproar hitler gaffe
0,1,7,33,0,7,0,40,0,cobbled effort seek fill food safety vacuum
0,2,12,54,2,11,4,66,0,investing 2016's worst-performing industry may best portfolio play
0,2,16,63,2,15,0,79,0,"kargil martyr's son follows path father, sacrifice life fighting country"
0,2,1,45,1,8,1,46,0,einstein letter auctioned expected $1 million
0,2,4,49,6,8,0,53,0,philippine duterte say didnt really mean separation u.s.
0,3,5,76,4,11,0,81,0,"centrelink debt recovery: digital transformation agency 'locked out' mygov, robodebt scheme"
0,3,6,44,0,8,0,50,0,trump name dow chemical ceo head manufacturing council
0,1,6,32,0,6,0,38,0,santander offer pressure rival match
0,3,2,58,2,13,0,60,0,"rare ""ring fire"" solar eclipse give sky gazers special treat sunday"
0,2,2,66,1,12,0,68,0,el chapos lawyer say drug kingpin subjected overly strict jail condition
0,1,1,26,0,5,0,27,0,india may rise regional power
0,2,2,89,2,18,0,91,0,military plane crash spain 'was caused computer data accidentally wiped three engines'
0,1,2,53,0,7,0,55,0,internet company offer organ executed chinese prisoner
0,3,9,51,2,7,0,60,0,"serena williams, reddit co-founder alexis ohanian announce engagement"
0,3,5,75,0,13,0,80,0,french presidential hopeful franois fillon face inquiry payment wife mp fund
0,3,20,58,4,16,1,78,0,watch nbc today show excerpt free online paralyzed 6-year-old girl take first step yahoo view
0,1,4,26,0,4,3,30,0,ru486 debate enters australian senate
0,3,4,41,1,7,0,45,0,donald trump's irate letter alex salmond revealed
0,1,5,33,1,6,6,38,0,2007 twenty20 world championship: india v pakistan
0,3,3,32,0,6,0,35,0,bowe bergdahl appeal obama pardon
0,1,3,40,0,5,0,43,0,romanian parliament ratifies eu accession treaty
0,1,5,45,1,10,0,50,0,"u nazi leader talk barack obama, economy"
0,3,3,49,0,7,0,52,0,prince harry receives colourful welcome nepalese embassy
0,1,9,36,2,10,0,45,0,"truth, revealed bugs: case brookey lee west"
0,1,8,26,2,6,0,34,0,u.s. move top mexican drug cartel
0,1,6,21,0,5,0,27,0,two knicks worth keeping
0,1,3,57,1,10,2,60,0,"19th century stable buffalo, new york officially saved demolition"
0,1,7,38,0,8,0,45,0,literary legend fight ventura county library
0,1,6,33,0,6,0,39,0,albany bar placement agent pension fund
0,3,1,69,2,10,0,70,0,"tasmania's health system underfunding costing lives, doctor health union say"
0,1,2,26,0,4,0,28,0,bonobo chimp threatened congo
0,2,3,46,1,8,0,49,0,"facing criticism, gabbard personally pay syria trip"
0,1,3,35,0,7,2,38,0,former communist leader hua guofeng dy age 87
0,3,9,41,3,11,0,50,0,"frank ocean premiere new version ""slide me"" f/ young thug"
0,1,6,29,0,5,0,35,0,steady guard guide spartan past kansa
0,3,2,47,3,10,0,49,0,new primate discovered angola -- already danger
0,3,14,67,2,13,0,81,0,"robert vadra attack govt demonetisation, say desperate coordinating bank"
0,2,2,47,0,8,0,49,0,great american whitelash claim new victim every day
0,2,6,33,4,7,0,39,0,ross kemp: people still think im grant mitchell
0,3,2,51,0,9,0,53,0,mormon history scholar file court brief trump travel ban
0,2,7,37,1,9,0,44,0,donald trump play golf tiger wood breitbart
0,2,15,39,1,12,3,54,0,isro beat record launching 103 satellite one shot!
0,2,14,59,4,15,2,73,0,joe biden defends hillary clinton: woman battered 30 year breitbart
0,2,17,49,1,14,0,66,0,south carolina teen nabbed airport charged trying join isi nbc news
0,2,10,44,4,9,0,54,0,"ben affleck say he's directing 'the batman,' surprising nobody"
0,3,10,42,0,10,0,52,0,gop health bill go house committee opposition mount
0,2,2,58,2,10,0,60,0,trump represent american view climate change: visual guide
0,3,7,39,2,10,0,46,0,"brazil zika families, life struggle scare"
0,2,2,59,1,13,0,61,0,saudi arabia call end tax-free living oil slump continues bite
0,1,5,44,0,8,4,49,0,chicago white sox win 2005 world series baseball championship
0,3,9,51,2,13,0,60,0,mets p noah syndergaard appear extra upcoming 'game thrones'
0,2,1,65,3,17,4,66,0,startup grand vision make hydrogen truck reality 2020 here's plan
0,2,2,61,1,11,0,63,0,andy murray: rising prize money trickle lower ranked player
0,1,2,27,0,5,0,29,0,northern japan hit strong quake
0,3,11,56,1,13,0,67,0,princess cristina spain found guilty fraud trial; husband convicted
0,1,5,34,0,5,0,39,0,concert holocaust survivor condemned
0,3,9,49,0,8,0,58,0,white house reporter still awaiting change president trump
0,3,2,33,0,8,1,35,0,u oil rig count jump 5th straight week
0,2,8,81,1,15,3,89,0,colombian gang leader believed behind 117 murder arrested year-long surveillance operation
0,3,14,60,3,14,0,74,0,"dana white take shot mayweather, say mcgregor would kick head 'to another planet'"
0,2,3,56,0,9,0,59,0,muslim american unite raise fund vandalized jewish cemetery
0,3,1,54,0,7,0,55,0,segregated school persist parent maintain divide
0,2,5,52,1,9,2,57,0,australia day: northern territory turn commemorate january 26
0,1,2,32,0,6,0,34,0,amber alert issued missing utah girl
0,1,7,21,3,5,0,28,0,madden end career n.f.l. analyst
0,1,2,53,0,9,0,55,0,two train collide china killing dozen injuring hundred
0,3,11,38,2,9,0,49,0,"obama praise labor secretary perez, who's weighing dnc bid"
0,3,4,24,0,8,0,28,0,life teen born hiv
0,2,5,63,3,13,0,68,0,"even immediate hurdle iowa n.h., clinton quietly looking ahead"
0,2,9,43,1,8,0,52,0,trump change tactic tax health-care repeal failure
0,3,3,59,0,12,0,62,0,trump closed white house comment line people calling hotel
0,3,12,53,4,13,0,65,0,q&a: government shutdown looming happens next? washington wire
0,2,6,41,0,6,0,47,0,muslim lawmaker propose banning alcohol indonesia
0,3,13,48,5,13,0,61,0,fmr. defense sec. gates: sense urgency u.s. leader russian hack
0,2,8,24,0,5,0,32,0,dmx reportedly checked rehab
0,2,4,14,0,3,0,18,0,new american face
0,3,14,49,4,14,0,63,0,yiyun li: 'to orphaned native language felt like crucial decision'
0,3,2,58,3,11,0,60,0,'the truth need advocate': scientist marching saturday
0,3,11,53,2,10,0,64,0,coral bleaching cover two-thirds great barrier reef: scientist
0,3,5,35,0,9,4,40,0,daft punk return play grammys 2017 weeknd
0,1,6,33,0,7,0,39,0,labor see green solar plant california
0,3,4,56,1,14,0,60,0,frank sinatra's open letter george michael good pep talk u
0,2,4,23,0,5,0,27,0,troll stole washington
0,2,9,43,5,8,0,52,0,gen. barry mccaffrey: michael flynns tweet border demented
0,1,3,46,0,10,2,49,0,canadian track field coach charlie francis dy age 61
0,3,3,42,1,8,0,45,0,donald trump refugee ban: full text executive order
0,1,1,36,1,6,0,37,0,video game's secret sex scene spark outrage
0,1,7,39,2,8,2,46,0,former first lady taiwan admits laundering $2.2 million
0,2,1,46,2,6,0,47,0,pakistan 'launches first cruise missile submarine'
0,3,11,53,3,12,0,64,0,"rob gronkowski guzzles water young student chant 'chug it,' end spike"
0,1,5,54,3,11,0,59,0,"japan facing 'most severe crisis since world war ii', say prime minister"
0,1,3,58,0,9,0,61,0,president obama renews push close guantanamo detention facility
0,1,3,21,2,7,4,24,0,u.s. war protest mom met bush 2004
0,3,4,28,0,5,0,32,0,mentoring moment forbes itunes
0,1,5,35,0,5,0,40,0,recession drain social security medicare
0,2,1,45,0,8,4,46,0,iceland end capital control 2008 financial crisis
0,3,10,45,3,11,5,55,0,college football's next big thing: 2017 no. 1 overall recruit najee harris
0,2,3,37,3,10,0,40,0,jenni murray: 'i want see woman run world'
0,3,3,54,0,13,0,57,0,mia tindall brings pet dog support mother zara horse trial
0,2,5,22,1,4,0,27,0,brexit bulletin: snap election
0,3,9,58,2,11,0,67,0,generation dirk: nowitzki's heir dunking deutschman changed game
0,3,8,30,1,9,0,38,0,"get ready daily, audio news report"
0,1,4,45,0,9,3,49,0,fulton fish market leaf manhattan 180 year
0,3,1,47,0,9,0,48,0,stroke rate appear rising steadily young adult
0,1,2,26,0,7,2,28,0,new zealand run low 20 cent coin
0,1,7,44,1,9,0,51,0,"depending context, bird couple sing harmony discord"
0,1,7,38,0,9,2,45,0,ex u secretary state warren christopher dead aged 85
0,2,3,53,1,8,0,56,0,robert harward turn trump's national security adviser offer
0,1,6,30,1,6,2,36,0,estimate put natural gas reserve 35% higher
0,3,10,55,0,10,0,65,0,kentucky f derek willis proposes girlfriend senior night ceremony
0,1,2,29,1,4,0,31,0,"tornado strike london, injuring six"
0,2,9,47,6,9,0,56,0,obama blame right-wing medium angering white people breitbart
0,3,2,45,0,7,3,47,0,mh370 relative campaigning answer missing flight
0,1,3,31,0,5,4,34,0,britain launch 2012 olympic lottery game
0,1,5,32,0,7,0,37,0,blinded science online dating game
0,1,5,27,0,8,3,32,0,80 killed 3 suicide bombing iraq
0,2,13,32,1,10,0,45,0,popular nfl team state one
0,2,3,57,2,15,0,60,0,saudi arabia world must take step make hajj safer muslim
0,2,6,30,1,8,0,36,0,rick perry hazard one-party rule
0,2,3,64,1,15,0,67,0,al franken may perfect senator trump era deadly serious funnyman
0,3,16,45,1,15,4,61,0,may best vcs please stand up: midas list 2017 open submission
0,3,2,60,4,10,0,62,0,"finally, much-needed answer terrifying ""big chicken"" twitter video"
0,3,3,31,1,6,0,34,0,forced removal united airline
0,2,1,45,0,10,0,46,0,giant want see linebacker play tightend
0,1,6,32,0,6,0,38,0,european paper find creative way thrive
0,1,7,39,3,6,0,46,0,"realnetworks, internet pioneer, switch gears?"
0,2,2,49,1,10,4,51,0,redskin defense come big preserve 16-10 win raven
0,2,2,49,0,12,0,51,0,trump signed twice many bill obama point
0,3,7,81,3,16,0,88,0,sxsw: artist claim racial abuse 'profiling' u airport blocked attending festival
0,1,7,32,2,9,0,39,0,"two coaches, like ball, always move"
0,1,6,52,0,7,0,58,0,skateboarding afghanistan provides diversion desolation
0,3,3,40,3,7,0,43,0,north carolina 'bathroom' law: deal reached repeal
0,1,6,35,0,6,0,41,0,study suggests higher failure heart device
0,2,10,45,4,13,0,55,0,caddell got right: rising people breitbart
0,2,6,40,0,7,0,46,0,american soldier killed fighting isi afghanistan
0,2,4,49,3,10,0,53,0,"burt reynolds talk trump, lost love latest movie [video]"
0,2,10,47,2,12,0,57,0,"steve king, hurling insult immigrants, rebuked party"
0,1,3,41,1,7,0,44,0,"bronx, new york church destroyed suspicious blaze"
0,1,1,32,1,4,0,33,0,zimbabwe presidential run-off date set
0,1,7,56,0,10,0,63,0,van jones environmental job adviser u president barack obama resigns
0,3,3,58,3,12,0,61,0,"celebrities, beg you: turn oscar elite political circus"
0,2,8,34,1,9,0,42,0,"save whales, must first save sardine"
0,1,3,25,0,6,0,28,0,cargo ship arctic sea may found
0,2,2,29,1,8,2,31,0,16 best sign women's march
0,3,11,47,2,9,0,58,0,"spring home buying survival kit, pre-qualification close"
0,3,9,55,1,12,0,64,0,arm airports: fort lauderdale renews concern gun terminal
0,3,4,47,1,8,0,51,0,"clemency manning, attention turn wikileaks head"
0,2,14,61,6,14,0,75,0,"mike made-it recruit rae sremmurd, kendrick lamar gucci mane 'perfect pint': listen"
0,1,7,33,0,8,0,40,0,knicks beat hawk fifth straight win home
0,1,3,41,0,5,0,44,0,esa launch largest commercial telecom satellite
0,3,10,42,2,7,0,52,0,betsy devos cite grizzly bear guns-in-schools debate
0,2,9,45,0,10,0,54,0,indonesian police kill three thought linked attack plot
0,3,4,32,0,6,0,36,0,paris imf letter bomb injures one employee
0,2,3,68,0,10,0,71,0,fracking inquiry northern territory commission two independent review
0,3,7,25,3,6,0,32,0,watch david bowie's eerie 'no plan' video
0,1,6,46,0,8,0,52,0,collegian show commitment elevating cricket america
0,2,4,24,0,6,0,28,0,nfl playoff bracket set
0,2,9,45,0,13,2,54,0,fight loom bill de blasio plan seek 90 new homeless shelter
0,1,4,35,0,5,0,39,0,peril pleasure entrepreneurship
0,1,1,62,1,10,0,63,0,talk-therapy make difference early treatment severe depression
0,3,8,27,3,8,4,35,0,"trump say sprint bringing 5,000 job back u.s."
0,1,4,45,1,9,0,49,0,bush rehearsed tele-conference u troop iraq
0,3,10,39,1,7,0,49,0,uber ceo leaf trump advisory council amid controversy
0,3,11,51,2,11,1,62,0,juju smith schuster drafted steelers; top twitter take 2nd-round pick
0,2,1,41,2,7,1,42,0,5-year-old florida girl dy accidental shooting
0,1,9,61,2,11,0,70,0,poll show former u.s. speaker newt gingrich latest gop presidential frontrunner
0,3,15,60,2,13,0,75,0,"bad news, indian-origin astronaut shawna pandya jetting space anytime soon"
0,1,10,57,1,11,0,67,0,"van spirit away protester egypt, signaling crackdown criticism gaza"
0,2,2,36,0,7,0,38,0,two dead severe flash flood maryland
0,3,3,43,1,8,0,46,0,"devos, session expected confirmed tight vote"
0,2,1,55,0,9,3,56,0,ivy league school accidentally email nearly 300 acceptance notice
0,3,7,37,1,8,5,44,0,"starbucks plan hire 10,000 refugee trump action"
0,1,4,30,4,7,0,34,0,'tim hortons' coffee shop go 'cold stone'
0,3,18,45,1,15,0,63,0,here enjoy amazing holiday dubai like srk fan
0,1,5,53,0,10,0,58,0,question raised mosquito device ahead new south wale trial
0,3,3,51,1,10,2,54,0,"truck plow crowd christmas market berlin, killing 12"
0,3,11,38,3,10,0,49,0,man insists 'chinese keep grass' sign racist
0,1,8,35,1,9,2,43,0,11th-hour court order block oil gas lease utah
0,3,6,55,1,13,2,61,0,australia fall series defeat 24-run loss new zealand third odi
0,3,6,23,0,5,0,29,0,new balkan instability rattle eu
0,1,8,39,0,7,0,47,0,nascar driver jimmie johnson becomes first time father
0,3,3,44,4,7,0,47,0,"trump's syria strike celebrated 'terrorists', iran say"
0,1,9,55,0,10,0,64,0,palestinian stop paying israeli hospital gaza west bank patient
0,1,4,52,1,10,0,56,0,"gunman kill seventeen drug rehab centre ciudad juarez, mexico"
0,2,4,36,3,5,0,40,0,funding jesus: bankrolled christ ministry?
0,2,5,57,2,13,2,62,0,article 50: happen economy theresa may started brexit?
0,1,4,39,1,5,0,43,0,u university advance andy warhol's photography
0,2,5,52,3,12,2,57,0,rio tinto agrees sell australian coal unit china's yancoal $3.2b
0,1,6,40,0,7,0,46,0,obama announce new mileage emission standard
0,3,9,43,1,10,1,52,0,texas news 4 child die texas gas poisoning; others injured
0,3,11,34,1,10,0,45,0,"learned employee need leader, friend"
0,2,2,46,0,8,0,48,0,picture homeless sleeping empty graf shock iran
0,2,11,48,2,9,0,59,0,"china raise key short-term interest rates, following fed closely"
0,2,2,51,0,13,4,53,0,jeb bush seek stir passion logo reach 2016 launch loom
0,1,6,27,1,5,0,33,0,"amid protests, asian summit canceled"
0,1,6,35,0,8,0,41,0,biden question vote stick policy iran
0,1,5,31,0,6,0,36,0,sign possible deal pakistan turmoil
0,1,3,45,0,7,0,48,0,u military withdraw military trainer pakistan
0,3,2,39,3,8,0,41,0,trump: gingrich wrong drain swamp
0,3,2,57,1,9,0,59,0,"tennessee couple tried selling baby craigslist, investigator say"
0,3,5,47,1,10,2,52,0,kazuyoshi miura score 50 beat sir stanley matthew record
0,1,4,32,2,5,0,36,0,uk mobile provider begin tv-on-phone trial
0,1,2,57,0,7,0,59,0,afghan presidential candidate abdullah may boycott runoff election
0,1,6,38,1,5,0,44,0,justice dept. investigates markit derivative
0,1,5,34,1,5,1,39,0,2nd-largest mall operator file bankruptcy
0,1,6,37,0,5,0,43,0,british financial regulator take tougher stance
0,1,7,31,1,6,0,38,0,puerto rico ex-governor acquitted graft
0,2,2,37,0,6,0,39,0,italian protest mafia stronghold locri
0,3,12,61,1,15,0,73,0,aaron hernandez's family could end making million dollar result death
0,1,5,51,0,7,0,56,0,andrew sayers resigns national museum australia directorship
0,1,1,43,1,6,0,44,0,alzheimer's disease reversed mouse using caffeine
0,2,15,66,3,14,0,81,0,jennifer lawrence prays 'compassion return white house' amid trump's immigration ban
0,3,3,33,2,7,0,36,0,'hamilton' make super bowl appearance
0,1,12,61,4,13,0,73,0,"michael weiner, behind-the-scenes force, set move forefront major league union"
0,1,3,69,0,8,0,72,0,fictional documentary flemish independence cause consternation belgium
0,1,6,25,1,8,6,31,0,"adp say u economy lost 742,000 job march"
0,3,8,45,1,7,0,53,0,mexico gain share north american light-vehicle production
0,1,3,81,1,14,0,84,0,"poll show prval clear lead, ineligible candidate simus could presented challenge"
0,1,3,50,0,8,0,53,0,google provides gmail access american cell phone customer
0,2,14,58,1,12,0,72,0,"gonzaga, north carolina win final four game advance ncaa national championship"
0,3,4,56,0,9,0,60,0,trump accuses obama administration wiretapping trump tower phone
0,3,9,45,1,9,0,54,0,zara's new madrid store challenge corte ingles retail tussle
0,2,2,51,1,10,0,53,0,trump's syria strike could moment defines legacy
0,2,7,44,1,10,4,51,0,qantas start australia's first nonstop flight europe 2018
0,1,2,22,0,4,4,24,0,2010 uk general election result
0,1,2,45,1,7,0,47,0,verdict announced france's largest child abuse case
0,1,4,14,0,4,0,18,0,choice drug czar
0,2,4,56,3,9,0,60,0,donald trump's 'celebrity apprentice' deal may include money brand
0,3,1,39,0,7,0,40,0,brazil pass mother austerity plan
0,3,7,40,3,7,0,47,0,marvel release first teaser trailer 'thor: ragnarok'
0,1,3,50,0,8,0,53,0,report indicate bush appointing friend lead plame inquiry
0,2,9,42,7,11,3,51,0,weeknd: topping hot 100 'starboy' 'honor' (exclusive)
0,2,3,33,2,7,0,36,0,game throne live concert isbonkers
0,3,4,66,4,11,0,70,0,neil patrick harris interview: 'being scrutinised young traumatic'
0,2,6,36,1,5,0,42,0,greek debt-relief measure unblocked eurozone
0,2,6,63,2,14,0,69,0,map nasa show drastic amount ice thats disappeared arctic
0,3,11,42,1,10,0,53,0,alec baldwin's donald trump impression book deal
0,1,4,52,6,12,4,56,0,merck co. found liable $253.4 million texas man's vioxx-related death
0,2,11,47,4,13,0,58,0,watch shawn mendes camila cabello crush cover ed sheeran's 'kiss me'
0,1,6,33,0,8,0,39,0,crisis underscore need save rainy day
0,1,5,34,1,6,0,39,0,"nato tanker pakistan attacked, four killed"
0,1,8,24,1,7,0,32,0,st. michael rice win class aa title
0,3,14,58,1,12,0,72,0,muslim-american teenage boxer amaiya zafar win right wear hijab fight
0,2,7,41,0,8,0,48,0,british prime minister theresa may visit trump friday
0,3,13,35,3,11,0,48,0,"leeco said miss u.s. sale forecasts, plan job cut"
0,2,10,31,3,12,0,41,0,"florida sun, sky, sea mind new york time"
0,1,7,31,0,8,0,38,0,bernanke say recovery least year away
0,3,2,55,1,9,0,57,0,trump blast judge raise question gorsuch independence
0,1,4,53,0,8,0,57,0,kosovo independence ruled legal international court justice
0,1,5,53,0,11,0,58,0,european union give iran two week comply un resolution
0,1,4,43,1,8,0,47,0,"two people killed fire greater manchester, england"
0,2,10,45,5,13,5,55,0,"didnt want lose identity: 16,000 reader reflect surname"
0,2,8,34,2,7,0,42,0,"bruno mar declares american music ""black music"""
0,3,9,41,2,9,0,50,0,arab summit endorse palestinian position eye u.s.
0,3,7,41,2,9,5,48,0,"turkish minister: 38 dead, 155 wounded twin istanbul bombing"
0,2,1,48,1,10,0,49,0,"study link pot use higher risk stroke, heart failure"
0,2,9,56,0,11,0,65,0,jon gruden comment interest coaching amid rumor surrounding ram
0,1,7,38,0,7,0,45,0,thousand chechnya protest lawyer killed
0,1,2,74,1,10,0,76,0,"british sailor detained, released yacht accidentally cross iranian water"
0,1,7,33,0,7,0,40,0,top russian aide call less kremlin control
0,2,2,79,1,16,2,81,0,"mom missing boy hawaii pleads guilty manslaughter, nearly 20 year disappearance"
0,3,5,70,0,15,0,75,0,scientist find dozen new specie gulf mexico deepwater horizon oil spill
0,2,3,46,1,8,0,49,0,"new tactics, taliban gain ground south afghanistan"
0,2,12,55,1,11,4,67,0,sony/atv exec focus songwriting skill billboard latin music conference 2017
0,3,14,64,6,11,0,78,0,michael rapaport rip politically correct f*ck aziz ansari trump-bashing snl monologue
0,2,4,47,5,8,0,51,0,george michael: 'i'm surprised i've survived dysfunction'
0,1,6,37,0,7,0,43,0,francoeur give struggling mets jolt optimism
0,2,4,23,1,4,0,27,0,america doesnt successor
0,2,5,30,0,7,0,35,0,paul ryan worst week washington
0,2,9,43,0,9,0,52,0,katy perry debut new blonde hair trump portrait unveiling
0,2,8,40,1,6,0,48,0,comet lander philae awakes months-long hibernation
0,3,5,34,0,6,0,39,0,china emerges powerhouse biotech drug
0,1,3,45,1,8,2,48,0,6.8 earthquake rock northeastern coast papua new guinea
0,3,6,31,2,5,0,37,0,texas executes man murder-for-hire scheme
0,3,14,48,1,13,0,62,0,ten thousand brit take street protest trump's travel ban
0,3,14,49,3,12,0,63,0,uga's nick chubb use social medium need advertise
0,2,5,61,5,12,0,66,0,sony marvel dropped another 'spider-man' trailer look amazing
0,3,4,45,3,9,0,49,0,cozy snowman pentatonix's 'coldest winter' video
0,2,14,53,1,13,0,67,0,study: violent crime murder slightly rise year largest city
0,2,1,23,0,3,0,24,0,zimbabwe dollar phased
0,1,5,30,0,4,2,35,0,pakistan win world twenty20 championship
0,3,7,62,1,13,0,69,0,elizabeth warren tell jimmy fallon mitch mcconnell even look
0,2,8,34,0,8,0,42,0,north dakota bar owner pull monumental coup
0,1,5,23,0,7,4,28,0,new ad campaign look back 1930s
0,1,7,22,2,5,0,29,0,u.n. lead evacuation sri lanka
0,1,3,41,1,7,3,44,0,person indiana win $314 million powerball jackpot
0,1,10,59,0,13,0,69,0,israeli arab recoil attack gaza allegiance country strained
0,1,6,36,0,6,0,42,0,republican debate risk supreme court battle
0,1,8,34,1,8,0,42,0,"sri lankan war nears end, peace remains distant"
0,2,5,19,0,5,0,24,0,weed wedding thing
0,2,14,59,2,15,0,73,0,anxiety muslim refugee stoked online far-right medium new york time
0,3,5,28,1,6,1,33,0,macau gaming revenue rise 8% december
0,3,3,83,3,16,2,86,0,"texan bench $72 million quarterback, brock osweiler, fan gave backup standing ovation"
0,3,11,51,2,12,5,62,0,"2016 saw highest pollution level delhi, yet delhiites bought 9 lakh vehicles!"
0,2,14,54,3,13,0,68,0,'spider-man' villain venom movie theater sooner think
0,3,2,30,1,5,0,32,0,"fitbit buying pebble, report claim"
0,2,14,33,1,9,0,47,0,dnc chief wont apologize using profanity slam gop
0,2,8,52,1,9,1,60,0,deadmau5 file trademark petition protect cat meowingtons' brand
0,1,6,29,0,6,0,35,0,athletics scrap plan build new stadium
0,3,5,53,0,13,2,58,0,headache abound minnesota man declared dead irs 29 year ago
0,3,3,59,0,10,0,62,0,child abuse royal commission see report suppressed catholic church
0,1,2,74,1,12,0,76,0,tennessee close christian ex-gay camp treating mental illness without license
0,2,5,33,0,6,0,38,0,biden rebuff giuliani black life matter
0,1,7,38,0,6,0,45,0,joint chief chairman criticizes afghan air strike
0,2,11,36,0,9,0,47,0,art banned country take center stage moma
0,2,10,50,1,12,2,60,0,bill cosby court case: judge weigh potential testimony 13 woman
0,1,6,33,0,7,0,39,0,gate look tougher approach north korea
0,2,1,51,1,10,0,52,0,married man faked terror plot avoid trip mistress:cops
0,3,3,49,0,8,0,52,0,cannot possibly confirm judge gorsuch election
0,3,10,40,2,9,0,50,0,woman see screaming face 'donald trump' inside red pepper
0,3,9,35,0,8,0,44,0,adorable dog dressed christmas
0,2,10,46,0,9,0,56,0,iran lift ban preventing u wrestler attending tournament
0,1,1,49,1,8,0,50,0,"british student walk free, putting foot trainseat"
0,3,9,40,0,9,0,49,0,montana abortion bill would make doctor try save fetus
0,2,2,27,1,4,0,29,0,donald trump's photo op presidency
0,3,4,44,1,9,0,48,0,ubs: costco going raise membership fee next quarter
0,2,5,48,0,11,0,53,0,oil slipping trader get jittery planned opec cut
0,1,7,34,1,6,0,41,0,long-lost lincoln letter returned archive
0,1,10,37,1,8,0,47,0,study show first-time online donor often return
0,1,8,27,3,6,0,35,0,"u.s., british libel ruling raise concern"
0,1,6,35,0,9,4,41,0,ferrari front row 2006 united state grand prix
0,3,8,43,4,9,0,51,0,oil hold steady trader `wait-and-see mode' stockpile
0,2,2,51,1,9,0,53,0,clinton surprise michigan loss expose risk trade
0,3,10,39,1,9,0,49,0,prince harry open mental health mom death
0,1,4,17,1,4,1,21,0,saving plan: 5 smart step
0,3,8,45,2,7,0,53,0,interracial couple's home vandalized n-word swastika
0,1,4,57,1,9,0,61,0,south africa's largest weekly newspaper want president mbeki resign
0,3,1,49,1,9,0,50,0,american attached democracy might think
0,1,1,38,0,6,0,39,0,inhabited tropical island lost rising sea
0,2,6,28,3,5,0,34,0,man behind america wine superstore
0,2,7,81,3,21,0,88,0,george h.w. bush wife barbara take part super bowl coin toss week released hospital
0,2,4,22,0,5,4,26,0,fantasy baseball draft kit 2017
0,3,1,59,3,10,0,60,0,dad's response daughter's pants-wetting accident school go viral
0,2,8,31,1,7,0,39,0,parent taking kids' college debt
0,3,5,49,0,7,0,54,0,isi claimed responsibility istanbul nightclub attack
0,2,4,56,5,12,4,60,0,hulk hogan $140.1 million ko courtroom could chilling effect medium
0,3,3,54,2,11,2,57,0,"syria war: air strike kill 25 jihadist idlib province, monitor say"
0,2,9,35,4,10,4,44,0,"u.k. may try charm trump, hoping early 2017 meeting"
0,1,2,43,0,8,0,45,0,fatal stabbings kill three belgian day care center
0,3,13,54,1,13,4,67,0,meet air marshal denzil keelor failed pakistan's plan sialkot 1965 war
0,2,11,42,3,8,0,53,0,flash boy exchange iex criticizes nasdaq order-type proposal
0,3,4,74,4,18,0,78,0,donald trump say britain right vote brexit offer 'quick' 'fair' trade deal
0,2,9,52,0,8,0,61,0,wisconsin family mistakenly targeted nazi flag outside apartment
0,3,1,26,2,5,4,27,0,canada legalise marijuana 'by 2018'
0,2,8,40,1,9,1,48,0,apple announces io 9 smarter siri real multitasking
0,3,11,22,2,8,0,33,0,espn's nfl mvp poll: brady still top
0,2,10,44,0,9,0,54,0,look beautiful haunting photo africanwildlife
0,2,5,35,0,6,0,40,0,spotify hire group blockchain developer
0,1,4,43,0,8,0,47,0,former beatle set quebec city concert amid protest
0,1,3,33,0,7,3,36,0,pioneer chemist albert hofmann dy age 102
0,3,2,61,2,13,0,63,0,metal band loses chicago gig 'excessive use gun violent imagery'
0,2,7,21,2,7,2,28,0,24 elf moment bestever
0,1,7,27,1,8,0,34,0,"new rules, winning mind"
0,3,10,48,2,9,0,58,0,rihanna call president trump 'an immoral pig' immigration order
0,3,14,59,2,12,0,73,0,"dead rat lizards, mid-day meal disaster continue plague government school"
0,3,3,74,2,12,0,77,0,censorship concern european parliament introduces 'kill switch' cut racist speech
0,1,6,25,0,5,0,31,0,former mlb player rollie stile dy
0,2,1,34,2,5,0,35,0,trump writing 'short' inaugural speech
0,2,2,49,3,9,0,51,0,texas pool party chaos: 'out control' police officer resigns
0,1,2,39,1,8,0,41,0,u woman sentenced jail faking son cancer
0,3,7,18,3,7,4,25,0,ford ceo's pay rise 19% $22 million
0,3,8,34,0,7,0,42,0,jon huntsman accepts post ambassador russia
0,1,3,49,0,8,0,52,0,hundred people gather support mikhail khodorkovsky
0,3,7,30,0,8,7,37,0,100 hilarious tweet helped u get through2016
0,2,8,56,3,15,0,64,0,'the curious incident dog night-time' win best play tony award
0,2,3,39,0,6,0,42,0,mystery shipwreck found north carolina coast
0,3,6,49,2,9,0,55,0,"suit alleges kiffin, fau defrauded ex-bama player assistant job"
0,2,1,56,0,10,0,57,0,session emphasizes primacy law political view
0,2,6,63,4,10,0,69,0,"exclusive: presidential hopeful sanders, clinton dead heat reuters/ipsos poll"
0,1,5,21,0,3,0,26,0,mckesson buy drugstore brand
0,3,10,60,0,10,0,70,0,kentucky coach john calipari heckled missouri crowd halftime interview
0,1,2,31,2,5,0,33,0,"copiap, chile mining accident: depth"
0,1,12,50,0,12,0,62,0,bill changing credit card rule sent obama gun measure included
0,1,3,57,1,8,0,60,0,"democratic republic congo adopts new constitution, plan election"
0,1,4,29,0,3,0,33,0,specter face conservative challenge
0,3,10,44,3,7,0,54,0,u.s.-muslim teen stopped boarding international flight home
0,1,3,35,1,7,2,38,0,uk jobcentre call centre staff 48-hour strike
0,3,13,49,1,10,0,62,0,house democrat slam fbi director james comey closed-door briefing
0,3,8,36,3,9,0,44,0,"watch video iggy azalea's new single ""mo bounce"""
0,2,1,60,1,10,0,61,0,"higher dementia risk linked living near heavy traffic, research show"
0,3,9,38,0,10,0,47,0,kentucky county economic prisoner jail
0,1,6,34,0,6,0,40,0,fierce lobbying greets bill ease unionizing
0,3,2,56,3,11,0,58,0,"""a sense despair"": mental health cost unchecked climate change"
0,3,11,38,2,11,2,49,0,"abn amro sell $20 billion asia, middle east banking asset"
0,2,3,59,0,13,0,62,0,rising number criminal using facebook live film act
0,2,13,50,1,11,0,63,0,deep-state doj disqualified judge seek jail time sheriff joe arpaio
0,1,2,33,0,7,0,35,0,man found dead car crash shetland
0,3,13,49,2,12,0,62,0,ivanka trump said dad cared child care. budget say otherwise.
0,3,8,48,0,8,0,56,0,trump pick rattle housing industry questioning loan backstop
0,3,10,53,0,10,0,63,0,trump nominates federal appeal court judge neil gorsuch supreme court
0,2,2,47,2,9,0,49,0,sexual assault: university prevent it?
0,3,1,46,1,8,0,47,0,"california snowpack measure low, big storm coming"
0,1,7,26,2,8,0,33,0,"yeah, done since derby?"
0,3,13,51,0,12,0,64,0,russian court ban teacher six year sex teenage student
0,3,9,47,2,9,0,56,0,"stromae pair repetto cozy, dance-inspired collection"
0,3,10,57,2,9,0,67,0,"pistons, magic reportedly discussed trade involving reggie jackson, jeff green"
0,2,2,42,0,8,2,44,0,luxury multiplex dress drab 62nd streetcorner
0,3,8,42,4,9,4,50,0,"yowza! 1,000 word added merriam-webster's dictionary"
0,1,4,40,0,6,0,44,0,scientist shocked great barrier reef bleaching
0,3,2,65,1,13,0,67,0,rising closing down: surviving thriving store shuts door
0,1,3,30,0,5,0,33,0,large bomb defused northern ireland
0,1,6,32,0,7,0,38,0,beyond boldface name indymac deal
0,3,4,38,0,7,0,42,0,myer buy marc david lawrence fashion brand
0,3,10,43,4,9,0,53,0,'duck dynasty' producer fired sued itv studio (exclusive)
0,2,1,54,1,10,1,55,0,watchdog find 3bn child support arrears may never collected
0,1,2,43,0,8,0,45,0,obama delay arrival copenhagen summit one week
0,1,5,34,0,5,0,39,0,missouri thrives running opponent ragged
0,2,1,54,0,11,0,55,0,warning parent newborn baby girl dy bed mother
0,1,6,29,0,5,0,35,0,rutgers rally fall short purdue
0,1,2,41,0,7,0,43,0,second stone circle found one mile stonehenge
0,3,8,45,0,7,0,53,0,arkansas executes inmate court ruling clear obstacle
0,3,13,54,7,15,0,67,0,"sunday week: vice president mike pence, sen. amy klobuchar, sen. ben sasse"
0,1,7,22,1,7,0,29,0,"south korea, life mobile"
0,1,4,28,4,7,3,32,0,"mit's ""$100 laptop"" unveiled november"
0,3,2,57,4,9,0,59,0,'climate change real': company challenge trump's reversal policy
0,1,1,35,0,3,0,36,0,romanian coalition government collapse
0,3,5,73,3,14,1,78,0,5-year-old make history youngest person qualify scripps national spelling bee yahoo
0,1,4,25,2,5,0,29,0,new 'mighty mouse' apple debut
0,1,6,72,6,14,5,78,0,"'have shot': bbc get 21,000+ complaint jeremy clarkson's public sector striker comment"
0,2,16,49,2,12,0,65,0,"amtrak crash: sign engineer using phone operating train, ntsb say"
0,1,8,25,2,6,0,33,0,u.s. open inquiry google book deal
0,3,10,48,0,10,0,58,0,tech startup seeing share venture investing pie shrink
0,3,15,50,2,12,0,65,0,donald trump's press secretary say whether russia behind dnc hack
0,3,2,52,3,11,0,54,0,n.c. novelist walk free agreeing plea deal wife's death
0,1,7,27,2,8,8,34,0,200910 uefa champion league: round 16 field set
0,2,12,46,1,10,0,58,0,"senate gop bypass dem boycott mnuchin, price suspending rule"
0,1,2,40,0,5,0,42,0,recession hit australian asbestos victim fund
0,3,14,53,4,15,0,67,0,james taylor bemoans end obama era: 'it feel like raining world'
0,3,5,37,1,10,0,42,0,roe v wade: woman u abortion legal test case dy
0,2,14,61,0,14,0,75,0,twitter dragged paul george missing final shot saying take final shot
0,2,10,56,3,13,2,66,0,cuomos $1.4 billion plan target brooklyn fight poor health poverty
0,1,7,34,0,9,0,41,0,opportunity wasted mets let sweep slip away
0,3,9,47,0,11,1,56,0,carmelo la la anthony reportedly split 7 year marriage
0,1,2,56,3,7,0,58,0,"chris benoit mystery editor confesses: claim ""terrible coincidence"""
0,3,1,67,0,13,0,68,0,scientist launched pie space came back almost perfect condition
0,1,3,24,2,5,0,27,0,kucinich run u.s. president
0,3,5,46,2,11,4,51,0,"2017 marc gasol all-stars, featuring true heir throne"
0,2,11,43,2,11,2,54,0,"petrol pump continue accept cards, till 13 january!"
0,2,9,28,0,6,0,37,0,virginia teen pleads guilty helping isi
0,2,8,49,2,12,1,57,0,john legend make appearance trailer master none season 2
0,2,9,36,3,10,1,45,0,red velvet earns second no. 1 world album 'rookie'
0,2,9,55,2,13,2,64,0,"iran, russia talk $10 billion deal tehran ink china military pact"
0,3,9,61,0,10,0,70,0,deron williams reportedly expected sign cavalier clearing waiver
0,2,11,42,1,10,0,53,0,adele dirty stand-up power go australian show
0,1,7,32,0,7,0,39,0,north korea press ahead missile launch
0,1,8,41,0,9,0,49,0,sideline inbounds pas becomes new point interest
0,1,7,35,1,7,0,42,0,mcdonald named chief executive procter gamble
0,1,4,59,0,10,0,63,0,son illinois senate president charged driving influence
0,3,13,45,3,11,0,58,0,top u.s. diplomat first asia trip come amid tension north korea
0,1,2,24,1,5,4,26,0,"campaign trail, december 2011"
0,1,10,38,1,9,0,48,0,author question cia redaction nyt op-ed iran policy
0,3,18,57,2,16,0,75,0,"india corrupt country asia pacific, two-third indian pay bribe"
0,3,12,62,3,12,0,74,0,president-elect trump attack civil right icon said presidency 'legitimate'
0,3,12,45,1,10,0,57,0,donald faison mourns death ex-wife lisa askey moving tribute
0,1,2,38,2,8,6,40,0,"owsley stanley, icon 1960s counterculture, dy 76"
0,1,4,24,4,6,2,28,0,"o.j. simpson laywer, cochran, dead 67"
0,3,9,30,2,9,0,39,0,vw talk plead guilty u.s. emission case
0,2,10,34,0,9,0,44,0,time joe duffy choked young conor mcgregor
0,3,3,39,1,9,4,42,0,"uk house price rise marginally 2017, say halifax"
0,3,10,60,1,12,0,70,0,obliterated! isi headquarters mosul blown away raf typhoon strike mission
0,2,2,52,0,7,0,54,0,netherlands bar turkish minister rally dispute escalates
0,3,3,48,0,10,0,51,0,jos mourinho denies unhappy living manchester
0,1,6,31,0,7,0,37,0,ronaldo join real madrid record price
0,2,9,57,1,9,0,66,0,florida fisherman reel possible world-record catch charity tournament
0,3,11,40,2,9,4,51,0,big donor fast-tracking charitable gift year-end 2016
0,3,3,46,0,13,0,49,0,u strike yemen week last year
0,3,12,44,1,9,0,56,0,nyc medical student accept obamacare repeal without fight
0,3,13,52,3,14,0,65,0,"drake chill sade, brings nicki, skepta trey songz final london show"
0,1,7,26,2,6,0,33,0,u.s. official say israel struck sudan
0,1,4,25,0,3,0,29,0,obama condemns iranian crackdown
0,3,3,47,2,11,0,50,0,gdp figure show dodged recession here's mean
0,1,8,41,0,8,0,49,0,little debbie cracker join list peanut butter recall
0,1,5,32,0,5,0,37,0,survey reveals broad support president
0,2,13,56,4,10,0,69,0,"emily ratajkowski: slut-shaming melania trump ok, regardless politics"
0,2,15,52,1,14,0,67,0,demonetisation: guard fire gun shot air disperse crowd bank punjab
0,1,1,46,0,7,0,47,0,madagascar leader name army officer prime minister
0,1,3,34,0,6,0,37,0,major rally escalate teacher strike bc
0,3,8,52,1,9,0,60,0,magic johnson advise lakers ownership: latest comment reaction
0,1,4,51,0,11,0,55,0,former nba ref surrender charge bet game officiated
0,3,8,37,3,11,1,45,0,"no, former president obama added $1 bill"
0,3,8,38,0,9,0,46,0,two stephen king movie marry weird normal
0,2,5,58,0,11,0,63,0,anthony crolla show heart loses point venezuelan jorge linares
0,3,6,58,5,11,0,64,0,"good fork cookbook, reviewed: reminder made brooklyn hype-worthy"
0,3,2,40,2,6,0,42,0,food apartheid punishing venezuelan
0,3,12,63,2,12,0,75,0,"plus-size beauty salon offer haircuts, highlight healthy dose body positivity"
0,2,10,37,3,7,0,47,0,michael keaton: trump policy recruiting tool isi
0,1,1,32,0,7,2,33,0,bolivia road crash leaf least 47 dead
0,1,1,46,1,9,6,47,0,"chinese police offer 300,000 yuan reward double bus bombing"
0,1,5,29,1,6,0,34,0,"bomb kill u marines, civillians iraq"
0,2,11,33,4,10,1,44,0,"joey badass: ""i already know i'm better rapper 2pac"""
0,3,8,55,2,9,0,63,0,"csiro, energy network australia lay roadmap emissions-free future"
0,3,2,49,0,10,0,51,0,hitler also published list crime immigrant list
0,2,18,44,2,13,0,62,0,full text: milo democrat lost white working class breitbart
0,1,9,35,2,9,0,44,0,u.s. soccer team prize cohesion quest world cup
0,2,6,71,1,19,0,77,0,clare balding: queen gave u shetland pony born became part family
0,3,2,41,0,8,0,43,0,bomb threat scary costly jewish center
0,2,11,35,4,11,0,46,0,mexican drug lord el chapo pleads guilty u.s. court
0,1,2,39,0,8,0,41,0,remains child discovered jersey care home
0,3,1,51,0,8,0,52,0,flight attendant rescue teenage girl human trafficker
0,3,11,49,2,10,0,60,0,jiu-jitsu fighter brutally break opponent's arm refused tap
0,1,5,25,0,6,0,30,0,mets extend winning streak seven
0,3,10,43,0,10,0,53,0,mexican avocado group make super bowl pitch trump tax loom
0,2,2,40,3,10,0,42,0,car want say hello. thats start.
0,3,4,45,0,8,0,49,0,family frederick douglas give trump history lesson
0,2,1,50,0,10,0,51,0,oil spike inventory post biggest drop year
0,2,3,31,0,6,0,34,0,vehicle hit crowd new orleans parade
0,2,13,41,0,12,0,54,0,bill de blasio waiting hillary clinton speak trade
0,2,12,39,0,10,0,51,0,ecb stand ready support bank needed france vote
0,3,3,49,1,7,0,52,0,nebraska lawmaker quits unsavory women's march retweet
0,2,4,59,3,9,0,63,0,"ditch hostile approach 'brexit zealots', europhile tory urge minister"
0,3,2,68,3,8,0,70,0,"ex-google self-driving engineer secretly collaborated competitors, suit say"
0,1,6,38,0,7,0,44,0,pelfrey mets take advantage sloppy national
0,3,10,42,0,10,0,52,0,caitlyn jenner impressive new mac collection way
0,3,11,58,8,13,0,69,0,"trump call supporter 'nasty,' 'vicious,' 'violent' rally orlando"
0,3,4,56,1,11,0,60,0,"two week in, donald trump smallest confirmed cabinet decade"
0,1,3,46,3,7,0,49,0,"seven-year-old girl killed detroit, michigan police raid"
0,3,4,55,1,10,0,59,0,major league baseball: rookie player banned dressing woman
0,2,14,67,4,14,0,81,0,"geert wilders, dutch far-right leader, convicted inciting discrimination new york time"
0,3,14,52,0,10,0,66,0,dems accuse gorsuch skirting major legal question scotus confirmation
0,1,7,29,0,7,0,36,0,chinese tv censor part address obama
0,3,13,51,1,13,0,64,0,indiana f og anunoby throw massive poster dunk late game vs. maryland
0,2,11,33,6,6,0,44,0,#lifeatcomplex: nick young chooses ultimate g.o.a.t.
0,1,3,41,0,7,0,44,0,big island resident prepare arrival flossie
0,1,4,46,0,8,0,50,0,serb pilot defend colleague air india express disaster
0,2,5,60,1,14,0,65,0,photo show like live new york legendary chelsea hotel
0,1,6,37,2,5,0,43,0,college basketball's missing first-round action
0,2,17,65,1,16,0,82,0,someone made edible water bubble replace plastic bottle drink future
0,2,11,40,6,11,0,51,0,mariah carey's rep say 'rockin' eve' producer 'set fail'
0,3,2,54,1,11,0,56,0,"manhunt one armed suspect cop, second suspect shot reno"
0,1,12,46,0,12,0,58,0,small nevada town fear damaging silence school bell soon
0,1,3,32,0,7,2,35,0,english actor norman painting dy age 85
0,1,4,36,0,8,0,40,0,research show hiv virus may hide bone marrow
0,2,4,43,1,8,0,47,0,cia officer give mixed review trump strange visit
0,2,6,42,0,8,0,48,0,grammys deliver promise politically charged show
0,1,5,36,0,6,0,41,0,economy rattle race governor california
0,2,13,43,3,11,0,56,0,"long unseen readers, h.g. well ghost story finally debut print"
0,2,3,81,1,13,0,84,0,uk business call government embrace low-carbon future enact climate change legislation
0,1,1,25,2,4,0,26,0,europe's airline chaos: depth
0,1,1,37,1,7,4,38,0,"underwater volcano cause 3,300 ft column steam"
0,2,4,72,0,11,0,76,0,manchester sea director defends casey affleck sexual harassment allegation
0,2,3,27,0,6,0,30,0,trump speak putin tuesday
0,2,2,51,2,8,0,53,0,"pre-teen nigeria bomber detonates early, second bomber lynched"
0,2,3,40,0,8,2,43,0,russia mark 70 year since victory nazi germany
0,2,8,34,1,7,0,42,0,campaign aide shout post-election forum
0,2,2,37,0,6,0,39,0,another woman accuses cosby sexual assault
0,2,2,12,0,1,0,14,0,proverbial sin
0,2,8,32,1,11,0,40,0,way woman reach white house?
0,1,5,54,0,8,0,59,0,former bosnian serb leader radovan karadi boycott genocide trial
0,2,13,61,0,17,0,74,0,ed sheeran reveals got drunk smashed justin bieber face golf club
0,2,1,58,0,10,0,59,0,major studio pushing release film home shortly cinema
0,1,3,28,0,4,0,31,0,tropical storm andres designated
0,2,15,66,1,14,0,81,0,"price cap stents, government regulate price artificial heart valve syrinx"
0,1,10,50,0,9,0,60,0,chrysler revamp plan could block lawsuit current vehicle owner
0,2,2,47,4,8,0,49,0,"demonic activity palpable trump rally, pastor say"
0,3,2,32,2,4,0,34,0,tillersons foreign policy: russia first
0,3,3,45,2,10,0,48,0,trump syria strike moral impulse policy change?
0,3,9,51,6,10,0,60,0,feinstein: trump's 'blizzard executive orders' 'splitting' u insider
0,3,1,57,2,12,0,58,0,"briton spend food leisure, less booze, smoking drug"
0,2,2,51,0,6,0,53,0,malta hijacker surrender releasing libyan passenger
0,3,1,50,0,8,0,51,0,mining deal plummet value commodity bust continues
0,1,2,36,0,6,0,38,0,oil spilled ship collide singapore
0,1,7,32,2,9,1,39,0,"britons, held 2 years, may freed exchange"
0,1,6,25,0,8,0,31,0,tiger wood open state mind
0,3,15,43,3,13,0,58,0,psa david lilo stitch better disneyprinces
0,2,1,40,1,8,0,41,0,"city stilled, shocked enraged attack"
0,1,6,34,0,6,0,40,0,marketer travel globally snack locally
0,3,5,24,0,6,0,29,0,cavs warrior win
0,1,4,44,0,7,0,48,0,romanian president meet eu official bucharest
0,1,3,33,0,6,0,36,0,seven face deportation uk dawn raid
0,2,4,26,0,3,0,30,0,insecure quietly revolutionary
0,1,5,30,1,7,0,35,0,"mapping human genome, via ebay auction"
0,2,3,62,3,10,0,65,0,marine corp nude-photo-sharing scandal even worse first realized
0,2,17,48,2,16,0,65,0,gorgeous green meteor lit indian sky island clue
0,1,7,25,2,7,1,32,0,bomb kill 7 afghan civilian u.s. base
0,2,2,37,0,5,0,39,0,starling dance around southern israel sky
0,3,2,47,3,10,2,49,0,"snap crackled, popped: share fall $20 first time"
0,3,4,39,2,6,0,43,0,dutch populist geert wilder call moroccan 'scum'
0,3,1,47,1,9,3,48,0,"112 dead river overflows, destroying home colombia"
0,3,2,44,0,12,0,46,0,sky pool houston let fly swim time
0,2,5,70,4,14,0,75,0,"scarlett johansson say 'will never, ever' comment divorce romain dauriac yahoo"
0,3,1,46,2,7,0,47,0,mom fighting cancer give birth 'miracle' quadruplet
0,2,9,46,1,8,0,55,0,nothing normal america freakish winter weather
0,1,3,37,1,4,0,40,0,activist remember burundi's gatumba massacre
0,2,1,37,0,8,2,38,0,33 people die siberia drinking bath oil
0,2,7,43,0,7,0,50,0,trump administration preview defense new travel order
0,1,4,49,0,9,0,53,0,harvard law school give highest honour pakistani judge
0,2,1,50,2,6,0,51,0,italy avalanche: friend describes survivor's miracle escape
0,2,8,35,0,8,0,43,0,new white house keep bungling social medium
0,3,2,58,0,10,0,60,0,madonna share photo newly adopted twin matching adidas outfit
0,1,3,22,0,3,0,25,0,swiss president visit ghana
0,1,3,42,0,6,0,45,0,u minimum wage move congressional negotiation
0,2,4,58,3,13,0,62,0,"someone lost pair snuggie-clad goats, ok found"
0,1,2,38,1,8,4,40,0,"fear loathing campaign trail, october 2008"
0,1,6,35,0,6,0,41,0,protester defy iranian effort cloak unrest
0,2,11,43,4,10,0,54,0,music talking: manager owen husney prince legacy
0,2,1,67,0,8,0,68,0,republican target environmental rule protecting park limiting methane
0,3,13,54,3,15,0,67,0,elle king covered 'golden girls' theme song fangirl dream came true
0,2,5,26,3,6,0,31,0,cnn talent now: 'the seventies'
0,1,7,34,1,7,0,41,0,"downturn, marketer still rely new product"
0,2,5,27,0,5,0,32,0,stock retreat risk appetite wane
0,1,1,53,1,8,0,54,0,ethic debate surround surgery stunt disabled girl's growth
0,1,12,40,8,14,4,52,0,"itv fined a$3000 cruelty rat ""i'm celebrity...get here!"""
0,3,13,37,2,12,2,50,0,tom brady told robert kraft he'd like play 6-7 nfl season
0,2,11,35,2,10,0,46,0,jimmy fallon stylish jared kushner 'snl' cold open
0,3,11,40,2,9,0,51,0,lol melissa mccarthy destroyed sean spicer 'snl'
0,1,14,36,1,8,0,50,0,canadavotes: ndp candidate david sparrow valley west
0,1,4,47,2,9,0,51,0,"church van flip killing four, injuring fifteen georgia, u"
0,3,3,33,1,5,0,36,0,report: faraday future close bankruptcy
0,1,6,51,0,9,0,57,0,investigation u airway river ditching new york completed
0,2,3,46,1,7,0,49,0,exposing darkness within: domestic violence islam
0,1,6,57,0,10,0,63,0,u president barack obama speaks memorial arizona shooting victim
0,2,11,39,0,10,0,50,0,trump trade agenda disarray amid sign deal china
0,3,5,68,4,18,0,73,0,fox news anchor hit trump: much lying much russia much smoke
0,3,10,48,0,9,0,58,0,didi chuxing roll silicon valley seeking automated car talent
0,2,4,27,0,7,0,31,0,trump wrong japan andmexico
0,1,10,31,1,7,0,41,0,"opec achieves cut output, halting price slide"
0,3,6,46,1,9,0,52,0,"coal seam gas mining cost farmer millions, csiro study find"
0,3,6,49,0,12,0,55,0,four cub top five mlb jersey sale since elusive series win
0,2,6,61,1,14,0,67,0,donald trump chilling comment dnc hack nothing russia
0,2,7,26,1,6,0,33,0,trust wikipedia health?
0,1,5,37,1,6,0,42,0,johnson johnson acquire cougar biotechnology
0,2,19,41,8,12,3,60,0,"trump's first 100 days: here's compare obama's, bush's, clinton's"
0,3,8,47,1,7,0,55,0,south korea prosecutor question former president park geun-hye
0,1,7,26,1,9,3,33,0,moore score 40 set mark no. 1 uconn
0,3,4,52,1,9,0,56,0,poll: immigration important problem trump congress
0,2,3,63,1,13,0,66,0,teenager replica gun shot los angeles police wanted die: police chief
0,1,3,26,0,4,0,29,0,yahoo launch new podcast search
0,3,6,30,0,5,0,36,0,retail boycott stopped making sense
0,3,7,41,0,9,0,48,0,deadline loom dakota protester leave campsite
0,3,2,56,1,11,0,58,0,"texas police officer faked death fled mexico, say official"
0,3,7,41,0,6,0,48,0,incarcerated vet finding healing shared space
0,3,9,44,1,9,0,53,0,french election sure thing gridlock parliament
0,1,5,38,0,8,1,43,0,3 american civilian die afghanistan attack
0,3,9,66,2,14,0,75,0,rewriting gray's anatomy: expert discover brand new organ human digestive system
0,3,4,68,0,12,0,72,0,israel accuses britain secretly playing lead role un resolution settlement
0,2,2,67,0,12,0,69,0,macron face uncertain first round french election hopeful vie last vote
0,3,4,48,2,8,0,52,0,eu politician business warn may 'difficult' brexit
0,3,18,50,3,14,1,68,0,super bowl synch master: umpg's tom eaton finalizing ad 3 day kick-off
0,3,8,41,1,8,0,49,0,"foreign policy, trump still speaking campaign language"
0,3,8,48,1,11,2,56,0,60 injured crowd crush australia's fall music art festival
0,3,12,41,0,11,0,53,0,watch firefighter bust icy lake save trapped dog
0,3,5,69,5,14,0,74,0,trump isnt first president saturday night live skewered. feud stand out.
0,2,17,52,6,11,0,69,0,"msnbc's lawrence odonnell: trump 'the laziest, ignorant president history'"
0,1,6,66,1,10,0,72,0,indian premier manmohan singh undergoes heart bypass; pranab mukherjee take charge
0,1,6,38,0,6,0,44,0,jim abbott continues motivate disabled athlete
0,3,7,39,3,8,2,46,0,james brown's 'funky drummer' clyde stubblefield dy 73
0,1,6,80,2,13,0,86,0,football: fa charge chelsea player misconduct; john terry investigated alleged racial abuse
0,2,5,44,3,9,0,49,0,factbox: apple u.s. government fighting
0,1,2,42,1,10,0,44,0,"dozen injured, one killed bomb blast egypt"
0,3,3,58,1,10,0,61,0,concern queen's health delay annual break sandringham
0,3,7,56,2,10,0,63,0,kkk documentary u tv channel accused 'normalising white supremacy'
0,2,6,38,0,7,0,44,0,trump grating style significant substance
0,3,4,20,1,4,0,24,0,"getting older, sleeping less"
0,3,5,59,1,13,0,64,0,tottenham stay hunt sunderland near drop football weekly extra
0,1,2,72,2,11,1,74,0,news international offer 3 million phone-hacking settlement family murder victim
0,3,14,57,4,14,0,71,0,kareena sonam kapoor bring house sassiness 'koffee' teaser!
0,3,5,23,0,4,0,28,0,janet jackson welcome son eissa
0,1,5,30,2,5,0,35,0,"new york's jfk airport evacuated, reopened"
0,3,10,29,2,7,4,39,0,nba trade deadline 2017: final b/r staff prediction
0,1,3,43,0,7,0,46,0,british newspaper make house lord bribery claim
0,2,6,64,3,14,1,70,0,game throne season 7: mark gatiss confirms return (and presumably iron bank)
0,3,7,47,3,9,0,54,0,"mick mulvaney, trump's omb pick, face question senate hearing"
0,2,3,50,1,7,0,53,0,french elections: centrist bayrou offer alliance macron
0,2,1,52,1,8,0,53,0,drug combo reversed plaque buildup heart patient artery
0,3,7,40,2,8,2,47,0,"han tietmeyer, former bundesbank president, dy age 85"
0,1,2,39,1,4,0,41,0,"tropical depression dissipates, impact mexico"
0,3,5,27,1,6,2,32,0,bodybuilding 50s: diet puzzle
0,3,6,27,1,5,0,33,0,illinois judge denies kevin gates' bail
0,1,3,38,2,7,0,41,0,'black boxes' pulled air india plane wreckage
0,3,14,57,2,14,2,71,0,"audience fails react jokes, kapil sharma cancel shoot within 15 minutes!"
0,1,1,49,2,9,0,50,0,"thai police, protester violent clashes; least one dead"
0,1,7,48,2,9,0,55,0,'scooter' libby jail sentence commuted u president george bush
0,2,11,40,2,10,0,51,0,craig venter mapped genome. he's trying decode death
0,3,5,41,1,10,0,46,0,"peace syria assad ousted, say nikki haley"
0,1,3,31,2,6,2,34,0,"edward woodward, english actor, dy aged 79"
0,3,7,37,0,9,0,44,0,russian critic putin assassinated ukraine
0,3,10,47,2,10,0,57,0,michael jordan's father's murder case could brought trial
0,1,8,27,3,6,0,35,0,"aid filing, g.m. reduces mileage estimate"
0,2,1,56,2,9,4,57,0,"turkey dismisses 4,400 public servant latest post-coup attempt purge"
0,2,2,65,1,10,0,67,0,three airline change policy wake united's passenger dragging incident
0,3,4,67,3,14,5,71,0,pakistan's anti-narcotics force burn 57 ton drug alcohol worth $152 million
0,2,1,47,1,11,0,48,0,md. house explodes day auctioned
0,2,9,52,1,7,0,61,0,google combat holocaust-denying search result algorithm update
0,2,2,58,2,9,0,60,0,"rupaul secretly got married, envision history's greatest wedding"
0,3,4,57,2,13,0,61,0,"political rise, stephen k. bannon man fixed address"
0,2,8,54,1,7,0,62,0,trump administration launch national-security probe steel import
0,3,4,59,1,10,0,63,0,nazi doctor josef mengele's bone used brazil forensic medicine course
0,2,10,35,0,11,0,45,0,meet woman poc sell trump merch living
0,3,12,40,3,9,0,52,0,"nobody safe republican undo net neutrality, fcc chair say"
0,1,6,34,0,6,0,40,0,juventus look early goal chelsea
0,3,4,79,11,16,0,83,0,"'phony,' 'failing,' 'worthless' name trump called year's pulitzer prize winner"
0,1,6,35,0,8,0,41,0,yankee rally beat lidge phillies ninth
0,2,3,53,2,8,0,56,0,thandie newton say historical drama 'limit' black british actor
0,1,5,32,0,5,0,37,0,russia cuba sign strategic partnership
0,2,6,25,0,8,0,31,0,fight ethic age trump
0,1,5,32,0,6,4,37,0,report royal international air tattoo 2009
0,1,7,29,0,7,0,36,0,new york film festival focus soccer
0,2,4,39,0,9,0,43,0,gold surge tension flare south china sea
0,2,11,37,0,8,0,48,0,gop official rail effort aimed nomination rule
0,2,5,61,0,10,0,66,0,german carnival mock donald trump theresa may controversial float
0,3,14,61,2,12,0,75,0,florida georgia line backstreet boy performance most-tweeted acm award moment
0,3,10,53,1,13,1,63,0,jusuf nurkic play game 3 vs. warrior recovering leg injury
0,2,3,47,0,9,0,50,0,turkey face long difficult fight isi syria
0,1,5,34,0,6,0,39,0,president mexico urge action emission
0,3,14,45,3,11,0,59,0,george h.w. bush practicing coin-tossing skill super bowl
0,2,17,49,0,13,0,66,0,punjabi mum addressing parent lgbt south asian fill withjoy
0,1,5,28,0,6,0,33,0,beltran play odds basepaths
0,1,8,44,0,9,2,52,0,epiphanny prince score 24 point rutgers top west virginia
0,1,2,36,1,5,0,38,0,well-preserved baby mammoth found siberia
0,3,12,67,0,13,0,79,0,david blaine almost died accidentally shooting mouth magic trick
0,1,2,33,0,5,0,35,0,man found dead stockholm explosion
0,3,2,58,3,11,1,60,0,"stopped ohio motorist handed 5-year-old son sippy cup wine, police say"
0,1,1,44,2,5,0,45,0,'expelled' producer accused copyright violation
0,2,5,34,5,11,0,39,0,slain nyc medic's son: 'i know die vain'
0,2,7,69,2,13,4,76,0,eurovision 2017: x-factor winner isaiah firebrace risky choice represent australia kiev
0,2,15,65,1,14,0,80,0,video show justin bieber getting smashed glass nhl all-star celebrity shootout
0,1,8,40,0,10,4,48,0,inquiry 1994 blast argentina jewish center get new life
0,3,4,55,0,8,0,59,0,kim kardashian celebrated christmas silently posing snapchats
0,2,4,49,2,9,0,53,0,"thanks trump ties, #deleteuber campaign grows social medium"
0,2,1,41,3,8,0,42,0,turkey went far coup response: legal expert
0,2,8,42,4,9,0,50,0,bbc: worker suing airline 'contaminated air' cnn video
0,2,8,44,1,10,0,52,0,restaurant review: mission chinese food lower east side
0,3,14,70,3,15,0,84,0,trump say nordstrom treated daughter unfairly; firework final vote jeff session
0,3,10,51,0,12,0,61,0,inevitable salt bae tattoo arrives pay tribute current meme god
0,2,12,35,3,7,0,47,0,late-night sxsw party claimed illmores throne?
0,1,4,35,2,8,0,39,0,"meth use usa's top drug problem, survey find"
0,2,9,50,4,9,0,59,0,"somewhere, taylor swift interpretive dancing lorde's 'green light'"
0,1,6,31,0,7,0,37,0,layer armed force wielding power law
0,1,8,45,0,9,0,53,0,democrat look way undo late bush administration rule
0,1,3,26,0,4,0,29,0,russian u satellite collide
0,2,2,74,2,15,0,76,0,trump say top priority 'protect serve' america amid backlash extreme vetting
0,2,5,24,3,4,0,29,0,snatch: rupert grint go gangster
0,1,5,32,0,6,0,37,0,hedge fund executive border chairman
0,3,5,42,2,8,2,47,0,iran's ex-president ali akbar hashemi rafsanjani dy 82
0,3,1,45,0,10,0,46,0,wyoming police dole donated money good deed
0,3,3,67,1,11,0,70,0,monash medical centre's sleep laboratory help kid struggle night
0,1,7,40,0,7,0,47,0,cosmetic surgery company settle case faked review
0,1,2,53,3,10,0,55,0,"uk government spy phone, email, browsing, entire population"
0,2,7,41,1,7,0,48,0,helen marten intricate sculpture win turner prize
0,3,2,46,2,8,2,48,0,"76ers-kings postponed due slick, slippery floor philly"
0,2,12,49,4,12,0,61,0,"global economy week ahead: fed bank england meetings, u.s. job report"
0,2,18,65,2,14,0,83,0,"european middleman haschke admitted swiss authority sp tyagi's bribe share, say cbi"
0,1,4,51,0,9,0,55,0,world cup qualifier may affected london underground strike
0,3,15,45,3,11,0,60,0,time low's alex gaskarth talk immigration ban aclu t-shirt campaign
0,1,1,40,1,6,3,41,0,canadian woman face 234 count double-doctoring
0,1,2,34,0,6,0,36,0,silent protest athens recent fire
0,3,11,56,6,12,3,67,0,"katy perry's 'bon appetit,' featuring migos, top billboard twitter trending 140 chart"
0,2,2,34,0,6,0,36,0,nepal quake turned woman builder
0,3,3,38,1,5,0,41,0,watch nintendo's switch presentation right
0,3,2,58,1,10,2,60,0,mosul: iraqi military recovers 61 body debris airstrikes probed
0,2,1,60,0,10,0,61,0,quebec supermarket donation program aid food bank tackle waste
0,1,4,29,0,6,4,33,0,south korean city win 2018 winter olympics
0,1,9,34,3,8,0,43,0,"innovation, u.s. said losing competitive edge"
0,2,3,45,1,10,0,48,0,visited j. crew witnessed business disaster
0,3,8,44,2,10,3,52,0,85-year-old woman cat survive 5 day colorado wilderness
0,3,3,43,1,11,0,46,0,affected flooding snow uk?
0,3,8,37,1,9,3,45,0,12.2 million people signed obamacare year
0,1,2,26,0,6,0,28,0,cyprus malta adopt euro
0,1,1,46,2,5,0,47,0,foot-and-mouth source confirmed research laboratory
0,3,10,41,1,10,0,51,0,raiders' move la vega oakland approved nfl owner
0,3,7,38,1,7,0,45,0,italian court boost renzis push early election
0,3,7,49,2,10,0,56,0,tom watson performs cheeky 'dab' pmqs corbyn blast may
0,3,3,75,0,12,0,78,0,hillary clinton reportedly blamed everyone humiliating defeat trump
0,1,3,11,1,2,0,14,0,charles b. rangel
0,3,10,58,1,9,0,68,0,christian slater looked perplexed tom hiddleston's golden globe speech
0,3,12,46,2,10,0,58,0,nfl john cena nail rob gronkowski impression 'saturday night live'
0,1,4,49,2,9,0,53,0,iraqi policeman killed protecting leader 'sons iraq'
0,3,5,31,4,6,0,36,0,report: isis's 'business model' near collapse
0,3,7,46,2,8,0,53,0,governor mexico write support detained seattle dreamer
0,3,3,59,1,10,0,62,0,beware exploding whales: new zealand issue warning mass stranding
0,2,5,64,3,15,0,69,0,trump claim tough christian syrian get united state
0,3,8,30,0,9,6,38,0,32 text 2016 really fuckingfunny
0,1,2,32,1,4,0,34,0,uk children's charity announce merger
0,2,2,73,2,13,2,75,0,claremont serial killings: man arrested women's murder still custody 24 hour later
0,3,4,51,1,12,0,55,0,"coral great barrier reef could saved big, bright cloud"
0,3,13,52,2,15,0,65,0,ed sheeran brought tear trip liberia red nose day [video]
0,2,2,72,2,16,0,74,0,video show police tackling beating black man suspected stealing car. his.
0,2,13,60,3,20,8,73,0,"week billboard chart history: 2009, kelly clarkson made record leap no. 1 hot 100"
0,1,1,24,0,6,0,25,0,net skill taught kid
0,1,2,83,3,12,0,85,0,anti-terror amendment rushed australian parliament new 'potential threats'
0,2,1,60,0,12,0,61,0,trump fire top aide urgent move reboot floundering campaign
0,1,1,38,0,8,0,39,0,bush may deploy military bird flu break
0,3,2,57,0,10,0,59,0,receding glacier cause immense canadian river vanish four day
0,2,1,39,2,11,2,40,0,study: 30% kid two sugary drink day
0,3,13,45,4,11,0,58,0,"sza's debut album: rihanna, rick rubin sleepaway camp influenced"
0,2,4,48,0,7,0,52,0,wonderfully quirky scene sumo world championship
0,2,2,40,1,8,0,42,0,dallas cop want help iraqi man shooting death
0,3,12,56,2,15,4,68,0,baltimore raven claim they're taking boat 2017 london game april fool's day joke
0,2,10,50,2,12,0,60,0,"draymond green's mom, grandma told stop cry official much"
0,2,3,57,2,12,0,60,0,"apple tax ruling mean ireland, tax multinationals"
0,3,15,39,2,9,0,54,0,chat app line challenge amazon's alexa ai-assistant
0,3,6,40,2,8,0,46,0,"real not? lance mccullers, sleeper cy young contender"
0,1,6,54,0,9,0,60,0,gm chrysler receive canadian loan amid u restructuring ultimatum
0,3,8,33,3,6,0,41,0,"asian nation want u.s. leadership, australia say"
0,1,1,40,0,8,0,41,0,warming ocean make harder fish breathe
0,1,6,28,0,7,0,34,0,fiat give detroit lesson small car
0,1,4,27,1,6,0,31,0,"four shot restaurant alabama, u"
0,3,4,70,1,11,0,74,0,bill snyder expected attend k-state spring practice despite throat cancer diagnosis
0,1,2,40,1,4,0,42,0,farrah fawcett's funeral arrangement announced
0,1,2,29,1,3,0,31,0,"brazil, bolivia promise cooperation"
0,1,2,58,0,9,1,60,0,authority arrest 7 state official mexico childcare centre fire
0,3,2,26,2,6,0,28,0,refugee ban: matter?
0,2,1,44,0,9,3,45,0,150 dead overflowing river rip city
0,3,12,66,1,12,0,78,0,quebec mosque shooting suspect reportedly white nationalist known right-wing troll
0,1,3,59,0,9,0,62,0,tsunami warning briefly issued indian ocean latest earthquake
0,1,7,34,0,6,0,41,0,stock rise sharply treasury bond auction
0,1,2,32,0,7,0,34,0,romania plan send troop iraq
0,3,1,76,3,12,0,77,0,uber launch self-driving car fleet despite warning regulator 'cease operation'
0,1,8,46,1,9,0,54,0,"homeland security nominee, good leadership detail"
0,1,5,33,0,5,0,38,0,shift marijuana policy delay sentencing
0,1,5,38,1,7,2,43,0,gmail 1st birthday; storage capacity increased 2gb
0,3,2,31,0,5,0,33,0,cyber attack transformed estonia
0,2,2,52,0,9,0,54,0,gunman dead firing dallas police outside headquarters
0,3,7,35,1,7,0,42,0,"obese couple take longer conceive, study find"
0,1,7,53,0,9,0,60,0,u secretary state hillary clinton pledge support afghanistan
0,2,2,53,3,9,0,55,0,colombian air traffic controller: 'i humanly possible'
0,1,3,54,1,7,0,57,0,disputed island disappears beneath sea india-bangladesh border
0,2,12,52,3,12,0,64,0,"dolly parton, cyndi lauper, kenny g share favorite christmas song"
0,3,18,38,4,14,0,56,0,pm modi beat barack obama win time 'person year' reader poll.
0,1,5,33,0,4,0,38,0,obama push financial regulatory overhaul
0,1,9,26,0,6,1,35,0,hsbc may sell 3 prominent office building
0,3,6,36,3,6,2,42,0,"peter sarstedt, british singer-songwriter, dy 75"
0,2,3,55,1,8,0,58,0,secret service fire two officer march fence-jumping incident
0,2,5,29,1,6,0,34,0,robert mugabe: give donald trump chance
0,2,6,15,1,3,0,21,0,"colombian plans, part iii"
0,2,7,51,3,8,0,58,0,krauthammer: syria strike 'total contradiction bannonism' insider
0,3,7,39,1,9,1,46,0,sarah sand named editor bbc radio 4's today programme
0,2,4,45,1,7,0,49,0,european games: vanessa sahinovic coma collision
0,3,5,22,0,5,0,27,0,trump golf course open dubai
0,2,2,45,1,11,3,47,0,lyft trying raise $500 million fight uber
0,2,10,46,3,10,0,56,0,donald trump trash phony bob vander plaats twitter breitbart
0,2,2,39,0,9,4,41,0,last chance sign obamacare 2017 coverage
0,1,4,29,2,5,0,33,0,"mr. miyagi pass away, thanksgiving day"
0,1,6,29,0,6,0,35,0,rachel alexandra face colt haskell
0,1,5,55,0,11,2,60,0,adult h1n1 swine flu death take northern ireland death toll seventeen
0,1,2,34,1,8,4,36,0,"fear loathing campaign trail, may 2008"
0,1,3,24,3,6,0,27,0,interpol hunt 'dr. death'
0,1,7,30,1,8,2,37,0,50-year streak end cuba fails reach final
0,1,5,79,2,13,4,84,0,2012 report gender equality development credit icelandic parental policy 'hopeful' change
0,2,11,69,1,12,0,80,0,ag jeff session unveils program accelerate deportation imprisoned illegals breitbart
0,3,3,48,3,9,0,51,0,viceroy's house review soapy account india's birth agony
0,1,6,32,1,5,0,38,0,japan sends destroyer anti-piracy patrol
0,1,1,34,0,4,0,35,0,conficker computer worm infection soar
0,3,12,39,2,9,0,51,0,gop senator blame paid protester deluge phone call
0,2,8,39,0,8,1,47,0,5 time christopher lee played great movievillains
0,3,5,36,1,9,0,41,0,olney: yadier molina deserves hall famer
0,1,8,31,2,8,0,39,0,bomb kill g.i. baghdad attack keep rising
0,2,14,56,2,15,0,70,0,trump talk muslim led acting attorney general defy ban new york time
0,3,4,25,3,5,0,29,0,'snl' mock trump's press conference
0,2,1,41,3,10,0,42,0,ode hope (and techno): poem get going
0,1,3,43,0,8,0,46,0,hundred lawsuit filed music sharer u
0,1,2,48,0,7,0,50,0,two chicago school evacuated suspicious package found
0,2,5,38,2,5,0,43,0,australia introduces value test citizenship
0,1,5,27,5,7,2,32,0,"james doohan, star trek's 'scotty', dy 85"
0,2,3,64,1,10,0,67,0,martin shkreli's twitter account suspended post creepy photo collage
0,2,11,41,4,11,1,52,0,walking dead star play punisher daredevil season2
0,1,2,30,0,5,0,32,0,gay iranian awaits decision asylum
0,3,1,56,1,11,0,57,0,muscle start aching morning workout
0,2,4,62,1,13,0,66,0,forget gold bikini. people mental illness carrie fisher queen
0,1,4,33,1,6,2,37,0,technology giant battle usb 3.0 standard
0,1,8,34,0,8,0,42,0,top air force official alter view fighter jet
0,1,6,27,0,6,0,33,0,foreign film get hand hollywood
0,3,14,58,4,16,11,72,0,"supreme court's highway liquor ban hit 2,000 hotels, 10,000 restaurant 10 lakh job"
0,1,4,27,0,5,0,31,0,two prime minister banned fiji
0,3,3,58,3,11,4,61,0,fukushima: parents' long search child swept away japan's 2011 tsunami
0,1,2,61,0,9,0,63,0,australian receives bravery award rescue indonesian air disaster
0,2,7,67,2,15,0,74,0,deviate: science seeing differently beau lotto review need brain control
0,1,7,26,2,8,2,33,0,u.s. drone strike said kill 60 pakistan
0,2,12,52,3,14,0,64,0,j.j. watt biggest star fieldeven technically field
0,3,3,47,0,7,0,50,0,iraq bomb attack target iranian kurdish opposition party
0,3,9,44,2,9,3,53,0,"zenefits lay 430 employees, one year founder's departure"
0,3,8,39,0,11,0,47,0,pharrell first man star chanel bag campaign
0,1,1,47,0,6,0,48,0,australian opposition minister give speech poverty
0,2,8,39,2,7,0,47,0,trump aide say press secretary used alternative fact
0,1,8,31,1,8,3,39,0,martin hold gordon win lifelock.com 400
0,1,1,40,1,8,3,41,0,"7 killed, 50 injured bangladesh shopping mall fire"
0,2,6,21,1,6,0,27,0,obamas job record stack
0,1,7,41,0,9,0,48,0,powerful force work inside physic hitting
0,3,2,59,0,10,0,61,0,john lewis skip inauguration second time congressional career
0,2,15,58,0,13,0,73,0,campaigner taking uk government court selling weapon saudiarabia
0,1,2,42,0,7,0,44,0,suicide bomber kill seven people afghan capital
0,1,4,26,0,5,0,30,0,church envoy attacked iraq
0,1,6,40,0,8,0,46,0,nadal master clay consistent relentless
0,2,5,59,1,9,0,64,0,"disappointing super tuesday, kasich turn focus midwestern state"
0,1,8,39,3,11,1,47,0,"kim clijsters, former no. 1, expected return tennis"
0,2,3,55,1,9,0,58,0,barry bennell: former football coach denies eight child sex offence
0,1,2,85,0,14,0,87,0,local government official confiscate london ice cream made human breast milk health reason
0,3,12,30,0,8,0,42,0,nyse etf trading suffers second straight outage
0,2,13,60,0,12,3,73,0,two airbus a320 plane carrying hundred passenger escape midair crash varanasi
0,2,8,48,1,9,0,56,0,"hirakhand express train derails southern india, killing dozen"
0,1,1,34,2,7,0,35,0,jersey child abuse case 'was covered up'
0,3,16,63,3,16,2,79,0,"$10 million funding, ariel kaye's parachute aiming shake home essential market"
0,2,3,58,0,11,0,61,0,spacex stick daytime rocket landing back earth launch space
0,3,10,46,0,9,0,56,0,watch volcanic eruption fire upside lightning bolt
0,1,3,51,1,8,0,54,0,bigoted woman: controversial gordon brown remark caught air
0,2,8,44,0,8,0,52,0,pipeline deal help push canadian takeover abroad record
0,2,5,20,0,5,0,25,0,nun charted star
0,1,5,44,0,6,0,49,0,cristiano ronaldo crash ferrari manchester airport
0,1,5,28,0,7,3,33,0,death toll australian fire rise 200
0,2,2,48,3,9,0,50,0,trump lie working brilliantly. new poll prof it.
0,2,8,45,4,8,0,53,0,"obmanos! president barack obamas legacy, latino lens"
0,3,8,45,1,10,0,53,0,"unilever bid premium fades, factor support stock"
0,2,2,55,1,12,0,57,0,"fake news take facebook feeds, many taking satire fact"
0,2,11,45,0,10,0,56,0,killing reindeer stop anthrax could snuff nomadic culture
0,1,2,58,1,10,0,60,0,"muslim cleric, two officer killed gun attack southern russia"
0,2,11,46,0,9,0,57,0,spacex plan moon flyby face economic technical challenge
0,3,8,31,1,7,0,39,0,pronounce harry potter spells?
0,3,1,17,1,3,0,18,0,trump's new travel ban
0,3,12,50,7,11,0,62,0,"bonobo, die antwoord, m.i.a. announced germany's melt festival lineup"
0,1,4,34,1,6,4,38,0,second arab-israeli bulldozer attack july 2008
0,3,2,49,0,8,0,51,0,robot probe show japan reactor cleanup worse expected
0,2,11,45,2,10,0,56,0,"trump read, protester flooding office book"
0,3,2,56,0,10,0,58,0,photo show extreme measure migrant take reach europe
0,1,4,24,1,6,5,28,0,major league soccer 2008: week 7 roundup
0,1,2,59,0,9,0,61,0,mansour announces election plan egypt violence protest
0,3,12,58,2,11,0,70,0,john legend's response chrissy teigen's postpartum depression essay lovely
0,1,6,28,0,6,0,34,0,lexapro maker forest accused fraud
0,2,3,70,1,14,0,73,0,"clean energy subsidy could used build new coal power plants, scott morrison say"
0,2,3,68,1,12,0,71,0,iraq investigation rightly questioning turn whitehall
0,1,4,34,1,6,0,38,0,saudi arabia's king fahd admitted hospital
0,3,11,60,0,14,0,71,0,woman caught trying sneak boyfriend prison stuffing pink suitcase
0,2,4,53,2,11,0,57,0,pc palmer deserved respect. owe public-sector worker
0,2,9,30,2,8,0,39,0,los angeles mayor declares today 'la la land' day
0,2,2,66,1,9,0,68,0,facebook employee protesting trump's immigration ban boycotting flying
0,1,7,31,0,8,0,38,0,gulf oil state seeking lead clean energy
0,3,7,28,4,8,1,35,0,"maluma drop new single video, 'felices los 4'"
0,1,2,40,1,5,0,42,0,scotland's grangemouth oil refinery catch fire
0,2,3,34,1,5,0,37,0,nordstrom dump ivanka trump fashionline
0,3,8,49,0,10,0,57,0,ten thousand californian allowed return home around dam
0,2,1,21,0,5,2,22,0,12 thing know pluto
0,2,6,69,2,15,4,75,0,former norwegian prime minister detained dulles airport hour. visited iran 2014.
0,2,7,38,0,9,0,45,0,unfair opacity credit card peddled poor
0,3,8,48,2,7,0,56,0,university churning billionaire [infographic]
0,1,4,42,1,9,4,46,0,contador win 2009 tour de france; cavendish win six stage
0,2,11,46,1,9,0,57,0,twitter ceo temporarily suspended platform breitbart
0,3,1,34,0,5,0,35,0,trump stand unverified wiretap claim
0,3,7,51,1,11,0,58,0,national museum african american history culture: know
0,1,5,27,0,5,0,32,0,fraud victim want maximum madoff
0,3,1,44,0,7,0,45,0,japan hold first civilian missile evacuation drill
0,1,1,37,1,5,0,38,0,"sydney train door stuck, passenger delayed"
0,3,2,40,4,9,5,42,0,"4-year-old who's read 1,000 book tour library congress"
0,1,1,24,1,4,0,25,0,haiti relief efforts: depth
0,1,7,35,1,8,0,42,0,"bond investors, focus scrutiny timing"
0,2,7,62,8,14,0,69,0,josh gad address gay 'beauty beast' character l.a. premiere: 'it's important'
0,3,12,50,1,11,0,62,0,"meet fancy feast, burlesque performer named cat food"
0,1,2,42,1,8,0,44,0,man dy serbian enclave; could call ambulance
0,1,6,44,0,7,0,50,0,indymac bank placed conservatorship u government
0,1,5,27,0,6,0,32,0,chavez want un uprooted new york
0,3,3,67,2,11,0,70,0,here's anti-trump protest played washington inauguration
0,2,9,33,5,9,0,42,0,watch sia's lyric video 'lion' theme 'never give up'
0,3,2,54,1,10,0,56,0,starbucks: nearly third sale made digitally last quarter
0,2,13,40,0,12,0,53,0,half american think medium tough trump
0,3,1,32,1,6,0,33,0,sort automatic gearbox best?
0,3,4,51,0,7,0,55,0,police raid french parliament franois fillon investigation
0,3,1,58,0,8,0,59,0,watching magnet morph liquid rocket fuel hypnotically beautiful
0,1,2,43,0,8,0,45,0,nine oil worker die helicopter crash siberia
0,1,5,15,0,3,4,20,0,2010 brit award highlight
0,2,5,40,2,7,0,45,0,"diana douglas webster, mother michael douglas, dy"
0,2,3,47,0,7,0,50,0,friendly hippo save struggling duckling rotterdam zoo
0,1,7,31,1,6,0,38,0,no-hit streak high schooler schuster end
0,1,9,20,4,8,0,29,0,"cnn, go-to site, get stay?"
0,1,1,41,0,6,0,42,0,british motorist showered cash motorway
0,2,15,34,4,11,1,49,0,ceo responds 7-year-old girl asked 'google boss' job
0,2,2,32,1,6,0,34,0,trump's pick army secretary drop
0,1,5,22,2,5,0,27,0,u.s. senator larry craig resign
0,1,6,34,0,6,0,40,0,senior afghan general dy helicopter crash
0,1,2,51,0,9,0,53,0,rwandan genocide investigation completed end july
0,2,1,47,0,8,0,48,0,cleveland bar customer fight back armed robbery
0,1,10,41,1,12,0,51,0,"knicks look forward, must put price lee robinson"
0,1,4,43,0,7,0,47,0,australian mp demand islamic headscarf ban school
0,1,3,58,0,10,0,61,0,autopsy reveals terri schiavo persistent vegetative state
0,3,7,48,0,9,0,55,0,scientist drill deep harness awesome energy volcano
0,1,4,35,2,6,0,39,0,"swiss woman gang-raped madhya pradesh, india"
0,3,13,52,4,10,0,65,0,"watch zedd's aclu benefit concert featuring miguel, tinashe, skrillex,"
0,2,1,35,0,8,1,36,0,4 reason love weird science fringe
0,2,5,46,2,9,0,51,0,"trump, clinton rack super tuesday wins; cruz keep foothold"
0,3,10,43,3,10,0,53,0,rupauls advice loving something need hear
0,1,3,61,1,7,0,64,0,israeli foreign minister reportedly boycott brazilian president's visit
0,1,6,44,0,7,0,50,0,europe offer glimpse difficulty financial reform
0,3,10,39,0,9,0,49,0,uber president jones quits amid turmoil search coo
0,3,9,41,1,9,0,50,0,watch live: michelle obama give final remark first lady
0,1,4,49,0,7,0,53,0,u secret service officer arrested prostitution sting
0,1,7,31,2,10,0,38,0,dell would 'happy' sell pc running mac o x
0,2,4,62,0,11,0,66,0,david lemieux back title hunt devastating knockout curtis stevens
0,1,3,36,2,6,1,39,0,wikinews interview 0 a.d. game development team
0,3,7,28,1,7,6,35,0,morgan stanleyvoice: 10 shrewd tax move 2017
0,1,4,24,0,6,0,28,0,taking measure big east
0,2,11,39,1,8,0,50,0,nyse exchange-traded fund platform hit technical glitch
0,3,7,59,0,13,0,66,0,duchess cambridge take control aircraft used train raf air cadet
0,2,2,61,0,12,0,63,0,next republican fight could even worse one healthcare
0,3,12,42,2,11,0,54,0,country artist sing pot music (even rap)
0,1,4,44,0,9,0,48,0,south korea say north korea test nuclear bomb
0,1,1,41,2,8,0,42,0,"iraq ballot audited due voting ""anomalies"""
0,2,4,48,3,11,0,52,0,russia accused 'state terrorism' ex-mp shot dead ukraine
0,2,4,42,0,9,0,46,0,eiffel tower go dark solidarity aleppo
0,2,3,33,2,7,0,36,0,trump hoping seize iraq's oil reserves?
0,2,7,39,1,8,0,46,0,assailing white house hollywood glass house
0,1,2,38,0,5,0,40,0,australia drop charge indian doctor
0,3,10,42,2,8,0,52,0,there's prosecco-flavored edible nail polish
0,2,13,64,1,11,0,77,0,nine hilarious quote rahul gandhi-akhilesh yadav press conference poll alliance
0,2,1,23,1,5,0,24,0,dont tell u pizzasucks
0,3,4,74,4,15,0,78,0,"copeland defeat fallout: labour leadership must take long hard look itself, tom watson say"
0,2,2,55,2,11,1,57,0,"couple keep pregnancy secret 9 months, surprise grandma yahoo"
0,2,2,62,0,13,0,64,0,brooklyn beckham got first tattoo internet lot question
0,3,12,38,0,11,0,50,0,cutest dog ever give free hug stranger new york city
0,3,14,37,2,9,0,51,0,get know rising k-pop band astro: exclusive video interview
0,1,7,33,0,6,0,40,0,sandisk offer flash drive simplify backup
0,2,7,42,1,6,0,49,0,india's demonetization affecting bitcoin startup
0,2,12,36,4,11,0,48,0,u.s. plan expand airline laptop ban u.k. airport
0,1,1,34,0,5,0,35,0,blair launch third final manifesto
0,3,13,47,1,12,0,60,0,"chinese new year, fake donald trump tweet break internet china"
0,1,8,42,0,8,0,50,0,softball pitching star rachele fico prepares next step
0,1,6,36,1,7,0,42,0,even well-off consumer aim less conspicuous
0,1,1,25,1,4,0,26,0,oil price reach six-month high
0,1,7,34,0,7,0,41,0,onboard device could offer clue montana crash
0,3,1,43,0,8,0,44,0,smartwatch wear emotion sleeve
0,3,7,49,3,11,2,56,0,oregon vs. arizona: pac-12 tourney title proximity ncaas stake
0,3,11,43,5,10,0,54,0,what's favorite prince royce collab new album 'five'? vote!
0,2,1,49,2,8,1,50,0,"chicago torture video: 4 charged hate crimes, kidnapping"
0,3,13,59,0,12,0,72,0,twitter laughed mercilessly tomi lahren reportedly lost job blaze
0,1,5,24,0,5,0,29,0,stress test prove sobering idea
0,2,9,32,3,8,0,41,0,sia without wig stunning! gorgeous! legend!
0,1,8,21,4,4,0,29,0,ex-k.g.b. agent buying london tabloid
0,3,2,40,2,5,0,42,0,climate change could render sudan 'uninhabitable'
0,1,6,28,0,6,0,34,0,pittsburgh cap rally win stanley cup
0,2,1,78,0,11,0,79,0,trump confidant serving presidential adviser could face tangle potential conflict
0,2,9,48,0,9,0,57,0,charge dropped family cheered loud graduation
0,1,5,31,0,5,0,36,0,newspaper company make cutback
0,3,11,33,2,10,0,44,0,'sad taylor swift' meme gift keep giving
0,2,1,61,1,12,1,62,0,hastert pleads guilty 2 count fraud charge hush-money scandal
0,1,6,37,0,7,2,43,0,16 foot asteroid pass earth satellite
0,3,3,53,0,10,0,56,0,passenger hijacked libyan plane leave malta return home
0,1,5,51,2,10,10,56,0,euro 2008 qualification: finland defeat kazakhstan 2-1 euro 2008 qualifier
0,1,2,25,0,4,0,27,0,seven killed chinese bombing
0,1,5,32,0,6,0,37,0,lawmaker call change paying bonus
0,1,6,33,0,7,0,39,0,hair provide clue shift elephant diet
0,1,4,36,2,7,0,40,0,house vote repeal washington d.c. handgun ban
0,1,2,42,1,8,0,44,0,cargo plane crash near khartoum; least four dead
0,1,6,38,1,8,0,44,0,"light centre court, waiting federer"
0,2,5,32,0,8,2,37,0,suicide bomber kill 13 protest pakistan
0,1,7,27,1,8,0,34,0,"governor say money, reaps boo"
0,3,3,42,0,7,0,45,0,trump call freedom caucus member tweetstorm
0,3,8,45,0,7,0,53,0,federal judge shuts indiana abortion ultrasound mandate
0,2,1,61,1,13,0,62,0,"bright new star burst sky five years, astronomer predict"
0,2,14,46,1,13,0,60,0,"tech leader vow resist trump, also hope find common ground"
0,2,5,58,0,10,0,63,0,child living autism face frustrating therapy gap waiting ndis
0,2,14,41,7,12,0,55,0,"weekend briefing: ted cruz, donald trump, n.f.l. new york time"
0,2,2,50,0,8,0,52,0,vladimir putin become murderous anddangerous
0,2,4,58,0,9,0,62,0,arsenal rediscover swagger swansea alexis snchez rage
0,2,4,56,4,6,0,60,0,hawaii's attorney general: religious hostility 'violates constitution'
0,2,5,62,4,14,0,67,0,"broke me: defiant, tearful kathy griffin slam attack trump family"
0,3,1,67,0,13,0,68,0,scouring river bed history book discover platypus threat
0,1,3,34,0,7,0,37,0,un office pakistan hit suicide bomber
0,2,11,41,2,10,0,52,0,come next may prepares trigger brexit: quicktake q&a
0,1,7,30,0,7,0,37,0,study find steep drop state tax revenue
0,3,8,51,4,12,2,59,0,here's comprehensive breakdown 16 'cs:go' team eleague major
0,1,7,29,1,7,0,36,0,"giant pack up, issue chagrin linger"
0,1,1,37,1,4,0,38,0,pakistan's governing coalition break apart
0,2,4,23,3,4,0,27,0,secret churchill war room
0,2,9,53,3,10,0,62,0,donald trump's official @potus account registered gmail address?
0,1,8,39,0,8,0,47,0,growing taste reef fish sends number sinking
0,2,5,52,1,11,0,57,0,new zealand corey anderson miss rest england tour injury
0,1,6,60,0,12,0,66,0,author billion year contract reflects life elite scientology group
0,3,12,45,2,12,0,57,0,"watch demi lovato bury james corden diva then, diva riff-off"
0,2,3,83,5,16,0,86,0,"last year's bizarre weather prof man-made climate change real 'no room doubt', say scientist"
0,3,6,35,0,7,0,41,0,meet woman responsible pink protest hat
0,1,2,25,0,4,0,27,0,paris hilton released jail
0,3,2,38,0,7,0,40,0,donald trump brings old lawsuit new address
0,1,4,70,1,16,4,74,0,"two people die contracting h1n1 virus, number swine flu death scotland rise 28"
0,2,3,33,2,7,0,36,0,trump 'willing work russia china'
0,1,5,54,2,8,0,59,0,"kay hagan sue elizabeth dole ""godless"" television advertisement"
0,1,3,62,1,9,0,65,0,"los angeles hospital lies, discriminates saudi liver transplant patient"
0,1,1,30,0,5,0,31,0,saturn moon may contain liquid water
0,1,5,28,0,5,0,33,0,north carolina approves ban smoking
0,3,1,57,2,9,0,58,0,five people hospital 'taking prescription drug alcohol'
0,3,1,48,2,9,0,49,0,france election: voter go poll wide-open contest
0,1,8,34,1,7,0,42,0,"security talk iraq needed, iran signal"
0,1,2,61,0,7,0,63,0,compensation funding agreement reached australian asbestos victim
0,1,3,45,2,9,3,48,0,garuda indonesia flight 200's pilot's trial begin week
0,2,9,44,1,9,0,53,0,cardinal star adam wainwright throw awful wild pitch vs. cub
0,2,1,53,0,7,0,54,0,mariner imposing order limit popular toasted grasshopper
0,2,1,45,0,7,0,46,0,obama make first public remark since leaving office
0,3,7,43,2,7,0,50,0,cnn/orc poll: expectation plummet health care overhaul
0,2,1,44,0,9,1,45,0,philadelphia officer fired upon 2nd night row
0,1,4,23,2,5,3,27,0,company cutting 401(k) match
0,1,2,13,0,4,2,15,0,rosa park dy 92
0,1,7,38,1,8,0,45,0,"obama selling economic plan airwaves,"
0,2,2,44,0,9,0,46,0,widening ethnic crack raise fear new war bosnia
0,1,4,36,1,6,0,40,0,"italian pm prodi loses confidence vote, resigns"
0,2,10,39,0,8,0,49,0,va dropping veteran caregiver roll
0,2,14,62,1,13,0,76,0,carmelo anthony give teenage cancer patient free new kia car celtics-knicks game
0,2,9,44,1,9,0,53,0,primark plan biggest expansion decade chain's sale soar
0,1,5,61,0,7,0,66,0,wikinews interview australian wheelchair basketball player tina mckenzie
0,2,3,62,2,12,0,65,0,"crucial vote, hillary clinton fails rally woman history-making bid"
0,2,9,29,2,8,0,38,0,donald trump plan revamp top u.s. spy agency
0,1,7,32,0,8,0,39,0,aging water main becoming hard ignore
0,1,8,40,0,9,0,48,0,hard foul loose elbow spark syracuse second half
0,3,8,43,2,11,0,51,0,james bond philanthropy give away last fortune
0,3,5,61,2,15,0,66,0,"pluto show face new image nasa, best-ever shot dwarf"
0,1,3,41,1,7,0,44,0,"police discover five body victoria, canada home"
0,1,7,33,0,9,0,40,0,arrest said near killing chandra levy
0,1,8,32,2,8,0,40,0,china say u.s. distorts fact report right
0,2,3,60,0,12,0,63,0,fight defund planned parenthood little abortion
0,3,17,71,2,16,0,88,0,"completely selfless gesture, gautam gambhir donates man match money sukma martyrs' family"
0,1,7,40,2,7,0,47,0,"paulus, former duke guard, chooses syracuse football"
0,3,5,21,0,5,4,26,0,bbc launch 2017 komla dumor award
0,3,2,31,0,5,0,33,0,sodastream issuing massive recall
0,3,5,43,5,9,0,48,0,killing bill (in style noted historian bill oreilly)
0,3,4,87,2,14,0,91,0,"manslaughter charge british marine, alexander blackman, sends serious message military"
0,2,2,35,2,9,2,37,0,hide seek: fed find $20 million mattress
0,3,1,29,1,7,3,30,0,world's oldest person died 117
0,2,12,37,2,12,0,49,0,donald trump say offer u.k. quick fair trade deal
0,3,12,28,5,9,0,40,0,pete davidson 'snl' say he's drug 'happy'
0,3,2,33,0,7,0,35,0,mount etna erupts first time year
0,3,4,70,4,14,0,74,0,"limit outrage: liberal journalist coming grip trump's win, hillary's loss"
0,3,5,35,2,7,4,40,0,2017 resolutions: cultural goal new year.com
0,2,1,50,1,8,0,51,0,china's first big jetliner clear final hurdle flying
0,3,10,43,1,9,0,53,0,photo reveal brutal reality ignored trump's refugee ban
0,1,5,29,0,5,0,34,0,geithner pressed bailout detail
0,3,7,36,2,7,0,43,0,"feel squished? airline shrinking headroom,"
0,1,3,42,0,7,2,45,0,prolific television producer aaron spelling dy 83
0,3,2,89,1,24,0,91,0,man killed tiger china scaled wall enclosure bid avoid paying zoo's entrance fee
0,3,8,44,0,9,0,52,0,syrian refugee heap praise trump airstrike insider
0,1,4,26,0,4,0,30,0,lebanese soldier killed ambush
0,1,5,32,2,6,0,37,0,"diamond sales, prices, plunge downturn"
0,1,5,30,0,7,2,35,0,senior aide hussein sentenced 15 year
0,2,2,40,1,9,0,42,0,trump save many carrier job claimed
0,3,9,50,0,11,0,59,0,choice health secretary vague replacing affordable care act
0,2,5,30,0,6,0,35,0,continuing quest perfect shot
0,3,2,42,1,9,6,44,0,"human america 100,000 year earlier thought"
0,1,4,55,0,10,0,59,0,man florida bus threatened knife praising michael jackson
0,3,6,19,0,6,4,25,0,richest woman world 2017
0,2,12,54,0,12,0,66,0,redskin safety duke ihenacho us tape make cleat look like chuck taylor
0,1,4,50,0,9,0,54,0,u prosecutor mike nifong disbarred ethic violation
0,3,5,59,3,10,0,64,0,"""frat life matter"" spray-painted uconn campus frat member arrested"
0,2,4,42,3,10,0,46,0,"stark farewell, obama warns threat u. s. democracy"
0,3,1,44,1,12,2,45,0,buy 40 ro we've reached peak ro
0,3,3,37,4,10,2,40,0,obama's last money shower un: $9.2 billion
0,2,2,55,2,15,0,57,0,early draft obama legacy theyre way top
0,3,6,56,5,14,0,62,0,"bears, chief texan gave plenty risky qb prospect ... here's"
0,2,4,37,1,5,0,41,0,neil gorsuchs stealth supreme court nomination
0,3,9,47,0,12,0,56,0,ralph lauren latest fashion victim new era retailer
0,2,5,61,1,10,0,66,0,"man removed flight allegedly harassing ivanka trump, jared kushner"
0,1,2,34,1,5,0,36,0,"google launch web browser, dubbed chrome"
0,1,3,42,2,7,4,45,0,2007 european football friendly match: england vs. germany
0,2,1,66,1,12,0,67,0,"indiana kid dead falling ice pond behind home, authority say"
0,3,2,31,1,4,0,33,0,five question comeys testimony
0,2,13,43,1,12,0,56,0,odell beckham jr. call nfl fining craig sager cleat
0,2,13,37,0,12,0,50,0,dan rather become viral voice reason trump era
0,2,2,83,4,15,0,85,0,protest trump's immigration order erupted across country here's like
0,2,6,43,0,9,0,49,0,italy prime minister matteo renzi step friday
0,2,10,37,0,9,0,47,0,adam carolla went manual laborer medium mogul
0,3,8,40,1,8,0,48,0,subway blast putin's hometown show rising terror risk
0,2,1,36,0,7,0,37,0,israel relaxing law marijuana use
0,3,14,50,0,14,0,64,0,dj khaled brought tear following new single beyonc jay z
0,2,1,39,0,7,0,40,0,visa crackdown put rural doctor risk
0,3,3,45,3,6,0,48,0,benjamin netanyahu: allegation 'baseless'
0,2,11,53,6,12,0,64,0,"donald trump responds obama: rattle someone, thats good breitbart"
0,1,9,31,0,7,0,40,0,alesis tapelink move song cassette cd
0,1,4,36,0,10,2,40,0,12 hurt san luis de la balsa tourist bus accident
0,2,3,36,0,8,0,39,0,lesson trump bipartisan bushera
0,3,8,30,4,8,0,38,0,guess favorite fast furiousmovie?
0,3,9,30,4,7,0,39,0,there's thing 'habitable super-earth'
0,2,1,55,1,9,0,56,0,hotdog cheese burger layered chip freaky combination
0,2,1,44,0,6,0,45,0,engineer outfit dragonfly hybrid drone tech
0,3,2,55,2,12,0,57,0,would ditch family fame? many millennials say would
0,3,8,28,0,7,0,36,0,diehard drake fan love new tattoo
0,3,10,50,3,9,0,60,0,indonesian artist angger dimas explains 'om telolet om' craze: exclusive
0,2,4,67,1,11,0,71,0,donald trump inauguration: watch stream presidential ceremony online
0,2,3,46,0,10,0,49,0,ahmadinejad trump twitter match made heaven
0,2,10,42,3,9,0,52,0,here trump white house shut national parkstwitter
0,3,4,69,1,16,6,73,0,javier methol: businessman survived 72 day andes plane crashed 1972
0,3,3,73,1,13,0,76,0,starbucks howard schultz hand key successor emotional investor meeting
0,2,5,41,2,11,0,46,0,guardian view rb sell-off: bad deal round
0,3,12,46,0,9,1,58,0,ncaa reconsider north carolina championship hb2 repeal
0,3,3,58,3,16,9,61,0,"nearly 40 college u 4-year degree cost $250,000"
0,3,8,42,1,7,0,50,0,magician found dead inside hollywood's iconic magic castle
0,3,3,49,1,10,0,52,0,"rare concession, top dem predicts gorsuch confirmed"
0,1,9,32,2,8,0,41,0,"reno, nev. art canvas include shag carpet"
0,2,6,39,3,8,4,45,0,kirsten gillibrand anti-trump left: 2020 foresight?
0,1,5,31,0,7,0,36,0,rising doubted dream reservation
0,3,9,38,0,9,0,47,0,two alameda county deputy fired role sf beating
0,2,13,46,0,12,1,59,0,man sentenced 4 month jail landing gyrocopter u capitol lawn
0,3,3,76,1,12,0,79,0,"facebook announces crackdown revenge porn main site, messenger instagram platform"
0,3,3,49,0,8,0,52,0,thousand protest hungary threat soros university
0,1,6,34,0,7,0,40,0,pat summitt make tennessee cradle coach
0,1,2,50,1,9,0,52,0,"gunman shoot board meeting florida, kill self"
0,2,10,41,5,9,0,51,0,"nurse, spy, cook: harriet tubman found freedom food"
0,1,5,35,1,7,2,40,0,"shuttle docks, astronaut number 13 station"
0,3,8,43,0,10,0,51,0,trump attend church service palm beach christmas eve
0,3,4,75,0,10,0,79,0,indonesian president joko widodo urge business invest outside traditional location
0,1,2,44,0,9,0,46,0,bomb ruled mexico plane crash killed twelve
0,2,1,78,4,14,1,79,0,"6 million american stopped paying car loans, becoming 'significant concern'"
0,1,9,22,1,7,7,31,0,nascar: trevor bayne win 2011 daytona 500
0,3,10,62,5,12,0,72,0,'weigh every day': secret peter fitzsimons' great aussie bloke slim-down
0,3,1,75,5,12,0,76,0,"teacher 'bullied' holding revision session 'lazy' students, education union warns"
0,1,3,58,2,9,0,61,0,hamas claim israeli jet shoot-down; report israeli soldier captured
0,2,9,51,5,9,0,60,0,peter schweizer: world see clinton cash hillary typical kleptocrat
0,1,6,29,0,6,0,35,0,iraq warily moving ahead oil contract
0,3,6,60,5,13,0,66,0,courageous reckless: tragedy american u.n. worker slain congo
0,2,5,43,2,10,0,48,0,twitter sued u.s. widow giving voice islamic state
0,3,12,48,2,11,0,60,0,lena dunham praise glamour letting 'cellulite damn thing'
0,2,1,61,2,12,0,62,0,call mall: identify world city shopping centres?
0,1,6,34,0,6,0,40,0,manchester united face tough test portugal
0,1,1,46,0,6,0,47,0,researcher identify genetic link peanut allergy
0,3,4,62,3,11,0,66,0,'we still mourning': charleston congregant prepare dylann roof trial
0,1,6,43,0,8,0,49,0,kidnapper bbc reporter alan johnston deny release
0,1,3,41,0,8,0,44,0,u stock market best week since november
0,1,3,22,0,5,2,25,0,flooding kill 91 el salvador
0,1,2,25,1,5,2,27,0,g20 protests: inside labour march
0,1,3,24,0,7,2,27,0,former emir kuwait dy age 78
0,3,2,63,0,12,0,65,0,obama obama spent almost seven month presidency foreign travel
0,3,2,35,0,5,0,37,0,huge explosion destroys factory ecuador
0,2,1,53,3,10,0,54,0,"sorry, president way less authoritarian lastone"
0,3,3,43,4,9,0,46,0,harrison ford: 'i'm schmuck landed taxiway'
0,2,3,50,1,7,0,53,0,south korea japan sign military intelligence-sharing deal
0,3,10,34,3,10,0,44,0,beer are: regional guide u.s. craft brew
0,2,12,56,7,15,2,68,0,"cuba gooding sr., 'everybody play fool' singer dad oscar-winning actor, dy 72"
0,3,9,35,0,8,0,44,0,american muslim fear donald trump next
0,2,5,58,2,8,0,63,0,"facebook, twitter, microsoft youtube create shared extremist database"
0,2,2,59,0,8,0,61,0,publisher slain philippine criticizing official drug
0,3,6,46,2,6,0,52,0,dreamer daniela vargas released immigration detention
0,1,8,41,3,8,0,49,0,"u.s. offer europe goodwill, expects something return"
0,3,11,48,2,10,0,59,0,here's lawsuit jonbenet ramsey's brother complicated
0,3,2,45,1,9,0,47,0,"again, trump succeeded supposed fail"
0,1,4,41,0,8,0,45,0,former irish politician liam lawlor dy car crash
0,3,10,50,2,9,4,60,0,"nba skill challenge 2017: complete participant list, comment reaction"
0,2,7,48,0,7,3,55,0,full 911 transcript released lawmaker criticize redaction
0,3,7,33,2,8,0,40,0,timeline syrian civil war u.s. response
0,1,4,26,0,5,0,30,0,obama welcome specter party
0,3,5,77,3,14,0,82,0,"aleppo risk becoming 'one giant graveyard', un warns syrian russian force continue advance"
0,2,4,50,0,10,0,54,0,judge reject trump plea avoid deposition jos andrs case
0,1,7,43,1,9,4,50,0,abc news yank 20/20 investigation tom cruise scientology
0,1,7,20,3,5,0,27,0,name hurting largest unit a.i.g.
0,3,1,51,1,10,0,52,0,brain scan help predict story we're likely share
0,1,2,69,1,10,0,71,0,queensland state green party run environmental lawyer treasurer's electorate
0,1,7,36,0,8,0,43,0,good golf gear make difference foul weather
0,2,5,35,0,9,0,40,0,new rule nypd great news forrapists
0,2,2,39,0,5,0,41,0,humanitarian crisis loom amid mosul offensive
0,3,2,50,3,9,0,52,0,aleppo evacuation: thousand wait leave 'new deal reached'
0,2,5,79,4,15,2,84,0,supreme court brexit appeal: judge 'heading split 7-4 decision' narrow win remain campaigner
0,1,4,70,0,9,0,74,0,bangladesh security tightened following pilkhana massacre bashundhara city fire
0,1,2,40,0,6,0,42,0,saginaw spirit victorious first home shootout
0,1,2,33,0,4,0,35,0,new orleans official confiscating gun
0,3,2,56,1,11,2,58,0,winter storm plaster northeast snow total 17 inch counting
0,2,13,46,3,10,0,59,0,redditor spoof nba all-star game sneaker video 'full house' theme
0,2,4,48,2,12,5,52,0,"wall st: dow jones share index climb within whisker 20,000 point"
0,2,15,63,3,14,0,78,0,"grip left-wing foundation, twitter prioritising politics profit breitbart"
0,3,3,44,0,10,0,47,0,eric trump announces wife lara pregnant baby boy
0,3,6,42,0,7,0,48,0,cyclone barrel toward northeastern coast australia
0,1,7,32,0,7,0,39,0,credit crisis leaving charity low cash
0,1,1,26,0,5,2,27,0,bangladesh storm kill least 23
0,1,3,36,0,7,2,39,0,polish humanitarian irena sendler dy age 98
0,1,9,32,0,6,0,41,0,damaged dna evidence shrink serial killer case
0,3,1,58,1,7,0,59,0,adoption agency's sudden closure leaf prospective parent hanging
0,1,6,81,1,14,4,87,0,australian rule football: leongatha upset traralgon round six 2010 gippsland football league season
0,3,4,59,0,10,2,63,0,watch star war celebration 40th anniversary panel livestream right
0,3,6,34,0,9,0,40,0,wild oat xi forced quit sydney hobart race
0,3,12,62,3,12,0,74,0,sarah hyland talk hosting 'lip sync battle shorties' spinoff: watch exclusive preview
0,2,3,50,3,9,0,53,0,judge rule bishop remains removed st.patricks
0,2,2,44,0,9,0,46,0,mitt romney top contender secretary state
0,2,2,60,1,12,0,62,0,syrian civil war: damascus cling normal life amid chaos conflict
0,3,17,49,0,15,2,66,0,jordan ullman majid jordan special guest episode 36 ovo sound radio
0,1,3,34,0,6,0,37,0,irish obama song prof popular internet
0,1,4,51,2,11,0,55,0,"u offer eliminate duty cotton, africa say enough"
0,2,3,80,3,12,0,83,0,"bill shorten argues reducing restriction book imports, want 'australian story told'"
0,3,6,65,0,14,0,71,0,uk tech industry could see investment asia double due brexit donald trump
0,2,11,69,9,10,0,80,0,"suburban chicago school teach blackenomics, trans-rights, white genocide black"
0,2,1,57,0,11,0,58,0,mental illness heart disease often found patient
0,1,4,24,0,3,0,28,0,sotomayor leaf passion behind
0,2,1,68,0,12,0,69,0,uber done giving lucrative incentive driver fastest growing market
0,3,3,47,0,8,0,50,0,secret santa pay meal account pennsylvania school
0,1,5,60,1,12,0,65,0,"u flight washington, dc diverted man reportedly try open door"
0,3,11,40,3,8,0,51,0,"""pll"" cast's first instagram post hilariously awkward"
0,2,2,40,1,7,0,42,0,car crash put poland's prime minister hospital
0,3,11,55,2,11,0,66,0,"darryl sutter, dean lombardi fired kings, luc robitaille named new president"
0,1,8,35,1,8,0,43,0,kindle join bookstore ritual: author sign
0,2,5,67,0,11,0,72,0,caitlyn jenner visit white house meeting trump administration official
0,3,3,51,0,10,0,54,0,contestant wheelchair first miss australia pageant
0,1,5,28,0,6,0,33,0,polite forum careful confession
0,1,3,32,0,6,0,35,0,virginian melee used apple ibook sale
0,2,10,48,1,9,0,58,0,supreme court strike state effort health care transparency
0,2,5,51,2,10,4,56,0,former celtic kitman jim mccafferty confesses sexual abuse 1990s
0,2,1,44,0,7,0,45,0,volkswagen face new front emission legal action
0,3,2,69,4,9,0,71,0,"united airline pilot ""infuriated"" ""grossly inappropriate"" dragging passenger"
0,1,2,31,0,4,0,33,0,tarantino wade manila flood
0,2,6,66,2,11,0,72,0,"china objections, ted cruz texas governor meet taiwanese president"
0,3,9,50,0,9,1,59,0,4 reason millennials develop public speaking skill
0,1,4,50,1,7,0,54,0,"major earthquake jolt bangladesh, centered nicobar island"
0,2,10,38,1,11,4,48,0,spain's rajoy begin first big test new term 2017 budget
0,1,2,56,2,8,0,58,0,"new mexico-based charismatic leader fails predict doomsday,"
0,2,5,32,1,4,0,37,0,atlantic daily: uncomfortable untruth
0,2,11,57,0,10,0,68,0,turkey suspends human right convention europe raise concern torture
0,3,3,56,0,9,0,59,0,indian taxi driver charged molesting australian woman mumbai
0,2,6,42,0,10,0,48,0,gonzaga best chance win ncaa tournament
0,1,4,47,0,9,0,51,0,gordon brown make speech part labour party conference
0,3,6,37,1,9,0,43,0,brexit: theresa may want early deal briton eu
0,3,4,33,0,7,0,37,0,iraqi troop hunt deadly sniper mosul
0,1,6,31,1,7,0,37,0,"deep bedrock, clean energy quake fear"
0,3,9,52,1,10,0,61,0,"man broadcast murder infant daughter facebook, kill"
0,3,2,47,0,7,0,49,0,footage show people fleeing stockholm truck crash scene
0,2,1,65,0,13,0,66,0,poland vote extreme abortion ban thousand woman go strike
0,1,4,32,0,6,0,36,0,tropical storm blanca form pacific
0,3,9,56,1,10,0,65,0,"doomsday clock move closer midnight, signaling concern among scientist"
0,3,1,53,0,9,0,54,0,dutch police arrest terror suspect seize arsenal weapon
0,2,11,56,1,14,0,67,0,fentanyl outpaces heroin deadliest drug long island new york time
0,1,5,47,2,9,0,52,0,mccain obama face u.s. presidential candidate debate
0,3,4,63,1,9,0,67,0,senate intelligence committee asks russia-related record preserved
0,1,6,24,1,6,0,30,0,"tiny photos, tiny dell printer"
0,1,1,39,0,4,0,40,0,german opposition launch election campaign
0,1,6,43,1,9,6,49,0,near-earth asteroid 2004 mn4 reach torino scale hazard rating 4
0,1,1,53,0,10,1,54,0,moldovan mobile phone growth result 2 million user
0,2,8,36,1,8,0,44,0,singapore beating hong kong asia's fintech race
0,2,4,59,2,9,0,63,0,ilie nastase apologises say serena williams comment spontaneous
0,2,6,68,4,11,0,74,0,"richmond by-election, brexit mp remain constituency resign?"
0,3,3,60,4,12,5,63,0,"bernie sanderss claim 36,000 people die yearly obamacare repealed"
0,2,2,63,1,10,0,65,0,criminal-justice reform congress officially caved dangerous myth
0,1,1,43,0,9,0,44,0,brazilian tribe neither new discovery hoax
0,2,1,59,0,11,0,60,0,maryland considers cracking driver linger left lane
0,2,2,82,1,17,0,84,0,knife-wielding attacker shot police south west france stabbing woman shoulder
0,2,5,29,0,5,0,34,0,rupert murdoch deserves little credit
0,2,11,52,3,10,1,63,0,maryland g melo trimble knock game-winning 3-pointer vs. michigan state
0,3,12,70,5,13,0,82,0,america ferrera anti-trump womens march: platform hate division assumed power yesterday
0,3,2,47,0,8,0,49,0,newtown school ask trump reject conspiracy theorist
0,3,9,35,1,9,0,44,0,amazing new font show like dyslexia
0,1,3,49,1,7,0,52,0,"volcanic eruption start top eyjafjallajkull, iceland"
0,1,5,30,1,7,0,35,0,"movie maker appeal crowd, money"
0,2,7,37,2,10,2,44,0,former wwe wrestler jimmy 'superfly' snuka dead age 73
0,1,5,21,0,5,0,26,0,man arrested obama threat
0,1,3,31,0,7,2,34,0,film director sydney pollack dy age 73
0,3,15,50,1,14,0,65,0,"leave tyler, creator bill nye make science literally sound cool"
0,3,3,39,2,7,0,42,0,schwarzenegger senate believers: back
0,2,8,32,2,7,0,40,0,making science teaching backup plan
0,3,16,46,0,15,0,62,0,goat suffers anxiety calm duckcostume
0,2,14,55,0,14,2,69,0,12 captivating image child monk indian himalaya make smile
0,1,6,32,0,6,0,38,0,michigan hold frantic finish clemson
0,1,10,55,0,12,2,65,0,18 people rescued civilian helicopter go coast scotland
0,1,3,39,0,6,0,42,0,lhc set new particle energy acceleration record
0,1,2,33,0,7,0,35,0,new zealand send bird flu brochure
0,2,10,38,1,10,0,48,0,"go green, get happy earth day freebie deal"
0,3,10,42,2,10,0,52,0,tokyo top monocle livable city ranking japan real time
0,1,3,27,1,5,0,30,0,intel's office across eu raided
0,3,11,36,3,10,2,47,0,lamelo ball's dad say son 'easily' score 92 point
0,2,2,34,0,9,4,36,0,ikea sell rug made syrian refugee 2019
0,2,9,49,3,9,0,58,0,chinese propaganda: build strategic nuclear arm fight trump
0,2,2,26,1,4,0,28,0,inside china largest ghost town
0,3,5,55,1,9,0,60,0,white house defends trump holocaust statement mention jew
0,1,3,50,0,10,0,53,0,qatar becomes first arab country fly fighter jet libya
0,3,8,35,0,11,4,43,0,gold trader bullish year dire end 2016
0,1,5,36,0,5,0,41,0,state slashing social program vulnerable
0,2,11,41,3,12,4,52,0,overwatch take home game year 2017 dice award breitbart
0,3,8,31,2,7,0,39,0,fed may take legal action london whale
0,1,9,42,0,9,0,51,0,judge approves inquiry barclays deal buy lehman unit
0,1,3,34,2,5,0,37,0,"iran, turkey, brazil reach nuclear agreement"
0,2,10,40,2,8,3,50,0,luxury know limit 623-foot-long superyacht concept
0,1,6,35,0,8,0,41,0,nugget use little everything even series
0,2,15,64,2,13,0,79,0,ben affleck's hard-hitting post battling alchohol addiction show struggle real
0,3,10,56,4,12,0,66,0,here's reminder christina aguilera christmas album (and amazing)
0,1,4,38,0,7,0,42,0,uk loses appeal conceal binyam mohamed torture
0,3,8,42,0,7,0,50,0,economy seen improving dramatically year
0,2,3,39,2,10,0,42,0,here's like use computer north korea
0,3,2,56,1,10,0,58,0,"celebrity photo hacking tied chicago address, court document say"
0,3,3,40,3,8,0,43,0,strictly come dancing: semi-final happened
0,1,6,34,0,7,0,40,0,satyam chief accused faking worker steal
0,2,3,48,0,8,0,51,0,wall street dealmaking exploded since trump took office
0,1,11,48,1,12,0,59,0,"source close side say nhl, nhlpa agree salary cap structure"
0,1,9,32,0,8,0,41,0,tee time may keep player rain cloud
0,3,1,67,0,10,0,68,0,employee decline genetic testing could face penalty proposed bill
0,1,2,49,2,8,0,51,0,suspected 'mastermind' london bombing longer suspect
0,1,3,37,0,7,2,40,0,fbi begin widespread financial probe 26 firm
0,3,5,55,0,9,0,60,0,gop house vote reject obama administration stream protection rule
0,2,12,54,6,13,0,66,0,"**horse race live wire** trump, clinton projected win new york primary breitbart"
0,3,5,39,1,7,0,44,0,time warner shareholder vote approve at&t merger
0,3,5,86,1,13,0,91,0,trump administration's hardline immigration stance supreme court case could see melania trump deported
0,1,5,19,1,4,0,24,0,seti institute set re-open
0,1,5,58,1,9,0,63,0,"aircraft crash mock dogfight shoreham airshow, united kingdom"
0,2,2,16,1,3,4,18,0,oscar 2017: live coverage
0,2,9,32,1,7,0,41,0,here president trump influence falltv
0,1,5,21,0,5,0,26,0,knicks find another way lose
0,3,15,59,1,14,0,74,0,"congress vote let isps sell internet history, movement grows expose"
0,1,3,30,0,6,2,33,0,disney animator ollie johnston dy 95
0,3,1,31,0,4,0,32,0,maybeshewill stream final show
0,3,1,55,1,12,0,56,0,good news: science say cat actually want chill
0,2,4,45,1,8,0,49,0,mixed reception capitol hill trump's proposed budget
0,2,4,41,1,9,6,45,0,le man 24 hour 2015: porsche prove unbeatable qualifying
0,1,2,31,0,5,0,33,0,eleven drown sudanese boat sink
0,2,7,36,3,8,0,43,0,mike pence: trump like leader since ronald reagan
0,3,2,85,5,14,0,87,0,"trump supporter thought president would deport bad hombres. instead, husband deported."
0,1,3,24,2,5,0,27,0,u.n. pull southern somalia
0,3,8,49,0,8,0,57,0,trump supporter say leaked tax document vindicates president
0,1,10,36,1,10,0,46,0,"bad economy lead patient put surgery, rush"
0,1,4,33,4,5,2,37,0,"magnitude 3.6 earthquake shake washington, d.c."
0,2,2,45,0,7,0,47,0,make money designing custom snapchat geofilters
0,2,10,51,0,12,1,61,0,serena williams beat venus williams win 7th australian open title
0,1,4,42,1,8,0,46,0,"eu deems uk privacy law inadequate, take legal action"
0,2,1,37,0,9,2,38,0,3rd brazilian prison riot week leaf 4 dead
0,1,5,22,2,5,0,27,0,"nfl: colts, saint kick season"
0,2,5,37,1,9,2,42,0,raymond kopa: real madrid france legend dy 85
0,1,6,32,0,9,0,38,0,tax change europe cut bill dinner
0,1,3,43,0,8,0,46,0,building collapse mecca eve hajj pillgrimage
0,1,3,37,1,7,0,40,0,"two killed new copiap, chile mining accident"
0,3,11,47,3,13,2,58,0,"skrillex release 'make war,' first song first last 10 year"
0,2,19,51,3,10,0,70,0,exclusive: sarah michelle gellar open 'incredible' friend shannen doherty
0,3,7,33,0,4,0,40,0,kehlani announces sweetsexysavage world tour
0,3,10,45,0,10,3,55,0,fall killed veteran hiker climbed california peak 700 time
0,2,4,61,1,10,0,65,0,eli pariser: activist whose filter bubble warning presaged trump brexit
0,2,4,64,2,9,0,68,0,bernie sander hire elizabeth warren 'draft' director progressive campaign
0,2,4,54,1,9,0,58,0,"new congress prepares undo obamacare, weigh trump personnel pick"
0,2,5,17,1,4,0,22,0,koch epic fixer upper
0,1,7,42,0,7,0,49,0,geithner say dollar remain dominant reserve currency
0,2,5,59,1,10,2,64,0,dear president trump: everyday american share message 45th president
0,3,4,43,0,8,0,47,0,mahershala ali becomes first muslim win acting oscar
0,1,5,52,0,7,0,57,0,former iranian president hashemi rafsanjani lead friday prayer
0,1,4,63,0,8,0,67,0,former northeastern u republican campaign director charged conspiracy
0,1,3,40,0,7,0,43,0,china indonesia hail deal copenhagen summit
0,1,2,49,1,6,0,51,0,bailout signal lisbon's capitulation financial market
0,2,10,28,1,7,0,38,0,bbc: even liberal buying gun trump
0,2,9,34,1,9,0,43,0,stream: south carolina nevada go poll
0,3,7,43,2,8,0,50,0,"northeast brace high winds, blizzard condition"
0,2,5,79,3,18,0,84,0,trump claim saved billion dollar air force one. military know he's talking
0,3,11,51,0,11,0,62,0,four western tourist face prison alleged nude pic mount kinabalu
0,2,12,46,1,12,1,58,0,gallup: trump net approval rating drop 8 point first week office
0,1,1,46,0,8,0,47,0,microsoft sale go higher expected last quarter
0,1,7,56,1,9,0,63,0,"tropical storm adrian form eastern pacific, threatens central america"
0,2,15,57,3,13,0,72,0,"solar employ people u.s. electricity generation oil, coal gas combined"
0,2,7,31,3,6,0,38,0,robert randolph premiere 'she got soul': watch
0,3,8,36,2,9,0,44,0,u.s. demand return drone seized chinese warship
0,1,1,50,0,6,0,51,0,louisiana official accused blocking rescue volunteer
0,3,4,66,0,15,0,70,0,comedian found way root patriot without also rooting donald trump
0,2,11,73,2,16,0,84,0,isi leader 'admits defeat iraq order militant flee kill suicide attacks'
0,3,1,20,1,3,0,21,0,page unavailable.
0,3,10,43,1,9,0,53,0,judge rule state case trump travel order proceed
0,2,7,35,0,8,0,42,0,italian court ruling could pave way election
0,3,3,42,2,9,2,45,0,"china, saudi arabia sign $65 billion cooperation deal"
0,1,5,41,4,10,2,46,0,"van vliet, best known 'captain beefheart', dy aged 69"
0,2,8,42,0,11,4,50,0,watch red carpet live stream billboard woman music 2016
0,3,4,71,3,12,0,75,0,"star war actress carrie fisher suffers 'cardiac episode' flight, critical condition"
0,1,2,40,0,6,0,42,0,ukraine implement tougher rule russian navy
0,1,3,43,0,7,0,46,0,ralph nader call democrat financial bailout
0,2,18,58,5,18,0,76,0,"trump mission make america great again: done, breitbart"
0,1,5,29,0,7,0,34,0,filming flight winged maple seed
0,1,6,37,0,8,0,43,0,obama lobby release second half bailout
0,3,2,47,1,7,0,49,0,california train accident: freight car plunge water
0,1,2,43,0,7,0,45,0,simus responds dismissal haitian justice
0,3,7,17,0,5,2,24,0,irs open free file friday 13th
0,2,5,31,2,6,0,36,0,un sends message: child #notatarget
0,3,5,29,1,6,0,34,0,new york fashion week: six talking point
0,2,6,38,1,5,0,44,0,"protests, violence flare around inaugural ceremony"
0,3,2,39,1,9,0,41,0,"venezuela, woman selling hair make end meet"
0,2,4,47,4,11,0,51,0,"dhs secretary homegrown terror: know stop that"""
0,1,5,25,0,4,0,30,0,cable war killing objectivity
0,2,5,56,3,10,0,61,0,donald trump listening session black history month anything
0,3,5,17,1,4,0,22,0,here's get divorced
0,3,15,51,4,14,0,66,0,"beau biden's widow dating married brother-in-law, joe cool"
0,2,12,51,3,13,0,63,0,"maggie rogers, nicky jam spotify editors' pick new music friday"
0,2,11,41,0,10,0,52,0,teen engineer build robot arm rescue puppy trapped well
0,2,10,40,0,9,0,50,0,chinese diver get engaged medal podium rio olympics
0,1,2,43,0,6,0,45,0,online retailer canada experience strong growth
0,2,2,50,1,8,0,52,0,police public remember westminster attack victim video
0,3,3,43,2,8,0,46,0,'pokmon go' banned china public safety concern
0,2,10,59,1,9,0,69,0,lebron james' public comment making life uncomfortable cleveland cavalier
0,2,2,32,0,6,2,34,0,observer view triggering article 50
0,3,8,45,3,10,0,53,0,"premier league festive slog: adored fans, endured player"
0,2,5,55,2,11,0,60,0,trump lawyer denies key comey claim attack ex-fbi chief leak
0,2,4,46,1,9,0,50,0,"pair threat close part white house, congress hearing"
0,3,6,45,0,9,0,51,0,un security council meeting sought nkorea missile test
0,3,6,37,1,7,0,43,0,lawmaker pressed trump policy town hall
0,2,8,26,1,8,0,34,0,cnn sunday change cnn video
0,1,2,33,1,6,5,35,0,"official myanmar death toll increase 78,000"
0,2,8,42,0,9,0,50,0,alleged chicago gang bos denies ordering hit informant
0,1,7,31,1,7,0,38,0,"travelers, tour bus boarding basra"
0,2,3,64,4,10,2,67,0,retiring 60-year-old teacher completely slays 'uptown funk' dance student
0,3,2,35,0,6,0,37,0,obama deliver farewell speech chicago
0,3,2,48,0,9,0,50,0,massive gold coin worth million stolen german museum
0,1,7,17,2,5,5,24,0,"uefa champion league: april 1, 2008"
0,2,7,41,0,8,0,48,0,repair continue oroville dam ahead upcoming storm
0,3,3,54,4,14,0,57,0,"no, spike missing girl d.c.; tweet created crisis"
0,3,4,51,0,12,0,55,0,map country boris johnson offended list
0,2,3,77,2,10,0,80,0,easter celebrations: christian around world commemorate christ's death resurrection
0,2,6,45,5,6,0,51,0,whats sinking us-russia relations? team trumpstruth-telling
0,3,9,40,2,9,0,49,0,u.s. house begin work first policy change obamacare
0,2,11,34,1,8,0,45,0,opec warns member comply oil-production cut
0,1,5,37,2,6,0,42,0,"body found cradle mountain, tasmania, australia"
0,2,10,40,3,12,0,50,0,trump agrees honor 'one china' policy call china's xi
0,1,6,30,0,5,0,36,0,new jet administration promise change
0,3,7,33,0,7,0,40,0,mtv movie award expanding include tv series
0,3,9,62,0,12,0,71,0,bristol palin blast artist refusing perform trump inauguration insider
0,2,6,31,0,6,0,37,0,bachelor give nick redemption edit
0,3,9,78,3,17,2,87,0,"new day, weekday 6-9am et white house press secretary: work journalist never important"
0,3,3,27,1,4,0,30,0,artist tyrus wongs remarkable life
0,3,10,55,2,10,1,65,0,barack obama designates 3 civil right monument preserve 'vibrant history'
0,2,8,83,1,15,0,91,0,"french presidential candidate macron ban two russian news outlet events, sparking fury moscow"
0,3,2,78,3,10,0,80,0,call 'airport-style' search student exam following telegraph investigation
0,1,7,27,0,8,0,34,0,chinese city chilly sex theme park
0,1,1,48,0,5,0,49,0,quiznos restaurant chain air controversial commercial
0,1,6,46,3,7,6,52,0,fuball-bundesliga 200809: goalkeeper butt sign bayern munich
0,2,11,40,1,9,0,51,0,conan o'brien outsources show mexico special episode
0,1,4,80,2,13,0,84,0,"emergency declared u state washington, eight additional casualties, many still without power"
0,1,2,51,0,7,0,53,0,globalization trade deficit connected say greenspan
0,1,3,33,0,7,2,36,0,american actress estelle getty dead age 84
0,3,1,43,0,10,3,44,0,solange bought 250 book fan angel
0,1,2,33,0,6,0,35,0,three dead infant found canadian home
0,1,10,31,0,8,0,41,0,millercoors asics bring action ad espn
0,3,10,25,1,10,4,35,0,15 black girl loved watching tv the90s
0,1,1,46,1,7,2,47,0,6.2 magnitude aftershock provokes panic southern chile
0,1,2,36,1,3,0,38,0,pakistan's musharraf announces resignation
0,1,6,32,0,6,0,38,0,home price continued decline march
0,3,3,39,3,8,0,42,0,st petersburg metro attack: 'bomb' found city raid
0,1,6,30,1,6,2,36,0,maker blackberry post 33% profit increase
0,2,10,42,2,9,1,52,0,"brantley gilbert, thomas rhettcollect new country chart no. 1"
0,3,6,32,0,7,0,38,0,paul manafort may register foreign agent
0,3,5,73,4,11,0,78,0,refugee deals: government odds 'people swap' description us-australia resettlement
0,2,2,35,2,6,0,37,0,russia 'starts withdraw' force syria
0,1,1,26,0,4,0,27,0,regazzoni dy road accident
0,3,9,44,2,8,0,53,0,snapchat's high-stakes clash neighbor venice beach
0,1,3,33,0,5,0,36,0,severe heat wave blanket northeastern u
0,3,16,61,0,15,0,77,0,internet drooling incredible love story two baby born hospital
0,3,12,54,0,12,3,66,0,100 shot fired north carolina shooting reportedly targeting young dolph
0,1,5,34,1,6,0,39,0,st louis cardinal win baseball's world series
0,2,3,59,0,10,0,62,0,national part three prospect acquire center fielder adam eaton
0,2,12,47,3,9,0,59,0,msnbc scold brian williams patronizing rachel maddow breitbart
0,2,2,40,2,5,0,42,0,"""apprentice"" contestant sue trump defamation"
0,3,3,26,2,4,0,29,0,"e-cigarettes major concern, say u"
0,3,4,58,2,12,0,62,0,"first time since trump took office, n. korea fire ballistic missile"
0,1,2,37,0,6,0,39,0,russian market remain closed friday
0,1,6,53,0,12,0,59,0,report find lot airline plane lost london due pilot error
0,1,6,33,0,7,0,39,0,inexpensive digital edge golf course
0,3,2,40,0,6,0,42,0,timelapse show thick fog rolling london
0,2,11,48,5,9,0,59,0,week: steve bannon stole progressive anti-wall street thunder
0,2,9,32,4,11,5,41,0,"like melania trump, glam room, $50,000"
0,1,7,32,1,7,0,39,0,"economy remains weak, fed see bright spot"
0,1,1,29,0,4,0,30,0,speculation abounds future pope
0,2,2,52,1,9,0,54,0,white house urge ban non-compete agreement many worker
0,1,8,49,3,8,0,57,0,football: melbourne victory win a-league pre-season cup penalty
0,2,13,52,0,12,0,65,0,john legend take public piano impromptu gig london train station
0,3,8,48,1,7,0,56,0,"electronics travel ban irks families, enrages business traveler"
0,3,3,38,3,6,0,41,0,"internet, meet finland's adorable first dog, lennu"
0,3,9,42,2,9,0,51,0,"james comey could shed light russia, trump wiretap charge"
0,3,10,44,0,9,0,54,0,teen vogue writer twist knife taking tucker carlson
0,3,4,65,4,14,0,69,0,'detached society': long-term program dale helping give kid new start
0,1,2,35,0,4,0,37,0,new professional open documentary project
0,3,2,56,6,13,5,58,0,"mar-a-lago rap sheet: noise, traffic stop $28,000 ring theft never"
0,2,15,42,1,13,0,57,0,kosovo turned fertile ground isi new york time
0,3,4,48,2,11,0,52,0,"fox news poll: confidence military remains high, medium low"
0,3,7,41,0,7,0,48,0,pinterest version suburbia grows outside atlanta
0,2,9,40,3,8,0,49,0,'phenomenal' tax plan president trump promised?
0,3,1,84,0,17,0,85,0,unfair illogical deny someone civil partnership happen straight
0,3,5,59,2,17,0,64,0,"trump ready war south china sea, team clear?"
0,3,8,76,2,14,0,84,0,shirley finn murder: brothel owner threatened expose alleged lover former wa premier ray o'connor
0,2,3,51,0,11,0,54,0,cdc working keep yellow fever vaccine supply running
0,3,5,42,3,8,0,47,0,warren whether session would discriminate ag: 'yes'
0,2,16,53,2,12,0,69,0,former university professor suggests nra 'more dangerous' isi insider
0,1,8,29,2,7,0,37,0,u.s. may convert bank bailouts common stock
0,3,8,45,0,7,0,53,0,stripe founder youngest irish billionaire funding
0,1,8,39,0,9,0,47,0,mugabe swears rival prime minister zimbabwe
0,2,2,39,1,9,0,41,0,one thing know sure comeys firing
0,1,5,32,0,8,0,37,0,lapp plat becomes first firm float iex
0,2,5,47,0,12,1,52,0,lib dems call 1p income tax rise provide nh funding boost
0,1,8,40,1,8,0,48,0,top-ranked men woman focused australian open title
0,3,12,49,2,12,0,61,0,"nicki minaj single, here's inevitable meek mill slander"
0,1,6,27,0,7,0,33,0,japan pay price lifetime job
0,2,13,60,4,13,0,73,0,seattle's headset offer big data analytics cannabis industry 'just like walmart'
0,2,9,34,0,7,0,43,0,ftc crack deceptive debt collection text
0,2,12,57,1,11,0,69,0,donald trump's company receiving direct payment foreign agent right
0,3,4,58,0,11,0,62,0,ari fleischer advises sean spicer correct wrong statistic used
0,2,9,35,1,9,2,44,0,somalia new army chief survives car bomb kill 13
0,3,6,44,2,10,0,50,0,us gerald r. ford begin sea trial test high-tech system
0,1,8,63,5,11,0,71,0,"bbc's mock week 'breached guidelines' olympian humour, say corporation's trust"
0,3,1,50,0,11,0,51,0,fish finger back menu family reject sausage
0,2,1,80,1,12,0,81,0,"trump call lower drug prices, fewer regulation meeting pharmaceutical executive"
0,1,7,33,0,7,0,40,0,question answer french open draw
0,1,4,39,0,8,2,43,0,french fashion designer yves saint laurent dead 71
0,3,2,49,0,10,0,51,0,gambian footballer drowned search better life
0,2,7,42,1,8,0,49,0,"scientology aftermath, leah remini strike back"
0,1,4,37,1,7,0,41,0,officials: u drone strike kill five pakistan
0,1,12,73,3,13,0,85,0,"campaign office john mccain evacuated centennial, colorado manchester, new hampshire, usa"
0,1,2,61,3,8,3,63,0,"'explosive' haitian cholera outbreak kill 292, neighboring country prepare"
0,2,11,45,4,11,0,56,0,team clinton: donald trump rape talk prof wounded breitbart
0,3,3,43,2,9,0,46,0,patriot look next year 'blitz six' trademark
0,2,11,53,2,10,0,64,0,"britain crumbling parliament, renovation costly take year"
0,2,9,46,3,8,0,55,0,expert say trump team falsehood classic gaslighting
0,1,6,45,0,7,0,51,0,synagogue restored eastern state prison philadelphia
0,1,4,50,0,8,0,54,0,government bahamas isssues warning hurricane hanna
0,2,9,55,4,10,0,64,0,torchbearer movie urgent wake-up call american christian breitbart
0,3,3,56,0,9,0,59,0,former iranian president sent trump letter discussing immigration
0,1,1,29,1,4,2,30,0,microsoft report 60% profit increase
0,3,1,74,0,16,4,75,0,nokia reportedly planning relaunch iconic 3310 people freaking
0,1,5,35,0,6,0,40,0,house pass expansion program service
0,2,3,48,0,8,0,51,0,nigeria super falcon march parliament demand bonus
0,3,5,47,1,13,0,52,0,drone lit sky lady gaga's super bowl halftime show
0,2,8,41,2,10,0,49,0,atlantic politics policy daily: gray lady trump
0,1,5,38,1,7,0,43,0,"elin gonzlez join communist youth group, ap say"
0,1,5,27,0,6,4,32,0,jenson button win 2009 turkish grand prix
0,2,4,66,2,12,0,70,0,"stephen hawking travel space board richard branson's ship, professor say"
0,3,7,45,1,7,0,52,0,putin french gambit backfire presidential leader fade
0,1,3,32,1,4,0,35,0,immigrant's festival begin argentina
0,1,6,33,0,6,0,39,0,german retailer expected buy download firm
0,1,2,46,1,7,0,48,0,panama-flagged ship hijacked somali coast pirate
0,1,3,61,0,8,0,64,0,australian labor party shelf government oversight medium legislation
0,3,8,39,3,9,0,47,0,"creator mcdonald's flagship sandwich, big mac, dy"
0,3,2,57,4,9,0,59,0,one california's famous 'drive-through' tree toppled winter storm
0,1,5,32,0,6,0,37,0,union dissident vote secede realign
0,3,13,38,0,9,0,51,0,health care lobby push back hawaii lgbtq fertility bill
0,1,5,54,1,10,0,59,0,"chemical weapon used iraq u military, say italian documentary"
0,1,6,35,3,8,0,41,0,"cat rhode island, usa nursing home 'senses death'"
0,2,3,43,1,8,0,46,0,"tiger escape circus, roams street palermo italy"
0,2,3,47,2,8,0,50,0,uk tourist australia 'rape ordeal' released hospital
0,3,17,60,2,16,0,77,0,game throne actress trolled donald melania trump people forit
0,2,4,40,0,7,0,44,0,nasa announce new discovery ocean world
0,1,7,40,0,7,0,47,0,qatar airway increase order airbus jetliner
0,3,5,45,0,10,0,50,0,rogue one fall well short force awakens opening china
0,3,8,37,1,10,0,45,0,"endangered specie stuff buy, mapped"
0,3,7,36,0,7,0,43,0,two killed army national guard helicopter crash
0,3,10,48,1,11,0,58,0,"bahrain book trump ballroom, critic see attempt curry favor"
0,2,9,36,3,8,0,45,0,beyoncs lemonade defiant midst upheaval
0,3,1,36,0,8,4,37,0,make 2017 year finally budget charity
0,2,7,79,4,12,0,86,0,trans-pacific partnership: malcolm turnbull accuses bill shorten populism amid 'dead deal' comment
0,3,5,46,3,12,0,51,0,jodie foster tell u travel ban rally: 'it time resist'
0,1,2,29,1,5,0,31,0,two-plane crash florida kill four
0,1,6,40,0,9,0,46,0,dutrow nurture dream return kentucky derby
0,2,8,43,2,8,0,51,0,trump concedes health law overhaul unbelievably complex
0,3,9,37,2,10,2,46,0,"despite 50% gain, bank yet win europe fund manager"
0,1,5,36,0,9,1,41,0,nasa extend phoenix probe mission 5 week
0,1,5,38,0,7,1,43,0,microsoft invested 4 billion usd xbox division
0,2,9,42,2,9,0,51,0,first single faith-and-biggie duet album
0,1,7,30,0,8,0,37,0,axe put brand hampton club scene
0,1,3,68,1,11,0,71,0,"tesco pricing error cambridgeshire, england allows customer get cheaper fuel"
0,1,6,43,4,8,4,49,0,"cadillac unveils obama's 'beast', 2009 presidential state car"
0,2,3,59,0,11,0,62,0,patriot coach could called witness aaron hernandez murder trial
0,2,1,59,2,10,2,60,0,government loses $2.2 billion student loan dodgy training provider
0,3,10,46,2,13,0,56,0,donald trump must named un climate change meeting
0,3,1,66,1,12,0,67,0,children's hospital unit forced close new patient due staff shortage
0,2,7,33,1,7,0,40,0,optimistic post-brexit britain
0,1,2,38,1,7,4,40,0,"number cholera death zimbabwe surpasses 4,000"
0,1,7,25,0,6,0,32,0,nasa say worker tried sabotage iss
0,1,2,51,1,9,0,53,0,"flash flooding greece kill one, dozen building flooded"
0,2,14,50,0,13,0,64,0,netflix user lost half billion hour life adam sandlermovies
0,1,3,23,0,4,0,26,0,vodafone buy connex oskar
0,2,5,37,5,7,0,42,0,no. no. next question: trump denies pressuringcomey
0,3,6,53,3,10,0,59,0,great british bake off: james accused 'cheating' christmas special
0,3,2,48,0,8,0,50,0,berkeley protest peaceful hundred rally coulter
0,1,3,65,0,10,0,68,0,asbestos discovery trigger evacuation closure new jersey middle school
0,2,7,43,0,8,4,50,0,china commodity juggernaut roll 2017 record tumble
0,2,5,44,0,9,0,49,0,george osborne start selling royal bank scotland
0,3,10,56,1,10,0,66,0,highly taxed company need trump deliver justify post-election rally
0,1,7,39,2,9,0,46,0,"josh beckett maintains order, image, mound"
0,1,1,38,0,6,0,39,0,irish bishop resigns child abuse scandal
0,2,10,39,2,9,0,49,0,like night day: two state utility approach solar
0,1,7,33,0,6,0,40,0,web site offer anonymous chat stranger
0,3,4,44,1,10,0,48,0,twice likely live american dream canada
0,3,11,53,2,12,0,64,0,'stranger things' star millie bobby brown getting ready take godzilla
0,3,7,39,0,9,2,46,0,22 train car plunge river california derailment
0,3,10,54,2,11,0,64,0,"paul manafort, former trump campaign chief, face new allegation ukraine"
0,1,3,43,0,6,0,46,0,johnson ousts livingstone london mayoral election
0,1,3,28,0,4,0,31,0,ngrid betancourt return france
0,1,3,32,0,5,0,35,0,litvinenko murder suspect running mp
0,1,5,24,0,6,0,29,0,u uk force join libyan attack
0,2,9,36,6,11,0,45,0,"shaq: trump fair square, time give chance"
0,3,10,36,1,8,0,46,0,"proposed trump budget hike defense spending, cut epa"
0,2,8,31,1,11,2,39,0,need miracle 34th street new york time
0,1,6,35,0,5,0,41,0,labor secretary proposes suspending farm rule
0,2,8,20,1,9,6,28,0,"12 best meme 2016, bymonth"
0,2,8,51,0,11,4,59,0,iman shumpert reportedly trade target rocket ahead 2017 deadline
0,3,17,47,1,16,0,64,0,found creator sad kermit meme shes got vault kermitmemes
0,1,5,32,0,6,0,37,0,celtic rebuff challenger throne
0,1,7,36,0,8,1,43,0,legal giant skadden loses 2 top partner kirkland
0,3,14,49,0,12,0,63,0,ucla commit jaylen hand jump parent win high school dunk contest
0,3,14,37,2,12,0,51,0,"afl-cio, house dems pledge help trump push rework nafta"
0,3,10,34,1,10,0,44,0,north korea paradox: good option
0,1,7,35,1,6,0,42,0,sony's drm protected cd install window rootkits
0,1,7,37,0,8,0,44,0,islamic law official swat valley pakistan
0,3,6,45,4,9,0,51,0,"""full frontal samantha bee"" apologizes nazi hair joke"
0,1,2,35,0,6,0,37,0,canadian liberal vote head third ballot
0,1,10,48,0,9,0,58,0,swimmer mary descenza mount comeback missing cut beijing
0,3,3,52,0,8,0,55,0,super bowl gave everyone terrible election night flashback
0,2,5,33,0,4,0,38,0,entertainment reporter get political
0,1,6,28,1,7,3,34,0,$125 million pledged big medical center
0,3,6,66,3,10,0,72,0,cia director: trump equating intelligence community nazi germany 'outrageous'
0,2,3,46,2,10,0,49,0,new report hillary clinton email damning
0,1,4,70,1,14,2,74,0,tarja turunen perform doro pesch's 25th anniversary concert record duet
0,2,19,56,2,18,0,75,0,trailer sachin: billion dream can't wait biopic release
0,3,1,53,1,8,0,54,0,"shaq defends triangle offense, say stubborn player must adapt"
0,1,3,42,0,8,0,45,0,france pledge twelve million euro aid pakistan
0,3,12,55,2,9,1,67,0,shirley caesar reportedly file $5 million lawsuit viral #unameitchallenge
0,2,2,72,1,15,0,74,0,senate criminal justice reform repeat one worst mistake war drug
0,3,12,48,3,9,0,60,0,"global economy week ahead: yellen speech, boj decision, europe sentiment"
0,2,5,51,6,12,0,56,0,"former trump adviser taiwan call: 'if china like it, screw 'em'"
0,3,3,67,2,10,0,70,0,russian warplane kill turkish soldier northern syria 'friendly fire' incident
0,3,5,61,0,12,0,66,0,trump campaign manager conway grand marshal christmas parade new jersey
0,3,7,45,0,9,0,52,0,nick kroll john mulaney host independent spirit award
0,2,5,51,0,11,1,56,0,2 democrat vote confirm supreme court nominee neil gorsuch
0,3,12,47,0,11,0,59,0,twitter fun old mitchell trubisky tweet bear draft qb
0,2,3,70,1,12,0,73,0,house price growth jump highest since march despite weaker market post-brexit vote
0,3,15,55,4,13,0,70,0,trump's 'massive' middle-class tax cut tiny compared promised rich
0,3,4,79,0,18,1,83,0,search called british woman feared fallen overboard queen mary 2 ocean liner
0,1,2,30,0,6,2,32,0,last stauffenberg plotter dy age 90
0,1,4,44,2,7,0,48,0,epa declares 'emergency' asbestos cleanup montana town
0,2,6,46,1,9,0,52,0,ex-child soldier dominic ongwen denies war crime icc trial
0,2,1,41,0,9,0,42,0,texas toddler dy left inside hot car
0,2,8,42,2,8,0,50,0,patrick stewart applying u.s. citizenship fight trump
0,1,2,32,0,5,0,34,0,fourth lebanon bomb rock shopping mall
0,3,2,49,0,11,0,51,0,emma thompson almost quit film costar body shamed
0,3,1,43,1,5,2,44,0,g20 finance minister drop anti-protectionist pledge
0,1,2,31,0,6,0,33,0,fourteen dead two attack somalia
0,2,9,44,0,8,0,53,0,country highest lowest salary expectation
0,1,8,49,2,8,0,57,0,"estonia convict hermann simm, former security official, treason"
0,2,11,47,4,10,0,58,0,"pregnant 'grey's anatomy' star big, feminist dream daughter"
0,2,3,39,1,9,0,42,0,"kill drones, amazon go actual game changer"
0,1,1,24,0,4,0,25,0,jersey knife attack kill six
0,1,7,31,2,5,0,38,0,stanford financial dodged u.s. regulator
0,2,2,53,0,11,0,55,0,san francisco taxing rich pay free community college
0,2,3,87,3,14,0,90,0,"battle mosul: iraqi force reach second bridge, storm strategic university complex, military chief say"
0,3,11,46,1,10,0,57,0,people cant handle hilariously awful beyonc wax figureis
0,3,10,32,1,9,5,42,0,"50,000 flee mosul battle isi advance iraq"
0,3,20,36,1,9,0,56,0,transcript: abc news anchor david muir interview president trump
0,2,3,56,2,9,0,59,0,beauty bible: illustrating world's widely distributed book
0,2,3,78,2,15,3,81,0,caught camera: shameless gang steal 600 donation buddhist temple pretending pray
0,1,2,40,0,7,0,42,0,time square shuts due suspicious vehicle
0,2,4,51,3,11,0,55,0,guardian view egypt dictatorship: war sisis making
0,2,1,47,3,9,0,48,0,texas 'affluenza' teen's lawyer seek release jail
0,1,5,18,0,5,0,23,0,panel changed get pay cut
0,3,5,57,2,11,3,62,0,240 prisoner moved hmp birmingham 'worst riot since strangeways'
0,3,5,31,5,8,0,36,0,former president obama: yes did. yes can.
0,3,7,44,0,7,0,51,0,brandon jennings sign wizard clearing waiver
0,3,3,38,3,9,0,41,0,"'star wars' movies, ranked worst best"
0,3,14,51,3,15,0,65,0,faith hill tim mcgraw preach respect toward woman new song 'speak girl'
0,2,2,54,1,14,0,56,0,"dude build epic lego train set dreams, put camera"
0,3,11,40,3,10,0,51,0,russia warns u.s. use force unilaterally n. korea
0,2,7,23,0,3,0,30,0,lead cnnverifizierter account
0,3,7,54,4,13,2,61,0,j.k. rowling '50 shade grey' author completely pier morgan
0,1,5,27,0,6,0,32,0,unusual appearance big clock
0,2,6,53,0,15,0,59,0,trump warned china rein north korea u would go alone
0,2,16,43,1,12,0,59,0,isro born india's rocket dream began ahmedabad
0,2,3,33,2,6,0,36,0,"so, michael phelps believe flossing?"
0,2,8,53,4,7,0,61,0,saddam hussein's daughter praise donald trump's 'political sensibility'
0,3,5,27,0,4,0,32,0,principal suspended trump skit
0,2,14,71,6,18,2,85,0,missy elliott pay tribute aaliyah's 'timeless music style' 20 year 'one million' released
0,2,6,71,5,19,0,77,0,'we told anyone sex baby': kim kardashian keep mum rumour boy
0,3,5,23,0,5,2,28,0,25 best justin timberlake song
0,1,3,31,0,6,0,34,0,heavy rain cause flooding across uk
0,2,5,57,0,11,0,62,0,boost manchester city gabriel jesus make early return training
0,2,13,56,4,14,0,69,0,soulja boy apologizes chris brown feud new twitter video: 'i've acting out'
0,1,5,31,0,4,0,36,0,charity seek bankruptcy protection
0,2,11,53,1,7,0,64,0,celebrity activist share letter #toimmigrantswithlove twitter
0,3,7,44,1,10,0,51,0,u hacking claims: clinton blame russia fbi bos loss
0,1,3,58,1,8,0,61,0,row lech wasa's alleged collaboration communist escalates
0,2,3,47,1,9,0,50,0,mta test open-gangway train give passenger moreroom
0,2,1,61,2,15,2,62,0,trump say releasing something 'phenomenal term tax' 2 3 week
0,1,8,30,2,8,0,38,0,"field, ice court, brother equal"
0,1,5,33,0,6,0,38,0,american injured clash israeli barrier
0,1,4,56,0,7,0,60,0,world health organization declares tuberculosis emergency africa
0,2,5,20,3,4,0,25,0,sandman editor next move
0,3,3,18,0,5,0,21,0,defense blowout
0,1,3,54,2,9,0,57,0,east timor australia problematic billion-dollar gas oil accord
0,1,4,55,1,8,0,59,0,russian prime minister resigns president vladimir putin's request
0,1,4,21,0,3,0,25,0,microsoft acquires voip firm
0,1,2,55,2,7,0,57,0,"conflicting reports, mounting fear, japanese nuclear disaster"
0,3,8,45,1,7,0,53,0,ex-nike employee auctioning original jordan protest trump
0,3,4,41,1,6,0,45,0,jailed egyptian novelist ahmed naji's appeal delayed
0,2,10,42,1,9,0,52,0,president obama one dapper groomsman aide's wedding
0,2,3,46,2,11,0,49,0,"next syria, ally foe fall aleppo?"
0,3,10,43,5,11,0,53,0,lucky: texas state rep. survives stray bullet head new year
0,2,11,36,3,9,0,47,0,gop congressman say poor dont want health care
0,3,2,57,0,11,0,59,0,british teen standing gender equality feminist hero
0,1,1,34,1,7,1,35,0,yahoo! purge personal data 3 month
0,1,4,20,0,6,2,24,0,40 die ferry sink vietnam
0,3,1,60,3,9,2,61,0,"california fault capable producing magnitude-7.4 earthquake, study say"
0,3,1,48,1,10,0,49,0,colorado landlord accused using tenant home sex pad
0,1,6,28,1,7,2,34,0,sophie reade win uk's big brother series 10
0,3,1,44,2,9,7,45,0,$154 million mansion china among 2016's expensive home
0,1,1,57,0,10,0,58,0,austrian man imprisoned daughter pleads guilty start trial
0,2,10,52,1,10,0,62,0,knife-wielding high school student shot campus police officer insider
0,2,1,60,1,14,0,61,0,fuel cell car emit nothing water brewing tea next logical step
0,2,6,40,2,8,0,46,0,"blindsided suv boom, hyundai motor trim costs, perk"
0,3,6,42,3,7,4,48,0,"coachella 2017: radiohead, beyonc, kendrick lamar headline"
0,2,13,60,9,12,2,73,0,imploded: hateful eight cop-hater tarantino lowest solo-grosser 20 year breitbart
0,3,2,73,2,13,0,75,0,"syria: suspected gas attack attracts little outrage, horror innocent drag"
0,3,4,63,2,12,0,67,0,"french presidential election: le pen, macron projected winner first round"
0,3,6,33,1,6,0,39,0,america's private prison back business
0,3,12,47,1,10,0,59,0,soon could enjoy kerala backwaters-like houseboat ride mumbai
0,1,4,62,0,11,0,66,0,right group afghanistan investigating claim u use phosphorus bomb
0,1,3,64,1,13,0,67,0,"large chimpanzee shot killed police u attack woman, officer"
0,2,17,62,10,23,0,79,0,behar: isnt time trump step wait hammer sickle u.s. flag?
0,1,3,26,0,6,2,29,0,physicist john wheeler dy age 96
0,3,2,74,3,12,0,76,0,sex abuse royal commission: adult molest child 'often popular member community'
0,1,2,35,0,6,2,37,0,suicide bomber kill 30 northwest pakistan
0,1,4,28,3,5,6,32,0,2007/08 bundesliga: nrnberg vs. bayern munich
0,1,3,27,0,6,2,30,0,british scholar tony judt dy aged 62
0,3,1,42,0,9,0,43,0,trump calendar keep track term end
0,3,10,61,0,12,2,71,0,dave koz reunite original christmas tour lineup 20th anniversary concert
0,1,2,45,0,7,0,47,0,last missing body minnesota bridge collapse found
0,2,11,46,3,11,0,57,0,"shift palestinian state put u.s. odds european, arab ally"
0,2,9,42,0,9,0,51,0,bison burger got pricier thanks canada rancher
0,3,15,48,5,13,0,63,0,"scott walker cpac: republican must ignore protests, time go big, go bold"
0,3,2,42,3,10,1,44,0,'legion' episode 1 recap: go little mad sometimes
0,3,12,63,4,11,0,75,0,"golden globes: jimmy fallon brave teleprompter failure, open musical number [video]"
0,3,1,55,0,9,0,56,0,montana abortion bill would force doctor deliver fetus
0,3,7,84,3,15,0,91,0,donald trump blast 'total witch-hunt' u attorney general jeff session recuses russia probe
0,3,3,31,0,7,0,34,0,love letter district columbia
0,1,6,49,1,10,0,55,0,republican lead race fill ted kennedy's vacated u senate seat
0,2,8,33,1,10,0,41,0,chino nacho's hit hot latin song chart
0,3,10,44,0,10,0,54,0,saudi oil ration mirror pricing heavy crude cut light
0,2,9,38,1,10,0,47,0,democratic party win back voter lost trump?
0,1,3,39,0,7,0,42,0,graner found guilty mistreatment abu ghraib
0,2,5,28,0,4,0,33,0,american obsession parenting
0,3,2,63,1,15,0,65,0,"donald trump refuse prove taking salary, despite promise"
0,2,6,34,5,4,0,40,0,trump conflict-of-interest worries...
0,3,10,43,3,11,0,53,0,alabama drive-in ban beauty beast gay character
0,3,15,34,8,11,0,49,0,"listen d.r.a.m.'s new single ""gilligan"" f/ asap rocky juicy j"
0,3,5,22,2,4,0,27,0,snapchat's big weakness: old
0,1,6,28,1,7,0,34,0,"deep lake huron, sign ancient hunt"
0,1,1,33,0,4,0,34,0,iranian government ban critical medium
0,3,6,48,2,12,1,54,0,amc released 3 new photo next episode 'the walking dead'
0,3,14,42,5,12,2,56,0,lebron james delivers $1.3 million cash family nbc's 'the wall'
0,3,2,65,3,10,0,67,0,"joseph jakubowski, wanted weapon thefts, threatening manifesto, arrested"
0,2,1,25,2,4,0,26,0,"remembering ""smell death"""
0,2,4,22,0,4,0,26,0,donald trump opponent
0,1,4,39,2,10,2,43,0,exit poll: 55% french voter say eu constitution
0,2,11,46,1,10,0,57,0,hilarious generator predicts sean spicer would f*ck name
0,1,4,51,2,11,2,55,0,"leonard skinner, namesake rock group lynyrd skynyrd, dy age 77"
0,2,1,44,1,8,3,45,0,1 killed 50-vehicle pileup pennsylvania interstate
0,1,5,61,1,11,0,66,0,coastal assassin get win roller derby event australia's sunshine coast
0,2,7,37,3,7,2,44,0,"jimmy breslin, pulitzer prize-winning writer, dy 88"
0,3,14,27,2,8,0,41,0,future dropping new album 'hndrxx' week
0,2,2,34,0,7,0,36,0,donald trump really might start trade war
0,3,4,79,0,12,0,83,0,indigenous kalgoorlie resident plan legal action landmark palm island court decision
0,2,7,74,1,16,0,81,0,"barry star devon terrell playing barack obama, struggling fit hope donald trump"
0,1,3,44,0,5,0,47,0,broadway market caf occupied gentrification
0,1,4,41,0,9,0,45,0,osama bin laden warns european union new audio tape
0,2,7,59,3,13,0,66,0,"sources: healthy luol deng, timofey mozgov agree sit rest lakers' season"
0,2,1,20,0,3,0,21,0,cursive make comeback
0,3,2,63,1,11,1,65,0,malaysia airline 1st carrier sign new satellite-tracking service
0,3,13,47,3,11,0,60,0,"bookstore displaying book men backwards, eye-opening"
0,1,2,20,0,5,2,22,0,ingmar bergman dy age 89
0,2,3,64,0,9,0,67,0,malaysian airport assassination focus new attention north korean leader
0,1,3,71,2,11,0,74,0,new poll show third party u.s. presidential candidate varying radically popularity
0,3,5,44,0,6,0,49,0,flushable wipe maker misleading consumer alleges accc
0,1,6,49,1,9,0,55,0,u navy los angeles-class attack submarine run aground near guam
0,1,4,33,0,8,0,37,0,gay play jesus christ open brazil
0,1,1,31,1,5,0,32,0,sydney's newest motorway open today
0,3,10,41,3,10,1,51,0,"jeezy announces trap die 3 tour, release 'never settle' video"
0,2,2,71,1,14,0,73,0,florida man arrested plotting bomb target store company's stock would plunge
0,2,16,59,2,14,4,75,0,"holy shit, here's vintage polaroid britney christina 2003 vmas wedding dress"
0,3,2,45,1,8,0,47,0,"trump, putin seek boost nuclear capability"
0,1,7,34,0,8,0,41,0,sri lanka attack said kill dozen hospital
0,1,2,39,0,8,0,41,0,myspace loses ten million user one month
0,1,2,33,0,4,0,35,0,teamster site suggests tigger pardoned
0,1,2,36,0,5,0,38,0,new zealand delay emission trading scheme
0,1,2,43,0,6,0,45,0,small british island get first democratic election
0,1,1,32,1,6,0,33,0,nepal's royal palace public museum
0,2,12,45,3,9,0,57,0,'moana' star auli'i cravalho land nbc pilot oscar performance
0,3,12,48,4,14,0,60,0,feinstein trump: 'i think he's going get out' office insider
0,3,2,24,0,4,0,26,0,cyclone debbie seen space
0,3,2,75,3,13,1,77,0,united airline ban 2 girl legging flight 'properly clothed'
0,3,6,68,3,13,0,74,0,"donald trump 'no regrets' accusing barack obama wiretapping, say sean spicer"
0,1,11,48,1,11,0,59,0,civilian toll d-day different afghanistan
0,1,8,29,1,8,0,37,0,"yankee fan top mets fan city, poll find"
0,3,11,46,2,11,2,57,0,"selena gomez ""13 reason why"" cast got powerful matching tattoo"
0,2,8,47,3,9,0,55,0,probe: brussels airport bomber wanted kill jew american
0,2,2,69,1,17,0,71,0,bill gate explains defines success nothing money power
0,3,13,73,1,12,0,86,0,bernie sander call house science committee tweeting breitbart's garbage climate reporting
0,3,11,36,3,14,2,47,0,nicki minaj put remy notice: 'u got 72 hour drop hit'
0,2,3,60,3,11,0,63,0,dale: mother's search answer son's treatment youth detention
0,3,11,55,3,12,0,66,0,watch must-see trailer 'baby driver' starring jamie foxx ansel elgort
0,2,13,52,0,12,0,65,0,tom price defends trump proposal cut funding public health andresearch
0,1,3,37,0,8,2,40,0,hollywood legend paul newman dy cancer age 83
0,1,6,35,0,6,0,41,0,company warm sponsoring mixed martial art
0,3,6,44,0,10,2,50,0,nh chief simon stevens refuse buckle 10 pressure
0,1,8,30,2,8,0,38,0,china plan challenge u.s. ban poultry
0,2,9,45,1,10,4,54,0,"gm laying 1,100 worker eliminating shift michigan plant"
0,3,11,41,0,11,0,52,0,kraft heinz takeover bid shake big food slow growth
0,1,3,44,1,10,2,47,0,helicopter ditch north sea; 18 board rescued
0,3,8,49,4,11,4,57,0,"carpool karaoke, rattlesnakes, nike ad: youtubes watched 2016"
0,2,3,45,0,7,0,48,0,glastonbury fest organizer asked replace kanye west
0,3,9,38,2,8,0,47,0,north korea test u.s. tillerson meet chinese leader
0,3,9,38,3,7,0,47,0,newsweek: nyc hate hoax highlight pressure muslim
0,3,9,37,0,10,0,46,0,pharrell celebs put ritz chanel paris
0,3,4,50,2,9,0,54,0,"vladimir putin responds trump's nuke tweet, jab democrat"
0,3,10,42,0,9,0,52,0,john green responded tumblr accusation sexualabuse
0,1,4,38,0,8,0,42,0,u host north korean diplomat nuclear talk
0,2,11,40,2,11,0,51,0,joe biden tell donald trump 'grow up' new video interview
0,3,6,62,1,11,0,68,0,"wikileaks doc allege cia hack smartphones, expose frankfurt listening post"
0,1,2,32,1,3,0,34,0,moscow detains anti-kremlin protester
0,3,8,33,2,12,6,41,0,"drake dart no. 1 artist 100, chuck berry debut top 40"
0,3,6,39,0,6,2,45,0,29 memorable surprise coachella performance
0,1,3,15,1,2,0,18,0,"hedge funds, unhinged"
0,2,10,39,4,9,0,49,0,"oscar nomination snub amy adams, 'jackie,' tom hank"
0,1,4,40,0,6,0,44,0,u navy aircraft crash afghanistan mission
0,1,8,32,0,7,0,40,0,europe cautious trade deal korea
0,2,7,27,0,6,0,34,0,swimmer start new year icy plunge
0,2,10,74,2,14,0,84,0,merry xxxmas! christmas shopper stunned german department store's rude window display
0,2,1,65,1,10,0,66,0,gorsuch's writing could prompt end life question confirmation hearing
0,2,5,73,1,12,0,78,0,trump's america code associated russian hacker found vermont energy company laptop
0,1,10,38,3,8,0,48,0,n.f.l. player representative face big vote union chief
0,2,1,53,0,6,0,54,0,trump administration revers transgender bathroom guidance
0,1,5,33,0,4,0,38,0,afghan leader outmaneuvers election rival
0,3,6,44,0,10,0,50,0,coalition syrian rebel force repel isi attack base
0,1,2,28,0,4,0,30,0,labour attack tory economic policy
0,1,3,45,0,7,0,48,0,two palestinian reportedly shot dead israeli troop
0,1,2,38,0,6,0,40,0,alleged axe murderer face australian court
0,3,1,60,1,11,0,61,0,"mediterranean diet linked lower risk breast cancer type, study say"
0,1,4,44,0,6,0,48,0,former chilean president pinochet suffers heart attack
0,1,4,34,0,5,0,38,0,remnant hurricane felicia affect hawaii
0,2,11,38,1,11,0,49,0,japanese man crushed death six-ton porn stash
0,2,7,32,1,6,0,39,0,education tied conspiracy theory belief?
0,3,5,67,1,12,0,72,0,south china sea: u aircraft carrier strike group conduct patrol disputed water
0,1,1,55,1,8,0,56,0,australian short-term inmate right vote reinstated
0,2,9,41,0,9,0,50,0,puerto rico governor say year needed fix island budget
0,3,2,44,0,10,0,46,0,mar volcano died time dinosaur
0,3,10,46,6,9,0,56,0,"calling successor traitor, afghan ex-leader denounces u.s. bombing"
0,1,5,27,0,5,0,32,0,russian icbm test launch failed
0,2,2,55,1,9,0,57,0,mcconnell wont use federal fund investigate voter fraudclaims
0,1,8,48,2,10,0,56,0,"rhoden: detroit oakland, coach combat culture losing"
0,3,8,39,5,9,0,47,0,review: handmaid tale creates chilling man world
0,1,2,50,0,8,3,52,0,preliminary report released spanair disaster killed 154
0,1,5,42,2,9,6,47,0,"sydney's gay lesbian mardi gras celebrated 450,000 people"
0,1,0,41,2,6,2,41,0,20-year-old capture abusive police officer tape
0,3,10,38,2,8,0,48,0,"egypt price soar, el-sisi say currency undervalued"
0,1,6,25,0,5,0,31,0,china tv network apologizes fire
0,3,13,51,1,13,0,64,0,"nba draymond green, kevin durant laugh jazz coach late timeouts loss"
0,3,2,65,0,10,0,67,0,family westminster attack victim found fate picture online
0,1,5,29,0,5,0,34,0,jenson button win hungarian grand prix
0,3,10,43,2,10,2,53,0,"19 tumblr post ""chopped"" gourmet hilarious"
0,2,2,55,1,8,0,57,0,trump's new health secretary already planning change obamacare
0,2,16,40,2,10,0,56,0,gallup poll: trump approval rating lowest peotus decade
0,1,1,46,2,7,0,47,0,australian teacher drop 'gay' kookaburra folk song
0,3,7,29,1,7,2,36,0,16 reason holiday suck youreanxious
0,3,2,41,2,7,0,43,0,kate moss escorted flight 'for disruptive'
0,3,11,60,1,13,0,71,0,john lydon explains chinese government inspired book drawing lyric
0,2,18,50,1,19,6,68,0,"past 50 days, 8 lakh people total r 133 crore digidhan yojana"
0,3,3,86,4,19,0,89,0,"lady lodge: soaring property price drive rise posh lodge bottom gardens, expert say"
0,2,1,41,0,6,0,42,0,pentagon begin review nuclear weapon policy
0,2,3,31,0,7,0,34,0,creep offered son sex centralpark
0,1,4,59,1,12,0,63,0,united nations: people access cell phone toilet india
0,1,6,35,0,6,0,41,0,european union lift ban indonesian airline
0,2,4,35,1,8,4,39,0,"lionel richie, mariah carey tour together 2017"
0,2,3,83,2,16,0,86,0,guinea pig club veteran take sky 'final flight' diagnosed terminal cancer
0,1,1,34,0,4,0,35,0,controversial cancer test gain support
0,3,13,51,6,12,0,64,0,congressman ted lieu troll donald trump 'bigly' crowd: 'they like you'
0,1,3,60,0,11,0,63,0,false cancer cure claim lead federal charge five u company
0,1,7,24,2,6,0,31,0,saab move separate g.m.
0,1,6,29,1,9,5,35,0,west indie cricket team england 2007 3rd odi
0,2,1,47,1,8,2,48,0,families' anguish 12 still missing firework blast
0,3,3,87,2,15,0,90,0,'moneyball' author michael lewis explains professional sport team need reinvent role scout
0,2,4,71,3,10,0,75,0,ecuador say temporarily restricted wikileaks founder assanges internet access
0,2,2,56,1,10,0,58,0,"trump era, congressional town hall packed protester"
0,1,3,40,0,7,0,43,0,automobile sale united state sharply
0,2,12,49,0,12,1,61,0,6 immigrant story make believe american dream
0,3,11,58,1,12,0,69,0,"new york knicks derrick rose comment knicks future, russell westbrook"
0,1,2,46,2,7,0,48,0,"pakistan's musharraf resign within days, say report"
0,3,8,48,0,7,0,56,0,trump say obama administration stop guantanamo release
0,1,5,35,0,7,0,40,0,u library congress plan archive twitter
0,2,7,28,2,8,4,35,0,pick 2004 nba all-star game starters?
0,1,6,30,0,6,0,36,0,state college also face cut ambition
0,2,4,74,5,15,0,78,0,"dear barack, youre idiot: president obama reveals reply letter insult"
0,1,11,46,2,8,0,57,0,"iter, clean energy fusion project, promise unlimited electricity"
0,3,3,59,1,10,0,62,0,"patriot complete biggest comeback super bowl history, win fifth title"
0,2,2,45,0,8,0,47,0,nail salon charge extra overweight people list
0,1,4,21,1,5,0,25,0,"wright dixon, drama"
0,2,11,39,4,12,3,50,0,rogue one: star war story rake $155 million north america
0,2,1,62,1,7,0,63,0,london attacker's unusual background raise question investigator
0,1,4,78,1,10,0,82,0,south korean presidential candidate promise legalise non-activex technology banking
0,1,2,51,0,8,0,53,0,result released recount zimbabwe election result
0,3,4,50,1,10,2,54,0,"coalition air strike killed 18 afghan civilian last week, un say"
0,1,5,28,0,6,0,33,0,lesson japan stemming crisis
0,1,2,41,0,5,0,43,0,pipe bomb explodes outside california courthouse
0,1,8,43,1,9,4,51,0,launch nasa's mar science laboratory rover delayed 2011
0,1,3,54,1,11,0,57,0,eu observers: one fourth vote afghan election suspicious
0,3,2,31,3,3,0,33,0,democrats' medicare-for-all litmus test
0,3,2,34,2,10,0,36,0,'i stung scorpion plane' canada
0,3,7,35,2,7,0,42,0,get: selena gomez's rebecca de ravenel earring
0,3,2,52,0,10,0,54,0,swimmer attempt board flight trunk malawi airport
0,3,4,52,2,10,5,56,0,"burma: 65,000 muslim flee alleged persecution rakhine state"
0,1,1,26,0,4,0,27,0,iraq start manual vote recount
0,1,2,46,0,5,0,48,0,haiti postpones presidential election december
0,3,3,60,4,10,0,63,0,lindsey graham: russia's 'trying undermine democracy world'
0,1,4,33,0,5,0,37,0,wikinews interview gary fung isohunt
0,1,8,33,1,8,0,41,0,"mexican man admits using acid bodies, army say"
0,3,9,38,3,10,0,47,0,"syria clearly blame chemical attack town, u.s. say"
0,1,3,42,0,7,2,45,0,australian radio personality stan zemanek dy aged 60
0,1,4,52,0,10,1,56,0,david abraham appointed new chief executive british channel 4
0,1,4,43,0,6,0,47,0,brazilian landless worker movement invades city hall
0,3,2,44,1,7,0,46,0,gabourey sidibe open weight-loss surgery
0,3,11,39,3,11,2,50,0,"19 best tweet last night episode ""the bachelor"""
0,3,6,31,0,7,0,37,0,cerberus load european property debt
0,3,12,39,4,12,2,51,0,24 grey anatomy moment thatll remind good used tobe
0,3,3,64,2,10,0,67,0,"serena williams' rep confirms pregnancy, already deleted snapchat photo"
0,2,4,57,1,10,0,61,0,anti-trump protester spread powerful message statue liberty
0,1,7,30,0,7,0,37,0,bank asks offshore client sign tax form
0,1,3,41,0,6,0,44,0,evo morale win presidential election bolivia
0,1,3,63,0,11,0,66,0,report blame new zealand skydive plane crash killed nine overloading
0,3,5,22,1,5,2,27,0,10 actor who've played darth vader
0,1,2,39,0,7,0,41,0,weening take stage grardmer photo finish
0,3,4,55,2,13,0,59,0,rex tillerson say military action north korea 'on table'
0,1,6,79,2,16,0,85,0,minnesota department health say 'theatre nights' bar exempt freedom breathe act
0,3,13,53,2,11,0,66,0,lebron james zip no-look pas andrew wiggins' leg derrick williams
0,2,14,53,4,11,0,67,0,department education misspells apology misspelling w.e.b. du bois' name
0,2,4,40,2,11,2,44,0,eu leader meet first 'brexit summit' april 29
0,2,5,66,3,12,0,71,0,destination london's best historic pub perfect place celebrate st george's day
0,2,1,26,0,4,2,27,0,week 16 fantasy quarterback rank
0,1,6,36,0,6,0,42,0,european leader meet amid economic division
0,2,4,48,3,9,0,52,0,ivan nova determined crash yankee rotation: areliever
0,1,1,51,2,7,0,52,0,"australian government review censorship ""hate material"""
0,1,7,40,1,7,0,47,0,"scandinavian nonbelievers, say atheist"
0,3,1,50,0,11,0,51,0,drone pick delightful footage gray whale calf
0,1,3,36,1,6,0,39,0,"five child found dead graham, washington"
0,1,2,35,0,5,0,37,0,suicide bomber hit checkpoint pakistan
0,1,5,35,0,4,0,40,0,journal register seek bankruptcy protection
0,3,2,50,0,10,0,52,0,letter trump million signature updating live
0,3,14,54,3,10,0,68,0,cnn's jake tapper fling refugee contradiction ivanka trump's pro-strike tweet
0,1,3,23,0,3,0,26,0,google introduces google buzz
0,1,7,29,0,8,0,36,0,path lehman client get asset back
0,2,5,60,5,14,2,65,0,"agnes nixon, creator children, quietly made soap relevant, dead 93"
0,3,6,36,0,9,2,42,0,former nc police chief detained jfk 90 minute
0,2,5,67,3,10,0,72,0,state department website remove article touting history trump mar-a-lago estate
0,1,6,27,3,6,2,33,0,ex-chief settle fraud suit $2.5 million
0,2,13,49,4,16,0,62,0,maluma leaf soul sold-out concert miami: 'it honor here'
0,2,12,51,0,11,0,63,0,stunningly racist french novel steve bannon explains world
0,2,2,35,3,7,4,37,0,"hershey's bitter news: cutting 2,000 job"
0,2,10,45,2,12,0,55,0,"la jeune rue project, founder, slide toward failure paris"
0,2,1,55,2,12,0,56,0,shake-up trading world's largest hedge fund
0,3,3,66,1,11,0,69,0,"abuse accusation cleric still run high pope francis, book claim"
0,3,7,78,3,14,0,85,0,hutt river principality: malcolm turnbull decline 'royal' invite prince leonard set cede throne
0,2,2,62,2,14,0,64,0,ryan say obamacare 'remain law land' health bill failure
0,1,2,70,2,11,0,72,0,"france first recognise libyan rebel ""legitimate representative people"""
0,1,2,24,0,3,0,26,0,south african spy suspended
0,1,5,46,1,9,4,51,0,2007 rugby world cup: argentina shock france tournament opener
0,1,4,56,0,10,0,60,0,italian mp start thirst hunger strike protest saddam execution
0,2,2,84,2,13,3,86,0,pictured: sewer 200 partygoer attended illegal raveafter wading water-filled tunnel
0,2,7,33,0,8,0,40,0,dangerous time emerging market
0,2,1,56,1,9,0,57,0,interest rate rise boost bank profit margin customers' expense
0,1,5,34,0,7,0,39,0,britain make final world war ii debt payment
0,1,8,40,1,7,0,48,0,"pakistan face tough fight taliban chief, mehsud"
0,1,8,51,2,9,0,59,0,u.s. general mcchrystal submits plan afghanistan president obama
0,3,11,19,2,6,0,30,0,troy ave shot brooklyn (update)
0,3,4,71,0,11,0,75,0,louisville mayor asks fbi investigate police department sex abuse allegation
0,2,2,38,3,10,0,40,0,"odds? mom, dad, son share birthday"
0,3,4,71,0,16,0,75,0,tale everton one kenyan refugee brings home human side english football
0,3,5,72,5,13,0,77,0,"kim jong-nam: malaysia release body slain half-brother kim jong-un, diplomatic spat end"
0,3,3,42,1,7,0,45,0,champagne cork pop moscow trump's inauguration
0,3,2,31,3,6,0,33,0,rohingya woman: 'they tore clothes'
0,2,1,67,0,12,0,68,0,asia investor boost use unorthodox data source battle beat benchmark
0,1,9,31,3,7,0,40,0,conrail plan may model g.m.-chrysler crisis
0,2,2,44,1,9,0,46,0,face mask helping kid beat london's air pollution
0,1,7,36,1,9,0,43,0,"andes, toxic site also provides livelihood"
0,2,9,32,1,10,0,41,0,many favorite shows? take high speed
0,1,4,25,1,5,2,29,0,medtronic post 69% decline profit
0,3,5,66,2,9,0,71,0,brexit brexit: scotland's leader nicola sturgeon seek new independence referendum
0,3,9,42,1,9,0,51,0,energy drink worse heart caffeine alone: study
0,2,12,35,2,10,0,47,0,"palestinian father, six-day war led divided life"
0,1,4,43,0,9,0,47,0,force loyal ouattara plan seal ivory coast border
0,3,6,52,3,11,0,58,0,jared kushner serve 'senior adviser' donald trump's white house
0,2,3,19,0,4,0,22,0,win constitution
0,2,11,34,1,10,0,45,0,"tom brady wore massive coat, internet loved"
0,3,2,36,0,10,0,38,0,dog found nose ear cut detroit
0,2,5,40,1,11,2,45,0,le man 24 hours: porsche audi set great showdown
0,1,6,30,0,6,0,36,0,new foundation take aim urgent threat
0,3,2,46,1,8,3,48,0,"vandal damage 100 headstone jewish cemetery, police say"
0,2,2,41,3,6,0,43,0,anxious election? here perspective.
0,3,5,47,1,10,3,52,0,new fbi photo show devastation pentagon 9/11 attack
0,3,10,47,1,11,0,57,0,watch live: family baton rouge deputy shot deadly ambush speaks
0,3,4,61,1,14,1,65,0,elon musk acted like ecstatic child spacex's rocket landed 1st time
0,2,12,52,2,10,1,64,0,6-year-old girl removed longtime foster family native americanlaw
0,1,2,47,1,7,0,49,0,ukrainian journalist gongadze's skull may found
0,1,12,58,0,12,0,70,0,iraqi general filing suit close newspaper tv channel alleged misquote
0,2,16,40,1,9,0,56,0,aclu announces mass foia donald trump's business conflict
0,2,11,35,1,8,0,46,0,"fyi, chrissy teigen really fucking funny onsnapchat"
0,2,2,50,0,7,0,52,0,trump administration weighs deeper involvement yemen war
0,2,11,32,0,7,0,43,0,former isi recruit weapon terrorism
0,3,4,32,2,7,2,36,0,sir john hurt: bafta-winning actor dy aged 77
0,3,1,61,4,11,0,62,0,pop-up 'repair cafes' save broken gadget solve growing waste levels?
0,1,7,24,0,7,0,31,0,sri lanka bar swede stand war
0,2,2,38,0,5,0,40,0,missing northern california mother found safe
0,3,8,38,1,10,0,46,0,app concert ticket beat scalper bots?
0,2,13,33,2,12,2,46,0,"28 movie tv show watch loved ""big little lies"""
0,3,16,62,0,14,0,78,0,pak pm nawaz sharif escape punishment probe ordered panama corruption case
0,2,10,42,2,9,0,52,0,"senior teeth need dental care, insurance coverage rare"
0,2,9,42,1,8,0,51,0,konnichiwa amsterdam: japan bank seek new home brexit
0,1,4,48,1,9,0,52,0,"iraqi insurgent guilty war crimes, say human right watch"
0,3,10,48,0,10,3,58,0,people wasted 500 million hour watching adam sandler movie netflix
0,1,2,44,1,6,0,46,0,obama's private prayer published israeli newspaper
0,1,2,32,0,5,0,34,0,boil water advisory lifted vancouver
0,1,3,21,1,4,0,24,0,anti-terror raid hague
0,1,10,33,2,10,0,43,0,"news corp. unit settle suit rival, buy"
0,1,2,29,0,4,0,31,0,anglican bishop abducted nigeria
0,3,8,34,4,8,0,42,0,donald trump blast roger goodell: 'hes stupid guy'
0,2,2,47,3,9,0,49,0,"trump, egypt's president meet talk terrorism, foreign aid"
0,2,4,57,0,10,0,61,0,freelancer say got stiffed company acquired one worldmedia
0,3,1,21,0,5,0,22,0,old horse friend
0,3,3,87,2,15,0,90,0,tory mp stand allegedly telling student homosexuality 'wrong dangerous society'
0,3,3,47,0,11,0,50,0,one major issue trump left address congress
0,1,3,34,1,7,2,37,0,british airway give medal flight 38's crew
0,2,4,54,3,12,0,58,0,"clinton team take part u.s. state vote recount, trump blast effort"
0,3,9,47,3,10,0,56,0,"lorde talk taking long break, david bowie influence 'melodrama'"
0,3,2,46,0,6,0,48,0,quokka sighting brings hope northcliffe population
0,2,5,60,0,9,0,65,0,former penn state president graham spanier convicted child endangerment
0,2,6,23,0,9,4,29,0,look new state local law 2017
0,1,4,46,1,9,6,50,0,"new york public library open collection 275,000 digital image"
0,1,2,43,0,7,0,45,0,uk police announce arrest suspected serial killer
0,2,4,76,1,15,0,80,0,"quarter people fantasised sexually ai voice assistant, study say list"
0,3,1,60,0,10,0,61,0,classifying human race biggest mistake history science
0,1,6,29,0,6,0,35,0,guitar magazine test luxury water
0,2,10,44,0,10,0,54,0,tennis continues fail serena williams come racism
0,3,6,42,0,8,0,48,0,protester shut milo yiannopoulos event uc davis
0,1,1,56,1,9,2,57,0,11th suspect arrested lao overthrow plot; indictment handed
0,2,13,61,1,12,0,74,0,blake lively ryan reynolds' beautiful baby make first red carpet appearance
0,1,4,32,1,5,0,36,0,zimbabwean police raid mdc party's office
0,2,1,46,0,8,0,47,0,campbell sinking sale fall expected
0,3,11,64,2,11,2,75,0,draymond green klay thompson judge kevin hart's heckling following warriors/76ers game
0,3,13,49,4,14,0,62,0,david guetta connects nicki minaj lil wayne 'light body up': listen
0,1,5,23,0,4,0,28,0,china release human right plan
0,3,10,33,1,10,1,43,0,amazon ride big data $1 trillion market cap
0,2,5,45,3,9,0,50,0,"muslim nypd officer threatened, told 'go back country'"
0,3,5,55,2,12,0,60,0,jeremy hunt 'googled fgm survivor asked could orgasms'
0,3,5,38,2,7,0,43,0,new nasa image show 'doomed duo' galaxy colliding
0,1,2,41,0,7,0,43,0,talk held avert nigerian oil production strike
0,2,19,66,3,14,0,85,0,msnbcs odonnell: maybe putin masterminded chemical attack trump could look good striking syria
0,3,2,37,2,7,0,39,0,two-thirds navy strike fighter jet can't fly
0,2,11,47,1,12,0,58,0,donald trump claim he's sold stock without offering proof
0,3,1,82,0,11,0,83,0,surgeon issue warning government policy revolutionary keyhole heart surgery procedure
0,3,10,54,3,9,0,64,0,"there's silver lining rex tillerson's nomination, environmentalist say"
0,3,3,15,0,4,2,18,0,carrie fisher dy 60
0,3,2,80,2,12,0,82,0,"san francisco's withdrawal national terror intelligence network hike risks, official say"
0,2,9,35,1,9,2,44,0,"suv hit 4 high school student washington, killing 2"
0,2,2,56,0,9,0,58,0,suspect acquitted murder tinder date plummeted balcony
0,1,2,35,0,5,0,37,0,deadly flooding pakistan kill hundred
0,2,4,67,1,13,0,71,0,man accused making threat jewish community center arrested st. louis
0,3,13,36,0,12,0,49,0,gif white guy blinking become huge reactionmeme
0,1,4,30,0,6,0,34,0,canadian convicted murder hiv case
0,3,2,31,0,7,0,33,0,u boy buried alive tonne snow
0,3,6,53,0,8,0,59,0,smiling queen charm maundy money recipient leicester cathedral
0,2,4,39,0,6,0,43,0,powerful earthquake shake chile christmas day
0,3,11,49,5,10,0,60,0,"lavar ball's pro football career, according teammates, 'garbage'"
0,1,2,22,0,4,0,24,0,german hostage freed iraq
0,2,6,25,1,7,0,31,0,trump show debate?
0,2,6,53,4,11,0,59,0,u.s. treasury chief tell imf expects frank candid forex analysis
0,1,7,29,2,6,0,36,0,u.s. military offer path citizenship
0,3,2,47,0,10,2,49,0,12 christmas joke better cracker one list
0,3,13,53,2,12,5,66,0,ey cybersecurityvoice: cybersecurity no. 1 business priority 2017
0,2,14,59,3,13,0,73,0,pretend election happen?: tucker grill dnc chair candidate insider
0,3,10,26,1,9,0,36,0,half million rigged vws?
0,1,2,34,1,7,0,36,0,first same-sex couple wed south france
0,3,7,34,1,7,0,41,0,november job report: everything need know
0,1,2,42,1,8,0,44,0,microsoft's attempt buy yahoo may never happen
0,3,17,55,3,16,0,72,0,know dilip kumar first choice 'lawrence arabia' omar sharif?
0,1,4,37,1,7,0,41,0,pakistani army storm red mosque; ghazi killed
0,1,8,36,2,8,0,44,0,north korean condemn u.s. sanction huge rally
0,1,2,34,1,5,0,36,0,somali al-shabaab group seizes three town
0,3,2,54,0,10,0,56,0,twitter strike comedy gold stream joke trump report
0,3,2,73,0,18,1,75,0,first mar astronaut may trapped inside tube 3 year chance escape
0,1,6,27,2,8,6,33,0,"flood fiji leave 11 dead; 9,000 evacuated"
0,1,7,55,1,8,0,62,0,ncaa football: three gopher player arrested following rape allegation
0,2,2,45,0,10,0,47,0,rhode island could next state make tuition free
0,1,4,74,0,10,0,78,0,protester arrested barricading inside portion keystone oil pipeline
0,1,4,41,0,9,3,45,0,five injured adam air 737 overrun batam island runway
0,1,7,32,0,7,0,39,0,another foe chechen leader shot dead abroad
0,3,14,63,4,14,0,77,0,"nina dobrev orlando bloom hanging romantically super casual, say source"
0,1,8,38,1,7,0,46,0,"defending world skating title, german take pair lead"
0,2,5,47,1,8,0,52,0,"president donald trump, justin trudeau hold press conference"
0,3,3,39,2,8,0,42,0,emmy rossum want equal pay shameless
0,3,3,62,1,11,0,65,0,"british spy reportedly moved russia, china secret file cracked"
0,2,3,58,1,13,0,61,0,"luckily world, donald trump get big decision right"
0,2,11,53,3,12,0,64,0,new orleans woman survives tornado hiding bathtub: 'i started praying'
0,1,6,35,0,8,0,41,0,working detail gun national park
0,1,3,48,2,9,5,51,0,"nearly 25,000 iraqi civilian killed iraq, watchdog group claim"
0,1,4,73,1,10,0,77,0,anti-scientology protest material removed youtube following threat legal action
0,3,12,59,0,11,0,71,0,stephen colbert top jimmy fallon rating sharp political commentary
0,1,4,48,1,8,0,52,0,"large gas main explodes san bruno, california neighborhood"
0,3,6,27,0,6,0,33,0,star chow golden globe
0,3,11,56,3,10,0,67,0,barrier-breaking football player what's next gay recruit my-king johnson
0,1,2,26,0,4,0,28,0,lawmaker japan found hanged
0,3,21,70,0,21,1,91,0,lack coordination hospital blood bank led wastage 6 lakh litre blood five year
0,3,5,46,3,11,0,51,0,north korea vow respond u navy's 'reckless' show force
0,3,1,57,0,11,0,58,0,german student eyed mowing pedestrian held murder charge
0,1,4,49,0,7,0,53,0,joseph kabila declared winner congo presidential election
0,3,1,59,3,9,0,60,0,affluenza teen father found guilty impersonating police officer
0,1,2,50,1,12,4,52,0,womens boxing included 2012 olympics first time
0,2,12,41,0,11,0,53,0,adorable moment baby koala held mom hersurgery
0,3,5,44,1,7,0,49,0,penny embrace us-australia partnership trump spat
0,2,10,78,2,18,2,88,0,"moroccan woman arrested trying smuggle migrant, 19, across border spain inside suitcase"
0,1,9,32,3,7,0,41,0,i.r.s. thwarted court shield textron tax paper
0,3,3,58,2,12,2,61,0,stunning $1.5 billion stadium built atlanta falcon
0,2,14,66,0,13,0,80,0,huge search operation underway find body crashed russian military plane passenger
0,3,11,38,1,12,0,49,0,nation zoo know need see cute animal right
0,2,10,59,0,10,0,69,0,dak prescott say biracial background helped connect cowboy teammate
0,1,4,39,1,6,0,43,0,nasa schedule launch date comet-chasing probe
0,2,3,40,3,8,0,43,0,absolute worst time 'girlboss' netflix
0,1,7,30,0,7,0,37,0,pakistan say make gain taliban
0,2,2,21,0,2,0,23,0,abbas kiarostami obituary
0,1,5,25,0,4,0,30,0,leftist party win salvadoran vote
0,2,3,88,0,19,0,91,0,clipper devastated injury luck blake griffin miss rest playoff toe injury
0,3,7,14,0,7,4,21,0,pay tax bill 2017
0,3,5,62,1,10,0,67,0,"conservative need safe space u universities, donald trump supporter say"
0,1,2,36,0,6,0,38,0,u nuclear security director asked resign
0,1,1,25,0,3,0,26,0,haiti rescue effort abandoned
0,1,7,45,1,10,0,52,0,"god, firearm america come together church kentucky"
0,1,2,30,0,3,0,32,0,rioting develops throughout england
0,1,4,23,0,3,0,27,0,liberty collect first victory
0,2,6,57,2,12,0,63,0,donald trump bash 'snl' twitter sketch tweeting much
0,3,5,57,3,10,0,62,0,egypt confirms al jazeera producer mahmoud hussein's arrest 'fake news'
0,1,2,35,0,6,3,37,0,188 fatah supporter permitted enter israel
0,2,1,74,0,13,0,75,0,high school runner shovel entire track lane snowstorm avoid treadmill
0,1,6,38,1,8,0,44,0,science quest ease figure skating's strain
0,3,4,71,3,15,2,75,0,yahoo ceo giving least $12 million compensation company hacking probe
0,2,8,28,0,6,4,36,0,oecd see economic growth accelerating 2017
0,3,1,53,0,7,0,54,0,trump son distance fundraiser selling access
0,1,5,30,0,5,0,35,0,appeal court reject suit protester
0,1,5,31,0,5,0,36,0,acquisition company announce bank deal
0,3,6,61,0,11,0,67,0,peter dutton want apology abc reporting manus detention shooting
0,2,3,58,1,10,0,61,0,facing future: gillian wearing digitally age new artwork
0,3,10,37,2,8,0,47,0,japan move sumo top tier two-decade absence
0,2,6,67,3,13,0,73,0,barack obama slam donald trump's muslim travel ban putting 'american value stake'
0,3,9,50,1,11,0,59,0,george michael death met disbelief celebrity twitter
0,3,5,48,1,8,0,53,0,"gop leader delay obamacare replacement vote, amid opposition"
0,3,5,49,2,9,0,54,0,american airline introduces basic economy class. worth it?
0,2,2,53,1,8,0,55,0,uk's gender pay ranking put discrimination spotlight
0,2,4,43,2,8,4,47,0,"texan trade brock osweiler, 2018 second-round pick brown"
0,3,7,73,3,14,0,80,0,"labour could lose copeland stoke by-election jeremy corbyn quit, diane abbott say"
0,2,11,49,2,10,0,60,0,sander camp deletes bloody sunday tweet showing march selma film
0,2,3,66,1,11,0,69,0,"obama transfer six gitmo detainees, including alleged bin laden bodyguard"
0,3,7,38,0,8,0,45,0,pope francis prays victim egypt church attack
0,1,5,27,0,6,4,32,0,felipe massa win 2008 european grand prix
0,2,6,46,1,9,0,52,0,michigan became feel-good story ncaa tournament
0,2,14,63,5,15,0,77,0,california today: muslim candidate say he triple threat donald trump new york time
0,3,10,50,0,11,3,60,0,jim harbaugh say 4 year spent coaching 49ers may warrant endurance medal
0,2,9,66,2,15,4,75,0,police: 200 descend philadelphia mall 2nd night violence; fracas organized snapchat
0,2,8,37,4,6,0,45,0,meet hillary clinton not-so-secret weapon breitbart
0,3,11,61,3,11,1,72,0,"mom, 3-year-old daughter killed louisiana dangerous storm sweep across southeast"
0,1,5,35,1,9,2,40,0,"robert wilson, bassist gap band dy aged 53"
0,1,2,30,0,6,0,32,0,ancient prayer book found irish bog
0,2,15,36,1,15,0,51,0,love letter love letter call hang wall
0,1,4,54,1,7,0,58,0,protester police violence surround london's scotland yard
0,3,11,27,4,10,0,38,0,nest's 'eagle cam' cracked
0,2,16,54,3,15,0,70,0,mouni roy recreates aishwaryas aaj jaane ki zid na karo naagin beyond sexy!
0,1,9,49,2,13,0,58,0,"seattle, world still turns, beacon memory lost newspaper"
0,3,11,47,3,11,0,58,0,"qb de'andre johnson, dismissed fsu punching woman, sign fau"
0,2,3,74,2,13,0,77,0,education department report find billion spent obama 'no impact' achievement
0,2,5,33,2,6,0,38,0,'nervous' patti smith forgets bob dylan lyric
0,3,9,36,3,10,0,45,0,"russian hacker acted aid trump election, u.s. say"
0,1,6,43,0,8,0,49,0,un security council vote extend ivory coast sanction
0,3,10,52,2,9,0,62,0,'yolocaust' project shame people take selfies holocaust memorial
0,1,8,47,1,9,0,55,0,"steelers arrive, talking short message tall receiver"
0,2,4,58,6,12,0,62,0,faith proved george michael superstar. patience proved great.
0,1,9,30,3,8,0,39,0,retention pay a.i.g. worker fix mess
0,3,4,35,3,8,0,39,0,recruit's dad urban meyer: recruit son
0,1,4,28,0,3,0,32,0,teaching teenager harassment
0,2,11,64,3,13,0,75,0,"exclusive: corey lewandowski escorted trump tower, trump campaign breitbart"
0,2,5,63,1,12,0,68,0,robbie williams caught using hand sanitiser greeting fan new year's eve
0,1,6,54,3,9,1,60,0,dozen 7-elevens transformed kwik-e-marts promote simpson movie
0,3,12,36,0,8,0,48,0,apollo tragedy taught nasa important lesson
0,2,2,43,2,10,0,45,0,"better bald, according science list"
0,1,5,34,1,6,0,39,0,un security council approves libya no-fly zone
0,3,10,52,2,11,0,62,0,"marine le pen, europe nationalist leader kick year election hope"
0,1,3,15,0,3,0,18,0,ebay acquire skype
0,1,5,24,0,7,3,29,0,britain add 700 troop afghan war
0,2,6,28,1,6,0,34,0,vance joseph hired broncos' head coach
0,1,6,34,1,5,1,40,0,zenit-3sl rocket launch echostar xi satellite
0,2,8,49,2,7,0,57,0,facebook's quarterly earnings blow past wall street's expectation
0,2,4,45,2,9,0,49,0,"justice sotomayor, princeton, avoids talk gorsuch"
0,1,7,53,1,10,0,60,0,"memorial service held sir bobby robson durham cathedral, england"
0,1,4,36,0,4,0,40,0,administration seek regulate derivative
0,1,9,34,4,7,0,43,0,"former fbi second-in-command say ""deep throat"""
0,3,2,87,3,18,0,89,0,"cat halted marlin game running onto field, leading priceless bit play-by-play announcing"
0,1,3,51,2,5,0,54,0,hurricane katrina: resource regarding missing/located people
0,2,16,53,1,15,0,69,0,"three youth fall trying take selfie moving train, crushed track"
0,2,9,36,2,9,0,45,0,luis fonsi's top hot latin songs: vote favorite
0,3,5,82,2,13,2,87,0,"frantisek rajtoral dead: former czech republic international found hanged killing himself, aged 31"
0,1,4,76,1,13,0,80,0,canada's health minister attempt stop american buying prescription drug bulk
0,2,2,45,1,9,1,47,0,olympics exec arrested nude scalping $3m intickets
0,2,4,69,2,10,0,73,0,beast balance review: jenga crossed skylanders tablet-augmented scoring
0,3,4,51,1,11,0,55,0,celtic well aware bulls' rajon rondo step matter
0,2,2,48,0,9,0,50,0,thief reportedly use smoke bomb target shop venice
0,2,8,42,1,11,0,50,0,ex-wells fargo ceo john stumpf one blame
0,3,3,20,0,3,0,23,0,elizabeth warren persists
0,3,14,52,2,13,0,66,0,'flip flop' star tarek el moussa talk divorce christina gun incident
0,1,1,33,0,4,0,34,0,israel undergoes major emergency drill
0,3,1,51,0,9,0,52,0,religious leader head effort help man facing deportation
0,3,16,62,1,15,0,78,0,anushka poking fun katrinas song promote phillauri prof best friend
0,3,9,37,1,9,1,46,0,drake 2 chainz reunite another potential hit?
0,1,1,75,3,9,0,76,0,wikileaks release thousand secret documents; 'international embarrassment' likely
0,3,11,39,2,9,2,50,0,87-year-old woman troll trump grave obituary
0,2,9,59,1,11,3,68,0,seattle mayor seeking $250k protect illegal immigrant deportation insider
0,2,10,39,2,9,0,49,0,new mexico law ban school 'lunch shaming' hungry kid
0,1,7,33,0,6,0,40,0,young japanese raise voice economy
0,2,10,51,1,9,0,61,0,sport world wonder trump immigration order affect athlete
0,2,6,75,1,18,0,81,0,isi us drone drop bomb iraqi army tank shocking new video war-torn city mosul
0,3,2,40,0,8,0,42,0,amari cooper provides mom dream house car
0,1,7,35,0,7,0,42,0,contact made aid worker kidnapped darfur
0,3,1,50,2,8,0,51,0,study find 'staggering' rise mastectomy state
0,2,10,56,0,12,0,66,0,sorrow revisits town student killed germanwings crash brought home
0,1,4,41,0,5,0,45,0,debris narrowly miss international space station
0,3,4,45,1,8,0,49,0,badlands twitter: u park climate change tweet deleted
0,1,6,40,1,8,0,46,0,stella english win sixth series uk's apprentice
0,2,10,40,5,11,1,50,0,maroon 5 kendrick lamar's 'don't wanna know' top pop song chart
0,1,9,38,1,12,0,47,0,"map georgia, old word start new rush tourist"
0,2,8,36,0,10,0,44,0,kanye west showed trump tower meeting
0,3,5,50,2,11,2,55,0,"butch trucks, founding drummer allman brother band, dy 69"
0,1,2,44,0,8,0,46,0,two million people displaced flooding india
0,3,6,32,0,8,0,38,0,drive inaugural parade past
0,1,6,27,0,7,0,33,0,hot debate give way embrace obama
0,1,10,37,2,9,0,47,0,u.n. health aid plan unites air traveler bill clinton
0,3,5,57,1,11,0,62,0,samuel l. jackson revives debate british black actor american role
0,1,1,40,1,9,6,41,0,japan pledge 25% cut greenhouse gas emission 2020
0,3,5,47,4,11,0,52,0,"steve alford: 'i staying bruin,' interested indiana job"
0,3,3,58,1,10,0,61,0,barack obama's legacy lie somewhere hope despair chicago
0,3,2,88,9,18,6,90,0,kim jong-un's half-brother died 15-20 minute 'ambushed deadly nerve agent' 'assassin paid 72'
0,3,14,76,1,16,3,90,0,nigerian air force kill 100 civilian accident strike targeting boko haram: military official
0,1,4,42,1,9,0,46,0,nypd shuts anti-war speech due absence permit
0,1,6,16,3,3,0,22,0,a.m.d. report narrower loss
0,3,11,48,3,9,4,59,0,"final four 2017: schedule, odds, prediction ncaa tournament semifinal"
0,2,1,70,2,10,0,71,0,murdered woman's sister support executing ex-soldier potentially historic move
0,2,7,37,0,7,0,44,0,lawsuit say thalia failed promote fashion brand
0,2,2,43,4,8,0,45,0,'hollywood' sign changed 'hollyweed' new year prank
0,1,6,24,0,5,0,30,0,zuma face new charge ruling
0,2,3,52,1,11,0,55,0,"half american want stricter gun laws, pew study find"
0,1,6,30,0,7,0,36,0,musical show unity upset many israel
0,1,8,35,1,7,0,43,0,high-tech device thump course test firmness
0,1,3,47,0,6,0,50,0,california congressman george radanovich leave office
0,2,10,44,1,9,0,54,0,chinese bike-share service vow stop child rider death
0,1,5,33,0,6,0,38,0,scientist uncover oldest known dna earth
0,2,3,63,1,11,0,66,0,escaped ny prisoner reportedly planning kill prison worker's husband
0,3,3,52,1,12,1,55,0,iraqi official: least 6 people killed baghdad suicide bombing
0,2,1,62,2,9,0,63,0,third-party candidate excluded presidential debates: snub many
0,3,2,49,1,7,0,51,0,atom-smashing scientist unnerved harsh trump budget
0,2,5,31,1,4,0,36,0,atlantic daily: conflicting interest
0,2,6,37,3,7,0,43,0,watch james corden's crosswalk 'beauty beast'
0,3,7,34,1,10,0,41,0,"xi jinping davos, making waning era"
0,1,2,43,1,8,2,45,0,41 killed suicide bombing near pakistan's swat valley
0,2,16,60,4,19,2,76,0,"roger water post new tease first solo rock album 25 years, 'is life really want?'"
0,2,3,65,6,9,0,68,0,"comminsure: deloitte report clear insurance arm 'systemic', 'cultural' problem"
0,1,2,37,0,5,0,39,0,suicide bomber blast two bangladeshi city
0,2,11,46,4,9,0,57,0,"watch father john misty perform ""total entertainment forever 'snl'"
0,2,1,62,0,11,0,63,0,humanity evolved wriggling sea creature large mouth anus
0,1,5,29,0,5,0,34,0,roddick sculpture another win paris
0,3,9,40,0,9,0,49,0,walt disney take another costly ride french theme park
0,2,4,41,3,8,0,45,0,"sergio garcia master victory: ""i screaming"""
0,1,4,24,0,4,0,28,0,chopard maintains bold outlook
0,3,5,33,2,7,0,38,0,terrible hollowness ghost theshell
0,2,3,62,4,15,0,65,0,john wall think isnt getting call should. pushing edge.
0,3,11,57,1,10,0,68,0,"obnoxious steelers fan videobombs new england broadcast, get shoved camera"
0,3,3,44,0,11,0,47,0,meal wheel want play bigger role health care
0,2,11,41,0,11,2,52,0,20th century fox apologizes using fake news promote afilm
0,1,3,45,1,8,0,48,0,"body recovered capsized boat kerala, india"
0,3,12,37,1,9,0,49,0,"gop want punish filming, photography house floor"
0,1,6,24,0,6,0,30,0,making fuzzy video come focus
0,2,10,47,4,10,1,57,0,germany angela merkel urge g-7 leader send russia united signal
0,3,5,85,4,17,0,90,0,"trump critic van jones: one extraordinary moment ever seen american politics, period"
0,1,2,28,0,5,0,30,0,prince harry ordered return home
0,3,3,49,1,10,3,52,0,winning ticket $435 million powerball jackpot sold indiana
0,1,2,41,0,5,0,43,0,mar opportunity rover pass distance milestone
0,3,3,84,4,18,0,87,0,wife describes 'terrifying' moment husband stabbed train man shouting 'i want kill muslim'
0,2,4,51,3,10,0,55,0,telltale game making five-part 'guardians galaxy' story
0,1,2,24,1,4,5,26,0,"myspace remove 90,000 sex offender"
0,3,8,37,2,9,3,45,0,200 arrested d.c. protest inauguration day
0,1,5,27,0,5,0,32,0,new exodus fuel concern pakistan
0,1,3,37,1,7,0,40,0,"tree car crash kill two oxfordshire, england"
0,1,8,43,2,8,0,51,0,"governing party, facing challenge, move left south africa"
0,1,2,34,0,5,0,36,0,camel sacrificed major turkish airport
0,1,4,31,0,5,0,35,0,cargo vessel grounded south gibraltar
0,2,2,49,1,9,4,51,0,private space station coming soon? company aiming 2020 launch
0,3,1,67,3,9,0,68,0,court dismisses lawsuit student distressed school transgender policy
0,2,9,44,1,9,0,53,0,dallas police attack: suspect killed shot sniper
0,3,2,73,3,16,5,75,0,750 people killed 78 terror attack donald trump claim went 'under reported' full detail
0,3,13,39,0,12,0,52,0,mike myers jimmy fallon dance bring joy world
0,2,5,45,1,8,0,50,0,"picking tim kaine, hillary clinton missed opportunity"
0,3,7,23,3,6,0,30,0,zsa zsa gabor best one liner [video]
0,1,10,46,1,10,0,56,0,iraqi leader kurd reach oil deal; pelosi make surprise visit
0,1,7,34,0,7,0,41,0,treasury set procedure sell bank warrant
0,2,3,56,1,7,0,59,0,unbelievable number behind russell westbrook's historic season
0,1,6,52,0,9,0,58,0,fred thompson make presidential announcement tonight show
0,3,8,46,0,9,0,54,0,trump inherits secret cyberwar north korean missile
0,3,6,56,0,11,0,62,0,british pm theresa may call early election strengthen brexit hand
0,1,3,27,1,6,0,30,0,"deadly crash dayton, ohio air show"
0,1,2,58,0,11,0,60,0,new zealand minister call ban using mobile phone driving
0,2,3,31,1,8,7,34,0,elaine thompson win womens 100m gold rio 2016
0,2,4,62,5,11,2,66,0,"braylon beam, 6-year-old cancer patient, sign 1-day deal coach carolina panther"
0,2,3,50,0,8,0,53,0,video show moment fort lauderdale airport gunman opened fire
0,1,3,47,0,7,0,50,0,venezuela ban coke zero unspecified health problem
0,3,3,70,5,11,0,73,0,donald trump: green card holder subject 'case-by-case' approach immigration ban
0,1,7,26,1,8,2,33,0,mcclatchy plan cut 15% work force
0,2,3,52,0,10,0,55,0,french left stake hope manuel valls presidential race
0,2,3,59,2,13,0,62,0,trump let syrian refugee in. feel sorry them.
0,2,2,72,0,14,2,74,0,doomsdayclock move 30 second closer midnight threat global annihilation grows
0,1,2,46,0,6,0,48,0,australian drug regulator requires warning zolpidem
0,1,3,85,4,16,0,88,0,expert raise serious question safety u.s. oil industry warn another spill may 'unavoidable'
0,2,8,49,3,10,1,57,0,lyft pledge $1 million aclu donation response trump's #muslimban
0,1,5,26,0,7,0,31,0,baghdad shaken series bomb
0,2,3,42,0,8,1,45,0,video show lake tahoe bear approaching 2 little girl
0,1,6,31,0,6,0,37,0,dulko sends sharapova another early exit
0,3,9,38,1,10,0,47,0,"germany, trump pose problem clear solution"
0,1,2,27,0,4,0,29,0,home stonehenge builder found
0,2,9,39,0,9,0,48,0,trump cite voter fraud nh without providing evidence
0,1,5,59,2,8,0,64,0,australia's queensland roar a-league football preliminary final
0,1,10,45,2,12,0,55,0,"first lady, ivory vivid yellow, tell story fashion"
0,3,8,45,0,7,0,53,0,federal judge block texas defunding planned parenthood
0,1,10,28,0,8,1,38,0,fia chief say deal reached prevent f1 split
0,1,6,30,1,6,0,36,0,someone please invent itunes news?
0,2,6,64,2,12,0,70,0,rod culleton's election invalid: high court order special recount wa senate vote
0,3,2,40,1,6,0,42,0,tech company condemn trump's revised travel ban
0,1,10,37,3,9,0,47,0,two n.h.l. youngster giving islander reason hope
0,1,3,44,0,7,0,47,0,gilad shalit exchanged palestinian prisoner
0,1,2,33,0,6,0,35,0,food package vesta occupier cut
0,2,4,47,1,9,0,51,0,sit back let #noballchallenge take timeline
0,2,6,44,3,7,0,50,0,predictions: win anthony joshua vs. wladimir klitschko?
0,2,1,42,0,12,0,43,0,tiny pig wake nap try first ice cream
0,3,4,58,1,12,0,62,0,senate dems continue fight see trump's tax return house setback
0,3,10,47,4,10,0,57,0,"here's peek disney's first marvel-themed ride, iron man experience"
0,3,4,54,3,12,0,58,0,guy ritchie's sense style final 'king arthur' trailer
0,2,7,53,3,12,3,60,0,trump's america donald trump: american rate president 100 day in?
0,2,3,45,0,9,0,48,0,paul say finished drafting bill replace obamacare
0,1,5,29,0,6,0,34,0,u uk diplomat detained zimbabwe
0,3,4,38,1,9,0,42,0,pope poster i: francis find everyone love
0,1,2,37,0,6,0,39,0,eight teen shot outside indiana skating rink
0,3,2,66,1,10,0,68,0,spanish woman given jail term tweeting joke franco-era assassination
0,1,5,36,2,10,0,41,0,last raiser first u.s. flag iwo jima dy
0,2,12,62,4,12,0,74,0,princeton suspends men's swim team 'vulgar offensive' comment women's team
0,2,3,48,2,7,0,51,0,billionaire green donor launch u.s. millennial voter drive
0,3,12,54,3,11,0,66,0,merkel finally confesses: doubt asylum seeker terrorist
0,1,8,47,1,11,0,55,0,"siberia, death knell complex holding deadly stockpile"
0,1,4,73,2,12,0,77,0,"united church christ endorses same-sex marriage, largest christian denomination"
0,1,1,36,0,5,0,37,0,samsung release first tablet computer
0,3,11,60,1,12,0,71,0,steph curry appears eye-popping ad promote mental health wellness campaign
0,3,5,47,3,9,0,52,0,disney face 'star wars'-size dilemma loss carrie fisher
0,2,9,30,4,7,0,39,0,pete wentz d.i.y.-inspired art collection
0,2,5,46,3,9,0,51,0,'fearless girl' stare wall street bull forever?
0,2,6,34,0,9,2,40,0,removing trump via 25th amendment bad idea
0,3,9,33,4,7,0,42,0,hate group u.s. flourishing [infographic]
0,2,4,84,1,17,0,88,0,donald trump sign new travel ban expected remove iraq list barred muslim-majority country
0,3,10,56,2,9,0,66,0,"darjeeling's iconic toy train derails journey, eleven tourist injured"
0,3,5,24,0,5,0,29,0,target plunge eight year
0,3,9,16,1,9,6,25,0,18 ya book cant wait read in2017
0,2,3,60,1,12,0,63,0,white house genius plan pas infrastructure bill really silly
0,1,4,45,0,8,4,49,0,technology innovation unveiled research intel day 2008
0,2,3,38,2,8,2,41,0,woolworth sell fuel business bp nearly $1.8b
0,3,9,40,1,10,0,49,0,booth made talking: soothers hit street
0,3,7,21,2,6,0,28,0,a-rod take j-lo ballgame
0,2,2,39,1,10,2,41,0,28-day limit police bail come force uk
0,3,9,36,0,9,2,45,0,25 best comedy movie streaming netflix right
0,2,4,41,3,11,6,45,0,48-team world cup work? fifas plan 2026 explained
0,1,9,35,2,9,0,44,0,ellen m. iseman: finding new home yankee stadium
0,2,6,54,2,10,0,60,0,national portrait gallery unveiled witty picture donald trump
0,2,4,38,0,7,0,42,0,meet fugitive u terrorist sheltered bycuba
0,2,8,40,2,8,0,48,0,"down, boy! val kilmer unabashedly creep cate blanchett"
0,1,2,22,0,5,0,24,0,france warns war iran
0,3,13,52,2,11,0,65,0,trump's pick army secretary troubling history anti-muslim remark
0,2,1,37,1,8,4,38,0,earth's temperature dip still sizzle 2017
0,1,2,26,0,6,0,28,0,world cup worker walk job
0,2,3,85,2,14,0,88,0,alex salmond suggests critic 'behave woman' comment understand scottish language
0,3,9,47,3,10,0,56,0,rise china: beijing unveils new aircraft carrier much fanfare
0,2,10,52,3,9,0,62,0,"democrat spar party leadership, anti-trump tactic washington wire"
0,2,4,59,2,14,3,63,0,new airline british airways' parent company fly europe $149
0,3,2,56,1,8,0,58,0,trump's border wall face another challenge indian reservation
0,2,16,63,4,15,0,79,0,"pinkerton: trump nation, fox nation: fox news roger ailes bill oreilly"
0,3,10,60,5,9,0,70,0,prepare erika jayne's 'xxpensive' video exclusive behind-the-scenes footage
0,2,12,42,2,8,0,54,0,outfront: hiv-positive counselor share story help others
0,3,9,31,6,11,2,40,0,"norma mccorvey, 'jane roe' 'roe v wade' case, dy 69"
0,1,6,32,0,6,0,38,0,green coalition gather strength europe
0,1,2,67,1,11,0,69,0,australian rule football: traralgon get game back ladder shake around middle
0,1,9,46,0,11,0,55,0,british newspaper say caught lord offering lobby fee
0,3,15,49,4,14,0,64,0,"remember ""felon bae""? well, walked first new york fashion weekshow"
0,2,3,36,0,8,0,39,0,bill gate say robot taxed list
0,2,4,55,1,8,0,59,0,journalist honor free press correspondent dinner withouttrump
0,3,7,44,0,6,0,51,0,democratic party election reveal growing populist energy
0,1,8,29,1,7,0,37,0,"state secrets, obama sounding like bush"
0,1,10,43,1,9,0,53,0,danish clothing company sell t-shirt support farc pflp
0,3,13,45,8,11,0,58,0,look inside donald trump mar-a-lago: new winter white house [video]
0,1,8,42,0,10,0,50,0,tour de france official team impasse radio ban
0,1,3,41,1,7,0,44,0,f-secure detects security flaw sony memory stick
0,1,1,35,0,7,0,36,0,hope treaty climate begin wither
0,3,2,35,2,6,0,37,0,defense ghosting: nothing personal
0,1,3,43,1,6,0,46,0,fbi detail chief justice's prescription drug trouble
0,2,8,44,0,11,1,52,0,tim tebow hit 2nd home run season columbia firefly
0,2,10,25,1,7,4,35,0,coca-cola ceo muhtar kent stepping 2017
0,3,2,61,0,12,0,63,0,europe hold breath italy head poll critical referendum
0,2,9,47,1,9,0,56,0,prison worker joyce mitchell planned getaway driver: source
0,3,10,41,0,11,0,51,0,etf investor miss best commodity trade year
0,1,1,23,0,3,0,24,0,zimbabwean unity talk fail
0,1,5,42,1,6,0,47,0,russian spacecraft phobos-grunt fall pacific ocean
0,3,3,39,1,6,0,42,0,nunes step russia-trump investigation
0,1,7,71,1,11,0,78,0,western star win women's national wheelchair basketball league championship thriller
0,3,17,56,1,15,0,73,0,"gaikwad fly again, sc notice government gau rakshaks must read story"
0,2,3,45,0,10,0,48,0,syria troop make gain aleppo help russia
0,2,7,57,4,10,0,64,0,seth meyers slam gop 'power grab' north carolina's governor-elect
0,3,2,36,1,6,0,38,0,trump hold campaign-style rally florida
0,1,4,53,0,8,0,57,0,poll predicts another liberal party minority government canada
0,1,3,31,1,6,4,34,0,beijing 2008: michael phelps win eighth gold
0,3,2,46,2,9,0,48,0,indiana mum 'bit beat son opening christmas gifts'
0,1,2,70,1,8,0,72,0,wikinews interview american zoologist pirate perches' chemical camouflage
0,3,8,51,5,8,0,59,0,franken call independent investigation trump putin crush
0,3,9,22,1,7,1,31,0,9 best gifs today appleevent
0,2,6,50,0,9,0,56,0,cctv capture final movement british backpacker killed goa
0,1,1,51,0,7,0,52,0,broadband user kicked service constant questioning
0,2,7,44,1,7,0,51,0,trayvon martin parent float potential future politics
0,1,8,32,2,7,0,40,0,u.s. unit secretly pakistan lends ally support
0,1,1,24,0,4,0,25,0,japan use renewable energy
0,3,2,55,4,10,1,57,0,"cesare, 3-year-old italian sheepdog, dy rescue house fire"
0,1,1,38,0,5,0,39,0,greek worker strike austerity measure
0,1,8,28,2,10,3,36,0,no. 7 blue devil top no. 13 lady vols knoxville
0,2,7,52,2,12,2,59,0,david bowie: surprise ep plan released mark late star's 70th birthday
0,3,16,73,6,17,0,89,0,one direction songwriter piano guys' 'what make beautiful' cover inaugural ball: 'breaks heart'
0,3,1,74,3,13,0,75,0,"alleged rape drunken undergraduate typical 'world modern students', court hears"
0,1,2,31,0,3,0,33,0,prominent iranian judge assassinated
0,3,4,67,4,15,1,71,0,"lg's new g6 flagship smartphone company's best yet, i'm hesitant recommend"
0,2,18,51,3,14,0,69,0,details: utah man killed london attack 'dream vacation' wife insider
0,3,8,39,1,8,0,47,0,republican health care vote: everything need know
0,2,7,36,0,8,0,43,0,fifty year freshman career plan four chart
0,3,11,52,4,15,0,63,0,"woman donate kidney complete stranger: 'god good, this' insider"
0,1,4,54,1,9,0,58,0,u presidential candidate barack obama's lead poll increase
0,1,4,25,0,4,0,29,0,mauresmo advance indian well
0,3,2,44,1,9,0,46,0,turner prize failing engage politics?
0,1,6,37,1,7,0,43,0,justice dept. seek equity sentence cocaine
0,2,2,35,2,8,0,37,0,woman science share message: give
0,1,8,36,3,7,0,44,0,interrogation memo detail harsh tactic c.i.a.
0,2,5,61,8,11,0,66,0,paul ryan greets new congress: once-in-a-lifetime opportunity [video]
0,1,5,42,0,7,0,47,0,wolfgang tilmans donates image quaker social action
0,3,9,51,4,12,0,60,0,"trump mar-a-lago facebook, national security crisis open"
0,1,5,40,0,8,0,45,0,nasa prepares roll orbiter discovery launch pad
0,1,10,45,0,9,0,55,0,florida pharmacy admits error might killed polo pony
0,3,3,55,0,10,0,58,0,alexis tsipras hint greece nearing compromise deal debt
0,3,2,54,1,9,0,56,0,starbucks offer employee free legal advice trump's travel ban
0,2,6,61,3,14,0,67,0,"this, that: white house plan work hillary clinton campaign"
0,3,9,40,2,8,0,49,0,girl autism sings stunning rendition 'hallelujah'
0,3,2,45,0,9,2,47,0,massive firework market blast kill least 29 mexico
0,1,2,33,0,7,0,35,0,one hundred die madrid plane crash
0,2,10,34,0,9,4,44,0,swatch ceo nick hayek see swiss watch turnaround 2017
0,1,6,8,2,4,5,14,0,"uefa cup: april 3rd, 2008"
0,2,1,60,0,10,0,61,0,watch monster machine cut manhole road ridiculous ease
0,3,3,46,3,8,0,49,0,"farewell, obama urge american escape bubble"
0,2,7,71,2,16,0,78,0,north korea say recent malaysia 'incident' political scheme u south korea
0,3,10,37,0,8,0,47,0,turkey arrest hundred sweeping raid isi
0,3,4,49,1,8,0,53,0,brexit: australia eye relaxed uk immigration trade deal
0,2,10,49,1,13,0,59,0,police raid marine le pen's front national party hq eu fake job probe
0,1,6,29,2,7,4,35,0,"strong profit, ericsson plan 5,000 job cut"
0,1,3,50,0,7,0,53,0,european commission might impose embargo chinese product
0,1,7,31,0,7,0,38,0,ant adjust foraging colony eats right
0,2,1,13,0,2,0,14,0,winter coming
0,1,9,47,0,10,0,56,0,pink worn crowne plaza invitational support amy mickelson
0,3,13,45,0,12,0,58,0,mma nate diaz say get boxing license california nevada
0,3,10,31,3,7,4,41,0,2017 nfl draft: predicting year's draft-day slide
0,1,6,37,0,8,0,43,0,toll may needed nsw pacific highway upgrade
0,3,8,81,0,15,0,89,0,turkish president tayyip erdogan claim concrete documentary proof west backing isi
0,1,5,31,1,10,0,36,0,bp: new cap gulf mexico oil well place
0,2,2,67,0,14,0,69,0,man forcibly removed united flight went hospital injury
0,3,6,51,7,11,1,57,0,"forbes periscope: "".@stevecase chat @alexrkonrad day 4 #sxsw"""
0,2,2,61,2,8,0,63,0,"fired reporter accused threatening jewish centers, cyber-stalking"
0,1,9,41,1,11,0,50,0,"many plan curtail use plastic bags, much action"
0,1,2,38,0,7,0,40,0,one dead small plane crash near phoenix
0,2,6,45,0,9,0,51,0,president donald trump complained cia medium
0,3,3,44,1,9,4,47,0,"israel plan 2,500 new settlement home occupied west bank"
0,3,4,52,0,13,0,56,0,news feed mess facebook giving another one
0,2,9,42,1,9,0,51,0,"amid patchwork eu laws, migrant scramble cross border"
0,1,6,32,1,7,2,38,0,video game publisher lost $10 million quarter
0,2,5,42,2,8,0,47,0,hoosiers' kevin wilson resigns; tom allen named new coach
0,1,2,49,0,5,0,51,0,hillary clinton form presidential exploratory committee
0,2,4,20,0,4,0,24,0,closing abortion right
0,1,3,26,2,7,2,29,0,13 killed u.s. air strike pakistan
0,2,14,60,4,14,0,74,0,"robert gibbs: wasnt racism, hillary lost economic message breitbart"
0,2,13,66,0,13,1,79,0,6 pilot grounded allegation delaying landing flight carrying mamata banerjee
0,1,2,21,0,3,0,23,0,violence iran increase
0,3,7,33,5,7,4,40,0,justin bieber's 'sorry' top vevo's most-watched 2016
0,3,8,38,1,8,0,46,0,judge fatally shot outside home chicago south side
0,1,6,23,0,7,0,29,0,gold holding tough season
0,1,2,40,1,7,0,42,0,socialist win second term spain's ruling party
0,3,14,59,5,14,4,73,0,"stephen colbert, michael stipe, james franco bid farewell 2016 perfect r.e.m. parody"
0,1,1,27,1,5,1,28,0,rudd heckled 5% climate target
0,1,5,34,1,6,4,39,0,united soccer league 2008: whitecap sign pozniak
0,2,7,40,0,6,0,47,0,yahoo outline leadership plan following verizon deal
0,2,13,52,2,12,0,65,0,draymond green said happy hear lebron james 'destroy charles barkley'
0,2,6,39,1,6,0,45,0,"man viciously kills, dismembers parent tennessee"
0,2,15,65,4,14,0,80,0,"michael slager, cop killed walter scott, convicted black life dont matter"
0,1,7,31,1,6,0,38,0,"indian growth soars, child hunger persists"
0,2,16,54,0,15,0,70,0,entire family bear died church parking lot eating poisonousplant
0,2,2,45,3,5,0,47,0,norway institution 'targeted russia-linked hackers'
0,3,2,80,2,14,0,82,0,duchess cambridge admits suffers lack confidence pressure 'perfect parent'
0,2,16,53,4,15,0,69,0,taya kyle: backlash trump's seal widow tribute 'makes sick stomach' insider
0,1,2,12,0,2,0,14,0,unrest belize
0,3,10,43,1,9,0,53,0,chris pratt stop cropping jennifer lawrence photo
0,1,6,39,1,6,0,45,0,wheelchair rugby tri-nations series begin sydney
0,3,2,47,1,10,1,49,0,drinking 3 cup coffee daily help prevent alzheimer's
0,1,4,48,0,9,0,52,0,hotel quarantined anthrax scare u state michigan
0,2,4,48,4,9,2,52,0,china anbang acquire strategic hotel $6.5 billion: source
0,3,4,46,1,12,0,50,0,lakers get here? inside story bus drama
0,1,6,32,0,6,0,38,0,china shuts office volunteer lawyer
0,3,2,58,1,10,0,60,0,top alzheimer's researcher explains help protect brain
0,1,6,31,0,8,1,37,0,suit name 2 judge accused kickback case
0,1,7,31,0,6,0,38,0,exeem annonunced successor suprnova
0,1,1,53,0,8,0,54,0,cancer trial patient dy hospital computer system error
0,2,8,49,1,9,0,57,0,security heightened time square new year's eve celebration
0,2,8,43,3,7,0,51,0,'handmaid's tale' waitlists surge library across america
0,3,1,52,4,6,4,53,0,"3,000-year-old nobleman's tomb discovered egyptian archeologist"
0,3,6,72,2,13,0,78,0,"mike penny arrives south korea, attends wreath-laying ceremony easter sunday service"
0,1,3,33,0,6,0,36,0,western new york prepares winter storm
0,1,5,59,1,11,0,64,0,british national party loses seat barking dagenham election
0,2,3,22,1,6,0,25,0,"new trump, old trump"
0,1,2,59,1,8,0,61,0,indonesian court overturn garuda pilot's conviction air disaster
0,3,5,32,1,5,0,37,0,europe missed private equity opportunity
0,3,6,68,1,11,0,74,0,kylie jenner went christina aguilera's birthday party dressed christina aguilera
0,3,3,45,0,7,0,48,0,boy scout america welcome first transgender member
0,2,5,56,2,11,0,61,0,"meet lilou, san francisco airport's first therapy pig stressed flier"
0,2,2,35,0,8,0,37,0,winter life cold canadian island
0,3,1,58,1,15,5,59,0,"apply look 37,000 puffin baby seal remote island"
0,3,5,56,2,11,0,61,0,bank england admits 'michael fish' moment dire brexit prediction
0,1,11,33,4,9,1,44,0,a.i.g. chief owns goldman stake worth $3 million
0,1,7,31,0,6,0,38,0,pork industry fight concern swine flu
0,2,2,51,1,11,4,53,0,"south korea take lead life expectancy 2030, study predicts"
0,2,2,47,2,11,1,49,0,record sale gin britain knock back 1 billion g&t's
0,2,2,72,0,15,0,74,0,david cassidy say dementia day appearing fall stage concert
0,2,1,47,0,9,4,48,0,celebrity death 2016 captured one heartbreaking photo
0,2,2,47,0,9,0,49,0,assisted suicide murky business new lifetimedrama
0,2,3,43,0,8,0,46,0,penny say gorsuch would worthy successor scalia
0,3,2,63,2,13,0,65,0,george michael worked 'homeless shelter' asked people keep secret
0,2,13,44,0,12,0,57,0,val kilmer unexpected twitter god need follow right
0,1,7,35,0,9,1,42,0,round 1 ticket holder get rain check refund
0,2,16,69,6,15,0,85,0,"atlantic ball: fbi docs, speech transcript play right voter distrust hillary breitbart"
0,2,12,43,1,12,1,55,0,no. 1 danger virtual reality gaming nobody want talk
0,1,2,55,1,10,0,57,0,"dow jones recovers hundred points, losing minute"
0,3,6,33,1,9,4,39,0,b-2 bomber kill nearly 100 isi terrorist libya
0,3,15,63,1,15,0,78,0,"tony romo literally retired, already comeback rumor count"
0,2,8,35,1,8,4,43,0,europe: perhaps best destination capital 2017
0,2,9,41,1,9,0,50,0,indiana town big bet international business pay
0,1,13,52,2,11,0,65,0,"dna test prove michigan man, searching origins, kidnapped toddler"
0,2,15,66,2,15,1,81,0,"marvel ceo ike perlmutter blasted $1m donation trump vet fundraiser, salon call boycott"
0,3,10,42,1,10,3,52,0,twitter want stream live video programming 24/7 first goal
0,3,6,37,0,8,0,43,0,investor gird busy week potential whipsaw
0,2,12,42,0,11,0,54,0,dive instructor save shark large knife wedged head
0,1,7,37,5,9,1,44,0,apple's itunes replaces wal-mart no. 1 u.s. music seller
0,2,3,71,3,20,0,74,0,janice dean: always read fine print -- last two month real pain neck
0,1,2,46,1,7,0,48,0,"nothing honourable honour killings, say indian court"
0,3,4,42,0,7,0,46,0,bill hillary clinton attend trump inauguration
0,1,8,35,0,6,0,43,0,blogger create pac recruit liberal candidate
0,3,10,49,2,9,0,59,0,international college student leery trump could cost u.s. billion
0,1,5,32,0,6,4,37,0,russia win junior eurovision song contest 2006
0,1,3,35,0,8,0,38,0,two people die bus crash north yorkshire
0,2,13,49,2,9,0,62,0,gop rep. proposes bill criminalizing transgender people restroom use
0,3,11,64,2,13,0,75,0,report claim russia considering extraditing edward snowden 'gift' donald trump
0,3,5,58,0,11,0,63,0,ian hislop furiously take government southern rail list
0,3,3,26,1,4,0,29,0,newt gingrich: trumpism explained
0,2,5,40,4,8,0,45,0,trump tell abe: us-japan tie 'cornerstone peace'
0,1,3,57,2,8,0,60,0,"native hawaiian blockade historic palace restore ""hawaiian nation"""
0,2,6,32,1,8,2,38,0,church bombing north egypt's capital kill 21
0,2,6,32,1,6,0,38,0,obama america version stanley baldwin
0,1,7,33,0,6,0,40,0,stock rise goldman post solid earnings
0,1,6,78,4,12,0,84,0,u.s. coast guard investigation find 'poor safety culture' contributed deepwater horizon disaster
0,2,7,46,0,8,0,53,0,louisiana lawmaker advance bill abolish death penalty
0,1,4,77,1,13,0,81,0,"person punta arenas, chile strike government announcement increase gas price"
0,2,7,33,2,6,4,40,0,2015 women's world cup prediction fivethirtyeight
0,3,2,61,4,9,0,63,0,"woman ""videobombed"" bright fireball live-stream calif. backyard"
0,2,9,50,1,12,0,59,0,health care front center democrat response trump address
0,2,14,47,3,10,0,61,0,apple finally building dual-sim iphone? filing suggest possible
0,1,2,30,0,7,0,32,0,new cave open public indiana
0,1,2,15,2,5,5,17,0,"sam's club cut 11,000 job"
0,3,1,56,0,11,0,57,0,trump admin ordered produce list traveler detained ban
0,1,7,26,0,7,0,33,0,jump food cost drive price index
0,2,6,51,1,10,0,57,0,"apple lawyer, fbi director face congress iphone encryption"
0,2,4,61,0,9,0,65,0,russian opposition leader alexei navalny win european human right payout
0,2,4,33,1,5,0,37,0,gigapixel: inauguration donald trump
0,2,4,46,3,9,0,50,0,england v new zealand: morgan hail 'close perfect' display
0,2,2,30,1,4,0,32,0,"cruz revers himself, endorses trump"
0,2,2,49,0,8,0,51,0,trump administration say iran complying nuclear deal
0,1,2,59,1,10,0,61,0,"ten confirmed dead, score missing overcrowded boat capsizes india"
0,3,5,34,0,7,1,39,0,germany arrest 2 syrian terrorism charge
0,2,5,62,2,10,0,67,0,israel threatens give trump 'evidence' obama orchestrated un resolution
0,2,7,33,4,10,7,40,0,"mom spends $2,000 nearly 300 present kid [video]"
0,1,3,29,0,3,0,32,0,iceland nationalises kaupthing bank
0,3,6,49,1,10,0,55,0,"ncaa ignores baylor rape scandal, deserves death penalty"
0,2,2,63,3,16,5,65,0,"dow closed 20,000 first time ever big landmark"
0,2,10,44,2,8,0,54,0,"trump defeats, muni bond see record-setting winning streak"
0,1,7,42,0,8,0,49,0,maine senator collins snowe gain backing stimulus
0,3,7,33,1,7,3,40,0,nearly 100 tech company oppose trump's muslim ban
0,3,12,64,5,12,0,76,0,trump african-american history museum denounces anti-semitism racism: stop
0,2,5,22,2,4,0,27,0,world longest rail tunnel
0,3,1,26,0,5,0,27,0,life insurer get new lifeline
0,2,0,64,4,12,3,64,0,"100 per cent renewable energy network affordable, secure 'off shelf': study"
0,1,8,56,5,12,0,64,0,"store drop game ""grand theft auto: san andreas"" given 'adults only' rating"
0,3,8,48,0,8,0,56,0,trump sign another executive order slash regulation
0,3,10,45,0,9,0,55,0,poor venezuelan parent give away child amid deep crisis
0,3,5,30,2,5,0,35,0,netflix's algorithm binge-worthy
0,2,11,54,1,13,0,65,0,homeless woman accused slashing mother face nyc subway breitbart
0,1,8,34,2,8,0,42,0,"nice, staid corner real estate: medical office"
0,3,2,60,1,9,0,62,0,ukip leader denies responsibility website hillsborough claim video
0,3,5,32,2,7,0,37,0,filming underway han solo star war film
0,1,6,28,0,6,0,34,0,zagat help bring rating health care
0,1,2,58,0,11,0,60,0,fire tomb uganda result clash protestors police
0,3,11,45,1,10,0,56,0,"soon, government decide much eat restaurant"
0,1,9,25,4,7,2,34,0,poland get $20 billion credit line i.m.f.
0,3,11,38,0,10,0,49,0,tomi lahren tried clap back wale failed miserably
0,2,12,48,6,11,0,60,0,trump flip-flopped. supporter upset noticed.
0,2,9,44,2,10,0,53,0,"""nj weedman"" raided swat team streaming facebook live"
0,3,11,46,2,10,0,57,0,lesson #deleteuber: working trump business minefield
0,3,5,47,0,10,0,52,0,stephen curry pass kobe bryant top jersey sale china
0,2,3,64,2,14,0,67,0,"tennessee delta, poor community loses hospital sense security"
0,1,10,37,1,11,0,47,0,want run new york city marathon? get checkbook
0,1,6,40,0,7,0,46,0,judd gregg withdraws u commerce secretary nominee
0,1,7,35,2,9,0,42,0,"brady show off, show rust, camera"
0,1,7,40,1,9,0,47,0,"lance armstrong, plodding return scorching day"
0,2,2,40,2,7,0,42,0,clinton mistakenly refers trump husband
0,3,1,51,1,11,0,52,0,congress verge deal avoid government shutdown
0,3,12,55,1,11,0,67,0,rumour surface kanye west surprise project rebooted saint pablo tour
0,2,4,81,4,14,0,85,0,"richard spencer call depeche mode 'the official band alt-right', band immediately denounces"
0,2,9,56,1,10,0,65,0,sweet briar college closing temporarily blocked virginia supreme court
0,2,2,46,2,7,0,48,0,"rare, hardly unprecedented: history veto override"
0,1,5,31,1,4,0,36,0,decoding battery-life number laptop
0,1,4,49,0,7,0,53,0,national academy science recommends manned hubble repair
0,2,2,60,0,12,0,62,0,chaffetz call ethic head testify day chief criticized trump
0,1,2,43,0,8,2,45,0,spectator killed 10 injured german airshow crash
0,3,4,38,1,6,0,42,0,bill oreilly becomes spokesman white america
0,3,8,40,3,9,2,48,0,"brexit talk could stretch 10 years, british official warns"
0,2,1,21,0,2,0,22,0,aleppo bombardment
0,1,3,61,3,8,0,64,0,'unfounded unsubstantiated': london policeman cleared beating muslim
0,3,9,40,5,10,4,49,0,"2015 nba playoff -- cleveland cavaliers, j.r. smith need"
0,1,2,77,1,11,0,79,0,uk scientist discover multiple antibiotic used fungus-farming ant protect colony
0,3,7,41,4,9,2,48,0,"dunkin' donut slaying suspect among fbi's ""10 wanted"""
0,2,11,48,2,13,2,59,0,"john carroll, editor reinvigorated los angeles times, dead 73"
0,1,1,52,0,8,0,53,0,australian man arrested dragging dead possum behind car
0,2,2,40,2,7,0,42,0,swedish gay sailor deployed deter russian sub
0,1,3,39,0,6,0,42,0,hubble space telescope running two gyroscope
0,1,4,28,0,6,0,32,0,breakthrough wto trade talk
0,3,16,52,0,15,0,68,0,afghan boy made lionel messi jersey plastic bag finally meet hero
0,1,7,45,0,10,0,52,0,soldier madagascar occupy vacant palace show force
0,3,11,41,4,13,1,52,0,here walking dead save whats left trash season 7
0,3,3,44,2,10,0,47,0,'the silence lambs' oddly work romantic comedy
0,3,8,33,0,8,2,41,0,21 really cute tattoo perfect couple
0,2,5,30,0,4,0,35,0,banning book marginalizes child
0,3,14,47,5,12,0,61,0,emmanuel macron: knight whose job slay france far-right party
0,1,6,29,0,5,0,35,0,mass grave found bangladesh mutiny
0,2,1,71,0,15,0,72,0,recovering heroin addict explains many people fail rehab day
0,3,8,39,1,8,1,47,0,2 flint ex-emergency manager charged tainted water
0,2,2,48,0,8,0,50,0,manus island asylum seeker charged raping local woman
0,1,6,32,1,6,0,38,0,"climate bill clear hurdle, others remain"
0,1,8,23,2,7,0,31,0,u.s. tied czech republic fed cup
0,3,8,33,2,8,0,41,0,shootin: rise big man three-pointer
0,2,1,37,1,8,0,38,0,here's long various drug stay body
0,3,8,44,0,7,0,52,0,visium star witness taped gottlieb working undercover
0,1,2,46,0,7,0,48,0,unidentified plane reportedly shot kodori gorge
0,2,3,54,2,11,0,57,0,mika brzezinski say clinton campaign wanted 'pulled air'
0,3,4,61,1,11,0,65,0,government's childcare reform pas senate must return lower house
0,3,2,40,1,7,0,42,0,grantas list best young american novelist
0,2,2,51,3,10,0,53,0,"missing nottingham mother pose 'risk harm' sons, court say"
0,3,4,46,2,9,0,50,0,"hacked again, sony tweet false news britney spears' death"
0,3,11,55,1,11,0,66,0,karl-anthony town transforming superstar right eye
0,3,5,41,1,8,0,46,0,george w. bush explains fondness michelle obama
0,3,5,35,0,7,0,40,0,henri van breda denies south africa axe murder
0,3,5,82,3,15,2,87,0,"here's elon musk, richard branson, 29 successful people ask job candidate interview"
0,1,4,32,1,9,2,36,0,"40 year on, reflection sliver moon"
0,1,2,26,0,5,0,28,0,bomb blast uganda kill dozen
0,3,1,36,2,8,4,37,0,"hatchimals, hit toy 2016, unveils brand new look"
0,2,9,42,3,11,2,51,0,"barbara hale, played perry mason loyal secretary, dy 94"
0,2,3,56,1,10,0,59,0,student make ridiculous twitter bet free wendys chicken nugget
0,3,2,29,2,8,0,31,0,iraq edge trump 'keep oil' talk
0,2,2,50,2,8,0,52,0,exclusive: bayer explores sale radiology business source
0,2,12,58,5,15,0,70,0,sen. liz warren refuse disavow madonna wish blow white house breitbart
0,1,2,31,0,6,2,33,0,explosion injures least 14 colorado
0,1,1,49,0,7,0,50,0,homeopathy proponent jailed allowing daughter die
0,3,2,48,2,8,1,50,0,police investigating death 3yo girl sydney's north-west
0,3,2,50,0,9,0,52,0,blasphemy charge create climate fear pakistani medium
0,1,4,26,0,5,0,30,0,george bush meet gordon brown
0,3,5,54,3,12,4,59,0,u-va. president teresa a. sullivan announces step summer 2018
0,3,6,34,2,8,0,40,0,dick van dyke 'joins cast mary poppins returns'
0,1,2,51,0,6,0,53,0,london underground train derails leaving passenger trapped
0,1,2,46,0,5,0,48,0,automobile manufacturer ford post unexpected profit
0,1,7,31,2,6,0,38,0,obama (as tv salesman) push home refinancing
0,2,1,56,1,8,0,57,0,sniper bizarre reaction terrorist bullet barely missesher
0,3,10,62,4,9,0,72,0,jason chaffetz: kellyanne conway promoting ivanka trump's product 'unacceptable'
0,3,4,75,3,16,0,79,0,mark hamill shared 'perhaps first' photo luke skywalker real nostalgia trip
0,2,4,24,0,5,0,28,0,chance rapper need intern
0,3,5,62,3,13,0,67,0,marine le pen's bodyguard top aide questioned eu 'fake jobs' investigation
0,3,7,32,2,9,0,39,0,"amex, challenged chase, losing snob war"
0,1,6,30,0,7,0,36,0,first lady control building image
0,1,3,50,1,9,0,53,0,"scotland yard say suicide bomb blast killed bhutto, bullet"
0,3,2,36,1,6,0,38,0,hoda kotb explains meaning daughter name
0,1,6,32,0,8,0,38,0,woman horseback find friend road
0,1,6,31,1,5,0,37,0,world cup without superstars? unthinkable
0,2,5,49,0,9,0,54,0,hawk gm wes wilcox apologizes making racially charged joke
0,1,2,36,1,5,2,38,0,6.4 magnitude earthquake rock andaman island
0,1,2,54,0,7,0,56,0,moldovan premier invite romanian counterpart pipeline start
0,3,10,59,0,9,0,69,0,trump white house counselor kellyanne conway promise traditional press access
0,3,12,47,2,11,0,59,0,richard branson say never see 'big business'
0,2,11,39,3,10,0,50,0,time manage expectation bit 'horizon zero dawn'
0,1,2,45,2,6,0,47,0,"uk television presenter sacked ""golliwog"" comment"
0,3,9,52,4,10,4,61,0,"beyonce, chainsmokers, drake top instagram's 2017 grammy prediction"
0,3,11,48,3,12,4,59,0,"myles garrett texas a&m pro day 2017: photos, video highlight reaction"
0,3,15,62,0,15,0,77,0,florida man allegedly kill woman sex corpse rebuff advance
0,2,6,31,0,7,0,37,0,ciara russell wilson welcome baby girl
0,3,2,43,1,10,4,45,0,mcdonald's best year sale growth since 2011
0,3,10,46,1,11,0,56,0,car talking one another? could proposed safety rule
0,2,15,60,1,14,0,75,0,emmanuel macron marine le pen set win first round france presidential election
0,2,3,64,1,10,0,67,0,sanderss convoluted claim democrat trying filibuster gorsuch
0,1,2,43,2,9,5,45,0,canada announces $9 billion plan purchase 65 f-35 fighter
0,1,4,34,2,7,0,38,0,low morale reported among u.s. soldier iraq
0,2,12,52,2,11,0,64,0,federal worker union slam trump climate order 'assault' public health
0,3,9,38,1,8,0,47,0,"pepsico want sell healthy food, consumer want chip"
0,1,7,33,0,8,0,40,0,eni sell gas operation italian grid owner
0,2,4,61,2,12,0,65,0,country music star maddie tae rally behind dead texas duck hunters' family
0,2,3,47,1,7,0,50,0,exxon's tillerson retiring prep senate confirmation
0,1,4,51,0,9,4,55,0,heavy metal band tersbetoni represent finland eurovision 2008
0,3,5,42,0,8,0,47,0,white house denies un resolution swipe netanyahu
0,1,8,41,0,8,0,49,0,cbs corporation begin trading new york stock exchange
0,1,6,24,1,5,0,30,0,cutting carry-ons size
0,1,2,43,0,11,2,45,0,dr dino get 10 year prison failure pay tax
0,3,2,56,0,10,0,58,0,british backpacker thai hospital falling moving train
0,2,15,27,5,12,0,42,0,milo twitter: hate say told so... breitbart
0,1,9,24,4,7,0,33,0,f.d.i.c. raise fee replenish bank fund
0,3,10,57,2,9,0,67,0,conspiracy theorist alex jones apologizes spreading fake 'pizzagate' story
0,1,2,34,1,4,0,36,0,three killed hezbollah-led protest
0,1,3,64,0,9,0,67,0,scientist debate whether hurricane katrina aggravated global warming
0,3,7,43,1,9,0,50,0,amazon win deal stream nfl's thursday night football
0,3,1,71,1,11,0,72,0,maryland school district worker fired correcting student spelling tweet
0,2,3,54,1,7,0,57,0,trump carrier deal could permanently damage american capitalism
0,1,6,29,0,7,1,35,0,flyer take round 3 series penguin
0,1,6,39,1,8,0,45,0,calpers oppose re-election bank america board
0,3,16,74,5,16,2,90,0,"indian hacker leak 1.7 million snapchat users' data payback alleged ""poor country"" comment, claim report"
0,3,9,27,4,7,0,36,0,u.s. fall u.s. news best country ranking
0,3,5,61,1,7,0,66,0,cyclone debbie: premier annastacia palaszczuk tour devastated community
0,2,3,39,3,6,0,42,0,conway: stop trying 'delegitimize' trump victory
0,1,2,34,2,5,0,36,0,"kidnapped british couple ""need urgent help"""
0,1,8,23,1,7,0,31,0,"jim collins, question big"
0,2,1,22,1,4,0,23,0,london killer's final hour
0,3,11,46,3,10,0,57,0,kim kardashian rock bizarre nail piercings: 'khloe would proud'
0,3,3,37,2,7,2,40,0,"michael chamberlain, father azaria, dy aged 72"
0,3,7,49,2,9,0,56,0,trump promise insurance everybody health law replacement
0,3,2,64,2,13,0,66,0,crime stats inform public. trump misusing scare u instead.
0,2,8,38,1,8,6,46,0,"north dakota oil pipeline spill estimated 176,000 gallon"
0,3,7,41,0,8,0,48,0,hmrc change decision vat adult colouring book
0,2,7,66,2,10,0,73,0,kim jong-nam death: japanese network release purported cctv footage assassination
0,1,3,41,2,5,0,44,0,sweden's crown princess marries long-time boyfriend
0,2,7,36,0,9,2,43,0,blast syrian town turkish border kill nearly 50
0,1,7,33,1,6,0,40,0,"despite major plans, obama taking softer stand"
0,3,5,54,1,12,0,59,0,lady gaga jumping super bowl roof america's new favorite meme
0,2,4,49,1,9,0,53,0,burnleys matt lowton denies middlesbrough late tame draw
0,2,8,49,0,7,0,57,0,knicks reportedly contacted clipper carmelo anthony trade
0,2,8,45,0,9,0,53,0,rally held across country support affordable care act
0,2,4,31,1,6,0,35,0,tresor riziki: fresh face african music
0,1,3,18,1,3,0,21,0,happened archway?
0,2,8,41,1,8,0,49,0,"robert alford intercept tom brady, return pick score"
0,3,11,39,2,9,4,50,0,nba trade deadline 2017: best-case trade scenario every team
0,3,1,58,0,10,0,59,0,beluga whale upstage bride wedding day spark hilarious meme
0,2,2,66,1,12,0,68,0,doctor help india poorest uniquely outfitted hospital train
0,1,4,24,1,5,0,28,0,"oversaving, burden time"
0,2,2,54,3,11,0,56,0,two-hour marathon: take break elusive barrier?
0,2,12,54,4,12,0,66,0,"infowars alex jones performance artist, lawyer say divorce hearing"
0,1,6,46,0,9,0,52,0,mario draghi succeeds antonio fazio bank italy governor
0,3,7,32,0,8,0,39,0,eagle ejected beat writer press box
0,2,4,27,1,6,0,31,0,wall st: u share market finish mixed
0,1,4,56,0,10,0,60,0,ibm partner google produce corporate desktop search program
0,2,3,30,0,7,0,33,0,coke share lose fizz weak ussales
0,1,6,39,0,9,2,45,0,avalanche kill 10 hiker remote mountain turkey
0,2,11,54,5,10,0,65,0,"rose cousin premiere bluesy, dark 'chains' new album 'natural conclusion'"
0,2,4,55,2,7,0,59,0,#distractinglysexy twitter campaign mock tim hunt's sexist comment
0,1,3,46,1,8,0,49,0,same-sex marriage pass third reading house common
0,3,2,34,0,8,0,36,0,adele back perform grammys
0,2,7,36,2,9,2,43,0,betty white celebs crushing 90 [video]
0,3,5,69,3,14,0,74,0,"finally, good airline news: fcc let people talk cellphone flight"
0,1,2,21,0,4,1,23,0,mixed reaction g8 summit
0,3,12,47,2,11,4,59,0,"nfl playoff schedule 2017: wild card matchups, bracket date start time"
0,2,2,61,1,13,0,63,0,"speech interviews, obama hold spotlight last day"
0,1,2,34,0,7,2,36,0,25 dead mine explosion west virginia
0,1,9,25,3,8,0,34,0,n.b.a. player line ride ride
0,2,3,84,5,20,3,87,0,28-year-old tight end retired nfl 6 season say 'a lot guy really love' football
0,2,4,35,1,6,0,39,0,conservative hail trump's supreme court pick
0,2,6,72,7,13,4,78,0,harry potter philosopher's stone (2001): original telegraph review 'amazing transfixing'
0,3,9,32,3,8,0,41,0,keith olbermann call trump: 'you jackass'
0,1,1,46,0,7,0,47,0,china launch major cleanup operation oil spill
0,1,1,32,2,6,0,33,0,"hussein enters ""not guilty"" plea trial"
0,2,1,44,0,6,0,45,0,stockholm remains defiant deadly truck attack
0,2,2,57,0,10,0,59,0,stopping dub scheme child refugee shameful heartless
0,3,4,52,1,9,2,56,0,coalition airstrike syria mistakenly kill 18 us-backed fighter
0,2,8,36,3,9,0,44,0,young thug reflects demon 'safe' video: watch
0,1,2,24,0,4,0,26,0,abducted teen florida found
0,1,7,31,0,8,0,38,0,pilot killed crash fedex plane japan
0,2,9,40,3,15,5,49,0,"xx debut no. 2 billboard 200 chart, weeknd hold no. 1"
0,3,4,55,0,11,0,59,0,get ready fewer commercial break better flow nfl game
0,3,5,59,2,12,0,64,0,"north korea: china need put pressure rogue state, malcolm turnbull say"
0,1,6,29,0,7,0,35,0,hbo plan expansion tv channel asia
0,3,11,56,4,12,0,67,0,"krauthammer: russia sanction 'slap wrist', trump must downplay insider"
0,3,3,49,4,10,1,52,0,may's 'global britain' get boost qatar look 5bn investment
0,2,9,52,4,9,4,61,0,"serena williams vs. mirjana lucic-baroni: 2017 australian open score, reaction"
0,2,10,38,2,8,2,48,0,10-year-old bust myth trans people powerful sign
0,2,3,46,2,8,0,49,0,"judith clark, getaway driver brink heist, denied parole"
0,2,2,31,0,4,0,33,0,trump throw weight around washington
0,2,4,71,2,13,0,75,0,man attacked 'corrosive substance' barking station east london rush hour
0,1,4,38,2,7,0,42,0,wikinews interview manager site 'lose game'
0,1,3,47,0,6,0,50,0,microsoft flight simulator series grounded layoff
0,1,1,35,0,5,0,36,0,scottish politician face perjury trial
0,1,8,33,5,7,2,41,0,a.i.g. sell japanese headquarters $1.2 billion
0,3,10,44,2,9,0,54,0,mosque shooting show one completely safe: quebec's premier
0,2,2,60,1,10,0,62,0,firework black market: expert struggle halt sale illegal cracker
0,3,3,48,2,13,0,51,0,trump hotel eye china door hasnt opened
0,3,8,57,1,10,0,65,0,lance stephenson responds raptors' criticism layup instagram post
0,3,6,50,0,7,0,56,0,lance stephenson reportedly sign minnesota timberwolves
0,1,5,25,0,5,0,30,0,nato oil tanker torched pakistan
0,1,4,47,0,7,0,51,0,international arm dealer viktor bout arrested thailand
0,3,17,64,5,15,0,81,0,lin-manuel miranda reacts first oscar nomination potential egot win: 'it's great thrill'
0,2,7,48,0,7,0,55,0,darrelle revis charged alleged altercation pittsburgh
0,3,2,47,1,11,0,49,0,trump trade: need know take office
0,1,8,42,0,9,0,50,0,seized telenor stake russian company move toward sale
0,2,4,80,4,17,0,84,0,ex-convict arrested plot attack bar new year eve known impressionable panhandler
0,1,5,55,2,13,2,60,0,"phil hill, first american win formula one championship, dy age 81"
0,2,1,63,0,13,0,64,0,fruit veg prisoner might alleviate crisis jail
0,2,3,64,2,12,0,67,0,"tbilisi flash floods: lions, bear tiger roam georgian capital storm hit"
0,1,7,27,0,6,4,34,0,open software developer meet fosdem 2008
0,3,8,44,3,10,0,52,0,mnuchin: trump 'absolutely not' trying talk dollar
0,3,9,64,0,10,0,73,0,american describes surviving suspected terrorist attack berlin christmas market
0,2,3,40,4,10,5,43,0,"world's longest uber ride ended brooklyn, cost $294.09"
0,1,7,28,1,8,1,35,0,time co. may include 2nd paper globe sale
0,3,3,58,1,11,0,61,0,uk criticised failure tell afghan warlord's victim release
0,2,16,55,2,15,1,71,0,"samsung galaxy s8 user say display tinted red, they're happy"
0,3,7,41,0,9,2,48,0,austrian police arrest 14 suspected islamic state link
0,3,2,49,1,11,4,51,0,"mermaid, vampire zombie emoji coming iphone 2017"
0,3,2,58,1,12,0,60,0,"sukumaran chan family deserve help, say wife death row man"
0,3,17,46,0,14,0,63,0,one gram dna potentially hold data stored internet
0,1,2,33,0,6,0,35,0,wallace gromit set destroyed fire
0,3,10,54,0,12,0,64,0,magic johnson want kobe bryant return lakers player relation role
0,1,8,42,0,7,0,50,0,florida win bcs national championship game oklahoma
0,2,12,61,0,11,0,73,0,crackdown slaughterhouse meat supplier lucknow go indefinite strike
0,1,4,24,0,4,0,28,0,china tightens security tibet
0,3,9,36,0,11,2,45,0,feel like shop size 20 living abroad
0,1,1,50,1,6,0,51,0,scotland's oldest detainee facing attempted murder charge
0,3,3,66,2,13,0,69,0,"airbnb, twitter latest tech company raise big money fight trump's travel ban"
0,3,2,84,3,17,1,86,0,6 fable fixed-income investing cartoon form narrated actor played dumbledore
0,3,2,41,1,9,0,43,0,archives: sarin gas attack look like
0,3,5,37,0,6,0,42,0,inside massive inauguration security effort
0,2,3,48,1,8,0,51,0,senate democrat vow legislation block trump travel ban
0,2,3,12,0,3,2,15,0,79 cent
0,2,2,35,0,7,0,37,0,pharma pay getting comfy trump
0,2,3,80,2,14,0,83,0,"first post-coup attempt meeting erdogan, obama signal effort bring culprit justice"
0,2,11,57,2,10,0,68,0,chinese construction worker set dynamite uncover new dinosaur specie
0,2,9,39,1,8,0,48,0,twitter freaking trump latest style mistake
0,3,2,44,1,8,2,46,0,payneham cemetery stand-off 90yo family plot
0,1,7,28,0,8,0,35,0,playboy say open sale business
0,3,3,59,0,9,0,62,0,heath ledger documentary trailer appropriately beautiful sad
0,3,6,36,0,8,0,42,0,highlight march science
0,2,3,59,1,11,0,62,0,"iran satellite launch tied ballistic missile program, un expert say"
0,3,16,56,2,16,0,72,0,"egypt likely see isi attacks, need change fight terror, analyst say"
0,2,9,29,0,8,0,38,0,free airline meal coach may coming back
0,2,2,49,2,11,0,51,0,send kiss loved one via iphone 'kiss messenger'
0,2,10,44,0,11,0,54,0,man sent manifesto donald trump captured manhunt
0,2,8,38,3,10,5,46,0,hot 100 chart moves: amine approach top 10 'caroline'
0,3,4,55,2,9,0,59,0,david beckham look totally unrecognisable 'king arthur' makeup
0,1,1,33,1,5,2,34,0,"mandela turn 90, world celebrity gather"
0,2,4,22,0,4,0,26,0,calling presidential lie
0,3,10,31,3,10,0,41,0,iggy azalea link lil uzi vert cant lose
0,3,8,43,1,9,0,51,0,financial-services firm start scout new office space
0,1,8,40,1,11,0,48,0,"buffalo, owen evans different fire ice"
0,1,3,33,0,6,0,36,0,theo walcott deal go arsenal
0,3,13,52,1,13,2,65,0,19 picture youll understand dad loses damn mind thermostat
0,1,9,69,3,11,0,78,0,"australian football: adelaide united defeat queensland roar, a-league grand final"
0,2,3,56,2,13,0,59,0,playing tetri ease mind trauma? study suggests can.
0,2,5,30,0,8,0,35,0,tinder look lot like snapchat
0,2,5,47,1,10,2,52,0,manchester city 10 men sink burnley thanks clichy agero
0,2,5,49,3,13,0,54,0,marc maron talk standup: think funnier ever
0,2,2,54,3,9,0,56,0,"kim kardashian robbery may inside job, investigator say"
0,1,4,44,0,11,3,48,0,poll 100 million vote name new seven wonder world
0,1,7,31,1,8,2,38,0,lakers survive slow start take 3-1 series lead
0,3,16,69,2,15,0,85,0,state dug deep voting irregularities. found nothing close widespread voter fraud.
0,1,2,32,0,6,4,34,0,uk experience first widespread snow 2009
0,2,1,50,0,8,0,51,0,gas company make guarantee meet domestic supply
0,3,5,43,1,10,0,48,0,what's likely change gop bill repeal obamacare
0,1,11,36,4,9,0,47,0,"lawsuit, dispute whether roberto alomar h.i.v."
0,1,1,63,0,10,3,64,0,egyptian archaeologist announce discovery marble statue 132 new site
0,2,19,56,1,16,0,75,0,"bizarre may sound, srk feel none performance deserve national award"
0,1,5,52,0,8,0,57,0,interview u political activist philosopher noam chomsky
0,3,4,51,1,10,0,55,0,"derrick rose miss knicks game, said chicago family issue"
0,1,2,25,0,5,5,27,0,mn4 2004 asteroid considered safe
0,1,3,45,0,8,0,48,0,tom delay face two new indictment money laundering
0,2,10,57,4,10,0,67,0,oakland warehouse fire: 'ghost ship' sailed regulators' finger year
0,3,1,41,1,7,0,42,0,baby koala hug mum life-saving surgery
0,1,7,30,1,7,0,37,0,"holding wig, dodger market fallen star"
0,3,2,48,0,8,0,50,0,accuser identified sex abuse case seattle mayor
0,1,6,33,0,8,0,39,0,lebanese shock arrest accused spy
0,3,6,42,1,5,0,48,0,dominique strauss-kahn acquitted aggravated pimping
0,3,8,41,1,7,0,49,0,"facebook revamps messenger, putting bot front center"
0,2,11,52,2,11,0,63,0,"dwyane wade's son, nephew put together highlight reel chicago high school"
0,3,2,60,0,11,0,62,0,pro tennis match interrupted couple extremely loud sex list
0,1,1,64,0,11,0,65,0,woolly mammoth demise may result climate change overhunting
0,3,10,59,5,11,1,69,0,"san bernardino school shooting: three dead, 1 wounded murder-suicide classroom"
0,3,5,21,0,4,0,26,0,dollar rise despite job miss
0,2,10,48,1,11,1,58,0,daredevil season 2: walking dead alum jon bernthal cast punisher
0,1,4,63,0,13,0,67,0,death nancy benoit rumour posted wikipedia hour prior body found
0,2,3,55,1,11,3,58,0,resist trump 101: harvard student launch new course activist
0,2,4,55,3,9,0,59,0,'great chemistry': trump abandon china criticism russia tie suffer
0,1,6,31,0,8,0,37,0,visa seek issue largest ipo u history
0,2,1,85,4,17,1,86,0,"company secretly run internet, raised another $8 million rule everything else,"
0,2,6,36,1,7,0,42,0,japan's flying fish make freshest sashimi
0,1,1,30,0,4,0,31,0,nokia launch internet music store
0,2,5,23,0,6,2,28,0,spanish singer bimba bose dy 41
0,1,9,14,0,5,0,23,0,webmd hlth plan merge
0,3,16,62,3,15,0,78,0,"trump's hhs pick, tom price, grilled stock trade working health legislation"
0,2,4,57,5,11,0,61,0,"coca-colas happy holiday truck tour banned, say health expert"
0,1,7,40,2,7,6,47,0,uefa champion league 2007/08: liverpool complete safe passage
0,1,4,20,1,6,4,24,0,magic tie series 76ers 1-1
0,3,2,35,1,7,0,37,0,neil gaiman webchat post question
0,3,2,61,1,9,0,63,0,"trump sign first executive order, targeting obamacare specific"
0,1,5,32,1,5,0,37,0,nhl: vancouver canuck showcase new uniform
0,1,7,34,2,7,0,41,0,sale benefit charity thrifty brides-to-be
0,2,7,41,2,9,0,48,0,stephen colbert accuses trump usual suspect parody
0,1,8,38,2,11,4,46,0,2010 fifa world cup: spain beat chile; go second round
0,2,10,50,0,9,0,60,0,donald trump israeli pm benjamin netanyahu bond transition
0,3,10,38,1,9,0,48,0,frank ocean super psyched viola davis' oscar win
0,3,17,66,1,16,0,83,0,australian medium cross line compare virat kohli animal extremely racist post!
0,2,3,66,2,12,2,69,0,leading republican senator criticize trump refugee travel ban 48 hour later
0,3,11,48,2,10,2,59,0,salary chronicles: negotiated first $18k consulting contract
0,1,4,38,2,8,2,42,0,china russia sign trade deal worth us$3.5 billion
0,2,7,16,0,5,0,23,0,sky falling gopro
0,1,5,74,2,14,0,79,0,taiwan blue camp pay respect thirtieth anniversary passing chiang kai-shek
0,2,3,39,2,6,0,42,0,chris hemsworth joining 'ghostbusters' cast
0,1,2,26,0,5,0,28,0,car bombing chechnya kill boy
0,2,9,32,1,10,0,41,0,"hold steph curry hate, time come"
0,1,7,36,0,9,0,43,0,internet provider try charge cost fall
0,1,4,22,0,3,0,26,0,tobacco company lose appeal
0,3,8,62,1,16,0,70,0,aig's ceo resigning year carl icahn called breakup company
0,1,1,34,1,6,0,35,0,hoax email play tube travellers' fear
0,2,6,66,2,10,0,72,0,high-level defence meeting japan postponed minister marise payne's health
0,1,2,27,0,4,0,29,0,blob alaskan coast identified
0,1,6,38,0,7,4,44,0,geelong win 2009 australian football league grand final
0,2,1,47,3,8,0,48,0,internet warriors: inside dark world online 'trolls'
0,2,11,49,0,13,0,60,0,hall fame running back weigh special running back draft class
0,3,6,34,0,7,0,40,0,paris increase security around eiffel tower
0,2,3,60,2,11,0,63,0,tsa team work ensure inauguration safety library virtual site
0,1,4,18,1,3,0,22,0,jackie stewart's long view
0,2,10,39,1,9,0,49,0,china upset soccer win south korea averts fan unrest
0,3,7,52,3,12,0,59,0,charles schumer meeting vladimir putin doesnt give trump co. pas
0,1,8,22,1,7,0,30,0,web news start-up eye texas
0,3,8,34,4,12,4,42,0,watch boy! today 1982 hall oates took 'maneater'
0,1,5,72,4,14,2,77,0,"eurovision '82 winner nicole talk 'ein bichen frieden', success contest today"
0,1,2,36,0,6,0,38,0,judge delay exit exam decision friday
0,3,4,46,0,9,0,50,0,celebrated syrian musician left limbo u travel ban
0,2,3,35,1,4,0,38,0,imf meeting drop anti-protectionism pledge
0,2,10,35,2,11,0,45,0,roger stone: need know trump khizr khan
0,1,5,41,0,8,2,46,0,barack obama elected 44th president united state
0,3,10,55,3,9,2,65,0,16-year-old spartanburg day school's zion williamson soar ridiculous block
0,1,8,32,3,7,0,40,0,executive hired salvage a.i.g. becomes target
0,3,9,40,1,8,0,49,0,donald trump's new travel ban face fresh legal challenge
0,1,7,29,0,8,0,36,0,bank japan step effort ease credit
0,1,5,21,1,3,0,26,0,social network eclipse e-mail
0,2,11,35,0,8,0,46,0,trump make unannounced trip honor fallen navy seal
0,2,8,45,1,9,0,53,0,carrier layoff teach worker cost global trade breitbart
0,1,3,46,0,9,0,49,0,freddie starr arrested part savile child sex inquiry
0,1,9,31,3,7,1,40,0,"blood profiling system flag 5 cyclists, u.c.i say"
0,1,4,27,0,4,0,31,0,microsoft ordered delete browser
0,1,3,42,0,5,0,45,0,porfirio lobo win honduran presidential election
0,3,4,44,1,9,4,48,0,tim allen jokingly compare hollywood 1930s germany video
0,2,2,49,0,8,0,51,0,leaked email show clinton sticking close talking point
0,3,5,26,0,7,0,31,0,many hurdle orderly brexit
0,1,9,30,4,7,0,39,0,disposing asset failed bank test f.d.i.c.
0,2,10,50,0,12,2,60,0,steve perry say first solo album 23 year inspired personal tragedy
0,2,3,88,1,16,3,91,0,selfies serengeti: researcher reveal stunning picture 225 camera set across savanna
0,1,4,42,1,10,6,46,0,"nearly 100,000 protest closure u military base japan"
0,1,2,52,0,8,0,54,0,u presidential candidate statistically tied poll
0,1,3,35,0,5,0,38,0,hurricane felix make landfall nicaragua
0,1,6,37,0,6,0,43,0,foundation could fined madoff investment
0,2,1,55,3,9,0,56,0,"no, health bill doesnt gut coverage pre-existingconditions"
0,2,10,32,4,7,0,42,0,o.j. simpson nfls latest concussion casualty?
0,2,5,60,0,12,0,65,0,dakota access pipeline plan still despite protest across u world
0,2,3,49,0,9,0,52,0,judge refuse stop construction dakota access pipeline
0,1,4,41,0,7,0,45,0,sri lankan president appoints fellow hardliner pm
0,2,8,43,3,10,4,51,0,"report: democrat lost 1,000 seat obama breitbart"
0,1,6,32,0,7,0,38,0,local insurance agency hustle slump
0,3,6,37,1,10,0,43,0,trump trade: extreme tactic search point
0,1,5,29,0,6,0,34,0,mickelson watney share lead doral
0,2,6,61,6,16,0,67,0,here's tom brady one nfl's richest star make spends million
0,3,1,50,2,9,2,51,0,hamburg airport evacuated 50 treated 'substance air'
0,1,4,69,5,12,0,73,0,u.s. vice president joe biden say positive consensus same-sex marriage 'inevitable'
0,2,11,40,2,10,0,51,0,risk back french election; euro jumps: market wrap
0,3,1,46,1,7,0,47,0,china's latest robot police officer recognise face
0,2,16,74,4,18,1,90,0,"5 thing read today: jeff session confirmation hearings, wal-mart plan job cuts, world cup expands"
0,2,8,36,0,7,0,44,0,nusra front militant kill druze villager syria
0,1,5,33,0,6,0,38,0,iraq suffers euphrates river dwindles
0,1,9,61,0,9,0,70,0,afghan insurgent expand use increasingly sophisticated homemade bomb
0,3,8,73,0,14,0,81,0,liverpool mayor call paul nuttall resign mep region amid hillsborough controversy
0,1,9,46,2,7,0,55,0,weir versus lysacek highlight u.s. figure skating championship
0,3,7,38,0,6,0,45,0,king reportedly trade demarcus cousin pelican
0,2,5,50,1,11,0,55,0,stephen curry need resemble league mvp late
0,1,3,35,1,5,0,38,0,"restored warplane flown hamilton, canada"
0,1,3,22,0,3,0,25,0,hurricane emily hit grenada
0,2,3,46,1,9,0,49,0,u say colombia's coca production surge record level
0,3,4,53,3,13,1,57,0,first 'game thrones' season 7 poster pretty badass
0,1,3,40,0,6,0,43,0,space shuttle discovery launch final mission
0,1,6,38,2,8,5,44,0,"english football: manchester united news august 6, 2008"
0,2,4,56,3,10,0,60,0,resistance now: activist say hell republican healthcare bill
0,1,3,28,2,7,2,31,0,kata air an-32 crash presumed dead
0,3,2,53,0,9,0,55,0,aaron hernandez innocent bystander bloodstained life
0,1,7,35,1,8,0,42,0,carbon offsets: small price pay efficiency
0,2,2,38,0,9,4,40,0,orlando release 9 hundred 911 pulse call
0,3,3,30,1,6,0,33,0,gaga back gay right trump's america
0,1,7,37,1,9,0,44,0,profit rise johnson johnson expects weak year
0,2,6,36,2,6,0,42,0,breitbart news daily: trump unshackled breitbart
0,1,6,34,0,6,0,40,0,republican throwback taking aim court pick
0,3,13,40,1,10,0,53,0,phoenix rapper trap house help sxsw speaker's song come life
0,2,8,38,0,8,0,46,0,death fentanyl overdoses double single year
0,2,13,42,4,12,0,55,0,"baby driver, action, script music go full throttle"
0,2,3,35,1,4,0,38,0,meet sandhurst's first pakistani instructor
0,2,3,49,0,9,0,52,0,dominican paper apologizes using baldwin photo trump
0,1,3,60,0,7,0,63,0,former rwandan government minister nyiramasuhuko convicted genocide
0,3,6,54,2,11,0,60,0,bom warns flooding cyclone debbie's wake; brisbane set pounding
0,2,11,34,2,10,0,45,0,"waka flocka drop gucci mane dis track ""was dawg"""
0,3,1,30,0,7,2,31,0,flu season hitting peak 43 state
0,1,3,39,0,6,0,42,0,large earthquake strike coast french guiana
0,1,4,40,0,7,0,44,0,palmeiro benched return major league baseball
0,1,5,27,0,5,0,32,0,sweden aid bailout baltic nation
0,1,3,24,0,7,2,27,0,eu ban 75w bulb come force
0,3,4,48,2,9,3,52,0,"trump's debt spread across 150 companies, wall street journal say"
0,2,5,36,2,10,2,41,0,'lethal weapon' actress mary ellen trainor dy 62
0,2,2,62,3,11,0,64,0,donald trump addressed alleged lurid sexual act saying he's 'germaphobe'
0,1,7,21,3,5,0,28,0,slight upgrade quarterly g.d.p.
0,2,16,41,1,14,2,57,0,"resolve work 20 hour day leave, cm yogi adityanath tell babu"
0,2,11,53,4,12,0,64,0,"buddy hield's side story: becoming steph, replacing boogie"
0,1,2,52,1,6,0,54,0,southern california auto maker announces fully-electric sedan
0,3,5,34,0,10,5,39,0,well fargo strip ceo 7 top exec 2016 bonus
0,2,12,42,0,10,0,54,0,merkel face spd challenger september tv debate
0,2,3,69,3,14,0,72,0,legal north carolina attorney general defend state bathroom law?
0,1,6,35,1,6,0,41,0,"explosion color, tibetan art flourish"
0,2,2,51,2,10,0,53,0,ka-ching! gambling lobby fight pokie reform
0,3,1,50,1,7,0,51,0,snowdonia crash: five body found helicopter wreckage
0,3,2,44,0,10,0,46,0,police hunt two men seven shot christmas party
0,2,7,49,0,7,0,56,0,trump wiretapping claim rejected senate intelligence chief
0,2,2,66,6,8,0,68,0,"president trump combative, freewheeling, fake news press conference, explained"
0,2,1,53,1,12,0,54,0,"social media, share story matter writes"
0,3,2,35,0,7,0,37,0,fire crew china battle tower block blaze
0,2,1,77,1,12,0,78,0,"oklahoma state senator plan resign following child prostitution charges, attorney say"
0,3,4,38,0,9,0,42,0,return mmr charlatan fit time
0,3,4,39,1,8,0,43,0,curt schilling tweet way cooperstown?
0,3,12,57,2,9,0,69,0,"nba donatas motiejunas becomes unrestricted free agent: latest details, reaction"
0,3,6,59,1,11,2,65,0,brexit brexit: britain file article 50 letter formally leave european union
0,1,3,43,0,7,0,46,0,china airline plane catch fire japanese airport
0,2,8,35,2,9,0,43,0,san francisco asks: child gone?
0,3,5,77,0,16,6,82,0,berlin christmas market attacker ani amri used 14 different identity coming germany 2015
0,2,7,35,2,8,0,42,0,espn cast shadow star war success disney
0,1,3,45,0,8,0,48,0,facebook uk government clash tribute killer
0,1,2,39,0,7,0,41,0,twenty dead double suicide bombing iraq
0,1,5,29,0,5,0,34,0,roche offer genentech turn hostile
0,1,6,33,0,6,0,39,0,agreement ship recycling win wide support
0,2,1,48,2,11,0,49,0,app let try tattoo ruin bodyforever
0,2,1,49,0,9,0,50,0,millennials totally mixed believein
0,3,4,44,2,9,0,48,0,zimbabwe dna test 'prove hunter killed crocodile'
0,2,2,66,3,14,0,68,0,"ninja came home killed family, boy tell police alaska slaying"
0,2,12,48,2,11,5,60,0,ncaa tournament 2017: b/r expert prediction updated result 2nd round
0,2,3,44,1,8,0,47,0,"uk lead europe wealthy female earners, survey find"
0,2,1,51,0,10,0,52,0,trump earned respect ultimate sore winner
0,2,1,57,0,10,0,58,0,sleep doctor explains sleep position could cause wrinkle
0,1,7,38,0,6,0,45,0,china take heavy criticism software directive
0,3,12,32,0,8,0,44,0,vizio settle ftc lawsuit snooping tv viewer
0,1,2,34,0,5,0,36,0,first nestorian search engine go online
0,3,10,40,2,8,0,50,0,cash-strapped gwalior farmer pay kids' school fee paddy
0,2,14,36,2,11,0,50,0,kobe bryant gift oregon duck new nike kobe a.d. nxt shoe
0,1,2,55,0,10,0,57,0,council europe planning use satellite image prison probe
0,3,2,56,2,10,0,58,0,'modest fashion' startup giving muslim woman clothes
0,1,4,47,1,9,2,51,0,uk government announce same-sex wedding start march 29
0,3,5,71,2,13,1,76,0,radio 1 apologises orlando bloom say 'pikey' live interview nick grimshaw
0,1,3,51,1,9,0,54,0,"despite speculation, aide say biden remain obama ticket"
0,2,4,46,1,14,4,50,0,"whatever imf thinks, long way boom time 2007"
0,3,3,55,0,13,0,58,0,george takei joked running congress want real
0,2,9,38,1,7,0,47,0,twitter stock fall following coo departure breitbart
0,1,2,35,0,7,1,37,0,delta 4 heavy rocket poised maiden launch
0,1,7,35,0,7,0,42,0,saving kashmiri village remaking life
0,2,3,80,1,15,0,83,0,"jakarta governor election going second round voting, quick count showing ahok lead"
0,1,1,53,1,11,2,54,0,sex offender pretend 12 year old; enrolls seventh grade
0,1,6,26,0,6,0,32,0,suit filed event inaugural
0,1,9,44,0,12,2,53,0,24th shin kong life tower run promote banana taiwan
0,3,6,32,1,6,0,38,0,north carolina gov. pat mccrory concedes race
0,3,3,68,2,14,0,71,0,'at least four dead' several missing avalanche french ski resort tignes
0,3,12,46,0,12,0,58,0,labour loses seat tory defeat ukip leader british voting
0,1,3,31,1,5,0,34,0,"second dust storm hit sydney, australia"
0,3,11,47,2,9,0,58,0,elaine chao's labor department failed protect low-wage worker
0,2,7,39,3,10,0,46,0,hey! you! quick! nintendo switch amazon right
0,2,1,45,0,8,0,46,0,delhi mascot blow whistle public defecation
0,3,3,34,2,6,0,37,0,warren beatty recall 'chaos' oscar night
0,1,9,40,0,12,0,49,0,want revenge derby favorite field long shot
0,3,3,59,4,15,0,62,0,buy fish credit card here? trader scoff goa bid ditch cash
0,2,2,68,0,11,0,70,0,volunteer pitch stop indigenous family evicted public housing
0,1,6,40,0,9,1,46,0,tape beating lead firing 5 birmingham officer
0,2,8,36,0,9,0,44,0,check popular netflix show state
0,1,5,30,1,6,0,35,0,"impairing european union, gibe gibe"
0,3,12,49,7,10,0,61,0,chainsmokers' debut album 'memories...do open' arrived: listen
0,2,13,58,0,14,0,71,0,chance rapper recruit king louie dj oreo upcoming encouraged tour
0,1,7,32,0,6,0,39,0,former nfl quarterback steve mcnair shot dead
0,1,2,38,2,6,2,40,0,"5.9 magnitude aftershock strike lolol, chile area"
0,1,4,28,1,7,0,32,0,"dead child found car sussex, uk"
0,1,6,32,0,8,2,38,0,ucla basketball coach john wooden dy age 99
0,3,3,47,1,9,0,50,0,"ipad magician strike again, time using apple watch"
0,1,5,60,4,10,0,65,0,'outraged' lahood unveils plan tackle fatigued u.s. air traffic controller
0,3,8,35,0,10,1,43,0,4 killed tree fall mobile home storm
0,3,5,65,3,11,0,70,0,"queen elizabeth, prince philip delay christmas travel plan 'heavy colds'"
0,1,2,42,0,7,0,44,0,u study examines suicide trend depressed youth
0,1,2,47,0,7,0,49,0,four earthquake hit philippine quick succession
0,1,5,29,0,5,0,34,0,document back saudi link extremist
0,3,13,54,1,12,0,67,0,uconn's ot loss mississippi state spark twitter reaction win streak snap
0,1,3,47,0,7,0,50,0,russian meeting hamas provokes criticism israel
0,2,9,56,1,9,0,65,0,hollywood hotshot david white lead world largest entertainment union
0,3,3,56,2,10,0,59,0,woman died superbug resistant available antibiotic u.s.
0,2,3,66,3,14,0,69,0,agency helped make america great first place. time double down.
0,1,8,24,3,6,0,32,0,ex-g.m. worker try reboot life
0,3,12,44,0,10,0,56,0,someone sending personalized potato bunch nba player
0,3,9,45,1,9,0,54,0,obama's ip advisor talk reform effort new administration
0,2,13,39,0,11,0,52,0,south korea mers case rise hong kong increase alert level
0,3,5,31,0,5,0,36,0,sea life captured stunning photograph
0,3,5,30,3,7,2,35,0,"john glenn: ex-astronaut, u senator dy 95"
0,3,9,48,0,10,0,57,0,obama bar state denying federal money planned parenthood
0,2,7,66,3,13,0,73,0,'trump's policy towards nafta mexico negative impact borderland'
0,1,5,34,0,4,0,39,0,bernanke reject bank nationalization
0,2,5,65,2,11,0,70,0,oil exploration firm 'largest undeveloped discovery' uk continental shelf
0,1,7,42,0,7,0,49,0,andy roddick present challenge coach larry stefanki
0,1,2,33,1,7,1,35,0,u stock see 9% drop making recovery
0,2,14,64,4,14,0,78,0,conspiracy hillary: doubt mind putin trying hack presidential election breitbart
0,1,6,33,0,7,0,39,0,gazprom seek gas pipeline bypass ukraine
0,1,2,38,0,7,0,40,0,suicide attack yemen shrine leaf nine dead
0,1,7,33,0,8,0,40,0,soldier kill iraqi couple raid home
0,3,9,43,4,8,1,52,0,9-year-old terminal cancer's travel dream fulfilled yahoo
0,1,7,33,1,7,0,40,0,"run refinancing numbers, run"
0,3,4,66,4,12,0,70,0,"keith ellison, first muslim congressman, call mass rally stop trump order"
0,3,1,62,0,10,0,63,0,french prime minister resigns focus upcoming presidential election
0,3,9,32,4,9,0,41,0,french montana: 'i ain't know nappy racist word'
0,1,4,22,0,5,1,26,0,4 body found maryland hotel
0,1,7,30,0,6,0,37,0,uconn find focus eliminates purdue
0,1,3,40,0,6,0,43,0,finnish terrestrial analogue tv network shut
0,2,8,39,1,8,4,47,0,swiss national bank may raise 2017 inflation forecast: chart
0,2,11,37,0,9,0,48,0,evercore isi switch fed call march hike dudley
0,2,10,42,1,11,3,52,0,new ebola vaccine give 100 percent protection new york time
0,2,2,67,1,11,0,69,0,trump's challenge asking congress authorization use military force
0,3,2,63,2,10,0,65,0,family westminster river plunge survivor 'overwhelmed love support'
0,1,6,29,0,6,0,35,0,manhattan awash sublet office space
0,1,2,62,0,10,0,64,0,south african government appeal calm death white supremacist
0,2,6,41,1,9,1,47,0,6 highlight ruling trump immigration order
0,3,9,33,2,10,2,42,0,snapchat parent plan pay bank 2.5% ipo proceeds
0,2,2,40,2,10,3,42,0,here every law trump signed first 100 day
0,2,5,68,1,13,0,73,0,"tragic end rashaan salaam, heisman trophy winner former college football star"
0,3,8,39,1,9,2,47,0,"socialite, hollywood glamour queen zsa zsa gabor dy 99"
0,3,12,54,3,11,2,66,0,confirmed: u.s. ban electronic device flight 10 middle eastern airport
0,3,5,42,3,7,0,47,0,state department remove promotion trump's mar-a-lago
0,2,10,48,2,10,0,58,0,two house chairman ask justice department probe flynn leak
0,2,2,38,0,6,0,40,0,doctor filmed uber tantrum explainsherself
0,3,5,29,0,8,1,34,0,harry style release single april 7
0,2,8,41,1,7,0,49,0,"winter storm flood streets, blanket mountain snow"
0,3,6,29,2,5,0,35,0,beyond two-state solution: option
0,1,5,33,0,6,4,38,0,canadian judge convict rwandan 1994 genocide
0,3,8,26,1,9,5,34,0,nfl free agency 2017: winner loser day 2
0,1,11,48,2,12,0,59,0,u.n. leader press sri lanka speeding relief war refugee camp
0,2,5,67,4,13,0,72,0,trump counselor kellyanne conway: 'i evidence' trump wiretapping claim
0,3,8,22,2,6,0,30,0,cisco ceo join blackrocks board
0,3,11,57,5,9,0,68,0,japanese car expert talk weeknd's mazda-obsessed 'party monster' video: exclusive
0,1,1,49,0,7,0,50,0,libyan government force capture eastern town rebel
0,3,16,46,5,14,0,62,0,irony could trip trump's quest make u.s. economy 'great again'
0,3,11,42,2,9,0,53,0,singapore eas property home price drop: quicktake q&a
0,3,3,56,3,9,0,59,0,"u.s. evicts russian spying, imposes sanction election hack"
0,3,3,28,0,6,0,31,0,big apple circus spring back life
0,1,5,44,0,6,0,49,0,volcanic activity expands mcdonald island australia
0,2,10,52,0,11,0,62,0,stock longer actively traded security stock market
0,1,7,40,0,8,0,47,0,computer maker prepare stake bigger claim phone
0,2,6,42,3,8,0,48,0,usss chief say friction trump private security
0,3,5,40,1,9,3,45,0,toughest un sanction yet cost north korea $800 million
0,2,9,39,0,8,0,48,0,stream netflix highest definitionpossible
0,3,3,68,0,11,0,71,0,house republican pull plan gut independent ethic committee trump tweet
0,1,5,34,0,7,0,39,0,celebration wheel observance purim
0,3,11,56,5,10,0,67,0,'homeland' producer feared show's woman president 'irrelevant' trump win
0,2,7,44,1,10,0,51,0,"immigration hawk buoyed trump pick dhs secretary, ag"
0,3,4,66,3,15,0,70,0,fitness audit (and good idea) featured story additional story
0,1,7,31,0,6,0,38,0,tight mortgage rule exclude even good risk
0,1,5,28,0,6,4,33,0,economy shrink fastest rate since 1950s
0,1,2,21,0,3,0,23,0,election held bulgaria
0,1,2,27,0,4,0,29,0,afghan pilot kill nine american
0,1,5,25,0,5,0,30,0,north korea set date launching
0,1,7,37,1,10,1,44,0,"2 tour de france rider shot, apparently air rifle"
0,2,1,34,2,7,0,35,0,"weird, lonely life auto-showmodel"
0,3,1,64,2,7,0,65,0,"ex-teacher researched teen marriage disappearing, investigator say"
0,1,4,20,0,4,0,24,0,race harness hydrate
0,1,1,47,0,8,0,48,0,thai government drop origami crane message peace
0,3,11,39,0,10,0,50,0,syrian refugee boy fled war feared drowned san diego
0,3,2,53,0,10,2,55,0,robbery suspect surrender 11 hostage taken florida bank
0,2,1,56,0,13,0,57,0,young man walked mile work drive police raise cash
0,1,1,47,0,8,0,48,0,man allowed keep deceased friend warehouse freezer
0,1,6,27,3,8,4,33,0,jobless rate surpasses 10% 15 state d.c.
0,3,5,47,2,8,0,52,0,northern ireland kyle lafferty romania main target
0,2,8,36,9,10,0,44,0,"trump: well build wall, thats easy one breitbart"
0,3,5,64,4,14,0,69,0,correct?: male gop lawmaker asks men pay prenatal coverage
0,1,3,32,4,6,0,35,0,tighten 'noose' osama can't operate: obama
0,3,14,55,5,13,0,69,0,"year country charts: chris stapleton, carrie underwood, fgl, maren morris"
0,1,3,40,0,7,0,43,0,pirate hijack thai merchant ship somali coast
0,3,4,34,0,8,0,38,0,eu see big trade opportunity china
0,2,1,37,1,10,2,38,0,"10 year iraq crash, pilot laid rest"
0,2,10,43,2,10,0,53,0,full text: president trump's new order travel immigration
0,1,1,19,0,3,0,20,0,greek debt deal reached
0,3,11,33,5,12,0,44,0,fetch: mean girl musical aim fall run
0,1,3,36,0,6,0,39,0,man accused holocaust museum shooting dy
0,2,3,36,0,9,0,39,0,rich new yorkers ask state raise tax
0,1,8,36,1,9,0,44,0,stewart win nascar all-star race first time
0,3,10,62,1,13,0,72,0,watch: president trump speaks wisconsin executive order curb foreign worker
0,1,2,40,0,6,0,42,0,south korean worker protest labour law
0,2,3,74,1,11,0,77,0,adler shotgun: barnaby joyce call relaxed restriction controversial firearm
0,3,4,56,2,9,0,60,0,international women's day: militant history global celebration
0,3,1,50,0,8,0,51,0,memorial fund established family fallen firefighter
0,2,11,46,4,10,0,57,0,"trump order wall, mexico president considers canceling u.s. trip"
0,1,3,40,0,6,0,43,0,controversy liverpool fan jailed bulgaria
0,1,3,47,4,8,0,50,0,wikinews exclusive: 'speed behind new zealand's road toll'
0,3,12,48,3,13,2,60,0,mike freeman's 10-point stance: packer may good thought
0,3,2,52,2,11,2,54,0,"truck bomb kill least 60, including army troops, northern mali"
0,2,8,67,0,14,0,75,0,donald trump us black history month speech attack cnn boast popularity
0,2,3,65,0,12,0,68,0,state department drop human right condition fighter jet sale bahrain
0,1,11,38,0,9,0,49,0,former astronaut bolden interviewed top nasa job
0,2,4,57,1,11,0,61,0,"one three unhappy nh patient actually complain, say new survey"
0,2,5,60,0,13,2,65,0,isi suspected twin suicide bombing wedding kill least 26 near baghdad
0,1,8,40,1,10,0,48,0,"baseball, number offer conclusion steroid use"
0,1,5,44,0,10,0,49,0,daisuke enomoto fourth space tourist iss
0,1,3,49,1,7,0,52,0,american botanist lou jost discovers world's smallest orchid
0,2,5,59,2,10,0,64,0,scottish paper describes trump inauguration return twilight zone
0,1,1,34,0,6,0,35,0,zimbabwe ban crop growing urban area
0,1,7,31,2,7,0,38,0,crisis europe u.s. hurt asian economy
0,2,11,52,1,12,0,63,0,"muay thai fighter land flying knee hell, finish foe stiff punch"
0,1,3,59,0,8,0,62,0,south african president wrongly announces death zambian counterpart
0,3,7,74,0,16,0,81,0,gina miller warns theresa may new court battle parliament guaranteed vote leaving eu
0,3,12,47,1,12,4,59,0,ashish nehra's magical six ball destroyed england day 2003
0,3,3,25,1,7,2,28,0,vinyl sale uk hit 25-year high
0,1,7,50,2,8,0,57,0,"financial crisis, ordinary people vs. extraordinary problem"
0,2,2,38,3,8,2,40,0,suge knight collapse bail set $25 million
0,1,1,34,0,7,0,35,0,man attacked shark safe hospital
0,3,4,44,3,10,0,48,0,want use uber? waze carpool expands cities.
0,1,3,57,0,10,0,60,0,france claim russia violated term ceasefire georgia
0,2,3,11,1,2,0,14,0,comeys weak case
0,2,1,23,0,5,2,24,0,54 stingray die chicago zoo
0,1,3,31,0,6,0,34,0,uk car crash leicestershire kill six
0,3,7,38,0,7,0,45,0,kylie jenner escape lawsuit thanks instagram
0,2,3,59,0,11,0,62,0,positive short supply coventry fail take flight robin
0,3,2,67,2,12,0,69,0,"original tamagotchi re-released, get ready relive childhood"
0,1,6,75,1,13,0,81,0,pakistani taliban threaten revenge attack bin laden death; cia say retaliation likely
0,1,4,30,0,5,0,34,0,u federal reserve lift interest rate
0,1,8,32,2,9,0,40,0,u.s. planning reveal data health top bank
0,1,4,25,0,5,0,29,0,subpoena lawmaker reported
0,1,3,22,0,4,1,25,0,2 adviser abducted somalia
0,1,7,27,1,6,0,34,0,cigarette butts: tiny trash pile
0,2,3,58,3,11,0,61,0,'he nothing wrong': florida principal ousted defending texas cop
0,1,4,59,2,11,0,63,0,"israeli president shake hand leader syria, iran pope's funeral"
0,3,7,59,6,15,0,66,0,"caitlin moran: writer, id peachy, zingy buttock gigihadid"
0,3,11,56,1,12,0,67,0,"ladainian tomlinson number retired, inducted charger hall fame"
0,2,2,73,2,12,0,75,0,amazon's giant robot-staffed supermarket may employ three human per store list
0,3,11,44,2,9,2,55,0,75-year-old grandpa learned draw grandchild
0,3,2,81,1,14,0,83,0,north carolina vote replace one anti-trans law another everyone obviously outraged
0,3,2,45,0,10,0,47,0,assad regime show mercy push regain aleppo
0,2,6,75,3,18,2,81,0,'a calling card russian culture': acclaimed red army choir lost 64 member plane crash
0,3,1,61,3,13,0,62,0,macron rise show extremism whether left right inevitable
0,2,9,48,0,9,0,57,0,andrew cuomo stand embattled program corruption case swirl
0,3,13,45,1,13,2,58,0,malaysia travelers: threat vx 11 day kim jong nam attack
0,2,5,51,2,11,0,56,0,"youtube videos, chicago woman take blame mom's murder bali"
0,3,5,45,1,9,0,50,0,packer wr jordy nelson spent night hospital; status iffy
0,2,12,38,2,11,0,50,0,"artist teach draw using ""the penis method"""
0,1,4,84,2,17,0,88,0,u.s. inform pakistan bin laden mission suspicion harbored government
0,1,6,38,0,8,1,44,0,2 oficials offer hope caution chinese econonmy
0,1,9,34,2,7,0,43,0,"modest power, mets try shedding long-ball image"
0,2,10,42,3,9,0,52,0,alphabet waymo asks court halt ubers self-driving car tech
0,3,6,38,0,7,0,44,0,michael flynn resigns national security adviser
0,2,2,44,0,9,0,46,0,thirteen bald eagle found dead maryland farm
0,3,2,56,0,10,0,58,0,man critical condition car hit pedestrian south london
0,2,5,54,3,11,0,59,0,border: possible tax mexican good worry u.s. business
0,3,8,38,0,8,0,46,0,auction offering coffee ivanka trump canceled
0,1,5,31,0,6,4,36,0,fernando alonso win 2010 singapore grand prix
0,3,8,46,1,9,0,54,0,fecal pollution taint water melbourne beach storm
0,2,5,74,5,12,0,79,0,'the future female': watch hillary clinton's first video statement since trump's inauguration
0,2,2,47,2,11,0,49,0,warcraft critical bomb summer. kinda liked it.
0,3,11,41,2,13,3,52,0,"zhou youguang, made writing chinese simple abc, dy 111"
0,1,4,24,0,4,0,28,0,fielder upstage pujols derby
0,2,5,26,0,6,0,31,0,former cia chief cut tie trump
0,2,8,27,1,7,0,35,0,george w. bush throw shade donald trump
0,2,2,64,1,12,0,66,0,family face reality possible budget cut killing program use yahoo
0,2,7,39,0,7,0,46,0,facebook ceo urge brazilian decry whatsapp block
0,1,6,63,2,9,0,69,0,uk elections: gordon brown offer resignation secure labour-liberal coalition
0,2,17,65,1,16,0,82,0,"sushmita sen make excellent point, say fantastic time actress film industry"
0,3,7,24,1,6,0,31,0,cher's thought tuba two tweet
0,3,15,73,6,13,0,88,0,man motivated 'self-investigate' #pizzagate conspiracy theory fire assault rifle inside d.c. pizza shop
0,3,3,36,1,7,0,39,0,"clarity promise mint digit, combined"
0,3,3,77,5,20,2,80,0,"pope warns eu 'risks dying' facing 'vacuum values', bloc mark 60th anniversary"
0,3,12,53,0,13,0,65,0,mma fighter break opponent endless barrage knee face body
0,3,2,30,2,5,0,32,0,peruvian santa gung-ho-ho drug bust
0,1,2,38,0,7,1,40,0,palestinian elect new president january 9
0,3,2,48,2,8,0,50,0,mayor want answer trump admin 'sanctuary city' policy
0,2,3,50,1,12,0,53,0,let thank super bowl giving u break frompolitics
0,1,6,21,1,6,4,27,0,nhl: detroit win 2008 stanley cup
0,2,13,56,1,12,0,69,0,"thanks adorable therapy donkey, little girl overcame speech disorder"
0,3,9,58,3,17,0,67,0,"timing could right maker monopoly barbie deal (mat, has)"
0,2,4,58,1,12,0,62,0,"sepp blatter may seek remain fifa president, source tell swiss paper"
0,2,19,55,3,18,0,74,0,"huge fan biryani, malaika arora khan's secret healthy living never skip meal!"
0,1,3,48,0,9,3,51,0,boeing 737 make emergency landing vnukovo airport moscow
0,1,2,34,2,7,0,36,0,"sarkozy say burqa ""not welcome"" france"
0,1,5,33,0,7,0,38,0,tiny island surrounded tension gulf
0,3,4,59,3,8,0,63,0,chapecoense crash: bolivian defence minister call plane disaster 'murder'
0,2,5,76,3,14,0,81,0,north korea threatens nuclear strike australia stop 'blindly toeing u line'
0,1,3,30,0,5,0,33,0,google prepares launch wifi service
0,1,8,47,1,10,1,55,0,scarponi win stage 6 giro; armstrong put finish perspective
0,1,3,43,0,5,0,46,0,german physical society demand nuclear disarmament
0,2,2,42,0,8,0,44,0,sanctuary city dig trump executive order
0,3,5,65,1,11,2,70,0,syrian-american poet amal kassir describes losing 10 family member syria bombing
0,2,13,47,1,12,0,60,0,salma hayek's dog crashed wedding cake story hilarious
0,3,3,60,2,8,0,63,0,lawsuit alleges mcdonalds overcharge cheeseburger value meal
0,2,2,46,0,8,0,48,0,alton tower denies shutting ride fallen clip
0,3,2,76,3,10,0,78,0,china 'abruptly cancels' australian delegation's planned visit human right criticism
0,3,13,52,7,16,2,65,0,r. kelly want drop 35 chapter 'trapped closet' 'r&b/hip hop' album
0,2,7,32,1,9,2,39,0,american dying average $62k debt
0,1,7,32,1,7,0,39,0,"yank laud attendance, seat sit empty"
0,1,2,47,0,5,0,49,0,haile gebrselassie announces retirement athletics
0,3,4,26,0,6,0,30,0,holiday season number video
0,1,5,29,0,6,0,34,0,bbc world service drop five language
0,3,10,50,0,11,0,60,0,two senate democrat put support behind neil gorsuch supreme court
0,2,2,60,3,17,2,62,0,know like care son microcephaly. child 53 year old.
0,2,1,59,0,12,0,60,0,ireland compensating woman forced travel abortion
0,1,2,47,1,10,2,49,0,"25 killed bus crash river gorge kashmir, pakistan"
0,3,2,28,1,3,0,30,0,northrop grumman's guidance miss
0,2,2,49,2,7,0,51,0,"senate confirms trump's pick defense, homeland security"
0,1,4,29,0,4,0,33,0,salmonella pistachio spur recall
0,2,4,52,0,9,0,56,0,otto warmbier dy day release north korean detention
0,1,6,37,0,7,0,43,0,u supreme court rule dc gun ban unconstitutional
0,2,5,63,1,11,0,68,0,"trump name lighthizer trade representative, tap penny adviser west wing"
0,2,16,70,1,15,0,86,0,dangal effect! phogat sister inspiring schoolgirl take amateur wrestling kerala
0,2,2,52,1,10,0,54,0,police: former student fathered son teacher killed
0,1,2,50,1,6,0,52,0,marine scientist say australia's blobfish face extinction
0,1,5,40,0,8,0,45,0,space shuttle endeavour return earth tuesday
0,3,17,25,7,12,0,42,0,t.i. drop 'do thing' feat. dj whoo kid dj mlk: premiere
0,3,8,24,0,6,0,32,0,attitude important iq
0,2,1,27,0,5,2,28,0,teenager denies murdering boy 15
0,1,8,34,1,8,0,42,0,"michigan, bank lends little bailout fund"
0,3,9,43,1,10,0,52,0,xi trump: china want peaceful solution north korea issue
0,2,10,33,1,8,0,43,0,alleged russian hacker among fbi's wanted
0,2,12,42,0,11,0,54,0,migrant tried sell wife rapist pay people smuggler
0,3,4,44,1,6,0,48,0,chapecoense plane crash: team awarded copa sudamericana
0,3,4,60,3,10,2,64,0,mick jagger: 73-year-old rolling stone frontman becomes father eighth time
0,1,2,31,0,5,0,33,0,wave kill two mediterranean cruise
0,2,3,78,4,17,0,81,0,"'obama perfect missed berlin, especially look trump insanity'"
0,1,10,49,3,9,2,59,0,"new orleans directnic offices, 'outpost crystal' visited 82nd airborne"
0,1,2,41,0,8,0,43,0,least fifteen dead stampede mali mosque
0,3,5,40,0,6,0,45,0,isi claim responsibility deadly baghdad blast
0,1,6,37,1,7,0,43,0,"digital casting, poised role beyond hollywood"
0,3,2,56,0,9,0,58,0,runner using strava create delightfully festive pattern
0,3,2,40,0,7,4,42,0,uk household downbeat finance since 2013
0,2,7,74,4,18,0,81,0,michael caine morgan freeman going style: 'people taken care of' video interview
0,1,7,33,1,6,0,40,0,class-action suit filed chinese milk scandal
0,2,2,36,3,5,0,38,0,kremlin spokesman: 'russia demonized'
0,1,1,25,0,4,0,26,0,hearse key thief spared prison
0,2,5,45,2,8,0,50,0,first u somali lawmaker get 'islamophobic threats' taxi
0,2,9,38,4,10,0,47,0,brexit isnt first fight gina miller mr. hedge fund
0,1,2,36,0,4,0,38,0,shot reported superdome evacuation
0,3,17,47,1,14,0,64,0,"jnu student drugged, gang raped afghan refugee met south delhi pub"
0,2,4,84,6,19,0,88,0,butlins ain't! bored brexit? feast eye (and weep envy) world's priciest holiday villa
0,3,3,51,1,11,0,54,0,"new michael brown video change outcome, expert say"
0,3,3,52,2,8,2,55,0,"demarcus cousin pick 18th technical, face one-game suspension"
0,2,1,23,0,4,0,24,0,sea dweller without state
0,2,10,41,0,10,0,51,0,american suv boom put sedan path forgotten minivan
0,1,6,34,1,6,0,40,0,"waiting madoff, angry crowd disappointed"
0,3,10,44,1,11,0,54,0,"fridge ruled oakland warehouse fire probe, sign arson"
0,1,3,47,0,9,0,50,0,radio host sacked threatened freedom speech hong kong
0,1,4,50,1,7,0,54,0,local council australia reject mcdonald's development plan
0,2,10,34,1,10,2,44,0,timeline tyga 21 savage's beef kylie jenner
0,2,10,48,0,9,0,58,0,aussie shunning bunny embracing easter bilby instead
0,2,12,62,7,13,3,74,0,blink-182 break forthcoming deluxe edition 'california': 'it's like whole album'
0,1,5,23,0,5,3,28,0,australia fire toll could exceed 200
0,3,7,62,2,13,2,69,0,remaining 27 eu country agree brexit guideline hollande say uk must 'pay price'
0,3,2,67,1,11,2,69,0,government estimate road crash costing australian economy $27 billion year
0,1,4,33,0,4,0,37,0,president delivers exhortation father
0,3,6,35,1,6,2,41,0,facebook messenger hit 1.2 billion user milestone
0,2,3,47,1,9,0,50,0,princess kate speaks loneliness motherhood yahoo
0,1,3,47,0,6,0,50,0,greenpeace demand chilean president create marine park
0,3,14,24,3,6,0,38,0,robert shiller: 'this market way overpriced'
0,3,7,44,6,10,0,51,0,"freedom caucus' jordan: end obamacare blaming, let get work"
0,1,6,32,0,7,0,38,0,italy seizes million asset four bank
0,1,6,55,0,10,0,61,0,canadian contacting pm stephen harper war afghanistan
0,3,7,32,3,9,0,39,0,trump: mike penny 'one hell good marriage'
0,3,11,48,0,11,0,59,0,woman wear chewbacca mask labor make giving birth epic
0,1,2,46,0,9,6,48,0,usain bolt break 200m 100m sprint record championship
0,2,11,50,2,12,2,61,0,san antonio spur honor tim duncan '21' sock retiring jersey
0,1,6,41,1,6,3,47,0,"connecticut beat marquette, giving calhoun 800th victory"
0,1,7,27,0,8,0,34,0,plant thrives used toilet
0,1,1,31,0,5,0,32,0,market dragged credit crisis
0,1,2,24,0,4,0,26,0,volcanic bulge found oregon
0,3,2,68,0,15,2,70,0,church england minister could work beyond age 70 ease recruitment crisis
0,1,2,23,0,4,0,25,0,hamas strike deal fatah
0,3,3,50,0,9,0,53,0,trump name carl icahn special adviser regulatory overhaul
0,3,2,47,1,10,0,49,0,monday motivation: word wisdom get week started
0,1,4,55,1,7,0,59,0,australian governor-general travel kuwait amidst terror threat
0,1,7,29,2,8,3,36,0,redstone get time pay $1.46 billion debt
0,3,5,47,4,11,0,52,0,"eu behaving 'like mafia' brexit, say nigel farage video"
0,3,10,44,2,9,0,54,0,trump clinton character appear 'american horror story'
0,2,8,36,1,9,0,44,0,"colbert ride trump wave, fallon tread water"
0,2,3,60,3,11,0,63,0,q&a: questioning politician special privilege select
0,1,5,51,3,9,0,56,0,"uk group liberty, edinburgh city council scientology 'cult' sign"
0,1,7,28,2,7,0,35,0,"location, location: still pay near"
0,2,7,45,0,8,0,52,0,mike krzyzewski sends bitmojis duke player personnel
0,3,7,44,1,7,0,51,0,airline industry expert approve uniteds policy change
0,2,16,37,2,11,1,53,0,"photos: trump end inauguration day way, dance 3 ball"
0,1,6,46,0,8,0,52,0,abc news anchorman peter jennings diagnosed lung cancer
0,1,5,34,0,5,0,39,0,irish enterprise exchange launched dublin
0,1,6,33,0,7,0,39,0,obama move undo rule abortion provider
0,1,6,45,0,7,0,51,0,australian labor party announces new climate change policy
0,1,7,37,2,7,0,44,0,"capital put trust varlamov, little-known goalie"
0,2,16,53,1,15,0,69,0,here's snap compare facebook twitter first day public company
0,1,2,71,0,12,0,73,0,russian passenger airliner make safe landing moscow concern gear damage
0,1,9,37,3,7,6,46,0,2007/08 uefa champion league: manchester united vs. barcelona
0,3,13,60,2,13,0,73,0,watch denzel washington get grilled classic movie line 'jimmy kimmel live'
0,2,5,53,1,13,0,58,0,week finance: change rba economy may shrunk
0,2,2,54,1,9,0,56,0,"kelly osbourne dish holiday plans, family tradition"
0,1,5,48,0,9,4,53,0,poland announces olympian 2008 summer olympics beijing
0,2,7,41,2,9,0,48,0,"jeff sessions, lifelong outsider, find inside track"
0,2,2,27,3,6,8,29,0,"drugmaker fined $100m hiking price 85,000%"
0,3,9,46,3,12,1,55,0,"matt kuchar hit hole-in-one masters, putting tie 3rd"
0,2,3,50,1,9,0,53,0,ahmadinejads run say state iranian politics
0,3,9,51,2,10,0,60,0,buffett's berkshire hathaway report rise net earnings fox business
0,3,10,59,1,9,0,69,0,christian leader denounce trump's hypocrisy ahead national prayer breakfast
0,1,5,48,1,9,0,53,0,"man jailed facebook murder case county durham, england"
0,3,8,41,1,8,0,49,0,watch key moment trump first solo press conference
0,2,2,54,2,10,1,56,0,"celebs, social medium star raise $1 million somali facing famine"
0,1,4,32,0,5,0,36,0,afghanistan woman protest shia family law
0,3,9,40,4,12,0,49,0,listen ed sheeran zion lennox's 'shape you' latin remix
0,2,11,54,0,12,0,65,0,tony romo join instagram hilarious video teaching young kid play
0,1,6,31,0,6,0,37,0,cuomo question merrill bonus
0,2,6,32,1,6,0,38,0,jennifer lopez alex rodriguez dating?
0,3,8,36,0,7,0,44,0,obama end automatic residency cuban migrant
0,3,12,52,0,13,0,64,0,red sox minor league club plan make tim tebow focus strikeout giveaway
0,3,9,39,1,9,0,48,0,soulja boy's plea deal allegedly includes toy gun clause
0,1,5,34,0,5,0,39,0,falling revenue threaten rebuilding iraq
0,3,3,69,1,11,2,72,0,company behind underwear maker duluth trading explodes 20% crushing earnings
0,3,7,40,1,9,0,47,0,danish doctor group want end circumcision boy
0,1,6,36,0,5,0,42,0,chrysler franchisees make case closing
0,2,7,28,0,8,4,35,0,unicef say 2016 worst year syrian kid yet
0,2,4,67,3,11,0,71,0,"hotel tax battle: florida court side expedia, priceline, travel company"
0,3,3,44,3,9,0,47,0,"trump cabinet, many general many generals?"
0,2,7,38,2,8,3,45,0,united statess $364 million humanitarian aid syria
0,3,4,57,1,9,0,61,0,"teach toddler transgender issues, national union teacher say"
0,1,2,42,1,8,2,44,0,"13 pilot whale returning sea, western australia"
0,1,5,48,2,13,5,53,0,2008 tour de taiwan stage 7: kam-po wong place first second time
0,3,10,48,1,12,0,58,0,"trump critic, nikki haley cast leading diplomat"
0,3,11,53,1,11,0,64,0,republicans' struggle replace obamacare feel like deja vu
0,3,3,48,0,9,0,51,0,trump name alexander acosta new pick labor secretary
0,3,5,28,1,7,0,33,0,picture kirk douglas year
0,3,4,26,1,4,0,30,0,inside jeanie buss' lakers takeover
0,1,8,30,2,7,0,38,0,taiwan take step forward u.n. health agency
0,2,7,80,1,14,0,87,0,barack obama us final press conference u president defend slashing chelsea manning's sentence
0,3,3,40,2,6,0,43,0,rory mcilroy 'bitterly disappointed' injury blow
0,1,3,29,1,7,0,32,0,"eu, china fail agree textile trade"
0,3,5,46,2,12,5,51,0,"daimler recall 75,000 mercedes-benz car uk due fire risk"
0,1,5,31,0,6,0,36,0,nato summit bucharest enters second day
0,2,5,37,1,9,0,42,0,hayden: russia worried war u
0,2,8,54,3,7,0,62,0,quebec terrorist attack: college student alexandre bissonnette charged
0,2,5,54,3,12,0,59,0,'the lego batman movie' pop-culture feast also give good batman
0,3,4,34,1,8,4,38,0,coolest health-tech product saw ce 2017
0,3,9,40,1,10,0,49,0,egypt risk interest gold tender centamin wont bid
0,2,5,66,2,14,0,71,0,"admit stockholm, donald trump right immigration sweden"
0,2,7,29,4,6,0,36,0,u.k. challenge: reconciling brexit aim
0,1,6,66,0,10,0,72,0,suspect madeleine mccann case robert murat confiscated possession returned
0,3,2,58,2,14,1,60,0,bernie sander call new health care bill tax break top 2 percent
0,1,4,41,0,8,0,45,0,u congressman sue obama military action libya
0,2,10,62,4,11,0,72,0,"bill kristol back deep state president trump, republican government breitbart"
0,2,6,44,0,10,0,50,0,justin bieber team rob gronkowski super bowl ad
0,3,11,49,1,9,0,60,0,well-funded founder changing feminine care industry
0,3,8,63,1,12,4,71,0,u election 2016 donald trump blast report he'll produce apprentice u president
0,2,1,32,0,6,2,33,0,62 dead ethiopia garbage dump collapse
0,2,10,41,0,9,0,51,0,la vega columnist quits ban writing adelson
0,1,2,27,0,4,0,29,0,eos airline file bankruptcy
0,1,5,31,0,5,0,36,0,marijuana smoke california cancer list
0,3,10,57,3,10,0,67,0,'tinderization nba' reportedly helping players' performance road game
0,3,2,63,1,13,0,65,0,assad said holding syrian boy heart-breaking photo house arrest
0,1,5,30,0,4,0,35,0,pristine african park face development
0,2,4,43,3,9,0,47,0,oil slides; focus turn canada fire u.s. stockpile
0,3,3,55,4,13,0,58,0,here's real data trump's twitter follower (who bunch eggs)
0,2,11,57,3,12,0,68,0,pavlich: 'dishonest' flynn never picked trump cabinet insider
0,3,10,52,0,12,1,62,0,anthony rizzo inspired cub game 7 world series naked speech
0,3,5,53,0,12,0,58,0,damon lindelof belief lost could return way star war
0,2,4,57,0,10,0,61,0,smithfield see north carolina meat operation back normal monday
0,1,1,42,0,7,0,43,0,skype apologises service go hour
0,2,15,64,4,17,0,79,0,first big company say serving legal marijuana trade? microsoft. new york time
0,1,2,28,0,5,0,30,0,typhoon kill two southern china
0,2,2,57,1,9,0,59,0,haunting photo show run-down abandoned silverdome become
0,3,4,44,0,8,0,48,0,mouse plane ground british airway heathrow flight
0,1,2,66,2,11,0,68,0,"arrival rainy season, perennial scramble zimbabwe seed, fertilizer"
0,3,5,39,1,11,0,44,0,angela merkel: must make effort eu love
0,1,5,33,0,6,0,38,0,chernobyl taking toll invertebrate
0,3,6,43,2,6,0,49,0,"inside ubers aggressive, unrestrained workplace culture"
0,2,11,44,4,12,0,55,0,"walden video game, challenge stillness new york time"
0,2,1,65,0,14,0,66,0,united plagued huge issue even dragging customer plane
0,1,5,37,0,8,0,42,0,nato troop kill four people bus afghanistan
0,1,6,34,0,8,0,40,0,obama resists call tougher stance iran
0,2,4,65,1,12,0,69,0,fortescue metal founder andrew forrest's luck turn iron ore price jump
0,1,6,60,3,8,0,66,0,"date set bradfield, higgins by-elections: australian electoral commission"
0,1,4,43,0,6,0,47,0,china successfully launch shenzhou vi manned rocket
0,2,3,52,0,11,0,55,0,james corden sting clash better singing waiter
0,1,5,51,1,7,0,56,0,"south carolina governor resigns gop post, explains disappearance"
0,1,3,32,0,5,0,35,0,palestinian arrested west bank raid
0,1,5,30,0,6,0,35,0,going beyond wave reshape surfing
0,1,3,44,0,9,0,47,0,state health care system sierra leone critical
0,2,4,55,0,10,0,59,0,larry cat claim festive spot downing street christmas tree
0,3,18,63,6,16,0,81,0,cnns mary katharine ham: im bothered suggestion ryan owen widow political prop
0,3,16,68,6,16,0,84,0,"prince harry, prince william dealing tragedy: talked enough mother [video]"
0,1,5,29,2,4,0,34,0,finding right point-and-shoot camera
0,1,5,53,0,8,0,58,0,nokia appoints microsoft business division head chief executive
0,1,10,34,2,11,0,44,0,bethpage black mastered (for day) club pro
0,3,1,42,2,8,5,43,0,"istanbul explosions: 38 killed, 155 wounded twin blast"
0,1,5,22,0,6,2,27,0,car bomb kill 16 baghdad market
0,3,3,44,1,8,0,47,0,turkey nightclub attack: say carried shooting
0,2,3,38,0,7,2,41,0,andy burnham lead labour race 53 nomination
0,2,7,47,2,8,2,54,0,"breaking: multiple explosions, 40 injured istanbul airport"
0,3,3,25,0,6,0,28,0,snap opened office china
0,3,2,40,1,8,1,42,0,fast furious 8 speeding box office record
0,3,10,57,3,10,0,67,0,o'reilly rip 'blatantly dishonest' medium coverage immigration raid insider
0,2,4,33,1,6,0,37,0,ad volume plunge bannons breitbartnews
0,3,5,29,1,8,3,34,0,every alert cnn sent trump's first 100 day
0,1,8,40,1,8,0,48,0,"italy agrees take migrants, ending standoff malta"
0,2,5,63,1,15,0,68,0,gop passage trumpcare one cruelest thing party ever done
0,1,6,38,0,6,0,44,0,marketing campaign put child mother first
0,2,6,35,0,6,0,41,0,central bank stockpiling foreign reserve
0,3,9,44,2,8,0,53,0,religious hospital pension clash accepted u.s. supreme court
0,1,3,27,0,4,0,30,0,search steve fossett continues
0,1,6,29,0,7,3,35,0,graham rahal prepares second indy 500
0,3,9,44,2,9,2,53,0,chicago police arrest 14-year-old sex assault shown facebook
0,3,6,28,2,6,0,34,0,wagyu world overrated steak?
0,1,8,47,1,7,0,55,0,"leaving israel, pope benedict offer stronger holocaust message"
0,2,15,52,2,13,3,67,0,shivaji memorial 210-metre-tall become tallest statue world
0,2,3,49,2,10,0,52,0,'orange new black' quickly becoming feminist classic
0,3,2,36,3,8,0,38,0,trump scrap nafta trade deal 'at time'
0,2,6,39,0,8,0,45,0,explosion firework market mexico kill dozen
0,1,4,25,0,5,0,29,0,liberty loses fever overtime
0,1,10,15,6,6,4,25,0,k.h.l. leader chides n.h.l. 2014 game
0,3,13,52,0,12,0,65,0,nypd allow officer wear turban beard religious reason
0,3,3,66,1,13,0,69,0,janet jackson confirms split husband month first child yahoo
0,2,12,52,2,11,0,64,0,tennessee kidnap suspect tad cummins allegedly planned flee u.s. girl
0,2,3,55,2,9,0,58,0,"trick persuading trump? flattery, proximity snappy pitch"
0,1,3,43,0,7,0,46,0,australian activist break pine gap spy facility
0,2,4,29,0,6,0,33,0,greece creditor head brink
0,2,4,30,0,5,0,34,0,paul ryan pressed planned parenthood
0,2,2,38,0,7,0,40,0,need stream thanksgivingweekend
0,2,10,55,1,11,0,65,0,british spy tapped king edward phone eavesdrop wallis simpson call
0,3,2,61,0,10,0,63,0,trump slam pollster survey buries sustained popularity clinton
0,2,5,73,3,13,0,78,0,tom brady explains bill belichick 'brainwashed' patriot well-oiled machine
0,1,2,35,1,6,0,37,0,world's oldest leather shoe found armenia
0,3,5,40,1,7,0,45,0,social scouting: nfl team track prospect online
0,2,3,62,0,11,0,65,0,singer craig strickland made lake succumbing hypothermia
0,1,8,44,2,8,0,52,0,kidnapper threaten kill u.n. official abducted pakistan
0,1,4,35,1,7,0,39,0,"west palm beach, florida plane crash kill four"
0,3,6,32,0,6,0,38,0,nick cannon spend christmas hospital
0,1,6,58,1,10,0,64,0,sprint/realnetworks provide cell phone internet radio podcasts u
0,3,12,49,2,12,0,61,0,"nfl jeff fisher discusses future coaching, desire play rams,"
0,2,11,42,1,10,0,53,0,mary tyler moore lobster tale show love creature
0,2,11,45,2,12,1,56,0,kanye west's yeezy season 5 debut new york fashion week: report
0,3,1,49,0,10,1,50,0,tennessee school bus driver indicted death 6 child
0,1,2,38,0,7,0,40,0,new specie dart frog discovered colombia
0,1,1,42,0,8,1,43,0,voyager 1 enters heliosheath edge solar system
0,2,3,53,2,9,0,56,0,tanna: yakel community's way life unchanged hollywood acclaim
0,2,9,45,4,11,4,54,0,"nona hendryx, wolf eyes, 'stranger things' set moogfest 2017"
0,3,9,38,0,10,4,47,0,brandon roy named 2017 naismith national h coach year
0,3,7,48,1,10,0,55,0,moab strike: u military defend use massive bomb afghanistan
0,1,5,60,1,9,0,65,0,david cameron miss prime minister's question father suffers stroke
0,2,3,47,1,9,0,50,0,donald trump's inauguration summed two tweet list
0,3,45,16,6,11,0,61,0,abc news public relation president donald trump first one-on-one...
0,2,2,54,1,11,4,56,0,eurovision 2017: ukraine warned show must go organising team quits
0,3,7,28,3,6,0,35,0,judging kendrick lamar's damn cover
0,2,5,53,1,13,1,58,0,u military's m1 abrams tank still king battlefield
0,2,5,61,2,11,2,66,0,"baby hospitalised using cancer council peppa pig 50+ sunscreen, mother say"
0,1,6,27,2,4,0,33,0,down-to-earth daly lived coaching dream
0,3,17,54,2,12,0,71,0,details: luke's wing help wounded warrior spend christmas loved one insider
0,2,4,46,2,8,2,50,0,islamic state militant kill 17 libya sabratha: official
0,1,4,23,0,6,3,27,0,491 scoreless minute come end
0,3,12,53,3,11,0,65,0,trump reportedly planning remove ban cia's notorious 'black site' prison
0,3,2,46,0,9,0,48,0,paris jackson open drug abuse suicide attempt
0,1,7,22,3,6,0,29,0,long line n.b.a. complaint desk
0,3,8,46,3,7,0,54,0,industry attract venture capital? [infographic]
0,3,12,49,2,11,0,61,0,"day collapse, minnesota gov. mark dayton say prostate cancer"
0,3,2,81,2,13,0,83,0,charity status: wealthy private school hospital deserve exemption paying income tax?
0,2,10,53,0,13,0,63,0,pope francis say better atheist hypocritical catholic
0,1,1,64,0,8,0,65,0,canadian judge strike marijuana possession law unconstitutional
0,1,8,32,1,9,0,40,0,"selling new deal, promising brief"
0,3,16,58,4,15,0,74,0,"who'll get sprawling bungalow, crore rupees, asset amma left without will?"
0,1,2,32,0,6,0,34,0,four russian store hit gas attack
0,3,17,47,5,14,0,64,0,"long wait, srk's 'zaalima' finally get chance promote raees india!"
0,3,2,69,3,16,2,71,0,"fascism helped create time zone oddity spain. 70 year later, may finally undone."
0,2,10,42,4,8,2,52,0,26 tweet prove #whatfeministswear anything f*cking want'
0,1,2,68,3,8,0,70,0,philippine's human right commission brand provincial capitol assault 'overkill'
0,1,1,53,1,8,2,54,0,israeli forensic institute illegally harvested organ '90s
0,2,13,36,1,10,0,49,0,milo burn gay pride flag unofficial trump ad breitbart
0,1,5,33,1,9,0,38,0,"city gridlock, lifeline scourge"
0,2,11,45,2,11,0,56,0,gronk reveals go sleevelessand need anymore
0,3,11,47,0,10,0,58,0,recent history lebron james calling cavalier teammate
0,3,12,40,2,10,0,52,0,everyone trying test john cena 'snl' monologue
0,3,6,21,0,5,0,27,0,future meme wholesome
0,2,9,37,0,11,2,46,0,ferrari catch fire pit stop 24 hour le man
0,3,10,47,1,10,2,57,0,school celebrates crossing guard who's served corner 50 year
0,1,6,27,2,4,0,33,0,"thinkpad, double-screened laptop"
0,3,2,43,1,8,0,45,0,color u sad: crayola retiring dandelion crayon
0,3,12,54,2,13,0,66,0,watch mcdonald's worker jump drive-thru help unconscious cop insider
0,2,15,60,2,11,0,75,0,viral sensation shirley caesar responds snoop music video #unameitchallenge
0,3,6,53,1,8,0,59,0,ireland supporter organise plane protest fais john delaney
0,3,1,44,0,8,0,45,0,building greenbelt land soared five year
0,2,14,40,3,12,2,54,0,cost ak-47 black market around world [infographic]
0,3,15,71,3,17,0,86,0,selena gomez talk bullied day disney channel: biggest high school world
0,1,5,49,1,9,0,54,0,"four us, eight afghan troop killed afghanistan attack"
0,3,6,35,0,6,0,41,0,turkish cargo plane crash kyrgyz village
0,2,8,62,2,11,0,70,0,fifty conservative mp challenge david cameron 'rigged' eu referendum rule
0,3,13,40,0,12,0,53,0,wild geode hair trend going instagram soon
0,2,8,44,2,7,0,52,0,heartbreaking death rock 'the vampire diaries' series finale
0,1,5,27,1,6,0,32,0,"honda brand, cinematic stroke"
0,2,9,39,3,7,0,48,0,digital disrupt: u.s. entertainment stock ride trump wave
0,2,8,46,4,6,0,54,0,germany arrest teen plotting 'islamist-motivated attack': cop
0,3,13,35,4,10,2,48,0,snap's two co-founders worth $5.3 billion ipo
0,1,2,23,1,5,0,25,0,inter lead race snap-up figo
0,1,6,40,0,7,0,46,0,sun retires sun industry standard source license
0,1,8,35,1,8,0,43,0,"tennessee house member win top job, loses party"
0,3,7,18,0,6,6,25,0,11 biggest ceo departure 2016
0,1,2,42,1,10,0,44,0,"ship sunk indian navy fishing boat, say owner"
0,2,10,57,1,10,0,67,0,gloria steinem refuse pay tax planned parenthood funding eliminated
0,1,5,35,0,6,0,40,0,shadow violence cling indian politician
0,3,18,51,3,12,1,69,0,centurylinkvoice: 6 tip making interactive voice response (ivr) work smb
0,1,3,29,0,6,2,32,0,british actress maggie jones dy age 75
0,1,2,56,2,11,1,58,0,"renault f1's team boss, top engineer quit team accepts cheating claim"
0,2,10,48,1,9,0,58,0,democratic trade union member warm donald trump's populist pitch
0,2,3,48,0,8,0,51,0,refugee germany fear backlash berlin truck attack
0,2,3,45,0,8,2,48,0,stolen chevrolet corvette returned owner 40 year
0,1,2,30,0,4,4,32,0,serbia condemns 1995 srebrenica massacre
0,2,9,46,3,9,3,55,0,sean spicer: session '100 percent straight' senate committee
0,1,8,35,0,7,0,43,0,new jersey native help italy defeat united state
0,3,3,45,2,8,0,48,0,"""last tango paris"" rape scene revelation spark outrage"
0,2,3,68,3,11,0,71,0,sydney-based professor 'heading back' australia murky flight ordeal china
0,3,6,54,0,13,0,60,0,jos mourinho say real madrid sign david de gea behind back
0,1,2,55,0,6,0,57,0,afghan presidential candidate abdullah withdraws election
0,2,7,42,1,8,0,49,0,pearson forecast year textbook gloom; sell penguin
0,1,5,52,1,9,0,57,0,police describe bloody evidence ny sen. monserrate assault trial
0,1,3,50,2,10,0,53,0,two veteran actor depart beleaguered soap 'days lives'
0,3,5,65,2,14,0,70,0,"toddler loaded car seat shot new year eve, authority kentucky say"
0,3,9,43,3,8,0,52,0,stallone sue warner bros. unpaid 'demolition man' profit
0,1,1,52,0,9,0,53,0,thai political talk show taken medium buyout attempt
0,2,6,41,4,9,3,47,0,"5 thing friday, march 16: wiretapping, north korea, africa"
0,1,2,32,1,5,0,34,0,"costa rican volcano erupts, alert issued"
0,1,5,30,0,6,4,35,0,sebastian vettel win 2008 italian grand prix
0,1,4,42,1,6,0,46,0,tropical storm carlos re-strengthens pacific
0,2,1,59,2,11,0,60,0,mercy plea priest's murder case come unlikely source: victim
0,1,7,35,2,6,0,42,0,"eli lilly, posting loss, cite imclone acquisition"
0,3,0,55,0,11,2,55,0,12 unstoppable woman making tech better place everyone
0,2,10,42,1,11,0,52,0,"may time foreigner buy japan stocks, goldman say"
0,2,1,56,0,7,2,57,0,edinburgh international festival celebrate 70th anniversary
0,3,7,26,1,7,0,33,0,best ernie johnson's visit espn
0,1,5,22,0,4,0,27,0,foe say law protects predator
0,2,5,46,3,11,2,51,0,ig report: tsa failed identify 73 worker 'linked terrorism'
0,3,1,58,1,9,0,59,0,wirral explosion: two people seriously injured suspected gas blast
0,1,2,36,0,7,0,38,0,mayor oslo resigns tax fraud scandal
0,3,9,34,1,9,0,43,0,los angeles home george lucas's new museum
0,3,15,59,2,16,0,74,0,teen throwing backpack guessed backpack challenge
0,1,5,36,0,8,0,41,0,making case climate migration driver
0,1,2,30,0,4,0,32,0,child virus outbreak reach beijing
0,1,7,27,0,5,0,34,0,winmx shut following riaa request
0,1,6,30,0,7,0,36,0,alcatel chief try paint rosy picture
0,3,10,47,1,10,2,57,0,forbes 30 summit music festival rock jerusalem's tower david
0,1,5,82,0,13,0,87,0,libertarian national committee fierce deadlock address growing bob barr controversy
0,3,9,58,1,15,0,67,0,would erase ex? bad memory could soon deleted mind good
0,2,12,56,4,11,0,68,0,"'no evidence' trump's wiretap claim, say top democrat intelligence committee"
0,3,3,61,0,10,0,64,0,tillerson kelly visit mexico amid tension deportation guideline
0,2,7,32,1,8,0,39,0,run family: musical sibling rock
0,2,7,36,3,7,0,43,0,watch lyric video linkin park's 'battle symphony'
0,1,5,37,0,8,0,42,0,asif ali zardari sworn president pakistan
0,3,7,29,2,6,0,36,0,job data show trump's challenge: pay raise
0,1,6,45,1,7,0,51,0,canadian pm announces funding us-canada bridge crossing
0,2,8,44,0,8,0,52,0,merkel face test closely watched saarland state election
0,2,2,51,1,7,0,53,0,fukushima: tenant rebuilding destroyed community
0,3,7,40,1,7,2,47,0,33 photo perfectly capture europe's tumultuous year
0,1,1,68,2,8,0,69,0,guinean military leader 'favourable' condition attempted assassination
0,3,11,46,1,10,0,57,0,saturn moon enceladus show sign could support alien life
0,2,11,48,1,11,0,59,0,brazil president michel temers senate ally hit new graft charge
0,1,2,50,1,9,0,52,0,"islamist militia driven mogadishu, vow keep fighting"
0,1,1,46,0,5,0,47,0,british police launch computer hacking investigation
0,3,8,32,0,7,0,40,0,crowdfunding took private equity
0,3,7,44,0,6,0,51,0,presidential commission sound warning botnet threat
0,1,3,55,0,11,0,58,0,parent terri schiavo sell list supporter marketing firm
0,1,6,36,1,7,0,42,0,"day layoffs, across industry continent"
0,3,7,48,1,12,0,55,0,part aca could eliminated gop health-care deal
0,2,9,53,2,13,0,62,0,here final version oculus rift insane new controller
0,3,4,43,0,8,0,47,0,consumer report name tesla top american car brand
0,1,6,30,0,5,0,36,0,house committee approves health care bill
0,1,2,43,0,5,0,45,0,dutch government collapse afghanistan troop
0,2,5,47,2,10,0,52,0,le fail: france loses biggest upset women's world cup history
0,3,2,37,1,9,5,39,0,"dow surge new high 21,000 trump speech"
0,2,6,64,3,13,0,70,0,"briton must unite 'divisive' brexit, theresa may say new year message"
0,2,14,52,3,13,0,66,0,ben carson: slave immigrant came worked really hard 'for less'
0,2,10,49,2,12,0,59,0,"reaching launch pad, rocket price may returning earth"
0,2,11,50,4,12,0,61,0,"mike penny firebombed gop office: act ""political terror"" breitbart"
0,3,10,66,0,15,1,76,0,mannequin challenge lot gun result 2 arrest marijuana weapon charge
0,1,5,48,0,6,0,53,0,australian national archive release loan affair document
0,3,12,37,0,9,0,49,0,bafta make big change ensure diversity movie
0,3,9,47,2,9,0,56,0,"blake griffin us kevon looney's head leverage, posterizes"
0,2,13,44,0,12,0,57,0,ikea giving employee four month paid parental leave
0,2,11,49,3,12,0,60,0,"trump threatens europe stability, top leader warns new york time"
0,1,2,32,2,7,4,34,0,"brazil's embraer plan cut around 4,200 job"
0,1,2,56,0,9,0,58,0,new jersey woman identified fifteen year psychiatric home
0,1,7,29,0,6,0,36,0,asia give metro economic storm
0,3,10,29,0,7,0,39,0,help nbc news propublica track hate crime
0,1,2,27,0,3,0,29,0,several earthquake shake nevada
0,1,2,38,0,6,0,40,0,scientist may test detect alzheimers
0,2,9,39,1,8,1,48,0,lebron james miss potential game-winning layup game 2
0,1,4,25,0,4,0,29,0,gang said contact politician
0,1,8,38,1,8,0,46,0,"despite red flags, judge ran kickback scheme year"
0,3,16,60,3,14,0,76,0,aaron paul recall breaking bad co-star jonathan bank helped court future wife
0,2,8,30,2,8,0,38,0,live! times: chicago rapper noname
0,2,16,58,3,15,2,74,0,"pc gaming, $32 billion industry, going change dramatically due new cloud technology"
0,2,14,43,10,11,0,57,0,"g.o.o.d. music's 'cruel winter' 'really done,' according cyhi prynce"
0,2,3,56,1,13,0,59,0,china move ban fentanyl could help curb drug addiction crisis u
0,2,21,58,2,15,0,79,0,jpmorgan chasevoice: usa rugby: igniting passion america sport loved around world
0,1,6,33,0,6,0,39,0,germany planning bigger stimulus package
0,1,9,43,1,7,0,52,0,four-run second help virginia eliminate cal state fullerton
0,3,10,33,1,9,0,43,0,"meet ian grillot, hero kansa barshooting"
0,1,2,45,0,7,0,47,0,israeli greenhouse preserved gaza pullout
0,2,10,50,1,10,0,60,0,inspiring america: homeless sister run gold brooklyn track club
0,1,6,28,0,5,0,34,0,gate reassures ally north korea
0,2,7,31,4,9,2,38,0,"ric marlow, 'a taste honey' songwriter, dy 91"
0,1,1,32,0,4,0,33,0,nauru hold parliamentary election
0,1,6,32,0,7,0,38,0,shanghai buy makeover fair
0,1,4,54,1,8,0,58,0,wikinews interview dr. phil klotzbach upcoming hurricane season
0,1,2,48,0,9,0,50,0,british army soldier court martialled war crime
0,1,5,28,0,5,2,33,0,boston celtic win 17th nba championship
0,1,7,25,0,6,0,32,0,barclays say seek bailout
0,3,7,42,1,6,0,49,0,stephen colbert mock kellyanne conway's microwave gaffe
0,2,10,44,0,9,0,54,0,disney film eerily similar due recycled animation
0,3,16,52,5,15,0,68,0,"pavlich: health care bill lower costs, gop 'own it' midterm insider"
0,1,2,60,2,12,0,62,0,"witness saw truck ""rev race"" recent texas oil refinery blast"
0,1,8,32,0,7,0,40,0,credit card processor say data stolen
0,3,3,59,4,11,0,62,0,'we arent rival friends': dortmund fan open home monaco supporter
0,1,2,29,0,4,0,31,0,pirate kill four american hostage
0,2,2,72,1,12,0,74,0,mexican politician climb border wall prove point trump immigration policy
0,1,5,50,0,8,0,55,0,international committee red cross condemns gaza blockade
0,2,8,38,3,9,0,46,0,israeli leader hail new era donald trump breitbart
0,3,1,53,0,8,0,54,0,judge halt deportation refugee ban cause worldwide furor
0,1,5,24,0,4,0,29,0,modifying mortgage tricky
0,3,5,47,0,8,0,52,0,white house plagiarized exxonmobil press release
0,3,10,69,2,10,1,79,0,"mastercard raise quarterly dividend, authorizes additional $4 billion stock buyback program"
0,1,8,28,1,9,0,36,0,"lose luggage must, wheel"
0,2,19,65,2,19,0,84,0,virat kohli new fan across border none wasim akram shoaib akhtar!
0,3,4,53,1,11,0,57,0,"president trump, first lady host governor dinner white house"
0,3,9,56,0,10,0,65,0,man charged killing saudi student gained international attention
0,1,4,50,0,11,0,54,0,republican aide fired trying hire hacker raise gpa
0,1,1,48,0,9,0,49,0,discovery shed light flow water carbon nanotube
0,1,4,43,0,8,0,47,0,oasis star noel gallagher assaulted stage toronto
0,1,4,18,1,5,4,22,0,"nortel cut another 3,200 job"
0,2,6,28,1,5,0,34,0,finding shelter trump's tweet storm
0,3,16,60,4,15,0,76,0,'molester' atif aslam concert actually security staff beaten 'victim'
0,2,14,60,3,12,0,74,0,"pm say demonetisation 'yagna' corruption, salute people patience"
0,2,1,68,1,9,0,69,0,"traumatised juvenile detainee higher risk reoffending, psychiatrist say"
0,1,5,48,2,8,0,53,0,baseball: oakland a's pitcher dallas braden throw perfect game
0,2,6,43,4,10,0,49,0,clemson qb deshaun watson: 'i'm best player country'
0,2,12,50,1,11,0,62,0,howard schultz stepping starbucks ceo focus higher-end shop
0,2,7,38,0,6,0,45,0,trump lower profile obama wiretap accusation
0,1,8,28,0,8,0,36,0,swiss may assume power break big bank
0,1,3,36,0,7,0,39,0,cooper claim learned plame rove
0,3,2,61,1,10,0,63,0,milan fashion week: gucci embrace brilliant absurdity fluid show
0,2,10,47,2,10,0,57,0,seattle seahawks richard sherman say 'karma' caught cam newton
0,3,1,22,2,5,2,23,0,uber lost $2.8 billion last year
0,2,9,58,2,14,3,67,0,ex-usa gymnastics ceo deposition sex abuse case delayed attend indy 500
0,3,1,57,0,10,2,58,0,pennsylvania mother hiked 26 mile save family describes ordeal
0,3,3,70,4,15,0,73,0,"'if true, get much bigger:' trump blast medium russia investigation"
0,1,3,48,0,7,0,51,0,massachusetts governor mitt romney seeking second term
0,3,5,66,2,12,0,71,0,"kristen stewart co-authored paper artificial intelligence spare time, nbd"
0,3,8,44,2,10,0,52,0,"bruce springsteen wont inauguration, music might"
0,1,5,54,1,11,0,59,0,yani tseng capture women's british open title record fifth major
0,2,10,41,0,7,0,51,0,nasa troubleshooting drill problem mar curiosity rover
0,2,13,55,0,12,0,68,0,syrian government opposition force agree attend new round peacetalks
0,2,2,66,2,18,0,68,0,apple let watch video tiny screen watch would want to?
0,1,4,41,3,7,0,45,0,"hospital declare ""code red"" wellington, new zealand"
0,1,4,27,4,9,2,31,0,french fry 'king' j. r. simplot dy age 99
0,1,4,39,2,7,0,43,0,say zimbabwean cholera epidemic 'past peak'
0,3,13,41,0,11,0,54,0,uber exec accused stealing ip google plead fifth
0,2,10,42,2,9,0,52,0,trump spox insists clinton never truly vetted
0,3,2,48,0,8,0,50,0,nasa image jupiter show planet unprecedented detail
0,1,2,48,2,9,0,50,0,"algerian teen fall death mecca; rape, murder suspected"
0,3,8,46,1,9,0,54,0,ukrainian central bank governor's future doubt rumor grow
0,1,7,33,0,7,0,40,0,cocaine trade help rebel reignite war peru
0,2,2,36,0,6,0,38,0,thousand flee mosul fear airstrikes
0,2,6,61,0,12,0,67,0,u navy strike group head toward korean water amid north korea nuclear threat
0,3,1,44,0,9,0,45,0,dog rescued meat farm begin journey new home
0,3,10,35,3,10,0,45,0,"kanye west join mary j. blige new song ""love yourself"""
0,1,1,43,2,5,0,44,0,"distributed computing get ""interstellar project"""
0,3,17,61,6,16,0,78,0,lularoe offering refund legging rip like wet toilet paper enough? [video]
0,1,6,31,0,7,0,37,0,oil industry ready work global warming
0,2,6,63,1,11,0,69,0,intel committee chairman: report russia meddling conflict dni testimony
0,2,1,19,1,4,0,20,0,color dress?
0,1,2,22,0,4,0,24,0,bombing iraq kill dozen
0,3,13,49,3,13,3,62,0,"'iron lady' irom sharmila loses first ever election, get less 100 vote"
0,3,7,28,2,6,0,35,0,split top box office third straight week
0,1,4,55,0,10,0,59,0,four uk retailer call administrator week christmas
0,3,16,54,2,15,0,70,0,"teen admitted made claim abducted raped ""three black males"""
0,1,2,44,0,8,0,46,0,snap election fails end political deadlock nauru
0,1,4,21,0,5,4,25,0,new york city dispute 2010 census
0,1,7,25,1,6,0,32,0,"job vanish, motel room become home"
0,1,7,38,0,10,0,45,0,voter narrow field two race mayor detroit
0,3,2,59,2,11,0,61,0,prince george attend private day school best friend 'banned'
0,3,4,35,0,6,0,39,0,painting politics whitney biennial
0,2,5,53,1,14,0,58,0,assad unleashed horror syria. eu must make deal
0,2,2,38,2,9,0,40,0,"whatever do, dont pee wall inpamplona"
0,1,6,45,5,12,6,51,0,"un: ethiopian gdp grew 1.7% 2009, may reach anti-poverty goal"
0,1,3,41,1,7,2,44,0,spanish newspaper co-founder carlos mendo dy aged 77
0,3,2,74,1,14,0,76,0,"somaliland, woman raped miscarriage result extreme drought"
0,2,7,36,1,7,0,43,0,alexander hamilton's letter auctioned nyc
0,3,2,65,2,13,0,67,0,"home recess, lawmaker face fiery town hall crowd trump, abortion"
0,2,4,63,0,16,0,67,0,russian jet fly close nato ship baltic sea show military force
0,2,2,77,0,19,0,79,0,max beagle dy lunging charging bear save owner walk yard
0,2,7,36,1,8,2,43,0,10 key moment thursday trump nominee hearing
0,2,4,28,0,6,0,32,0,defenseless face enemy
0,2,2,32,0,5,0,34,0,turmoil politico staffshakeup
0,2,19,54,3,17,0,73,0,"went shia labeoufs ""he divide us"" art installation honestly ablast"
0,1,11,37,4,9,0,48,0,u.s.g.a. agrees give ticket holder rain check refund
0,2,1,49,1,9,0,50,0,"hacker nabbed data every federal employee, union claim"
0,3,12,50,3,14,0,62,0,soon able play ariana grande 'final fantasy: brave exvius'
0,3,3,32,0,12,6,35,0,25 best place live u 2017
0,2,8,40,0,8,0,48,0,kathy griffin beheads donald trump bloody shock photo
0,1,6,30,1,5,0,36,0,green technology: sensor help save water
0,1,7,31,1,7,0,38,0,same-sex ruling belies staid image iowa
0,2,2,57,1,9,0,59,0,meet architect giving manhattan retail store refreshinglook
0,3,7,33,0,8,0,40,0,trump running white house like democrat
0,1,7,53,0,10,0,60,0,texas executes arturo diaz u supreme court refuse intervene
0,1,6,30,0,5,0,36,0,four animal right activist arrested
0,1,1,30,1,5,0,31,0,bird flu resistant anti-viral drug
0,1,6,35,0,5,0,41,0,matsuzaka sends cuba unfamiliar territory
0,2,11,48,1,10,0,59,0,steve smith join nfl network analyst: latest comment reaction
0,3,10,49,0,9,0,59,0,artist created image inspire change around abortionrights
0,2,11,38,2,10,3,49,0,bear vanish s&p 500 option put-call ratio baffle pro
0,2,10,46,0,9,0,56,0,woman reclaim street cairo stunning ballet photo
0,2,4,35,6,9,2,39,0,"bill paxton, actor 'twister' 'aliens,' dy 61"
0,2,1,44,2,7,0,45,0,lordes new heartbreak-fueled single surefirehit
0,1,5,35,3,9,0,40,0,un official: dr congo rape capital world
0,2,7,39,1,6,0,46,0,"affordable housing program cost more, shelter fewer"
0,3,10,37,0,9,0,47,0,rob gronkowski go wild camera wwe smackdown
0,2,2,41,0,7,0,43,0,missing ethan reunited father two week
0,3,2,54,1,10,0,56,0,eating disneyland's newest restaurant cost much rent
0,3,1,21,1,5,2,22,0,ford say profit fall 50%
0,2,2,64,2,17,0,66,0,"move over, vine people raking thousand dollar week new video app"
0,3,2,59,2,10,0,61,0,italy's anti-mafia squad overdrive asylum seeker flood europe
0,1,8,55,0,10,0,63,0,soldier iraq react cautiously obama deadline troop withdrawal
0,1,3,77,1,10,0,80,0,two unconscious drug-overdosed men discovered outside university canberra residence hall
0,2,6,23,1,5,0,29,0,one land populist arent
0,1,0,49,2,8,6,49,0,".asia domain application near 300,000 opening registration"
0,3,15,54,2,15,5,69,0,"bihar woman offering rs. 25,000 reward anyone brings back missing parrot"
0,2,8,46,2,9,0,54,0,"buck trade mile plumlee hornets' spencer hawes, roy hibbert"
0,3,6,42,3,10,3,48,0,mh370 'highly likely' north suspended search zone: atsb
0,3,10,53,3,11,0,63,0,mike pence: trump every right criticize branch government
0,3,3,55,3,10,0,58,0,syria war: u launch missile strike response 'chemical attack'
0,1,2,41,0,8,0,43,0,death toll six minneapolis bridge collapse
0,2,6,37,0,6,0,43,0,giant boulder damage truck california highway
0,3,4,51,0,7,0,55,0,jeff koons plagiarised french photographer naked sculpture
0,3,3,43,1,10,4,46,0,pac-12 boast four finalist wooden award trim list 15
0,2,9,45,1,9,0,54,0,"paris jackson join gisele bundchen, hadid sister img model"
0,2,12,53,0,12,1,65,0,least 4 dead train struck bus carrying senior citizen mississippi
0,2,2,42,1,8,0,44,0,"euro surges, yen dive french election fear abate"
0,1,8,48,1,8,0,56,0,"coach rich rodriguez, rebuilding effort michigan continues"
0,2,8,36,1,7,0,44,0,expect rex tillerson's state department
0,3,6,61,2,12,4,67,0,"blade runner 2049 trailer screen ahead alien: covenant, confirms ridley scott"
0,3,9,46,1,8,0,55,0,uber defies california regulator self-driving car service
0,3,5,61,3,10,0,66,0,mystery ancient egyptian leg likely solved: theyre queen nefertaris knee
0,1,3,48,1,8,2,51,0,thunderbird 1.0 mail user agent released mozilla foundation
0,2,13,39,3,9,0,52,0,"tsa roll new pat-downs, traveler say theyre invasive"
0,1,4,43,0,5,0,47,0,kanchi shankaracharya jayendra saraswathi custody
0,3,2,38,0,5,0,40,0,multiple arkansas execution blocked judge
0,2,11,42,1,10,0,53,0,tom brady post odd cartoon trolling texan fan pat win
0,1,2,28,1,5,0,30,0,"indian ocean tsunami, one year"
0,2,6,18,2,6,0,24,0,london fall? dare you!
0,2,6,32,0,7,0,38,0,netflix u twitter account hacked ourmine
0,3,5,86,3,16,0,91,0,"'unofficial strikes' contributing southern rail chaos, hr bos claim passenger warned major delay"
0,3,9,31,1,9,5,40,0,2017 nfl free agents: best player available week 3
0,3,3,14,1,5,8,17,0,30 30 2017: consumer tech
0,1,1,48,1,8,2,49,0,"20 dead, seventeen trapped chinese coal mine explosion"
0,3,2,23,0,5,0,25,0,motherhood time zika
0,3,9,54,2,11,0,63,0,fabric nightclub director say 'no pleasure relief' night reopening
0,3,16,51,4,15,2,67,0,"inspired ranveer singh's lady v ricky bahl, afghan man dupe u woman 60 lakh"
0,1,9,27,0,7,0,36,0,settlement appears likely ubs tax case
0,1,8,31,0,8,0,39,0,china aim dalai lama new tibet holiday
0,1,12,44,3,10,0,56,0,"rescue captain, u.s. sniper held steady despite many moving part"
0,1,2,43,2,7,0,45,0,detail emerge al-zarqawi's location pinned
0,3,3,57,3,12,0,60,0,"yes, italy constitution need fixing. urgently bank"
0,1,9,45,1,10,2,54,0,cern say repair lhc particle accelerator cost us$21 million
0,1,1,77,0,11,0,78,0,genius award recipient luminary campaigning worldwide renunciation war
0,1,4,38,0,7,0,42,0,suspected u drone attack kill eight pakistan
0,2,3,61,5,12,0,64,0,"""god made bulletproof,"" oft-shot rapper yung mazi tweet he's shot"
0,3,7,29,2,6,0,36,0,marc stein's pick nba all-star reserve
0,3,1,38,0,6,0,39,0,trump prepares critical week diplomacy
0,3,12,59,1,12,0,71,0,university creates space campus exclusively minority lgbt student insider
0,3,10,45,1,10,0,55,0,"lindsey graham joke michael flynn, devin nunes town hall"
0,2,5,77,3,17,0,82,0,"brexit (and maybe frexit), online map show funniest name use anyone else leaf eu"
0,1,6,24,4,6,2,30,0,"h.p. profit fall 17%, meet forecast"
0,2,5,66,2,11,0,71,0,poll analysis: theresa may extended honeymoon prime minister officially
0,2,7,79,1,15,0,86,0,one reason president donald trump changed rhetoric china? really like chinese president
0,3,18,46,7,12,0,64,0,watch: 'who gave manners?': russia's lavrov scold nbc's mitchell insider
0,3,11,42,2,12,0,53,0,"obama step back public life, trying avoid one word: trump"
0,1,3,40,1,8,0,43,0,"nursery harmful children, say new uk study"
0,1,3,36,0,8,0,39,0,woman killed amusement park ride new york
0,1,8,32,0,7,0,40,0,goodes earns first pro title champion win
0,3,10,43,3,11,0,53,0,lebron james 'humbled' si sportsperson year award yahoo
0,3,2,36,2,5,0,38,0,hollywood sign vandalized read 'hollyweed'
0,1,8,53,0,9,0,61,0,leader beyond reproach limit possibility political change
0,3,6,34,0,6,0,40,0,patent feud underappreciated risk biogen
0,1,8,34,2,10,1,42,0,"manuel, charge mets day 1, mull big change"
0,2,14,68,3,13,0,82,0,ranveer singh akshay kumar jamming 'hookah baar' absolutely entertaining unmissable!
0,3,4,50,0,10,0,54,0,math behind repealing replacing affordable care act
0,3,3,56,0,10,0,59,0,sculptor widely mocked ronaldo bust compare jesus
0,1,5,25,0,7,3,30,0,7 blast around baghdad kill least 24
0,1,8,35,3,9,0,43,0,"u.s. capacity prosper, obama volcker say"
0,1,3,69,1,14,5,72,0,"radical left computer activist capture data blood honour web forum 31,948 user"
0,1,6,35,0,5,0,41,0,porsche look restructuring vw relationship
0,1,3,36,0,6,0,39,0,law delay university minnesota strike
0,1,6,33,1,8,0,39,0,"sri lanka press rebels, mounting cost"
0,3,3,76,0,17,1,79,0,u added job major advanced economy combined past 7 year
0,1,5,57,1,10,0,62,0,wolfram research new product alpha compete google wikipedia
0,3,9,41,1,9,0,50,0,blackberry's bet software handset begin pay
0,3,10,43,1,13,0,53,0,know france: macron le pen appear headed runoff
0,3,10,52,1,13,3,62,0,ancient bacteria yield clue woman's dramatic cause death 800 year ago
0,1,4,53,1,8,0,57,0,radiation killed ex-spy alexander litvinenko found germany
0,1,7,31,2,6,0,38,0,tropical storm cindy threatens u.s. gulf coast
0,2,7,83,1,15,0,90,0,romania fed cup captain ilie nastase heard making derogatory comment serena williams' unborn child
0,2,1,55,1,10,0,56,0,illinois mother dy house fire saving newborn baby's life
0,1,3,22,0,3,0,25,0,british pm condemns walkout
0,3,6,24,0,6,0,30,0,trump force one ready takeoff
0,3,1,48,0,6,0,49,0,heartburn drug linked recurring superbug infection
0,3,9,41,2,9,0,50,0,shakira invite fan show 'chantaje' dance move
0,2,16,69,1,18,0,85,0,billie lourd share sweet throwback mom carrie fisher: voice forever head heart
0,3,8,33,1,10,0,41,0,"going knife, eye ear wide open"
0,3,25,59,8,14,0,84,0,"top republican senator: obamacare replacement plan 'can't pass' senate, gop 'pause, start over'"
0,3,3,61,1,9,0,64,0,one stock helped decimate billionaire bill ackman's hedge fund performance
0,2,1,86,4,15,4,87,0,"doctor's father make second epic journey daughter's memory snapping wrong penguin 8,000-mile trip"
0,2,8,50,0,9,0,58,0,lawsuit accuses michigan doctor sexually abusing young gymnast
0,2,10,48,1,11,0,58,0,updated look every team's cap situation heading free agency
0,1,3,45,2,11,3,48,0,two 10-year-old uk boy arrested alleged rape girl aged 8
0,3,1,71,1,15,0,72,0,state prison full ship inmate thousand mile away
0,3,2,19,2,5,5,21,0,"burger sell $10,000 dubai"
0,3,8,43,0,9,0,51,0,guide transgender bathroom directive trump could ax
0,3,10,36,6,9,0,46,0,volkswagen executive trip u.s. allowed f.b.i. pounce
0,3,2,37,2,7,0,39,0,voter fraud explained: here's need know
0,3,12,62,0,11,0,74,0,gujarat police high alert pakistani infiltrator cross border kutch
0,3,8,31,1,8,4,39,0,world's first malaria vaccine pilot run 2018
0,1,6,32,0,5,0,38,0,financial stock pull european market
0,1,2,45,2,9,2,47,0,20 year on: lockerbie victims' group head talk wikinews
0,1,3,38,1,6,0,41,0,"apple collecting location data iphone, ipad"
0,1,6,38,0,8,2,44,0,former japan prime minister kiichi miyazawa dy 87
0,3,1,42,3,12,0,43,0,'goat yoga' thing hundred lining
0,3,5,70,3,12,3,75,0,myer share surge: solomon lew's premier investment confirms 10.8pc stake department store
0,1,4,35,0,6,0,39,0,young quaker disappointed uk visa denial
0,3,4,12,0,5,6,16,0,17 artist watch 2017
0,1,4,76,0,12,0,80,0,inspector close chicago landmark healthy food restaurant finding dead mouse cooler
0,1,5,55,1,10,0,60,0,"reggae singer smiley culture dy police raid surrey, england"
0,2,4,59,4,11,2,63,0,heidelberg project: end road detroit 30-year-old street artwork
0,2,8,47,1,8,0,55,0,"jim harbaugh present pope francis michigan helmet, jordan"
0,3,1,37,2,7,1,38,0,exxon beat taking $2 billion write-down
0,2,1,51,0,8,0,52,0,fundraising regulator draw tough new rule charity
0,3,4,41,0,7,0,45,0,ivanka trump accosted jetblue flight passenger
0,1,3,25,0,4,0,28,0,jp morgan apologizes slavery
0,1,7,42,0,8,0,49,0,levi leipheimer inch closer tour california title
0,1,9,50,0,11,0,59,0,critic kyrgyzstan leader believed dead suspicious car crash
0,3,1,38,2,6,0,39,0,woman barred flight 'wearing leggings'
0,2,10,35,1,10,0,45,0,gold miner burned bad deal rushing m&a
0,2,5,68,0,15,0,73,0,britain first tried take gary lineker incredible response list
0,2,13,61,3,15,0,74,0,eric prydz release hopeful pryda track 'lillo' honor fan passed cancer: listen
0,2,1,60,1,16,0,61,0,world's first craft beer hotel want soak hot tub full beer
0,3,4,55,1,13,0,59,0,"look knockoff apple airpods, might soon able buy"
0,1,3,58,1,10,0,61,0,one year on: egyptian mark anniversary protest toppled mubarak
0,3,4,23,0,5,0,27,0,resurgent threat al qaeda
0,3,2,62,1,11,0,64,0,british man's attempt swim across atlantic slowed shark jellyfish
0,3,3,30,1,8,0,33,0,new music listen week: fedz
0,1,6,28,2,7,1,34,0,7 u.s. soldier linguist wounded iraq
0,2,3,34,0,6,0,37,0,deadly shark wash cyclone debbie
0,1,2,48,0,7,0,50,0,blair recognizes kyoto treaty stopped restriction
0,2,8,71,1,17,0,79,0,outrage italian judge clear man raping woman hospital bed scream
0,3,12,43,3,10,0,55,0,n. carolina stalemate bathroom bill ncaa deadline loom
0,1,7,33,0,7,0,40,0,obama selects steven chu u energy secretary
0,1,5,62,0,9,0,67,0,egyptian politician elbaradei say ousted president mubarak must stand trial
0,3,4,46,2,11,0,50,0,here's world reacted us' missile strike syria
0,1,2,51,0,10,0,53,0,uk animal welfare group prosecutes woman threw cat bin
0,2,10,35,3,11,0,45,0,wall st. lending main st. even many decry dodd-frank
0,3,3,31,0,8,0,34,0,russian plane crash black sea
0,2,3,39,3,10,0,42,0,"india v england, fourth test: day four happened"
0,3,3,50,1,12,0,53,0,detach van gogh action figure's ear give crush
0,2,3,44,2,8,2,47,0,poll: 55% american bothered russian election hacking
0,3,12,46,1,11,0,58,0,here like inside deadly oakland warehouse partyfire
0,2,2,51,0,9,0,53,0,facebook live update allows video streamed browser
0,3,2,59,3,12,1,61,0,trump claim obama first identified 7 country travel ban
0,3,11,46,4,10,0,57,0,"biloxi, mississippi, refers great american day instead mlk day"
0,3,14,64,3,15,3,78,0,"15 lakh registered company india, 9 lakh file returns! money laundering suspected"
0,3,3,45,3,6,0,48,0,tillerson: russia 'failure allowed syria chemical attack'
0,3,12,49,0,11,0,61,0,trump announces exxonmobil ceo rex tillerson secretary state pick
0,1,3,50,0,9,0,53,0,group claim activist held china free tibet protest
0,3,1,24,1,3,3,25,0,venezuela pull 100-bolivar note
0,1,7,35,1,6,0,42,0,cricket: india beat pakistan visakhapatnam odi
0,2,14,62,4,14,1,76,0,"coachella day 2 midday report: bank steelz bring rap-rock, sarah barthel join local native"
0,3,13,49,0,12,0,62,0,saving boeing job would much bigger challenge trump carrier
0,1,2,51,0,8,0,53,0,demonstrator clash police algeria slum protest
0,2,4,51,2,8,0,55,0,north korea missile test demonstrates limit u.s. intelligence
0,2,4,66,1,11,0,70,0,street beggar flown scotland sweden kind-hearted tourist christmas
0,3,1,60,2,10,0,61,0,french police arrest two 'attack plot' day presidential vote
0,1,1,40,1,3,0,41,0,uganda introduces anti-homosexual legislation
0,2,1,48,0,12,0,49,0,men eat lot red meat risk painful gut disorder
0,2,11,46,5,12,0,57,0,"antonin scalia, r.i.p. honor legacy foe judicial imperialism"
0,1,10,41,1,10,0,51,0,"bolt skip reebok meet, shadow eclipse rival"
0,2,9,43,1,8,0,52,0,keeper boston light reflects america first lighthouse
0,2,12,42,2,11,0,54,0,eat this: hot dog crust pizza hut popular specialtypizza
0,3,14,44,4,13,0,58,0,atlanta black history month: rare video martin luther king jr. wsb-tv
0,1,5,29,1,6,0,34,0,"korea advance together, unity"
0,3,6,45,2,8,2,51,0,beloved playstation mascot 'crash bandicoot' return june 30
0,1,9,31,2,8,0,40,0,florida leader want u.s. money fill budget gap
0,2,12,53,5,12,0,65,0,priebus: 'i know whether true' russia responsible election hack
0,3,6,35,0,5,0,41,0,fund manager reveal currency strategy
0,3,12,39,2,13,0,51,0,woman directed 'xx' ready scare crap
0,2,15,47,6,15,0,62,0,s.n.l. begin new season alec baldwin donald trump new york time
0,2,4,51,0,10,0,55,0,leigh heap pressure warrington gareth hock lead way
0,2,12,44,2,13,5,56,0,myles garrett reportedly expected browns' no. 1 pick 2017 nfl draft
0,2,10,48,2,10,0,58,0,"vladimir putin say syria cease-fire deal reached, hostility end"
0,3,7,70,3,12,0,77,0,trump's america donald trump: republican seek undo obama-era gun regulation congress
0,3,3,52,2,11,0,55,0,labor call overhaul 'mickey mouse' work dole course
0,3,3,43,1,11,0,46,0,"joining high court, real neil gorsuch set stand"
0,1,4,28,0,5,1,32,0,gorillaz nominated 5 grammy award
0,2,5,38,3,8,5,43,0,berkshire profit climb 15% $6.29 billion investment
0,3,5,70,3,15,0,75,0,trail blood: ari fleischer nearly caught fort lauderdale shooting
0,3,4,54,2,6,0,58,0,"trump administration dismisses, replaces obama-era surgeon general"
0,2,13,50,2,13,0,63,0,"degree debunked, melania trump website taken new york time"
0,3,6,52,4,10,0,58,0,whitney tilson trump's supporters: 'i think donald trump conned them'
0,3,1,38,3,7,0,39,0,monday briefing: 'shambles' asylum system
0,3,13,56,4,13,0,69,0,'mother bombs': u force drop massive non-nuclear bomb afghanistan insider
0,3,9,40,0,7,0,49,0,kendall jenner channel marilyn monroe love magazine
0,3,2,31,0,7,0,33,0,russian spy ship virginia coast
0,1,7,32,1,8,0,39,0,loud clear: sharapova back victory
0,3,1,66,1,10,0,67,0,"nighttime encounter lead unlikely friendship white cop, black teen"
0,2,6,44,0,7,0,50,0,revolution bandmates speak prince anniversary event
0,3,8,45,0,9,0,53,0,dolly parton start fund help victim tennessee wildfire
0,1,4,22,3,5,0,26,0,herman cain: simcity rumor 'a lie'
0,2,8,48,1,10,0,56,0,"raid illegal immigrant bring harsh memories, strong fear"
0,3,16,61,2,12,0,77,0,off-duty nypd detective accused peering children's window masturbating
0,1,3,37,0,6,0,40,0,new south wale water supply problem continue
0,1,3,29,1,6,0,32,0,"tree continue die houston, texas"
0,2,11,47,0,10,0,58,0,someone keep stashing bottle steak sauce around ohio library
0,1,3,56,0,10,3,59,0,yemeni passenger plane 153 people onboard crash indian ocean
0,3,12,41,1,11,0,53,0,dog maul owner tried dress sweater: police
0,1,5,33,2,7,0,38,0,vp cheney role surface u.s. domestic spying
0,2,15,56,0,14,0,71,0,mom adorably extra stage incredibly stunning baby shoot eachmonth
0,2,5,23,0,4,0,28,0,cohen shift damage control
0,2,16,73,0,19,0,89,0,isi fighter shoot chaos following uk missile drone raid jihadi target mosul
0,3,6,25,1,5,0,31,0,see romney jump trump's hoop
0,2,11,52,0,11,0,63,0,justin bieber make instagram return official flood new photo
0,1,6,26,0,6,0,32,0,irish developer found dead home
0,1,8,35,3,10,3,43,0,prince (27 points) scarlet knight turn back no. 2 seed
0,1,3,30,0,6,0,33,0,pope lift restriction latin mass
0,3,9,44,4,9,0,53,0,watch romeo santos perform 'heroe favorito' 'jimmy kimmel live'
0,1,6,40,1,10,2,46,0,un official: 90 rwandan rebel killed drc army troop
0,1,8,34,0,10,0,42,0,apple said talk sell iphone verizon
0,2,4,47,1,7,0,51,0,trump tap climate-change skeptic oversee epa transition
0,3,8,25,0,8,0,33,0,carrie fisher may known
0,1,5,33,0,5,0,38,0,executive barclays defend staff bonus
0,2,10,45,1,10,1,55,0,sony music ceo confirms apple's streaming service 1 day wwdc
0,2,4,62,1,8,0,66,0,"lgbt employee protected workplace discrimination, appeal court rule"
0,3,4,63,5,10,2,67,0,stockholm attack: suspect '39-year-old uzbekistan supported isi online'
0,2,6,50,1,9,0,56,0,"didi gregorius leaf wbc, return yankee shoulder injury"
0,2,5,48,0,12,0,53,0,army corp ruling big win foe dakota access pipeline
0,3,4,13,0,3,0,17,0,day picture
0,3,8,41,3,9,0,49,0,brightening bridge staten island video nytimes.com
0,3,1,53,1,10,1,54,0,japanese student feared dead avalanche; least 6 injured
0,1,6,26,0,7,2,32,0,abc news anchor peter jennings dy 67
0,1,6,37,0,9,2,43,0,mutated strain h1n1 virus detected u norway
0,1,4,28,0,3,0,32,0,racism conference adopts resolution
0,2,8,48,0,12,3,56,0,covering northern virginia family 6 take family 13 fire
0,3,13,50,1,13,2,63,0,"27 savage quote prove never fuck khlo, kourtney orscott"
0,3,8,41,4,10,0,49,0,review: encores! serf bathtub martini new yorkers
0,2,3,39,0,5,0,42,0,cambridge university professor lego proposed
0,1,2,50,2,8,0,52,0,india china discus energy: cooperation competition?
0,3,14,51,2,13,0,65,0,one iran's biggest movie star boycotting oscar trump's visa ban
0,3,20,47,5,12,0,67,0,mike made-it say kendrick lamar's 'humble.' beat originally gucci mane
0,3,3,44,2,8,0,47,0,"malaysia: poisoning kim caused paralysis, quick death"
0,2,1,32,2,8,1,33,0,furious 7 huge debut box office
0,2,17,45,3,16,0,62,0,one kyrie irving 'friends' tattoo say he's fan show
0,2,13,50,3,10,0,63,0,"morehouse college honor warner/chappell ceo jon platt, usher, tyler perry"
0,1,4,37,1,6,0,41,0,rugby union: noosa thrash caloundra caloundra
0,1,3,42,0,8,0,45,0,boy stop wearing brett favre jersey four year
0,2,2,41,1,7,0,43,0,jim boeheims successor got tired waitingaround
0,3,23,54,2,16,0,77,0,"pm modi call victory emergence new india, launch #iamnewindia pledge namo app"
0,1,8,47,0,9,0,55,0,senate vote add sexual orientation hate crime protection
0,2,10,51,2,14,1,61,0,"madonna gave world glimpse new twins, stella esther, 7 month ago"
0,1,3,49,0,9,0,52,0,civil defence thwart israeli air strike gaza refugee camp
0,1,5,26,1,5,4,31,0,alistair darling unveils uk's 2010 budget
0,3,9,35,5,10,0,44,0,"u.s. probably role mosul deaths, commander say"
0,3,5,25,3,7,0,30,0,vote: nba's best point guard?
0,3,2,59,1,14,1,61,0,body 2 pal went rocklahoma concert found; foul play expected
0,2,9,29,1,8,0,38,0,big sean kendrick lamar go wrong?
0,2,5,31,1,5,0,36,0,america heroin epidemic start mexico
0,2,12,26,2,5,0,38,0,gaffney: make america deterrent great
0,3,9,45,3,10,1,54,0,netflix reveal 'stranger things' season 2 release date?
0,2,4,23,2,8,8,27,0,fifa: french probe 2018 2022 world cup bid
0,1,2,47,1,8,0,49,0,bomb discovered toilet iranian plane; defused safely
0,1,6,38,0,6,0,44,0,chike okeafor brings fourth dimension cardinal
0,2,10,49,1,12,0,59,0,"vladimir putin, russia play smart round global martial art"
0,2,16,47,4,14,3,63,0,cnn's tapper: trump 'cramming like college kid' show something 100 day
0,1,3,39,1,7,0,42,0,clash france anti-condom speech pope
0,2,13,52,1,12,0,65,0,trump making america great again? american dream index keeping score
0,1,2,38,2,5,0,40,0,government 'concerned' situation ossetia
0,1,7,52,2,10,0,59,0,u.s. presidential candidate fred karger denied place fox news debate
0,1,7,43,0,9,0,50,0,u senate confirms robert gate new secretary defense
0,1,6,35,0,7,0,41,0,clinton pledge tough diplomacy fast start
0,1,2,46,1,8,4,48,0,"linux installed 2,460 desktop computer italian school"
0,1,5,46,2,8,0,51,0,"australian comedian ""could shot"" apec prank"
0,1,4,36,0,8,0,40,0,texas tech coach may move university miami
0,2,7,38,0,9,0,45,0,time sean spicer white house easter bunny
0,2,1,32,0,6,0,33,0,mixed fortune world clowning
0,3,2,48,2,8,0,50,0,target recall easter toy due 'serious ingestion hazard'
0,3,2,82,3,14,0,84,0,"punishment breaching entitlement 'like slapped wet piece lettuce', xenophon say"
0,3,3,67,5,14,0,70,0,"trump white house vow wont coddle rioter, looter, violent disrupter"
0,1,4,50,2,10,0,54,0,"man arrested slaying six-member family near tel aviv, israel"
0,2,6,54,1,8,0,60,0,peter falconio murder: girlfriend joanne lee find australian sister
0,2,4,56,0,9,0,60,0,recep tayyip erdoan urge speedy formation new turkish government
0,1,1,45,0,6,0,46,0,scientist suggest scaring toad limit population
0,1,2,22,0,5,2,24,0,mortar raid kill 15 somalia
0,3,18,67,0,17,0,85,0,people saying chelsea clinton never going happen honored magazine
0,3,7,79,2,18,0,86,0,that's one way get rid them! female dragonfly fake death escape unwanted male suitor
0,1,1,64,0,9,0,65,0,australia announces plan close five mainland refugee detention centre
0,1,1,51,1,7,0,52,0,austrian student protest new government's student fee plan
0,3,16,55,3,17,4,71,0,"fast furious film would caused r 3,400 cr damage stunt performed real!"
0,1,3,30,0,5,0,33,0,vanuatu pm accused assaulting envoy
0,3,10,56,6,11,4,66,0,"sale orwell dystopian classic 1984 soar trump claims, alternative fact"
0,1,4,19,0,4,0,23,0,buying high selling low
0,1,5,41,0,6,0,46,0,katrina conspiracy meteorologist quits idaho tv news
0,3,1,28,0,8,7,29,0,baltimore top 100 homicide far 2017
0,3,1,41,0,8,0,42,0,trump reportedly sign revised travel ban order
0,2,7,33,3,7,0,40,0,listen jidenna's debut studio album 'the chief'
0,1,7,32,2,8,0,39,0,inquiry graft iraq focus u.s. officer
0,1,5,24,0,7,0,29,0,fall rise right whale
0,1,7,41,1,6,0,48,0,attorney general challenge anti-bias law california
0,1,2,33,0,5,0,35,0,eleven dead belarus subway bombing
0,3,3,58,1,11,0,61,0,paul nuttall's stoke byelection paper gave address moved
0,2,12,41,0,9,0,53,0,sears rally ceo assures investor comeback plan
0,2,9,47,2,11,0,56,0,"myanmar bar rohingya fleeing, wont address plight"
0,2,3,37,3,7,0,40,0,"dollar, yield fall tepid u.s. economic data"
0,1,2,35,1,6,0,37,0,josef fritzl's former house demolished
0,2,2,46,2,8,0,48,0,trump going investigate voter fraud. happened?
0,2,2,48,0,10,0,50,0,shopper wear pyjama tesco given dressing
0,2,12,40,1,12,1,52,0,woman nominated directing oscar 7 year
0,1,3,33,1,6,0,36,0,sci-fi fantasy author andre norton dy
0,1,1,32,0,5,0,33,0,mississippi tornado kill least ten
0,2,1,49,0,10,0,50,0,oyster grown old toilet used clean citywaters
0,1,4,43,1,8,0,47,0,"delta flight make emergency landing jfk, injury"
0,1,5,51,0,10,0,56,0,san francisco mayor gavin newsom run governor california
0,1,4,29,1,4,0,33,0,religious freedom vs. sanitation rule
0,3,1,60,0,10,0,61,0,judge overturn abuse conviction man killed trial
0,1,3,29,1,4,0,32,0,belgium's queen fabiola seriously ill
0,1,1,37,0,7,0,38,0,iran continue work nuclear fuel cycle
0,3,4,62,3,14,0,66,0,tremendous loss giant ages: music legend pay tribute chuck berry
0,3,7,32,3,7,0,39,0,hear internet's syd float 'treading water'
0,2,12,37,0,9,0,49,0,gop oppo firm gearing possible sander nomination
0,1,8,23,3,7,0,31,0,word i.r.s. protest pastor
0,1,3,40,0,8,0,43,0,murderer dutch filmmaker van gogh get life term
0,1,3,31,2,5,0,34,0,lebanon: un resolution end conflict
0,3,12,52,3,12,0,64,0,"kansas' carlton bragg jr. get stuffed rim, fall failed dunk attempt"
0,2,3,49,2,13,4,52,0,two week till trump take office. time plan improve 2017
0,1,7,37,0,8,0,44,0,profit fall blackrock downturn real estate
0,1,5,31,1,5,0,36,0,"fitzgerald focus winning, talking"
0,1,8,29,0,8,0,37,0,calm judicial eye storm madoff bail
0,2,6,34,0,6,0,40,0,britain set historic brexit process motion
0,3,2,54,0,8,0,56,0,carrie fisher hospitalized suffering heart attack plane
0,2,6,58,1,14,0,64,0,donald trump state visit uk could moved london midland
0,2,4,33,1,6,0,37,0,u french elections: spot difference
0,3,11,49,5,11,0,60,0,o'reilly: hatred toward pres. trump reached 'dangerous level' insider
0,1,3,43,1,6,0,46,0,reason litvinenko's conversion islam revealed
0,2,4,22,1,6,2,26,0,top 10 player women's world cup
0,2,15,48,4,13,0,63,0,dhs draft report cast doubt extra threat travel ban national u.s.
0,3,13,44,2,15,0,57,0,"astronaut gene cernan go moon, took u"
0,2,7,23,0,6,0,30,0,dutch train powered wind
0,3,11,40,2,10,0,51,0,east eu cheap-labor growth model risk wage keep rising
0,1,6,60,0,9,0,66,0,united state justice department open investigation white house leak
0,3,5,48,3,10,0,53,0,"no, cat arent really taking westminster dog show [video]"
0,1,4,46,0,8,0,50,0,u investigator probe close call north carolina runway
0,2,2,65,0,13,0,67,0,nt family vow rebuild tattoo parlour gutted fire police say suspicious
0,2,12,52,2,11,0,64,0,elizabeth warren tell u can't even jamie dimon's mansplaining
0,1,3,31,0,5,0,34,0,ed stelmach elected new alberta premier
0,2,11,75,2,14,0,86,0,watch intense trailer christopher nolan's new wwii film featuring one direction's harry style
0,3,10,53,2,10,0,63,0,china lodge diplomatic protest trump's call taiwan's president
0,2,6,83,1,21,4,89,0,going roll hay? french farmer become latest profession strip racy 2017 calendar
0,2,12,44,4,9,0,56,0,all-glowed-up 'wizards waverly place' cast reunites wedding
0,3,5,25,1,8,6,30,0,year review: top 10 health story 2016
0,3,4,43,1,9,0,47,0,"schumer, pelosi among democrat react syria strike"
0,3,10,53,1,10,0,63,0,"prosecutor removed markeith loyd case received threats, noose mail"
0,1,5,26,0,6,4,31,0,felipe massa win 2008 turkish grand prix
0,3,7,38,0,8,0,45,0,dan coat expected named intelligence director
0,3,4,75,1,13,0,79,0,jack wilshere smash two glorious goal england slovenia: internet reacts
0,1,5,21,1,8,2,26,0,kodak lose 18% work force
0,3,8,32,3,7,0,40,0,ann coulter: let make russia sister country!
0,3,5,42,2,8,0,47,0,police link 'croydon cat killer' portsmouth pet death
0,2,4,40,3,9,0,44,0,"voice aleppo: bana, seven, escaped freedom"
0,2,13,58,1,12,1,71,0,microsoft's record stock price stumble failing beat revenue estimate q3
0,2,6,39,2,13,5,45,0,2015 nba final -- league admits missed call end game 2
0,2,4,70,7,13,3,74,0,here's make l.l.bean's '100% satisfaction guarantee' best return policy retailer
0,2,11,33,1,10,0,44,0,jay z's new venture fund come surprise
0,1,7,36,0,8,0,43,0,big east flex muscle backyard former member
0,1,7,25,1,6,0,32,0,"bleak afghan outpost, troop slog"
0,3,4,70,2,12,0,74,0,animal activist finally something applaud ringling bros. circus: closure
0,3,3,55,2,7,0,58,0,migration watch report criticised 'risking british livelihoods'
0,2,2,68,1,11,0,70,0,federal prosecutor brought charge case far less serious sessions
0,1,2,37,0,6,0,39,0,china establish protest zone olympics
0,2,11,33,1,9,0,44,0,free trade: nba deal could jolt playoff race
0,1,6,24,2,4,0,30,0,kyrgyzstan ratifies u.s. base accord
0,1,6,35,0,6,0,41,0,kyle busch dominates finally conquer bristol
0,3,12,42,3,9,0,54,0,"worldstarhiphop founder lee o'denat, aka q, died natural cause"
0,2,8,58,1,10,0,66,0,"ricky williams questioned, frisked police video alleged trespassing"
0,3,5,79,1,16,4,84,0,"eu migrant could allowed enter britain 2022, theresa may suggests free movement extension"
0,2,11,47,0,14,0,58,0,dog maul family one owner tried dress sweater
0,1,8,41,1,7,0,49,0,wave-powered monitor moving beyond listening whale
0,2,4,52,3,10,0,56,0,birth defect common zika-infected pregnant woman u.s.
0,2,13,77,9,15,0,90,0,"tom coburn: rubio trustworthy electable, cruz effective working others, trump carnival barker"
0,3,4,22,2,7,8,26,0,30 30 asia 2017: healthcare science
0,3,4,44,1,8,0,48,0,"president donald trump sign new travel ban, exempts iraq"
0,1,6,41,0,7,0,47,0,fernando alonso becomes new formula one world champion
0,1,8,36,1,9,0,44,0,upbeat sympathetic: fine line super bowl ad
0,1,2,58,0,9,0,60,0,hidden treasure worth billion dollar discovered indian temple
0,1,8,28,4,7,0,36,0,"u.s. confront, board, north korean ship"
0,1,8,32,0,8,0,40,0,tiny french town mourns triple loss jet crash
0,2,3,49,4,10,4,52,0,'battle orgreave': probe 1984 miners' clash policing ruled
0,3,8,50,2,11,4,58,0,andy murray vs. mischa zverev: score reaction 2017 australian open
0,2,9,52,0,10,0,61,0,human remains found former bon secours catholic orphanage ireland
0,2,6,57,3,13,0,63,0,kremlin tell russian medium 'no trump' us-russia tie begin fray
0,2,4,50,2,10,0,54,0,main question strike syria: russia respond?
0,3,3,48,0,8,0,51,0,public mobilizes save patron saint named fanny cornforth
0,2,2,64,0,13,0,66,0,elderly couple burn house christmas tree burst ball flame
0,2,4,35,3,6,0,39,0,hate trump supporters? hate liberals? here
0,1,7,35,1,7,0,42,0,"redskin sign haynesworth, pay top dollar"
0,2,3,48,1,7,0,51,0,fillon france election: party brings forward crisis meeting
0,1,8,48,2,9,0,56,0,"victory charge player championship, stenson, wood"
0,1,6,36,1,7,1,42,0,"pulled 2 directions, market finally break loose"
0,3,11,44,0,10,0,55,0,body cam footage capture moment cop saved woman burning car
0,1,6,22,1,6,0,28,0,body billboard: ad
0,2,4,58,2,10,0,62,0,"exclusive: obama, aide expected weigh syria military option friday"
0,3,9,43,0,8,0,52,0,house democrat inviting trump expand social security
0,3,6,61,1,15,5,67,0,fast furious 8: vin diesel go rogue new trailer released super bowl 2017
0,1,3,30,1,5,0,33,0,four body found florida's turnpike
0,2,2,82,4,9,0,84,0,"employer 'short-changing' australian worker withholding superannuation payments, report say"
0,1,2,41,1,5,0,43,0,run-off likely croatian presidential election
0,3,19,68,4,18,0,87,0,"turn 'mowgli girl' raised monkeys, abandoned parent mentally ill"
0,3,11,45,1,12,0,56,0,big sneaker brand turned lonzo ball surprise
0,2,2,47,0,5,0,49,0,trump administration proposes stricter obamacare rule
0,1,10,36,2,9,0,46,0,india fear pressure u.s. mend tie pakistan
0,2,4,56,2,12,0,60,0,claim mp lied kenya massacre 'may contempt parliament'
0,3,15,61,0,16,0,76,0,internet went wild photo appears show phil jackson riding public bus
0,1,5,45,1,7,0,50,0,former taiwanese president chen shui-bian released bail
0,2,10,60,1,13,1,70,0,lebron james triple-double lead shorthanded cavs past warrior nba final game 2
0,3,9,48,1,10,0,57,0,hundred company raise hand build trump border wall
0,1,2,50,2,8,0,52,0,microsoft offer pay blogger 'correct' wikipedia article
0,2,9,54,1,8,0,63,0,outfront: transgender activist creates nonprofit fund trans surgery
0,3,10,46,3,11,0,56,0,anderson .paak take u church gospel rendition come
0,1,7,28,3,8,0,35,0,"freed u.s., saudi becomes qaeda chief"
0,1,6,37,0,8,0,43,0,france lower tax entice diner restaurant
0,2,3,45,1,10,0,48,0,woman: different clinton take different era
0,2,2,56,1,13,0,58,0,trump cabinet shaping one whitest recent history
0,1,4,24,0,5,1,28,0,suicide bomber kandahar kill 8
0,3,5,47,0,8,0,52,0,brexit brexit force british jew seek german citizenship
0,1,7,28,0,6,0,35,0,perry see low score wet condition
0,3,4,65,4,14,0,69,0,"netanyahu back trump's mexico wall, tout similar one egypt border 'great idea'"
0,2,8,36,2,10,5,44,0,china's jobless rate drop 4% first time since 2002
0,1,1,37,0,5,0,38,0,french police search missing explosive
0,2,13,53,1,12,0,66,0,hundred queer people held guerrilla dance party outside mike pence's home
0,1,3,53,3,6,0,56,0,ahmadinejad pictures: iran gov't denies hostage-taker allegation
0,3,4,28,1,5,0,32,0,traffic jam nation crossroad
0,3,2,58,2,9,0,60,0,china's one-child policy explored stage show premiering melbourne
0,3,6,45,0,8,0,51,0,trump rescinds rule bathroom transgender student
0,2,2,72,1,13,0,74,0,kendrick lamar's lyric photoshop stretch mark sparking lot feeling
0,1,1,39,0,5,2,40,0,hiroshima mark 65th atomic bombing anniversary
0,1,3,26,0,3,0,29,0,adventurer steve fossett missing
0,1,4,30,1,7,1,34,0,tour de france: gert steegmans win stage 2
0,3,1,51,1,7,0,52,0,stunning aerial photo world's aquaculture operation
0,3,2,32,0,7,0,34,0,deadly attack london unfolded
0,1,6,47,0,9,0,53,0,alitalia conditionally accepts joint bid air france klm
0,3,3,36,1,6,0,39,0,kuki gallmann's kenya safari lodge burned
0,3,2,59,2,9,0,61,0,'disappearing' golden eagle spark murder mystery row scottish estate
0,2,13,66,4,15,0,79,0,anne gearan: clinton looked close hostage video answer email question breitbart
0,1,2,63,1,12,0,65,0,"uk motorway closed several hours, heavily congested due woman bridge"
0,3,5,70,1,15,0,75,0,"without fifth super bowl ring, tom brady already greatest quarterback ever"
0,3,5,37,2,8,2,42,0,"sandy gallin, hollywood agent producer, dy 76"
0,3,10,47,3,9,0,57,0,record rainfall close australian national park video nytimes.com
0,3,1,55,1,10,2,56,0,"22 beautiful building world, according architect"
0,3,7,61,0,14,0,68,0,uk pm theresa may reject petition would bar trump official state visit
0,1,2,28,0,5,0,30,0,many dead egyptian resort blast
0,3,6,43,1,7,2,49,0,ex-49ers legendary receiver dwight clark diagnosed al
0,3,4,52,0,9,0,56,0,new south africa finance minister gigaba call radical reform
0,3,7,50,2,12,3,57,0,"reporter clare hollingworth, broke news world war ii, dy aged 105"
0,1,2,40,0,9,0,42,0,death toll fatal fire croatia climb eight
0,2,4,81,2,20,2,85,0,"queen elizabeth power long, 4 5 uk resident alive ascended throne"
0,1,9,27,0,8,0,36,0,spain hail arrest man seen eta leader
0,2,5,37,3,6,0,42,0,former america next top model contestant killed
0,2,15,39,3,13,0,54,0,"ted cruz: yes, mitch mcconnell lied dont regret saying"
0,1,7,23,4,5,0,30,0,v.m.i. revived high-octane offense
0,2,7,77,5,20,1,84,0,planet earth 2: watch sir david attenborough's mic drop finale: 'a home u life'
0,2,10,39,3,14,1,49,0,"hate group number u.s. rose 2nd year row, report say"
0,2,12,37,4,11,0,49,0,u.s. gas 'pain train' may chug along spring fever grip bear
0,3,8,37,2,9,0,45,0,vacation over: obama return public life next week
0,1,6,60,0,13,0,66,0,nasa flyby saturn moon titan produce first image liquid another world
0,1,7,35,0,8,0,42,0,yankee rally biggest hit stay inside park
0,1,5,24,1,3,0,29,0,obama sign equal-pay legislation
0,2,7,39,2,11,2,46,0,bettor put $1.1 million falcon win super bowl
0,2,9,42,0,10,0,51,0,sending money overseas get faster bank pick winner
0,3,13,67,3,13,0,80,0,"akshay kumar's visionary idea come life, insurance scheme stuntmen stuntwomen launched"
0,1,4,44,0,6,0,48,0,australian foreign minister condemns fiji medium decree
0,3,1,35,1,5,2,36,0,massachusetts mattress conceals $20m cash
0,1,5,18,2,5,0,23,0,"two tough mets, what?"
0,2,10,58,2,10,0,68,0,swedish finance minister admits big problem economy migrant influx
0,2,11,51,0,9,0,62,0,faa investigating harrison ford plane incident orange county airport
0,1,3,30,0,6,0,33,0,un warns humanitarian crisis gaza
0,1,5,40,0,9,0,45,0,balancing freedom role state germany
0,2,3,71,0,14,0,74,0,house way mean chairman aim move tax reform bill committee spring
0,2,6,68,2,14,0,74,0,"food fight: beat china fakes, new zealand australian produce firm raid tech larder"
0,2,9,33,3,9,5,42,0,21st century fox $14.5 billion sky deal gain eu approval
0,1,4,49,0,9,0,53,0,landing space shuttle atlantis postponed due bad weather
0,3,12,51,0,11,0,63,0,vegetable opinion determine high low maintenance youare
0,1,2,42,2,8,0,44,0,la vega 'chili finger' woman history lawsuit
0,3,1,53,1,8,0,54,0,metro board committee advance plan late-night service cut
0,1,6,33,1,7,0,39,0,"iraq try prove autonomy, make inroad"
0,1,2,29,0,6,0,31,0,rule may bent launch discovery
0,2,7,36,0,9,0,43,0,sean spicer step comparing assad hitler
0,3,3,37,2,10,4,40,0,'carlos jackal' back trial 1974 paris attack
0,3,7,40,0,8,3,47,0,justin bieber impersonator accused 900 child sex crime
0,3,3,50,1,8,0,53,0,aleppo battle: hundred leave syria city evacuation resume
0,2,1,61,0,11,0,62,0,yelp right fire entitled millennial whined salaryonline
0,2,17,73,4,19,0,90,0,camila cabello writing music family's journey cuba: 'i want make love song immigrants'
0,3,6,33,0,5,0,39,0,museum acquire rare harriet tubman portrait
0,3,2,48,0,6,0,50,0,racism motivated trump voter authoritarianism
0,2,1,39,0,6,0,40,0,massive winter storm wreaks havoc traveler
0,1,4,25,0,7,2,29,0,chrysler tell 1 4 dealer close
0,1,3,40,0,7,4,43,0,welsh swimming squad named 2006 commonwealth game
0,2,9,39,0,11,1,48,0,kanye west unveil yeezy season 5 new york fashion week
0,1,5,23,0,5,0,28,0,hard sign reverse migration
0,2,3,73,1,12,0,76,0,moanas real life: samoan man teach daughter traditional pacific voyaging skill
0,2,2,40,3,8,0,42,0,"protesting trump sit-ins, sign thick skin"
0,2,2,52,2,8,2,54,0,heimlich manoeuvre: inventor life-saving technique dy aged 96
0,3,2,56,3,9,0,58,0,fort lauderdale shooting suspect's gun 'given back health tests'
0,1,2,31,1,7,0,33,0,mrs. dino sentenced one year prison
0,3,12,68,2,12,0,80,0,"scarborough: trump must come statement opposes assassinating journalists, rival"
0,2,19,49,2,14,0,68,0,derrick rose disappeared knicks game one knew (updated)
0,2,13,41,6,12,0,54,0,angela rye slam former rep. joe walsh: 'that's make bigot!'
0,1,5,65,3,11,2,70,0,philippine senate house representative probe p50-million drug bribe mess
0,1,2,45,0,8,0,47,0,annual rich list show ireland six billionaire
0,2,1,50,1,7,0,51,0,"trump protest intensify, doubt swirl spontaneity"
0,3,5,44,1,10,0,49,0,telecom policy tilt favor industry trump's fcc
0,3,12,54,2,11,0,66,0,"kansa bar shooting suspect allegedly asked victim ""status legal"""
0,3,13,42,2,12,0,55,0,could bought ticket donald trump's new year's eve party
0,1,5,32,0,6,0,37,0,afghan lawmaker accuse governor graft
0,2,5,64,0,11,0,69,0,sean spicer joke melissa mccarthy impression press briefing
0,3,2,49,0,7,0,51,0,waldorf astoria hotel closing transformative makeover
0,2,6,68,2,13,0,74,0,rosie o'donnell offer glimpse she'd look like playing trump adviser steve bannon
0,2,3,57,4,9,0,60,0,"here's hyperloop one's massive, high-speed transport system work"
0,3,5,47,3,10,0,52,0,tom hiddleston golden globe speech: 'my word came wrong'
0,1,4,47,0,10,0,51,0,selgros cash carry open two new store transylvania
0,3,3,43,0,8,0,46,0,trapped skier rescued cable car italian alp
0,3,6,31,2,5,2,37,0,21-gun salute honor queen elizabeth jubilee
0,1,7,30,0,8,0,37,0,davis cup open weekend full twist
0,1,3,36,0,7,3,39,0,strongest earthquake 150 year hit costa rica
0,3,7,52,1,14,4,59,0,golden globe 2017: la la land make history star take aim donald trump
0,2,7,73,2,11,0,80,0,'fake doctor' allegedly impersonated british rheumatologist sarang chitale slammed nh
0,3,5,30,1,7,4,35,0,trump raise million 2020 re-election bid
0,3,4,47,2,11,2,51,0,china cut gdp target 6.5% leader seek stability economy
0,2,4,31,5,8,5,35,0,"late-night tv host trump: 100 days, 99 problem"
0,3,9,43,0,8,0,52,0,tiger statue destroyed people kept mocking online
0,2,2,36,2,7,0,38,0,'hero' street dog india help catch criminal
0,1,5,46,1,8,0,51,0,sixth arrest warrant issued thailand's former pm thaksin
0,2,5,65,2,14,0,70,0,good news donald trump: strong majority still say russia didnt matter
0,2,10,48,1,12,0,58,0,"kushner flynn met russian envoy december, white house say"
0,2,3,33,1,8,6,36,0,"la county email hack expose data 750,000 people"
0,1,8,38,0,11,1,46,0,unusual strain swine flu found people 2 state
0,3,4,64,1,9,0,68,0,builtoncorp: wa homeowner hit builder placed voluntary administration
0,2,11,58,1,13,0,69,0,modern technology unlocks secret damaged biblical scroll new york time
0,3,3,36,1,7,0,39,0,holocaust: hunt million missing name
0,1,5,30,0,6,4,35,0,jenson button win 2010 australian grand prix
0,2,2,70,1,12,0,72,0,north carolina pass law letting official opt performing same-sex marriage
0,2,11,54,0,10,0,65,0,physically challenged minor girl raped young man inside jagannath temple
0,2,12,45,3,11,0,57,0,land air travel enough elon musk. he's going underground
0,3,8,66,1,14,0,74,0,really exercise: interactive body map reveals true risk lazy
0,1,1,46,2,11,2,47,0,iraqi gasoline cheapest world $.05 per gallon
0,2,12,54,0,13,0,66,0,wider political battle play fight supreme court pick neil gorsuch
0,1,3,37,0,9,2,40,0,jackass star ryan dunn dy car accident aged 34
0,2,9,30,3,6,0,39,0,ikeas open source sofa invite customization
0,1,6,31,1,7,0,37,0,"ogilvy let lead dwindle, finish top"
0,1,3,38,1,7,0,41,0,pirate seize greek-owned ship coast yemen
0,1,2,26,0,4,0,28,0,new zealand local loop unbundled
0,3,11,47,5,9,0,58,0,u.s. city microbrewery per capita? [infographic]
0,2,12,49,6,11,0,61,0,hannity: left's 'crybaby freak-out' mind-numbing level insider
0,3,12,50,1,12,2,62,0,b1a4 get intimate fan spotlight musicality new york concert return
0,1,2,47,0,9,0,49,0,israel seizes ship claimed carrying weapon gaza
0,1,10,33,3,8,0,43,0,many government knew week ago a.i.g. bonus
0,1,4,54,1,11,0,58,0,"spanish trawler missing, three die uk storm hit northern europe"
0,2,9,48,2,11,0,57,0,wedding photo becomes symbol s. korea mers scare business insider
0,1,4,50,1,6,0,54,0,counting continues nepal's constituent assembly election
0,2,13,51,2,12,0,64,0,katy perry make political statement 'persist' armband grammys
0,3,2,33,0,5,0,35,0,speaker consider position
0,3,10,43,5,10,0,53,0,"neo-nazi posting, police whitefish, mont., step patrol"
0,2,4,52,1,13,0,56,0,billy bush: man egging trump tape groping woman
0,2,6,43,1,10,0,49,0,new yorkers rushing divorce new yearsday
0,2,3,57,0,12,0,60,0,border wall talk lead top mexican official float american entry fee
0,1,6,25,0,5,0,31,0,steelers holmes admits sold drug
0,2,8,42,0,10,0,50,0,escaped murderer sweat matt remain run third day
0,3,10,54,0,10,0,64,0,steve harvey absolutely destroyed social medium meeting trump
0,2,6,40,2,9,0,46,0,"morning brief: trump talk north korea china, japan"
0,2,1,45,0,9,0,46,0,sick boy asked stuffed cow receives whole herd
0,2,13,48,2,10,1,61,0,nyt: 5 woman took settlement accusing oreilly sexual harassment
0,1,1,33,0,5,0,34,0,somalia food hijacker make new demand
0,2,10,55,2,13,1,65,0,"kalief browder, held rikers island 3 year without trial, commits suicide"
0,3,2,55,1,10,0,57,0,lobbyist like manafort want register foreign agent
0,1,8,40,1,8,0,48,0,"austin meeting, seeking exposure new tech product"
0,1,6,20,3,6,0,26,0,cheer marta debut w.p.s.
0,1,11,57,1,13,0,68,0,"yankee finally play ball rules, enabling fan get close batting practice"
0,3,2,76,0,10,0,78,0,disturbing video capture united passenger forcibly removed overbooked flight
0,3,12,57,5,13,0,69,0,dj black coffee discusses drake's use global genres: 'he's investing culture'
0,1,7,47,0,9,0,54,0,questioning role politics secrecy kenyan election poll
0,2,12,46,5,10,0,58,0,bernie sanders: donald trump 'has endangered' u.s. job carrier deal
0,2,1,77,1,10,0,78,0,google ordered explain taxpayer-funded advert appear alongside extremist material
0,1,4,37,1,7,0,41,0,john reid: iraq radicalise muslim youth
0,3,4,33,2,6,0,37,0,"brian fallon: sean spicer lied, resign"
0,1,4,24,0,4,0,28,0,starbucks sell instant coffee
0,1,2,66,0,12,4,68,0,captain four shipping company face legal action 2009 australian oil spill
0,2,6,34,2,5,0,40,0,"storm batter sydney, australia, causing flood"
0,1,5,30,0,5,0,35,0,housing construction fell march
0,1,4,31,0,4,0,35,0,pettitte maintains composure victory
0,1,4,31,1,3,0,35,0,malaysia: premier announces resignation
0,2,5,57,1,10,0,62,0,thunder ene kanter london detainment romania politics
0,2,6,57,3,12,2,63,0,brexit ruling: mp 'could stop eu withdrawal even article 50 triggered'
0,3,8,46,3,12,0,54,0,"'the fate furious', one jason statham becomes mvp"
0,2,8,54,0,8,0,62,0,texas teacher arrested allegedly recording student undressing
0,1,7,34,0,6,0,41,0,house look secret withheld congress
0,1,7,36,0,8,0,43,0,cycling ready use blood profile fight doping
0,1,3,38,0,6,0,41,0,underwater volcano erupts pacific near japan
0,1,6,34,0,6,0,40,0,obama directs regulator tighten auto rule
0,2,8,39,0,11,0,47,0,ann coulter verge pulling speech berkeley
0,3,9,42,0,11,0,51,0,chrissy teigen play santa claus give fan best gift
0,2,2,40,0,6,0,42,0,government back driverless car trial london
0,3,1,47,0,7,0,48,0,former white supremacist help others leave hate group
0,2,1,50,1,10,2,51,0,alaskan dive 32-degree water annual polar plunge event
0,2,1,40,1,10,0,41,0,"woman paid teen sex, let booze smokepot"
0,3,5,46,1,10,0,51,0,"duke, duchess harry cheer london marathon runner"
0,1,6,34,1,10,0,40,0,"closing roof new era, better worse"
0,1,7,33,0,8,0,40,0,capuchin monkey pick right tool tough nut
0,2,7,36,0,9,0,43,0,aaron gordon picasso slam dunk contest
0,3,4,29,0,5,0,33,0,jerramy stevens defends wife hope solo
0,1,4,68,1,13,0,72,0,"wreckage gas tanker removed crash onto railway line county durham, england"
0,1,7,28,0,7,0,35,0,aide say pardon libby irked cheney
0,3,2,53,0,9,0,55,0,mass grave young child found former catholic orphanage
0,3,4,67,4,13,0,71,0,"lawmaker retweeted offensive post womens march. day later, resigned."
0,3,13,63,4,13,0,76,0,univisions ramos: trump effect scaring illegal immigrant away entering u
0,3,4,38,4,8,4,42,0,"trump declares victory: sprint create 5,000 u.s. job"
0,3,3,26,2,7,0,29,0,iran lift ban u.s. wrestling team
0,1,6,25,0,7,2,31,0,tar heel step gingerly round 16
0,3,9,39,1,10,0,48,0,riddle hitler didnt use sarin gas remains unsolved
0,1,4,28,0,6,4,32,0,waterboarding used 266 time 2 suspect
0,2,11,63,3,14,0,74,0,schumer: trump want put america first label china 'currency manipulator'
0,1,7,28,0,7,0,35,0,israel say action gaza war crime
0,2,10,46,1,9,1,56,0,2 million resident war-ravaged aleppo without running water
0,3,14,58,1,12,0,72,0,j&k ban usage loudspeaker firecracker government private function
0,2,5,86,2,21,0,91,0,theresa may set 'brexit vision' warn uk quit single market given control border
0,3,2,73,1,10,0,75,0,"gaza sister caught smuggling explosive labelled medicine, israeli authority say"
0,3,3,29,4,6,0,32,0,tiger woods: 'i'll never feel great again'
0,1,1,42,2,6,0,43,0,"lizard capable problem-solving, study show"
0,1,2,37,1,8,3,39,0,world's oldest person dy california age 115
0,3,4,55,3,13,0,59,0,"affordable care act remains law land, trump vow explode"
0,1,8,28,0,6,0,36,0,uk cable tv operator ntl acquires telewest
0,1,3,48,0,6,0,51,0,southampton city council vote water fluoridation
0,2,10,28,4,8,0,38,0,mariah carey drop new yg collab 'i don't': listen
0,3,14,61,2,15,1,75,0,pulitzer prizes: daily news propublica share public service award; new york time win 3
0,1,1,51,0,5,0,52,0,australian government considers controlling fuel supply
0,2,1,48,1,8,0,49,0,"woman assaulted forced car, sparking police chase"
0,1,1,22,1,3,0,23,0,swine flu worldwide: update
0,1,5,30,0,5,0,35,0,security net wrap capital inaugural
0,3,10,30,1,8,0,40,0,behind gm's sudden change heart rental car
0,3,4,40,2,10,5,44,0,"18,000 call illinois gop congressman's phone town hall"
0,2,3,32,1,4,0,35,0,unilever reject kraft heinz mega-merger
0,2,12,44,0,11,0,56,0,adele sings tribute victim london terror like adele
0,1,3,34,0,5,0,37,0,hurricane richard make landfall belize
0,3,1,63,0,15,1,64,0,brain implant help paralyzed man drink coffee 1st time year
0,3,8,44,1,9,0,52,0,peru floods: woman climb rushing floodwaters safety
0,3,5,43,0,12,0,48,0,north sea oil company trap oil could run cash july
0,2,10,48,1,9,0,58,0,"cyclone debbie slam australia, knocking power thousand"
0,3,10,41,3,9,0,51,0,carrie fisher reportedly appear 'star wars: episode ix'
0,2,5,62,0,11,0,67,0,treasury secretary steven mnuchin say tax reform unlikely happen august
0,1,2,54,0,8,0,56,0,macedonia say compromise greece name dispute possible
0,2,1,58,1,8,0,59,0,drug-resistant superbug may widespread previously known
0,2,6,42,2,7,0,48,0,victoria beckham join james corden 'carpool karaoke'
0,2,8,33,0,7,0,41,0,world cup player reached peakbadass
0,2,10,46,0,9,0,56,0,police investigating black student burned hot gluegun
0,3,10,53,0,11,0,63,0,deal kushners chinese company fifth avenue skyscraper
0,2,4,53,0,8,0,57,0,bipartisan call conway investigation ivanka trump plug
0,3,1,43,0,5,0,44,0,calgary zoo investigating penguin drowning death
0,3,15,61,5,11,0,76,0,"russell westbrook shatters another triple-double record, hears ""mvp!"" chant magic fan"
0,2,11,47,1,10,0,58,0,russell westbrook partner nba make high-end frame team
0,1,6,33,0,7,0,39,0,fed cite easing decline affirms policy
0,2,4,25,5,4,0,29,0,rfk jr.s deadly anti-vaccine gospel
0,2,2,41,3,8,5,43,0,"michigan, flint replace 18,000 lead-tainted water line"
0,2,11,42,1,10,0,53,0,alt-j talk chasing excitement magic confident new album
0,2,3,52,0,8,0,55,0,della famina sell hampton newspaper billionaireinvestor
0,3,2,29,0,6,0,31,0,janet jackson give birth baby boy
0,3,11,48,2,10,0,59,0,kel mitchell announces baby news adorable tribute 'good burger'
0,3,6,36,1,8,4,42,0,fifth harmony perform 2017 people's choice award
0,3,4,67,1,11,0,71,0,"remarkable exchange undocumented mom, paul ryan expose cruelty trumpism"
0,3,8,29,1,10,8,37,0,12 linkedin's 20 promising 2017 job tech
0,2,3,41,1,5,0,44,0,gay-club shooter considered attacking disneyworld
0,3,2,58,0,11,0,60,0,amanda seyfried among several star private photo leak online
0,2,3,53,5,9,0,56,0,samantha bee call ohio's 'heartbeat' abortion bill 'illegal crack'
0,3,10,49,1,9,0,59,0,cam newton rock floral shirt-short combo coachella music festival
0,3,6,31,1,8,0,37,0,looking back new year eve time square
0,1,5,29,1,4,0,34,0,princess beatrice's unlocked bmw stolen
0,2,4,13,0,3,0,17,0,bikers rally waco
0,3,10,38,0,9,0,48,0,mayim bialik adorably clueless come dating
0,3,5,25,1,5,0,30,0,new hotbed tech startups: europe
0,3,8,46,0,7,0,54,0,african union readmits morocco three decade withdrawal
0,1,2,59,1,10,4,61,0,"scottish archaeology student discovers 5,000 year old chewing gum finland"
0,2,2,41,1,9,0,43,0,trump make good pledge prosecute leaks?
0,3,2,55,1,10,0,57,0,brazilian police say greek ambassador killed wife's lover
0,3,12,44,2,9,0,56,0,"montee ball open alcoholism, nfl, college football career"
0,2,8,38,0,10,0,46,0,top scientist urge trump abide iran nuclear deal
0,3,2,40,1,8,0,42,0,man find long-lost brother chance noosa cafe
0,2,7,40,4,8,0,47,0,"shareef o'neal, son shaquille o'neal, commits arizona"
0,1,7,60,2,8,0,67,0,"ntsb continues investigation near-collision pennsylvania, united state"
0,3,11,49,1,10,0,60,0,womens march organizer calling people boycott company
0,2,15,45,1,11,0,60,0,business giant poured cash gop super pac election's final day
0,3,4,73,2,12,0,77,0,"ptsd symptom go beyond psychological, sleep apnoea irritable bowel syndrome: study"
0,3,12,52,0,12,0,64,0,japan want keep trade hardliner wilbur ross away economy talk
0,2,6,58,1,11,0,64,0,referendum result may lead nowhere italy's five star northern league
0,3,6,49,2,10,0,55,0,"howard stern say donald trump ""still want hillary clinton win"""
0,2,2,57,1,10,0,59,0,"trump bar door refugees, visitor seven mainly muslim nation"
0,1,7,39,0,10,0,46,0,son former u vp al gore arrested drug possession
0,2,3,44,1,10,0,47,0,meet eccentric designer met gala newmuse
0,1,7,32,0,7,0,39,0,joint action needed heal world economy
0,3,5,55,1,9,0,60,0,"jrue holiday voice appreciation support lebron james, others"
0,2,2,69,2,12,0,71,0,trump secretary state candidate say russian hacking report might 'false flag'
0,3,8,42,0,9,0,50,0,early china data show economy firmer footing december
0,2,2,45,0,8,0,47,0,teen rockville rape case contends sex consensual
0,3,4,62,5,15,0,66,0,'the walking dead' back february here's preview return
0,3,15,56,2,14,0,71,0,good news! india first ever virtual reality cinema mumbai open booking
0,1,4,52,3,8,0,56,0,kai-fu lee: developer rule next-generation internet world
0,1,3,49,2,8,0,52,0,"bus crash victoria, australia injures twenty, critical"
0,3,1,57,0,11,0,58,0,closest comet decade share sky lunar eclipse weekend
0,3,10,53,4,12,0,63,0,sander trump's nuclear race: congress must stop 'tweeter chief' insider
0,1,12,48,4,9,0,60,0,"three goals, midfielder power second-string u.s. lineup past sweden"
0,1,7,34,1,6,0,41,0,gazprom put positive spin first-half result
0,1,4,49,1,9,0,53,0,"transgender woman hired city manager lake worth, florida"
0,2,12,41,1,11,0,53,0,mariah carey rough time new year eve performance
0,2,9,47,1,8,0,56,0,suspected orlando cop killer wearing bulletproof vest: police
0,2,11,70,0,12,1,81,0,patrick beverley investigated reportedly confronting thunder fan rocket game 3 loss
0,2,12,52,1,11,0,64,0,san bernardino police chief see chance nothing value shooter iphone
0,1,5,28,0,5,0,33,0,california begin hunt deeper cut
0,1,3,38,1,6,0,41,0,lexmark release printer built-in cd burner
0,1,8,43,0,9,0,51,0,election el salvador invoke rivalry civil war year
0,1,7,82,5,14,0,89,0,alleged 'rights group' involved removal anti-scientology video youtube exist; say eff
0,2,10,38,3,10,0,48,0,"ryan lochte want dance, apparently stars!"
0,3,4,44,0,11,0,48,0,new world trade center tower honor old new
0,2,17,64,1,14,0,81,0,"abhinav bindra spot future olympic winner india, appointed chairman new top committee"
0,3,8,28,0,10,8,36,0,nomination open 30 30 class 2018
0,1,6,32,0,7,1,38,0,novelist given 3 year insulting thai king
0,3,4,35,3,6,0,39,0,wikileaks' assange: russia give u email
0,2,7,61,3,14,4,68,0,forgotten trump roast: relive brutal 2004 thrashing new york friar club
0,3,3,61,2,12,0,64,0,"donald trump say he's meetings, get photographed golfing gear list"
0,1,5,31,1,6,0,36,0,classic bobby valentine: waiting call
0,2,9,41,2,9,0,50,0,finally 'like' disable comment instagram post
0,3,1,81,2,13,0,82,0,bird brain stupid: pigeon show human-like ability build knowledge generation
0,1,6,36,0,6,0,42,0,trade deficit narrow import decline sharply
0,2,3,35,0,9,0,38,0,tony romo gave could give cowboy
0,2,3,44,4,9,0,47,0,tina fey: trump cant muster dignity seventh grader
0,1,8,32,2,8,0,40,0,spate attack test iraqi city u.s. pullout
0,3,10,60,0,13,0,70,0,kylie jenner spread holiday cheer gifting world seductive short film
0,3,2,31,2,4,2,33,0,neil gorsuchs 11th-hour plagiarism scare
0,1,5,42,0,10,4,47,0,hundred cyclist take part 2008 london naked bike ride
0,2,12,46,4,11,0,58,0,"'the grand tour,' amazon bet million jeremy clarkson's car show"
0,2,7,52,0,10,0,59,0,harvard law school dropped lsat admission requirement
0,3,3,69,1,12,0,72,0,engineer shut niagara falls' water flow found surprisingly corps
0,1,3,38,1,6,0,41,0,"state emergency declared kingston, jamaica"
0,1,2,27,0,5,2,29,0,suicide bomber kill 31 pakistan
0,2,10,67,0,19,0,77,0,chilling cctv show moment taxi driver shot dead gunman holding child arm
0,3,1,47,1,11,3,48,0,mom donates 18.5 gallon breast milk newborn son dy
0,1,2,26,1,4,0,28,0,e-passport cloned five minute
0,3,11,49,1,11,0,60,0,watch alesso talk new chainsmokers remix drake miami music week
0,2,14,77,4,16,0,91,0,"last stand: hillary plan closing rally philadelphia bill, chelsea, barack michelle breitbart"
0,2,1,51,2,8,0,52,0,council funding freeze 'means cut many essential services'
0,3,8,31,1,7,0,39,0,"skirt club, woman mix business pleasure"
0,1,1,77,5,9,0,78,0,"'fascinating' 'provocative' research examines genetic element bipolar, schizophrenia"
0,3,9,37,4,10,2,46,0,exxons $20 billion spending plan point u.s. energy surge
0,3,2,49,0,10,0,51,0,fox news racial discrimination lawsuit hand
0,3,16,65,2,15,0,81,0,hero kupwara attack gunner rishi kumar single-handedly killed two three terrorist
0,2,2,79,3,19,0,81,0,"driver passed suspected drug overdose. back seat, child trying wake him."
0,2,11,58,1,13,0,69,0,karlie kloss school desiigner climate change bill nye's new show netflix
0,2,13,49,1,12,0,62,0,"careful, say randeep hooda gurmehar kaur fiasco"
0,3,10,58,3,8,2,68,0,71-year-old dana rohrabacher staffer knocked unconscious anti-trump protester
0,1,6,34,0,6,0,40,0,taiwan semiconductor want make solar cell
0,3,2,67,1,12,0,69,0,homeowner arrested fatally shooting intruder found shower: police
0,2,13,48,6,14,3,61,0,'100 day horror': ny times' blow say trump 'colossal failure' insider
0,2,8,38,2,7,0,46,0,trump disparages dumb deal australia refugee
0,3,7,37,0,9,4,44,0,saudi arabia plan payouts offset subsidy cut 2017
0,2,4,31,3,8,2,35,0,bafta nominations: 'la la land' 11 award
0,1,2,30,2,5,0,32,0,"chess champion ""fritzed"" computer"
0,3,9,55,0,11,4,64,0,oklahoma sooner joe mixon surveillance video 2014 assault woman released
0,2,8,68,1,13,0,76,0,north korea: chinese president xi jinping asks restraint call donald trump
0,3,8,34,2,9,0,42,0,dave chappelle say trump 'kind bad comedy'
0,1,2,27,0,3,0,29,0,nicolaus copernicus buried
0,1,7,38,0,7,1,45,0,northern iraq suicide blast kill 4 american soldier
0,2,6,6,0,2,4,12,0,mashbash sxsw 2017
0,2,3,54,0,10,0,57,0,tourist getting pulled staring northernlights
0,1,6,33,0,6,0,39,0,six fighter set start showtime tournament
0,2,5,27,0,5,0,32,0,civilian trying flee fallujah
0,1,4,30,3,5,0,34,0,'mates' australia's parliament house
0,2,6,55,3,11,0,61,0,"iowa, sanders, omalley stake liberal ground ahead clinton speech"
0,3,11,50,2,10,0,61,0,schumer: trump nominate someone else dems confirm gorsuch
0,1,7,41,0,7,0,48,0,south korean express fatigue recalcitrant north
0,3,10,44,1,9,0,54,0,world's indebted developer battle short
0,2,4,81,1,13,0,85,0,women's festival southbank centre london drop controversial event rapist protest
0,2,9,43,1,13,0,52,0,man life year heart backpack breitbart
0,1,10,48,2,10,0,58,0,"hard-hit areas, habitat humanity add demolition mission"
0,3,10,61,2,11,0,71,0,donald trump call intel briefing alleged russian hacking 'constructive meeting'
0,3,8,39,2,9,2,47,0,"week 14 nfl power rankings: cowboys, patriot rule roost"
0,1,1,42,0,6,0,43,0,technology developed detect fake drug quickly
0,2,13,56,3,14,0,69,0,revisited last tango paris rape scene cause internet outcry new york time
0,2,6,73,1,10,0,79,0,queensland cabinet reshuffle: mark furner replace stirling hinchliffe resignation
0,1,9,25,2,8,0,34,0,u.s. say shot iranian drone iraq
0,1,2,43,0,6,0,45,0,body recovered canadian helicopter crash
0,3,4,64,0,14,0,68,0,leftist candidatetries hold line ecuador latin america move right
0,1,2,27,2,7,0,29,0,claim 'bigfoot' dead body hoax
0,1,2,32,0,5,0,34,0,pollution arctic carried seabird
0,1,3,50,0,8,0,53,0,health canada issue warning toothpaste india
0,2,9,32,3,8,0,41,0,game throne father day card youdeserve
0,3,1,57,0,10,0,58,0,new connected bike trick kid exercising learning
0,3,5,69,1,12,0,74,0,malcolm turnbull take lead economy scott morrison; cabinet reshuffle looming
0,1,1,43,2,6,0,44,0,genetically modified dairy cow produce 'human milk'
0,1,2,42,0,6,0,44,0,tsunami warning issued earthquake near japan
0,3,10,48,0,10,0,58,0,halsey receives rising star honor billboard woman music award
0,1,10,20,2,8,6,30,0,2007 fifa u-17 world cup: germany top group f
0,3,1,58,0,9,0,59,0,paralympian forced wet train without accessible toilet
0,3,2,61,1,9,0,63,0,long-lost locket belonged titanic survivor tragically lost husband
0,2,3,67,2,18,0,70,0,woman drink two glass wine night 'should sent liver scan gps'
0,2,4,51,2,10,0,55,0,"sources: mlb, union agree use dugout signal intentional walk"
0,3,2,59,3,10,0,61,0,trump ally: obama official subpoenaed 'leaking' admission
0,3,1,47,0,10,1,48,0,2 former christie aide get prison bridge revenge plot
0,2,6,33,1,5,0,39,0,reading literature wont give superpower
0,3,2,40,2,8,1,42,0,parent 5-year-old genius colombia seek help
0,3,6,26,0,6,0,32,0,nick mangold released new york jet
0,2,4,45,2,9,0,49,0,"live updates: decision day health care, trump russia"
0,2,2,39,0,6,0,41,0,east midtown rezoning plan might finallyhappen
0,1,8,27,0,7,0,35,0,deal brings tv show movie youtube
0,3,2,63,0,10,0,65,0,trump skipped military brass negotiation defense company
0,1,2,51,1,8,0,53,0,victorian premier unveils plan world's largest solar plant
0,3,8,46,0,9,0,54,0,tent city homeless head university washington campus
0,2,3,49,2,12,0,52,0,'dear white people' star explain time show
0,2,1,48,1,8,0,49,0,amazon drone could parachute package people's house
0,2,5,64,1,12,0,69,0,"week, donald trump neither made friend influenced people capitol hill"
0,3,10,36,4,8,0,46,0,woo-oo! 'ducktales' reboot drop debut date new teaser
0,1,6,40,0,7,0,46,0,president ingushetia wounded suicide bombing
0,1,1,31,0,3,0,32,0,indian flooding displaces thousand
0,3,9,45,1,10,0,54,0,"forget vienna, oslo european cultural capital visit"
0,1,7,37,1,8,1,44,0,"another shutout, capital force ranger game 6"
0,3,2,70,0,14,0,72,0,sweden break wind power record half million kwh intense weather storm
0,3,6,32,2,6,0,38,0,"watch live: trump speaks melbourne, florida"
0,2,4,53,3,10,4,57,0,'justice failed austin callaway': town attempt atone 1940 lynching
0,1,3,37,0,7,0,40,0,u peace activist deported australia
0,1,1,37,1,6,1,38,0,spanish economy contract 1% second quarter
0,2,14,61,2,13,0,75,0,"raman raghav, nawazuddin siddiqui's manto biopic make respect even"
0,1,3,41,0,10,0,44,0,obama ask special bp claim fund oil spill
0,2,8,32,1,7,0,40,0,trump spokesman lying ridiculousmeme
0,2,13,53,5,13,0,66,0,"kerry: one state, israel either jewish democraticit cannot"
0,2,3,67,4,12,4,70,0,"alan dershowitz: strange, incredible 2016 race left u electile dysfunction"
0,2,5,57,1,11,0,62,0,kevin durant lead u men basketball team third straight olympic gold
0,3,10,34,2,7,0,44,0,"luke bryan, jokingly, get political acm award"
0,3,8,39,0,6,0,47,0,fbi arrest volkswagen executive emission scandal
0,1,5,29,0,6,0,34,0,unlikely ally resident west bank
0,2,10,38,1,8,0,48,0,melissa mccarthy upset trump alec baldwin?
0,1,3,76,1,14,0,79,0,egypt protests: army say use force demonstrator mubarak announces cabinet
0,2,11,36,3,10,0,47,0,haley: think regime change likely happen syria
0,1,1,45,0,7,0,46,0,madoff prosecutor want asset wife child
0,2,8,36,1,8,0,44,0,silicon valley: twitter ceo dick costolo tough
0,1,2,48,0,9,0,50,0,least nineteen dead suicide bomb blast pakistan
0,3,6,43,3,8,0,49,0,gop drop u.s.-mexico wall demand spending talk advance
0,2,2,79,3,11,0,81,0,elton john recovering 'potentially deadly' bacterial infection; cancel string concert
0,2,12,56,2,14,4,68,0,"gm lay nearly 1,300 worker detroit plant, cut production several factory"
0,2,2,18,4,4,0,20,0,trump's speech: how'd do?
0,2,3,40,0,7,0,43,0,memphis grizzly sit atop clutch mountain
0,1,3,34,0,5,0,37,0,judge threatened michael jackson jail
0,2,11,44,2,11,0,55,0,damien hirst alienated collectors. new work win back?
0,2,3,51,0,10,2,54,0,india andhra pradesh train crash leaf 39 dead score injured
0,3,12,52,1,13,0,64,0,kushners felon father back helm new york empire two fellow inmate
0,3,16,54,0,15,0,70,0,brie larson emma stone going new friendship goal theoscars
0,2,8,46,0,7,0,54,0,school apologizes student target black basketball team
0,2,3,53,2,11,0,56,0,lucky toddler star 'beauty beast' photoshoot
0,3,9,39,3,11,0,48,0,arrest stockholm truck attack: think driver
0,1,3,35,2,6,0,38,0,"lewis ""scooter"" libby indicted five charge"
0,1,4,24,0,6,0,28,0,wood announces birth son
0,2,5,23,1,9,0,28,0,yoga plane cnn video
0,3,1,45,0,8,0,46,0,student loan default rising faster think
0,1,7,45,0,11,0,52,0,looking past affair race governor south carolina
0,1,7,58,2,9,0,65,0,"photo source barack obama presidential campaign ""hope"" poster discovered"
0,2,5,57,5,9,0,62,0,netanyahu summons u.s. envoy anti-settlement resolution adopted u.n.
0,3,3,47,1,9,2,50,0,rex ryan fired bills' postseason drought reach 17 season
0,1,5,26,0,5,0,31,0,cbs fire radio personality imu
0,2,15,34,2,11,5,49,0,gop medicaid overhaul would cut funding $880b 10 years: cbo
0,1,3,50,0,8,0,53,0,catholic pilgrimage dongl blocked chinese police
0,2,14,48,1,11,0,62,0,watch: road rage shouting match turn violent fight arizona street
0,1,3,25,1,5,0,28,0,drug-dealers war rio de janeiro
0,3,4,59,1,10,0,63,0,"taiwan scramble jets, navy china aircraft carrier enters taiwan strait"
0,3,12,40,0,9,0,52,0,scientist testing new injection could preventhiv
0,1,6,34,1,5,3,40,0,space shuttle endeavour completes sts-123 mission
0,2,4,56,1,12,0,60,0,girl interrupted dad's bbc interview made star
0,1,9,40,0,10,0,49,0,brandeis say plan sell art collection raise cash
0,2,10,42,5,8,0,52,0,"anti-trump protester spell ""resist!!"" san francisco beach"
0,2,5,51,0,9,0,56,0,fbi raid new jersey building near suspicious devicesfound
0,2,9,33,1,9,4,42,0,could 2020 bring epic battle trump oprah?
0,2,2,47,1,9,0,49,0,pharrell williams' early life made movie musical
0,1,4,32,0,6,0,36,0,nelson mandela taken u terrorist list
0,1,6,30,0,7,0,36,0,nation disarray hold hope vote
0,1,5,17,0,5,0,22,0,best two day sport
0,2,9,42,5,9,0,51,0,dr. jane orient: universal coverage mean less care breitbart
0,2,13,61,6,11,0,74,0,nyt mag: facebooks building global community manifesto bound considered partisan
0,1,8,49,0,9,0,57,0,china investigate french company claim tainted formula
0,2,14,58,1,14,0,72,0,"indian chinese navy saved ship pirates, china hijack credit"
0,1,9,41,1,7,0,50,0,third-place finish help spain recover semifinal loss
0,3,6,71,1,14,0,77,0,"white house vow plan offer insurance every american, downplays upcoming cbo report"
0,3,9,44,6,9,0,53,0,let oscar f**k overshadow 'moonlight's' historic moment
0,2,10,36,2,8,0,46,0,black-ish working serial abuser chris brown?
0,3,5,58,2,14,0,63,0,woman jailed playing ed sheeran song 'shape you' repeat top volume
0,1,5,22,0,5,0,27,0,mugabe rival back zimbabwe
0,1,9,65,0,9,0,74,0,first impression create unrealistic expectation young basketball recruit
0,1,5,42,0,8,4,47,0,chicago white sox win 2005 american league baseball pennant
0,2,2,57,0,10,0,59,0,richmond park offer first glimpse changed political landscape
0,3,8,53,1,12,0,61,0,banksy's walled hotel unveiled bethlehem next west bank wall
0,2,2,44,2,8,0,46,0,passing plate becomes sunday morning stickup
0,1,6,40,1,6,0,46,0,"mozilla, internet explorer adopt universal rss symbol"
0,1,3,29,0,6,0,32,0,farmer block main road south italy
0,1,5,25,0,5,0,30,0,post office acting reduce loss
0,3,2,26,2,6,0,28,0,beijing's smog: tale two city
0,3,2,49,1,7,0,51,0,"russia recognizes ukrainian rebel documents, passport"
0,1,3,48,0,9,0,51,0,dalai lama threatens resign situation tibet worsens
0,1,4,35,0,7,0,39,0,laura bush visit middle east goodwill tour
0,2,8,42,2,9,0,50,0,comey asks justice dept. reject trump wiretapping claim
0,1,3,39,0,6,0,42,0,runaway train cause chaos london underground
0,2,9,29,0,9,4,38,0,academy award looked like 1997
0,3,1,41,1,6,0,42,0,foodie millennials really fueling food waste?
0,3,14,54,2,13,0,68,0,ed sheeran finally see picture mini look-alike stop grinning
0,1,14,53,3,11,0,67,0,south african prosecutor may drop fraud charge a.n.c. leader jacob zuma
0,3,1,60,1,10,0,61,0,cambodian police officer accused faking hit politician's car
0,3,11,51,1,11,4,62,0,"tracy mcgrady, bill self highlight 2017 naismith basketball hall fame class"
0,1,5,74,0,16,0,79,0,oil spewing crack seafloor gulf mexico fifty foot deepwater horizon well
0,2,8,37,1,8,0,45,0,read bob dylan's nobel prize acceptance speech full
0,3,4,69,3,15,0,73,0,destination malta's azure window worried drop tourist
0,2,3,44,4,11,2,47,0,"grammy-winning jazz, pop r'n'b singer al jarreau dead 76"
0,1,8,61,2,10,0,69,0,illinois governor blagojevich appoints roland burris vacated u.s. senate seat
0,2,10,27,3,9,0,37,0,dont worry always worry (it may help you)
0,1,5,26,0,4,0,31,0,satellite track carbon dioxide
0,2,2,35,0,6,0,37,0,man busted stealing scotch airportbar
0,3,10,52,0,11,2,62,0,college football former heisman trophy winner rashaan salaam dy age 42
0,1,4,15,1,4,1,19,0,no. 2 duke rout maryland
0,3,1,69,1,11,0,70,0,"millennials skipping doctor visit avoid high healthcare costs, study find"
0,1,6,30,2,4,0,36,0,point-and-shoot preclude thinking
0,2,8,37,2,9,3,45,0,steven a. cohen mystery buyer $141 million sculpture
0,2,2,47,0,6,0,49,0,mass migrant rescue operation underway mediterranean
0,1,6,63,0,14,0,69,0,three battalion royal irish regiment disband part ni peace process
0,1,2,36,0,7,0,38,0,abu ghraib prison camp struck tractor bomb
0,1,10,26,1,6,4,36,0,nascar: kurt busch win 2011 budweiser shootout
0,3,11,44,3,10,0,55,0,complete guide rewatching twin peak nyt watching search
0,2,10,44,0,9,0,54,0,anthony anderson learned proper oral sex technique mom
0,1,4,64,3,10,2,68,0,co-operative group purchase somerfield supermarket chain 1.5 billion
0,3,2,49,1,9,0,51,0,"tennessee couple tried sell baby craigslist, say police"
0,3,3,67,3,11,0,70,0,"local mayors: sessions definition, might actually sanctuary city"
0,1,5,31,1,6,0,36,0,"competing food, beetle becomes killer"
0,3,3,36,1,8,0,39,0,gop score win health bill pre-dawn vote
0,1,4,67,0,10,0,71,0,hong kong democratic party stir universal suffrage reform package controversy
0,1,1,34,1,7,0,35,0,spain's new cabinet woman men
0,2,2,48,1,7,0,50,0,kenya election: kenyatta blame primary chaos turnout
0,2,3,50,1,10,0,53,0,south west voters: tell u issue decide election
0,1,2,53,0,8,0,55,0,new zealand police defend decision charge speeding policeman
0,2,10,45,2,10,0,55,0,"berkeley, reversing decision, say ann coulter speak"
0,2,10,39,4,9,1,49,0,"woolly mammoth could 'de-extinct' 2 years, scientist say"
0,2,5,41,1,8,0,46,0,nyc mayor de blasio blasted drunk-driving comment
0,1,5,34,0,7,4,39,0,winner 2006 new zealand music award announced
0,1,3,67,1,10,0,70,0,three dead murder-suicide shooting southern california fast food restaurant
0,3,10,38,1,11,0,48,0,"donald trump push taiwan, china could push back"
0,3,10,32,0,9,0,42,0,build beautiful platform deck weekend
0,2,8,41,0,9,0,49,0,justice seek time find evidence wiretap claim
0,1,6,22,0,4,0,28,0,jpmorgan post profit quarter
0,1,4,42,0,7,0,46,0,vandal deface family crypt pierre elliott trudeau
0,2,8,43,1,10,0,51,0,grand tour: jeremy clarkson really taunting bbc
0,3,10,43,4,11,0,53,0,samsung plant catch fire -- guessed -- battery
0,3,10,54,1,10,0,64,0,eric frein trial: jury selection begin alleged pennsylvania cop killing
0,1,7,44,0,7,0,51,0,charter company flying cuba thrive despite complaint
0,2,1,56,1,9,0,57,0,"motorcycle racer struck lightning event, finish anyway"
0,2,15,41,5,15,0,56,0,"j balvin drop new track video 'si tu novio te deja sola,' feat. bad bunny"
0,3,3,46,4,6,0,49,0,barack obama's original sin: america's post-racial illusion
0,3,5,33,1,8,0,38,0,"wonder worry, syrian child transforms"
0,1,1,50,0,7,0,51,0,china shoot weather satellite ballistic missile
0,1,7,49,0,7,0,56,0,little excitement among voter european parliament election
0,1,2,47,1,7,0,49,0,"security guard scientology building shoots, kill man"
0,3,9,28,0,9,4,37,0,best worst city finding job 2017
0,2,8,47,0,9,0,55,0,merkel challenger look harness unruly party election bid
0,3,9,47,2,9,1,56,0,netflix change rating system 5 star feel yesterday'
0,1,3,9,1,2,0,12,0,henry a. waxman
0,3,14,71,1,14,0,85,0,french presidential candidate franois fillon vow fight despite formal probe wife work
0,1,8,55,0,11,0,63,0,stimulus may provide relief state jobless health insurance
0,2,8,45,0,11,2,53,0,president donald trump host patriot white house april 19
0,1,8,69,2,13,0,77,0,ahmedi iran's pdki discusses kurdistan's general strike democratic future iran
0,2,1,51,2,7,0,52,0,artist writer inauguration protest important
0,2,6,40,3,9,1,46,0,here google invested $1 billion elon musk spacex
0,2,8,63,1,12,0,71,0,cavaliers' owner dan gilbert called andre iguodala draymond green twitter
0,3,6,59,5,13,0,65,0,get tissue 'cos steve irwin's son basically mini-steve 'tonight show'
0,2,10,52,3,10,0,62,0,kellyanne conway: i'm getting death threat fueled pro-clinton rhetoric
0,3,10,42,0,9,0,52,0,blue ivy carter allegedly helped unite kanye west beyonc
0,3,12,55,0,12,2,67,0,meryl streep continues reign queen hollywood 20th oscar nomination
0,2,3,51,0,8,0,54,0,chinese investment kushner property manhattan called
0,2,6,59,1,13,0,65,0,gop congressman: democrat acting way leading civil war
0,1,2,51,0,7,2,53,0,polio vaccination campaign target 85 million african child
0,1,4,21,0,6,2,25,0,memphis notch 19th win row
0,2,7,44,2,9,0,51,0,"steven yeun ""the walking dead"" marries girlfriend joana pak"
0,2,16,41,0,12,0,57,0,nasa crewed mission venus would pave way human mission mar
0,2,6,17,1,7,0,23,0,nap new york time
0,1,9,27,2,10,0,36,0,u.s. men manage tie haiti gold cup
0,2,3,57,0,10,4,60,0,boris johnson among record number renounce american citizenship 2016
0,3,3,39,3,9,0,42,0,"texas, mississippi, true home blues?"
0,3,3,51,0,12,0,54,0,listing muslim brotherhood terror group bad idea
0,3,7,45,2,8,0,52,0,kellyanne conway blast 'haters' sexist criticism insider
0,1,2,43,0,8,0,45,0,police warn possible bomb threat central london
0,2,8,33,1,7,4,41,0,nhl player participate 2018 winter olympics
0,1,5,31,2,7,1,36,0,"sale improve, profit fall 9% walgreen"
0,3,10,41,2,9,0,51,0,wife 'american pie' singer mclean get protective order
0,3,4,51,1,9,0,55,0,ivanka trump attend women's economic summit angela merkel
0,1,2,27,0,3,0,29,0,facebook unblocked bangladesh
0,1,6,34,3,7,2,40,0,u.s. pledge $40 million afghanistan election
0,1,3,36,1,5,0,39,0,three serbia's neighbour recognize kosovo
0,2,1,53,0,12,0,54,0,hero cat bit sleeping owner alert family house fire
0,3,2,47,0,7,0,49,0,passenger ferry collides smaller boat washington
0,2,2,59,3,13,0,61,0,"hateful act rise, trump responsibility take stand"
0,2,11,49,3,10,0,60,0,"eastern u.s. still threat deadly storms, tornado midwest"
0,2,2,48,0,9,0,50,0,vince young hire agent hope reviving playing career
0,3,14,60,1,14,2,74,0,50% doctor working public hospital face verbal physical abuse patient
0,2,6,27,1,5,0,33,0,investor trust trump rally?
0,2,7,40,6,8,0,47,0,white house: muslim ban hysteria ludicrous breitbart
0,3,4,24,1,6,0,28,0,digital shine bed bath beyond
0,3,2,55,2,10,0,57,0,"philly mayor slam trump ""false statements"" city murder rate"
0,1,1,42,0,6,0,43,0,uzbekistan arm depot explosion leave three dead
0,1,2,49,1,5,0,51,0,kamchatka deep-focus underwater earthquake reach moscow
0,2,2,46,0,9,0,48,0,south korean showing world protest work
0,1,3,53,1,9,0,56,0,"papua new guinea police chief attacked, house torched response"
0,1,9,23,4,8,4,32,0,g.m. lower 2009 outlook u.s. auto sale
0,1,7,21,5,8,2,28,0,u.s. expected 70% revamped g.m.
0,1,4,68,2,14,2,72,0,australia women's national goalball team loses 0-3 united state pool play london
0,2,7,34,0,7,0,41,0,le pen extends lead french presidential poll
0,1,7,35,0,6,0,42,0,grand jury investigates los angeles priest case
0,2,11,47,10,11,0,58,0,"trump: cruzs new york value remark made anger, hatred breitbart"
0,1,1,61,0,8,0,62,0,italian university legislation spark protest student staff
0,2,9,48,1,10,0,57,0,china seizes unmanned american vessel south china sea breitbart
0,1,7,34,0,7,0,41,0,france look help airbus loan guarantee
0,2,1,80,2,14,0,81,0,call 'backpacker au pair' visa industry regulation parent seek affordable child care
0,2,3,48,2,11,0,51,0,severe morning sickness known hg leave woman starving
0,1,2,28,0,5,0,30,0,brief bomb alert central london
0,1,8,29,0,8,0,37,0,porsche vw remain far apart deal talk
0,1,2,29,0,4,2,31,0,galatasaray clinch 17th turkish title
0,2,8,39,2,9,0,47,0,never remember: city laugh along massacre
0,2,7,35,1,7,0,42,0,another court defeat ohio strict voting law
0,1,5,41,0,8,0,46,0,runaway emu train collides freight train india
0,3,4,55,2,12,0,59,0,time gov. penny tried block syrian refugee failed miserably
0,3,8,18,1,3,0,26,0,vmwarevoice: cio perspective
0,2,4,21,0,5,0,25,0,get ready led takeover
0,1,5,27,0,5,0,32,0,microsoft plan open retail store
0,3,7,41,1,7,1,48,0,5 nonsensical claim donald trump's latest interview
0,2,13,58,2,12,0,71,0,here kellyanne conway trying really hard talk mike flynns resignation
0,2,7,21,2,6,0,28,0,icymi: brexit week
0,2,4,60,2,8,0,64,0,tom hiddleston apologizes inelegantly expressed golden globe speech
0,1,8,32,0,7,0,40,0,church know role talking manuel
0,3,10,54,0,11,2,64,0,rob gronkowski join andre giant memorial battle royal wrestlemania 33
0,1,3,38,1,5,1,41,0,kosmos-3m rocket launch six orbcomm satellite
0,3,5,64,3,12,0,69,0,donald trump's indonesian business partner hary tanoe 'may try run president'
0,3,12,49,0,13,0,61,0,lebron james appears take jab lonzo ball game bull
0,3,2,49,0,11,2,51,0,zoo knoxville investigates 33 animal turned dead
0,1,2,60,0,7,0,62,0,serbia montenegro military announces mandatory service shortening
0,2,3,67,1,13,0,70,0,taylor swift's jumpsuit opened debate confusing world fashion copy
0,3,7,45,0,7,0,52,0,johnny manziel announces engagement girlfriend bre tiesi
0,3,5,59,1,14,0,64,0,house foreign affair chair: north korea could soon able hit u nuke
0,2,9,33,1,8,0,42,0,"southeast alaska, ferry system lifeline"
0,2,17,62,1,13,0,79,0,man murdered former nfl running back joe mcknight indicted second-degree murder charge
0,3,14,63,0,13,0,77,0,congress quietly pass new rule allowing house member hide record ethic probe
0,2,3,74,4,15,0,77,0,hillary clinton say misogyny played role loss. research suggests might right.
0,1,6,34,0,6,0,40,0,prosecutor look reclaim madoff asset
0,1,2,35,0,6,0,37,0,serial child imposter held french police
0,2,2,57,3,11,2,59,0,"clinton: trump economic plan benefit rich, mine create 10m job"
0,3,14,44,1,13,0,58,0,fit fight: watch kangana ranaut speak life award show
0,2,6,33,0,9,1,39,0,5 trump voter going inauguration
0,2,7,35,2,6,4,42,0,2015 nba playoffs: lebron james' unfathomable workload
0,1,1,50,1,7,0,51,0,denmark elect new centre-left coalition prime minister
0,2,4,26,0,5,0,30,0,david cameron panama paper
0,1,2,60,0,10,0,62,0,terror suspect arrested connection bombing public bus israel
0,1,7,62,3,12,0,69,0,"condoleezza rice confirmed next u.s. secretary state, pending full senate vote"
0,3,4,31,2,5,0,35,0,dakota access pipeline: happens next?
0,1,7,58,1,9,0,65,0,u basketball: cleveland cavalier partner flash seat sue ticketmaster
0,2,8,72,4,17,0,80,0,even wouldve helped her: donald trump rip ted cruz carly fiorina fall stage event
0,3,1,46,1,8,0,47,0,ohio woman pleads guilty dad fatal heroin injection
0,1,2,57,0,7,0,59,0,transport telecommunication struggle amid confusion london
0,2,11,50,1,13,0,61,0,chicago planning add hundred police officer new york time
0,2,11,45,1,9,0,56,0,zara pull skirt featuring frog resembles alt-right meme pepe
0,3,8,47,0,8,0,55,0,divided senate confirms steven mnuchin treasury secretary
0,3,11,48,2,12,2,59,0,"record store day turn 10: founder break past, present future"
0,1,2,49,0,7,0,51,0,body retrieved philippine ferry capsized typhoon
0,1,6,33,0,7,0,39,0,russia ready resume gas shipment europe
0,3,3,48,0,6,0,51,0,southampton close investigation assistant eric black
0,1,5,42,0,7,0,47,0,alan turing building open university manchester
0,3,9,40,1,10,0,49,0,"israel, teaching kid cyber skill national mission"
0,3,5,37,5,9,0,42,0,interactive map: weed legal u.s. [video]
0,1,8,34,1,7,0,42,0,war crime trial hear ex-liberia president
0,1,1,48,0,6,0,49,0,vandalism online epilepsy forum trigger convulsion
0,2,4,61,0,13,0,65,0,hurley win quicken loan national way officer gentleman
0,1,3,41,1,6,0,44,0,carling cup: match abandoned player collapse
0,2,15,62,0,14,0,77,0,frightened dog would tremble everything finally calmed meeting kid
0,1,4,31,0,5,0,35,0,dutch mp advocate proscription koran
0,3,3,53,2,11,0,56,0,malala yousafzai say trump 'needs go visit refugee camps'
0,1,4,58,1,12,0,62,0,"fbi arrest four alleged plot bomb bronx synagogues, shoot plane"
0,3,1,54,0,11,0,55,0,got proof retail apocalypse getting worse
0,1,3,36,0,8,0,39,0,new flotilla planned set sail gaza strip
0,3,3,47,1,7,0,50,0,donald trump's rhetoric translates government paper
0,2,3,34,0,5,0,37,0,fashionable englishwoman paris
0,3,10,38,1,10,0,48,0,woman creates art shower hair beautiful
0,3,8,45,1,7,0,53,0,inside kim kardashian's luxurious costa rica vacation retreat
0,1,4,47,2,10,0,51,0,"planet jupiter, mercury mar line up, visible naked eye"
0,2,9,57,2,9,0,66,0,clinton listless dem debate performance unlikely halt sanderss momentum
0,3,8,42,2,6,0,50,0,mile-wide hole could revolutionize pakistan's economy
0,3,7,76,2,17,2,83,0,india's tiger tragedy: big cat death jump 25 per cent poacher blamed culture casualty
0,2,3,43,2,9,2,46,0,"brexit trade deal could take 10 years, say uk's ambassador"
0,1,4,51,1,9,0,55,0,broward county sheriff police dog killed shootout florida
0,3,4,59,1,12,0,63,0,"one crew member dead, two injured black hawk helicopter crash maryland"
0,1,10,43,0,11,0,53,0,unsightly algae extends grip crucial new york stream
0,1,4,25,0,6,4,29,0,2006 olympic winter game open italy
0,1,3,37,2,6,0,40,0,australia's high court rule mod-chips legal
0,3,2,53,1,12,2,55,0,"least 56 killed brazil prison riot drug turf, official say"
0,3,12,37,1,11,0,49,0,time start telling friend much money make
0,3,7,52,0,10,0,59,0,controversial daca deportation case landed judge curiel
0,3,6,46,0,11,0,52,0,house dems demand meeting dhs chief trump travel ban
0,1,8,49,3,9,4,57,0,"taiwan textile foundation market ""2008 taipei style"" cross-straits"
0,3,2,44,2,8,0,46,0,biggest winner loser 'trumpcare'
0,3,10,28,4,8,0,38,0,hip-pop act raja debut 'could us' video: watch
0,2,15,49,3,13,0,64,0,"cnn leftist charles kaiser us n-word live air, make anchor cry breitbart"
0,3,2,43,1,6,0,45,0,drought-stricken somalia battle hunger cholera
0,3,4,51,3,10,0,55,0,floella benjamin: queen gave masterclass people skill
0,3,2,47,0,9,0,49,0,trump aide set air difference paris climate deal
0,3,2,49,0,9,0,51,0,soaring house price reduce number baby born england
0,3,1,52,3,8,0,53,0,trump family say 'not involved' conservation fundraiser
0,3,7,16,1,5,0,23,0,bill o'reilly fox news
0,1,4,37,1,7,0,41,0,"asio settle court, wrongful detention case"
0,3,7,38,0,6,0,45,0,nostalgia marketing search authenticity
0,2,11,42,1,9,0,53,0,lauren graham fictional tv daughter finally met reallife
0,2,9,43,2,9,1,52,0,new york prison break: 7 inmate whove passed dannemora
0,2,9,26,2,7,0,35,0,u.s. neglecting smartest kid
0,1,2,55,1,10,0,57,0,"kaczynski elected new president poland, according poll"
0,3,18,64,0,17,0,82,0,life come full circle sushmita sen return manila judge miss universe pageant
0,3,1,37,1,5,0,38,0,paraguay president back re-election bid
0,1,8,32,1,7,0,40,0,"mexico, curbing violence learned"
0,3,6,38,4,8,0,44,0,official: pentagon calling terror group 'isis'
0,3,13,62,5,13,2,75,0,"10-point: gerard baker spy viruses, bond yields, lac-mgantic compensation fund"
0,2,2,48,1,9,0,50,0,could violence ukraine precursor something worse?
0,3,10,54,1,9,0,64,0,thousand sign george takei's petition solidarity muslim american
0,2,8,47,2,9,0,55,0,"trump pick ambassador israel recants harsh attacks, slur"
0,2,6,35,0,7,0,41,0,tom brady lead patriot historic victory
0,2,9,39,1,9,0,48,0,"reflation trade dead, long live reflation trade"
0,2,6,27,0,8,0,33,0,rupert murdoch step ceo fox
0,3,9,48,1,11,0,57,0,mayor de blasio court voter toughest borough: staten island
0,3,3,54,2,10,0,57,0,romanian pm 'press ahead' corruption decree protest grow
0,2,2,42,0,9,0,44,0,warren buffet could buy entire airline
0,1,2,49,0,7,0,51,0,martial law declared philippine province massacre
0,1,1,52,0,7,0,53,0,politician denies claim smoked cannabis ambassador
0,1,3,28,1,4,0,31,0,"earthquake south medan, indonesia"
0,2,2,45,3,10,2,47,0,"3 officer killed, 3 others injured ambush baton rouge"
0,2,9,47,0,11,0,56,0,south african trade union call president jacob zuma resign
0,2,4,17,0,5,0,21,0,bomb steve bannon
0,1,8,39,0,7,0,47,0,rivera take time recovering shoulder surgery
0,3,4,50,4,14,0,54,0,jake arnott: fear sack every day best job ive ever
0,2,3,54,1,10,2,57,0,"russian military plane crash black sea, 92 people believed dead"
0,3,9,49,0,10,0,58,0,grayson allen announces return duke blue devil senior season
0,2,3,57,1,10,0,60,0,devos attack continue; critic incorrectly blame twitter typo
0,1,3,27,0,5,0,30,0,high tide sweep west galveston bay
0,1,5,26,1,5,0,31,0,"toyota, tesla develop electric suv"
0,3,3,51,0,7,0,54,0,reza aslan criticised documentary cannibalistic hindu
0,2,8,82,4,17,0,90,0,trump's america u election hacking claims: joe biden tell donald trump 'grow up' social medium attack
0,3,6,53,2,10,0,59,0,white house seeking significant cut u.s. payment united nation
0,1,2,19,0,4,2,21,0,terrorist seize 50 iraq
0,1,7,29,1,8,2,36,0,"gunman kill 10 alabama, take life"
0,3,5,81,3,17,0,86,0,new year's eve reveller flee west london pub 'candle used light christmas tree branch start blaze'
0,3,8,29,3,6,0,37,0,get: rita ora's shark-themed coach sweater
0,3,8,39,1,6,0,47,0,far-left firebrand mlenchon shake french election
0,1,3,30,0,6,0,33,0,golfer tiger wood injured car crash
0,2,8,49,4,8,0,57,0,"gorka: trump incredibly pragmatic relation russia, iran"
0,1,7,27,3,6,0,34,0,"trade decline, u.s. deficit narrow"
0,2,10,56,0,9,0,66,0,superbike racer javier fore catch fire spanish qualifying session
0,1,4,29,1,7,2,33,0,tour de france: robbie hunter win stage 11
0,2,13,51,2,13,0,64,0,florida high school flier tell woman prom dress make 'good girl'
0,1,6,31,0,7,0,37,0,french bill advance open shop sunday
0,2,10,29,0,9,0,39,0,mosquito like u much good
0,3,3,58,0,12,0,61,0,merkel ally call europe retaliate trump imposes trade tariff
0,1,7,34,2,8,3,41,0,justice dept. back saudi royal family 9/11 lawsuit
0,2,4,23,1,5,0,27,0,another attica horizon?
0,2,5,42,0,10,0,47,0,poli ruled cheltenham gold cup injury
0,1,8,61,0,11,4,69,0,caboolture play maroochydore 2013 sunshine coast rugby union preliminary final
0,1,2,34,1,6,0,36,0,judge decide nigerian election re-run
0,3,5,86,0,17,0,91,0,clay matthew strip eli manning recovers loose ball giant stand around watching huge play
0,1,9,27,0,7,0,36,0,bbc resists effort share license fee
0,2,10,32,1,11,0,42,0,"bbc kid parent back, cartoon"
0,3,12,46,2,11,0,58,0,conan dissects donald trump's habit taking credit due
0,1,7,34,2,5,0,41,0,"file-sharing site violated copyright, court say"
0,3,12,52,3,17,8,64,0,watch e! news season 2017 excerpt free online grammys 2017 number yahoo view
0,1,2,46,0,9,0,48,0,uk driver urged panic buy delivery strike
0,2,5,76,2,12,0,81,0,donald trump adviser michael flynn 'discussed sanction russian ambassador'then denied
0,3,4,32,5,9,3,36,0,"ms-13 trump's public enemy no.1, be?"
0,1,2,44,0,6,0,46,0,unreported tainted milk incident publicised china
0,1,2,19,2,3,4,21,0,2011 'pichileminian week' end
0,1,3,58,1,9,3,61,0,mumbai police investigation indicate pakistani role 11/7 serial blast
0,1,6,29,0,5,0,35,0,demonstration hong kong denounces wto
0,1,7,15,1,4,0,22,0,"fighting aids, peer peer"
0,3,10,60,0,10,0,70,0,dylann roof allegedly stopped another church charleston church massacre
0,3,7,35,3,9,1,42,0,iraq's pm say isi could defeated 'within 3 months'
0,1,5,22,0,5,0,27,0,damon stay hot power yank
0,1,6,26,1,7,0,32,0,memo editor: tech show subdued
0,1,9,26,0,7,0,35,0,russia nato work repair frayed tie
0,2,2,35,0,6,0,37,0,bill maher apologizes using racial slur
0,2,1,55,2,7,0,56,0,mailman busted spontaneous sexual relation withmailbox
0,1,2,16,0,2,0,18,0,oracle buy innobase
0,3,6,28,2,8,2,34,0,"rickles, king insult comedy, dy 90"
0,1,7,29,1,6,0,36,0,"israel say hamas damaged, destroyed"
0,2,6,47,4,10,0,53,0,katy brand: victoria wood's two soup funniest sketch ever
0,1,7,28,0,9,0,35,0,aol realigns overseer niche site
0,2,11,65,4,11,0,76,0,"debbie reynolds, eddie fisher, elizabeth taylor: inside hollywood first love triangle"
0,1,4,35,0,5,0,39,0,u president obama proposes financial reform
0,2,11,48,1,13,0,59,0,ruble staging rally russia's surprise rate cut trend side
0,3,7,46,4,11,0,53,0,cold paw: britain russia compete title 'world's best cat'
0,2,3,51,2,11,0,54,0,stephen colbert cartoon owl take trump 'clean coal'
0,2,5,52,0,7,0,57,0,hillary clinton win puerto rico democratic presidential primary
0,1,4,59,1,10,0,63,0,news michael jackson's death overload internet site spark hoax
0,3,2,60,2,13,0,62,0,"two baby boy twins, italian court say arent brother"
0,2,9,37,3,9,0,46,0,"nas, wu-tang clan damian marley headline cannabis cup"
0,2,8,48,1,9,0,56,0,trump's first day president brought thousand protester
0,2,10,48,1,11,0,58,0,paul ryan fbi clearing hillary clinton again: vote donald trump
0,3,4,68,1,15,0,72,0,"press fired comey reject trump wiretap claim, offer evidence russia probe"
0,3,1,67,5,13,0,68,0,underarm 'granny toss' accurate cricket...or trying hit waste paper basket
0,3,9,56,0,10,0,65,0,tracee elli ross delivers inspiring acceptance speech golden globe
0,2,2,50,1,6,0,52,0,israel-china construction deal reportedly ban settlement
0,1,7,32,1,6,0,39,0,baseball ticket much? check back tomorrow
0,1,2,67,2,10,2,69,0,8.8 magnitude earthquake hit chile; tsunami warning issued throughout pacific rim
0,1,5,73,2,19,8,78,0,ice hockey: blackhawks score two goal 28 second gain 2-0 series lead 2010 stanley cup final
0,2,3,45,1,10,2,48,0,man getting lost purple heart 66 year brother's death
0,2,1,59,0,10,0,60,0,california rancher cleared shoot mountain lion preying herd
0,2,13,58,3,12,0,71,0,chris christie defends trump: 'believes america morally superior russia'
0,2,1,54,1,10,0,55,0,bad moms: messy motherhood finally accepted screen
0,2,4,67,1,12,0,71,0,west virginia bob huggins scary moment defibrillator go game
0,1,3,46,0,8,0,49,0,seven killed kenyan protest radical islamic cleric
0,2,9,45,2,9,0,54,0,"corpus christi, texas, issue water warning chemical spill"
0,1,10,67,2,13,0,77,0,australia women's water polo team fina women's world league super final quarter final
0,2,5,50,0,8,0,55,0,sec charge two israeli resident mobileye insider trading
0,1,2,39,0,7,2,41,0,warrant issued 28 iraqi corruption scandal
0,2,12,33,3,12,1,45,0,"kendrick lamar way, joey badass go no. 1?"
0,3,8,42,1,8,0,50,0,mercks ebola vaccine found protect deadly virus
0,2,12,48,0,11,0,60,0,panasonic commits solar cell production tesla new york plant
0,1,5,37,0,7,0,42,0,aidan burley mp sacked following nazi pic furore
0,2,7,31,0,7,0,38,0,china eas foot gas military spending
0,2,8,54,3,11,2,62,0,"mriosoares, central player portugal transition democracy, dy 92"
0,3,6,53,7,14,2,59,0,"frank pellegrino sr., actor ""the sopranos"" co-owner rao's, dead 72"
0,3,2,40,2,7,0,42,0,samantha bee dive 'deep state' conspiracy
0,2,10,45,3,10,3,55,0,liam payne tweet he's '100 percent certain' one direction reunite
0,3,8,45,1,8,0,53,0,turkey's tourism industry suffers recent terror attack
0,3,10,53,3,11,0,63,0,krispy kreme employee writes 'black life matter' officer's order insider
0,1,5,26,0,5,0,31,0,revamped nugget reason hope
0,1,3,33,1,6,0,36,0,snow-laden branch kill man central park
0,1,12,72,2,15,8,84,0,uefa champion league 200809 qualification: 42 club learn fate first second qualifying round
0,1,1,35,0,5,0,36,0,niger facing food shortage drought
0,1,2,31,0,6,0,33,0,two pilot dead richmond plane crash
0,2,9,45,1,9,0,54,0,"former jets, chief rb joe mcknight killed louisiana shooting"
0,2,2,28,1,4,0,30,0,donald trump ideology violence
0,2,2,39,1,8,0,41,0,police: forced entry building jewel heist
0,3,12,50,2,11,0,62,0,little big town's best vocal harmonies: six video prove prowess
0,3,2,67,3,17,0,69,0,"george michael: grieve artist, time knew, young lover"
0,1,3,33,0,4,0,36,0,italian journalist giuliana sgrena freed
0,2,5,29,0,8,1,34,0,winner loser nfl free agency day 1
0,2,3,78,2,17,0,81,0,"diane greene, one powerful woman tech, promised protect woman google"
0,1,4,56,0,9,0,60,0,u president obama announces deal reached avert government default
0,3,11,46,2,11,0,57,0,guy grade ex-girlfriend's apology letter sends back
0,1,2,28,2,5,2,30,0,u deficit reach record $1.4 trillion
0,3,11,55,2,13,0,66,0,nightly news view beijing: chinese medium covering pres. trump
0,3,1,69,0,14,0,70,0,story child sex abuse deportation victim crime record time
0,1,5,39,0,8,0,44,0,un accuses u wholesale right violation iraq
0,3,17,51,3,15,2,68,0,"five-judge bench decide triple-talaq valid not, hearing begin 11 may"
0,1,4,25,2,5,3,29,0,"japan win world baseball classic, 10-6"
0,3,5,67,2,14,0,72,0,"jew nationwide watching, fbi work crack case phoned-in bomb threat"
0,3,5,62,7,14,0,67,0,tim howard banned three game fined calling fan 'motherf*****' ml game
0,1,1,40,0,6,0,41,0,woman suffers heart attack cardiology summit
0,1,7,30,0,11,7,37,0,jenny li thomas dold win 2008 taipei 101 run
0,2,4,72,5,16,0,76,0,arrival 'sucked' meryl streep performed 'like clown' one oscar voter really think
0,1,7,34,1,7,0,41,0,"chinese official gamble, luck run"
0,1,9,38,1,9,0,47,0,"spring break mexico, revelry mix new caution"
0,2,1,39,2,8,1,40,0,journalist shot dead front 6-year-oldson
0,1,2,27,0,5,0,29,0,plane ditch sea near sicily
0,3,1,60,0,10,0,61,0,rugby league considers central contract ease club v country tension
0,1,6,76,0,14,0,82,0,creationism intelligent design place uk science curriculum say uk government
0,1,3,34,0,6,0,37,0,davie shipyard sale cleared qubec court
0,2,12,54,1,13,0,66,0,safaree samuel say wouldve gotten nicki minaj remy work together
0,2,12,33,1,9,0,45,0,donald trump rewrite electoral map gop?
0,1,3,40,1,6,0,43,0,croatian ruling party expels ex-pm membership
0,1,1,25,0,3,0,26,0,lufthansa pilot begin strike
0,1,7,35,1,8,0,42,0,"goal tougher make, rule change bonus"
0,1,4,31,0,4,0,35,0,founder indian company interrogated
0,2,11,50,3,11,0,61,0,"lin-manuel miranda beat beyonce, adele ap's entertainer year"
0,1,3,27,0,6,2,30,0,broadcaster paul harvey dy age 90
0,1,3,40,0,8,0,43,0,brazil cease hunt body air france crash
0,3,11,65,1,18,2,76,0,youtube unveils $35 month tv service revealsviewers watch billion hour video day
0,2,16,67,5,19,0,83,0,luis fonsi talk anatomy 'despacito': 'i wanted make fun song would make people want dance'
0,1,1,46,2,9,0,47,0,obama call food safety system 'hazard public health'
0,2,4,13,0,3,0,17,0,roger ailes died
0,3,6,18,2,7,0,24,0,good bad night sleep?
0,3,10,53,1,14,1,63,0,randy moss sound twitter accuses ex spending $4 million drug
0,3,8,80,1,17,4,88,0,"queen step patron 25 organisation 91st birthday, including save child nspcc"
0,1,7,72,2,10,0,79,0,"visiting student detained louisiana, usa, photographing exxonmobil chemical plant"
0,2,5,28,3,4,5,33,0,"beverly hills, 90210: technology time-capsule"
0,1,4,56,0,9,0,60,0,president kosovo fatmir sejdiu resigns breach constitution
0,1,7,49,4,9,8,56,0,"former canadian prime minister brian mulroney release ""memoirs: 1939-1993"""
0,2,2,62,0,10,0,64,0,american reported killed walking caribbean beach husband
0,1,10,38,1,10,0,48,0,"trial begins, cheer greet iraqi threw shoe bush"
0,3,14,56,6,14,0,70,0,confirmed! amitabh bachchan play cameo akshay kumar sonam kapoor's 'padman'
0,1,6,32,0,7,0,38,0,milk scandal china yield cash parent
0,3,1,51,1,7,0,52,0,college student dy choking pancake-eating contest
0,1,4,30,0,5,0,34,0,un report condemn west bank settlement
0,3,3,66,2,11,0,69,0,"seventy-five year pearl harbor attack, survivor gather honor lost"
0,3,2,47,0,7,0,49,0,primary school ban child fasting ramadan
0,3,8,21,0,7,0,29,0,order plan b seamless
0,3,12,42,2,11,0,54,0,donald trump begs medium 'mercy' shawn mendes mashup
0,1,4,39,1,6,0,43,0,football cl: second qualifying round final result
0,3,3,32,0,5,0,35,0,video show u launching cruise missile
0,3,6,56,0,11,0,62,0,chelsea handler troll trump nordstrom bag outside white house
0,3,8,35,0,8,0,43,0,former labor secretary tom perez elected dnc chair
0,1,5,40,0,8,2,45,0,denver bronco player kenny mckinley found dead aged 23
0,2,8,76,4,14,0,84,0,jon stewart america complexity: country elected donald trump elected barack obama
0,2,2,62,1,10,0,64,0,report: trump looking revamping aerial surveillance program border
0,1,5,33,1,7,1,38,0,4-wheel dream million driver india
0,3,10,42,2,10,0,52,0,"push come shove nba, everyone's microscope"
0,3,9,51,1,9,1,60,0,adrian peterson sign 2-year contract saint leaving viking
0,2,4,43,1,8,0,47,0,beci orpin: behind scene instagrammable life
0,2,2,30,0,4,0,32,0,hitler lookalike arrested austria
0,1,4,49,4,11,0,53,0,"thrill ride u.s., canada shut girl's foot severed"
0,3,10,37,3,8,1,47,0,optic gaming win eleague 'cs:go' season 2 championship
0,1,5,34,0,4,0,39,0,louisville withstands late villanova threat
0,2,13,50,4,11,0,63,0,"apology decades-old lynching, police chief aim interrupt past"
0,2,11,55,1,13,0,66,0,report: anthony scaramucci headed white house assistant trump
0,3,5,60,2,13,3,65,0,donald trump printed made-up 300bn nato invoice handed angela merkel
0,1,3,45,0,7,0,48,0,roadside bomb kill two british soldier afghanistan
0,3,11,38,1,7,0,49,0,esa's exomars prepares sample lower martian atmosphere
0,1,5,32,0,7,0,37,0,decline black state prison drug
0,2,8,50,1,9,3,58,0,obama administration sending $500 million global climate change fund
0,3,2,57,3,10,0,59,0,"trump call legal system ""broken,"" address border wall cost twitter"
0,1,7,41,1,8,0,48,0,"preakness afleet alex, kentucky derby winner third"
0,2,1,49,1,9,0,50,0,sonys new toy teach coding robot construction kid
0,2,2,60,0,9,0,62,0,new york prison employee arraigned allegedly helping killer escape
0,2,8,35,1,10,1,43,0,6 rihanna's coziest look fenty x puma line
0,2,4,62,1,13,0,66,0,living land give takes: cattle culture outback australia
0,2,2,76,2,13,0,78,0,centrelink: tax office say cannot blamed automated debt recovery system's failing
0,1,3,30,0,6,0,33,0,heavy rain cause severe flooding uk
0,2,2,68,1,11,0,70,0,"record number american giving citizenship, government data show"
0,3,13,40,0,10,0,53,0,nasa studying manned trip around moon prod trump
0,1,9,33,3,7,0,42,0,bonus money troubled a.i.g. draw heavy criticism
0,1,3,29,1,6,3,32,0,beijing plan $242b freeway link taiwan
0,2,2,59,4,13,0,61,0,"sorry, skeptics: global warming may great plant life"
0,1,4,40,1,5,0,44,0,wheelchair-bound australian rescued new orleans
0,3,5,33,0,8,0,38,0,papal response sexual abuse church
0,3,8,28,1,9,0,36,0,time upgrade ipad? probably
0,1,7,27,1,7,2,34,0,texas a&m down oklahoma big 12 semifinal
0,3,5,39,3,7,0,44,0,borussia dortmund attack: iraqi suspect 'linked is'
0,3,5,30,0,5,2,35,0,13 inspirational quote ashley graham
0,1,6,60,2,10,0,66,0,"u marine killed vehicle capsizes, sink oceanside harbor, california"
0,1,6,21,1,5,0,27,0,n. korea warns stalled talk
0,2,3,50,5,9,4,53,0,"flat-pack fashion: ikea take swipe balenciaga's $2,150 shopping bag"
0,3,6,33,0,7,0,39,0,christmas reborn iraqi town freed isi
0,2,1,25,1,4,0,26,0,hung parliament mean?
0,3,2,44,1,8,0,46,0,google's case uber took unexpected turn
0,1,4,32,0,7,1,36,0,attorney jack thompson set sight sims 2
0,1,5,33,0,6,0,38,0,future biofuels expected remain bright
0,2,11,61,1,11,0,72,0,russell westbrook go reporter questioning oklahoma city thunder's team play
0,2,10,50,3,12,1,60,0,clinton cash movie viewed 2 million time opening week breitbart
0,1,2,38,0,9,2,40,0,least 15 die boat sink macedonian lake
0,2,11,56,0,9,0,67,0,nfl commissioner roger goodell belief marijuana addictive unhealthy
0,3,3,56,2,8,0,59,0,"australian junior oliver anderson match-fixing charge, say report"
0,3,14,60,0,13,0,74,0,rick scott remove prosecutor murder case refused seek death penalty
0,1,4,58,3,9,0,62,0,al-jazeera poll show many pakistani identify america 'biggest' threat
0,1,4,23,0,4,0,27,0,contrast policing protest
0,3,8,40,0,9,0,48,0,investor look past headline bull market roar ahead
0,1,2,49,0,8,1,51,0,apple executive leaf company iphone 4 antenna issue
0,2,5,28,2,7,0,33,0,abc news quiz: much retained?
0,2,1,71,0,15,2,72,0,seven people executed 11 day lethal injection drug expire
0,1,1,41,0,4,0,42,0,iraqi provincial election relatively peaceful
0,1,8,31,0,7,0,39,0,older audience looking better ever
0,1,1,47,0,8,0,48,0,ukraine close school report swine flu death
0,2,3,58,4,15,0,61,0,cat rescued inside chimney: 'she happy there' yahoo
0,2,5,58,3,11,0,63,0,rod stewart clarifies 'mock execution' video: playing game throne
0,2,3,53,6,11,1,56,0,"guardian galaxy 2 five post-credits scenes. yes, five."
0,3,10,50,3,9,0,60,0,justin timberlake miss hole-in-one inch pro-am golf tournament
0,3,11,49,2,12,2,60,0,"76ers ticket sale team get ben simmons, dario saric, shaved hair"
0,2,4,80,1,15,2,84,0,"18 million would lose insurance first year obamacare repeal without replacement, cbo report say"
0,2,12,38,1,10,0,50,0,president trump need five-year defense plan day one
0,3,4,44,0,7,0,48,0,trump want investigation intelligence leak nbc
0,1,2,44,2,5,0,46,0,western australia apologises abused wards-of-state
0,3,11,31,4,12,2,42,0,"10 year iphone: 'the best yet come,' say tim cook"
0,2,3,50,1,10,0,53,0,kansa shooting: widow indian man call hate crime action
0,3,5,51,1,10,0,56,0,jay-z become first rapper inducted songwriter hall fame
0,3,11,52,0,12,0,63,0,bill belichick rolled nfl combine quietly stunted everyone
0,3,4,56,3,11,0,60,0,may sturgeon battling scotland future. blink first?
0,3,11,45,2,11,1,56,0,2 chainz announces release date 'pretty girl like trap music'
0,3,2,47,1,8,0,49,0,journalist shouted corbyn press conference video
0,1,5,25,0,7,0,30,0,job ride luxury wheel
0,2,8,32,1,7,4,40,0,scarlett johansson top-grossing actor 2016
0,2,7,42,0,8,0,49,0,secretary state kerry commenting tlllerson pick
0,2,12,38,0,9,0,50,0,lng use surging idled spending may trigger next spike
0,3,7,47,1,8,0,54,0,tillerson reject trump's past call nuclear proliferation
0,2,7,44,1,8,0,51,0,victor cruz released giants: latest comment reaction
0,1,7,33,0,6,0,40,0,drug trial company find scrutiny
0,2,10,42,2,10,0,52,0,china exceeded u.n. cap north korean coal import december
0,2,10,54,1,11,0,64,0,twitter creates issa rae concept film starring rihanna lupita nyong'o
0,2,9,39,0,8,0,48,0,angie martinez develop tv project endemol shine
0,1,7,31,0,8,0,38,0,knicks top rocket win fourth five game
0,1,2,33,0,5,0,35,0,nicole kidman injured movie stunt
0,1,2,36,0,4,0,38,0,european venus probe launched successfully
0,2,12,54,7,12,0,66,0,"donald trump tweets: ted cruz stole iowa, result nullified breitbart"
0,3,11,53,1,14,0,64,0,"look russian compound nestled new york washington, dc suburb"
0,3,5,26,2,4,1,31,0,volkswagen's 7 billion-euro repair man
0,2,1,56,2,9,0,57,0,apple privacy czar grapple internal conflict user data
0,2,3,46,4,9,3,49,0,"thomson said tunisia '100% safe', sousse attack inquest hears"
0,2,4,47,0,10,3,51,0,usain bolt disappointed time 200m victory new york
0,3,5,56,3,14,0,61,0,please send saturn's 'death star moon' may climb mountain
0,1,3,56,1,9,4,59,0,finnish female politician highlighted world bank's 2012 gender report
0,3,10,63,0,9,0,73,0,government watchdog press jason chaffetz investigate kellyanne conway
0,1,4,47,1,6,0,51,0,israeli-american activist arrested entering gaza strip
0,3,12,48,1,11,0,60,0,"truck slam mardi gras parade crowd new orleans, injuring dozen"
0,2,9,50,1,9,0,59,0,watch live: official give update fort lauderdale airport shooting
0,3,10,44,5,10,0,54,0,solidarity: women's march across world video nytimes.com
0,3,12,43,4,10,0,55,0,penny say u.s. honor australia refugee deal trump called dumb
0,1,3,13,1,3,0,16,0,"schedule, day day"
0,3,11,38,2,9,0,49,0,"dnc race shakeup: ray buckley exit, endorse keith ellison"
0,1,4,49,0,6,0,53,0,fire damage building housing berlin philharmonic orchestra
0,3,8,52,0,11,4,60,0,college football team player poised huge bounceback year 2017
0,1,1,48,0,7,0,49,0,ryanair executive pay frozen increased fuel price
0,2,2,39,2,7,0,41,0,"war-torn western mosul, determined remain"
0,1,6,34,1,7,0,40,0,winner loser bigger best-picture pool
0,3,6,37,2,8,1,43,0,"california husband, wife charged 2nd wife's murder"
0,3,3,37,0,7,0,40,0,nab profit dip first quarter trading update
0,3,9,34,4,9,3,43,0,'rogue one' soar second-best december debut $155m
0,1,5,34,0,7,0,39,0,july deadliest month u afghanistan war
0,1,1,34,0,5,0,35,0,hubble detects methane distant planet
0,2,5,44,0,8,0,49,0,bob dylan finally collect nobel prize literature
0,1,1,77,3,13,1,78,0,"6-year-old boy colorado found alive, unhurt runaway balloon allegedly carried away"
0,1,5,37,3,8,0,42,0,"u denies arrest al-masri, al-qaeda iraq leader"
0,1,6,41,1,7,0,47,0,cuba sentence usaid worker fifteen-year prison term
0,2,9,32,2,6,3,41,0,sharp increase oled-investment plan $878 million
0,3,10,34,1,10,3,44,0,pregnant server get $900 tip time christmas
0,1,4,55,1,9,0,59,0,russian orthodox church elect first new patriarch post-soviet era
0,3,12,41,2,11,0,53,0,chimamanda ngozi adichie say woman's job likable
0,2,2,61,5,13,5,63,0,"woman 'wins 37,000 damages' strip-searched left naked met police"
0,3,5,52,2,13,0,57,0,al qaeda leader mock 'the new fool white house' yemen raid
0,2,7,50,0,9,0,57,0,trump inauguration security planner brace wave protester
0,3,1,53,2,9,0,54,0,"leader powerful theyre humble, new research show"
0,1,3,51,0,11,0,54,0,bush call congress make money available food aid
0,1,15,45,3,7,0,60,0,canadavotes: ndp candidate anne lagac dowson westmountville-marie
0,1,5,43,2,7,2,48,0,spokesman: saudi government donating us$50 million haiti
0,2,3,46,1,6,0,49,0,jennifer lawrence visit louisville children's hospital
0,3,6,68,4,12,0,74,0,por qu testigos de la corrupcin catastrfica de venezuela siguen apareciendo en ee.uu.?
0,1,6,33,1,7,1,39,0,deep discount lifted retail sale 1% january
0,1,4,48,1,10,0,52,0,"bus accident buffalo, new york leaf least eight injured"
0,1,1,32,1,4,0,33,0,portugal hold first same-sex marriage
0,1,1,58,1,8,0,59,0,"canadian sextuplet could get blood transfusion, religion forbids"
0,3,8,37,0,7,0,45,0,martin shkreli case twitter transparency
0,3,3,81,0,14,0,84,0,chemical weapon expert reportedly turkey investigate alleged sarin attack syria
0,3,14,49,2,13,0,63,0,science want dig nose eat booger healthy!
0,1,6,25,2,5,0,31,0,u.s. resists order wiretapping case
0,1,1,27,0,5,2,28,0,14 killed bushfires australia
0,3,10,42,0,9,0,52,0,north korean ship head home china order coal returned
0,2,3,43,2,9,0,46,0,trump praise arrest 'troubled person' white house
0,2,2,40,0,10,4,42,0,spacex fly two space tourist around moon 2018
0,3,5,59,2,10,0,64,0,tito's ark: bosnian nuclear bunker transformed contemporary art space
0,2,5,79,3,14,4,84,0,grammys 2017: adele forced restart tribute george michael error 'fastlove' performance
0,2,9,32,4,8,0,41,0,peggy noonan: trump could break gop breitbart
0,3,13,52,0,11,3,65,0,amanda nunes troll ronda rousey meme following dominating ufc 207 victory
0,2,8,42,3,8,0,50,0,"winter storm sock midwest, east, spawning accidents, death"
0,2,1,75,3,13,6,76,0,"southern rail bos double income almost 500,000 despite delays, cancellation strike"
0,1,3,34,2,7,3,37,0,minimum wage united kingdom increase 5.05
0,3,4,53,1,7,0,57,0,anti-semitic valentine republican student event spark outrage
0,1,7,35,1,9,0,42,0,"ohio, growing market mexican drug trade"
0,2,2,69,4,14,1,71,0,bully tormented 9-year-old boy. relative say may driven child suicide.
0,2,1,44,2,7,3,45,0,ancient tissue found 195 million-year-old dinosaur rib
0,1,6,30,0,6,0,36,0,men dressed police free mexican inmate
0,3,11,49,1,13,4,60,0,"tiger wood miss 2017 master due back injury, timetable return"
0,2,2,49,1,10,0,51,0,"lindsey graham campaign smile, one wisecrack time"
0,3,9,47,2,9,0,56,0,newt gingrich: madonna arrested women's march remark
0,2,2,54,3,8,0,56,0,ben affleck share he's completed treatment 'alcohol addiction'
0,3,13,63,1,12,0,76,0,dubai building rotating skyscraper every apartment spin individually!
0,3,5,28,0,6,0,33,0,roman holiday investor italy
0,3,4,30,0,7,0,34,0,iran drop trump visa ban u wrestler
0,2,10,45,0,9,0,55,0,spotlight boj move monetary policy market operation
0,3,12,42,2,10,0,54,0,"train delays, police action cause chaos around nycs penn station"
0,2,7,44,2,7,0,51,0,trump attack senator credibility gorsuchs comment
0,3,13,62,5,16,1,75,0,"chance rapper talk fatherhood, grammy night origin '3' hat katie couric: watch"
0,1,7,34,0,7,0,41,0,steelworker try force way meeting
0,1,2,61,0,10,0,63,0,scotland denies bail terminally ill man convicted lockerbie bombing
0,2,2,60,0,12,0,62,0,trump reacts london terror stoking fear renewing feud mayor
0,1,4,38,0,7,0,42,0,concern health situation uk austria
0,2,11,66,1,11,3,77,0,400 militant surrender pakistan's balochistan province seeking independence
0,3,7,70,6,19,0,77,0,"james may: jeremy clarkson knob, richard hammond t**t, i'm mate either"
0,1,3,43,0,10,0,46,0,six arrest made search killer rhys jones
0,2,3,66,1,11,0,69,0,seabin founder pete ceglinski battle hard make ocean-cleaning dream reality
0,3,6,41,1,7,1,47,0,authority allege $1 billion fraud platinum partner
0,3,2,56,0,11,0,58,0,brazen killing rhinoceros paris put zoo security spotlight
0,3,5,30,0,5,0,35,0,boeing agrees acquire liquid robotics
0,3,1,45,0,8,2,46,0,predicting biggest offseason change 32 team
0,3,8,63,2,17,0,71,0,blackhawks prove yet take win cross check blog- espn
0,2,9,50,0,8,0,59,0,newly blond kanye west make first appearance hospitalization
0,1,1,28,0,5,2,29,0,40 injured attack thailand
0,3,2,57,2,9,0,59,0,trump-lewis feud could harbinger new round hyper-partisanship
0,3,12,57,2,11,0,69,0,"immigration agent stop making arrest courts, trump official tell judge"
0,2,16,49,1,15,0,65,0,"one militia man say prefers death prison, really want go home"
0,2,15,65,1,13,0,80,0,"canada welcome refugee yet again, provides temporary housing permit amid u travel ban"
0,3,6,82,2,15,0,88,0,barack obama warns donald trump 'enormous consequences' middle east shift final press conference
0,2,3,19,1,5,2,22,0,specter $20 avocado
0,1,3,31,2,8,2,34,0,un: 4.8 million ethiopian need food aid
0,3,1,43,0,6,0,44,0,quebec police report fatality mosque shooting
0,1,6,43,0,10,0,49,0,debating blame reducing much village rubble
0,1,3,28,0,5,0,31,0,hurricane ike make landfall cuba
0,2,13,55,4,12,0,68,0,regeneron's new drug price could disappoint everyone. here's that's good thing
0,3,9,46,0,9,0,55,0,vietnam seen moving closer emerging upgrade bank opening
0,3,10,39,0,12,0,49,0,call attack u base uneasy island bahrain
0,3,6,40,1,9,0,46,0,"tencent customer come music, stay perk"
0,3,1,35,2,9,5,36,0,"bitcoin jump $1,000 first time 3 year"
0,3,4,35,2,8,4,39,0,"muhammad ali letter nelson mandela sold 7,200"
0,2,3,66,2,16,0,69,0,"civil war tsunami behind it, sri lankas east coast opening tourism"
0,2,15,60,2,13,0,75,0,"congress twitter account hack, smart fence india-pak border must read story"
0,1,2,46,0,6,0,48,0,atlantic storm danielle strengthens hurricane force
0,1,5,31,0,5,0,36,0,iran agrees suspend uranium conversion
0,2,3,46,4,9,0,49,0,bleachbit selling cloth something -- homage clinton
0,1,4,54,0,7,0,58,0,gibraltarian chief minister suggests joint sovereignty spain
0,3,7,35,1,7,0,42,0,ohio carjacking duo stymied stick shift: police
0,3,1,44,0,8,0,45,0,amazon patent hint floating warehouse sky
0,3,9,49,1,9,0,58,0,mets mascot burn pitcher noah syndergaard valentine's day joke
0,2,11,52,0,10,0,63,0,china chase silicon valley talent worried trump presidency
0,1,11,43,3,10,0,54,0,"overnight star, mediate return u.s. open added pressure"
0,1,3,49,1,9,0,52,0,"plane crash catalina island injures three, cause bush fire"
0,3,13,52,0,12,0,65,0,millennial woman want ivanka trump stop trying make ivanka trump happen
0,1,5,43,4,7,0,48,0,"student commits suicide school near philadelphia, u.s.a."
0,2,9,47,1,9,4,56,0,britain's queen elizabeth ii attends first official engagement 2017
0,2,11,35,2,9,0,46,0,mark bittmans shrimp green sauce recipe nyt cooking
0,1,2,30,0,4,0,32,0,chameleon snake discovered borneo
0,3,8,39,1,9,0,47,0,battle loom bill cosby's testimony drug sex
0,3,6,69,4,13,3,75,0,"day trump inauguration, state dept. sends $500 million united nation climate fund"
0,3,7,34,1,7,0,41,0,february job report: everything need know
0,1,4,35,1,6,0,39,0,"iraqi pm, russian leader discus energy deal"
0,1,4,29,0,5,0,33,0,warren buffett rating agency
0,2,11,51,1,9,0,62,0,tennis official review anti-corruption unit amid match fixingclaims
0,3,12,52,2,13,0,64,0,andrew rayel announces new label armada miami music week: watch
0,1,5,28,0,4,0,33,0,new terrain produce unexpected star
0,1,2,34,0,5,0,36,0,los angeles undergoing large power outage
0,1,7,35,1,10,0,42,0,"crisis not, russia build bridge east"
0,2,12,58,3,9,0,70,0,d'angelo russell sink game-winning buzzer-beater hour death grandmother
0,1,1,23,0,3,0,24,0,korean navy exchange fire
0,2,4,47,3,7,0,51,0,liberal group launch site tracking trump's mar-a-lago trip
0,3,2,44,1,9,0,46,0,trump syria strike amount coherent policy
0,2,1,72,1,14,0,73,0,"carbon emission soaked tree well initially thought, say scientist"
0,2,6,34,1,8,5,40,0,mcshay's best available day 2 2017 nfl draft prospect
0,2,14,52,0,13,0,66,0,patton oswalt share sweet tribute late wife anniversary death
0,3,3,44,0,10,0,47,0,poor reporter wipe electric scooter live tv
0,3,9,41,0,9,0,50,0,dutch populist wilder feel trump burn slide poll
0,1,5,47,0,9,4,52,0,2009 shri shyam bhajan hindu religious festival held hyderabad
0,3,8,52,0,9,0,60,0,trump administration give final approval dakota access pipeline
0,1,1,40,0,6,0,41,0,medium report exaggerate cell phone risk
0,3,7,72,3,11,1,79,0,"orthodox christian christmas: russia, ukraine, serbia among country celebrating january 7"
0,3,5,55,2,11,4,60,0,u. s. unseals charge jordanian woman 2001 jerusalem sbarro bombing
0,3,17,47,2,17,2,64,0,"""this us"" star chrissy metz 81 cent bank account got thepart"
0,1,8,45,2,9,0,53,0,"sasha cohen, lacking olympic gold medal, considers comeback"
0,2,2,47,0,12,0,49,0,find many thing google know aboutyou
0,3,3,48,0,9,0,51,0,man dressed gorilla completes london marathon six day
0,1,7,34,1,8,0,41,0,pitched battle bear bull wall st.
0,1,3,37,1,6,0,40,0,explosion kill briton qatar; dozen injured
0,2,1,61,2,9,0,62,0,"mississippi nun killings: suspect charged capital murder, police say"
0,2,7,30,0,8,0,37,0,looking mystery man tied faux avon bid
0,2,3,21,0,6,0,24,0,zsa zsa gabor word
0,1,5,29,0,6,0,34,0,bbc television centre placed sale
0,3,2,60,0,15,4,62,0,86 percent trump county make less year 27 trump staffer worth
0,1,8,51,0,9,0,59,0,iraqi lawmaker charged masterminding attack parliament
0,1,1,64,0,8,0,65,0,california lawmaker denies affair sexual discussion becomes public
0,3,14,48,2,13,0,62,0,design team behind beyonc lady gaga light runway nyfw [video]
0,1,2,36,0,6,0,38,0,barack obama give speech racial division
0,2,4,54,2,10,0,58,0,rohingya muslim myanmar suffering. world mustnt look away
0,3,7,44,1,8,0,51,0,gorsuch pick spur liberal campaign democrat block
0,3,1,43,1,7,0,44,0,"naked man shot police pursuit, authority say"
0,2,9,46,2,12,0,55,0,founder n.j. school disabled charged theft public fund
0,2,2,86,3,18,1,88,0,rosetta mission: philae comet lander 'ready operations' wake make first contact 7 month
0,2,16,62,2,16,0,78,0,hrithik requested twinkle make film followed adorable twitter banter!
0,1,3,51,0,7,0,54,0,major u presidential candidate passport file breached
0,2,13,47,1,12,0,60,0,"obama ban oil gas drilling arctic, setting showdown trump"
0,2,10,59,4,12,3,69,0,"video: hillary clinton leaf 9/11 memorial ceremony early, dragged van breitbart"
0,2,12,50,1,11,0,62,0,trump's budget would dire effect local regional art program
0,1,1,41,0,5,0,42,0,japanese riot police deployed around consulate
0,2,3,51,0,12,0,54,0,best buy employee pool money buy wii boy visited daily
0,2,5,20,1,3,0,25,0,isi ramadan terror campaign
0,2,10,52,2,12,0,62,0,'the fate furious' break global box office record opening weekend
0,2,5,49,2,8,0,54,0,"newspaper worse tv trump/clinton coverage, report find"
0,3,3,47,0,10,0,50,0,nfl security guard fired apparent sex act game
0,3,11,59,0,12,0,70,0,lindsay lohan meet turkish president erdogan syrian refugee bana alabed
0,1,3,36,0,7,0,39,0,nuclear site close uk worker walkout
0,1,3,50,2,12,5,53,0,"general petraeus: 30,000 troop may able leave iraq next summer"
0,3,12,58,3,11,0,70,0,idina menzel say 'karma' behind donald trump's rumored inauguration day problem
0,1,8,29,2,7,0,37,0,israel strike hit u.n. building gaza strip
0,3,3,81,1,17,0,84,0,donald trump's idea pay mexico border wall spark concern avocado price could toast
0,2,16,54,2,14,4,70,0,"reliance jio begin broadband service insane plan, offer 100 mbps free 3 months!"
0,3,3,40,6,9,2,43,0,kyra poh: 14-year-old 'world's fastest flyer'
0,3,4,84,4,13,0,88,0,"trump's america iran defies trump sanction military exercise, vow 'roaring missiles' threatened"
0,2,7,34,4,9,6,41,0,"letter einstein god (and toys) sell $420,625"
0,3,7,50,1,10,0,57,0,chris paul questionable return injury clipper vs. spur
0,2,1,59,2,12,0,60,0,idaho judge say rape direct consequence social medium system
0,1,6,26,1,6,0,32,0,long obama honeymoon last?
0,2,5,46,2,12,0,51,0,stephen hawking fear may welcome trump u video
0,2,11,47,2,10,0,58,0,trump penny rally totally unprecedented
0,1,7,30,0,7,0,37,0,web site help cellphone user find signal
0,1,2,55,0,9,0,57,0,several hundred buried mass graf nigeria following clash
0,3,4,57,2,11,0,61,0,brilliant way weather geek paid tribute 'twister' star bill paxton
0,3,4,55,1,9,2,59,0,pelicans' demarcus cousin suspended one game 18th technical foul
0,3,10,52,3,10,4,62,0,"pakistan follows modi's move, pass resolution demonetise 5,000 rupee note"
0,2,4,59,2,11,3,63,0,"trump celebrate andrew jackson 250th birthday nashville, attend rally"
0,3,1,55,0,10,0,56,0,listen voicemail people impacted immigration ban
0,1,4,41,0,7,0,45,0,fire destroys social security building brasilia
0,2,8,42,2,9,0,50,0,russia election hacking signal new era espionage?
0,2,4,35,2,9,0,39,0,who's u syria airstrike
0,1,8,32,2,9,0,40,0,"getting here, better ferry?"
0,1,7,35,0,7,0,42,0,sense triumph eludes israeli near gaza border
0,1,5,49,2,12,3,54,0,"man florida, usa, arrested using 911 complain fast food"
0,1,6,31,1,10,0,37,0,"italy, sign defiance kebab coke"
0,2,2,37,0,6,0,39,0,one dead oakland residential building fire
0,3,6,29,2,9,6,35,0,world bank cut 2015 global growth forecast 2.8%
0,3,5,53,0,10,0,58,0,new river thames road crossing route linking kent essex unveiled
0,3,17,55,2,17,1,72,0,"arjun kapoor set make third appearance koffee karan season 5, why?"
0,2,2,60,2,12,0,62,0,"brangelina broke marijuana, could mean divorce?"
0,3,5,44,2,9,0,49,0,vitaly churkin: u release cause russian's death
0,1,6,33,0,7,2,39,0,20 dead taliban attacker storm kabul office
0,2,1,65,2,10,0,66,0,"avalanche becoming common, thanks climate change, researcher say"
0,1,2,14,1,3,3,16,0,$500 million tribe
0,2,12,58,2,11,0,70,0,"chattanooga singer johnny balik delivers refreshing introduction ""i need it"""
0,3,19,68,2,19,6,87,0,"10 year first-round exit 2007 world cup, sachin tendulkar reveals wanted quit"
0,3,7,19,4,7,1,26,0,j. cole's '4 eyez only' go gold
0,3,4,83,1,12,0,87,0,donald trump: malcolm turnbull refuse comment immigration ban despite international criticism
0,2,2,69,4,16,3,71,0,mass incarceration doesnt much fight crime. cost absurd $182 billion year.
0,3,7,32,3,8,0,39,0,fantastic beast new dumbledore: jude law
0,1,11,40,5,8,0,51,0,"n.b.a., public-address announcer setting frenzied tone"
0,1,6,19,3,4,0,25,0,gap appear g.o.p. solidarity
0,2,3,51,3,9,0,54,0,"sunderland relegation worst day football, say david moyes"
0,3,4,59,1,10,0,63,0,"vincent janssen must prove worth spur training ground, say pochettino"
0,3,2,72,1,11,0,74,0,north carolina governor-elect say lawmaker call session repeal bathroom bill
0,3,7,31,0,7,0,38,0,google make nevada land grab data center
0,2,2,46,0,9,0,48,0,gene therapy let french teen dodge sickle cell disease
0,2,1,54,0,10,0,55,0,husband accused killing wife auction fur andjewelry
0,2,4,46,0,9,1,50,0,theresa may win common backing 8 june general election
0,2,13,46,2,13,0,59,0,alec baldwin back donald trump befriend alien 'snl' cold open
0,2,3,53,1,9,0,56,0,michael bloomberg world leaders: ignore trump climate change
0,3,10,42,1,11,0,52,0,china's xi hold first meeting trump next week florida
0,2,5,49,6,8,0,54,0,"pablo sandoval, baseball's ""kung fu panda,"" sport slimmed-down look"
0,3,12,44,1,11,0,56,0,george michael family say speculate hedied
0,2,5,29,0,7,0,34,0,hyperloop one tap brake testing
0,1,5,53,1,11,2,58,0,mlb: ranger score 30 run oriole first game doubleheader
0,2,2,43,1,6,0,45,0,chapecoense plane crash: colombia blame human error
0,2,9,47,1,9,0,56,0,"louisville pitcher josh rogers catch line drive, hit shimmy"
0,1,1,47,0,6,0,48,0,pakistani nuclear scientist released house arrest
0,2,12,29,3,9,0,41,0,"isi winning social medium war, u.s. concludes"
0,2,10,57,0,10,0,67,0,college student suffers severe reaction hazing involving peanut butter
0,3,7,25,1,8,0,32,0,baidus loss setback ai china
0,1,2,42,0,8,0,44,0,freed journalist call iran release aid worker
0,3,3,45,1,8,0,48,0,lane kiffin leaving alabama next week's title game
0,3,2,50,3,8,0,52,0,"""complete meltdown humanity"": aleppo civilian try escape"
0,3,7,60,0,16,0,67,0,nyc woman arrested flashing bb gun hotel want star prison tv show
0,2,7,40,1,8,4,47,0,2017 naismith trophy: lonzo ball headline list finalist
0,2,8,38,3,7,0,46,0,white house try rebrand trump's 'deportation force'
0,2,3,35,6,6,0,38,0,penny 'trumpcare': 'congress ready'
0,1,4,43,0,8,0,47,0,u scientist maryland accused spying israel
0,2,3,27,1,7,0,30,0,number: refugee europe
0,2,10,41,3,11,4,51,0,2017 oscars: justin hurwitz win best original score 'la la land'
0,1,1,59,0,8,0,60,0,guatemalan government may suspend liberty state emergency
0,1,7,37,0,7,0,44,0,israel remove illegal settler outpost west bank
0,1,3,43,1,8,0,46,0,cindy klassen named canada's female athlete year
0,2,7,41,4,7,0,48,0,sarandon prefers trump wall clinton moral judgment
0,3,8,57,1,10,0,65,0,heroic mp tobias ellwood seen leaving westminster pc palmer's funeral
0,1,7,28,3,7,2,35,0,deficit u.s. pension agency top $33 billion
0,1,7,29,3,5,3,36,0,shawn crawford win 200-meter u.s. championship
0,3,4,68,3,14,2,72,0,man monis's girlfriend amirah droudis sentenced 44 years' jail murder ex-wife
0,1,4,62,0,13,0,66,0,los angeles city council sue police officer accused filing false report
0,2,12,50,0,11,0,62,0,george takei joked running congress people got excited
0,1,1,43,0,6,0,44,0,study raise health concern shower curtain
0,2,11,62,4,11,0,73,0,"democrat latino, black, asian american legislator vow fight together trump"
0,3,2,46,1,8,2,48,0,firefighter battled massive 10-alarm blaze cambridge
0,1,5,57,2,8,0,62,0,"formula one: renault dismisses piquet, schumacher barred practising"
0,3,10,56,5,12,0,66,0,donald glover thanks migos making 'bad boujee' 'atlanta' acceptance speech
0,3,3,56,1,9,0,59,0,europol boss: britain carry sharing intelligence brexit
0,1,2,31,1,5,2,33,0,uk unemployment increase 17-year peak
0,2,10,54,3,9,0,64,0,showtime financial drama billion double melodrama machismo
0,2,11,68,8,12,0,79,0,"todd seavey: clinton cash show clinton sociopathic, self-serving predator breitbart"
0,1,4,86,0,13,0,90,0,internal audit reveals irs improperly identified hundred thousand taxpayer potential fraud
0,2,15,46,2,14,2,61,0,"30, rams' sean mcvay join list youngest coach ever major pro sport"
0,3,4,45,1,8,0,49,0,gorsuchs confirmation could impact supreme court
0,1,6,38,0,6,0,44,0,seller offer guarantee address layoff worry
0,2,1,39,0,6,0,40,0,dallas police end search suspicious person
0,1,4,43,0,8,0,47,0,u supreme court overturn death penalty child rape
0,1,3,37,0,6,0,40,0,one killed university oklahoma explosion
0,2,7,31,2,7,1,38,0,oscar-nominated film $0 ticket sale
0,1,9,32,2,10,2,41,0,mgm mirage raise $2.5 billion stock bond sale
0,3,3,29,0,8,0,32,0,voted get rid zac goldsmith
0,1,6,28,0,7,0,34,0,lehman loss start money fund
0,1,5,41,1,8,0,46,0,stevie wonder perform pre-game show superbowl xl
0,1,1,44,0,7,0,45,0,somali hospital hit shell continued unrest
0,3,8,37,1,8,0,45,0,china geely plan bid malaysian car maker proton
0,1,8,29,5,5,0,37,0,"outcry a.i.g., unrelenting, test geithner"
0,2,12,49,4,12,0,61,0,'how dare you!': mccain tear professor tweet soldier insider
0,2,19,65,2,18,0,84,0,"here's india need stop celebratory firing gun, sake innocent life claim"
0,3,9,38,0,12,2,47,0,super rare frog seen first time 50 year
0,2,9,43,0,8,0,52,0,newly signed jim jones tease migos jeezy collaboration
0,3,12,52,2,12,1,64,0,supreme court weighs credit card 'swipe' fee violate 1st amendment
0,2,9,38,0,9,0,47,0,investor euphoria stock set race past fair value
0,2,2,43,5,10,2,45,0,kim jong-nam killing: suspect 'paid $90 take part prank'
0,1,3,34,1,6,0,37,0,football: thomas srensen ready new club
0,1,2,29,1,4,0,31,0,new york legalizes same-sex marriage
0,2,4,63,4,13,2,67,0,moonlight resonated strongly brokeback mountain 12 year ago
0,1,8,53,2,9,0,61,0,sports-heavy broadcast day bbc one receives complaints; bbc responds
0,2,8,54,2,12,0,62,0,plumber creates giant moving star war at-act garden friend's son
0,1,7,29,2,8,0,36,0,"tiger woods, family guy, back course"
0,1,5,24,0,6,0,29,0,light bulb poised big change
0,3,4,51,4,10,0,55,0,labour tory 'remoaners' plotting 'delay dilute brexit'
0,1,4,48,1,8,0,52,0,australian volunteer firefighter kept busy new year's day
0,3,1,61,2,12,2,62,0,"2 officer shot, 1 killed, responding traffic accident california"
0,1,2,39,1,5,0,41,0,uk unemployment rate reach thirteen-year high
0,2,2,44,2,10,0,46,0,tim dowling: gigging band playing fire
0,2,1,43,2,8,0,44,0,yellow taxi 'have lower accident rate blue ones'
0,2,10,52,1,9,0,62,0,would sacrifice return invest socially responsible companies?
0,2,9,41,1,9,0,50,0,turkey may limit foreign-currency loan rein lira risk
0,2,11,54,3,12,0,65,0,guillermo 'jimmy kimmel live!' asks silly question super bowl medium day
0,1,5,20,0,6,0,25,0,prescott stand uk mp
0,2,10,48,3,9,0,58,0,walmart employee texas film man's racist rant 'foreigners'
0,2,2,85,6,21,1,87,0,fed hiked rate 3rd time history signaling major cyclical top stock
0,3,7,34,2,6,0,41,0,disney find 'frozen' princess broadway
0,1,7,62,1,13,0,69,0,rocket attack us ashland docked jordan; another rocket fired israeli town
0,2,6,19,2,6,0,25,0,vote: win super bowl li?
0,1,3,21,0,6,0,24,0,serbia apply join eu
0,3,2,53,0,11,0,55,0,southern rail user face another day chaos acas talk resume
0,3,4,32,0,6,0,36,0,house gop abruptly scrap health care vote
0,3,6,37,0,7,0,43,0,chance rapper reveals schedule spring tour
0,2,5,33,1,7,0,38,0,uk senior eu official resigned
0,3,8,28,2,8,1,36,0,blow $9 billion: fallen stroh family
0,2,14,45,2,13,0,59,0,"jay nigel barker ""top model"" reunion people excited"
0,2,7,53,1,9,0,60,0,one-time daca recipient deported homeland security dispute status
0,3,5,26,0,4,0,31,0,colton haynes officiallyengaged
0,2,16,64,6,16,0,80,0,cnns gregory: ive run word express shock potential trump presidency breitbart
0,2,8,28,3,11,0,36,0,"crude price fall dollar, u.s. shale output"
0,1,7,44,0,8,0,51,0,gunman kill judge ingushetia latest caucasus violence
0,1,1,19,0,2,0,20,0,japan enters recession
0,2,4,49,1,8,0,53,0,white house referring russia question trumpsattorney
0,1,7,30,0,7,0,37,0,elgato sytems offer tv software mac
0,1,8,38,0,10,0,46,0,stay dry golf course following family wisdom
0,1,1,48,0,8,0,49,0,texas woman accused shooting landlord dy hospital
0,2,8,49,0,7,0,57,0,indonesia confounds mining industry export policy curveball
0,2,3,59,1,10,0,62,0,manchester house explosion: five hurt home destroyed blackley blast
0,1,7,28,0,8,0,35,0,mets manuel get relief rain
0,1,2,36,0,5,0,38,0,opera singer pavarotti serious condition
0,2,5,70,2,14,3,75,0,relative missing flight mh370 passenger fly madagascar 'take search hands'
0,1,7,28,1,6,0,35,0,"overtime again, celtic keep cool"
0,3,7,48,0,9,0,55,0,erdogan race dollar campaign unrivaled power
0,3,3,58,0,8,0,61,0,member exxonmobil advisory panel sends scathing resignation letter
0,2,1,44,1,7,0,45,0,dystopian fiction selling like there's tomorrow
0,3,6,40,3,10,0,46,0,german fm: turkey 'further away ever' joining eu
0,2,4,49,0,10,0,53,0,spicer denies report trump want meeting putin iceland
0,2,10,60,3,11,0,70,0,delaware correction officer 'saved lives' dying hostage situation: union
0,2,3,47,0,8,0,50,0,march life attendee express hope trump presidency
0,2,6,81,2,15,1,87,0,leftover season 3 trailer: justin theroux return swansong damon lindelof's underrated gem
0,3,7,31,1,7,0,38,0,bill oreilly return podcast monday
0,2,6,52,1,11,0,58,0,"two employee suing microsoft, alleging job gave ptsd"
0,3,11,51,1,12,0,62,0,mom slain backpacker slam trump false claim terrorist attack
0,2,13,48,3,11,0,61,0,"bias alert: medium link lochte, trump even though swimmer supported obama"
0,2,13,55,4,12,0,68,0,ed sheeran reveals 'love yourself' originally written new album 'divide'
0,3,13,38,0,10,0,51,0,repealing aca could nightmare mental health care
0,3,11,41,4,10,0,52,0,joke: father john misty's 'pure comedy' lead rock album chart
0,2,9,56,0,9,0,65,0,taxstone reportedly indicted weapon charge irving plaza shooting
0,3,15,66,1,14,0,81,0,nawazuddin siddiqui share interesting detail like work three khan
0,2,5,67,6,15,0,72,0,"nobody dy dont access health care, gop lawmaker says. got booed."
0,1,6,35,0,6,0,41,0,privatization hong kong phone group rejected
0,3,8,27,1,7,0,35,0,china's big saver racking debt
0,1,3,70,1,10,0,73,0,"pakistan government must investigate killing abduction journalists, say un"
0,3,15,64,2,14,0,79,0,irrfan khan hindi medium humorous dig india's undying obsession english language
0,1,1,51,0,6,0,52,0,canadian foreign affair minister resigns amid controversy
0,3,8,48,0,10,0,56,0,archie miller agrees contract indiana replace tom crean
0,3,3,53,0,11,0,56,0,friend san bernardino attacker pleads guilty providing gun
0,1,2,35,0,6,3,37,0,airbus a380 test flight delayed accident
0,2,2,50,1,8,0,52,0,"conservative want health bill changes, house leader resist"
0,3,2,65,5,9,0,67,0,"london attack: woman wearing hijab 'distressed, horrified', photographer say"
0,3,3,65,0,10,0,68,0,eu demand china investigate torture lawyer release political prisoner
0,3,2,55,2,12,0,57,0,cat get purr-fect retro glamour shot help get adopted yahoo
0,1,4,42,1,6,0,46,0,german christian democrat win by-election dresden
0,3,10,35,0,8,0,45,0,politically progressive show tv rightnow
0,3,9,42,1,10,0,51,0,"trump bump twitter revenue report fall short, bigly"
0,1,6,37,0,7,0,43,0,hillary clinton nominated u secretary state
0,2,0,33,2,9,4,33,0,"1,200 foot salt mine, praying snow"
0,1,9,31,1,8,0,40,0,"swine flu vaccine may month away, expert say"
0,2,7,29,0,8,0,36,0,student debt america hit new record
0,1,7,32,1,8,0,39,0,"tired looking work, create"
0,2,9,45,1,9,0,54,0,protest erupt nationwide second day trump travel ban
0,2,13,49,1,14,2,62,0,sheriff: baby abducted fl hospital 18 year ago found alive sc insider
0,2,11,53,2,8,0,64,0,people sharing #disabledandcute photo beautifully empowering
0,1,5,24,1,5,0,29,0,strike threat uk's northern rail
0,2,6,34,0,5,0,40,0,chinese authority bust illegal vaccinering
0,3,8,36,0,10,3,44,0,james harden give game ball fan 100th birthday
0,3,3,44,1,8,0,47,0,white house: fed step marijuana law enforcement
0,3,3,26,0,5,0,29,0,google sued department labor
0,1,3,22,0,4,0,25,0,interview jimbo wale
0,3,4,35,2,7,0,39,0,letter africa: ghanaians leave home?
0,1,9,28,0,7,0,37,0,mgm mirage reach deal la vega project
0,2,9,31,1,8,0,40,0,"investor took uber, silicon valley"
0,2,2,44,0,8,0,46,0,photo kansa police officer feeding baby go viral
0,2,21,63,0,17,0,84,0,h prannoy feel aggression displayed pbl boost upcoming badminton season
0,3,3,55,1,11,0,58,0,holly bobo murder trial: jury selection begin month delay
0,2,12,48,1,11,0,60,0,magic johnson's old tweet gain new life lakers name executive
0,1,2,38,0,6,0,40,0,hydrofoil collides cargo ship near sicily
0,1,6,37,0,7,0,43,0,empowering big investor carry risk abuse
0,2,12,45,6,13,5,57,0,hot 100 chart moves: lorde's a-leaping ed sheeran debut 10 song 'divide'
0,3,3,46,0,8,0,49,0,question mount botched yemen raid approved trump
0,3,2,43,1,7,0,45,0,successful ebola vaccine fast-tracked use
0,1,5,25,0,7,0,30,0,life harmony wayman tisdale
0,3,12,52,1,10,1,64,0,suntrustvoice: 5 thing know getting accurate business valuation
0,1,8,26,0,6,0,34,0,usa today name new publisher editor
0,1,7,43,0,8,0,50,0,bush propose major overhaul social security benefit
0,2,11,42,1,10,0,53,0,"appalachian trail, combat veteran learn let thing go"
0,1,2,41,0,8,3,43,0,tornado kill one injures 100 northern colorado
0,3,13,42,4,10,0,55,0,'walking dead' star josh mcdermitt go co-star's body shamers
0,2,2,48,2,9,0,50,0,zambia first female fighter pilot: aircraft know sex
0,1,2,39,1,4,0,41,0,bobby charlton launch anti-landmine campaign
0,2,3,53,2,11,0,56,0,'the last jedi' director share exciting peek opening crawl
0,2,13,49,5,13,0,62,0,'very fake news': pres. trump questioned intel leak cnn's acosta insider
0,1,8,35,1,9,0,43,0,"veteran move up, leader full bloom augusta"
0,1,2,42,1,6,0,44,0,canada-wide manhunt suspect ontario slaying
0,1,5,44,1,7,0,49,0,"u presidential candidate obama speaks berlin, germany"
0,3,1,37,0,6,3,38,0,washington state mumps outbreak nears 300 case
0,1,6,45,1,9,0,51,0,u president george w. bush caught driving without seatbelt
0,1,8,46,1,11,0,54,0,"north shore oahu, enforcing respect local wave"
0,2,14,52,0,13,0,66,0,sushma swaraj guarantee help woman suffered heart problem flight
0,1,2,35,0,5,0,37,0,isolated native tribe discovered brazil
0,1,1,48,0,6,0,49,0,clinton meeting fuel speculation presidential bid
0,1,2,35,0,5,0,37,0,turkey armenia sign historic agreement
0,3,8,45,1,9,0,53,0,putin exploit europe division bid dominate gas supply
0,1,10,41,2,12,0,51,0,"mets yankees, new park home plenty quirks,"
0,3,9,46,0,9,4,55,0,former president barack obama reveals 2017 march madness bracket
0,3,7,32,1,5,0,39,0,nevada woman died near-ultimate superbug
0,3,10,44,1,9,0,54,0,fan's football throw turn blunder cfp festivity
0,2,7,37,2,8,0,44,0,russia sexual blackmail didnt die soviet
0,1,8,30,1,7,0,38,0,luxury travel site voyage.tv debut
0,1,6,65,3,12,3,71,0,"steve kubby, co-author california proposition 215, grows dangerously ill u custody"
0,1,10,46,0,9,0,56,0,texas authority obtain dna jailed flds leader warren jeffs
0,2,10,34,1,11,0,44,0,marry wrong person new york time
0,1,7,45,0,9,0,52,0,space shuttle atlantis land safely edward air force base
0,1,7,29,2,7,0,36,0,"circuit city, lacking buyer, shut"
0,2,11,54,0,11,4,65,0,jabrill pepper reportedly tested positive dilute sample 2017 nfl combine
0,2,3,72,2,14,0,75,0,clinton go trump six guy named steve economic advisory council
0,3,10,32,0,9,0,42,0,amazon take aim costco new prime visa card
0,2,7,34,1,9,0,41,0,hell hath fury like weiner scorned breitbart
0,2,3,55,5,11,0,58,0,"weekend attacks, clinton acted like leader. trump not."
0,2,13,55,1,11,0,68,0,"john mccain, chuck schumer call select committee investigate russia hack"
0,2,3,44,0,8,0,47,0,uk police still think westminster attacker acted alone
0,1,2,40,0,6,0,42,0,libyan rebel misrata restrict press freedom
0,1,6,32,0,6,0,38,0,punchless mets ground loss
0,2,3,53,2,11,0,56,0,pm 'unlikely change terms' parliament vote final brexit deal
0,3,3,46,0,10,0,49,0,house upstate new york completely encased ice
0,1,6,31,0,6,0,37,0,north korea vow produce nuclear weapon
0,1,1,34,0,4,0,35,0,narathiwat raid recovers stolen weapon
0,1,9,37,1,8,0,46,0,iran asks iranian-american salvage world cup bid
0,3,12,72,5,16,0,84,0,"trump's america donald trump: funding cut unfpa may 'devastating effects' women, un chief say"
0,3,4,19,0,5,0,23,0,share news tip forbes
0,3,2,45,1,9,2,47,0,kenya naivasha: 39 dead fireball engulfs traffic road
0,2,2,46,2,8,0,48,0,germany hunt 'violent armed' tunisian truck attack
0,3,4,46,0,10,0,50,0,jason day withdraws match play ailing mother
0,1,5,26,4,7,0,31,0,missing link ... bigger audience?
0,3,12,54,5,14,0,66,0,"seth rogen, billy eichner talk voice timon pumbaa live-action 'lion king'"
0,2,2,53,1,10,0,55,0,"win working class, democrat need start talking straight"
0,3,1,59,2,12,0,60,0,"beyonce reveals shes twins, internet may never"
0,3,9,45,0,10,0,54,0,fake review counterfeit amazon trying quash
0,3,13,56,0,15,1,69,0,obama leaf mixed legacy middle east 8 year cairo speech gave region hope
0,3,11,37,1,9,1,48,0,ucla's lonzo ball put oregon away ridiculously deep 3
0,2,3,66,0,9,0,69,0,tech investor admits sexually harassing female entrepreneur silicon valley
0,1,3,39,1,5,0,42,0,"earthquake strike northeast japan, shake tokyo"
0,3,10,51,0,10,0,61,0,wisconsin police hunt armed man allegedly mailed manifesto trump
0,2,4,49,0,9,0,53,0,body missing u navy sailor found inside damagedwarship
0,1,9,40,1,9,0,49,0,"even amid slump, demand toyota prius insatiable"
0,3,4,78,3,13,0,82,0,acclaimed iranian director wont attend oscar due unjust condition trump executive order
0,2,10,59,3,9,0,69,0,steve aoki tease 'unexpected' collaboration fifth harmony's lauren jauregui
0,1,1,44,0,6,0,45,0,colombian army general resigns civilian death
0,3,2,33,3,6,1,35,0,"kiper's round 1 winners, question marks,"
0,2,3,52,1,10,0,55,0,lebanon rape law: wedding dress hang beirut sea front protest
0,1,3,55,1,11,0,58,0,"woman found guilty killing fianc drink driving bath, england"
0,1,2,34,0,5,0,36,0,suicide bomber kill five afghan child
0,2,2,64,1,14,0,66,0,"offer access trump family fundraiser pulled back, tie remain"
0,2,1,55,0,8,0,56,0,miracle baby becomes youngest survive major abdominal surgery
0,2,14,49,5,11,0,63,0,wish bone say 'eazy-e umbrella' unites snoop dogg bone thugs-n-harmony
0,3,3,59,0,11,0,62,0,forest fire destroys dozen home near chilean port city valparaiso
0,1,5,56,0,10,0,61,0,british airway flight land short runway london heathrow airport
0,1,6,53,0,10,0,59,0,ioc lift ban iraqi athlete participating beijing olympics
0,3,3,42,0,9,0,45,0,couple suing georgia name daughter allah
0,1,2,36,0,4,0,38,0,erosion influence nigerian climate policy
0,3,7,67,1,14,0,74,0,trump's america donald trump say mexico repay united state cost border wall
0,3,5,73,3,11,0,78,0,clarendon ballroom get harassing call declining host trump backer deploraball
0,1,3,53,0,8,0,56,0,los angeles internatonal computer glitch cause four hour backup
0,1,7,37,1,8,0,44,0,uefa cl: first qualifying round winner known
0,2,2,40,1,6,0,42,0,gatlinburg firefighter couldnt save home
0,2,7,36,1,5,0,43,0,thought trumpcare/gop slaughterhouse
0,2,1,43,0,6,0,44,0,australian cyclone leaf shark stranded upstream
0,3,16,71,6,18,0,87,0,selena gomez address difficult time went last year cant stand social medium
0,1,6,36,1,7,0,42,0,"manuel address mets, putting focus future"
0,1,3,32,0,4,0,35,0,india double commonwealth game budget
0,1,7,50,0,11,0,57,0,homeless man cause bomb scare laguardia airport new york city
0,3,11,61,0,14,0,72,0,arizona police officer resigns caught video punching woman face
0,3,3,29,2,6,0,32,0,jeff session deep trouble. bigly.
0,1,8,39,0,8,0,47,0,leader say obama tapped pastor outreach office
0,2,4,53,0,11,4,57,0,college world series preview 2015 cinderella field eight team
0,1,6,31,2,7,0,37,0,"houses, decked sale, burglarized"
0,1,7,38,1,9,0,45,0,path supreme court: speak capably say little
0,2,11,45,2,11,0,56,0,trump's attorney general pick opposes hate crime law roe v. wade
0,1,8,44,0,12,0,52,0,china fails halt sale looted relic paris auction
0,1,6,60,4,11,0,66,0,"john ""jebby"" bush, son florida governor bush, arrested public intoxication"
0,2,2,47,3,8,0,49,0,"u.s. factory, private payroll data point firming economy"
0,3,0,44,1,9,5,44,0,"386 gymnast allege sexual abuse 20 years, report say"
0,2,8,45,2,7,0,53,0,official: brazil ousts impeached president dilma rousseff
0,1,5,35,0,9,4,40,0,ioc visit madrid part 2020 olympic bid process
0,2,10,41,1,9,0,51,0,zap! magnet study offer fresh insight memory work
0,1,6,29,0,7,0,35,0,festive crowd come chant tear
0,1,5,42,1,8,0,47,0,somali opposition group al-shabaab block wfp food aid
0,2,1,60,3,14,0,61,0,nivea actually ran ad slogan 'white purity' end well
0,1,6,83,2,17,5,89,0,"cricket: caloundra lead glasshouse stump day 2 2010 sunshine coast, queensland division one grand final"
0,3,11,49,5,10,0,60,0,"warriors' 'dance cam mom' attends all-star weekend, dance steph curry"
0,3,13,49,3,12,0,62,0,charleston survivor: black white people need 'get know one another'
0,2,9,55,1,10,0,64,0,lyon-besiktas europa league match delayed projectile thrown pitch
0,3,2,42,0,9,2,44,0,least 30 killed attack kabul military hospital
0,3,4,17,0,3,0,21,0,math behind futility
0,2,6,21,1,6,0,27,0,mr. reality tv go washington
0,2,2,55,0,10,0,57,0,trump pitch unity congress amid turbulent start presidency
0,2,2,36,0,4,0,38,0,survivor remembers chapecoense plane crash
0,3,9,50,2,10,0,59,0,globalist medium launch project show human side mass migration
0,1,2,40,3,6,0,42,0,arrest made australia 'anti-terror' raid
0,1,3,24,0,4,0,27,0,finding message blueprint
0,2,2,67,0,13,0,69,0,new law turkey offer citizenship foreign investor buy property
0,3,5,65,2,13,0,70,0,mashtalk: apple required provide instruction fix iphone?
0,1,7,32,1,7,0,39,0,"stoking fears, baghdad bomb kill dozen"
0,2,6,38,0,9,0,44,0,cia head john brennan warns trump watch tongue
0,2,12,50,4,14,0,62,0,"earthquake italy, half town longer exists new york time"
0,2,1,56,2,7,0,57,0,bahamas billionaire spat turn serious murder-for-hireclaim
0,2,1,54,1,6,0,55,0,"hungarian camerawoman sentenced kicking, tripping refugee"
0,3,2,56,2,10,0,58,0,missing alaska teen's remains found; another teen face murder charge
0,1,9,38,1,9,0,47,0,"bill clinton see hope health care changes, time"
0,3,9,42,0,9,0,51,0,chair hull city bidder greaterchina arrested hong kong
0,2,2,43,1,7,0,45,0,schumer outline plan trans-hudson railproject
0,3,1,45,1,8,0,46,0,comey's hearing pass political storm rage
0,2,9,42,0,8,0,51,0,parent release video teen believed kidnapped teacher
0,3,1,41,0,9,0,42,0,baby hippo born six week early fight life
0,1,6,30,0,7,0,36,0,fed call gain household wealth mirage
0,1,3,43,2,8,0,46,0,north korea prepared 'sacred' nuclear war south
0,3,4,67,1,13,0,71,0,passenger adam saleh's flight refute claim kicked speaking arabic
0,3,7,41,1,9,0,48,0,"cadbury drop easter reference, entering culture war"
0,3,17,56,2,16,0,73,0,shah rukh khan floor everyone wit charm ted talk we're surprised!
0,3,7,42,1,7,0,49,0,treasury mnuchin fends push reject protectionism
0,1,6,33,0,6,0,39,0,european court refuse delay intel inquiry
0,2,9,52,0,8,0,61,0,facebook blame controversial takedown technicalissues
0,2,11,39,3,10,0,50,0,pusha belief racism 'no longer hidden' trump's win
0,3,18,63,5,16,4,81,0,"rube goldberg price scheme, epipen competitor auvi-q free patients, $4,500 insurer"
0,1,5,37,0,5,0,42,0,finding business security military contract
0,2,4,78,0,14,0,82,0,british spy removed operation russia china crack code leaked snowden file
0,3,11,52,1,10,0,63,0,shah rukh khan booked allegedly rioting damaging railway property!
0,3,4,52,1,9,0,56,0,sean spicer talking president trump audience size
0,1,7,28,0,7,0,35,0,new round worry push share lower
0,1,2,31,1,3,0,33,0,"ontario, canada byelections announced"
0,1,4,29,1,8,2,33,0,"fire kill 32 theatre beni suef, egypt"
0,2,13,52,5,15,0,65,0,"judge denies lighter security 'el chapo,' say 'i think know reasons'"
0,2,8,36,1,4,0,44,0,inside xxxtentacions complicated legal situation
0,3,14,42,1,13,0,56,0,look: fox news fox business going red woman today insider
0,2,3,47,7,9,0,50,0,"exclusive: there shutdown, there shutdown, trump say"
0,1,2,50,3,6,0,52,0,'very serious': chinese government release corruption report
0,2,13,58,2,11,0,71,0,president trump first foreign trip include red-carpet welcome saudi arabia
0,2,4,54,0,13,0,58,0,postmodern jukebox big band style lady gaga cover
0,1,5,48,0,11,0,53,0,fbi confirms ricin found university texas
0,3,1,46,1,9,2,47,0,dailymotion video website loses 85m users' detail hack
0,2,2,29,0,4,0,31,0,live coverage trump inauguration
0,1,6,25,0,6,0,31,0,villanova much blue devil
0,3,11,51,1,12,0,62,0,mike shinoda heading cannes: midem tap linkin park artist keynote
0,3,8,41,0,10,0,49,0,solar could beat coal become cheapest power earth
0,3,3,72,3,12,0,75,0,"dressed frill: like outfits, designer molly goddard reputation keep growing"
0,1,2,28,0,7,2,30,0,bomb blast somalia kill least 30
0,1,3,41,0,6,0,44,0,middle eastern troop enter bahrain protest
0,1,7,39,0,10,0,46,0,andy pettitte accepts pay cut return yankee
0,3,3,61,2,12,4,64,0,"still 1,000 child calais refugee centres. need sanctuary"
0,2,3,57,0,11,2,60,0,donald trump take 12th golf trip since becoming president nine week ago
0,3,10,52,0,10,0,62,0,matt barnes waived king following demarcus cousin trade pelican
0,3,14,56,1,13,0,70,0,taiwanese chinese people reacting trump surprise phonecall
0,1,7,26,2,6,0,33,0,north korea said detain u.s. reporter
0,2,10,43,2,8,1,53,0,michael phelps teach 7-month-old son boomer swim underwater
0,1,7,28,0,7,0,35,0,shuttle set lift station part
0,3,7,47,1,8,2,54,0,judge approves $25 million settlement trump university lawsuit
0,1,7,29,0,6,0,36,0,comcast nfl network continue haggle
0,3,7,30,1,8,2,37,0,nfl playoff picture: six team clinch week 16
0,3,3,59,5,14,5,62,0,"'i regret poor,' say 85,000 year taxpayer funded nigel farage"
0,1,4,44,2,7,0,48,0,"apec country set ""aspirational goals"" climate change"
0,3,10,39,0,10,1,49,0,california brace rain storm kill least 7
0,2,3,52,0,12,0,55,0,penny learn flynn misled russia last week
0,2,2,51,2,6,0,53,0,bruin mindless julien penny-pinching perfectlybackfire
0,2,6,35,2,8,0,41,0,elizabeth: forgotten year john guy review
0,1,2,25,0,4,0,27,0,briton face execution china
0,2,7,37,2,9,0,44,0,"trump speaks taiwan leader, affront china"
0,2,8,42,0,7,0,50,0,harvard book store creates bowling green massacre section
0,1,2,42,0,5,0,44,0,australian immigration denies issuing banned drug
0,1,2,30,0,7,2,32,0,least 40 killed bombing pakistan
0,2,9,37,1,9,0,46,0,"sea level rise, vital salt marsh disappearing"
0,1,4,29,0,4,0,33,0,sanford apologizes cabinet member
0,1,7,60,0,11,0,67,0,chinese political dissident hu jia freed chinese premier wen visit britain
0,3,6,39,0,6,0,45,0,adrian peterson reportedly visit patriot
0,1,2,45,2,9,0,47,0,multiple bomb threat sydney 'nothing hoax'
0,3,3,60,1,9,0,63,0,un nuclear watchdog: iran showing satisfactory commitment nuclear deal
0,2,5,66,1,11,0,71,0,"amid trump twitter controversies, white house preparing expand social medium team"
0,3,3,48,1,10,0,51,0,bulls' dwyane wade want leave option open summer
0,2,3,42,0,7,0,45,0,nordstrom quietly purging store michaelkors
0,1,1,34,0,5,0,35,0,british doctor killed honeymoon
0,3,3,83,2,14,0,86,0,death penalty: australia's top lawyer urge government push end capital punishment worldwide
0,2,10,43,0,9,0,53,0,hillary clinton joined instagram hillary clintonway
0,2,14,38,5,11,4,52,0,"d'angelo russell: latest news, rumors, buzz pg's 2015 nba draft stock"
0,3,12,42,2,10,3,54,0,840-hp dodge challenger demon banned public roads?
0,1,2,46,0,8,1,48,0,least 3 police officer killed pittsburgh shooting
0,1,9,28,0,9,0,37,0,figuring kind flat panel tv buy
0,1,6,54,0,10,0,60,0,palestinian president pleads un security council help gaza
0,2,7,40,0,10,2,47,0,death toll fire oakland artist collective rise 33
0,1,5,25,1,5,0,30,0,"amid gloom, obama pledge recovery"
0,1,3,37,0,6,1,40,0,british oceanliner qe2 make final journey home
0,2,12,51,3,13,0,63,0,taran killam jay pharoah leaving saturday night live new york time
0,3,10,45,2,10,0,55,0,"tour gary player's incredible south african stud farm, sale"
0,2,18,62,2,15,0,80,0,"mp cm attends wedding late bhopal jail employee's daughter, gift job appointment letter"
0,3,2,49,0,8,0,51,0,indianapolis colt black cheerleader hug boy used slur
0,3,2,61,0,13,0,63,0,new jersey give free baby box move lower infant mortality rate
0,2,3,45,1,10,4,48,0,trump rather weird meeting 2017 teacher year
0,3,6,78,6,13,0,84,0,"aleppo: syria's bashar al-assad say recapturing rebel stronghold also mark 'victory' iran, russia"
0,2,2,21,1,3,0,23,0,women's march live coverage
0,1,1,44,0,8,0,45,0,california ban sale violent video game minor
0,2,6,39,2,8,2,45,0,ex-imf chief rodrigo rato get 4.5 year embezzlement
0,1,4,33,1,7,3,37,0,"wreckage, victim air france flight 447 found"
0,2,2,41,1,7,0,43,0,chipotle challenge may go beyond food safety
0,2,1,65,1,12,3,66,0,scientist turned cooking oil material that's 200 time stronger steel
0,1,6,26,0,5,0,32,0,new reactor must handle plane strike
0,3,7,39,1,7,1,46,0,iphone 8 leak explains apple's expensive new smartphone
0,3,2,54,0,7,0,56,0,senate committee investigating trump wiretapping claim yet
0,2,13,52,4,12,0,65,0,"hall passes, buses, lunch duty: principal could focus achievement?"
0,2,4,43,3,8,2,47,0,al jarreau: seven-time grammy-winning jazz singer dy 76
0,3,2,44,0,8,0,46,0,advocate warn fight ahead trump pursues torture
0,2,3,44,2,10,0,47,0,pope say trump christian sign global concern
0,2,8,44,1,7,0,52,0,american obsessed eating healthyand twinkie
0,3,6,58,0,11,0,64,0,olympic star testify congress sex abuse usa gymnastics program
0,1,2,35,0,6,0,37,0,three aid worker released somali gunman
0,3,7,40,4,10,0,47,0,"france town wither, fear decline frenchness"
0,2,6,5,2,2,0,11,0,cnngo cnn.com
0,2,10,55,2,12,0,65,0,"teen apologize wearing red, white, blue high school basketball game"
0,3,16,63,3,15,0,79,0,josh kushner's complex world: jared's liberal brother run billion dollar fund trump era
0,3,2,54,0,11,0,56,0,cookie order roll business owned woman syndrome
0,1,11,48,0,12,0,59,0,randy johnson lost little fastball reputation
0,2,12,51,1,11,0,63,0,"trump administration banned laptops, one airline passing"
0,3,11,41,2,10,0,52,0,u.k. shower smallest eu state attention ahead brexit
0,2,5,46,2,9,0,51,0,president obama speaks u.s. troop final christmas visit
0,1,8,27,2,6,0,35,0,u.s. jobless claim rise expected
0,3,11,49,0,13,6,60,0,navy chief sunil lanba tell father bought 11 phone connection 1980s
0,2,2,50,3,8,0,52,0,minnesota president stand bans: 'much bigger football'
0,3,8,52,1,12,4,60,0,"politics, diversity major topic joke speech 2017 golden globe"
0,2,3,41,2,8,4,44,0,"football star love $4,500 louis vuittonbackpack"
0,1,6,33,1,4,0,39,0,conocophillips report fourth-quarter loss
0,3,9,44,1,9,0,53,0,ex-google executive want saudi telecom next softbank
0,3,2,63,1,13,0,65,0,"dao video, passenger complain booted en route wedding"
0,1,8,38,0,8,0,46,0,china fear rural tremor migrant flock coast
0,1,6,58,1,8,0,64,0,"wikinews interview jon greenspon, independent candidate u president"
0,3,3,50,0,9,0,53,0,marlin plan bronze statue jose fernandez ballpark plaza
0,1,5,35,0,6,0,40,0,democrat see progress proposal economy
0,2,17,44,2,14,0,61,0,"new day say they'd never leave wwe fight ufc, comment conor mcgregor"
0,2,14,60,0,12,0,74,0,jimmy garoppolo confuses nfl fan medium instagram post leaving patriot
0,1,3,50,0,9,0,53,0,musician phil collins announces never play drum
0,1,7,32,0,7,0,39,0,taliban loss sure gain pakistani
0,1,5,24,0,5,0,29,0,tried outsmart wall street
0,3,11,54,1,10,0,65,0,south korean pour street president park geun-hye amid scandal
0,2,3,40,4,9,3,43,0,"italy emma morano, world oldest person, dy 117"
0,2,4,40,0,8,0,44,0,david miliband running top un development job
0,3,16,45,1,13,0,61,0,hispanic caucus fear dhs head turn blind eye agents' bad conduct
0,1,3,30,0,5,0,33,0,hearing begin david hooke death
0,1,1,29,0,4,0,30,0,florida prison ban inmate smoking
0,3,1,57,2,14,2,58,0,"wisdom albatross, oldest known wild bird, laid egg age 66"
0,2,3,66,6,15,0,69,0,'hellfire' america missile choice hit target five mile away
0,1,7,33,1,7,0,40,0,"confidence, south korea roll title game"
0,2,1,28,0,3,0,29,0,five health myth reinvestigated
0,3,7,42,1,8,0,49,0,predator russian banking track prey economy ruin
0,2,4,56,5,12,0,60,0,"evil, evil, evil be: emotional testimony dylann roof trial begin"
0,2,18,35,3,10,0,53,0,panic! bacon shortage keep hearing real
0,2,7,32,3,6,2,39,0,"84-year-old defies age, fly trapeze escondido"
0,1,5,32,0,6,0,37,0,sydney thanked patience apec
0,2,5,42,3,8,0,47,0,amazon-whole food deal roils wall st.; energy share gain
0,1,6,17,0,6,2,23,0,mtv vh1 broadcast live 8
0,1,2,35,0,5,0,37,0,building collapse barbados trap family
0,2,15,58,2,14,0,73,0,"actor played barb ""stranger things"" opened bisexuality ontwitter"
0,2,8,37,0,7,0,45,0,staple explores sale failed office depot deal
0,3,5,52,1,10,0,57,0,"katy perry, john legend added grammys performance roster"
0,3,14,32,3,13,0,46,0,"uk pm theresa may give trump quaich: it, why?"
0,3,4,58,1,12,0,62,0,trump north korea carry another nuclear weapon test?
0,2,1,38,0,7,0,39,0,nine tip apartment decorating budget
0,3,2,44,0,9,0,46,0,victim come forward marine nude photo scandal
0,1,4,41,1,5,0,45,0,japan's prime minister fukuda announces resignation
0,3,13,43,2,12,0,56,0,here read youre sick stigma around mental illness
0,3,10,51,1,9,0,61,0,fort lauderdale shooting: shocking new video show moment rampage began
0,2,8,44,0,9,0,52,0,kevin durant hire extra security return oklahoma city
0,2,8,40,4,11,4,48,0,adopted refugee family 12 months. came month 13.
0,1,6,51,1,9,0,57,0,"body alumnus found rensselaer polytechnic institute, new york"
0,1,3,42,1,10,2,45,0,"death toll musayyib, iraq fuel tanker blast rise 98"
0,2,5,40,3,12,3,45,0,"week apps: yahoo get caller id, yelp 411,"
0,1,6,44,0,6,0,50,0,woman binghamton athletics file harassment complaint
0,3,13,60,6,14,0,73,0,chelsea clinton writes childrens book woman take answer [video]
0,2,2,46,1,6,0,48,0,russian authority detain dozen anti-putin rally
0,3,10,43,3,12,0,53,0,week tv: big little lies; war child; replacement
0,2,11,63,2,13,0,74,0,global music right likens radio 'cartel' conspiring keep songwriter payment low
0,3,9,40,3,9,0,49,0,"'tough' tillerson help north korea, china oilman say"
0,1,3,57,2,9,0,60,0,"dark knight film director's brother arrested murder, kidnapping"
0,3,11,43,1,11,1,54,0,company raise $1 billion create blood test detect cancer
0,3,14,42,0,10,0,56,0,new mexico may become seventh state ban lgbt conversiontherapy
0,3,9,44,3,8,0,53,0,u.k. high-yield issuance undeterred brexit record comeback
0,3,7,48,1,9,1,55,0,"canadian tourist, 9 others killed shooting jordanian castle"
0,2,4,43,0,8,3,47,0,787 dreamliner eyepopping rehearsal paris air show
0,2,10,46,3,12,2,56,0,"mount everest: nepali man, 85, aim become oldest person climb peak"
0,2,2,57,1,10,1,59,0,university glasgow get green light 1 billion expansion project
0,2,12,54,0,11,0,66,0,guy perfectly recreated disney photo minnie mouse decade later
0,1,5,51,1,8,0,56,0,didier drogba withdraws cote divoire national football team
0,3,4,28,0,5,1,32,0,6 music industry powerbroker watch
0,2,13,49,5,10,0,62,0,n.c. gov. mccrory claim political left fed emergence transgender issue
0,3,1,72,0,13,0,73,0,oklahoma lawmaker want protect people destroy drone flying property
0,3,14,59,2,13,0,73,0,"vidya balan take gurmehar kaurs side, say everyone freedom express"
0,2,15,38,1,13,0,53,0,"free himself, james harden look awful lot like nba mvp"
0,1,1,50,0,11,0,51,0,japan likely change law allow female heir throne
0,1,2,40,1,7,0,42,0,pakistan new policy renewable energy launched
0,2,6,25,0,5,0,31,0,trump could kill social security
0,3,20,51,3,11,0,71,0,delingpole: ronald reagan would hated stupid conservative carbon tax idea
0,1,2,51,2,7,0,53,0,twenty-five child injured bus-truck collision florida
0,1,2,47,1,9,2,49,0,"nitrite poisoned milk kill three babies, sickens 35 china"
0,1,5,39,0,9,4,44,0,george laura bush introduce 2008 white house egg roll
0,1,3,35,3,7,0,38,0,obama muslims: 'americans enemy'
0,1,6,35,1,7,0,41,0,transfer: aston villa sign zat knight fulham
0,3,13,60,1,13,1,73,0,miami fan punch 1-legged west virginia fan run away bizarre bathroom fight
0,1,9,33,1,8,0,42,0,"baseball, slow start may happy ending"
0,1,4,48,2,6,0,52,0,u.s. manufacturer general motor seek bankruptcy protection
0,2,2,45,1,8,0,47,0,"current, former major leaguers die dominican crash"
0,2,2,47,0,9,0,49,0,uk industrial production fall worst rate four year
0,3,2,25,1,4,0,27,0,inside japan's bizarre owl cafs
0,3,12,49,0,11,0,61,0,milo ventimiglia defended rory gilmore threw shade dean andlogan
0,3,10,50,2,11,0,60,0,ted cruz considered scalia's supreme court vacancy? insider
0,2,1,41,1,8,0,42,0,here's maple syrup jug teeny tiny handle
0,2,8,37,2,10,2,45,0,chinese group pay record $2.2 billion hong kong land
0,2,1,43,0,6,0,44,0,neuroscientist explains magician deceive u
0,3,12,61,4,15,0,73,0,michelle obama's twitter farewell: 'being first lady honor lifetime'
0,3,1,60,1,9,0,61,0,government seek official advice postal ballot same-sex marriage
0,2,3,57,0,14,1,60,0,trump got egypt free american aid worker 3 year prison
0,1,6,26,2,8,2,32,0,quarterly profit 14% bed bath beyond
0,1,7,32,0,8,0,39,0,yahoo microsoft said weighing ad pact
0,2,8,44,1,9,0,52,0,"trump agrees renegotiate nafta canada, mexico leader"
0,3,1,61,1,11,0,62,0,sincerity enough: problem problem sincere disbelief
0,3,9,54,0,9,0,63,0,mexico eliminates infectious disease leading cause blindness
0,3,8,63,1,12,0,71,0,wa election: abc refused access one nation function despite medium attending
0,3,15,50,3,18,3,65,0,"5 years, 9 film superstardom 9 reason alia bhatt actor love love!"
0,2,3,72,2,18,0,75,0,bill gates: bioterrorism could kill nuclear war one ready deal
0,3,2,64,0,11,0,66,0,fight horrendous battery drain bug currently plaguing iphone user
0,1,2,33,0,4,0,35,0,posted deadline christmas delivery
0,1,3,27,0,5,0,30,0,wildfire rage north los angeles
0,2,7,83,3,14,0,90,0,theresa may warns donald trump iran malign influence speech republican philadelphia
0,3,2,78,2,12,0,80,0,"education minister responds damning report, say he's open importing specialist teacher"
0,2,14,44,4,13,0,58,0,auntie maxine became meme hero anti-trump internet
0,2,16,64,2,13,0,80,0,ex-nhl tough guy george laraque help detain alleged kidnapper police arrive breitbart
0,1,4,24,0,3,0,28,0,clemens still denies everything
0,2,1,22,0,4,0,23,0,afterlife hotel soap
0,2,2,30,1,6,0,32,0,map: largest company every state
0,1,9,27,3,7,0,36,0,g.o.p. leader want opposition
0,2,9,56,1,12,0,65,0,idaho judge make celibacy marriage condition rapist probation
0,3,8,52,0,9,0,60,0,white house fire security aide criticizing trump administration
0,2,10,39,3,11,0,49,0,leak reveal trump tax returns? dont hold breath
0,1,6,25,1,6,0,31,0,"gunman suspect rape, police say"
0,1,1,47,1,9,3,48,0,tech heavyweight unite offer $100 laptop poor nation
0,2,4,47,3,8,0,51,0,stephen curry: i'm fine fourth-highest paid warrior
0,3,1,65,0,14,0,66,0,museum worker threaten walk dispute able sit shift
0,3,3,62,3,15,0,65,0,'trial century': heir samsung empire headed court next week
0,1,8,37,1,10,0,45,0,"known water, venice turn tap lessen trash"
0,2,10,65,2,10,0,75,0,libertarian vp candidate likens trump immigration policy kristallnacht breitbart
0,2,2,52,2,11,0,54,0,brexit: day two supreme court hearing concludes happened
0,1,2,40,0,7,0,42,0,strong earthquake strike coast taiwan
0,3,3,72,3,11,0,75,0,"chemical giant ineos 'exploiting brexit relax climate change laws', document suggest"
0,2,2,46,1,8,0,48,0,impeachment seemed impossible day ago. anymore
0,3,15,42,2,14,0,57,0,judge lost job defying law. may become senator.
0,3,12,54,6,11,3,66,0,report: sleep deprivation cost u.s. economy $400 billion every year [infographic]
0,2,7,41,0,6,0,48,0,facebook murder suspect steve stephen commits suicide
0,1,4,24,0,7,2,28,0,u actor dennis hopper dy age 74
0,1,2,32,1,5,0,34,0,pakistan: eight killed hospital blast
0,3,7,49,0,9,0,56,0,chris brown accused punching photographer tampa nightclub
0,3,13,54,1,10,0,67,0,dutch police: berlin market attack suspect may passed netherlands
0,3,3,37,4,5,0,40,0,netanyahu: kerry's speech 'skewed israel'
0,2,6,48,3,9,0,54,0,"tamil nadu: trader ban pepsi, coca-cola support local product"
0,2,10,50,1,9,0,60,0,social learning help millennial workforce productive?
0,1,8,44,0,11,0,52,0,china add security force tibet amid call boycott
0,2,2,49,3,10,0,51,0,take long: trump's press secretary already meme
0,3,11,46,0,10,0,57,0,warrior become fastest team nba history clinch playoff berth
0,3,3,66,1,15,0,69,0,think tank tie putin reportedly plan sway election trump's favor
0,3,5,42,1,7,0,47,0,constance wu call casey affleck's oscar nomination
0,1,5,50,1,7,0,55,0,afl provides insufficient support european leagues: germany
0,3,1,52,2,7,0,53,0,westminster attack: picture emerges terrorist's final hour
0,2,11,36,0,8,0,47,0,sec probe hedge fund promise investor loss
0,1,8,39,1,8,0,47,0,"expert find flaw chinese software filter, green dam"
0,2,7,51,1,13,0,58,0,one joke photo become symbol south korea fear mers
0,2,1,44,0,7,0,45,0,dystopian fantasy trilogy feel almost tooreal
0,1,2,31,0,6,0,33,0,john key admits visiting strip club
0,3,3,50,0,8,3,53,0,possible mh370 debris found relative disappeared passenger
0,2,13,51,2,11,0,64,0,planet brains? peril potential self-aware geological change
0,1,8,33,1,9,0,41,0,"advice two new books, talking head"
0,2,6,29,0,8,0,35,0,house clear path repeal health law
0,1,9,54,0,8,0,63,0,crop scientist say biotechnology seed company thwarting research
0,2,2,63,0,13,0,65,0,trump trying take credit job announcement charter made month ago
0,2,2,44,2,10,0,46,0,"turkey failed coup, sense fatalism set"
0,2,9,63,2,13,0,72,0,see darren criss menace grant gustin melissa benoist 'the flash' musical episode
0,3,13,49,0,12,0,62,0,pro wrestler come bisexual video boyfriend hit web
0,1,6,37,0,8,0,43,0,roger federer win french open roland garros
0,2,10,47,3,12,0,57,0,"cpac day one: kellyanne conway, mike penny steve bannon speak live"
0,2,12,39,3,12,1,51,0,j. cole preview new music '4 eyez only' documentary hbo
0,2,6,23,0,6,0,29,0,kid wish teacher knew
0,1,2,35,1,7,0,37,0,"dannie abse hurt, wife killed car accident"
0,3,12,61,2,14,0,73,0,trump first month travel expense track surpass barack obamas average year
0,2,12,66,0,18,0,78,0,young penguin stolen zoo decapitated thug leave body park railing
0,1,5,25,1,5,0,30,0,uk house commons' speaker resigns
0,3,7,31,2,7,0,38,0,scream painter edvard munch get new museum
0,2,2,55,1,9,0,57,0,bonn meeting end last-minute compromise paris climate text
0,1,2,35,0,5,0,37,0,los angeles wildfire nearly contained
0,1,7,15,5,7,2,22,0,no. 2 oklahoma no. 3 u.n.c. fall
0,1,6,29,0,7,0,35,0,pakistan bring noise final four
0,3,4,72,3,12,0,76,0,canadian church volunteer 'stopped entering u fear they'd steal american jobs'
0,3,2,48,0,7,0,50,0,fraudsters target thousand online christmas shopper
0,1,6,31,2,7,6,37,0,"unhcr: 200,000 people displaced violence yemen"
0,2,8,41,1,10,4,49,0,robert durst case: hearing focus mystery 1982 phone call
0,3,12,34,4,10,3,46,0,"w2w4: blackhawks lightning, game 5 cross check blog- espn"
0,3,0,59,2,11,6,59,0,"100,000 child missed school family holiday last year, figure show"
0,3,12,35,2,10,4,47,0,"jonathan isaac declares 2017 nba draft, return fsu"
0,3,3,56,3,11,0,59,0,"reddit ban result new ""fat steeple hate"" subreddit business insider"
0,1,1,66,0,10,0,67,0,brazilian environmentalist tell resident urinate shower save water
0,3,6,50,2,9,0,56,0,queensland state seat could pauline hanson's one nation win?
0,2,4,51,1,11,0,55,0,voice america: learned speaking voter across u
0,1,4,60,0,10,0,64,0,united state authority bust multimillion dollar drug ring new jersey
0,1,4,62,2,11,0,66,0,e.c. president advise portuguese referendum light current crisis
0,3,2,43,0,8,0,45,0,saturday morning may icy mess around washington
0,2,9,65,3,14,1,74,0,"espn segment show craziest part lebron james insane, finals-saving block game 7"
0,2,7,37,3,6,0,44,0,esquire panic! global warming creating vast desert
0,3,5,61,5,13,0,66,0,"best photo day: sydney mardi gras, china's people congress mosul, iraq"
0,1,3,54,0,8,0,57,0,pacific rim brace tsunami following major chilean earthquake
0,2,14,44,3,11,0,58,0,chaffetz break utah gop call delay town hall violence
0,2,10,37,3,9,0,47,0,want raise? u.s. industry driving wage growth
0,3,11,50,1,13,1,61,0,"one 6 american adult say taken psychiatric drugs, report say"
0,2,11,38,3,11,0,49,0,"john key, new zealand prime minister, say step"
0,1,8,36,0,10,0,44,0,mets using tour lure sell ticket citi field
0,3,1,37,0,6,0,38,0,brussels attack survivor walking one year
0,1,7,46,1,8,0,53,0,"eu investigate secret cia establishment romania, poland"
0,1,2,54,1,9,0,56,0,"radioactive part mistakenly sold, melted scrap metal china"
0,2,1,69,2,11,0,70,0,disney rep say company plan thoroughly review alligator signage attack
0,2,12,39,0,11,0,51,0,food one serving meal wheel give senior
0,2,10,45,1,11,2,55,0,park service name 24 diverse national landmark new york time
0,1,5,29,1,5,0,34,0,"mercedes focus image, recession"
0,1,5,29,0,5,0,34,0,new york governor eliot spitzer resigns
0,2,8,11,0,6,4,19,0,matt ryan 2016 nflmvp
0,2,7,37,1,8,0,44,0,"clinton, trump aide angrily clash election forum"
0,3,18,51,2,13,0,69,0,trump urge stronger push isi could include big u.s. presence syria
0,2,11,55,0,11,0,66,0,former child soldier among million migrant making way europe
0,3,4,55,0,12,0,59,0,new jersey state trooper help deliver baby girl side interstate
0,3,3,46,2,12,6,49,0,"$100,000 cash found stashed old tv canadian recycling plant"
0,2,8,45,2,8,0,53,0,"treasury fall, stock mixed commodity gain: market wrap"
0,2,5,38,5,9,0,43,0,trump: great respect unfair new yorktimes
0,1,2,35,1,7,2,37,0,car bomb kill 15 pakistani anti-terror unit
0,3,2,58,2,11,0,60,0,"young man died police custody, middle-class chinese outraged"
0,3,4,60,0,12,0,64,0,veteran sending hundred pizza deployed troop super bowl sunday
0,3,5,37,3,8,0,42,0,oscars: what's academy award goodie bags?
0,3,5,26,0,5,0,31,0,bank retreat apartment market
0,2,9,29,1,8,2,38,0,riot fest co-founder sean mckeough dy age 42
0,3,12,45,3,11,0,57,0,queer character westworld either evil ormissing?
0,3,7,39,1,9,0,46,0,colt fire gm ryan grigson; chuck pagano remain coach
0,3,4,43,0,9,0,47,0,tina fey blast white woman supporting donald trump
0,2,3,40,4,8,0,43,0,kamiyah mobley: 'tears joy' stolen baby's family
0,3,9,56,1,11,0,65,0,supreme court review lexmarks power prevent resale toner cartridge
0,1,6,72,1,12,0,78,0,ngo taiwan promote carbon-decreasing movement different sector earth day
0,1,5,46,0,9,2,51,0,special olympics founder eunice kennedy shriver dy age 88
0,1,6,28,0,6,0,34,0,xavier turn back upset bid wisconsin
0,2,1,74,6,15,0,75,0,ikea debuted bizarre new collection inspired 'todays nomadic youth' take look
0,1,3,35,1,7,0,38,0,"second day snow uk, disruption continues"
0,1,3,43,0,6,0,46,0,ariane rocket launch skynet turksat spacecraft
0,3,10,43,1,10,0,53,0,"nightly news one uber driver part driver, part matchmaker"
0,1,7,29,0,7,0,36,0,wild cossack ride cultural battle
0,2,12,41,2,11,0,53,0,japan pm abe visit pearl harbor console soul victim
0,3,4,58,3,16,0,62,0,age caesar: fresh look key player time historic unrest
0,2,3,37,0,8,0,40,0,audrey hepburn photo go display london
0,3,5,56,1,11,0,61,0,syrian refugee girl bana alabed announces book deal simon schuster
0,2,2,50,1,8,0,52,0,pakistan: woman sentenced death burning daughter alive
0,3,5,52,1,11,0,57,0,here's perfect way participate random act kindness week
0,1,8,37,0,8,0,45,0,button revives career formula one racing team
0,2,12,64,4,12,0,76,0,"nielsen music's first-quarter numbers: explosive growth streaming, much vinyl"
0,1,8,37,0,8,0,45,0,emotion run high hornet knicks halt skid
0,2,1,39,0,6,0,40,0,washington shooting suspect found dead cell
0,2,3,55,3,10,0,58,0,'top chef' alum get political receipts: immigrant cooked food
0,1,5,27,0,5,0,32,0,european share fall gloomy report
0,3,13,58,0,12,0,71,0,trump could roll back decade progress made immigrant detention humane
0,3,3,58,1,12,0,61,0,march trump: violence woman earth linked
0,3,3,61,1,9,0,64,0,u ban electronic device flight eight majority-muslim country
0,3,10,39,3,8,0,49,0,bob diamond mount latest comeback u.k. minor league
0,2,5,17,1,5,0,22,0,left phony war gun
0,1,6,37,0,6,1,43,0,unexploded ww2 bomb discovered schiphol airport
0,1,4,23,0,5,0,27,0,secret talent scout
0,3,4,46,3,10,3,50,0,"edwin encarnacion, indian agree 3 years, $60m club option"
0,2,2,49,1,9,2,51,0,blackberry spending $75 million auto hub several year
0,3,4,55,1,10,2,59,0,aclu receives $24 million donation amid immigration ban controversy
0,1,2,51,1,8,0,53,0,"low fare airline, ryanair celebrates twenty year business"
0,3,2,55,1,10,0,57,0,sheriff offering inmate help build trump's proposed border wall
0,3,9,40,0,9,0,49,0,hedge fund training computer think like
0,3,2,64,1,11,0,66,0,pause aleppo fighting spur thousand civilian flee rebel-held area
0,1,2,35,0,5,0,37,0,suresh joachim break ironing world record
0,2,9,38,2,8,0,47,0,government: wont cuffed student loan default
0,1,5,38,1,7,0,43,0,"whale kill trainer seaworld orlando, florida"
0,2,12,66,4,15,0,78,0,youre hired: donald trump pick gov. nikki haley ambassador united nation breitbart
0,1,4,34,1,5,0,38,0,"shrinking city debut detroit, michigan"
0,3,8,35,0,7,0,43,0,uber chief travis kalanick ride recent storm
0,2,8,43,5,10,0,51,0,necessary: cant stump trump take victory lap breitbart
0,1,2,28,2,5,0,30,0,un 'optimistic' tsunami aid effort
0,2,3,82,1,19,0,85,0,donald trump make harder low-income family buy house one first act president
0,3,7,44,3,8,0,51,0,fbi director james comey 'incredulous' trump's tweet
0,1,3,17,0,3,1,20,0,apple launch 3g iphone
0,3,4,41,5,10,6,45,0,"second jane austen 5 note 'worth 50,000' found christmas card"
0,1,1,20,1,2,0,21,0,taiwan's cabinet resigns
0,1,4,48,2,9,2,52,0,u air carrier spirit airline announces $45 carry-on baggage fee
0,1,2,44,2,7,2,46,0,openoffice.org office suite version 2.0 released
0,3,4,42,1,6,0,46,0,chapecoense air crash: bolivia suspends lamia airline
0,3,11,50,3,14,0,61,0,"frank ocean share preview new song ""biking f/ jay z tyler, creator"
0,1,1,62,1,8,0,63,0,"australian man allegedly ignites carpet, plastic static electricity"
0,2,9,38,3,9,4,47,0,bangkok world's visited city 2016 [infographic]
0,2,1,43,2,5,0,44,0,apple 'spaceship' headquarters ready boarding
0,1,2,29,0,4,0,31,0,child massacred kenyan school
0,3,7,28,2,6,0,35,0,kenya want double u.s. coffee shipment
0,1,4,49,0,8,0,53,0,u house representative pass universal health care bill
0,3,14,55,4,14,0,69,0,watch mike myers jimmy fallon compete usa vs. canada dance-off 'tonight show'
0,2,2,55,1,11,0,57,0,islamic state dealt hefty body blow death top aide: official
0,2,11,43,5,12,0,54,0,"trump, russia go thursday foe u.s. friday friend"
0,3,9,37,2,11,0,46,0,boeing speaks trump term iran deal: job
0,1,4,47,0,9,0,51,0,tamil tiger promise fight back sri lankan force
0,3,9,47,2,11,2,56,0,"happy 38th birthday, aaliyah: look lasting impression style"
0,3,12,37,2,12,0,49,0,oculus lost market leadership -- win back
0,1,6,36,0,6,0,42,0,data retention directive passed eu parliament
0,1,13,54,2,14,0,67,0,south korea u.s. joint force raise alert level north issue threat
0,3,4,22,1,8,4,26,0,mma fight we'd like see 2017
0,2,9,56,3,9,2,65,0,"bakersfield police fatally shoot unarmed grandfather, 73, dementia: family"
0,1,2,38,0,6,0,40,0,armenia send military force afghanistan
0,3,9,46,1,10,0,55,0,"deputy use drone, thermal imaging find teen runaway insider"
0,2,9,49,5,11,0,58,0,trump draw line: hollywood vs. georgia june runoff election
0,1,3,30,0,5,0,33,0,two shot outside los angeles nightclub
0,3,8,28,3,8,0,36,0,"nav release new track ""some way"" f/ weeknd"
0,2,7,39,4,10,0,46,0,eric shawn reports: 'do trust iran'| latest news video
0,1,1,35,0,5,0,36,0,apple top contaminated produce list
0,1,2,30,0,6,2,32,0,u unemployment rate highest 26 year
0,3,10,37,1,10,0,47,0,best moment big sean's show radio city music hall
0,1,6,32,0,6,0,38,0,debt settler offer promise little help
0,2,2,54,3,11,0,56,0,schoolgirl crush. close friend little sister.
0,2,6,48,1,8,0,54,0,hearing highlights: session questioned link xenophobia
0,3,2,57,2,9,0,59,0,google alters search autocomplete remove 'are jew evil' suggestion
0,1,3,8,0,2,0,11,0,four top
0,3,1,87,0,12,0,88,0,romanian government scrap controversial corruption decree thousand join day mass protest
0,1,4,17,0,4,0,21,0,bali defies fatwa yoga
0,3,11,44,3,10,0,55,0,germany drop inquiry claim u.s. tapped angela merkels phone
0,1,3,33,1,4,0,36,0,toshiba transatlantic challenge success
0,2,4,61,3,11,0,65,0,"'new york times' jump gun, announces pulitzer win way announcement"
0,3,4,52,0,11,0,56,0,penny open asian trip amid increasing tension north korea
0,2,15,69,3,18,4,84,0,watch e! news season 2016 excerpt free online kardashian christmas card year yahoo view
0,1,10,39,0,10,0,49,0,lawson big toe help north carolina run past gonzaga
0,2,7,35,3,8,0,42,0,daily: defiant display conservative unity
0,3,6,54,4,14,0,60,0,get involved women's march washington d.c.
0,3,16,56,4,14,0,72,0,"bill o'reilly call vladimir putin 'killer', donald trump say american bad"
0,3,2,62,0,11,0,64,0,gopro finally realizes smartphones exactly camera
0,2,1,56,1,7,0,57,0,pikachu-themed battery recalled overheat
0,1,3,70,0,10,0,73,0,norwegian military security agency accused conducting illegal surveillance pm
0,2,10,43,1,10,2,53,0,cuppa thugs: brutal smuggler ran 18th century tea cartel
0,1,5,39,1,7,0,44,0,"optimism washington, pessimism wall street"
0,2,3,36,4,7,0,39,0,"deutsche bank investors: no, really, werefine"
0,3,3,54,1,9,0,57,0,seth meyers shuts trump's wall exposing inconsistency
0,2,2,55,3,11,0,57,0,smerconish: trump withdrew climate deal throw base bone
0,3,3,41,0,10,0,44,0,police search man shot sikh seattle suburb
0,2,3,60,1,10,0,63,0,rumor google's next pixel smartphone already starting emerge
0,2,1,48,1,8,0,49,0,orlando shooter's wife pleads guilty aiding husband
0,1,5,35,0,5,0,40,0,swindler find growing market foreclosure
0,2,12,57,2,12,0,69,0,producer much alive mistakenly included oscar 'in memoriam' tribute
0,2,8,44,1,7,0,52,0,pittsburgh offer driving lesson ubers autonomous car
0,2,2,78,3,14,0,80,0,croydon 'hate crime': police release image three suspect brutal attack teen refugee
0,2,11,47,3,13,0,58,0,sanders: ill beat hillary iowa large turnout breitbart
0,1,1,39,1,5,0,40,0,wikileaks.org restored injunction lifted
0,1,7,33,1,7,0,40,0,osama obama: bin laden address u president
0,3,4,54,2,12,0,58,0,tillerson germany first trip abroad u.s. secretary state
0,1,2,43,0,9,0,45,0,new zealander blind one eye novelty lens
0,1,6,39,0,7,0,45,0,mortgage turn lucrative bank second quarter
0,1,6,34,1,6,0,40,0,unexpected journey anonymous all-star
0,3,5,75,3,15,0,80,0,"draymond green, whose team leaving oakland, want fan boycott raider leaving oakland"
0,1,6,39,0,8,0,45,0,governor illinois call increase income tax
0,1,3,31,0,5,0,34,0,msn browser upgrade leaf user frozen
0,1,5,48,1,9,0,53,0,football: chelsea beat wigan win fourth premier league title
0,2,10,55,1,11,0,65,0,anthrax distance global music right's radio fight open letter
0,2,5,54,2,10,0,59,0,google bad week: youtube loses million advertising row reach u
0,1,3,35,0,6,0,38,0,slovenian alpinist rescue nanga parbat
0,1,2,48,2,9,0,50,0,"chicago man pleads ""not guilty"" mumbai attack plot charge"
0,1,9,32,0,7,0,41,0,nascar driver montoya win pole new hampshire
0,2,5,59,1,10,0,64,0,ex-power ranger ricardo medina pleads guilty killing roommate sword
0,3,5,20,1,6,0,25,0,bill o'reilly fox news
0,3,4,57,1,11,0,61,0,bloody foot keep emma stone playing tambourine prince
0,3,5,19,0,5,0,24,0,world chess big problem
0,2,10,44,1,9,0,54,0,trump trade rep pick get actual praise progressive
0,1,8,61,1,13,0,69,0,"hillary clinton attends grand opening erie canal harbor buffalo, new york"
0,1,8,34,1,10,0,42,0,"like newspapers, cable tv seek profit web"
0,1,10,54,2,12,6,64,0,2007 fifa u17 world cup: germany eliminates americans; set england quarter final
0,2,8,42,0,9,0,50,0,russia election meddling get airing hill comey
0,2,9,30,0,9,0,39,0,tom brady say super bowl jersey stolen
0,3,1,60,3,11,5,61,0,"macys delivers disappointing holiday season, plan cut 10,000 job"
0,2,9,54,3,10,1,63,0,"brandon spike facing 4 charge connection hit-and-run, abandoned car"
0,1,4,39,1,9,0,43,0,woman's body found home papua new guinea leader
0,1,2,42,1,7,0,44,0,taleban launch attack afghan city; several dead
0,1,7,26,0,8,2,33,0,nias yet receive aid 10 day quake
0,3,10,43,2,8,0,53,0,trump's golf course would benefit water-rule rollback
0,2,3,71,2,13,0,74,0,"joko widodo expected talk trade, trust, tourism foreign tension australia trip"
0,3,7,49,1,7,0,56,0,senate approves trump controversial choice budget director
0,1,3,34,3,7,0,37,0,"urban fox 'mauls' two baby london, england"
0,1,5,34,0,5,0,39,0,australian emission trading plan trouble
0,2,1,27,0,6,0,28,0,teach kid sugar
0,1,7,41,1,9,0,48,0,"obama take oath, nation crisis embrace moment"
0,3,5,57,2,12,2,62,0,china's gdp growth rate expected announced 6.5pc annual parliament
0,1,5,34,0,6,0,39,0,egyptian tycoon sentenced death murder
0,3,7,49,0,12,2,56,0,police arrest 12yo boy trying drive across australia nsw wa
0,3,2,61,0,11,0,63,0,trump tout plan bolster military aboard aircraft carrier virginia
0,1,3,53,1,7,0,56,0,"benet academy, illinois student support classmate leukemia"
0,3,7,57,1,14,0,64,0,quiet passion review cynthia nixon give emily dickinson soul poet
0,1,3,29,0,6,0,32,0,two train collide near rio de janeiro
0,3,15,60,1,14,0,75,0,"slaughter civilian aleppo, bashar assad prepares make nice donald trump"
0,3,9,47,1,9,0,56,0,community celebrates missing mom's return welcome home party
0,1,5,24,1,7,0,29,0,"yamaguchi ice, home"
0,2,5,53,0,12,0,58,0,fbi investigating shooting two indian men kansa hate crime
0,2,11,47,6,12,0,58,0,forbes encourages trump push 'massive' tax cut plan: 'why wait?' insider
0,3,3,38,0,8,0,41,0,tobacco firm flout uk law plain packaging
0,2,1,74,1,10,0,75,0,middle-aged people consider taking magnesium supplement protect bone
0,3,10,59,6,11,0,69,0,"gingrich blast media: 'these reporters, propagandists!' insider"
0,2,10,43,0,9,0,53,0,ailing sushma swaraj may undergo kidney transplant next week
0,2,6,25,0,9,4,31,0,watch 65 year today fly 65 second
0,2,12,54,5,9,0,66,0,melissa mccarthy play tree-hugging eco-warrior kias super bowl commercial
0,2,11,37,3,11,2,48,0,"man charged theft john legend's bag, $25k cufflink jfk"
0,2,7,46,3,9,0,53,0,video voyeur arrested harassing woman target breitbart
0,3,6,35,1,8,0,41,0,"built steel, pittsburgh thrives culture"
0,2,2,87,3,18,0,89,0,looking me? monkey learn recognise mirror key indicator self-awareness
0,3,5,47,2,11,1,52,0,full text: read 9th circuit court's ruling trump travel ban
0,1,5,31,0,5,0,36,0,financial unit weighs general electric
0,1,5,32,0,7,1,37,0,saudi king dismisses 2 official shuffle
0,2,8,44,2,11,4,52,0,"world billionaire rank fell 2016, combined wealth"
0,2,8,60,2,10,0,68,0,television graphic confuses georgia's flag university georgia's logo
0,2,12,47,3,12,0,59,0,henry rollins: white people would lose mind forced black
0,1,2,45,0,8,0,47,0,australian death row vietnam smuggling heroin
0,2,7,45,0,6,0,52,0,hungarian president sign university law sparking protest
0,1,3,40,1,7,0,43,0,"mayor flint, michigan resigns health reason"
0,3,12,49,2,14,0,61,0,"dennis schroder going star, he's making sure everyone know"
0,1,5,38,0,6,0,43,0,ricky hatton regains ibf light welterweight title
0,3,11,55,0,11,0,66,0,protester dress kkk garb protest jeff session confirmation hearing
0,2,5,55,2,11,0,60,0,"no, former president obama planning coup president trump"
0,1,11,34,4,8,0,45,0,boston university stuns miami win fifth n.c.a.a. title
0,1,6,35,1,5,0,41,0,"stimulus also requires stability, bernanke say"
0,1,7,34,0,6,0,41,0,rhode island weighs using shorter official name
0,3,1,38,1,7,0,39,0,male female doctor better patients?
0,2,4,41,1,7,0,45,0,"trump fire irs commissioner, lawmaker demand"
0,2,4,59,1,14,4,63,0,tim allen say conservative hollywood like living 1930's germany
0,3,18,63,0,17,0,81,0,new life begin rio medallist sakshi malik tie knot fiance satyawart kadian
0,1,2,34,0,6,0,36,0,small plane crash florida destroys home
0,2,18,57,1,19,6,75,0,rewind 2016 virat kohli blow away west indie india still miss world t20 final berth
0,3,3,46,2,7,0,49,0,kim jong-nam death: malaysian police arrest female suspect
0,3,8,48,1,12,0,56,0,economist trump: paying wall least worry
0,1,2,44,1,7,0,46,0,uruguay senate give green light same-sex marriage
0,1,5,33,2,8,2,38,0,"hugh carey, former new york governor, dy aged 92"
0,3,10,40,4,10,1,50,0,j. cole 4 eyez empathetic condescending
0,3,6,58,3,12,0,64,0,jump: bradley wiggins latest victim tv celeb-mangling show
0,3,7,44,2,8,2,51,0,musk nearing $1.4 billion windfall tesla achieves milestone
0,2,3,34,1,5,2,37,0,singer-songwriter peter sarstedt dy aged 75
0,2,6,32,1,9,1,38,0,little mix song remixed: listen 7 best
0,3,4,84,1,18,0,88,0,pope worried hackers? snap show pontiff reading ipad camera blocked sticker
0,2,6,45,4,8,0,51,0,trader paying 'extortionate fees' short snapchat (snap)
0,2,5,45,3,9,2,50,0,liverpool 2-0 tottenham hotspur: premier league happened
0,2,18,33,3,12,0,51,0,"remy ma's ""shether"" one savage dis track ever"
0,2,13,58,3,13,2,71,0,interscope blanket l.a. bus stop ad celebrating steve berman's 25th year label
0,1,8,31,0,8,0,39,0,biden outline plan less power
0,1,3,48,1,7,0,51,0,record number viewer watched mccain's acceptance speech
0,2,11,39,2,10,0,50,0,andy cohen think trump pretty much 'real housewife'
0,2,7,40,2,8,0,47,0,nuclear option: lester medium molester breitbart
0,2,4,29,1,7,0,33,0,"retail sale tick higher, anz job ad dip"
0,2,11,54,1,10,0,65,0,donald trump voter fraud fixation offer window governing via twitter
0,2,11,52,1,10,0,63,0,"trump family tried auction coffee ivanka, raising ethical concern"
0,2,2,46,1,9,4,48,0,"deutsche bank cut tie 3,400 client trading business"
0,1,3,20,2,3,0,23,0,"iraq executes ""chemical ali"""
0,2,11,53,3,12,0,64,0,adidas' slept-on collection inspired bob marley's love brand
0,2,3,48,1,8,0,51,0,court unanimously ousts south korea's leader corruption
0,2,4,50,3,11,6,54,0,"u.s. accuses fiat chrysler trying mask emission 100,000 vehicle"
0,2,2,41,0,8,0,43,0,meet woman made american space history
0,3,10,44,1,9,0,54,0,"russia possibly behind brexit vote website crash, panel say"
0,3,2,56,3,10,0,58,0,"koch network condemns trump immigration ban, call 'wrong approach'"
0,1,2,39,1,7,0,41,0,iraqi rebel seize control ramadi's inner city
0,3,8,73,2,15,2,81,0,brexit vote: theresa may win common approval trigger article 50 labour's clive lewis resigns
0,2,7,42,1,11,0,49,0,"jack dorsey return twitter chief, shrug quip"
0,2,7,42,1,7,0,49,0,"refugee arrival decline sharply trump, say report"
0,1,1,66,2,13,5,67,0,"chinese quake death toll nears 32,500, major aftershock occurs mourning begin"
0,1,2,31,0,5,0,33,0,sri lankan military liberates key town
0,3,2,56,0,9,0,58,0,indian police accused raping woman restive chhattisgarh state
0,1,4,71,0,12,0,75,0,swiss canton appenzell innerrhoden fight back invasion german naked hiker
0,2,2,78,1,18,0,80,0,teenage girl told can't bring girlfriend prom internet furious list
0,2,11,42,2,10,0,53,0,welcome mongolia new postal system: atlas random word
0,3,2,69,1,11,0,71,0,"colorado, three generation achieve peaceful family vacation high elevation"
0,1,7,36,0,8,0,43,0,discount force restaurant eat lunch
0,2,5,52,0,10,0,57,0,libyan force fully cleared isi regional capital
0,1,7,43,0,7,0,50,0,former pennsylvania state senator convicted fraud case
0,3,2,53,1,10,6,55,0,"80 year since alcoholic anonymous began, glimpse inside 1965 meeting"
0,3,8,42,0,9,0,50,0,german man killed elephant escaped circus buchen
0,3,4,46,1,9,0,50,0,ivanka trump new title hardly drain white house swamp
0,2,9,37,0,10,3,46,0,lil wayne pass drake hot 100 hit among soloist
0,2,3,61,7,15,0,64,0,border patrol chief: 'if right' wall 'important' 'effective'
0,2,4,26,2,6,0,30,0,trump sits fox news sunday
0,1,7,28,0,8,0,35,0,old men triumph game built youth
0,3,2,52,2,15,0,54,0,"want listen hot new album spotify, time pay"
0,2,3,73,1,13,0,76,0,doj stir free-speech fight demanding libertarian site turn info commenters
0,1,3,16,2,4,4,19,0,euro 2008: austria vs. poland
0,3,8,39,2,8,0,47,0,super bowl glare fix attention texas bathroom bill
0,3,6,44,1,10,0,50,0,"nina simone, tupac elo set receive special honour"
0,1,2,39,0,7,0,41,0,south korean scientist clone dog first time
0,1,4,29,1,5,0,33,0,european football: santa cruz rover
0,1,4,40,2,6,0,44,0,"hillary clinton win pennsylvania, cut obama's lead"
0,1,2,48,0,7,0,50,0,uzbek president blame outlawed islamist group death
0,1,3,44,0,7,2,47,0,former professional wrestler giant gonzlez dy aged 44
0,3,4,30,1,4,0,34,0,vote: nfl conference championship pick
0,1,6,33,0,5,0,39,0,bermuda premier escape censure uighur
0,2,4,44,0,10,0,48,0,contractor say trump refusing pay work dc hotel
0,1,1,67,3,11,0,68,0,"road accidents, suicide, pregnancy violence among top killer world's youth"
0,2,12,55,1,11,0,67,0,"david price underwent mri elbow injury, scratched spring training start"
0,3,15,30,6,10,0,45,0,"donald trump: germany owes 'vast sum money' nato, u.s."
0,2,10,52,1,10,1,62,0,3rd night charlotte protest peaceful; protester shot wednesday dy
0,1,1,33,0,5,0,34,0,nightwish announce detail new album
0,3,8,70,1,16,0,78,0,"bruno mar tell james corden seduce women, sing along uptown funk carpool karaoke"
0,2,8,53,1,12,0,61,0,cbi warns brexit divorce bill row putting eu-uk trade tie risk
0,1,2,28,0,6,5,30,0,russian boeing 737 crash 88 aboard
0,3,2,49,2,7,0,51,0,follow car! toll-collecting bureau step enforcement
0,1,1,42,0,5,0,43,0,israeli court order controversial wall rerouted
0,2,1,44,2,11,3,45,0,"snap share drop 4 percent, fall $20 first time"
0,3,11,54,2,13,0,65,0,label using 'playlist albums' break new artist streaming era
0,3,14,38,0,10,0,52,0,ryan adam cancel acl live performance sxsw due illness
0,3,11,44,7,10,0,55,0,marine marine: veteran lawmaker praise gen. mad dog mattis pick
0,2,2,63,3,10,0,65,0,jewish employee trump son-in-law writes open letter antisemitism row
0,3,12,60,4,12,0,72,0,"director judd apatow support far-left berkeley riot, warns beginning"
0,3,1,72,4,16,2,73,0,cartier bos $7.5bn fortune say prospect poor rising 'keeps awake night'
0,1,3,32,1,6,0,35,0,barclays bank credit rating cut moody's
0,2,2,44,2,10,2,46,0,"1 killed, 2 hurt shooting downtown fresno, california"
0,1,4,68,2,11,0,72,0,toyota employ japanese hybrid solar powered vehicle carrier ship 'auriga leader'
0,3,6,53,2,11,0,59,0,"pfa player year award: kant, hazard ibrahimovic shortlist"
0,3,10,59,5,15,1,69,0,watch time-lapse two people eating ihops 'all eat pancakes' 5 hour
0,3,7,35,2,8,4,42,0,"beyonc, adele, drake garner nod 2017 grammy award"
0,2,12,47,2,11,0,59,0,"rasila's killer stationed another floor, far murder spot"
0,3,5,45,5,8,0,50,0,new 'logan' trailer feature wolverine reading 'x-men' comic
0,1,3,38,0,5,0,41,0,explosion afghanistan kill british soldier
0,1,9,42,2,9,0,51,0,u.s. issue scathing report immigrant died detention
0,3,11,30,0,9,0,41,0,ikea going sell rug made syrian refugee
0,1,2,39,2,6,0,41,0,"federal response katrina ""national disgrace"""
0,1,4,23,0,4,0,27,0,ethnic fighting erupts sudan
0,2,3,47,1,8,0,50,0,egyptair crash: body crew member returned family
0,3,7,44,3,10,0,51,0,"golf summit? trump tee up, talk obamacare paul, mulvaney"
0,2,7,30,1,8,0,37,0,hooked smartphones new york time
0,3,2,43,0,6,0,45,0,protester rally istanbul referendum result
0,2,6,82,4,16,0,88,0,"ian mckellen: facing on-set, christopher lee true gentleman touchingly nervous"
0,2,4,47,1,8,0,51,0,fidel castro: thousand attend rally former cuban leader
0,3,4,50,2,12,0,54,0,one keep straight face 'snl' sketch chocolate
0,1,2,41,1,8,0,43,0,"uk beer, soft drink delivery driver vote strike"
0,1,4,35,2,5,2,39,0,"philadelphia flyer beat montreal canadiens, 3-2"
0,1,8,36,1,7,0,44,0,"helicopter plan excessive, obama mccain agree"
0,2,3,54,2,11,0,57,0,'rogue one' earned biggest thursday preview movie year
0,1,7,31,1,7,0,38,0,"sri lanka, kouchner miliband urge truce"
0,3,3,41,1,9,0,44,0,"eye toward trump, arab leader seek consensus"
0,2,12,52,3,12,2,64,0,"strapped student blow $1.5 million bank glitch cars, boat stripper"
0,1,2,39,1,7,0,41,0,saturn's moon titan host liquid lake river
0,3,6,58,2,12,0,64,0,expect carrie fisher debbie reynolds' public memorial yahoo
0,1,2,55,2,10,2,57,0,fannie mae forgives mortgage debt 90-year-old woman shot
0,3,4,56,2,9,0,60,0,aleppo dentist brings 'hollywood smiles' somali fleeing syria
0,2,6,37,0,7,0,43,0,chipotle continues rocky path earnings slide
0,1,5,24,0,5,0,29,0,uk government announces cut vat
0,2,8,38,2,10,2,46,0,police find $1.2 million worth weed old nuclear bunker
0,3,4,55,0,9,0,59,0,philippine army find body beheaded german hostage jurgen kantner
0,1,9,32,0,7,0,41,0,retailer say loss cit threatens supply chain
0,1,6,32,0,5,0,38,0,keeping true identity online becomes battle
0,3,12,52,1,11,0,64,0,"soulja boy reportedly slapped felony gun charge, could face prison time"
0,1,9,47,1,9,0,56,0,financial crisis dims hope giant cross-border bank europe
0,3,4,48,0,10,1,52,0,national steak poultry recall nearly 2m pound chicken
0,3,3,67,4,14,0,70,0,"trump's ongoing feud russia, say opposed better relation 'fools'"
0,3,2,55,0,12,0,57,0,eminem prof lot word rhyme orange list
0,1,8,46,0,9,0,54,0,political swing tennis player sour dubai tournament
0,2,2,66,0,15,0,68,0,melania remind donald put hand heart national anthem
0,3,14,51,2,13,0,65,0,"bangkok, celebrated street food, ordering vendor get road"
0,1,10,44,3,8,0,54,0,s.e.c. head say initiative sharpen focus investor protection
0,3,5,67,1,11,0,72,0,salesman director asghar farhadi upset right-wing critic oscar win speech
0,3,5,66,3,12,0,71,0,brexit: theresa may attacked 'morally wrong' decision delay eu citizen right
0,1,1,61,2,10,4,62,0,"australian report show emission increase ""more doubled since 1990s"""
0,2,3,43,0,7,0,46,0,barack obama visit scotland charity fundraiser
0,2,3,38,0,6,0,41,0,debate break north carolina billboard
0,2,10,31,2,10,2,41,0,"no, melania trump want wire $20 million"
0,1,4,51,1,9,0,55,0,"five boy charged raping girl greater manchester, england"
0,2,12,42,4,10,0,54,0,"x-files reboot brings back mulder, scully search truth"
0,1,7,24,3,4,0,31,0,i.o.c. bar international torch relay
0,1,10,47,0,11,0,57,0,crew american cargo ship describes ordeal pirate attack
0,3,3,42,1,6,0,45,0,dalai lama's rapturous welcome buddhist monastery
0,1,2,36,1,5,0,38,0,australia's howard call nativity scene
0,3,8,71,0,15,0,79,0,four tet make spotify playlist music muslim country donald trump banned u
0,2,8,41,1,9,0,49,0,montana mine test trump team appetite china deal
0,3,13,52,3,14,0,65,0,bill nye science guy climate change trump: maybe world end
0,1,7,22,3,6,0,29,0,case paying a.i.g. bonus
0,3,8,38,1,7,0,46,0,china internet censorship: new york time apps removed
0,1,10,36,0,10,0,46,0,worker jlg france use threat win severance pay
0,2,4,33,2,4,0,37,0,could veteran concussion-related cte?
0,2,14,37,4,12,0,51,0,"u.k. voter head polls, eye london mayoral race"
0,1,3,32,0,5,0,35,0,russian polar submarine tv footage faked
0,1,5,28,0,5,0,33,0,net worth family decline sharply
0,3,1,45,2,6,0,46,0,'pizzagate' shooting suspect facing new federal charge
0,1,3,62,0,11,2,65,0,mark latham fight 12 month resigning australian opposition leader
0,1,8,42,2,9,0,50,0,wrenching management shuffle u.s. olympic committee
0,3,2,58,0,8,0,60,0,turkish opposition party contesting referendum result
0,1,2,50,1,6,0,52,0,un holding recruitment exam under-represented country
0,1,6,32,0,7,0,38,0,pope slip break right wrist vacation
0,2,8,48,0,9,0,56,0,taiwan president spotlight telephone call trump
0,2,7,56,4,9,0,63,0,"kareem abdul-jabbar: crucial election, im endorsing hillary clinton"
0,1,2,23,1,3,0,25,0,turkey ban pro-kurdish party
0,2,4,27,0,5,0,31,0,baylor hire temple coach matt rhule
0,1,2,60,0,11,0,62,0,death toll arizona helicopter collision seven survivor dy
0,1,4,42,0,9,2,46,0,suspect btk killing arrested 25 year hiding
0,1,6,50,2,9,0,56,0,"uk transport minister ""pied"" launch future heathrow group"
0,2,3,43,7,12,0,46,0,mark late non-call: 'had idea ... nobody made aware'
0,3,6,42,1,10,2,48,0,"saint line, lb reuben foster snatched 49ers"
0,1,5,25,0,7,0,30,0,new lesson army iraq duty
0,1,6,33,0,6,0,39,0,bobby bowden fumble chance greater legacy
0,2,12,70,4,14,0,82,0,donald trump: perhaps angela merkel wiretapped obama administration breitbart
0,3,2,42,1,5,0,44,0,trump's senseless syria strike accomplish nothing
0,2,5,61,2,12,3,66,0,"u airstrike kill 100 alleged al-qaida militant syria, pentagon say"
0,3,4,45,0,10,0,49,0,army vet awarded bronze star bravery vietnam battle
0,3,13,44,4,12,0,57,0,trump pressure get answer iran missing ex-f.b.i. agent
0,2,12,50,2,9,0,62,0,"johnny manziel reportedly drawing interest nfl teams, re-hired agent"
0,2,13,62,3,12,0,75,0,president obama writes note praising 'diverse tales' honored sunday's golden globe
0,3,4,49,4,9,0,53,0,trump blocked fha mortgage-insurance cut -- here's mean
0,1,1,67,0,12,0,68,0,idaho company claim new record transmitting data across wireless link
0,3,16,64,10,17,0,80,0,lox forthcoming 'filthy america' album: 'don't think going hear bunch conscious s---'
0,2,3,42,2,8,0,45,0,"gonzaga team come from? well, everywhere"
0,1,3,43,2,8,2,46,0,"yegor gaidar, russian economist politician, dy 53"
0,2,10,45,1,9,0,55,0,"california nevada, brief respite powerful storm"
0,3,7,37,1,7,0,44,0,"debbie reynolds, carrie fisher joint funeral"
0,3,5,51,1,9,0,56,0,anti-immigrant one nation party shunned western australia poll
0,1,5,56,3,9,0,61,0,chef appeared gordon ramsay's 'kitchen nightmares' commits suicide
0,1,7,61,0,10,2,68,0,indian army celebrates victory day 35th anniversary bangladeshi liberation
0,1,4,33,1,5,4,37,0,"virginia governor commute 1,000th u execution"
0,3,1,47,0,9,0,48,0,iowa fire department welcome six baby seven month
0,2,15,42,1,14,0,57,0,waiting see win iowa? take look past winner fared
0,3,2,60,1,10,0,62,0,peru prepare withstand devastating flood landslides?
0,2,3,64,0,13,0,67,0,ferry crash leaf five people hospital holiday island gran canaria
0,3,10,54,2,12,0,64,0,justin trudeaus family vacation aga khan island lead ethic inquiry
0,2,1,36,1,8,0,37,0,time start searching nextcar
0,2,13,50,3,13,0,63,0,"kesha claim dr. luke support new album, want leave penniless"
0,3,8,50,4,8,0,58,0,artist record joan manuel serrat's 'mediterraneo' refugees: watch
0,1,7,44,0,8,0,51,0,south african president jacob zuma chooses new police chief
0,3,3,47,0,9,0,50,0,ice rip prankster jamming hotline report space alien
0,2,11,63,1,11,0,74,0,"raider punter marquette king challenge bronco fan fight, deletes account instead"
0,2,6,33,0,7,0,39,0,irish whiskey gain popularity new cachet
0,3,3,47,0,8,0,50,0,historic queen mary ocean liner could sink without repair
0,3,6,25,2,5,4,31,0,world's highest-paid musician 2016
0,1,2,41,0,9,2,43,0,coordinated series bomb kill least 80 india
0,2,1,49,0,8,0,50,0,finland pay unemployed citizen monthly income trial
0,3,8,39,5,10,0,47,0,'castle hill' ed sheeran's next single 'divide'
0,1,9,51,1,12,0,60,0,"leipheimer coast tour california, armstrong part pack"
0,2,3,57,1,12,0,60,0,use multiple phone number single phone t-mobile
0,2,11,65,1,12,0,76,0,berkeley sends email faculty calling coddling undocumented student breitbart
0,2,3,57,1,9,0,60,0,catalan ex-leader artur ma banned office illegal referendum
0,1,7,38,3,9,4,45,0,wikimania 2008: mediawiki use u.s. department state
0,2,1,48,0,9,3,49,0,nearly 200 nation agree binding deal cut greenhouse gas
0,2,3,45,0,9,0,48,0,michael sweetney tried kill knicksrookie
0,1,8,29,0,5,0,37,0,delta ii rocket launch glast observatory
0,3,9,41,2,8,0,50,0,"fishing village held tiny, heartwarming womensmarch"
0,2,1,66,3,11,0,67,0,non-verbal six-year-old boy deaf dog learn communicate using sign language
0,2,8,45,1,8,0,53,0,"manhattan rent decline every apartment size, even studio"
0,3,8,51,1,10,0,59,0,netanyahu visit: israel pm praise malcolm turnbull calling un
0,1,6,37,0,5,0,43,0,soaring cost jeopardize missile defense program
0,3,4,47,1,9,0,51,0,years-long case michael jordan win china court ruling
0,2,9,22,2,6,0,31,0,here's trump's fcc might look like
0,1,3,20,0,5,2,23,0,author vine deloria dy 72
0,1,4,35,0,6,0,39,0,bickering bogey montgomerie lyle
0,2,2,66,0,14,0,68,0,ed sheeran fight council plan build cartlodge country home
0,3,4,78,3,12,0,82,0,university apologizes heavy heart great embarrassment hitler valentine day card
0,3,1,55,3,9,2,56,0,18-year-old rescued dachshund living bucket list adventure yahoo
0,3,1,30,1,8,2,31,0,"top 50 video game time, ranked"
0,1,5,68,2,9,0,73,0,illinois high school girl basketball: geneva win benet-naperville north tournament
0,3,9,43,2,8,0,52,0,people spotted apple self-driving test car silicon valley
0,2,6,52,4,9,0,58,0,'she believed helping people': remembering master sgt. debra clayton
0,1,2,35,0,6,0,37,0,makeup oscar nominee list narrowed seven
0,1,4,34,0,8,0,38,0,fast track offer iceland applies join eu
0,2,13,45,2,9,0,58,0,"steve lacy describes working kendrick lamar creating ""pride"""
0,2,8,57,3,8,0,65,0,christina grimmie's family release animated superhero video 'invisible'
0,3,5,33,0,8,0,38,0,manny pacquiao amir khan fight april
0,1,7,64,1,11,4,71,0,australian rule football: drouin 2010 gippsland football league grand final
0,2,8,63,3,12,0,71,0,"donald trump's rhetoric could spark war balkans, warns eu chief jean-claude juncker"
0,3,2,71,3,16,0,73,0,"hailed hero kansa bar shooting, victim said naturally right"
0,3,5,51,1,11,0,56,0,"donald trump leader effort secure brexit, say white house"
0,2,3,50,1,7,0,53,0,berkeley cancel ann coulter visit fearing violentprotests
0,2,13,48,3,11,1,61,0,"meet 2-yo snake charmer australia, catching reptile hobby!"
0,2,8,37,1,8,0,45,0,merkels run fourth term got complicated
0,3,5,55,3,10,0,60,0,sarah palin blast donald trump's deal carrier 'crony capitalism'
0,2,4,51,2,11,0,55,0,"sources: coach k meet duke players, ban locker room"
0,1,7,37,2,8,0,44,0,obama transfer terrorism detainee u.s. trial
0,2,14,40,0,11,0,54,0,fbi join investigation four young men found dead ny park
0,2,16,63,1,14,0,79,0,"mitt romney used powerpoint presentation criticize barack obama, course"
0,3,10,46,2,12,3,56,0,nearly 700 mile fencing us-mexico border already exist yahoo
0,3,8,37,1,7,0,45,0,american democracy survive era inequality?
0,1,11,43,3,11,0,54,0,obama embarks honeymoon. question: long last?
0,1,7,25,2,9,0,32,0,"euro, boon, burden"
0,1,6,60,4,9,0,66,0,"series earthquake hit taiwan, turkey, uzbekistan, kyrgyzstan, indonesia"
0,2,11,55,1,15,0,66,0,greenwood call celebs: use stage pulpit politics insider
0,3,5,50,0,10,0,55,0,classified battle orgreave file released home office
0,3,6,50,0,11,0,56,0,george osborne facing call quit mp evening standard job
0,3,2,53,0,9,0,55,0,donald trump say plan dissolve charitable foundation
0,1,3,31,0,6,0,34,0,pirate seize cargo ship indian ocean
0,1,2,45,1,5,0,47,0,no-confidence vote initiated romanian cabinet
0,1,7,27,0,6,0,34,0,black box iranian air crash found
0,2,2,58,3,11,0,60,0,trump president unthinkable. thats many find fascinating.
0,3,11,53,4,12,0,64,0,"migos, jimmy fallon, root perform ""bad boujee"" office supply"
0,2,10,42,1,9,0,52,0,jeff session suggests crackdown coming legal weed
0,1,4,48,2,8,0,52,0,"new year eve tornado slam northwest arkansas, killing three"
0,1,2,30,0,5,0,32,0,japan airline file bankruptcy
0,3,15,56,3,15,4,71,0,"twitter can't decide whether happy sad r 3,600 crore shivaji memorial"
0,1,3,39,0,7,0,42,0,former worldcom chief found guilty charge
0,3,1,45,0,7,2,46,0,georgia police chief apologizes 76 year lynching
0,1,4,62,1,13,0,66,0,china south east asian nation create world's largest free trade area
0,3,5,52,5,11,0,57,0,wonderful day: veteran undocumented wife wont deported ice
0,1,1,38,0,6,0,39,0,british police charge taxi driver murder
0,2,9,42,0,9,0,51,0,former soviet gymnast olga korbut say goodbye medal
0,2,3,57,1,13,7,60,0,100 woman 2016: frontline woman policing peace afghanistan
0,3,3,32,3,9,7,35,0,"google's new vr camera 17 lens cost $18,000"
0,3,6,61,1,13,1,67,0,"paris attack planner among 3 isi fighter killed drone strike, pentagon say"
0,2,3,53,0,9,0,56,0,mike penny welcomed washington neighbour gay pride flag
0,3,1,44,3,9,0,45,0,science march 'hope' fact-based future
0,1,3,33,2,6,0,36,0,u.s. tugboat latest victim somali pirate
0,2,13,48,4,11,0,61,0,easy writer: walter mosleys passion bringing black la story life
0,1,7,24,1,7,1,31,0,red sox varitek agree 1-year deal
0,1,6,30,1,7,0,36,0,sudan may allow joint un/au force darfur
0,2,7,38,2,7,0,45,0,nevada caucuses: ben carson still fighting breitbart
0,2,5,43,5,9,2,48,0,"jimmy ""superfly"" snuka, pro-wrestling hall famer, dy age 73"
0,3,2,44,2,9,0,46,0,north korea 'ready nuclear attack' amid show force
0,3,9,44,1,9,0,53,0,"retail stumble, beacon shine bank sport arena"
0,2,16,62,1,15,0,78,0,favorite naani jiya return small screen shruti seth confirms shararat sequel!
0,3,4,56,2,12,0,60,0,austrian voted europe mind weekend italian
0,3,2,61,1,11,0,63,0,"rightwing paper leading election charge, may need follow"
0,3,5,23,1,4,0,28,0,democratic party empty rage
0,1,7,35,0,7,0,42,0,new mexico ousts adviser investigated new york
0,3,4,80,0,15,0,84,0,gold spike trump say country take advantage u devaluing currency
0,1,6,35,1,6,0,41,0,"upbeat business cape cod, despite recession"
0,3,8,40,0,10,0,48,0,prince left behind treasure trove see paisley park
0,2,3,80,1,14,0,83,0,"day fort lauderdale shooting, state legislature considering open carry bill"
0,3,11,30,1,9,4,41,0,walk-up song top 2017 nfl draft prospect
0,1,3,45,0,9,0,48,0,joran van der sloot charged murder peruvian woman
0,3,1,50,0,7,0,51,0,california gang member charged killing police officer
0,1,6,31,0,6,0,37,0,leftist salvadoran party take lead vote
0,1,5,31,0,7,0,36,0,mets still star theater absurdity
0,1,8,29,1,8,0,37,0,bad recession? check new home sale
0,3,3,76,5,11,0,79,0,kellyanne conway mocked 'spy microwaves' claim interview obama 'wire-tapping'
0,1,6,46,2,10,0,52,0,america's cup: team new zealand win alinghi second race
0,1,3,61,0,11,0,64,0,tsunami two major earthquake strike island near india japan
0,3,8,35,0,8,0,43,0,computer chip evolve keep deep learning
0,2,5,55,0,11,3,60,0,unstoppable pakistan crush india 180 run win champion trophy final
0,3,2,34,0,6,0,36,0,two killed argentina rock concert crush
0,2,9,56,0,10,0,65,0,vince carter turn back clock historic performance grizzly
0,1,1,34,2,6,0,35,0,'fockers' set meet another weekend title
0,3,3,35,2,9,3,38,0,d.c. lab botched zika test 400 people
0,1,1,65,0,10,0,66,0,kentucky lawmaker critical condition fight high school cafeteria
0,1,3,40,2,9,0,43,0,"un report say number ""abject poor"" tripled gaza"
0,2,1,42,1,9,0,43,0,utah man donates money cover kids' school lunch
0,3,2,45,1,7,0,47,0,trump's first budget face early republican resistance
0,2,7,45,2,11,0,52,0,ex-waffle house ceo: maid tried blackmail sextape
0,3,21,53,3,19,1,74,0,"david warner new no. 1 odi batsman, even better virat kohli ab de villiers?"
0,3,9,48,4,9,0,57,0,jennifer lopez roberto carlos premiere new single 'chegaste': listen
0,1,4,28,1,5,0,32,0,"easter gifts, multiplying loose"
0,2,7,32,0,6,0,39,0,starbucks mobile ordering working well
0,3,14,51,0,13,0,65,0,johnny manziel got engaged model support nfl comeback dream
0,2,1,53,2,9,0,54,0,greece three week deal 'potentially disastrous' debt
0,3,3,47,1,10,2,50,0,mogadishu: suicide car bomb kill least 34 somali capital
0,3,3,42,4,9,0,45,0,tina brown: clinton's loss 'wake call feminism'
0,3,6,71,3,15,0,77,0,"week finance: trump take power; chinese gdp, key job figure mining result released"
0,1,3,19,0,3,0,22,0,expanding downturn
0,1,5,28,0,6,0,33,0,bbc sky network reject gaza appeal
0,3,10,29,0,9,0,39,0,uk lawmaker back bill trigger eu exit talk
0,3,18,45,4,13,3,63,0,"adam silver suggests nba might add 4-point shot, 10-point shot nba all-star game"
0,2,4,25,4,1,0,29,0,unilever-colgate? unilever-nestle?
0,2,15,37,2,12,0,52,0,imam gave sermon community jfk. watch it.
0,2,3,47,1,8,0,50,0,nfls masturbating security guard live inanonymity
0,2,16,50,2,15,0,66,0,smith trying sing twelve day christmas u attemptingit
0,1,7,39,1,7,0,46,0,same-sex marriage ruling set tuesday california
0,3,3,65,3,13,0,68,0,germany right wing attacked media. german trust press ever.
0,3,11,41,2,13,4,52,0,"body camera help policing? 1,200 new york officer aim find"
0,3,2,63,3,12,0,65,0,trump call salacious allegation russia dossier 'fake news' happened
0,3,5,37,4,7,0,42,0,syria war: u 'disappointed' russia's syria stance
0,3,13,44,1,13,3,57,0,jat owned lutyens' delhi 104 year old wait compensation
0,3,3,53,1,9,0,56,0,aleppo: clash erupt rebel blame iran delayed evacuation
0,3,7,40,1,7,1,47,0,penthouse offer $1 million compromising trump tape
0,2,5,23,0,4,0,28,0,health saving account work
0,2,4,63,5,11,0,67,0,@ivanka brighton's message trump: 'please pay attention climate change'
0,1,5,65,0,10,0,70,0,mayor london boris johnson announces bidder additional tramlink vehicle
0,1,4,61,1,13,2,65,0,"city sue owner partially collapsed 19th century livery buffalo, new york"
0,2,10,57,1,11,0,67,0,"texas police department waif tickets, asks toy donation instead insider"
0,2,7,34,3,5,2,41,0,"family, friend mourn 16-year-old found decapitated"
0,3,13,66,4,11,0,79,0,"denying #surgicalstrikes, pakistan threatens 'befitting response' india"
0,1,6,34,1,6,0,40,0,cellphone credit cards? american must wait
0,3,9,48,1,10,0,57,0,suspected louvre attacker id'd egyptian national tourist visa
0,1,7,31,0,7,0,38,0,organic dairy watch good time turn bad
0,1,7,29,1,8,0,36,0,"week ends, share manage stay upside"
0,1,7,36,2,8,4,43,0,"east german stasi spy killed protester, ohnesorg, 1967"
0,2,2,42,4,10,2,44,0,"john glenn's widow turn 97, say miss 'terribly'"
0,3,3,71,2,12,0,74,0,woman 'treated like rock stars' finding alone british airway flight
0,2,6,34,0,7,0,40,0,myth consensus supreme court nominee
0,1,3,32,0,5,0,35,0,read santa clara mark tenth anniversary
0,2,3,48,0,10,0,51,0,iranian baby allowed u emergency procedure
0,2,7,42,0,8,0,49,0,drake congratulates chance rapper first grammy
0,3,8,46,1,8,0,54,0,top-ranked bank slip bottom scandinavian splinter
0,2,1,52,3,7,0,53,0,russia 'determined fight terror' envoy's assassination
0,2,3,41,0,6,0,44,0,epa scrub climate change information fromwebsite
0,2,6,50,1,10,0,56,0,"u general accuses russia, iran boosting taliban afghanistan"
0,2,1,56,0,10,0,57,0,mom dy hammer attack also left kid critically injured
0,1,2,50,0,7,0,52,0,chechnyan president sue russian activist murder claim
0,3,13,32,5,13,3,45,0,"yes, 200 buck note coming. no, look like!"
0,1,3,22,0,4,0,25,0,navy helping new orleans pet
0,3,4,20,0,4,0,24,0,oscar paper currency
0,2,8,50,1,8,0,58,0,federal judge block trump immigration order nationwide breitbart
0,2,3,42,3,6,0,45,0,china 'seriously concerned' trump's taiwan policy
0,3,4,73,0,16,0,77,0,drug industry hired dozen official dea agency tried curb opioid abuse
0,2,7,43,1,7,0,50,0,tepco struggle communicate radiation spike wasnt
0,2,2,44,2,10,0,46,0,"putin, trump speak phone, agree work improve tie"
0,2,2,42,1,8,0,44,0,dutch election: vote key test populist support
0,1,9,29,1,9,2,38,0,uconn men overpower texas a&m reach round 16
0,2,9,40,0,10,2,49,0,bomb blast near newly liberated syrian town kill least 60
0,1,2,25,2,5,5,27,0,"tom cruise order 14,500 takeaway meal"
0,3,9,33,2,8,0,42,0,better: improve upward-facing dog yoga
0,1,1,29,0,5,0,30,0,angry driver take cyclist pack
0,2,5,58,0,13,0,63,0,internet band together help chrissy teigen get fun dip hand
0,2,3,56,3,9,0,59,0,new-elected w.va. sheriff charged stealing meth evidence room
0,3,4,69,2,13,0,73,0,isi gunman 'disguised doctors' attack military hospital close u embassy kabul
0,3,9,49,4,11,0,58,0,donald trump slam 'phony polls' 'dishonest media' inaugural ball
0,1,7,31,0,8,0,38,0,news medium run china look abroad growth
0,2,7,37,3,9,0,44,0,chuck todd: trump brink lame duck presidency
0,3,6,64,3,11,1,70,0,wham! star andrew ridgeley attack 'mucky' channel 5 documentary george michael
0,1,8,36,0,9,0,44,0,white house debate led plan widen afghan effort
0,3,5,50,1,10,2,55,0,sesame street new muppet julia brought 60 minute viewer tear
0,1,8,29,3,6,0,37,0,injury history hamper n.f.l. prospect
0,3,11,48,2,11,4,59,0,oscar 2017: hollywood sound man kevin oconnell hope end record drought
0,3,13,34,6,10,0,47,0,"sit down, humble stream kendrick lamar's 'damn.' album"
0,1,3,43,2,8,0,46,0,"china censors, arrest catholic wake pope's death"
0,1,6,54,1,8,0,60,0,"united kingdom, czech republic suspend referendum eu constitution"
0,1,4,51,2,8,0,55,0,"westchester county, ny build affordable housing non-whites"
0,1,3,46,2,8,3,49,0,california employee owe state us$13.3 million unpaid loan
0,1,6,40,1,6,0,46,0,un security council considers cote d'ivoire sanction
0,2,10,43,1,12,3,53,0,report: samsung planning shift 500 job mexico u insider
0,1,3,36,1,8,4,39,0,south africa defeat wale 43-17 rugby test match
0,1,2,50,0,10,0,52,0,least fifteen dead iraq gunman attack central bank
0,1,7,27,1,7,0,34,0,"santana hurts, mets feel pain"
0,2,7,34,2,7,0,41,0,digging gold africa war-torn country
0,3,3,81,4,12,0,84,0,global watchdog: there's 'incontrovertible' evidence sarin used syria chemical weapon attack
0,2,4,57,0,12,0,61,0,travel industry expert warn u tourism could take major hit trump
0,1,4,22,0,6,0,26,0,flying dark fare sale
0,2,2,31,0,7,0,33,0,cop fatally shoot pit bull thebronx
0,2,1,42,3,9,0,43,0,pictures: share photo theme 'city'
0,3,2,63,1,14,2,65,0,"suspected gas attack kill 58 syria victim foam mouth, activist say"
0,2,1,52,2,8,0,53,0,three-quarters city subway line plagued chronicdelays
0,1,5,43,1,7,0,48,0,document show fred thompson worked pro-choice group
0,3,3,76,1,11,0,79,0,defence force chief promotes gender diversity crucial australia's military capability
0,1,5,38,0,8,0,43,0,nasa say phoenix spacecraft may landed ice
0,1,8,30,3,7,0,38,0,"u.s., step toward industrial policy auto"
0,3,8,41,1,10,3,49,0,well fargo pay $110 million settle fake account lawsuit
0,2,8,46,0,8,0,54,0,australia recall top diplomat craft foreign policy agenda
0,3,3,37,0,8,0,40,0,fury india flag doormat sale amazon
0,3,10,62,0,9,0,72,0,emory professor claim evidence microaggressions cause pyschological harm
0,3,3,44,1,8,0,47,0,president trump deliver border wall promise?
0,2,12,70,4,13,2,82,0,"10-point: gerard baker deutsche bank resignations, trade agreements, turkey election"
0,2,2,49,3,12,0,51,0,"johnny manziel say sober, need 'one team believe me'"
0,3,8,37,2,7,0,45,0,"exercise really help healthy, graceful aging?"
0,1,4,33,2,7,3,37,0,u house approves $1.17 billion amtrak funding
0,2,6,31,0,7,0,37,0,syrian band brings music aleppo berlin
0,2,4,50,2,12,0,54,0,would donald trump tax plan benefit him? let u count way
0,2,12,46,1,11,0,58,0,republican plan tax import create american job
0,1,8,32,1,9,1,40,0,2 ex-timesmen say tip watergate first
0,3,3,88,0,20,2,91,0,nfl draft pick priceless story finding got drafted 49ers speaking another team
0,1,4,29,3,5,0,33,0,"carter: u ""likely behind"" venezuela coup"
0,1,7,28,2,7,0,35,0,"bleak picture, yes, help still wanted"
0,3,9,46,4,9,0,55,0,reince priebus: press access white house hasnt determined
0,1,8,28,3,6,0,36,0,justice decline f.t.c. appeal rambus case
0,3,10,58,3,11,3,68,0,kipp stone praise favorite superhero '100 black panthers': exclusive premiere
0,3,12,52,3,12,0,64,0,kirk cousin trade rumors: brown reportedly 'will try' deal redskin qb
0,3,3,56,1,13,0,59,0,"man custody claiming bomb near white house, source say"
0,1,8,51,0,9,0,59,0,iran arrest iranian employee british embassy protest return
0,2,5,32,1,4,0,37,0,super typhoon nock-ten hammer philippine
0,3,3,40,2,10,0,43,0,mark levin confused. trying confuse you.
0,3,9,40,2,11,0,49,0,"cutting cash would boon world poor, rogoff say"
0,3,7,39,0,9,0,46,0,joel embiid undergo surgery meniscus tear knee
0,1,5,33,1,8,0,38,0,"new york area blog spawn book deal, nbc sitcom"
0,3,17,71,3,15,0,88,0,everyone please take wholesome survey mrs. porter second-grade class learn aboutgraphs
0,2,14,50,2,11,0,64,0,"dumpster fires, fishing travel: republican sitting rnc"
0,3,11,44,0,12,3,55,0,mother sell newborn r 200 couple worked hospital staff
0,3,4,39,2,10,0,43,0,ford say u.s. china need work together trade
0,2,13,45,2,11,0,58,0,"man stab guard high-security louvre museum paris, cop shoot"
0,2,2,51,0,7,0,53,0,trump high court pick gorsuch show conservative credential
0,3,14,48,2,14,2,62,0,"amid meat ban, police find carcass 40 cow medical officer room"
0,2,3,11,0,3,0,14,0,case newt
0,1,4,47,0,8,0,51,0,london zoological society report health planet earth
0,1,6,38,0,6,0,44,0,french minority doubt political success
0,1,5,26,0,8,2,31,0,duke top texas advance round 16
0,1,1,61,1,8,0,62,0,"haiti rescue effort continue, survivor face increasing insecurity"
0,2,2,42,2,7,0,44,0,trump's wall: irish town latest battleground
0,1,1,47,3,5,0,48,0,"taiwanese political party propose ""anti-invasion"" law"
0,2,15,64,1,14,0,79,0,"trump budget cut international food aid program, halt funding clean water rural area"
0,1,1,35,0,5,0,36,0,chinese human right activist face trial
0,1,8,57,0,11,4,65,0,nathalie carpanedo finish wild card run 2013 ipc alpine world championship
0,2,8,43,2,8,0,51,0,nigeria central bank hit unpatriotic policy critic
0,2,2,76,1,13,0,78,0,trump reported pick secretary state longstanding tie russian government
0,1,7,37,1,7,0,44,0,"late push, johnson edge hamlin martinsville"
0,2,17,60,5,19,4,77,0,watch e! news season 2016 excerpt free online brand-new kim kardashian west? yahoo view
0,2,4,70,2,13,0,74,0,definitely-not-russian hacker happen slam trump bomb russian ally
0,3,2,44,1,8,0,46,0,brown university drop fee low-income applicant
0,3,1,61,3,8,0,62,0,blood test detects cancer pinpoint location...before symptom appear
0,1,6,35,0,10,2,41,0,three walk 10th push mets past brave
0,2,8,43,1,9,0,51,0,white house predicts massive job loss robot breitbart
0,2,5,30,1,6,0,35,0,"peace palestine, start scratch"
0,1,2,31,0,7,2,33,0,least 32 dead snowstorm china
0,3,6,48,1,10,0,54,0,uk's daily mail pay melania trump damage modeling claim
0,2,8,56,3,7,0,64,0,northwestern football player re-enact basketball game-winner vs. michigan
0,1,2,35,0,5,0,37,0,chinese hostage rescued philippine
0,3,6,42,2,9,0,48,0,north korea official say icbm launch could come 'anytime'
0,1,4,47,1,11,2,51,0,"somali pirate seize greek freighter, 25 crew gulf aden"
0,1,6,52,2,10,0,58,0,"sequel aftershock hit o'higgins, bobo maule region chile"
0,1,3,62,0,10,0,65,0,ten thousand protest london copenhagen climate change summit
0,2,3,51,0,9,0,54,0,dancing officer help usher donation salvation army
0,1,6,30,1,9,0,36,0,"crowd, day cold confusion"
0,1,8,35,2,10,1,43,0,yahoo post earnings drop; plan cut 5% work force
0,3,7,26,1,8,0,33,0,new york get ferry skeptic board?
0,3,2,59,1,12,0,61,0,week finance: trump tax cut inflation set dominate market
0,1,7,33,1,6,0,40,0,"mumbai spill over, floodwater creep closer"
0,2,8,63,0,10,0,71,0,obama administration rushed preserve intelligence russian election hacking
0,1,3,13,0,4,2,16,0,15 die indian train
0,3,3,38,3,10,2,41,0,section 18c: what's fuss matter?
0,3,2,61,1,13,0,63,0,"week tweet trump stoked anxiety, moved market altered plan"
0,2,10,42,0,9,0,52,0,jill stein file presidential vote recount wisconsin
0,1,5,27,0,5,0,32,0,sport museum file petition court
0,1,3,36,0,5,0,39,0,veteran sergeant account u torture coverup
0,2,11,34,3,10,0,45,0,"big seans new video ""halfway balcony"""
0,2,11,46,2,10,0,57,0,testimony: robert durst's slain friend posed missing wife
0,1,3,39,2,7,0,42,0,o.j. simpson arrested assault charge
0,3,10,41,2,8,0,51,0,pope francis give ted talk urging revolution tenderness
0,1,8,47,2,12,2,55,0,"44th president, long day steeped pomp, history emotion"
0,1,3,29,1,5,0,32,0,"sotomayor, trailblazer dreamer"
0,3,2,47,0,11,0,49,0,david bowie know dying final month
0,1,6,38,0,8,0,44,0,progress lag meeting leader israel
0,1,6,33,0,9,0,39,0,slicing decade video new life web
0,2,2,84,1,19,0,86,0,female police officer risk groped assaulted front line britain's drink crisis
0,3,13,44,7,10,0,57,0,"global economy week ahead: european wages, u.k. inflation, u.s. home sale"
0,3,7,34,0,7,0,41,0,former bear wr alshon jeffery heading eagle
0,2,5,23,1,7,0,28,0,"nepal, monthly exile woman"
0,1,5,27,1,5,0,32,0,"fungi, killer dinner companion"
0,1,3,32,0,7,0,35,0,warrant issued arrest ric flair
0,2,2,41,0,5,0,43,0,fort lauderdale airport shooting suspect charged
0,1,4,36,0,5,0,40,0,paulo crowned copa libertadores champion
0,2,2,44,2,9,0,46,0,cadillac try unite 'divided nation' oscar ad
0,1,6,26,1,7,0,32,0,"tehran, symbol ready reappear"
0,3,10,45,1,12,2,55,0,south carolina man killed police shot 17 time back: lawsuit
0,2,2,48,0,8,0,50,0,eight afghan policeman one family killed colleague
0,1,1,35,0,4,0,36,0,guantanamo prisoner stage hunger strike
0,1,7,32,0,7,0,39,0,paulus say future could quarterback
0,3,12,58,0,11,0,70,0,indiana university longer accept athlete history sexual violence
0,1,2,29,0,5,0,31,0,car bomb kill seventeen pakistan
0,1,5,22,1,7,0,27,0,"deep debt, deep worry"
0,3,4,56,1,11,0,60,0,thousand email detail epa head close tie fossil fuel industry
0,2,8,40,3,9,0,48,0,body bending sound guggenheim video nytimes.com
0,2,11,45,1,9,0,56,0,jimmy kimmel suggests perfect vacation spot bill o'reilly
0,2,2,41,0,6,0,43,0,venomous lionfish sends florida diver hospital
0,1,13,37,2,6,0,50,0,canadavotes: chp candidate stefan jetchick louis-hbert
0,3,2,57,1,11,0,59,0,trump's new travel ban executive order compare predecessor
0,2,6,52,1,9,2,58,0,interpol suspends $22m partnership fifa amid bribery allegation
0,1,7,39,1,8,0,46,0,"control series, ranger struggle contain avery"
0,2,2,42,0,6,0,44,0,melania trump get glamorous new official portrait
0,3,8,39,0,10,1,47,0,7 congo army officer charged war crime massacre
0,2,1,54,2,10,0,55,0,abuse baby 'could identified earlier medical staff'
0,2,8,46,3,8,0,54,0,italian populist slam court politicized block trump order
0,3,10,55,1,11,0,65,0,michael flynn paid represent turkey interest trump campaign
0,2,9,82,3,18,0,91,0,happy day star scott baio defends backlash erin moran: 'you bash support trump'
0,2,2,44,2,8,0,46,0,"report: orlando killer grew unstable, violent home"
0,3,5,54,3,9,0,59,0,draymond green: knicks owner james dolan using 'slave master mentality'
0,3,14,63,3,14,0,77,0,"texas high school student caught nazi salute, saying heil trump senior picture day"
0,2,11,61,1,12,0,72,0,french presidential hopeful le pen name nationalist prime minister fox business
0,1,2,43,0,8,0,45,0,swiss court rule favor american account holder
0,2,2,41,0,6,0,43,0,tanker train explodes bulgaria derailing
0,3,9,60,0,9,0,69,0,federal lawsuit claim kentucky jail unlawfully imprisoned hundred inmate
0,3,5,56,4,11,0,61,0,"amid nuclear threat, u.s. military option north korea?"
0,1,5,32,0,6,0,37,0,ticketmaster live nation agree merge
0,1,6,38,0,7,0,44,0,iranian president sends letter pope benedict xvi
0,1,4,23,0,5,0,27,0,romanian fighter jet hit ufo
0,3,9,35,1,8,0,44,0,russia role syrian gas attack clear: official
0,2,11,44,1,12,4,55,0,pro football hall fame 2017: complete list nfl inductee canton
0,3,9,49,1,9,2,58,0,22 emotional reaction woman president obama's farewell speech
0,2,2,51,0,7,0,53,0,prosecutor claim conspiracy oregon militant standoff
0,2,10,51,2,13,0,61,0,insane clown posse sued stealing poem 'chicken soup soul'
0,1,7,37,1,6,0,44,0,"pennsylvania trial, tension simmer race"
0,2,14,52,1,10,0,66,0,milb player get mustache-style haircut losing college world series bet
0,1,6,27,0,6,0,33,0,bond insurer spin municipal unit
0,2,8,51,3,11,1,59,0,"trump's granddaughter, 5, sings mandarin go viral social medium"
0,2,14,61,1,13,0,75,0,"ted cruz brings daughter meet donald trump, insulted mother grandfather"
0,2,13,57,4,16,1,70,0,mike birbiglias 6 tip making small hollywood. anywhere. new york time
0,3,12,39,2,11,0,51,0,"britney spears' la vega show coming end, manager say"
0,1,2,36,0,6,0,38,0,myspace share database sex offender
0,1,7,34,0,8,0,41,0,mexico take power isolate case swine flu
0,3,6,47,0,12,0,53,0,isi going scorched earth loses ground iraq syria
0,1,2,24,0,6,0,26,0,thousand job go corus
0,3,7,45,6,12,0,52,0,"lgbtq people trump: we're here, we're queer, erase u"
0,1,5,39,0,7,0,44,0,tension rise north korea united state
0,2,1,59,0,13,4,60,0,florida grand jury hear 2013 police shooting black man holding fake gun
0,3,6,44,4,11,0,50,0,"today new app: catch quickly, watch video, delighted!"
0,3,1,58,0,8,0,59,0,principal resigns student reporter look credential
0,3,14,64,1,13,0,78,0,farhan akhtar give perfect response abu azmi's remark bengaluru mass molestation
0,2,4,53,2,12,0,57,0,"election donald trump, mourn. organize"
0,1,5,28,1,5,0,33,0,"partnership based service, size"
0,3,2,43,0,9,0,45,0,uk retail sale fall rising living cost bite
0,2,8,45,0,9,1,53,0,2 white house official helped give nunes intelligence report
0,1,5,23,1,6,2,28,0,best buy report 10% sale increase
0,2,11,37,3,11,0,48,0,ashley graham: time think fattest woman alive
0,3,4,49,0,11,0,53,0,marcus mariota carted broken leg titan lose jag
0,1,9,32,2,9,6,41,0,2007 german league cup: werder bremen 1-4 fc bayern munich
0,1,3,23,2,4,3,26,0,unemployment spain reach 17.4%
0,2,10,34,1,10,2,44,0,26 way make year christmas dinner bestyet
0,3,18,56,2,16,0,74,0,"blast bhopal-ujjain train, sahayak system army must read day"
0,3,11,52,2,10,0,63,0,trump vs. retailers: timeline corporate reaction consumer boycott
0,2,1,73,0,12,0,74,0,hunt master investigated police allegedly whipping saboteur riding crop
0,1,3,47,0,7,0,50,0,u report say afghanistan significant mineral wealth
0,2,10,56,1,11,0,66,0,yale university group seek allow woman all-male fraternity insider
0,2,10,53,2,12,0,63,0,"one year orlando massacre, here question america need ask"
0,1,5,28,0,7,0,33,0,dissecting bank plan way profit
0,1,5,25,0,5,0,30,0,battle close israeli election
0,3,8,63,0,13,0,71,0,indigenous people papua new guinea saved hundred wounded soldier wwii
0,2,3,52,0,8,0,55,0,fukushima radiation reach united state shore first time
0,1,6,45,1,8,0,51,0,sri lanka army capture tamil tiger's capital kilinochchi
0,3,14,48,2,12,0,62,0,donald trump trick medium crediting creating u.s. job
0,1,7,38,2,9,4,45,0,"2007 rugby world cup: new zealand, australia ireland win"
0,3,2,72,0,12,0,74,0,teenage cyberbullying victim mocked facebook day suicide front parent
0,2,1,52,1,9,0,53,0,"missouri man executed killing girlfriend, daughter"
0,1,3,41,1,7,0,44,0,bomb blast athens destroy finnish diplomat's car
0,1,6,34,0,6,0,40,0,saving presidential copters could costly
0,3,18,56,5,16,0,74,0,sunny leone's killer move srk's intensity 'laila main laila' set screen fire
0,3,5,67,3,13,0,72,0,donald trump: 'you always concerned' thermonuclear war north korea
0,2,8,43,2,9,0,51,0,new yorkers hold vigil victim 'bowling green massacre'
0,1,1,46,1,6,0,47,0,mozambique's ruling party retains control election
0,3,9,36,2,11,2,45,0,"jack rudin, head new york real estate dynasty, dy 92"
0,1,4,29,1,6,0,33,0,"shooting diner carson city, nevada"
0,1,10,32,3,9,0,42,0,terry robiskie take son work n.f.l. combine
0,1,6,33,0,6,0,39,0,obama opposes trade sanction climate bill
0,3,11,40,3,9,0,51,0,"clinton ally say smoke, fire: russia-trump collusion"
0,3,4,37,0,9,0,41,0,john mayer reveals new song ex katy perry
0,1,2,33,0,4,0,35,0,australia first begin revival campaign
0,1,2,57,0,9,0,59,0,witness expose big corruption scheme brazilian ruling party
0,2,7,55,2,11,0,62,0,"carrie fisher, mark hamill oprah named among year's disney legend"
0,2,5,73,1,13,2,78,0,istanbul nightclub attack: turkish police hunt gunman killed 39 people nye celebration
0,2,3,59,3,8,0,62,0,exclusive: trump call chinese grand champion currency manipulation
0,1,1,29,0,5,0,30,0,kenya confirms first swine flu case
0,3,10,59,3,11,0,69,0,"ani amri, suspected berlin attacker, history criminal activity, extremism"
0,2,7,49,2,9,0,56,0,"kevin durant, russell westbrook connect lob all-star game"
0,2,5,59,2,13,0,64,0,tax office heard 'whispers' brandis could step deal carve bell group
0,3,7,16,1,5,0,23,0,yellen: march table
0,1,4,56,1,9,0,60,0,"chilean miner rescue begin tuesday, minister maalich announces"
0,2,2,32,1,5,0,34,0,u torture victim's family thanks police
0,1,3,36,0,8,1,39,0,hurricane dean upgraded category 2 storm
0,3,2,34,1,6,0,36,0,u unemployment rate fall nine-year low
0,3,2,45,1,6,0,47,0,brussels attacks: first anniversary bombing marked
0,2,10,48,5,11,0,58,0,o'reilly: dems' blind opposition trump 'harmful america' insider
0,3,5,79,4,16,0,84,0,"boris johnson could moved another job less 'dangerous', say ex-tory foreign secretary"
0,1,6,30,1,7,0,36,0,"year losses, citigroup profit"
0,3,5,26,2,5,0,31,0,career evolution barbie [video]
0,1,8,65,4,12,8,73,0,"former canadian prime minister trudeau criticised new book ""brian mulroney: memoir 1939-1993"""
0,1,3,45,2,8,2,48,0,"dennis ritchie, c programming language creator, dy aged 70"
0,3,10,43,0,9,0,53,0,kendall jenner cara delevingne pose topless goofy photo
0,3,2,50,1,8,0,52,0,northern ireland's first minister face vote confidence
0,3,7,39,0,8,0,46,0,mnuchin say expect complete tax overhaul august
0,2,3,41,0,8,0,44,0,trump scold qatar tillerson seek ease crisis
0,3,8,36,1,10,0,44,0,time recognize truth giant
0,2,17,51,2,15,2,68,0,'i committed first murder 12' sp candidate heard bragging leaked audio clip
0,1,7,31,0,7,0,38,0,snuggie rode silly ad stardom rival
0,3,1,39,1,6,0,40,0,tension tunnel ever-changing border
0,3,4,52,1,8,0,56,0,gylfi sigurdsson swansea stun liverpool five-goal thriller
0,2,9,22,0,8,2,31,0,tv legend mary tyler moore died at80
0,3,2,71,0,12,0,73,0,deadly brown snake captured swallowing python whole rare picture australia
0,1,3,42,0,6,0,45,0,united state senate pass financial overhaul bill
0,3,1,65,1,10,2,66,0,moscow police detain 30 protester anti-government demonstration
0,1,7,34,1,9,0,41,0,"brothel ask taxed, official see catch"
0,3,3,61,4,12,0,64,0,im finally weather girl: woman syndrome fulfills lifelong dream
0,3,14,55,2,13,0,69,0,"trump budget cuts, border tax loom general mills, smucker food giant"
0,1,8,29,1,9,0,37,0,"arizona, uconn right state mind"
0,2,7,31,2,8,0,38,0,talk teen marijuana [video]
0,3,10,38,6,9,0,48,0,lox drop new album 'filthy america... beautiful'
0,3,4,51,0,9,0,55,0,barack michelle obama donate swing set washington shelter
0,2,7,39,1,8,1,46,0,"multiple dead, 2 arrested quebec city mosque shooting"
0,3,13,39,3,13,1,52,0,baby groot cute new 'guardians galaxy vol. 2' teaser
0,3,1,70,2,16,0,71,0,trump national security adviser know pitfall job wrote book
0,1,6,35,1,7,0,41,0,"tracking flight birds, tiny backpack"
0,3,8,38,1,8,0,46,0,climate change may intensifying china smog crisis
0,1,8,32,3,9,0,40,0,"hunted puma, flees, fox, fight"
0,1,5,31,1,5,0,36,0,icann approves .xxx domain pornography
0,3,3,50,2,8,0,53,0,corporate america worried trump's crosshairs?
0,1,2,33,1,6,2,35,0,"20 dead hyderabad, india flyover collapse"
0,3,1,79,2,14,0,80,0,indian airline creates 'women only' section plane prevent abuse solo female passenger
0,3,12,48,1,10,0,60,0,tuesday nba roundup: washington wizard emerging dark horse east
0,1,5,35,0,5,0,40,0,agency skeptical internet privacy policy
0,1,4,31,0,6,0,35,0,bainimarama sworn fiji caretaker pm
0,2,5,45,3,10,0,50,0,new top u.s. diplomat play central role trump china shift
0,2,1,43,1,8,2,44,0,panel verdict: supreme court decision article 50
0,1,3,43,0,6,0,46,0,u navy successfully destroys disabled spy satellite
0,2,2,46,1,8,0,48,0,motorist assisted wounded trooper: would died
0,3,12,34,1,10,4,46,0,german curve steepens since 2008 ecb tweak qe: chart
0,2,5,56,5,10,0,61,0,"u.s. slam russian barbarism syria, moscow say peace almost impossible"
0,3,2,69,2,16,2,71,0,'stud badboy' shot m62 police used fast car launder profit drug empire
0,3,13,52,0,12,0,65,0,fake nonprofit accused spying real human right activist
0,2,11,32,5,10,0,43,0,"trevor noah: 'when see trump, see stand-up comedian'"
0,1,4,45,0,5,0,49,0,controversial florida attorney jack thompson disbarred
0,3,4,42,1,10,2,46,0,xiaomi mi 6 brings galaxy s8-level spec half price
0,3,10,45,7,11,4,55,0,"tony award 2015: fun home, curious incident take home award speakeasy"
0,2,4,67,0,15,0,71,0,lady gaga super bowl halftime show feature hundred drone aerial light show
0,1,2,45,0,7,0,47,0,politically charged murder trial way malaysia
0,3,7,41,0,7,4,48,0,political scandal overshadows south korea 2018 olympic prep
0,1,5,29,0,4,0,34,0,germany bar genetically modified corn
0,2,5,35,0,5,0,40,0,international effort contain chernobyl
0,3,4,67,1,13,0,71,0,donald trump's pick head u army withdraws potential conflict interest
0,2,3,38,1,6,0,41,0,house democrat petition trump's tax return
0,1,7,42,0,7,0,49,0,environmental gain lose priority china amid downturn
0,3,10,56,1,10,0,66,0,kennedy center appoints simone eccleston first director hip-hop culture
0,3,9,40,0,7,0,49,0,pwc confirms partner responsible best picture mishap
0,1,2,37,2,7,4,39,0,"1,000 arrested iraq crackdown al-qaeda"
0,2,13,67,6,16,0,80,0,ted cruz: schumer trying force govt shutdown appease left-wing radical base breitbart
0,2,10,54,2,10,0,64,0,godman arrested sexually assaulting threatening woman chennai
0,1,1,66,0,9,0,67,0,british airport closed small jet transporting transplant organ crash
0,1,6,24,1,8,0,30,0,"eta set car bomb la rioja, spain"
0,1,2,41,1,7,3,43,0,massive flooding china; 550 thousand evacuated
0,1,8,31,3,8,0,39,0,ex-lobbyists u.s. case espionage win round
0,3,16,63,2,15,0,79,0,"rest fight reservation, young jat working professional want"
0,3,5,49,2,11,1,54,0,fearless girl stare wall street bull april 2 [video]
0,1,6,25,2,7,4,31,0,"$8,000 phobos medium center come tech"
0,3,12,40,3,10,0,52,0,espn's 'sportscenter' give way serious film oscar win
0,3,12,43,3,12,3,55,0,reckitt benckisers ceo pin future $16.7 billion baby food deal
0,3,9,53,0,15,2,62,0,arkansas plan execute historic number inmate span 10 day
0,1,2,27,0,4,0,29,0,bravitude climbing fast google
0,3,10,31,3,9,0,41,0,sam bee hillary clinton: 'it you'
0,2,7,44,0,7,0,51,0,kehlani cancel european tour undergo emergency surgery
0,2,14,50,7,15,0,64,0,"transcript best-picture mixup: la la land, moonlight"
0,3,4,59,0,11,0,63,0,prince william get squirted water cheeky london marathon runner
0,3,1,46,0,8,0,47,0,trump reportedly forced part beloved cellphone
0,1,4,28,1,5,0,32,0,al-qaeda warns saudi arabia attack
0,2,3,62,2,9,0,65,0,tax evasion: hundred australian identified multi-country fraud probe
0,3,4,67,2,12,0,71,0,gordon brown push 'patriotic' third option powerful scotland brexit
0,1,6,22,2,6,0,28,0,big u.s. role lending student
0,3,3,37,3,11,4,40,0,fox news poll: 2016 election battle continues -- home
0,2,6,37,2,6,0,43,0,harvard new approach america teacher deficit
0,3,8,43,1,8,1,51,0,china's expanding 1 trillion yuan club show changing economy
0,3,4,72,6,14,1,76,0,'the walking dead' showrunner tease season 8: 'the first four episode melt people's minds'
0,3,14,54,1,13,0,68,0,begum jaan review: story unique direction falter several point
0,2,5,52,2,10,0,57,0,ebola nurse pauline cafferkey return sierra leone 'closure'
0,3,13,51,0,13,3,64,0,climate change could escalate risk extreme rainfall much 400 percent
0,2,1,40,0,6,0,41,0,one financial habit millennials keep
0,3,4,36,0,7,2,40,0,trump becomes 45th president united state
0,2,5,52,1,8,0,57,0,national security adviser michael flynn's job security jeopardy
0,3,9,38,3,7,0,47,0,ecbs next trick? acknowledge europe improving economy
0,2,7,31,0,7,0,38,0,five thing learned epipen scandal
0,3,9,42,1,8,0,51,0,swiss train running world's longest rail tunnel
0,2,13,56,5,12,0,69,0,gop rep. say obamas syrian refugee bait switch endangers american breitbart
0,3,2,38,3,7,0,40,0,women-only pink taxi hit street pakistan
0,1,2,53,2,8,0,55,0,"water main burst west edinburgh; traffic, utility disrupted"
0,3,2,59,1,8,0,61,0,donald trump place five-year lobbying ban administration official
0,3,8,50,3,7,0,58,0,oscar pistorius potential release leaf steenkamp family shocked
0,3,18,57,3,16,0,75,0,could first lady: actress emma thompson tell tv host trump asked
0,3,5,57,1,12,0,62,0,"lgbt people get married healthier happier, study show list"
0,1,3,14,0,3,0,17,0,fda back clone meat
0,1,1,34,0,4,0,35,0,hussein trial judge submits resignation
0,2,6,35,3,8,0,41,0,former cia acting director clinton: trust
0,1,3,26,0,5,0,29,0,flood south africa wreak havoc
0,2,4,22,2,7,2,26,0,dear donald trump: want $49 back
0,3,6,24,0,7,0,30,0,lego launching woman nasa toy set
0,3,14,52,1,13,0,66,0,there scientific reason behind hangover get worse get older
0,1,4,44,0,7,0,48,0,stephen hawking concludes visit israel palestine
0,1,6,35,0,6,0,41,0,sex predator accusation shake wisconsin town
0,3,5,71,1,13,0,76,0,michelle obama paid surprise visit female student international womens day
0,1,3,18,0,3,0,21,0,illinois pass budget
0,3,3,64,1,12,0,67,0,white house dispute claim trump aide's tweet violated federal ethic law
0,3,3,35,2,5,0,38,0,coroner: rashaan salaam death ruledsuicide
0,2,1,67,0,12,0,68,0,thousand child teenager anorexia forced wait month help
0,1,3,45,1,7,0,48,0,"detroit lion fire coach mariucci, two assistant coach"
0,1,9,46,1,10,0,55,0,bidder up: yankee city reach deal sell stadium memorabilia
0,2,4,43,0,9,0,47,0,bbc crew attacked china forced sign confession
0,2,10,54,0,11,0,64,0,pope francis new year address say terrorism cast bloodstain world
0,1,6,33,0,7,0,39,0,softer policy drug debated argentina
0,3,1,48,1,9,0,49,0,"marriage beneficial men women, study show"
0,1,3,33,2,7,3,36,0,minimum wage united state increase $6.55
0,2,11,39,1,10,0,50,0,here's law pose greatest threat donald trump
0,3,7,46,0,10,0,53,0,jay z take shot phil jackson introducing lebron james
0,1,5,31,0,7,0,36,0,fewer letter space mailbox
0,2,4,48,1,11,1,52,0,thirsty t-mobile giving free iphone 7 join network
0,3,8,45,2,8,0,53,0,hell back? schwarzenegger reportedly mulling run senate
0,2,5,64,4,11,0,69,0,"donald trump's 'muslim ban' could beginning, amnesty international warns"
0,1,3,60,1,9,0,63,0,minyama resident promise keep fighting stop mcdonald's development
0,1,2,23,0,7,4,25,0,air canada back black 2010
0,1,2,43,1,7,0,45,0,twelve people dead blast north-west pakistan
0,3,10,47,0,11,3,57,0,prince search warrant reveal 100 pill found paisley park
0,3,8,50,1,7,0,58,0,azealia banks' arrest warrant retracted following court appearance
0,1,2,33,0,3,0,35,0,kangaroo injures australian politician
0,2,11,31,1,11,0,42,0,look moon going amazing weekend
0,2,6,59,0,11,0,65,0,former malaysian pm mahathir throw weight behind rally oust leader najib
0,1,5,35,0,7,0,40,0,bbc cut electric prom financial reason
0,2,5,55,1,8,0,60,0,alberto salazar facing allegation nike oregon project
0,2,3,63,3,11,0,66,0,"clooney used golden girl role healthcare, show secretsrevealed"
0,1,2,44,0,7,0,46,0,ousted honduran president say crisis deal failed
0,1,10,34,0,8,0,44,0,yachting company chief pleads guilty ubs tax case
0,2,12,50,6,8,0,62,0,"kansas' sviatoslav mykhailiuk go coast-to-coast, sink game-winner vs. ksu"
0,2,10,45,4,9,0,55,0,say what? twitter agog ben carson's 'hippocampus drilling' tale
0,2,4,36,2,8,0,40,0,west wing real estate: proximity trump?
0,3,4,47,2,11,0,51,0,"ahoy, johnny depp! raid treasure chest like pirate"
0,1,5,44,2,6,0,49,0,obama 'angry' afghanistan general stanley mcchrystal
0,3,7,67,4,14,0,74,0,"gale sayers dwight clark, nfl legend bad diagnoses, suspect football blame"
0,2,1,44,1,7,0,45,0,trump comment breaking bank joltsmarkets
0,1,6,27,1,6,0,33,0,"norway wins, russia call tune"
0,2,4,41,0,9,2,45,0,20 u airstrikes conducted yemen overnight
0,1,5,23,0,6,2,28,0,least 35 killed somali clash
0,3,2,44,1,8,0,46,0,syrian war: peace talk threat amid rebel warning
0,2,3,47,0,8,0,50,0,scientist issue dire warning cape cod shark attack
0,2,6,37,1,7,0,43,0,lower east side landmark sunshine cinema toclose
0,3,2,51,0,8,0,53,0,justice dept threatens sanctuary city immigration fight
0,2,1,44,0,9,0,45,0,meet sensor could watching work
0,1,5,25,0,4,0,30,0,ethiopian withdraw key base
0,2,12,52,2,12,0,64,0,"golden globe afterparties, star applaud meryl streep new york time"
0,2,11,35,2,8,0,46,0,trevor noah givesbill oreilly send-off deserves
0,1,5,38,2,7,6,43,0,english premier league 2007/08: club seek brazilian star
0,2,9,51,2,9,0,60,0,chris chiozzas buzzer-beater sends florida past wisconsin overtime
0,3,24,51,0,16,0,75,0,priyanka chopra instagram puppy post first person thepuppy
0,2,3,31,0,5,0,34,0,epipen competitor launch february
0,3,9,43,2,8,0,52,0,"global economy week ahead: federal reserve meeting, china data"
0,2,7,42,3,9,0,49,0,teacher make gofundme 'buy' senator's vote betsy devos
0,2,8,38,1,8,2,46,0,17 arrested kim kardashian paris jewelry heist: update
0,1,7,41,0,8,0,48,0,music industry imitates digital pirate turn profit
0,3,11,51,5,10,0,62,0,watters: media's anti-trump bias 'exposed' latest paris attack insider
0,2,9,33,1,11,0,42,0,"lost city z, lost art adventure film"
0,3,7,42,0,8,0,49,0,french jobless claim decline third month november
0,1,8,33,1,8,0,41,0,"tested early north korea, obama option"
0,2,7,31,0,7,0,38,0,airbnb challenge host less racist
0,1,5,34,0,6,0,39,0,test delivers message domestic audience
0,1,6,30,0,6,0,36,0,angry ad seek channel consumer outrage
0,3,9,33,0,9,2,42,0,21 movie watch black history month isover
0,2,9,38,4,11,4,47,0,golden globe 2017: tracee elli ross' historic win 'means lot'
0,2,8,36,3,11,1,44,0,snapchat file ipo $snap look raise $3 billion
0,3,3,35,2,6,0,38,0,trump's mexican border wall: see proposal
0,1,6,31,0,5,0,37,0,wider drug war threatens colombian indian
0,2,11,42,8,10,0,53,0,"lyin, leakin susan rice: trump aide, jr. unimpressed denial"
0,1,2,31,0,4,0,33,0,south dakota tower demolition botched
0,1,5,57,0,9,0,62,0,sweeping bank regulatory overhaul passed u house representative
0,1,3,37,1,7,0,40,0,uk government look drink-drive limit
0,3,14,59,1,13,0,73,0,legal woe sanjay dutt! warrant issued threatening filmmaker
0,1,3,33,1,7,0,36,0,"boat sink new jersey coast, killing one"
0,2,8,43,2,10,0,51,0,mike trout surprise young fan gift sportsnation espn
0,1,2,38,0,5,0,40,0,palestinian rocket attack kill israeli woman
0,3,7,34,0,6,0,41,0,alleged yahoo hacker evaded previous arrest
0,3,13,39,4,13,1,52,0,listen dom kennedy's new album 'los angeles sale vol. 1'
0,2,3,45,3,8,0,48,0,"iran unveils second underground missile, likely irk u.s."
0,1,4,43,1,9,2,47,0,rhode island borrows $90 million u jobless claim
0,2,2,54,0,10,0,56,0,pool fence warning toddler scale open gate adelaide
0,3,2,45,2,8,4,47,0,"archaeologist egypt open ancient tomb, find 1,000 statue"
0,3,1,54,1,7,0,55,0,health insurer accused anti-competitive conduct dentist
0,2,4,44,2,9,0,48,0,report: harrison ford jet run-in california airport
0,1,5,37,0,8,4,42,0,san francisco giant win first world series since 1954
0,3,3,57,1,8,0,60,0,"russian thinktank gameplanned undermining u election, source say"
0,1,7,28,2,8,4,35,0,"3,500 layoffs, corning latest cut job"
0,1,8,22,4,5,0,30,0,remembering lost n.h.l. all-star game
0,1,4,45,1,8,2,49,0,greece's orthodox church leader christodoulos dy age 69
0,1,6,32,0,6,0,38,0,illness afflict home criminal past
0,3,8,32,0,9,6,40,0,hot 97 reveals stadium stage lineup summer jam 2017
0,3,1,54,0,11,0,55,0,genius fridge hack absolutely perfect wine lover
0,2,12,53,3,14,0,65,0,people photoshopping hell new 'star wars: last jedi' poster
0,1,4,23,0,5,1,27,0,4 aid worker abducted somalia
0,1,1,48,0,9,0,49,0,pope apologises person reaction comment
0,3,5,29,0,5,0,34,0,driver rescued flooding oregon
0,1,5,72,1,13,0,77,0,pastor michael guglielmucci admits cancer hoax; video removed youtube
0,2,3,51,4,11,0,54,0,"spring bloom coming early, d.c. cherry blossom"
0,1,7,31,1,7,0,38,0,"palm, tough smartphone act follow"
0,1,8,34,3,7,0,42,0,"europe, possible survival lesson u.s. paper"
0,2,12,40,6,14,5,52,0,"go going once, twice... whisky go go neon sign sell $48,300 auction"
0,3,5,51,0,8,0,56,0,new zealand flood force evacuation tropical storm debbie
0,1,3,48,1,9,0,51,0,"judge known jailing pirate shot dead bossaso, somalia"
0,1,3,30,0,5,0,33,0,cbc service return normal tomorrow
0,2,2,65,1,10,0,67,0,hundred hay bale delivered fire-affected farmer across australia
0,1,5,28,0,7,0,33,0,family dissident fled china
0,3,2,75,3,12,0,77,0,"trump national security adviser want avoid term 'radical islamic terrorism', source say"
0,1,5,27,1,5,3,32,0,nhl: montreal canadiens open 100th season
0,2,5,52,4,11,0,57,0,"u.s. north korea saber rattling, conflict imminent?"
0,3,4,24,0,4,0,28,0,home steeped jewish heritage
0,1,2,42,0,5,0,44,0,suspect arrested hijacking mexican airliner
0,2,5,42,4,9,0,47,0,police: woman trained poison kim jong un half brother
0,2,1,57,2,11,0,58,0,swedish 'bikini cop' stopped pickpocket quits job photo fame
0,3,7,32,1,6,0,39,0,"rikers island staff overuse force, report say"
0,3,9,39,0,9,0,48,0,venezuela lead u asylum request crisis deepens
0,1,3,51,1,14,4,54,0,fast food chain mcdonalds set open 1000 store end year
0,3,12,35,1,11,0,47,0,"global coal use stall india prop growth, iea say"
0,3,3,43,2,8,1,46,0,'peaky blinders' creator drop new detail season 4
0,2,1,43,1,8,0,44,0,poor pay price subway-workerbenefits
0,1,3,23,0,5,0,26,0,bosnian war criminal sent uk
0,1,3,53,0,8,0,56,0,uk regulator proposes sky share channel broadcaster
0,1,3,45,0,9,0,48,0,six die bus carrying polish tourist crash serbia
0,3,5,64,0,12,0,69,0,john legend surprise commuter impromptu gig st pancras station piano
0,1,4,47,0,8,0,51,0,final launch space shuttle discovery delayed another day
0,3,8,41,0,11,1,49,0,planet earth 2 currently highest rated tv show imdb
0,2,2,51,0,8,0,53,0,white house accuses medium playing inauguration crowd
0,3,3,65,1,13,3,68,0,"jcpenney shuttering 140 store sale weaken, sluggish growth seen ahead"
0,2,5,38,2,10,0,43,0,thatcher may eu speech measure data
0,2,9,35,2,9,0,44,0,visa ban amended allow iraqi interpreter u.s.
0,1,3,58,0,9,0,61,0,iceland united kingdom diplomatic dispute financial crisis
0,2,12,57,3,14,0,69,0,"salah abdeslam, suspect paris attacks, extradited france new york time"
0,3,6,53,5,9,0,59,0,kilty pleasure: paul burrells im celebrity- diana-inspired tartan
0,2,8,43,1,9,0,51,0,china banking giant try snatch share mobile payment
0,3,3,47,2,7,0,50,0,berlin market attack: tunisia arrest suspect amri's nephew
0,2,5,56,0,9,0,61,0,donald trump supporter descend washington dc ahead inauguration
0,3,4,65,1,9,0,69,0,covergirl's first male spokesmodel anger twitter insensitive africa tweet
0,2,2,51,0,9,0,53,0,gamer fatally stabbed teen internet cafe avoidscharges
0,2,12,51,1,12,0,63,0,curious coloradan adam hirtle shoot see feel like: cop
0,3,10,41,5,9,3,51,0,"mashable periscope: ""mashable house tour 360 #mashhouse #sxsw"""
0,2,16,51,2,15,0,67,0,"oscar nominated record number black actors, there still way togo"
0,3,8,47,2,8,0,55,0,kevin gates' wife issue statement husband's incarceration
0,3,6,26,2,8,6,32,0,30 taken hospital 25-car pileup i-91
0,2,4,52,5,10,0,56,0,chelsea handler nix two-party politics: 'i'm democrat anymore'
0,1,4,51,2,9,0,55,0,dying canadian infant moved u.s. hospital medical treatment
0,1,3,45,2,10,4,48,0,u.s. president given clean bill health 2005 annual checkup
0,1,3,42,0,8,2,45,0,soviet human right activist yelena bonner dy aged 88
0,1,6,30,0,7,0,36,0,japan korea vow unity economic slump
0,3,11,57,3,12,2,68,0,watch eerie new trailer selena gomez-produced netflix series '13 reason why'
0,2,1,43,2,8,0,44,0,"teen yelled homophobic slur, threw brick men:cops"
0,1,1,47,3,6,2,48,0,ash-triggered flight disruption cost airline $1.7 billion
0,3,1,64,0,12,0,65,0,manus police want officer island tension refugee deal mount
0,2,14,57,1,10,0,71,0,poll: across political spectrum massive majority reject islam migrant crisis
0,3,5,41,1,7,2,46,0,gofundme campaign chicago beating victim raise $50k
0,1,8,47,0,10,0,55,0,shocked grieving gazans find body rubble home
0,2,3,47,0,9,0,50,0,u cancer teen surprised dream trip watch leicester
0,1,12,45,5,12,0,57,0,"fan montreal n.h.l. all-star game cheer own, lecavalier"
0,2,2,47,1,6,0,49,0,gambia election: internet international call banned
0,1,12,41,0,12,0,53,0,group rich american sue ubs keep name secret tax case
0,1,7,34,0,7,0,41,0,democrat scramble cut cost health plan
0,2,7,24,0,5,0,31,0,nba power ranking playoff begin
0,1,2,46,0,7,0,48,0,woman reveal account forced abortion scientology
0,2,6,53,3,8,0,59,0,man's nsfw 'complaint' donut escalates spectacularly twitter
0,1,6,35,0,6,0,41,0,south african viper win singapore rugby seven
0,1,5,14,0,4,0,19,0,cash machine run low
0,2,4,70,1,18,0,74,0,teenager stop dabbing dad sworn speaker house list
0,1,1,24,0,4,2,25,0,chechnya chopper crash kill 15
0,2,0,24,0,5,1,24,0,7 way boost happiness
0,2,11,29,1,10,4,40,0,best play 2017 nba all-star game
0,2,8,20,1,9,6,28,0,33 fact didnt know start of2016
0,1,3,56,2,11,2,59,0,"calm return salt, jordan riot police shooting; 35 arrested"
0,1,3,50,0,8,2,53,0,ukrainian basketball player alexander belostenny dy age 51
0,3,5,47,2,9,0,52,0,jake butt collect loss-of-value policy following torn acl
0,3,6,52,2,10,1,58,0,logan: hugh jackman confirms x-men timeline wolverine 3 exists
0,2,7,26,0,7,0,33,0,mlb power ranking start march
0,3,13,58,9,15,2,71,0,"rep. mo brooks: obamacare 2.0 republican welfare program, worst bill ive ever faced"
0,3,6,78,0,18,3,84,0,boris johnson pressed uk keep selling bomb saudi arabia air strike killed 140 funeral
0,1,7,39,2,7,0,46,0,fifa suspend asian cup football (soccer) champion iraq
0,1,1,40,0,6,0,41,0,turkmen president ban recorded music public
0,1,11,60,0,12,0,71,0,britain refuse entry dutch lawmaker whose remark film angered muslim
0,1,2,44,0,5,0,46,0,united kingdom officially enters economic recession
0,1,1,23,0,4,0,24,0,sydney plan loss rainbow
0,2,5,53,0,10,0,58,0,brain adhd show smaller structure related emotion
0,2,11,59,5,14,0,70,0,harry styles' biggest 'sign times' influences: bowie pink floyd coldplay
0,1,3,48,0,10,0,51,0,oil spillage platform explodes gulf mexico
0,2,3,29,1,7,2,32,0,bar fire kill 13 people france rouen
0,2,3,48,2,10,4,51,0,fox business republican debate 2016 lineup: here made cut
0,3,2,64,1,12,0,66,0,"one suspect arrested, one large basement murder massachusetts couple"
0,3,9,52,2,9,0,61,0,"samsung heir, seeking modernize opaque culture, instead face scandal"
0,2,8,41,2,8,0,49,0,sweden telia another problem turkcell: free speech
0,1,2,57,0,7,0,59,0,thousand evacuated chemical truck overturn pennsylvania
0,3,11,46,4,11,3,57,0,"sluggish housing recovery took $300 billion toll u.s. economy, data show"
0,1,5,43,3,8,4,48,0,"bbc receives 8,400 complaint 'eastenders' cot death story"
0,1,2,25,1,3,0,27,0,india-china border talk resume
0,1,5,26,0,8,7,31,0,jeff gordon win 2011 subway fresh fit 500
0,3,4,64,1,10,0,68,0,science news ancient eclipse record revise modern calculation earth's spin
0,3,4,43,0,11,0,47,0,fox drop analyst said uk may helped spy trump
0,2,8,38,0,9,0,46,0,iranian baby heart defect undergo surgery soon
0,3,2,77,2,12,1,79,0,banker-turned-googler explains 2 biggest difference working tech finance
0,3,11,41,4,11,0,52,0,"mike pompeo confirmed lead c.i.a., rex tillerson advance"
0,2,10,35,1,10,0,45,0,donald trump two-bit thug bidding
0,1,6,24,0,6,0,30,0,spain france clean storm
0,2,8,40,0,9,0,48,0,florida teen accused murdering mom birthday
0,2,2,41,0,8,0,43,0,fedex driver handle jackknifed big rig like bos
0,3,3,76,0,15,0,79,0,leadership expert say leak coming white house could symptom mismanagement
0,2,13,46,3,9,0,59,0,akzo nobel-ppg: trans-atlantic megadeal could actually happen
0,3,4,41,3,7,0,45,0,russia josef stalin: outspoken grandson 'found dead'
0,1,3,38,1,6,2,41,0,south korean regulator fine microsoft $32 million
0,1,7,30,1,7,0,37,0,"share fall, dollar hit low euro"
0,1,3,47,0,9,0,50,0,kenya government reform record reviewed au expert
0,3,8,44,2,9,0,52,0,suspect murder 'witnessed' family parrot appears court
0,1,2,48,2,7,0,50,0,u undergraduate commits suicide 'outing' via webcast
0,1,6,21,3,6,0,27,0,put ad web. count clicks. revise.
0,1,7,32,1,8,0,39,0,"rarity days, barclays move expand"
0,3,10,45,3,11,0,55,0,increasingly frequent call baltic sea: russian navy back
0,2,2,59,2,12,0,61,0,obama fire saying complete strategy yet training iraqi
0,1,2,42,0,11,1,44,0,9 year old girl reported latest u swine flu death
0,3,9,40,0,9,0,49,0,multiple people reportedly shot meek mill concert ct
0,3,8,54,3,9,0,62,0,"grayson allen return suspension vs. georgia tech: comments, reaction"
0,2,1,44,3,7,4,45,0,readers' travel photography competition: 2016 winner
0,1,8,38,0,10,0,46,0,jeter hit one five homer help hide blemish
0,2,5,21,1,4,0,26,0,"easy bikes, spandex required"
0,1,1,65,1,9,2,66,0,toronto police announce arrest 96 people drug-trafficking investigation
0,1,6,36,0,6,0,42,0,government take industry trouble
0,1,6,36,0,6,0,42,0,investment officer stanford group indicted
0,1,6,42,0,8,0,48,0,europe feel strain protecting worker plant
0,2,8,38,4,7,0,46,0,"jeremiah tower: reclusive celebrity chef, glass"
0,1,3,52,1,10,0,55,0,"curfew imposed jammu kashmir, three injured four killed"
0,2,2,54,1,12,2,56,0,meet urgent need 11 million syrian fleeing conflict?
0,3,14,50,3,12,0,64,0,"self-driving car excite industry, they're yet ready prime time"
0,1,6,48,0,10,0,54,0,u congress house panel ok big cut public broadcasting fund
0,2,9,49,2,8,0,58,0,robert durst case: hollywood producer lynda obsts memory questioned
0,3,3,47,2,9,0,50,0,"muhammad ali jr. detained airport second time, lawyer say"
0,2,9,59,0,12,0,68,0,majority promised dakota keystone pipeline job expected temporary
0,2,1,29,2,7,4,30,0,moscow 30 30: people power list
0,1,4,26,0,3,0,30,0,official identify alabama gunman
0,2,1,49,0,11,0,50,0,lost dog found stuck frozen lake saved dramatic rescue
0,3,2,84,3,13,0,86,0,we're better together! hilarious heart-warming display teamwork captured around world
0,3,2,53,0,11,0,55,0,lyft surpassed uber daily downloads first time ever
0,1,4,50,1,11,1,54,0,"f1 test, bourdais hope return winning form edmonton"
0,1,2,54,0,7,0,56,0,tanzania accused supporting terrorism destabilise burundi
0,2,3,48,3,10,6,51,0,"cheeto look like harambe worth $100,000? nothing okay anymore"
0,1,3,49,0,9,0,52,0,concern sovereign debt eu member roils market
0,3,9,45,1,10,0,54,0,brief timeline carmelo la la anthony's strained marriage
0,3,4,50,3,10,0,54,0,"iraqi force mosul performing 'at peak', say u commander"
0,1,2,26,0,4,0,28,0,second school haiti collapse
0,2,9,45,4,9,0,54,0,"deal rosneft u.s. sanctions-compliant, say essar group ceo"
0,1,1,27,0,4,0,28,0,moscow gas pipeline catch fire
0,1,3,47,1,8,0,50,0,"indiana state fair stage collapse kill four, injures forty"
0,3,21,54,5,17,0,75,0,mcconnell say gop plan b obamacare subsidy cant share it: well let youknow
0,2,5,34,1,6,0,39,0,jaden smith join baz luhrmann's netflix drama
0,3,1,47,5,12,0,48,0,"'the future liberal want' here, meme"
0,1,2,52,0,7,0,54,0,official result say namibian president reelected poll
0,2,10,39,0,9,0,49,0,american airline bringing back perk hated
0,2,15,57,2,13,0,72,0,"up's rape accused minister gayatri prajapati still walk free, airport put alert"
0,1,2,32,0,4,0,34,0,rokot launch three gonets satellite
0,3,1,42,2,7,0,43,0,"fashion designers, resistance runway"
0,2,6,65,2,14,0,71,0,new book shed light turmoil prince charles princess diana's marriage yahoo
0,2,9,44,2,10,0,53,0,israeli settlements: like live inside divided land
0,3,12,36,0,11,0,48,0,raf simon stan go first raf simon fashion show
0,2,7,46,0,7,0,53,0,suzanne somers want make alternative medicine affordable
0,1,2,18,0,3,1,20,0,7 year psychologist
0,3,15,50,1,13,0,65,0,dominant: julio jones unlike anything nfl seen
0,1,8,31,2,8,0,39,0,e.w. scripps report loss cut salary
0,2,3,61,3,13,0,64,0,"carrie fisher's urn shaped like giant prozac pill, like would've wanted"
0,2,20,13,0,6,1,33,0,donnison manus png pkg r4 jondonnison
0,1,7,68,0,13,0,75,0,germany threatens walk un general assembly ahmadinejad denies holocaust
0,2,7,55,1,9,0,62,0,report: protester columbia university call elimination israel
0,3,12,44,4,9,0,56,0,trevor noah gop: 'premature legislation make anyone happy'
0,3,5,40,3,9,0,45,0,"ramesses ii, victor kadesh: kindred spirit trump?"
0,1,6,26,0,6,0,32,0,golfer clothes laid
0,3,3,55,2,12,0,58,0,"spike tv getting huge rebrand, happens programming?"
0,3,11,58,2,10,0,69,0,"protest begin mangaluru kambala, karnataka's traditional buffalo race"
0,2,8,35,2,8,0,43,0,foul-prone ncaa hoop star became giant tehope
0,3,4,77,4,17,0,81,0,donald trump's team 'having meeting dark can't find right light switch white house'
0,1,6,29,1,4,0,35,0,pegasus rocket launch c/nofs satellite
0,1,3,21,2,4,0,24,0,"work begin ""lisbon treaty"""
0,3,6,70,2,13,0,76,0,there's one important line david cameron arnold schwarzenegger's video list
0,1,2,31,0,5,0,33,0,georgia want ceasefire ossetia war
0,2,18,45,3,11,0,63,0,winning: gallup report u.s. job creation index continues hit record high
0,3,3,26,2,7,0,29,0,'i trust donald trump keep u safe'
0,3,3,82,1,13,0,85,0,hyundai showcase iron man-inspired robot suit could give elderly superhuman strength
0,1,5,66,0,12,4,71,0,2012 report gender equality development suggests australian woman okay
0,1,8,49,0,9,0,57,0,inadi wikimedia argentina sign agreement cooperation
0,3,1,52,0,9,0,53,0,canadian man beheaded bus passenger granted total freedom
0,2,2,50,2,11,0,52,0,dialing past: early internet affect media?
0,3,3,81,5,12,0,84,0,'it happen': top intelligence official shooting trump's allegation wiretapping
0,1,7,45,1,8,0,52,0,"nugget mavericks, squabble series continue"
0,1,1,46,0,8,0,47,0,arizona applies ban autodialers mobile phone spam
0,2,2,41,3,7,0,43,0,u.s. judge throw many metal price-fixing claim
0,3,11,46,4,10,0,57,0,'hamilton' cast bid farewell obama 'one last time' performance
0,2,7,31,0,8,0,38,0,trump ups drama supreme court pick
0,2,9,39,2,12,0,48,0,christen press went abroad found place u.s. team
0,1,9,32,1,9,0,41,0,recession good time middle-aged
0,2,13,44,1,14,4,57,0,india rank 97th world average internet speed 5.6 mbps
0,3,2,41,1,7,0,43,0,netanyahu: iran missile test must go unanswered
0,1,3,22,0,3,0,25,0,balancing needle cigar
0,3,4,51,3,9,0,55,0,"trump role son-in-law jared kushner need review, democrat say"
0,3,10,62,2,13,0,72,0,"questlove, pete rock, react death influential musician david axelrod"
0,1,5,28,0,5,0,33,0,scandal topples chief deutsche bahn
0,2,9,41,2,8,0,50,0,here's one reason trump's legislative agenda flailing
0,3,3,37,0,7,0,40,0,uk employment fall month brexit vote
0,1,6,16,3,5,0,22,0,quest shrink s.l.r.
0,2,8,43,1,10,0,51,0,ted cruz refuse endorse paul ryan congress breitbart
0,1,2,42,0,4,0,44,0,michael morale execution postponed indefinitely
0,2,11,53,4,11,0,64,0,brexit bat aside younger generation european identity new york time
0,2,6,76,1,16,0,82,0,diego costa real madrid: seven reason chelsea offered striker transfer
0,1,9,52,1,10,0,61,0,"obama, choice unified palestinian government isolated hamas"
0,2,12,61,2,14,0,73,0,"rex tillerson, exxonmobil strike deal sever tie he's confirmed secretary state"
0,3,11,49,0,10,0,60,0,donald trump reeeeeally need stop using unsecured android phone
0,2,3,48,2,7,0,51,0,trump presidential pen could remake supreme court agenda
0,1,2,58,1,7,0,60,0,"u interrogation technique received early approval, report suggests"
0,2,13,57,2,15,0,70,0,"speaker david gowan reshapes arizona house, carpet new york time"
0,2,6,55,1,12,2,61,0,robert pirsig: zen art motorcycle maintenance author dy aged 88
0,3,2,62,5,11,0,64,0,cant breathe: video show deputy pepper-spraying man restraint chair
0,2,8,44,0,8,0,52,0,young voter reluctantly learned love hillary clinton
0,3,8,53,3,9,0,61,0,student protest dress code #iamnotadistraction written arm
0,2,2,38,0,6,0,40,0,family pay tribute killed derbyshire woman
0,2,11,45,3,11,0,56,0,"seattle city council say happy new year raising gun, ammo price"
0,1,7,34,0,7,0,41,0,analysis show german fossil early primate
0,2,1,59,2,13,0,60,0,leave soda car freezing outside
0,2,7,48,4,9,0,55,0,"week best podcasts: must remember this, embedded, radiolab"
0,1,1,73,1,9,0,74,0,large scale gene transfer single-celled multicellular organism reported
0,2,5,81,3,16,0,86,0,high school teacher's facebook page 'urged people vote donald trump muslim could butchered'
0,3,7,36,1,7,0,43,0,trump rapid rapprochement plan russia fade
0,3,1,88,0,15,0,89,0,allergan got exclusive access treatment could revolutionize treat genetic disease
0,1,3,51,1,8,0,54,0,mexican billionaire carlos slim remains world richest man
0,1,1,35,0,6,0,36,0,australian carbon tax plan hit road block
0,2,3,58,5,11,0,61,0,"trump set meet merkel, europe decider, frosty start relation"
0,1,3,42,1,7,0,45,0,"thai pm barred politics, three party dissolved"
0,2,4,68,4,15,0,72,0,"obama sanction russia, trump say time move bigger better thing"
0,3,9,44,2,11,0,53,0,"jury secrecy doesnt apply marred bias, supreme court rule"
0,1,6,37,2,8,0,43,0,misaki stop riggs 'strikeforce mansion ii'
0,3,4,23,2,5,6,27,0,"19 stunning wedding dress $1,000"
0,3,3,57,1,9,0,60,0,aleppo: operation evacuate besieged syrian city begin delay
0,3,5,45,0,10,0,50,0,father maryland high school rape suspect arrested ice
0,1,3,39,0,7,0,42,0,u troop philippine resume activity
0,3,6,46,6,12,2,52,0,"homeland season 6, episode 1: carry civilian brooklynite"
0,1,4,39,1,6,4,43,0,"wikimania 2008 open bibliotheca alexandrina, egypt"
0,1,3,54,0,11,0,57,0,west indie win third match cricket series india
0,2,7,28,0,6,0,35,0,make college back student loan
0,1,2,45,0,9,0,47,0,libyan rebel gaddafi troop battle two front
0,3,12,45,1,11,0,57,0,fifth harmony made camilas exit official new groupphoto
0,2,13,50,1,12,0,63,0,"far barcelona concerned, lionel messi indispensable club"
0,2,3,86,0,15,2,89,0,record number electoral college voter defect donald trump officially confirmed 45th president
0,1,6,29,1,6,0,35,0,"right clash youtube, video vanish"
0,2,1,67,2,13,5,68,0,"which? survey find household appliance blame almost 12,000 fire three year"
0,2,11,53,0,12,2,64,0,kodak black settle lawsuit florida record label signed 16
0,2,2,77,3,19,0,79,0,"three day crash, trapped car dead girlfriend. face charges."
0,2,1,37,1,4,0,38,0,ireland pass same-sex marriage referendum
0,3,4,36,1,8,0,40,0,google map let play pac-man real street
0,3,12,62,3,12,0,74,0,anonymous white house official claim trump's disastrous muslim ban 'success story'
0,3,2,38,2,9,0,40,0,trump friend say priebus way head
0,3,13,53,2,12,4,66,0,"starting 2017, french worker legally protected off-hours work email"
0,3,8,40,3,10,0,48,0,feeling chill? blame polar vortex. global warming.
0,2,12,42,0,11,0,54,0,lamar odom document road recovery new reality series
0,3,13,52,0,12,0,65,0,harry style finally unveiled new single people losing shit
0,1,5,61,2,8,0,66,0,israeli-arab hebrew university student charged operating al-qaeda cell
0,2,14,61,1,14,0,75,0,tech failure ellen pao write memoir blaming everything sexism racism breitbart
0,3,11,46,2,10,0,57,0,apple hire porsche's race car engineering chief build icar!
0,3,5,41,2,9,2,46,0,'modest' 90th birthday party retired pope benedict xvi
0,2,5,44,2,10,0,49,0,donald trump stolen paul ryans party him?
0,3,4,59,1,10,0,63,0,gavin grimm case: supreme court scrap case transgender bathroom right
0,3,11,37,3,10,3,48,0,25-year-old may soon give hong kong first $1 billion startup
0,2,8,33,3,7,0,41,0,"sexual harassment isnt sex, power"
0,2,1,57,0,9,0,58,0,collarenebri shock toxic moonshine claimed three life
0,3,15,66,3,14,0,81,0,"priyanka chopra celebrates president day baywatch team tow, post hilarious video!"
0,1,8,42,2,8,0,50,0,"pernetti, new rutgers athletic director, feel right home"
0,1,2,73,2,13,0,75,0,kraft canada recall cooky report 'sharp metal objects' baked cooky
0,1,2,52,0,7,0,54,0,responsibility claim london attack questioned expert
0,3,7,40,3,9,2,47,0,"rickles, comedy equal opportunity offender, dy 90"
0,1,2,32,1,6,0,34,0,"ford, fiat produce small car together"
0,3,8,50,1,9,0,58,0,aaron hernandez's family hold private ceremony connecticut
0,1,2,34,0,5,0,36,0,south park episode available free online
0,3,10,42,1,9,0,52,0,russia reject trump charge iran top terrorist state
0,1,8,41,2,11,0,49,0,"first, third outfield, mets want tati position hit"
0,1,3,54,4,10,5,57,0,obama raise $35m re-election fund 244 campaign 'bundlers' since april
0,1,2,50,1,8,0,52,0,thai-cambodian general talk border clash kill two
0,3,10,48,1,15,9,58,0,rap song account half billboard hot 100's top 10 first time since 2013
0,1,5,33,0,6,0,38,0,banking industry showing sign recovery
0,3,11,46,2,11,1,57,0,reese witherspoon think perfect time 'legally blonde 3'
0,1,4,37,1,7,0,41,0,"several business catch fire queens, new york"
0,1,4,43,0,8,0,47,0,bomb blast hit south thailand market town sungai golok
0,2,3,56,1,10,0,59,0,blondie suspect success molly meldrum's hand accident
0,1,6,44,0,10,4,50,0,uni defeat nambor 2013 sunshine coast rugby union season end
0,2,2,10,0,2,0,12,0,israel fire
0,3,2,53,0,9,0,55,0,new eclipse forever stamp magically transform moon
0,1,7,31,3,10,0,38,0,"kenya qatar (by way holland), long run"
0,1,4,22,1,7,4,26,0,"3,100 strike vale inco canada"
0,1,6,35,0,5,0,41,0,chief doubt chrysler would survive bankruptcy
0,1,4,23,0,5,0,27,0,rule change worker farm
0,1,2,49,0,10,2,51,0,60 member chadian sect killed troop violence
0,3,15,64,1,14,0,79,0,"citizen lash cutting trees, mumbai metro get arborist preserve greenery"
0,2,8,31,0,7,0,39,0,goldman sachs say trump rally curbed
0,2,1,32,1,5,0,33,0,world mysterious family tree
0,2,12,58,0,13,0,70,0,teacher creates tennis ball chair help student autism sensory issue
0,3,11,57,0,13,0,68,0,wife falcon player andy levitre stayed entire playoff game labor
0,3,10,50,0,11,0,60,0,new jersey reject proposal give charter school hiring leeway
0,2,12,44,0,9,0,56,0,comey confirms fbi probing trump campaign colluded russia
0,3,10,40,2,13,0,50,0,report: want job? able say one language
0,1,3,40,0,7,0,43,0,canadian military accused agent orange cover
0,3,2,78,2,14,0,80,0,muslim police officer claim called isi leader colleague 'fired complaining'
0,1,5,22,0,4,0,27,0,french police round migrant
0,1,2,35,0,6,0,37,0,local regional election held russia
0,2,7,40,0,6,0,47,0,french president declares economic state emergency
0,2,5,31,3,7,0,36,0,trump refusal condemn putin killer
0,2,14,55,2,15,1,69,0,delhi molester even keep count victim 5 major read today
0,2,12,43,0,11,0,55,0,spongebob fan loving birthday cake girl got herbrother
0,3,5,61,2,11,0,66,0,french election: voter paris' barbes market think candidate
0,1,8,39,0,8,0,47,0,another politician killed iraqi voting draw near
0,3,2,40,0,12,2,42,0,nh home woman missing 35 year eyed new search
0,1,2,53,1,10,0,55,0,"two die school bus accident missouri, several others injured"
0,3,8,39,0,7,0,47,0,netflix first quarter gain fall short expectation
0,1,2,47,1,8,3,49,0,woman awarded 18.6 million dollar lawsuit equifax
0,3,3,46,3,9,0,49,0,"dutch election might over, europe's headache"
0,2,7,44,0,9,0,51,0,lebanon auction energy right area contested israel
0,3,8,46,2,9,1,54,0,scuffle pro-trump rally held; 6 arrested california clash
0,3,11,31,2,8,0,42,0,fidelityvoice: forget take mrd year end
0,1,5,25,2,8,2,30,0,opel germany seek $4.2 billion aid
0,2,5,47,1,10,0,52,0,could begrudge lukas podolski roy rover ending?
0,3,10,55,1,11,0,65,0,dennis schroder suspended hawk failing report all-star break
0,1,2,34,0,4,0,36,0,coordinated terrorist attack hit london
0,3,3,82,1,13,0,85,0,"iraq torture claim lawyer leigh day evidence client scheming insurgents, tribunal hears"
0,3,2,65,1,9,0,67,0,turkish opposition appeal referendum result expanded erdogan's power
0,2,12,50,0,11,0,62,0,people inspired montreal restaurant giving away freemeals
0,1,6,22,0,6,0,28,0,bid respect stopped
0,1,2,52,0,9,0,54,0,human remains mass grave confirm argentina secret death camp
0,1,2,60,1,7,0,62,0,european airline ryanair fined ash-triggered flight cancellation
0,2,3,34,1,6,0,37,0,"multiple people slashed queens, thebronx"
0,1,2,39,0,8,0,41,0,one dead jet crash airport rwanda
0,3,5,58,1,11,0,63,0,u drop biggest non-nuclear bomb ever used islamic state afghanistan
0,2,11,52,2,13,0,63,0,tool get headline governor ball (to possible shock lorde fans)
0,1,2,37,0,6,0,39,0,serial killer sentenced death swaziland
0,2,2,52,1,9,0,54,0,experts: china might building database federal worker info
0,1,2,49,1,5,0,51,0,obama's suspension guantanamo repatriation criticized
0,3,2,49,3,9,0,51,0,david cameron's 'cronies' attempt receive honour secret
0,2,11,54,5,14,0,65,0,joe biden: hillary doesnt say enough reach middle class breitbart
0,3,6,37,0,7,0,43,0,trump revives keystone pipeline rejected obama
0,2,3,72,0,11,0,75,0,allegation nate parker reinvigorated push understand sexual consent
0,1,2,55,1,7,0,57,0,"powerful earthquake rock southern japan, tsunami warning issued"
0,2,14,48,3,13,2,62,0,getting donald debt: 25-year-old tie bind trump wilbur ross
0,1,8,45,0,9,1,53,0,2nd custody hearing canceled jackson relative hold talk
0,1,1,35,0,6,0,36,0,dutch minister resign prison fire
0,1,11,53,2,10,0,64,0,"battle land embattled governor, message show extra-sharp medium elbow"
0,2,3,45,4,10,0,48,0,queer muslim woman south: exist fierce
0,1,4,18,0,4,0,22,0,buffeting small jet
0,2,1,67,1,11,0,68,0,woman's outraged response general election gone gloriously viral
0,3,1,57,1,10,2,58,0,"newborn abducted hospital found alive 18 year later, sheriff say"
0,3,1,60,0,10,0,61,0,indonesian police posed slain alleged thief counselled
0,3,1,46,1,8,0,47,0,couple closer ever husband's brush death
0,1,6,20,2,6,1,26,0,crash iraq kill 4 u.s. soldier
0,2,5,60,7,11,0,65,0,charging bull sculptor say fearless girl distorts art. he fighting back.
0,3,10,60,4,10,0,70,0,trump blame russian connection conspiracy theory clinton campaign cover
0,2,8,44,1,8,1,52,0,samsung's reputation tank among american note 7 fiasco
0,3,7,78,1,17,2,85,0,10 fall valentine's day hoax comedian claim donald trump want send theresa may flower
0,1,7,25,2,7,0,32,0,tentative deal g.m. sell opel stake
0,2,13,60,0,15,2,73,0,singer russian military choir among 92 feared dead plane crash black sea
0,2,2,53,2,8,0,55,0,"police identify british-born attacker, victim count rise four"
0,3,3,36,0,8,0,39,0,u missile system en route korean peninsula
0,2,9,37,1,10,0,46,0,lawyer: iranian family thrilled baby treated u
0,1,3,71,1,14,1,74,0,"tv channel hold exclusive trademark right number 3, stockholm court rule"
0,2,10,45,1,9,0,55,0,forgotten part basketball thats changing nba playoff
0,3,11,49,2,9,0,60,0,"serge ibaka trade rumors: latest news, speculation surrounding magic pf"
0,2,9,18,4,5,2,27,0,"run-dmc sue wal-mart, amazon $50m"
0,2,11,49,0,10,0,60,0,nfl writer realize ben roethlisberger blocked many twitter
0,3,7,55,1,11,0,62,0,murray ball: fan pay tribute late footrot flat new zealand cartoonist
0,2,7,41,0,6,0,48,0,secretive nonprofit back governor around country
0,1,6,32,0,6,0,38,0,maxine water scold critic bank meeting
0,3,9,45,0,10,0,54,0,florida eye doctor melgen guilty count medicare fraud
0,1,3,40,0,7,0,43,0,qatari diplomat detained la vega bound flight
0,2,6,34,0,6,0,40,0,belly dancing recover cancer treatment
0,3,12,49,1,10,0,61,0,watch taylor swift surprise oldest fan adorable home sing-along
0,1,1,36,0,6,2,37,0,stolen minibus recovered 35 year theft
0,2,2,45,1,8,0,47,0,india modi eye victory biggest state election test
0,3,3,49,2,10,0,52,0,"way, iceland's president would ban pineapple pizza"
0,1,1,37,1,4,0,38,0,astronomer discover large exo-solar system
0,3,8,27,0,9,0,35,0,team envyus go epic run win ogn apex
0,3,1,54,1,11,0,55,0,head clouds: share story life tall building
0,2,3,57,1,10,0,60,0,"matter many republican denounce trump, racism charge stick"
0,2,12,51,0,12,0,63,0,ted nugent kid rock floated potential gop senate candidate insider
0,2,5,53,0,10,0,58,0,patrick stewart ian mckellen rekindle bromance kiss
0,1,3,42,0,8,0,45,0,condemned u killer face execution firing squad
0,1,3,43,1,7,4,46,0,2008 taiwan designers' week show potential innovation
0,3,3,71,2,11,0,74,0,george michael: fan lay floral tribute charity reveal singer's secret generosity
0,1,10,34,3,9,0,44,0,i.b.m. unveils software find trend vast data set
0,1,3,43,1,8,2,46,0,new york city reach $33 million strip search settlement
0,2,2,61,6,12,0,63,0,out-of-office reply say youll limited access email? dream
0,2,7,49,1,9,0,56,0,nasa's journey mar aided university canberra researcher
0,1,4,38,0,7,0,42,0,cyclone phet turn pakistan hitting oman
0,2,3,58,5,14,0,61,0,"naomi klein: trump idiot, dont underestimate good"
0,3,8,38,1,7,0,46,0,uber crash show human trait self-driving software
0,1,3,37,0,8,0,40,0,man shot pope released prison turkey
0,1,1,44,1,4,0,45,0,honda demonstrates mind-reading robotic technology
0,1,7,39,2,7,0,46,0,"philip rizk, protester freed egypt, describes ordeal"
0,3,8,37,1,5,0,45,0,new un secretary-general face harrowing challenge
0,2,10,48,0,9,0,58,0,oklahoma pol hit child prostitution charge quits state senate
0,2,2,58,4,15,0,60,0,"time money summer vacation, im trying naycation instead"
0,2,7,57,2,15,4,64,0,bafta award 2017 baftas wouldnt british without stephen fry host
0,2,7,35,0,10,4,42,0,stock surge first quarter 2017 ride tech wave
0,2,7,83,0,13,0,90,0,adrian peterson minnesota viking receives overwhelming support hometown adrian peterson day
0,3,11,57,2,11,0,68,0,elton john cancel entire caesar palace run due 'unusual bacterial infection'
0,3,9,53,3,9,0,62,0,petraeus mishandling classified information: 'i made serious mistake'
0,1,8,31,0,8,0,39,0,latvia shaken riot weak economy
0,1,5,26,0,7,2,31,0,bomb kill least 76 baghdad market
0,1,7,35,1,6,0,42,0,"amazon strong quarter, unlike retailer"
0,3,5,56,0,11,0,61,0,abused isi detainee recounted torture suffered hand
0,3,17,68,1,16,0,85,0,indian hockey captain vandana kataria walk movie hall play national anthem
0,3,11,44,3,9,0,55,0,chris pratt say blue-collar america remark pretty stupid
0,2,3,27,1,6,0,30,0,valentine's day number video
0,1,5,63,0,12,0,68,0,u secretary state hillary clinton say america help fuel illegal drug trade
0,3,12,51,1,11,0,63,0,david bowie know cancer terminal three month death
0,3,4,49,0,10,0,53,0,close powerful dji drone could change business
0,3,15,51,1,13,0,66,0,nba michael jordan told richard hamilton good enough wear shoe
0,3,6,13,0,3,0,19,0,cnn politics live vote
0,2,1,46,1,9,0,47,0,want preserve liberal international order
0,2,2,33,4,6,0,35,0,"air canada's colors: bandit, raccoon loon?"
0,2,6,33,1,6,0,39,0,israel can't avoid settlement talk anymore
0,1,7,37,1,7,0,44,0,cut-prone fighter turn surgery limit bleeding
0,1,5,40,0,5,0,45,0,novitzky aid prosecutor clemens investigation
0,2,10,52,1,10,0,62,0,kevin durant's absence showing warrior built defy adversity
0,3,3,51,0,9,0,54,0,sheriff deputy dy car plunge san antonio sinkhole
0,3,6,56,1,11,0,62,0,"hug, tom brady roger goodell still effectively bury deflategate"
0,2,10,52,3,9,0,62,0,"charlotte riots, democrat cancel pro-clinton press call breitbart"
0,3,9,50,3,9,0,59,0,d.c. lamont peterson beat david avanesyan wba welterweight title
0,1,5,33,0,6,0,38,0,researcher hunt fishless lake maine
0,1,15,41,3,7,0,56,0,canadavotes: ndp candidate jo-anne boulding parry soundmuskoka
0,3,1,58,1,7,0,59,0,odd football-size armored creature solve ancient footprint mystery
0,2,4,45,4,7,0,49,0,"wall street falls, snapping three-day rally; wal-mart weighs"
0,1,4,45,0,7,1,49,0,ariane 5 rocket launch first automated transfer vehicle
0,3,3,66,3,10,0,69,0,euthanasia debate becomes personal nikki gemmell mother's 'lonely death'
0,3,1,71,0,11,0,72,0,elbow knitting method woman provides creative outlet two vehicle accident
0,2,3,56,0,9,0,59,0,shock man forcibly removed overbooked united airline flight
0,3,10,35,1,9,4,45,0,ideal landing spot 2017 nba draft's top prospect
0,1,6,33,0,6,0,39,0,russia ukraine settle natural gas dispute
0,1,5,27,1,5,0,32,0,"beijing suburb, vibrant string"
0,1,2,43,3,7,0,45,0,'brakes failed': fourteen killed guatemala bus crash
0,3,8,51,3,11,0,59,0,"international womens day: call action, protest word praise"
0,2,17,64,1,15,3,81,0,resilience: youtube star triumphed crippling anxiety garner 100m view
0,2,5,38,0,6,0,43,0,steve bannon loses national security council seat
0,1,5,34,1,5,0,39,0,successor illinois anti-blagojevich
0,1,3,51,2,9,0,54,0,"two killed, one seriously injured crash lancashire, england"
0,3,10,45,2,7,0,55,0,volkswagens ex-ceo denies prior knowledge emission cheating
0,3,10,57,2,11,0,67,0,chelsea manning's commutation likely mean leniency edward snowden
0,2,2,53,1,9,0,55,0,iran blind acid-attack woman sharia retribution punishment
0,1,2,57,1,9,0,59,0,"south african serial killer guilty nineteen rapes, sixteen murder"
0,3,5,31,0,6,4,36,0,turmoil police shooting lingered 2016
0,3,5,40,3,11,1,45,0,vote: get no. 1 seed eastern conference?
0,2,14,53,1,14,2,67,0,"16th century mexican church rise dead, thanks severe drought"
0,2,15,59,0,11,0,74,0,stunning photo series highlighting experience lgbt african immigrant
0,2,5,26,0,6,0,31,0,guide watching golden globe
0,3,7,33,1,11,4,40,0,"nhl ice olympics, say 2018 game south korea"
0,3,12,56,0,11,0,68,0,baahubali face obstacle tamil nadu karnataka distribution film
0,3,2,53,0,6,0,55,0,israel approves settlement home following trump inauguration
0,1,2,44,0,8,0,46,0,ten climber killed avalanche turkish ski resort
0,1,6,29,1,7,0,35,0,"power fed, despite failure"
0,2,8,42,0,8,0,50,0,ten dead explosion saint petersburg metro station
0,2,13,50,2,13,0,63,0,joel embiid tag 'meniscus' location ig post ruled year
0,2,9,48,0,12,1,57,0,police suspect social medium mall violence across least 9 state
0,2,8,46,1,11,0,54,0,lavar ball: prefer lonzo lakers learn magic johnson
0,1,2,33,0,6,0,35,0,two dead building collapse kenya
0,2,12,37,4,12,1,49,0,drake's 'more life' no. 1 album third straight week
0,3,7,47,0,9,0,54,0,bbc trust say laura kuenssberg report corbyn inaccurate
0,2,11,38,4,10,0,49,0,"andreea cristea, fell thames u.k. attack, dy"
0,3,4,68,3,15,3,72,0,walking dead season 7 episode 15 review: unusually tame build-up next week's finale
0,3,15,53,0,11,0,68,0,ncaa say rick pitino properly handle louisville recruiting sex scandal
0,3,8,80,4,15,0,88,0,listen bruce springsteen's rejected 'harry potter' song even bos get hogwarts
0,2,2,41,0,7,0,43,0,trump draw far smaller inaugural crowd obama
0,3,11,45,2,9,0,56,0,new data suggest u.k. government figure getting released early
0,3,1,48,3,10,10,49,0,"2017's $100,000 oscar gift bag includes pelvic floor exercise tracker"
0,2,2,38,0,5,0,40,0,philippine earthquake kill four mindanao
0,3,8,49,5,10,0,57,0,"donald glover, james earl jones cast disney's live-action ""lion king"""
0,1,2,44,0,11,3,46,0,four bombing two day leave 130 dead iraq
0,2,14,45,4,13,0,59,0,"let put end madness, say brother slain police officer"
0,1,6,34,0,7,0,40,0,panel issue standard reduce prison rape
0,1,8,60,1,12,0,68,0,"jack grime continues white house run united fascist union, talk wikinews"
0,3,2,58,0,9,0,60,0,facebook user let stranger choose profile picture
0,3,13,43,0,12,0,56,0,election inspired gay hunter stop hiding truly
0,2,5,49,2,11,3,54,0,fox news poll: president trump's first 100 day getting mixed review
0,2,5,39,1,8,0,44,0,trump praise china's xi handling north korea
0,1,5,44,0,7,0,49,0,u defense secretary announces cut pentagon program
0,3,1,62,2,10,0,63,0,university student charged 'gruesome murder' mother denied bail
0,3,8,51,2,9,1,59,0,"one 6 american take antidepressants, psychiatric drugs: study"
0,3,2,42,0,10,0,44,0,panda cub atlanta zoo public first time
0,2,8,60,0,10,0,68,0,israel soldier elor azaria convicted manslaughter killing palestinian
0,1,4,24,0,4,0,28,0,wikileaks release iraq war log
0,3,6,68,5,17,2,74,0,'now hold daughter': hope bangladesh 'treeman' 16 surgery remove growth
0,2,4,34,1,8,0,38,0,"bush twin offer advice sasha, malia obama"
0,1,2,39,0,7,4,41,0,remains 1912 expedition plane found antarctica
0,1,1,21,0,2,0,22,0,scottish budget rejected
0,3,2,68,1,10,0,70,0,child sex abuse royal commission: lawyer reveal trauma representing survivor
0,1,1,33,0,4,0,34,0,iraqi parliament approves election law
0,2,12,54,1,11,0,66,0,"trump weakens fuel economy standards, american innovation price"
0,2,3,57,1,12,0,60,0,"disdain trump clinton strong, even dead campaigning"
0,2,10,42,0,9,0,52,0,photographer transforms one room world ofcolours
0,1,3,33,1,6,1,36,0,post-kyoto agreement subject g8 debate
0,3,9,34,1,8,4,43,0,cristiano ronaldo win best fifa men's player 2016 award
0,1,5,36,1,8,0,41,0,nhl: duck take commanding three game lead wild
0,1,6,64,0,11,0,70,0,montreal lab question ethic recent epo doping claim lance armstrong
0,3,9,31,0,8,0,40,0,search new lisbeth salander beginsnow
0,1,8,30,1,10,1,38,0,"uconn roll round 8, test"
0,2,1,29,1,6,3,30,0,bank fined 413m euro rate rigging
0,2,12,36,3,13,0,48,0,levar burton lavar ball: trump 'two pea pod'
0,3,7,40,0,6,0,47,0,improving population health make financial sense
0,1,3,39,0,5,0,42,0,publisher seek injunction google print
0,1,3,33,1,6,0,36,0,"suicide attack hit mall netanya, israel"
0,2,5,42,0,6,0,47,0,thai crown prince maha vajiralongkorn proclaimed king
0,1,2,53,1,8,0,55,0,security force open fire anti-government protestors syria
0,3,9,35,0,10,1,44,0,ranking top 4 nba draft prospect final four
0,3,2,79,2,11,0,81,0,istanbul nightclub attack: suspected gunman caught police two-week nationwide manhunt
0,1,6,29,0,8,0,35,0,ham radio weekend talking moon
0,3,15,56,1,13,0,71,0,shaquille o'neal pay funeral boy accidentally shot instagram
0,3,2,83,1,17,0,85,0,mobile keep tab elderly relatives: device send warning message wander
0,2,11,41,0,10,0,52,0,post malone reminds u unreleased music kanye west
0,2,15,52,4,12,0,67,0,listen: green day single focus american culture mass shooting breitbart
0,2,12,27,1,9,0,39,0,snoop dogg say want twitter's next ceo
0,1,8,62,0,11,0,70,0,baltic riot spread lithuania face deteriorating economic condition
0,1,7,31,2,8,0,38,0,"vick, prison, work humane society"
0,3,4,45,1,7,0,49,0,gambia president jammeh concedes defeat election
0,1,8,32,0,8,0,40,0,making sims neighbor relate
0,3,5,21,1,5,0,26,0,woolly mammoth last stand
0,2,9,51,3,12,0,60,0,"britain leave eu, brexit join oxford english dictionary"
0,1,6,34,1,7,0,40,0,potential heir procter gamble chief resigns
0,1,5,60,0,10,0,65,0,papua new guinea culture tourism minister charged attempted murder
0,3,14,63,1,13,0,77,0,seven miner killed dozen feared trapped coal mine collapse jharkand's lalmatia
0,1,6,33,1,5,0,39,0,"urging freedoms, obama chides zimbabwe leader"
0,1,1,34,0,5,0,35,0,feverfew compound get leukemia root
0,2,10,51,2,9,2,61,0,family reeling 13-year-old accidentally kill self instagram live
0,1,5,73,1,13,0,78,0,"former pasqua aide claim iraq intended reward charles pasqua, denies received oil"
0,2,12,49,3,12,0,61,0,geert wilder breitbart: people wisdom islam serious threat
0,3,3,51,1,8,0,54,0,"climate change pose increasingly severe risks, eu agency warns"
0,3,18,44,2,9,0,62,0,unicef usavoice: american never forget: life without vaccine
0,1,3,48,1,7,0,51,0,google mistakenly collect private data wi-fi network
0,3,2,54,1,9,0,56,0,delta passenger kicked flight bathroom emergency yahoo
0,2,8,42,1,8,0,50,0,michigan show trump could redraw electoral map vs. clinton
0,1,3,51,0,9,0,54,0,swiss man successfully fly jet pack across english channel
0,1,4,31,0,8,0,35,0,idi amin offered act peacemaker ni
0,2,5,10,3,4,0,15,0,edge: got
0,2,6,70,0,14,0,76,0,putin owns super bowl ring thanks misunderstanding patriot owner robert kraft
0,3,5,27,0,6,0,32,0,donald trump focus trade job
0,2,7,30,1,8,0,37,0,"melanoma rate rise, new data show"
0,2,10,52,4,11,3,62,0,$100 billion chinese-made city near singapore 'scares hell everybody'
0,1,2,34,2,6,5,36,0,"fuel leak prompt 17,000-vehicle recall toyota"
0,1,3,43,0,7,0,46,0,canadian still face public beheading saudi arabia
0,2,3,70,2,13,0,73,0,arrest young black suspect brutal chicago attack spark hate crime debate [video]
0,1,1,14,0,3,1,15,0,cairo blast kill 3
0,1,4,26,0,5,0,30,0,arrest warrant issued tom delay
0,3,10,58,1,11,0,68,0,project include simple starting point workplace diversity: better data
0,2,3,54,1,13,0,57,0,woman born vagina. hope child list
0,2,13,64,4,16,2,77,0,"thomas j. perkins, pioneering venture capitalist silicon valley, dy 84 new york time"
0,1,6,29,1,6,0,35,0,"ranger shut devils, assisted avery"
0,1,7,35,1,9,0,42,0,"mike dunlap coaching arizona, long"
0,2,7,82,3,19,0,89,0,"mother uber ceo travis kalanick died boating accident, father serious condition"
0,2,4,53,3,8,0,57,0,"melbourne christmas day 'terror attack' foiled, say australia police"
0,1,9,38,1,9,0,47,0,"boom town busts, brief political movement fade away"
0,1,5,40,2,10,2,45,0,"nguyen cao ky, former leader south vietnam, dy aged 80"
0,2,6,26,1,8,3,32,0,jay z selling $850 bottle champagne
0,1,4,58,1,9,0,62,0,australian football league: club threaten take home game interstate
0,2,5,63,1,13,0,68,0,"maryland fall ohio state, miss chance clinch big ten regular season title"
0,3,14,70,2,13,0,84,0,"david dao, doctor dragged plane, file court paper demanding united airline preserve evidence"
0,1,8,42,0,9,0,50,0,bayer running ad clarify benefit birth control pill
0,3,9,47,1,10,0,56,0,man get life sentence death pregnant ex-girlfriend hawaii
0,3,7,60,0,13,0,67,0,russia accuses foreign secretary boris johnson trying start new cold war
0,2,1,50,2,13,0,51,0,"man lost bet, friend duct-taped yield sign"
0,2,2,67,2,10,0,69,0,"official release initial list orlando nightclub shooting victim names, age"
0,3,6,42,0,7,0,48,0,conference battle produce competitive pro bowl nfl
0,2,2,22,0,6,1,24,0,suicide bomber kill 9 iraq
0,2,3,52,1,10,0,55,0,google's new font beautiful typeface east asian language
0,2,2,25,0,4,0,27,0,snake hunting everglades
0,2,10,50,3,9,0,60,0,hate performance reviews? good news: they're getting shorter simpler
0,3,7,25,0,7,0,32,0,fight trump face drug price
0,1,1,41,0,8,2,42,0,french police detain 20 terror suspect dawn raid
0,3,9,47,0,9,0,56,0,lance stephenson get deep channeling inner michael jordan
0,1,3,50,0,9,1,53,0,west virginia university regains title number 1 party school
0,2,3,72,0,13,0,75,0,vatican mole left secret message hidden confession box renaissance church rome
0,1,4,34,2,6,0,38,0,senior diplomat criticizes u.s. policy iraq
0,1,1,21,0,4,2,22,0,slovak bus accident kill 12
0,2,11,45,1,11,4,56,0,"1,500 tribals thrown home devamachi forest karnataka"
0,1,10,54,0,13,1,64,0,concern raised 2 obama adviser tied citigroup unit lost money
0,3,10,55,2,11,0,65,0,yemeni brother center immigration lawsuit finally allowed enter u.s.
0,3,12,54,1,11,0,66,0,one india's oldest social group includes everyone keep mizoram united
0,2,14,50,6,12,0,64,0,"schumer: gop lawmaker 'real problems' trump, 'break' away insider"
0,3,3,49,0,10,0,52,0,south african baby girl abducted durban found safe well
0,3,2,38,1,6,0,40,0,"pictures, westminster aftermath air"
0,1,3,45,1,9,0,48,0,"large hadron collider damaged, shut repair"
0,3,3,49,0,6,0,52,0,spacex successfully launch rocket saturday setback
0,3,2,44,3,10,7,46,0,"london attack: muslim group raise $25,000 victim 48 hour"
0,1,5,23,0,4,0,28,0,case aiding insurer
0,2,2,59,1,10,0,61,0,widow orlando nightclub shooter file petition change child's name
0,1,2,46,0,7,0,48,0,african refugee allege forced labour turkish police
0,3,1,33,2,6,3,34,0,trump's grand plan collide 100-day mark
0,3,4,73,2,12,0,77,0,trump's america donald trump vow military build-up feisty speech conservative summit
0,1,5,34,1,4,0,39,0,border company thrive mexican-american
0,1,1,48,0,5,0,49,0,tunisia hold presidential parliamentary election
0,3,12,42,5,12,0,54,0,film like o.j.: made america may cut oscar consideration
0,3,1,57,0,10,4,58,0,clinton formally launch 2016 campaign focus economic equality
0,1,7,33,2,6,0,40,0,u.s. help palestinian build force security
0,2,17,63,2,14,0,80,0,gm test self-driving car michigan's snowy road aggressive push autonomous future
0,1,4,57,1,10,0,61,0,"second controlled explosion carried bristol, united kingdom"
0,1,2,46,0,7,0,48,0,phone hacking scandal prompt medium review australia
0,3,5,69,1,13,0,74,0,ukip's paul nuttall fails turn hustings stoke amid hillsborough controversy
0,2,8,49,4,12,0,57,0,'lord rings' cast reunites series instagram photo [video]
0,1,5,69,0,11,0,74,0,report find canberra northern territory expensive cocaine australia
0,1,5,70,1,8,0,75,0,australian prime minister-elect tony abbott announces first ministerial appointment
0,2,11,48,4,11,3,59,0,'the basketball tournament' offer $1 million ex-nba player 97 team
0,2,4,50,2,12,0,54,0,oscar red carpet live action 'beauty beast'
0,1,2,33,0,5,0,35,0,protester say japanese whaler shot
0,1,10,48,3,12,2,58,0,"hitting bottom, boxer paul spadafora, 33, trying regain top"
0,1,6,28,0,5,0,34,0,study say antiunion tactic common
0,3,15,53,3,14,0,68,0,robert de niro haunted bernie madoff's bad decision 'wizard lies' teaser
0,3,7,45,0,8,1,52,0,7 hijabi blogger challenge traditional notion beauty
0,2,3,50,1,7,0,53,0,russia-brokered syrian ceasefire chance succeeding
0,2,7,38,3,10,1,45,0,grammy award made: 4 craftsman grammium
0,2,10,49,0,11,0,59,0,house democrat ask devin nunes recuse russia inquiry
0,1,7,41,0,9,0,48,0,body found mystery lingers kin missing woman
0,3,3,30,1,4,0,33,0,could trump defrost russian relations?
0,2,7,74,4,17,2,81,0,"went 24-hour 'ultimate' taco bell la vegas, serve alcoholic baja blast slushies"
0,3,5,55,0,14,0,60,0,jay z first rapper inducted songwriter hall fame
0,3,3,55,2,13,0,58,0,man fight twitter scammer vowing marry 'hindu mosque'
0,1,7,37,0,9,0,44,0,big ben dropped itv news ten opening sequence
0,3,4,77,0,14,0,81,0,spain ramp border check gibraltar schengen move tension tighten brexit
0,2,10,70,3,13,0,80,0,"queen's birthday honours: bem katie cutler, beautician helped mugging victim alan barnes"
0,1,5,61,2,10,0,66,0,"train car derail thompson river, british colombia, chemical spilled"
0,1,5,24,0,4,0,29,0,ida ireland open shanghai office
0,3,1,28,1,7,0,29,0,like live monastery
0,3,3,47,1,10,0,50,0,lisa frank makeup line could rainbow-hued future
0,2,7,39,2,8,0,46,0,million china learn live smog airpocalypse
0,3,8,49,0,10,0,57,0,seattle homeless camp invited university washington
0,3,19,40,7,13,2,59,0,"every 90 girl going scream, omg what!? iconic shoe re-release"
0,2,2,59,1,11,0,61,0,deputy help girl build snowman mom cancer recuperates yahoo
0,1,1,67,1,10,0,68,0,"mongolia declares state emergency violent protests, five people killed"
0,1,2,31,0,5,0,33,0,beirut car bomb target hamas official
0,3,9,51,1,10,0,60,0,"million risk losing health insurance republican plan, analyst say"
0,3,9,44,0,11,0,53,0,million taxpayer reaching refund loan
0,1,7,34,0,8,2,41,0,tiger complete turnaround first big 12 title
0,2,9,58,1,9,0,67,0,"grammy producer ken ehrlich apologizes metallica, shirley caesar glitch"
0,3,8,41,1,9,0,49,0,malaysia: cause death determined yet north korean
0,3,1,57,2,10,0,58,0,jailing way people whove convicted exactly nothing
0,3,8,44,1,9,0,52,0,expect expecting acosta labor secretary
0,1,1,32,0,5,2,33,0,17 killed cambodian ferry capsizes
0,1,9,44,0,10,0,53,0,bargain shopper find lot elbow room yankee stadium
0,2,7,43,0,9,0,50,0,taliban kill afghan woman accused adultery northeast
0,3,1,49,1,9,0,50,0,facebook ready ramp flight solar-powered drone
0,1,7,31,2,5,0,38,0,oestgaard buaas retains u.s. slopestyle title
0,2,5,23,1,5,0,28,0,end thailand tiger temple
0,1,6,30,0,8,0,36,0,conviction fraud fled child
0,1,2,31,0,6,0,33,0,michael jackson fate hand juror
0,1,1,34,0,6,0,35,0,arctic ice cap shrank sharply summer
0,3,1,49,0,7,0,50,0,congo prepares potentially violent political crisis
0,2,7,35,0,7,0,42,0,nicki minaj call giuseppe zanotti twitter
0,2,3,48,3,12,0,51,0,"fabulous life dr. dre, one wealthiest men hip-hop"
0,3,4,43,1,9,0,47,0,gorsuch tally: senator stand court nominee
0,2,3,74,0,12,0,77,0,theresa may avoids question possible knowledge trident missile error vote
0,2,11,36,2,11,4,47,0,nfl free agency 2017: team improved far?
0,2,13,32,6,10,0,45,0,"remy ""shether"": 'i'm particularly proud it'"
0,1,5,37,1,8,2,42,0,state h1n1 swine flu world's dominant virus
0,3,5,52,0,8,0,57,0,isi claim responsibility istanbul nightclub shooting spree
0,2,11,56,1,9,0,67,0,anti-defamation league offering sean spicer remedial holocaust lesson
0,1,4,18,0,4,0,22,0,remembering way
0,3,5,73,0,12,1,78,0,body recovered three drown crowded 4wd swept northern territory floodwaters
0,2,15,28,1,9,0,43,0,"opec keep promise crude oil cuts, iea say"
0,1,7,30,2,8,0,37,0,u.s. stock hope stabilizing economy
0,3,4,36,2,8,0,40,0,george h.w. bush get special visitor hospital
0,3,13,73,3,15,0,86,0,"pete hoekstra call hearing susan rice unmasking scandal, big brother potentially worst"
0,2,3,51,2,9,0,54,0,managed tax transparency pakistan. everywhere else?
0,2,8,29,4,9,2,37,0,president trump dow 20k: im proud
0,2,4,42,1,8,0,46,0,syria: u warns assad using chemical weapon
0,2,11,37,7,7,0,48,0,"trump, may meeting revive u.s.-uk special relationship?"
0,2,1,37,1,9,4,38,0,"oil down, end year biggest gain since 2009"
0,3,2,58,5,11,0,60,0,london terror: utah victim's family harbor 'ill-will harsh feelings'
0,2,5,51,1,8,0,56,0,pro-settlement hardliner friedman confirmed u envoy israel
0,1,1,26,0,6,0,27,0,briton urged vote post
0,3,6,37,1,8,0,43,0,sling arrow lead outrageous fortune?
0,3,9,42,0,8,0,51,0,hong kong losing sheen make cathay business model obsolete
0,1,3,45,1,9,0,48,0,"police shoot eight gunman new orleans bridge, five dead"
0,2,2,56,0,12,0,58,0,scientist grow beating human heart stem cell list
0,2,8,49,0,12,1,57,0,2 killed clash demolition arab bedouin village israel
0,1,7,25,0,7,0,32,0,coach iraqi karate team shot dead
0,2,4,56,1,10,0,60,0,behind mysterious stock dump ahead trump's lockheed martin tweet
0,2,7,43,2,9,2,50,0,joel embiid injury: update 76ers center's foot recovery
0,2,5,52,0,12,0,57,0,nasa release stunning new image earth seen space night
0,3,3,48,1,11,0,51,0,study: hillary clinton ran one worst campaign year
0,3,11,29,0,8,0,40,0,nasa show landing pluto would look like
0,3,8,43,0,8,0,51,0,trump pick former texas governor perry energy secretary
0,1,7,32,0,6,0,39,0,new hampshire senate pass gay marriage bill
0,2,5,78,3,15,0,83,0,"resident voted brexit, british county realized e.u. might stop sending money"
0,2,3,46,3,9,0,49,0,debate over: correct way pronounce 'porsche' revealed
0,3,9,46,1,12,0,55,0,trump us iphone despite calling apple boycott
0,3,4,48,2,8,0,52,0,trump rip 'ungrateful' chelsea manning obama criticism
0,1,2,51,1,10,3,53,0,"west african cholera claim 500 lives, death feared"
0,3,3,43,1,9,0,46,0,growing poor make harder succeed: janet yellen
0,2,11,40,3,10,0,51,0,"brexit created many losers, winner too. you?"
0,2,3,47,0,6,0,50,0,sport industry mourns legendary broadcaster craig sager
0,3,5,70,3,12,0,75,0,archbishop philip freier 'deeply ashamed' anglican church's response child sex abuse
0,1,2,21,1,4,4,23,0,"sun microsystems cut 6,000 job"
0,2,1,23,3,3,0,24,0,obamas safe spacehypocrisy
0,3,2,65,1,10,0,67,0,"small farmer struggle worldwide, palestinian farmer really rough"
0,1,2,24,0,4,2,26,0,exit festival 05 begin tomorrow
0,2,1,81,0,19,0,82,0,hero service dog break leg throwing path bus save blind owner
0,3,2,60,0,13,0,62,0,amber heard say warned coming bisexual would end career
0,3,3,58,1,11,0,61,0,"new york commuter train derails brooklyn rush hour, injuring dozen"
0,2,2,31,1,5,2,33,0,theresa may article 50 letter annotated
0,1,1,62,1,11,0,63,0,"china executes people rest world combined, according report"
0,2,4,55,3,12,0,59,0,studying aleppo university: 'you get used seeing blood floor'
0,1,9,36,2,11,0,45,0,"judo icon, fighter sport, facing new battle"
0,2,4,60,1,13,6,64,0,"theresa may refuse shut shop boxing day despite 140,000 petition signature"
0,3,12,54,0,11,0,66,0,maryland victim longer need prove physically fought rapist
0,3,12,58,1,9,0,70,0,matthew fisher-davis discusses fouling northwestern lead ncaa tournament
0,1,3,37,1,9,2,40,0,"two bomb blast kill least 17 istanbul, turkey"
0,1,2,71,0,10,0,73,0,wimbledon official receive criticism animal right group shooting bird
0,3,16,53,4,14,0,69,0,"boxing legend muhammad ali's son detained u airport, asked whether 'he muslim'"
0,1,8,36,0,7,0,44,0,unlikely player helping mets hold ground
0,3,8,46,5,11,2,54,0,"william christopher, actor father mulcahy m*a*s*h, dy 84"
0,2,2,47,0,10,0,49,0,petra kvitova unable play tennis least six month
0,3,4,64,2,9,0,68,0,kim jong-nam assassination: indonesian vietnamese woman charged murder
0,1,2,38,0,5,0,40,0,former chadian leader receives death sentence
0,2,14,49,4,16,0,63,0,"gambia back again, new leader still senegal new york time"
0,3,2,83,2,13,0,85,0,"turkish parliament approves presidential system bill, paving way vote extend erdogan's power"
0,3,8,36,0,9,0,44,0,bank mexico sell dollar peso reach new low
0,2,8,41,0,8,0,49,0,world cup power ranking latest round qualifier
0,1,8,32,0,6,0,40,0,verizon wireless voip device cut landline
0,2,12,44,4,12,5,56,0,gurugram pollution go 'severe' pm 2.5 level show increase 115%
0,1,3,64,0,10,0,67,0,controlled explosion take place police enquiry uk bombing continues
0,2,13,52,2,15,0,65,0,"mom booked leaving kid hot car leaf kid hot car, again: police"
0,3,5,75,5,14,0,80,0,"star war isnt political, say disney chief responding boycott trump supporters. he wrong."
0,2,13,48,2,12,0,61,0,"study find india asia's corrupt country, japan come last"
0,3,3,53,0,10,0,56,0,transgender teen activist jazz jennings soon get doll
0,2,1,75,3,13,6,76,0,10 stunning side-by-side photo show destructive japan's 2011 earthquake tsunami
0,2,3,47,0,7,0,50,0,watch first surgery recorded snapchat spectacle
0,1,5,26,0,5,0,31,0,local issue dominate india vote
0,1,2,25,0,4,0,27,0,local election held croatia
0,2,12,57,0,9,0,69,0,kitsplit acquires cameralends becomes biggest online camera rental company
0,2,8,49,0,9,0,57,0,turkish police hunt gunman istanbul nightclub terror attack
0,1,3,30,0,6,0,33,0,new michael jackson song released
0,2,3,44,2,11,0,47,0,"god help u all, martha stewart's truck stuck snow"
0,3,3,19,0,3,0,22,0,french disconnection
0,3,12,48,5,11,0,60,0,"cheadle kendrick's niece: breaking rapper's ""dna"" video"
0,1,9,44,1,9,0,53,0,padraig harrington win first pga tour event; honda classic
0,2,6,50,6,11,3,56,0,"5 thing wednesday, april 19: facebook, georgia race, uk ""snap"" election"
0,1,2,26,0,5,0,28,0,men isolated mimic mar flight
0,3,2,49,1,8,0,51,0,historically black college: band march inauguration
0,2,16,43,3,10,0,59,0,"amu, allahabad university among non-performers audited ugc!"
0,1,5,45,0,8,0,50,0,demonstrator police clash imf meeting istanbul
0,1,2,46,0,9,4,48,0,olympics organiser insist london win 2012 ballot fair
0,2,9,50,0,9,0,59,0,supreme court must restore religious liberty military member
0,3,5,24,0,4,0,29,0,guidebook donor advised fund
0,2,6,33,0,8,0,39,0,pedal bear blurred line specie
0,1,8,69,4,12,0,77,0,u.k. national portrait gallery threatens u.s. citizen legal action wikimedia image
0,2,1,61,3,11,2,62,0,"generation give damn climate change, say 14-year-old activist"
0,2,3,72,5,13,0,75,0,ivanka trump complained medium called adviser. shes officially adviser.
0,2,10,50,0,11,2,60,0,5 insight judge neil gorsuch 2nd day confirmation hearing
0,1,7,33,0,7,0,40,0,energy cost push consumer price january
0,2,1,49,0,9,0,50,0,phoenix turn petition adopt sanctuary city status
0,2,13,45,3,12,2,58,0,nba player power rankings: b/r's top 30 small forward halfway point
0,3,11,49,3,11,0,60,0,"former sen. bob dole's influence helped lead call trump, taiwan"
0,1,11,63,3,14,0,74,0,"paul schneider leaving nbc's park recreation; rob lowe, adam scott appear series"
0,1,2,39,1,7,4,41,0,sharapova knocked wimbledon 2005 semi-final
0,1,7,38,0,7,0,45,0,british bank northern rock plan increase lending
0,3,9,40,2,13,0,49,0,like apply job donald trump white house
0,3,2,39,0,7,0,41,0,african attacked roaming mob india
0,3,8,49,0,11,0,57,0,rick derringer pleads guilty bringing loaded gun airplane
0,3,16,58,2,13,0,74,0,former sen. al d'amato kicked jetblue flight trying lead passenger rebellion
0,1,2,47,3,8,0,49,0,"ipswich, england serial murder adapted 'musical'"
0,1,2,46,0,6,0,48,0,bill clinton leaf hospital following heart procedure
0,1,6,41,0,8,0,47,0,herman van rompuy named first permanent eu president
0,1,8,46,0,7,0,54,0,farmer angry report kirchner eye nationalization
0,3,11,56,3,13,0,67,0,buried train french teacher daughter: cuban exile search home
0,3,13,46,1,10,0,59,0,google's deepmind developed ai learns old experience
0,2,12,33,3,10,0,45,0,baron davis rock mean jheri curl espn's 'first take'
0,1,3,46,3,8,0,49,0,"injuries, death car-bomb explodes madrid, spain"
0,1,2,32,2,5,0,34,0,"russia probing jewish law ""incitement"""
0,2,15,55,2,13,1,70,0,"jolly llb 2 movie review rating featuring akshay kumar, annu kapoor, huma qureishi"
0,3,3,51,2,10,2,54,0,suicide bomber kill least 30 soldier yemen's aden: official
0,2,8,57,2,12,0,65,0,"ultimate insult, trump roll back epa's climate policy within epa"
0,2,2,55,5,11,0,57,0,roomba creator responds report poopocalypse: see lot
0,2,4,53,1,11,0,57,0,"female journalists, mary tyler moore showed u life wanted"
0,3,17,56,5,15,0,73,0,hollywood wish everyone 'hippy' new year famous la sign altered 'hollyweed'!
0,3,9,35,1,8,4,44,0,dale earnhardt jr. retiring nascar 2017season
0,2,2,75,0,11,0,77,0,union leader threatens illegal strike government tightens rule industrial action
0,1,6,37,0,5,0,43,0,extended stay hotel seek bankruptcy protection
0,3,5,33,1,6,0,38,0,mohammad marandi: iran crucial stopping
0,3,10,55,0,10,0,65,0,steve martin deletes carrie fisher tweet getting thrashed internet
0,1,1,38,0,6,0,39,0,google announces new database service blog
0,2,4,67,2,10,0,71,0,"st petersburg explosion: subway blast suicide attack, russian investigator say"
0,3,5,66,0,9,0,71,0,opposition intensifies campaign david gillespie following bob day ruling
0,2,3,36,2,9,0,39,0,vote: far cowboy go playoffs?
0,3,1,45,2,10,0,46,0,"here's much inauguration costs, pay"
0,2,11,60,1,10,0,71,0,"ancient peru, archaeologist find rare spinal condition possible inbreeding"
0,2,10,32,3,9,2,42,0,nyt: obamas could bag $45 million book deal breitbart
0,2,6,36,0,6,0,42,0,malcolm butler visiting saint amid trade rumor
0,2,7,38,1,9,2,45,0,labor market recovery best 25 year business insider
0,1,2,22,1,3,0,24,0,jetliner crash-lands peru
0,3,15,65,3,15,0,80,0,"exclusive: anna wise talk working kendrick lamar, writing steve lacy, new album"
0,2,3,60,1,9,0,63,0,sanctuary cities: seattle sue trump administration executive order
0,1,6,28,0,6,0,34,0,federer return turn back upset bid
0,3,6,37,0,6,0,43,0,flight attendant train spot human trafficking
0,1,2,26,0,3,0,28,0,error hit greenpeace donation
0,2,5,74,3,14,0,79,0,"""they tried supplant mainstream media"": jane mayer billionaire behind bannon trump"
0,3,5,32,2,7,2,37,0,"ikutaro kakehashi, founder roland, dy 87"
0,3,5,41,1,11,0,46,0,add dead rabbit united airlines' long list pr woe
0,1,3,56,0,11,3,59,0,scientist discover 300 new specie island luzon philippine
0,1,6,29,1,6,1,35,0,germany predicts economy shrink 6%
0,3,4,54,0,10,0,58,0,u appeal court reject white house request reinstate travel ban
0,2,5,52,1,9,0,57,0,bbc reporter describes up-close encounter mount etna eruption
0,1,8,27,0,8,2,35,0,usc defeat penn state 95th rose bowl game
0,1,4,22,2,6,5,26,0,"bse sensex hit all-time high 14,000"
0,1,7,36,0,9,4,43,0,materazzi reveals slur uttered 2006 fifa world cup
0,1,1,46,0,9,0,47,0,shuttle launch called due faulty fuel tank sensor
0,3,9,28,0,8,0,37,0,hottest new car detroit auto show
0,2,3,44,1,9,0,47,0,everyone missing big picture trump yemen raid
0,2,3,79,1,15,0,82,0,"trump, alleged use sarin syria prompted different reaction chemical weapon"
0,1,4,27,0,6,0,31,0,file sharing site pirate bay sold
0,3,1,48,3,10,0,49,0,"raccoon 'erotic' ad became obsessed breasts, zoo say"
0,2,9,40,2,9,0,49,0,"china mark lunar new year prayers, incense, firework"
0,2,6,49,2,12,0,55,0,robert durst jinx pleads guilty murder los angeles
0,3,3,30,0,6,0,33,0,mall america host first black santa
0,1,7,37,0,7,0,44,0,privacy issue complicates push link medical data
0,1,5,35,0,6,0,40,0,former first lady nancy reagan endorses mccain
0,3,4,78,1,15,0,82,0,bird-brained drunk fly try swipe giant ornamental chicken polish easter market
0,1,5,27,0,5,0,32,0,crisis shape corporate model
0,2,3,57,3,13,0,60,0,"isil slave market sell girl little 'pack cigarettes', say un"
0,2,13,65,2,15,0,78,0,"immigrants, poor minority gain sharply affordable care act new york time"
0,3,13,51,0,11,0,64,0,imperial beach sewage spill draw dozen angry resident ibwc meeting
0,2,2,79,3,16,0,81,0,"doctor says: come breastfeeding, health happiness matter much baby"
0,3,10,43,0,12,0,53,0,single woman buying home twice rate single men
0,2,3,47,3,10,0,50,0,donald trump president: thought would easier
0,2,11,27,0,9,0,38,0,watch lance bass join bsb stage la vega
0,3,13,72,5,16,0,85,0,rob thomas show 'smooth' side performance new series 'front center': exclusive premiere
0,3,6,52,0,11,0,58,0,trump blame democrat house gop failure pas health care bill
0,1,7,24,3,8,3,31,0,3nd rescue would give u.s. 40% citigroup
0,1,4,51,1,11,2,55,0,celebrity plastic surgeon dr. frank ryan dy car accident aged 50
0,2,9,67,0,9,0,76,0,dresden unveils controversial monument look like radical islamist fortification
0,2,16,57,3,17,0,73,0,"former cowboy tony romo: lining behind golf ball, fails u open bid breitbart"
0,3,9,34,2,9,0,43,0,fall last minute tax refund phishing scam
0,2,5,45,3,9,0,50,0,"giants, ben mcadoo fined use walkie-talkie vs. cowboy"
0,1,3,27,0,6,0,30,0,u teen missing aruba feared dead
0,2,3,60,4,16,0,63,0,truth donald trump's cry 'fake news' historical norm
0,3,3,61,2,10,0,64,0,donald trump's handshake: real meaning explained body language expert
0,3,2,31,1,4,0,33,0,kidnapped honduras teens' body found
0,2,8,42,1,10,0,50,0,"dropping health vote, trump swallowed need showdown"
0,2,3,47,1,8,0,50,0,rare ledger reveal shoe-buying habit tolkien waugh
0,1,5,22,1,5,4,27,0,"american express plan 4,000 job cut"
0,1,4,67,0,9,0,71,0,wiltshire constabulary issue european arrest warrant hayley richards murder
0,2,7,53,3,11,4,60,0,live update hillary clinton 2016 campaign kickoff rally nyc [video]
0,3,13,50,2,14,1,63,0,suspect road rage killing 3-year-old boy said car following close
0,2,3,29,0,8,0,32,0,six food could send theer
0,3,14,56,2,13,3,70,0,gop rep peter king: 99.5 percent accurate say obama admin surveilled trump transition
0,1,2,37,0,8,3,39,0,xbox 360 shortage expected debut day europe
0,1,10,33,1,10,0,43,0,browsing? web store may follow door
0,2,3,45,0,7,0,48,0,new sanction iran announced trump administration
0,2,1,47,2,11,0,48,0,"likely catch flu cold snap, study say"
0,2,3,69,1,13,0,72,0,ghost shell: studio admits whitewashing controversy hurt film box office
0,1,5,24,0,5,0,29,0,televising yankee game net
0,1,7,35,0,7,0,42,0,allotting iraqi oil right may stoke hostility
0,3,11,41,1,5,0,52,0,people imagine would happen #ifonlytheearthcouldspeak
0,1,7,34,0,6,0,41,0,economic blogger angered seoul acquitted
0,3,8,43,1,6,0,51,0,several earth-like planet discovered orbiting nearby star
0,1,6,35,0,6,0,41,0,refugee region pakistan trickling home
0,3,3,57,2,12,0,60,0,country music star luke bryan hit back 'insulting' heckler gig
0,3,2,56,4,12,2,58,0,"police: man kill mom, set home ablaze, shoot cop 50-mile chase"
0,2,4,39,4,8,0,43,0,"sushi lovers, beware: tapeworm found u.s. salmon"
0,1,6,32,1,7,0,38,0,"lookout, digital security camera"
0,2,1,58,1,11,3,59,0,"trump inherit 100 court vacancies, plan reshape judiciary"
0,1,4,62,0,10,0,66,0,court rule massey appeal u restriction mine disaster investigation
0,2,3,53,2,12,0,56,0,brexit jitter mean less junk mail (and less money royal mail)
0,3,10,55,2,9,0,65,0,philippine's duterte disband anti-drug police unit korean murdered
0,2,7,40,2,9,0,47,0,cambodia mp back law barring pm hun sen's long-time rival
0,1,2,39,0,8,0,41,0,iraqi peace talk begin finland within day
0,1,6,43,0,7,0,49,0,former british northern ireland secretary mo mowlam dy
0,2,2,16,0,2,0,18,0,scientist trump
0,2,3,64,3,12,2,67,0,"jerusalem attack: four israeli soldier dead, 17 injured, truck ram crowd"
0,2,4,83,8,17,2,87,0,"shes pretty special: defying odds, d.c. area first heart transplant patient still alive 30 year later"
0,1,6,56,1,9,0,62,0,"richard stallman, founder gnu project confirmed safe earthquake"
0,2,6,37,2,11,3,43,0,"3 killed, 4 injured, 5 missing house collapse poland"
0,2,8,48,2,10,2,56,0,"michael novak, catholic scholar championed capitalism, dy 83"
0,3,4,73,2,12,0,77,0,mugwump? boris johnson use insult opposition leader leaf britain perplexed
0,3,5,35,1,6,0,40,0,istanbul besiktas: stadium blast captured tv
0,3,13,60,1,12,0,73,0,john lewis sat atlanta airport demanded answer detained traveler
0,3,4,48,2,9,0,52,0,"warrant: clinton, abedin email led fed seize weiner laptop"
0,3,4,71,4,14,0,75,0,"va. democrat northam ramp energy bid governor, call trump narcissistic maniac"
0,1,1,60,1,9,2,61,0,russian territory expands 4.5 square kilometre seismic activity
0,1,8,30,0,9,0,38,0,coors light us cold turn heat rival
0,3,2,57,3,8,0,59,0,astronomer think they've discovered 'interstellar' black hole
0,3,3,69,4,11,0,72,0,trump blame 'both democrat republicans' 'totally made up' dossier allegation
0,2,6,56,3,11,4,62,0,"1,000 clinton-petraeus email missing record sent state, fbi file show"
0,2,6,39,1,6,0,45,0,racing drivers: tatiana caldern ramona karlsson
0,2,5,61,2,11,0,66,0,quiz: much know headaches? featured story additional story
0,2,10,42,1,9,0,52,0,venus williams: trailblazing court boardroom
0,1,4,58,1,9,0,62,0,"resident evacuated partial building collapse buffalo, new york"
0,2,6,47,0,7,0,53,0,christie call special prosecutor clinton foundation
0,1,8,35,1,9,0,43,0,"power guile, red sox finish sweep yankee"
0,3,2,45,1,8,0,47,0,thai police call raid scandal-hit buddhist temple
0,3,17,48,2,14,0,65,0,"steven mnuchin worked goldman sachs, know gop bio"
0,2,2,64,3,10,0,66,0,photography project capture 'first hello' parent newborn yahoo
0,2,12,39,1,9,0,51,0,battle isi mosul: iraqi force advance airport
0,2,5,47,5,12,0,52,0,said done: guilty one thing: protecting leeds united
0,1,3,66,2,11,0,69,0,wave arrest turkey suspicion involvement 'ergenekon' organization
0,2,12,48,4,13,0,60,0,"easy way deep clean keyboard, mouse monitor (no excuses!)"
0,2,9,43,3,8,1,52,0,"u.k. parliament attacker leaf 3 dead, including police officer"
0,1,9,32,2,9,6,41,0,"wwe raw result cincinnati, oh september 22, 2008"
0,3,5,70,0,13,0,75,0,nicola sturgeon say tony blair right say brexit strengthens case independence
0,1,2,30,0,4,0,32,0,tennessee governor sign budget bill
0,3,3,47,2,6,0,50,0,zuckerberg: facebook manifesto re-boot globalisation
0,1,2,27,1,4,0,29,0,dell drop itanium-based server
0,2,4,53,3,11,0,57,0,homer marge 'the simpsons' love conquers
0,2,6,33,0,8,0,39,0,gop senate move forward obamacare repeal
0,2,11,58,2,14,2,69,0,"ted cruz target marco rubio florida rally, 10 new campaign office breitbart"
0,2,9,41,2,11,0,50,0,rubio say u cant defeat isi syria's assad removed
0,2,7,35,2,8,0,42,0,poll: fatherhood man important life role
0,2,15,49,5,13,2,64,0,"chuck berry covers: 15 essential cut rolling stones, ac/dc, nina simone"
0,1,6,42,0,7,0,48,0,computer science program make comeback enrollment
0,3,12,53,2,14,0,65,0,alec baldwin say 'in discussion venues' play donald trump
0,2,12,46,4,14,0,58,0,"tom brady nfl mvp? nope. context make clear, matt ryan."
0,2,1,37,2,8,0,38,0,healthy fad lunch could making youfat
0,2,8,49,0,9,0,57,0,army eas uniform regulation allow religious exemption
0,3,1,40,2,9,0,41,0,sound cricket 'could become thing past'
0,3,1,56,0,10,0,57,0,kangaroo stuns couple smashing window jumping bed
0,2,14,43,4,13,0,57,0,"alec baldwin's trump may show 'other venues' outside snl, say"
0,1,2,33,0,5,1,35,0,sony recall playstation 2 power adaptor
0,1,9,33,3,9,2,42,0,w.h.o. raise alert level flu spread 74 country
0,1,6,29,1,7,1,35,0,$8 million award first solo tobacco trial
0,1,9,60,3,13,4,69,0,"former f.a. chairman alleges fifa 2018 world cup vote riddled bribes, corruption"
0,3,13,51,1,11,0,64,0,video: suspect home invasion terrorize woman hiding bathroom insider
0,2,9,44,3,8,0,53,0,olympics photographer captured usain bolt cheeky grin
0,2,16,50,4,14,0,66,0,"judge jeanine challenge gop: 'put big boy pant on,' get behind trump insider"
0,3,6,39,1,8,2,45,0,29 dead mexican firework market explosion: official
0,3,8,38,5,9,0,46,0,"black power!, art political punch populist reach"
0,1,4,26,1,7,1,30,0,tour de france: tom boonen win stage 6
0,3,1,53,3,9,0,54,0,'the system work goodwill': cut affecting magistrate
0,2,17,67,1,16,0,84,0,"kuldeep yadav make replacing virat kohli, seizes opportunity spin aussie"
0,1,3,59,1,9,0,62,0,convicted sex offender u targeted on-line identity registration
0,3,4,68,3,15,0,72,0,"obamacare case burping kid, gorsuch's legal writing show intellect, wit"
0,3,11,53,3,11,0,64,0,huckabee blast obama admin: 'have common decency' toward israel insider
0,3,1,29,1,5,0,30,0,kenya's vinyl king keep spinning
0,3,18,58,1,17,0,76,0,"good news book lovers, croatia first country world become free reading zone"
0,1,3,31,1,4,0,34,0,"severe sandstorm strike beijing, china"
0,3,9,28,1,9,4,37,0,best buy cities: invest housing 2017
0,3,8,38,0,9,0,46,0,brad pitt star netflix film afghanistan war
0,3,2,51,0,10,0,53,0,turkish police court first istanbul trial coup plot
0,2,3,61,0,11,0,64,0,man masterfully transforms face makeup look like caitlyn jenner
0,3,3,57,2,11,0,60,0,first lady's jackie-esque style work hard set gracious tone trump
0,2,3,42,1,7,0,45,0,argentina ex-leader cristina fernandez go trial
0,2,1,22,2,4,0,23,0,orgasm left paralyzed
0,1,5,24,1,6,0,29,0,"gaza, wait rebuild lingers"
0,1,3,39,1,7,0,42,0,lula's future hand brazilian parliament
0,1,2,30,2,5,5,32,0,"14,500 job cut announced hewlett-packard"
0,2,5,53,3,11,0,58,0,quote art deal perfectly explains trump presidency
0,2,1,48,0,10,0,49,0,fatty food addiction might fault afterall
0,2,2,30,1,6,0,32,0,army warns new threat: energy drink
0,3,5,40,0,7,0,45,0,gop introduces plan massively cut social security
0,2,5,43,2,6,0,48,0,#cuteanimaltweetoff: zoo compete claim cutest animal
0,1,9,24,5,8,0,33,0,g.o.p. debate: broader party purer one?
0,1,1,28,0,5,0,29,0,iran nuclear talk enter third day
0,3,9,40,0,10,0,49,0,uk court delay terror trial muslim fast ramadan
0,2,4,80,3,12,0,84,0,faded ferris wheel rusting roller-coasters: inside japan's eerie abandoned amusement park
0,2,2,44,0,8,2,46,0,death toll rise 36 california warehouse inferno
0,3,6,49,4,9,0,55,0,lebron james quite okay kyrie irving flat-earth comment
0,2,6,36,2,7,0,42,0,prediction westworld season finale
0,3,11,35,1,8,0,46,0,hong kong property price near peak: jpmorgan
0,3,12,43,4,12,4,55,0,"adele, beyonc, maren morris sale surge much 6,700% grammys"
0,1,5,49,0,9,2,54,0,two child die contracting h1n1 virus northern ireland
0,1,5,37,0,6,0,42,0,japanese prime minister yukio hatoyama resign
0,1,4,63,4,12,0,67,0,u.s. u.k. government warn citizen travelling area hit tsunami
0,1,3,53,2,8,0,56,0,"phone threat close tunnels, snarl traffic baltimore, maryland"
0,1,5,47,1,11,0,52,0,un worker killed afghan burning qur'an florida
0,2,6,36,3,5,0,42,0,middle eastern christian facing tragedy: church
0,3,13,44,2,10,0,57,0,"illustration ""moana"" would look like irl breathtaking"
0,1,3,51,0,6,0,54,0,singapore exam board set mathematically impossible question
0,1,11,35,4,9,0,46,0,"g.o.p. praise part stimulus plan, opposed"
0,2,2,44,0,8,0,46,0,australian artist call ban fake aboriginal art
0,3,1,59,0,10,0,60,0,chinese student beat female classmate challenging class
0,2,4,56,2,10,0,60,0,donald trump fire back goofy elizabeth warren raging tweetstorm
0,2,4,45,0,7,0,49,0,kylie minogue kylie jenner trademark battle resolved
0,3,2,51,0,8,0,53,0,republican rely misleading obamacare factoid
0,1,1,52,2,8,2,53,0,11-year-old california girl charged throwing stone defense
0,2,7,26,0,6,0,33,0,prodigy america raised
0,2,14,52,1,12,0,66,0,fbi director comey wrong: case prosecuting hillary clinton strong
0,1,6,32,1,5,0,38,0,trans-atlantic hat trick michael bradley
0,3,1,29,1,5,5,30,0,"starbucks pledge hire 10,000 refugee"
0,2,4,69,2,15,0,73,0,"jimmy garoppolo's instagram account posted goodbye boston, many feel hoax"
0,2,1,60,2,10,0,61,0,california added four discriminatory state travel ban
0,2,11,31,1,10,0,42,0,time take luxurious look mexico city
0,2,2,17,0,1,0,19,0,bloomberg technology
0,3,7,52,3,14,0,59,0,report: russia could send edward snowden back u 'gift' trump
0,2,3,79,4,16,1,82,0,apple give back gigabytes: io 9 'app thinning' feature finally give phone's storage boost
0,3,5,36,1,6,0,41,0,seoul rally south korea's president park
0,2,2,49,2,10,3,51,0,"tim tebow boost average .246 three hits, including triple"
0,3,14,62,4,15,0,76,0,lamar odom admits cheating khlo kardashian: 'b*tches thots came woodwork'
0,2,3,45,1,8,0,48,0,ernie el isnt going away quietly mastersdisaster
0,1,6,24,2,5,0,30,0,last wwii comanche 'code talker' dy
0,1,3,27,0,7,2,30,0,british chef keith floyd dy age 65
0,3,12,50,0,11,0,62,0,south korea military say north korea fired missile water coast
0,3,2,60,0,14,0,62,0,free market failed australia priced u gas supply
0,1,4,25,2,6,0,29,0,grand national 'comply die'
0,3,11,38,0,10,0,49,0,fcc regulator vote ease limit tv station ownership
0,1,6,34,0,6,0,40,0,ayatollah tap distrust rooted history
0,3,3,54,1,10,2,57,0,"cia publishes history, nearly 13 million page document online"
0,3,2,59,1,12,0,61,0,white house leaked memo: national guard swoop migrant policy
0,3,1,43,0,5,0,44,0,trump business terminates three overseas project
0,1,6,48,0,9,0,54,0,burger king ceo insult british woman speech student
0,2,13,65,4,13,0,78,0,uber release diversity report repudiates hard-charging attitude new york time
0,1,2,73,1,14,0,75,0,coroner make first post mortems athens airliner crash victims; text message hoax
0,3,2,60,1,9,0,62,0,video purportedly show colorado officer throwing woman face-first
0,1,5,43,2,7,0,48,0,american bandleader kevin eubanks leave 'tonight show'
0,1,2,47,1,7,0,49,0,russian reverse engineer skype; uploads source public
0,1,3,22,0,4,0,25,0,ala observes banned book week
0,1,5,72,0,14,4,77,0,fiji make progress gender role according 2012 report gender equality development
0,1,8,33,0,9,0,41,0,china said seeking bigger stake rio tinto
0,1,4,39,0,8,2,43,0,traffic restricted romanian national road 66
0,1,1,41,0,7,0,42,0,new drug may treat virtually viral infection
0,1,6,31,1,6,0,37,0,"recession, strategy shift big chain"
0,1,3,39,0,5,0,42,0,australian prime minister announces new cabinet
0,1,6,59,2,11,0,65,0,german internet watchdog remove url 'virgin killer' search engine
0,3,8,66,6,17,0,74,0,"total disaster marine le pen win french election, say france u.s. envoy"
0,1,3,51,0,8,0,54,0,australian tv network sprung fabricating live cross rival
0,2,3,54,0,10,0,57,0,trouble envoy warns damage row prosecuting uk troop
0,3,4,55,0,10,0,59,0,ivanka trump reassuring presence unpredictable white house
0,1,6,50,2,11,2,56,0,"avenged sevenfold drummer james ""the rev"" sullivan found dead age 28"
0,1,5,35,0,6,0,40,0,revenue profit plunge sun microsystems
0,3,12,60,5,14,0,72,0,limbaugh: isnt unreasonable donald trump suspect he tapped
0,2,5,36,2,7,0,41,0,"disabled, shunned silenced trump america"
0,1,4,52,0,10,0,56,0,libyan court upholds death sentence foreign medic hiv case
0,2,6,66,1,11,0,72,0,breitbart leaked tape speaker paul ryan criticising then-candidate donald trump
0,1,2,50,0,6,0,52,0,domestic economic impact likely japanese earthquake
0,3,2,48,1,8,0,50,0,ex-spy go back undercover amid trump dossier controversy
0,2,10,35,2,9,0,45,0,'unnecessary' swearing cool never
0,3,10,41,3,9,3,51,0,u.s.-led coalition count 229 civilian death mosul strike
0,3,2,36,1,6,3,38,0,fully repealing obamacare cost $350 billion
0,3,1,32,0,7,0,33,0,strong press keep elite check
0,2,7,42,0,8,0,49,0,paul manafort testify house intelligence panel
0,2,15,51,2,12,0,66,0,quad city's adam vay knock cincinnati's michael houser echl goalie fight
0,1,5,29,0,7,1,34,0,egypt arrest 7 bombing cairo bazaar
0,2,3,48,1,7,0,51,0,north korea: pentagon address confusion strike group
0,1,6,32,0,6,0,38,0,overhaul florida voting rule proposed
0,2,9,42,2,11,4,51,0,"weeknd top billboard artist 100, george michael debut no. 8"
0,2,2,46,2,8,0,48,0,georgia's dedicated liberal woman turn red state blue?
0,2,7,53,4,16,4,60,0,"left army 2013. three year later, fed say, plotting help isis."
0,3,10,40,1,9,0,50,0,"minzy sends debut solo ep world, heatseekers album chart"
0,1,7,31,0,8,0,38,0,killing sikh leader set riot india
0,1,6,26,0,4,2,32,0,strikeforce challenger 14 mma result
0,1,2,33,0,5,0,35,0,new jersey legalize medical marijuana
0,2,2,68,7,13,0,70,0,rachel dolezal claim give 'two s***s' parents' remark ethnicity
0,3,12,41,1,11,0,53,0,"trump trade threat uniting rest world, top eu official say"
0,3,16,58,6,16,1,74,0,"premiere: dj infamous talk2me, jeezy, ludacris, yo gotti ball ""run check up"" video"
0,3,8,47,0,10,0,55,0,royal family head christmas church service without queen
0,3,9,52,2,11,0,61,0,kylie jenner officially second richest member family [video]
0,2,10,49,2,7,0,59,0,vmwarevoice: transforming security: principle least privilege
0,3,2,70,4,13,1,72,0,horrific: police say man video-recorded sexual assault girl younger 5
0,1,5,70,2,10,0,75,0,wikinews interview former matilda's player sarah walsh australian women's soccer
0,1,1,62,0,7,0,63,0,california company recall fresh spinach salmonella contamination
0,3,9,39,2,6,0,48,0,immigration authority target oregon dreamer duo
0,1,2,40,2,7,0,42,0,"four australian state ablaze, two dead, home lost"
0,1,7,28,1,7,0,35,0,"april, fed weighed purchase debt"
0,1,5,24,0,5,0,29,0,obama promise trim federal fat
0,3,3,55,1,9,0,58,0,row norway muslim group appoints spokeswoman full-face veil
0,1,12,43,3,11,0,55,0,v.c.u. point guard eric maynor final shot unfinished business
0,3,3,27,1,5,0,30,0,rex tillerson: russia pose danger
0,3,7,31,1,9,0,38,0,chuck berry honored fan club st. louis
0,1,3,46,0,7,4,49,0,university north carolina win 2005 basketball tournament
0,2,11,67,1,15,0,78,0,hospital cafeteria worker save thousand dollar buy toy kid christmas yahoo
0,3,8,19,0,8,4,27,0,world like in1997
0,2,13,54,2,10,0,67,0,"trump name pick national security adviser, attorney general, cia director"
0,3,13,53,2,12,0,66,0,'stranger things' kid already look like winner golden globe red carpet
0,1,3,65,3,13,1,68,0,window 7 get 'early release' china; software pirate beat microsoft punch
0,1,7,35,2,9,0,42,0,getting glimpse lighter side a.j. burnett
0,1,1,51,0,7,0,52,0,accidental email brings product placement agency fire
0,2,12,53,2,11,0,65,0,"community art center exhibit vandalized ""make america great again"""
0,2,4,26,0,5,0,30,0,unc top gonzaga national title
0,3,14,55,4,12,0,69,0,'the founder': origin tale mcdonald's sharp bite restaurant industry today
0,2,6,48,0,10,0,54,0,kate william join queen easter service windsor castle
0,2,2,73,0,11,0,75,0,california teacher mocked student skipping school immigrant boycott day
0,3,3,60,0,11,0,63,0,female isi suicide bomber us child decoy attack libyan force
0,1,2,50,0,10,2,52,0,fire explosion kill least 30 iranian chemical factory
0,2,12,47,3,12,0,59,0,c.i.a. evidence russian effort help trump earlier believed
0,3,11,34,1,10,0,45,0,"correction might bad, investor say"
0,3,6,57,5,15,0,63,0,syrian refugee camp: would tell president trump come see u [video]
0,2,14,53,3,11,0,67,0,"trump think russia hacked dnc, slam 'sick people' salacious kremlin story"
0,2,8,58,5,15,0,66,0,baml: revising fed rate-hike call loss momentum u data
0,3,7,78,0,13,0,85,0,james packer caught middle corruption inquiry israeli prime minister benjamin netanyahu
0,1,10,51,1,9,0,61,0,hard-charging doctor emanuel add perspective obama health care team
0,1,6,43,2,7,0,49,0,"saudi arabia block access blogger, flickr, livejournal"
0,3,8,51,1,9,0,59,0,hollywood writer union vote authorize strike producer
0,3,6,27,2,6,0,33,0,tale u announce debut album 'endless'
0,3,9,45,2,9,0,54,0,u.n. see record spike civilian child killed afghanistan
0,1,2,24,0,4,0,26,0,hundred dead hajj stampede
0,2,15,48,2,13,0,63,0,rocket gm daryl morey creating musical called 'small ball' fake mj
0,1,5,32,0,7,0,37,0,kirin suntory consider merger japan
0,3,11,43,1,10,0,54,0,alec baldwin jump kendall jenner's defense pepsi ad fiasco
0,2,3,15,0,2,0,18,0,wimbledon fast fact
0,1,1,32,1,6,0,33,0,human remains cause mad cow disease?
0,2,12,34,1,9,0,46,0,nypd seek cure gun violence data-driven case
0,2,8,38,1,7,0,46,0,"demi lovato rock bikini bod, share inspiring message"
0,3,2,54,1,10,0,56,0,simone bile busy shining worry body-shaming troll
0,3,6,34,0,7,0,40,0,un ambassador haley hit russia hard ukraine
0,2,3,55,2,14,3,58,0,elite u college student top 1% bottom 50%
0,2,2,39,1,6,0,41,0,protesting trump administration?
0,3,13,68,2,12,0,81,0,"newly created independent spring football league invite johnny manziel, ray rice, among others"
0,1,2,45,1,6,0,47,0,pakistan's intelligence agency said support taliban
0,2,9,54,2,12,0,63,0,divide us: shia labeouf launch four year anti-trump art project
0,2,8,40,0,9,0,48,0,tennis star petra kvitova badly injured home invasion
0,3,10,38,1,9,0,48,0,tiesto debut pop-up shop series miami music week
0,2,1,26,0,5,0,27,0,baby pygmy hippo debut splash
0,1,2,38,0,6,0,40,0,taliban commander blow pakistan
0,2,2,51,1,7,0,53,0,serena williams surprise fan late-night tennissession
0,3,16,61,2,15,0,77,0,"india's revered yamuna river also polluted country, bubble toxic foam"
0,1,7,34,0,6,0,41,0,presidential fiscal pivot come early time
0,1,1,47,0,9,2,48,0,mozilla set record software downloads 24 hour
0,1,4,50,1,9,0,54,0,"typhoon megi kill seven taiwan, head towards southern china"
0,1,2,30,1,4,0,32,0,india's congress party win election
0,2,6,39,0,6,0,45,0,supreme court reject challenge lethal injection
0,1,7,42,0,10,2,49,0,cyclist jason english liz smith win 24 solo australia
0,1,3,54,0,10,0,57,0,european union offer train somali troop fighting break
0,3,14,46,5,13,0,60,0,watch: 'fox friends' celebrates vets' heroism medal honor day insider
0,2,10,38,4,8,0,48,0,samantha bee 'fixed' bill o'reilly's fox news exit statement
0,2,1,66,0,12,0,67,0,colorado school district decides allow teacher arm campus
0,3,6,53,1,11,0,59,0,roxane gay pull book simon schuster milo yiannopoulos deal
0,3,4,17,1,4,1,21,0,toshiba lost $6 billion
0,3,13,64,4,14,0,77,0,smith reveals real reason turned 'independence day' sequel 'suicide squad'
0,1,4,67,0,10,0,71,0,international expert probe deadly ebola reston virus outbreak philippine pig
0,1,2,29,0,4,0,31,0,stardust land utah successfully
0,3,4,59,1,10,0,63,0,former clinton aide rewriting silicon valley political playbook
0,1,6,29,0,6,0,35,0,foreign money seek buy lebanese vote
0,3,10,46,3,10,0,56,0,woman braid hair together show solidarity u.s.-mexico border
0,1,6,35,0,6,0,41,0,immigration agency criticized health care
0,1,5,32,0,5,0,37,0,slump dash oregon dream californian
0,2,2,43,0,8,0,45,0,poker table keep decreasing nevada casino floor
0,1,9,26,0,6,0,35,0,kbc get aid belgian government
0,1,3,16,0,3,0,19,0,paradox privacy
0,1,2,29,0,7,0,31,0,world bank warns high bird flu cost
0,3,6,30,1,8,0,36,0,alabama gop call gov. bentley resign
0,2,1,42,1,7,0,43,0,headless body found hoarder home beneathtrash
0,1,14,70,1,15,0,84,0,mpaa's valenti sign betamax tape eff protester grokster case continues u supreme court
0,3,10,60,3,13,0,70,0,"barrier reef risk winding unesco 'danger' list, queensland government say"
0,2,13,71,3,17,0,84,0,sarah palin: president trump call unshackling political band tying u un
0,3,1,38,2,8,2,39,0,"colo, oldest gorilla captivity, dy aged 60"
0,1,6,33,0,6,0,39,0,arthur nadel indicted investment fraud
0,2,12,67,1,16,0,79,0,"acc move league championship north carolina, following lead nba ncaa"
0,3,10,27,1,7,0,37,0,russell westbrook make mvp case?
0,1,9,43,1,15,3,52,0,"moving day 2 first families, bit magic 93 pair hand"
0,2,9,43,0,8,0,52,0,ohio plan return controversial executionsedative
0,3,1,76,0,12,0,77,0,uncertainty loom patient community clinic ahead proposed health care change
0,3,10,43,1,9,0,53,0,mercyme rule top christian album hot christian song chart
0,2,5,9,1,3,0,14,0,"rest peace, vcr"
0,3,1,34,0,10,2,35,0,soda sale fell 12th year row
0,3,7,43,0,8,0,50,0,mar investigating skittle said intended cattle
0,1,5,31,0,6,4,36,0,fernando alonso win 2008 singapore grand prix
0,2,8,40,1,7,0,48,0,cruz question trump temperament commander chief
0,2,8,45,1,9,2,53,0,grateful dead reissues: archivist share detail next 22 year
0,3,7,31,0,11,0,38,0,harsh reality hitting housing market
0,3,9,45,4,8,0,54,0,analysis: senate's 'nuclear option' may lasting consequence
0,1,2,63,0,12,2,65,0,somali pirate agree release egyptian ship fertiliser cargo 28 crew
0,1,11,26,1,7,0,37,0,"abc, fox cbs present season lineup"
0,3,2,35,2,7,4,37,0,mariah carey's lip synching 2016's last victim
0,1,3,41,2,6,0,44,0,third party u.s. presidential candidate hold debate
0,3,7,30,1,7,0,37,0,"move tequila, mezcal take center stage"
0,3,15,59,1,12,0,74,0,bbc interview gatecrashed adorable kid becomes biggest blooper year already!
0,2,17,59,3,17,0,76,0,record number global billionaires. real question more?
0,3,13,47,3,11,0,60,0,clip-on tie hold new clue hijacker d.b. cooper amateur sleuth
0,3,12,65,4,13,0,77,0,chris evans voice support scarlett johansson 'black widow' standalone flick [video]
0,1,2,54,0,6,0,56,0,president afghanistan uninjured assassination attempt
0,2,13,49,1,10,0,62,0,david gilkey: npr buddy share story favorite picture
0,3,5,56,2,13,4,61,0,nasty women's choir: hilarious christmas caroler need end 2016
0,1,9,36,1,8,0,45,0,"smith, mine bird experience aboard"
0,2,11,40,3,13,1,51,0,guy founded snapchat snap worth $4 billion
0,3,2,48,2,8,0,50,0,"aleppo: new deal reached secure evacuation, official say"
0,2,3,71,3,15,0,74,0,murder put facebook. family message forgiveness could legacy.
0,1,7,36,0,6,0,43,0,speculation clinton travel first
0,1,3,29,1,5,0,32,0,senior al-qaeda leader iraq killed
0,3,12,38,3,10,0,50,0,"trump son-in-law poised quit family firm ceo, lawyer say"
0,2,2,24,0,5,1,26,0,6 new frapp flavor starbucks
0,1,1,28,0,4,2,29,0,g20 protester dy collapsing
0,3,7,47,2,8,2,54,0,poll: 55 percent concerned russia's interference election
0,3,8,79,3,16,0,87,0,"white house warns north korea test u.s. resolve, offering syria afghanistan strike example"
0,1,4,34,1,5,1,38,0,vivaldi atlantic 4 break canada-europe record
0,1,2,48,0,9,0,50,0,number suspect finnish dogfighting case rise ten
0,3,14,48,0,14,1,62,0,nc restaurant seeing business banned kid 5 insider
0,3,2,46,3,7,0,48,0,'bathroom bill' compromise anger democratic gov's ally
0,3,4,59,1,14,0,63,0,bank urged make sharp break past improve culture: aba report
0,1,2,51,4,8,0,53,0,"argentina score extra-time; beat mexico, get quarter-finals"
0,3,13,43,3,11,0,56,0,top trump aide: u.s. working china counter north korean threat
0,2,17,46,0,16,0,63,0,old lady scooter lost highway trooper helped herhome
0,1,6,37,0,7,1,43,0,governor proposes closing 8 court new hampshire
0,2,8,27,1,8,0,35,0,sit-in house floor gun control
0,3,7,36,1,7,0,43,0,"female captain command respect, many ship"
0,2,6,27,1,7,0,33,0,trump legal option travel ban case
0,1,4,42,0,8,4,46,0,andy blair win capital punishment 2013 mountain bike race
0,1,4,28,2,6,0,32,0,aung san suu kyi release order 'signed'
0,2,4,50,1,14,3,54,0,"100 day russia drama trump white house, end sight"
0,1,9,32,0,9,0,41,0,many gull die oil spill river ohio
0,1,2,53,0,8,0,55,0,chinese restaurant closed toronto rat photo published
0,1,2,42,0,7,0,44,0,coalition ups ante australian school tax rebate
0,1,3,37,0,7,0,40,0,desmond tutu call election african pope
0,1,8,51,0,8,0,59,0,canadian minister national defence withdraws nato candidacy
0,1,7,37,0,9,0,44,0,toxic dose selenium cited death polo horse
0,3,8,44,0,8,0,52,0,childhood hunting buddy turn financier duterte drug war
0,1,6,49,0,6,0,55,0,pakistani military launch airstrikes taliban stronghold
0,3,1,52,2,10,0,53,0,french worker get 'right disconnect' email hour
0,1,6,34,0,7,0,40,0,mugabe zimbabwe premier wage battle wit
0,1,8,33,1,7,0,41,0,"rout, gonzaga win west coast conference title"
0,3,7,52,6,13,0,59,0,"yep, u.s. gave 'make somalia great again' hat country's president"
0,3,10,50,3,11,0,60,0,icahns trump relationship spark civil war u.s. ethanol industry
0,3,12,43,1,10,0,55,0,chicago cop loses police power off-duty killing unarmed man
0,1,4,27,0,5,0,31,0,intel responds amd antitrust suit
0,3,14,57,0,14,0,71,0,trump kick mlk day weekend trashing civil right leader john lewis twitter
0,1,3,39,0,6,0,42,0,bomb dagestan explodes russian military truck
0,3,14,47,4,11,6,61,0,"house repeal bill bid goodbye obamacare tax $250,000-a-year earner"
0,1,5,23,0,5,0,28,0,big east veteran look lament
0,1,4,30,0,5,0,34,0,nokia take symbian o development
0,1,3,30,0,5,0,33,0,declares global swine flu pandemic
0,3,6,39,1,5,0,45,0,president obama commute chelsea mannings sentence
0,3,3,49,1,8,0,52,0,egypt's mukhabarat hire washington lobbyist boost image
0,2,1,44,0,7,0,45,0,mathematician predicts next decade beawful
0,2,2,61,0,9,3,63,0,columbia university accidentally sent acceptance letter 277 applicant
0,1,5,32,0,5,0,37,0,jonathan ross announces departure bbc
0,3,5,67,0,12,0,72,0,u scientist fear america donald trump become like totalitarian regime
0,3,2,48,1,8,0,50,0,carrie fisher's brother say actress stable condition
0,1,4,27,0,5,0,31,0,chelsea beat arsenal carling cup
0,1,12,45,2,10,0,57,0,title ix ruling involving u.c. davis could lead stricter standard
0,2,11,48,0,9,0,59,0,simple spongebob revelation explains patrick soclueless
0,2,4,60,1,10,0,64,0,revived gop health care talk could hurt pre-existing condition
0,1,4,34,1,5,0,38,0,ira decommissioning complete de chastelain
0,2,8,34,1,7,0,42,0,troian bellisario patrick j. adam gotmarried
0,1,7,29,2,7,0,36,0,libya fault u.s. halt weapon program
0,2,4,67,3,10,0,71,0,celebrity interview edith bowman: 'japan wonderful sensual explosion'
0,3,10,42,3,7,0,52,0,nigeria's succession jitter ill president: quicktake q&a
0,1,8,35,0,10,0,43,0,delphi said new deal leave bankruptcy
0,3,2,49,2,11,0,51,0,dutch election: voter go poll netherlands live
0,2,16,52,0,15,0,68,0,people applauding dog trying clean pee toiletpaper
0,2,10,43,0,9,0,53,0,browning america upending political party
0,3,10,47,1,10,4,57,0,mitch trubisky declares 2017 nfl draft: latest comment reaction
0,3,2,60,3,11,0,62,0,therapist also need therapists: 'suffering unique one group'
0,2,1,30,0,8,0,31,0,cash old tech gadget
0,3,10,61,2,10,2,71,0,calibre 50 renews contract universal music latin entertainment's disa: exclusive
0,3,4,27,1,3,0,31,0,forest whitakers character study
0,3,3,46,0,6,0,49,0,medicinal marijuana sale approved federal government
0,3,8,62,0,13,0,70,0,noted feminist vladimir putin donald trump show support woman iwd
0,1,8,42,0,8,0,50,0,african migrant arrive italy standoff malta
0,2,13,57,2,15,0,70,0,new york time left alarmed donald trump reach union voter breitbart
0,2,6,49,2,10,0,55,0,mark cuban: adam silver said tony romo contract honored
0,1,9,24,0,6,0,33,0,miss california usa keep title
0,3,2,52,2,8,0,54,0,amazon become world's first trillion-dollar business
0,2,2,54,0,12,0,56,0,iran say country pay half price new boeing jumbo jet
0,3,3,67,0,11,0,70,0,chuck schumer explains confirmation vote trump nominee delayed
0,1,12,46,2,12,0,58,0,back injury force federer pull davis cup match u.s.
0,3,2,61,1,11,0,63,0,swedish student start-up sign deal deal build electric car siemens
0,1,5,28,0,5,0,33,0,judge allows asbestos case continue
0,1,1,43,0,7,0,44,0,murderer road accident victim sentenced death
0,1,6,36,0,6,0,42,0,gay festival china push official boundary
0,1,3,31,0,6,0,34,0,second video osama bin laden surface
0,3,3,79,5,16,0,82,0,"afghanistan wooed fugitive warlord, aiming lure taliban, too. warlord deal stuck."
0,3,2,68,1,11,0,70,0,donald trump's foreign policy might unconventional delivering result
0,1,6,25,0,6,0,31,0,early voting iraq mostly smooth
0,1,2,48,0,7,0,50,0,suspect atlanta courthouse shooting appears hearing
0,1,7,34,3,9,0,41,0,"sinopec, chinese oil giant, bid addax, rival"
0,1,5,62,0,9,0,67,0,russian government homosexuality position lead nyc russian vodka boycott
0,3,12,56,1,12,3,68,0,fake note worth r 9.63 crore deposited bank since demonetisation announced
0,3,4,73,4,14,0,77,0,ex-trump official issue cheeky apology remark obamas: 'i certainly racist'
0,3,2,55,2,8,0,57,0,"masked suspect shoot man ""execution style"" baltimore barbershop"
0,2,6,53,0,12,4,59,0,democrat use gop health care bill republican 2018
0,3,8,71,1,15,0,79,0,tony blair denies pitching donald trump's middle east envoy secret white house meeting
0,3,2,64,0,14,1,66,0,5 chart show tory exaggerating threat voter fraud list
0,2,14,68,4,12,0,82,0,"immigrant middle-east america's top entrepreneurs, still trump want anymore"
0,1,5,38,0,9,0,43,0,robert gate hope continue u troop cut iraq
0,3,7,43,0,9,0,50,0,american air negotiation buy stake china southern
0,1,5,86,3,12,0,91,0,"two-time eurovision entrant edsilia rombley discusses music, love, contrasting contest experience"
0,2,2,52,1,10,5,54,0,"fourteen garden village built england totalling 48,000 home"
0,2,7,31,2,8,4,38,0,"1,000 year slumber, china vow invent"
0,2,13,62,3,12,0,75,0,interior secretary sally jewell future scientist trump: 'make voice heard'
0,2,2,54,0,9,0,56,0,russell westbrook apologizes official throwing ball
0,1,3,57,0,9,0,60,0,american actor morgan freeman serious condition car accident
0,2,12,42,0,9,0,54,0,harvard law school dropping lsat could lead sweeping change
0,2,2,39,0,7,0,41,0,shoal goldfish starving rival munich
0,3,3,60,5,11,0,63,0,"original champion 'rocket league' didnt survive, theyre moving"
0,1,1,52,2,9,2,53,0,65-year-old woman arrested death two mexican wrestler
0,3,3,41,0,9,0,44,0,lloyd shrink hundred uk branch two staff
0,2,12,58,1,12,5,70,0,"demonetisation force 20,000 people defer wedding plan andhra telangana"
0,3,4,68,1,14,0,72,0,"susan rice, obama colleague take heat past claim syria chemical weapon purge"
0,3,16,56,4,15,0,72,0,here first look kims reaction robbery keeping kardashians
0,3,8,46,0,8,0,54,0,wyclef jean hancuffed mistaken robbery suspect
0,3,3,49,1,8,0,52,0,skorean supporter arrested ex-president protest seoul
0,2,10,57,3,9,0,67,0,local official grapple trump's fearmongering 'sanctuary city' policy
0,1,7,35,1,9,5,42,0,2007 german league cup: bayern munich win 6th league cup
0,2,3,14,0,5,6,17,0,50 best podcasts 2016
0,2,1,46,1,8,0,47,0,good news: automation already destroyed job
0,3,10,39,0,9,0,49,0,fcc chief roil capital net neutrality rollback
0,2,8,44,0,8,0,52,0,doctor find possible tie zika another deformity
0,1,7,36,0,9,0,43,0,google using wikipedia source news site
0,3,2,62,0,12,0,64,0,new era consumer protection republican take helm watchdog agency
0,2,4,60,0,13,0,64,0,beijing city official told lunar new year firework crack smog
0,2,5,50,2,12,4,55,0,"best country world? switzerland, canada uk top 2017 list"
0,3,8,46,3,11,0,54,0,"california, forefront climate fight, wont back trump"
0,1,8,19,0,4,0,27,0,myspace display amber alert
0,2,19,48,2,17,2,67,0,10-year-old grew hair two year make wig friend withalopecia
0,3,3,51,1,7,0,54,0,haiti: jovenel moise confirmed winner presidential election
0,3,6,64,3,12,0,70,0,"park geun-hye: impeachment legal basis, lawyer south korean president say"
0,3,13,37,4,8,0,50,0,"kendrick lamar tease music, lebron james praise 'damn.'"
0,2,9,52,2,9,0,61,0,dallas cowboy cowboy 'hire' wrestling icon sting intimidation coach
0,3,2,53,2,10,0,55,0,"maryland teen plotting mass school shooting, police say yahoo"
0,3,3,49,3,10,3,52,0,glencore qatar buy $11.3bn stake russia's largest oil company
0,2,15,53,2,12,0,68,0,"nbc news video see brazil soccer team, pilot final interview fatal flight"
0,2,2,49,2,9,0,51,0,berlin truck attack: tunisian linked market death report
0,3,2,59,4,13,0,61,0,'the spirit like did' malaysian voice anger naked prank
0,3,4,45,0,7,3,49,0,u billionaire philanthropist david rockefeller dy 101
0,3,11,45,5,11,0,56,0,twin peaks: new viral campaign may provide clue new season [video]
0,2,2,70,3,13,0,72,0,"ambush killing iowa officer cowardly act calculated murder, police chief say"
0,2,1,30,1,4,0,31,0,apple reveals self-driving car plan
0,1,8,37,1,9,0,45,0,"venezuela, trying map blueprint lost city"
0,2,2,59,2,9,0,61,0,senate invokes historic 'nuclear option' rule change confirm gorsuch
0,1,1,30,0,3,0,31,0,tonga renews emergency regulation
0,2,6,58,3,10,0,64,0,"u.s. state department tweets, deletes congratulation iran oscar win"
0,1,4,45,1,8,0,49,0,senator ted stevens loses re-election bid alaska ballot
0,3,3,79,3,13,0,82,0,syrian regime denies bashar al-assad suffered stroke year 'psychological pressure'
0,2,1,54,1,10,3,55,0,british couple become world's oldest newlywed combined age 194
0,1,7,55,1,10,0,62,0,bush appoints john bolton united states' ambassador united nation
0,1,3,46,0,6,0,49,0,yukio hatoyama formally elected japanese prime minister
0,2,1,75,5,14,0,76,0,"penny say voter right know medical records, hit back deplorables remark"
0,1,2,30,0,5,0,32,0,plane crash california kill three
0,3,11,60,1,16,2,71,0,audi that? kung fu master us testicle pull seven car weighing 12 tonne
0,3,5,56,1,12,0,61,0,nobody speak review hulk hogan v gawker doc enjoyable revelatory
0,2,2,62,3,9,0,64,0,venezuelan womens response country economic crisis: get sterilized
0,1,4,28,0,8,2,32,0,former first lady taiwan dy age 88
0,2,6,52,1,11,0,58,0,met adjusts new year's eve policing plan nice berlin attack
0,2,4,43,2,8,0,47,0,one american town. many different way american.
0,1,2,21,0,3,0,23,0,canadian may elect senate
0,1,4,51,0,9,0,55,0,san diego state university pitcher taken first baseball draft
0,1,7,27,0,8,3,34,0,sudan say 244 died clash week
0,1,2,30,0,4,0,32,0,zimbabwe election victory mugabe
0,1,5,33,0,6,4,38,0,rubens barrichello win 2009 european grand prix
0,1,7,51,0,7,0,58,0,payment plan northern ireland reconciliation provokes outrage
0,2,2,72,0,13,0,74,0,united airline pilot removed going bizarre political rant intercom
0,2,2,31,2,5,0,33,0,ivanka trump clothing brand sale 'boom'
0,2,5,49,2,9,0,54,0,trump fbi comment russian aimed cooperation: aide
0,2,6,32,3,5,0,38,0,world's creative city [infographic]
0,3,2,43,1,7,0,45,0,"mom film arrest, handcuffing autistic florida boy"
0,2,12,44,3,12,0,56,0,trump address u.k. parliament? common speaker help
0,1,6,33,0,7,0,39,0,weapon found home boston murder suspect
0,3,7,60,2,10,0,67,0,"milo yiannopoulos, controversial breitbart editor, disinvited speak cpac"
0,2,2,83,1,16,0,85,0,french forest high school may relocate make way high-rise new northern beach town centre
0,1,2,39,0,7,0,41,0,uk shadow home secretary resigns terror law
0,1,8,39,1,6,0,47,0,"wladimir klitschko unifies ibf, wbo heavyweight title"
0,3,4,45,1,6,0,49,0,ecuador election: socialist lenin moreno declared winner
0,2,11,53,3,13,0,64,0,"win grammy best latin rock, urban alternative album? vote!"
0,1,4,47,1,7,0,51,0,"caloundra win sunshine coast, australia cricket grand final"
0,3,4,51,1,13,2,55,0,snap enough demand push ipo valuation high $25 billion
0,2,4,51,0,13,2,55,0,dutch woman resident uk 30 year may leave brexit
0,3,9,52,0,10,0,61,0,deutsche bank investment banking chief jeffrey urwin talk depart
0,3,2,77,2,11,0,79,0,donald trump 'lied journalist softening immigration stance manipulate coverage'
0,1,5,27,0,4,0,32,0,white house pushing stimulus package
0,2,9,47,2,9,0,56,0,"company plow ahead move mexico, despite trump pressure"
0,2,2,68,1,11,0,70,0,new delhi hit chilliest temperature season people stop complaining
0,2,5,48,3,11,0,53,0,donald trump say u relation russia 'may all-time low'
0,3,2,27,2,5,0,29,0,oscar predictions: win big?
0,2,16,59,1,15,0,75,0,couple worried delay wedding due trump immigrationban
0,1,6,25,0,5,0,31,0,vw cancel meeting porsche merger
0,3,10,40,1,9,0,50,0,jain find second act ex-deutsche bank chief join cantor
0,2,3,40,1,7,0,43,0,myer raid could trigger david jones merger: analyst
0,1,2,32,1,6,0,34,0,muqtada al-sadr call end fighting
0,2,6,20,0,6,1,26,0,5 andra day song know
0,1,7,31,0,7,0,38,0,google end project selling radio ad
0,3,4,52,0,9,0,56,0,friend cayla doll banned germany surveillance concern
0,1,4,27,2,5,0,31,0,u.s. senate majority go democrat
0,2,1,26,0,4,0,27,0,gold drop suddenly sharply
0,2,14,51,0,13,0,65,0,tom brady wore extra jacket sideline people havethoughts
0,1,8,30,2,9,0,38,0,u.s. relies aid ally terror case
0,3,2,51,2,10,2,53,0,"vince wilfork, 35, thinking retirement take time decide"
0,1,8,38,1,9,0,46,0,kim yu-na skate carrying hope south korea
0,2,5,30,0,5,0,35,0,republican might replace obamacare
0,3,2,80,3,14,0,82,0,"trump dodge asked whether associate contact russia, call bombshell report 'a joke'"
0,3,3,35,2,5,0,38,0,southwest airlines: overbook anymore
0,2,10,66,3,11,0,76,0,"jennifer garner visit congress, give emotional testimony child poverty [video]"
0,2,4,56,2,10,0,60,0,"rise larry ellison, jet-setting billionaire founder oracle"
0,1,6,27,1,8,0,33,0,"new bet oil, reason worry"
0,1,7,47,0,8,0,54,0,betting wimbledon match raise eyebrow initial concern
0,2,3,52,0,12,0,55,0,weed business set one fastest growing job generator u
0,3,2,71,1,11,0,73,0,"coal seam gas oversight repeatedly cut newman government, cabinet document reveal"
0,2,1,41,0,8,0,42,0,welcome rehab actually drinkwine
0,3,10,43,1,10,2,53,0,16 story expand mind international womensday
0,1,6,38,0,7,0,44,0,drop building apartment hurt housing start
0,1,8,41,0,7,0,49,0,iraq considers giving foreign oil investor better term
0,1,4,28,0,4,0,32,0,iwf revers censorship wikipedia
0,3,3,47,2,10,0,50,0,germany migrants: record number opt leave balkan
0,3,2,25,1,6,4,27,0,stephin merritt: 50 song 50 year
0,2,6,35,1,5,0,41,0,leah reminis battle scientology continues
0,3,5,34,4,9,0,39,0,run jewel trump: 'it's going horrible'
0,3,13,37,2,10,0,50,0,trump's epa pick went easy industry backed him: report
0,2,4,40,1,9,0,44,0,"xavier, gonzaga close first final four"
0,3,9,49,0,8,0,58,0,two juvenile charged connection deadly tennessee wildfire
0,2,3,51,3,10,0,54,0,"""my life made here"": undocumented student fear fate trump"
0,3,8,38,0,9,0,46,0,golden state warrior went hero heel
0,1,6,32,1,5,0,38,0,stimulus plan ensures boom sector: oversight
0,3,13,44,2,12,4,57,0,nfl combine 2017 notebook: top running back show game tape lie
0,3,18,52,2,17,0,70,0,"mariah carey making movie based iconic song ""all want christmas you"""
0,1,9,32,0,7,0,41,0,mgm averts bankruptcy citycenter la vega
0,3,13,58,2,12,0,71,0,radiohead guitarist jonny greenwood perform 'there blood' score live
0,1,7,49,0,9,0,56,0,pakistani paramilitary force try stem advance taliban
0,2,1,49,3,9,2,50,0,shakespeare first four folio sell auction almost 2.5m
0,1,2,32,0,6,0,34,0,u unemployment rate ten percent
0,3,3,71,4,15,0,74,0,churchill full flaw lived mistake brian cox latest film challenge
0,1,8,42,0,10,0,50,0,day new beginning michelle obama daughter
0,3,7,80,2,16,0,87,0,"barack obama could win libel case donald trump wiretap claims, claim george w bush's lawyer"
0,2,9,62,6,9,0,71,0,"visiting african-american museum: waiting, reading, thinking, connecting, feeling"
0,2,11,42,0,8,0,53,0,andre johnson break cry nfl retirement speech
0,1,2,36,0,5,0,38,0,rwandan genocide suspect arrested uganda
0,1,3,79,1,10,0,82,0,bush administration change official position legitimacy qur'an desecration allegation
0,2,11,46,3,10,0,57,0,look like cleveland cavalier kyrie irving friendstattoo
0,3,10,49,1,9,0,59,0,seven best quote warren buffett's annual shareholder letter
0,2,12,43,3,11,0,55,0,"sign ""see something say something"" newsletter!"
0,2,6,50,0,9,0,56,0,malaysia expels north korean ambassador kim jong nam murder
0,2,4,31,1,9,0,35,0,"hail acc, new king bowl season"
0,2,6,23,0,5,0,29,0,woman remember tosmile
0,1,5,24,1,6,0,29,0,"call jihad, answered america"
0,2,15,45,1,13,0,60,0,white house think vote house ocare repeal vote week
0,1,4,70,1,9,0,74,0,former australian police medium director stephen linnell's perjury conviction quashed
0,3,2,63,3,15,4,65,0,flynn 2016: 'given immunity' probably mean committed crime
0,3,3,51,1,8,0,54,0,indonesia blasphemy case: emotional scene ahok trial begin
0,2,5,51,2,9,0,56,0,egypt's coptic christian siege ahead pope francis's visit
0,3,12,54,2,11,0,66,0,beneath surface: digging microsoft's claim momentum mac
0,1,2,31,1,5,2,33,0,southern california hit 5.1 earthquake
0,2,4,46,2,11,0,50,0,amazon echo help solve murder? police soon find out.
0,3,2,50,0,8,0,52,0,baltimore police overhaul approved trump objection
0,2,9,39,1,8,1,48,0,"samsung rushed galaxy s8 despite design flaw, say analyst"
0,1,4,57,1,9,0,61,0,"north korea cancel military, political agreement south korea"
0,1,9,13,3,6,4,22,0,2008 mls: toronto fc d.c. united
0,3,2,46,1,7,0,48,0,once-booming gun industry recalibrating trump
0,2,1,30,0,5,0,31,0,europe cold weather death toll rise
0,1,3,48,0,9,0,51,0,u federal agent raid strip club empire washington state
0,2,11,40,1,10,0,51,0,one negotiation option realize
0,2,6,54,1,11,0,60,0,"osu attack suspect visited washington dc area day earlier, source say"
0,1,7,30,0,6,0,37,0,budget woe expose rift tobacco money
0,1,1,33,1,4,0,34,0,canada's new governor general announced
0,2,5,33,0,7,0,38,0,public vetting kaine clinton vp begin
0,1,5,41,1,5,0,46,0,u republican elect first african-american chairman
0,1,3,33,1,6,2,36,0,"suicide bomber kill 24 peshawar, pakistan"
0,3,13,46,3,11,1,59,0,kelsey plum break single-season record point d-1 women's cbb
0,3,3,51,0,9,0,54,0,italian priest nix nativity scene avoid offending muslim
0,2,11,59,4,13,2,70,0,"progressive hit trump ed sec death threats, security cost $7.8 million breitbart"
0,1,7,48,1,10,0,55,0,michelin's tyre mistake sends u formula one grand prix farce
0,1,3,44,0,6,0,47,0,aircraft make emergency landing edinburgh airport
0,1,3,50,0,8,0,53,0,burning debris satellite spotted several u city
0,3,15,75,5,20,4,90,0,one direction's harry style hit no. 1 billboard twitter trending 140 chart debut single 'sign times'
0,2,5,44,3,10,2,49,0,"jose bautista reach one-year, $18m deal return blue jay"
0,1,7,35,0,6,0,42,0,perry catch campbell atop master leader board
0,3,4,55,4,9,0,59,0,"austria election: van der bellen promise ""pro-european"" president"
0,1,5,32,1,6,0,37,0,"new england, canada brace hurricane bill"
0,2,2,54,1,13,0,56,0,cheeky little girl steal pope's skullcap give kiss
0,1,2,57,1,9,0,59,0,"tornado damage hundred missouri homes, force closure airport"
0,1,6,25,1,7,0,31,0,"open, rain top leader board"
0,2,10,54,1,8,0,64,0,first african-american crewmember join international space station
0,2,7,61,4,12,0,68,0,"fa cup photo essay road wembley, quarter-final: middlesbrough v manchester city"
0,2,4,62,0,10,0,66,0,u church defy donald trump offering sanctuary undocumented migrant
0,2,5,57,3,12,0,62,0,"barack obama hit donald trump, warning 'american values' stake"
0,1,5,31,0,5,0,36,0,bairds encounter familiar ground doral
0,1,1,36,0,6,0,37,0,scientist say moon slowly shrinking
0,3,11,57,2,11,0,68,0,kind stranger return girl's lost backpack fort lauderdale shooting yahoo
0,2,4,40,0,7,0,44,0,china say protect south china sea sovereignty
0,3,5,41,2,8,0,46,0,"chance rapper model ""thank obama"" clothing line"
0,2,6,57,1,12,0,63,0,"gavin degraw talk travel, crazy schedule nostalgia new york city"
0,3,2,57,0,11,0,59,0,president trump replace halted travel ban new executive order
0,3,9,57,2,13,7,66,0,89% muslim live country affected president trump executive order 13780
0,3,3,50,1,9,2,53,0,"truck plough crowded christmas market berlin, killing 12"
0,2,1,33,2,5,0,34,0,world's happiest countries?
0,3,16,71,1,14,0,87,0,uttar pradesh navnirman seva chief amit jani arrested putting anti-kashmiri hoarding across
0,1,3,22,1,5,3,25,0,class 9/11 graduate west point
0,2,3,20,1,1,0,23,0,vodka-cranberry reclaimed
0,1,3,41,0,6,0,44,0,wikinews interview restore fourth organizer
0,3,5,44,2,7,0,49,0,"power rankings: ultimate warriors, mysterious cavs"
0,1,5,50,3,9,2,55,0,magnitude 6.3 earthquake hit new zealand's south island; dozen dead
0,1,8,38,1,7,0,46,0,"militant pakistan torch nato, u military vehicle"
0,1,2,42,1,7,0,44,0,islamist militant blow girls' school pakistan
0,1,4,47,0,10,0,51,0,najibullah zazi pleads guilty plot bomb new york subway
0,1,5,48,0,8,0,53,0,russia ban abc following interview chechen rebel leader
0,1,4,49,2,10,3,53,0,new al-qaeda video show osama bin laden meeting 9/11 hijacker
0,2,9,64,0,9,0,73,0,controversial pinelands forest preserve pipeline approved new jersey regulator
0,1,5,30,0,6,0,35,0,tropical storm irene pass new york
0,2,6,28,0,5,0,34,0,jerrod carmichael find story
0,1,4,56,1,11,0,60,0,christian band mercyme's tour bus fatal collision car indiana
0,3,13,62,0,13,0,75,0,goldman sachs president gary cohn leading candidate top white house economic post
0,3,3,15,1,5,8,18,0,30 30 europe 2017: finance
0,2,9,40,2,9,0,49,0,indie artist can't afford skip streaming: guest post
0,2,1,80,1,13,0,81,0,trump blast foreign worker program company pay below-average wage foreign worker
0,3,2,40,0,6,0,42,0,ariana grande slam male fan objectification
0,2,7,44,0,7,0,51,0,islamic state feature trump brussels celebration video
0,2,6,25,0,5,0,31,0,zimbabwe selling wildlife
0,1,7,37,0,8,0,44,0,chinese grease wheel power luxury gift
0,2,10,42,3,10,0,52,0,two child shot outside chuck e. cheese's fort worth: police
0,2,10,41,4,9,0,51,0,john kerry warns israel: two-state solution jeopardy
0,2,11,41,4,12,1,52,0,h. moser cie. creates $1 million watch made genuine swiss cheese
0,2,3,46,0,6,0,49,0,topless feminist protester attack donald trump waxwork
0,1,8,40,0,8,0,48,0,uk serious fraud office investigate mg rover collapse
0,3,8,48,3,8,2,56,0,"aleksei navalny, russian opposition leader, receives 15-day sentence"
0,3,2,83,1,10,0,85,0,romania protests: hundred thousand march decree decriminalising corruption offence
0,3,2,55,2,9,0,57,0,jack daniel's want fill morning whiskey-infused coffee
0,3,3,66,1,8,0,69,0,former oklahoma football player accused prostituting ex-sooners cheerleader
0,1,1,44,1,8,0,45,0,"wisconsin gunman named, could charged two state"
0,1,6,26,1,5,0,32,0,unesco put world's major work online
0,2,3,43,3,10,2,46,0,apple say spent $50 billion last year u.s. supplier
0,2,2,57,2,9,0,59,0,"doctor thought germanwings co-pilot unfit fly, prosecutor say"
0,1,3,36,0,5,0,39,0,vettel becomes youngest formula one champion
0,1,3,36,1,6,0,39,0,"two tornado touch near wellington, utah"
0,1,7,31,1,6,0,38,0,"time, sabathia rediscovers fastball"
0,3,9,24,4,6,4,33,0,2017 nfl draft: chris simms' can't-miss player
0,1,1,80,1,12,0,81,0,egyptian prime minister step down; armed force appoint former transport minister position
0,3,2,41,0,9,0,43,0,oreo cadbury egg make candy stash seem weak
0,3,9,37,1,10,0,46,0,"sephora add products, rivalry heat store"
0,1,2,26,1,4,0,28,0,"apple launch new, faster iphone"
0,1,6,34,1,6,0,40,0,inquiry focus ex-pension official bush
0,2,13,72,5,14,0,85,0,oscar weekend flashback: justin timberlake ryan gosling's best moment together 'mickey mouse club'
0,3,14,43,1,12,2,57,0,air force chief b dhanoa fly mig-21 solo inspect western front
0,2,9,40,0,8,0,49,0,italian prime minister botch attempt read borges
0,3,6,60,0,12,0,66,0,prepare super bowl nfl star reading mean tweet
0,3,2,71,0,14,0,73,0,grieving ray lonely fisherman taken expense paid angling trip new friend
0,3,2,64,2,14,0,66,0,burrowers: copper mine's fate hint light end tunnel michigan
0,3,4,59,0,12,0,63,0,uk man leigh timmis spends seven year cycling around world charity
0,2,5,58,2,9,2,63,0,"russia-australia relation state frozen disagreement crimea, mh17"
0,3,11,37,0,9,0,48,0,health insurer wrestle next step gop bill fails
0,3,9,47,3,9,1,56,0,tommy hilfiger's ultra-rare ferrari might fetch $3 million auction
0,2,1,25,0,3,0,26,0,pope defends economic message
0,1,2,41,1,6,0,43,0,discworld author film battle alzheimer's
0,3,1,64,1,15,4,65,0,"china opened highest bridge world 1,800 foot ground"
0,1,1,44,1,6,0,45,0,brazilian soccer player's mother freed kidnapper
0,1,2,39,0,9,2,41,0,sri lankan president promise end war 48 hour
0,1,6,32,0,6,0,38,0,phil mickelson rally win northern trust
0,3,8,53,0,11,0,61,0,trump call unity opening concert inaugural festivity begin
0,1,7,34,1,8,0,41,0,"clinton listening tour, china get earful"
0,3,12,39,0,13,4,51,0,son thanks mom cared dad 20 year 20 adventure
0,3,9,40,0,10,0,49,0,tim tebow say want adopt child every continent
0,3,5,36,3,7,0,41,0,tottenham hotspur v watford: premier league live!
0,1,9,37,1,9,0,46,0,"coaches, recruiting top player dark side"
0,2,3,62,1,12,0,65,0,there raging talent war ai expert costing automaker million
0,3,1,35,3,8,3,36,0,man 'ran ocean avoid 375 restaurant bill'
0,1,8,44,0,7,0,52,0,missouri system treat juvenile offender lighter hand
0,2,6,43,0,9,0,49,0,theresa may holding talk white house donald trump
0,3,4,49,2,8,0,53,0,park geun-hye impeached: south korea rally demand full removal
0,3,3,62,1,13,0,65,0,"hot air balloon cross channel france world record attempt, picture"
0,3,2,50,0,7,0,52,0,eric trump suspends operation charitable foundation
0,3,1,27,0,4,0,28,0,imagine world without giraffe
0,3,6,50,0,11,0,56,0,people gripped lapd car chase streamed live facebook
0,3,5,58,1,11,0,63,0,pro-donald trump rally across u attract handful supporter
0,3,8,42,1,9,0,50,0,ryan: russia clearly tried meddle political system
0,1,2,49,0,8,0,51,0,nine dead shooting rampage connecticut beer warehouse
0,1,8,34,2,7,0,42,0,h.p. lower bar printing glossy color magazine
0,1,7,30,0,7,0,37,0,bank america board gun critic
0,3,1,42,4,7,2,43,0,"30-a-day habit: tastier, asian approach mealtime"
0,2,14,59,1,14,0,73,0,"boyfriend attacked her, calling police got woman banned town"
0,3,7,60,0,12,0,67,0,malala yousafzai likely study oxford university achieves aaa offer
0,2,12,46,7,11,0,58,0,frank ocean premiere 'chanel' a$ap rocky remix 'blonded' radio: listen
0,3,14,39,1,11,7,53,0,"blink 182, afi lead opening night 2016 kroq almost acoustic christmas"
0,1,7,58,2,11,0,65,0,cnn typo mix prospective u.s. presidential candidate osama bin laden
0,2,11,57,0,16,0,68,0,pair classic rock event bring fleetwood mac eagle coast
0,1,9,31,2,8,1,40,0,u.s. congress pass cafta 2 vote house margin
0,1,5,28,2,7,3,33,0,chinalco invest $19.5 billion rio tinto
0,2,13,57,1,12,0,70,0,big sean's mogul prep program help student break entertainment world
0,3,4,55,3,10,0,59,0,vince carter definitely wear t-shirt showing dunking trump
0,3,8,47,1,9,1,55,0,electrical contractor suing trump hotel unpaid $2 million bill
0,3,4,44,0,8,0,48,0,bt reach deal ofcom legally separate openreach
0,2,4,53,1,9,0,57,0,gameday kickoff: conference title game affect playoff
0,3,4,54,0,10,0,58,0,jimmy kimmel take united airline hilarious mock safety video
0,1,2,39,1,7,2,41,0,bomb hit northwestern pakistan; least 30 killed
0,1,3,44,1,8,0,47,0,"man jailed murder child manchester, england"
0,2,7,37,2,7,0,44,0,trump cant easily replicate brexits success
0,2,9,42,9,8,0,51,0,[*bn*]the nuclear option[*]: comparing trump sander breitbart
0,3,4,52,1,9,0,56,0,report: passenger removed plane harassing ivanka trump
0,1,6,29,0,7,1,35,0,least 3 hostage reported slain yemen
0,2,3,44,0,9,0,47,0,third brit throw away christmas turkey sprout
0,3,10,40,2,9,0,50,0,man killing ex-nfl player admitted shooting: sheriff
0,1,1,42,0,7,0,43,0,bad weather make life tougher quake survivor
0,2,6,82,1,15,0,88,0,"penny tell north korea test american resolve, offering syria afghanistan strike example"
0,2,5,51,2,9,2,56,0,australian year: general david morrison's tumultuous 12 month
0,1,2,40,0,9,0,42,0,adam air may shut string accident
0,3,11,29,3,8,0,40,0,cmo today: new star war give disney another hit
0,3,10,42,0,10,0,52,0,rumored jay z zaytoven collaboration headed way
0,2,9,49,2,9,0,58,0,"american think obama, kennedy, reagan gave best inaugural address"
0,1,6,21,1,6,0,27,0,wood return left: winner
0,2,7,34,1,7,0,41,0,"lawyer travel ban case seek emails, subpoena"
0,3,9,45,1,10,2,54,0,"italy bus crash kill 16, mostly hungarian teenager school trip"
0,2,2,63,0,10,0,65,0,hillary clinton poised win popular vote despite losing presidential race
0,2,2,28,2,5,0,30,0,voting romania's election?
0,3,1,51,0,9,0,52,0,family pay tribute woman killed collision hospital
0,1,6,58,1,10,0,64,0,"former ukraine pm yulia tymoshenko end hunger strike, daughter announces"
0,2,10,52,1,11,0,62,0,texas arkansas senator pit queso cheese dip washington wire
0,1,1,27,0,4,0,28,0,iran conduct nine missile test
0,2,12,39,5,16,0,51,0,"china ant financial, owned trump ally jack ma, make u.s. play"
0,3,17,51,4,15,0,68,0,"heartfelt message m dhoni, virat kohli tell 'you'll always captain'"
0,1,6,33,1,8,0,39,0,"ire columnist, author torture memo"
0,1,7,26,0,6,0,33,0,cisco plan big push server market
0,2,9,52,1,10,0,61,0,protest flare paraguay congress vote extend president term
0,3,7,38,3,8,0,45,0,"chance rapper release coloring book, spirit"
0,1,8,47,1,9,1,55,0,rutgers add football recruiting lounge $5 million donation
0,3,3,58,2,12,0,61,0,"inauguration day tips: bring cash, pack phone charger get early"
0,1,5,53,0,11,0,58,0,fda recall foreign meat used aid victim hurricane katrina
0,1,2,35,0,5,0,37,0,large earthquake strike nation georgia
0,1,3,35,0,8,3,38,0,island man spends night 162 scottish island
0,3,2,83,4,14,4,85,0,"could oldest beef stew? archaeologist discover 2,300-year-old cooking pot containing cow bone"
0,3,2,47,2,10,0,49,0,dad accepts 'best husband' award gym short oscar
1,3,9,41,0,9,0,50,0,moment turned charlie murphy comedy legend
1,1,10,40,4,10,2,50,0,"15 woman show ""unflattering"" hair, makeup,"
1,2,12,51,1,11,0,63,0,lindsey graham meet donald trump lunchgives new cell phone number
1,3,2,37,1,8,2,39,0,lucy worsley: 20 best historic house visit
1,1,7,16,0,6,0,23,0,proper grown yet
1,3,12,46,1,12,2,58,0,21 aerial view city around world beyond magical!
1,1,9,23,1,8,0,32,0,here's bake booze nail
1,3,3,48,2,9,0,51,0,march madness 'news dump' made u question everything
1,3,14,56,4,13,0,70,0,"anurag kashyap's strong fb post, manveer's generous donation charity ent"
1,1,7,37,0,8,3,44,0,25 insanely delicious thing make 3 ingredient
1,1,14,43,3,13,0,57,0,"cast ""parks rec"" first episode vs. last episode"
1,1,9,43,0,9,2,52,0,18 picture everyone love spilling tea understand
1,1,5,18,0,4,0,23,0,cupcake flavor
1,1,9,37,0,9,2,46,0,24 time nathan fillion funniest thing twitter
1,1,8,38,0,8,2,46,0,17 time jordin spark totally slayed instagram game
1,1,9,44,1,9,2,53,0,19 time ryan reynolds' instagram made even irresistible
1,1,8,24,1,7,0,32,0,said it: kanye west jenna maroney
1,1,9,32,1,8,0,41,0,creepy terrence howard's kiss emmy
1,1,13,46,9,11,2,59,0,"dakota johnson's advice 16-year-old self: ""don't get tattoos, idiot!"""
1,1,12,38,0,12,2,50,0,23 worst thing people actually said first date
1,1,7,29,0,7,2,36,0,57 way people eating disorder got well
1,3,1,45,1,7,0,46,0,best photo day: slacklining electioneering
1,1,13,45,0,11,0,58,0,identify justin bieber music video youtube comment
1,2,5,37,0,8,0,42,0,hand positron voyager vr cinema chair
1,1,12,43,1,11,0,55,0,rock christmas making girls' dream come true
1,1,12,41,0,10,0,53,0,reminder chace crawford look flawless af right
1,3,3,51,5,14,1,54,0,top 5 source salt u.s. diet (potato chip make list)
1,1,12,38,1,10,0,50,0,man three-day boner taking herbal supplement
1,1,11,51,0,10,0,62,0,alternate universe celebrity thanksgiving look like
1,1,9,28,0,9,2,37,0,19 tumblr post real anime fan
1,3,16,50,2,12,0,66,0,"adpvoice: flexible tech revolution, organization"
1,1,9,29,0,9,2,38,0,20 reason give new joker chance
1,1,8,31,2,7,0,39,0,"people dyeing hair ""pumpkin spice"""
1,1,11,37,0,10,0,48,0,wish knew started losing weight
1,1,11,36,0,11,2,47,0,18 struggle way real people cry easily
1,1,7,25,1,6,2,32,0,10 go-go remake absolutely must hear
1,1,8,33,0,7,0,41,0,shape test determine best quality
1,3,12,33,3,10,0,45,0,tsa precheck vs. global entry: one better deal?
1,3,9,32,0,9,0,41,0,tiger wood round golf donald trump
1,1,12,45,0,11,0,57,0,need see video alan rickman pranking daniel radcliffe
1,1,11,32,0,9,0,43,0,tv brother brother real life
1,1,11,32,0,10,0,43,0,know old based favorite kitten
1,1,11,41,2,10,0,52,0,salma hayek's advice woman basically ever need
1,1,12,32,1,10,2,44,0,21 diy ornament take tree next level
1,3,13,49,0,12,0,62,0,woman voted trump government deporting husband
1,1,10,40,0,9,0,50,0,watch seahorse shoot baby seahorse stomach
1,2,6,26,0,6,0,32,0,secret finding ideal hotel
1,3,4,67,4,12,1,71,0,7 adrenaline-fuelled activity chase post summer blue away (toyota c-hr)
1,1,6,18,0,5,0,24,0,find dream puppy
1,3,14,61,3,13,0,75,0,"former batchmate slam mira feminism remarks, say 'belittled' girl college"
1,1,7,26,0,7,2,33,0,19 thing super polite people get
1,1,8,26,0,7,0,34,0,know celebrity hate
1,1,9,37,0,8,0,46,0,albus dumbledore quote life motto
1,2,12,36,0,11,0,48,0,guy england driving tank gas station
1,1,7,33,1,6,0,40,0,here's ten country approach mental health
1,2,1,33,2,8,0,34,0,living within mean greatcon
1,1,12,40,0,12,2,52,0,17 photo make fall love young matthew perry
1,1,8,33,1,7,0,41,0,here's make spinach artichoke garlic bread
1,3,7,31,0,8,6,38,0,10 inspirational quote artist lost 2016
1,1,9,34,3,10,1,43,0,7 seriously legit way earn $$$ working home
1,1,8,36,2,7,0,44,0,"brace yourself, america, dressed chip coming"
1,1,9,28,0,9,2,37,0,13 way ghost problem
1,1,9,24,1,8,0,33,0,here's map canada westeros
1,3,9,30,0,8,0,39,0,best deal internet thisweekend
1,1,8,38,0,9,6,46,0,23 incredibly disrespectful thing people food 2015
1,3,7,38,3,7,0,45,0,"israel, apple, debbie reynolds: thursday briefing"
1,1,9,35,2,8,3,44,0,29 nintendo present 1-up gift-giving game
1,1,9,44,0,8,0,53,0,people going nut ridiculously hot veterinarian
1,2,2,34,3,6,0,36,0,trump: 'if something happens blame' judge
1,1,11,45,2,10,0,56,0,"kanye release ""real friends"" snippet kendrick lamar collab"
1,1,5,22,0,4,0,27,0,evolution natalie dormer
1,2,2,30,0,8,2,32,0,20 best tech job america right
1,1,8,30,0,7,0,38,0,polite golden retriever much
1,1,8,41,0,8,2,49,0,18 deliciously filling salad guaranteed make hungry
1,1,9,32,2,8,0,41,0,"best ""scream queens"" drinking game ever"
1,2,11,35,3,10,0,46,0,"sza share video new song ""love galore"" f/ travis scott"
1,1,5,16,0,4,0,21,0,vape god instagram
1,1,8,26,0,7,0,34,0,guess old timey slang word
1,2,10,43,0,11,2,53,0,average woman change dress size 31 time lifetime
1,1,10,37,0,9,0,47,0,proposal cake put proposal shame
1,1,8,31,0,8,2,39,0,13 magical fact sex wizarding world
1,1,8,20,1,7,0,28,0,know whether nerd
1,2,1,71,1,14,0,72,0,culture kink-shaming making u much less sexually liberated think
1,1,11,34,1,10,1,45,0,try cool figure-8 bun hair dripping wet
1,1,8,29,0,8,2,37,0,23 bleakest christmas tree world
1,1,17,38,0,12,0,55,0,take moment appreciate angela bassett baftas
1,3,2,60,3,14,3,62,0,"despite rhetoric, here clear sign trump eager show 100-day win"
1,1,8,17,2,4,0,25,0,hbcu homecoming do's don'ts
1,3,21,66,3,20,0,87,0,"best movie tv show new netflix, hulu, amazon hbo march nyt watching watching logo search"
1,1,9,47,0,9,2,56,0,23 profoundly disturbing photo homemade sex machine america
1,1,15,43,1,14,0,58,0,disco ball moment there's nothing
1,1,9,50,1,8,0,59,0,investigation: kim kardashian literally funniest person alive
1,1,11,36,0,10,0,47,0,pete wentz want fall boy collab taylor swift
1,3,11,56,1,11,0,67,0,wapo offer grieving space open border lobby ahead session confirmation
1,1,14,49,2,13,0,63,0,"try guess even disney movie ""walt disney presents"" screen"
1,3,12,40,3,11,2,52,0,nba player power rankings: b/r's top 30 center halfway point
1,1,11,35,1,10,0,46,0,"truth is, katy perry actual queen halloween"
1,1,7,22,0,6,0,29,0,actually prefer guy pie
1,1,6,24,0,5,0,30,0,instagram theme
1,1,9,35,2,8,0,44,0,what's absolute laziest thing ever paid
1,1,7,26,0,7,1,33,0,horoscope week december 7
1,3,3,46,2,11,0,49,0,"missile north korea showed off, one one."
1,1,5,27,1,4,2,32,0,15 real-life achievement canadian
1,3,14,53,1,13,0,67,0,searching intersexual pig ended finding world's rarest dog
1,1,9,35,0,9,2,44,0,17 picture beach body get motivated
1,1,12,41,0,11,0,53,0,photo kid freaking santa make laugh
1,1,8,35,0,8,2,43,0,23 euphoric experience everyone love eat
1,1,10,28,2,8,0,38,0,"well remember ""catdog"" theme song"
1,1,14,28,0,13,3,42,0,many top 100 tv show time seen
1,1,13,42,1,13,2,55,0,know favorite '90s movie based first letter name
1,1,8,24,0,7,0,32,0,guess celeb made art
1,2,9,19,1,7,0,28,0,super bowl li: need know
1,1,8,29,0,7,0,37,0,solve puzzle hate authority
1,1,7,34,0,7,2,41,0,32 autumn leaf photo almost pornographic
1,2,2,47,0,8,0,49,0,elderly resident unaccounted dallas condo fire
1,1,9,30,0,9,2,39,0,12 way get help feel completely alone
1,2,1,72,1,13,0,73,0,"first, woman delivers baby transplant frozen childhood ovarian tissue"
1,1,12,51,0,12,2,63,0,14 photo proving many rickshaw driver heart broken
1,1,13,53,1,12,0,66,0,saturday night live hilariously made fun dating apps last night's episode
1,1,8,25,0,8,2,33,0,32 gift idea canadian life
1,2,10,49,0,11,0,59,0,expensive death game throne probably surprise
1,1,11,25,0,11,4,36,0,tell best part 2016
1,1,12,45,0,11,0,57,0,secret delicious cauliflower pizza lot lot cheese
1,1,9,38,0,8,0,47,0,crossword everyone love dirty cartoon
1,1,6,31,0,6,2,37,0,17 picture short girl never understand
1,1,8,37,0,8,2,45,0,25 face every older sibling definitely made
1,3,2,35,0,8,0,37,0,czech zoo dehorning white rhino
1,1,6,18,0,6,2,24,0,23 thing metal fuck
1,1,7,27,0,6,0,34,0,solve crossword fart
1,1,11,48,3,8,0,59,0,"asl interpretation adele's ""hello"" heartbreakingly gorgeous"
1,1,16,36,0,15,0,52,0,man set fire gas pump trying kill spider lighter
1,2,2,50,3,10,0,52,0,argentina tried trump-like tariff -- went horribly wrong
1,3,10,31,1,9,0,41,0,ten thing good manager ask employee
1,1,11,36,1,10,0,47,0,zayn malik new instagram it'll destroy soul
1,1,9,30,1,8,0,39,0,guess belieber directioner
1,3,13,55,1,13,0,68,0,advocate call gun control: legal gun different illegal gun
1,1,8,27,2,7,0,35,0,hey stores: way early christmas
1,3,2,45,3,9,0,47,0,bolivia's abandoned ski resort: sign drought come?
1,1,15,58,4,13,0,73,0,"j.k. rowling daniel radcliffe lead ""harry potter"" star paying tribute alan rickman"
1,1,15,46,1,16,4,61,0,18 product sale 30% totally buy love sparkle
1,3,8,34,2,8,2,42,0,there finally movie get 90 nostalgiaright
1,1,13,40,0,13,2,53,0,16 tweet sum length would go avoid people
1,1,12,38,0,12,2,50,0,21 picture way real people always cold
1,1,5,20,1,5,2,25,0,45 sign old millennial
1,1,12,48,2,11,0,60,0,here's orphan black fan dealing tatiana maslany's emmy loss
1,1,10,39,1,9,0,49,0,here's jumping wedding photo terrible idea
1,1,6,21,0,6,2,27,0,11 work art inspired madonna
1,1,13,57,2,12,0,70,0,"weather reporter snuck multiple ""star wars"" pun reporting weather"
1,3,4,58,1,12,0,62,0,theresa may decision call snap election took britain surprise
1,3,3,39,2,9,0,42,0,got hacked yahoo account? here's
1,3,9,32,0,8,0,41,0,anagram quiz reveal mindworks
1,1,14,43,2,13,0,57,0,"pug frenchie recreated ""lady tramp"" beautiful"
1,2,16,71,4,16,0,87,0,"pooja bhatt, nucleya, atul kasbekar, shane falguni peacock came together create funky music video"
1,1,6,26,0,6,2,32,0,19 gift everyone hate everyone
1,1,11,28,0,11,2,39,0,26 people one point life
1,1,13,54,2,10,0,67,0,everything need know mcdonald's new chocolate-covered french fry
1,3,10,54,1,10,0,64,0,"judge denies bond chicago suspect charged hate crimes, kidnapping"
1,3,9,48,0,8,0,57,0,riot engulf italian migrant centre following asylum seeker death
1,3,3,50,2,11,1,53,0,'game thrones' season 7 photo offer first glimpse winter
1,3,8,39,0,8,0,47,0,migrant sexually attack girl city hall youth party
1,1,11,32,2,10,0,43,0,here's care damn cold
1,2,7,31,3,6,0,38,0,pope francis: muslim terrorism exist
1,1,5,21,0,4,0,26,0,would smooch animal
1,1,4,13,0,3,0,17,0,hoverboard
1,3,2,29,2,7,2,31,0,10 u.s. job vanishing alarming rate
1,1,10,43,0,9,0,53,0,find political conspiracy hidden crossword
1,1,7,26,0,7,2,33,0,29 hilarious tweet going gym
1,2,1,32,1,5,0,33,0,truck driver stop high-speed car chase
1,2,17,60,3,18,2,77,0,"air pollution, delhi also world no.1 noise pollution 5 major read today"
1,3,9,49,3,12,2,58,0,"report: evidence detroit voter fraud, many vote 37% precinct"
1,1,7,29,0,6,0,36,0,guess personal life philosophy
1,1,18,47,0,17,0,65,0,little girl asked mom friend dad melt heart
1,3,7,32,4,6,0,39,0,"america fattest cities, ranked [video]"
1,2,4,35,1,6,0,39,0,dutch ivf centre probe suspected sperm mix-up
1,3,9,49,4,9,1,58,0,watch dog 2 review: competent cringeworthy open-world adventure
1,1,17,30,0,10,0,47,0,charli xcx looked like space dominatrix mtv emas
1,3,4,38,0,10,0,42,0,may brutal number cbo report
1,3,0,25,0,7,5,25,0,7 thing expect esports 2017
1,1,9,44,2,8,0,53,0,"here's survive adulthood, according judah friedlander"
1,1,12,39,2,12,2,51,0,hardest '90s alt rock music video quiz ever take
1,3,6,32,0,6,0,38,0,trump resistance commercialized
1,1,9,35,2,9,2,44,0,"17 ""family feud"" answer never stop funny"
1,1,12,37,0,11,0,49,0,sweet dog became mom litter orphaned opossum
1,1,11,30,1,11,2,41,0,17 thing bored mind
1,2,6,53,2,13,1,59,0,everything need remember season 2 orange new black
1,1,11,42,3,10,2,53,0,11 non-human disney character made feel thing ~down there~
1,1,4,30,0,4,2,34,0,16 sinfully delicious chocolate dessert
1,1,9,42,4,8,0,51,0,"drag queen play ""fuck, marry, kill"" republican candidate"
1,1,9,31,3,7,0,40,0,quick shout-out lupita nyong'o's umbrella man
1,1,5,21,0,4,0,26,0,night owl become early riser
1,1,12,47,1,11,0,59,0,video show apollo mission like never seen
1,1,9,50,2,9,2,59,0,23-year-old student dy suffocation skrillex concert delhi
1,1,10,37,2,9,0,47,0,"""harry potter"" character cast black actor"
1,1,12,36,0,11,0,48,0,kind pet adopt based birth month
1,3,12,60,3,12,0,72,0,safe space event organizer claim wouldnt feel safe describing event reporter
1,1,12,47,1,11,0,59,0,wish known breast cancer diagnosed
1,1,11,32,0,10,0,43,0,cover art kanye west coldplay album
1,1,18,63,0,17,0,81,0,dad recorded adorable question son asked watching star war first time
1,1,6,29,0,6,2,35,0,25 genius spaghetti recipe know
1,3,7,35,0,8,2,42,0,10 risky brand comeback social medium worked
1,3,7,76,2,18,0,83,0,revealed: food never put freezer breadcrumb potato hot food
1,3,6,22,1,5,0,28,0,popular egg opinions?
1,2,3,46,0,8,0,49,0,reason vote democrat top amazon bestseller list
1,1,10,40,0,9,0,50,0,get post without moaning pleasure
1,3,8,46,1,8,1,54,0,4 surprising role might've forgotten debbie reynolds played
1,2,3,59,2,10,0,62,0,"well actually, jaw-dropping steph curry highlight illegal move"
1,1,16,60,0,16,0,76,0,would say company announced wanted replace robot someday
1,3,1,35,0,6,0,36,0,mother made ultimate sacrifice
1,1,12,44,1,11,0,56,0,tried virtual reality first time here's happened
1,1,11,39,0,11,2,50,0,27 reason china best place next epic adventure
1,3,10,42,1,9,0,52,0,grad lifevoice: address workforce diversity gap
1,1,9,29,1,9,3,38,0,100 year girls' fashion look like
1,1,8,33,1,7,0,41,0,can't stop watching mini cooking video
1,2,10,44,2,11,1,54,0,"chris brown, soulja boy settle twitter beef $1m boxing match"
1,1,10,40,0,9,0,50,0,woman smashing face bread oddly compelling
1,2,13,31,4,10,0,44,0,drunk lemon: cnn cut mic new year eve show
1,1,8,36,1,9,4,44,0,11 stats put wayne rooney's 50 goal perspective
1,3,1,49,1,11,4,50,0,online fight dog became one 2016s greatest meme
1,1,11,39,2,10,0,50,0,"""math circus"" important game generation"
1,2,0,30,1,5,1,30,0,9 at-home remedy actually work
1,1,7,24,0,7,2,31,0,24 cake want everything
1,1,8,38,0,8,2,46,0,15 creepy eyeball treat guaranteed scare guest
1,1,11,38,3,9,2,49,0,17 mcdonald's international menu item u.s. need right
1,2,1,37,0,6,0,38,0,social medium problem gripping girl
1,3,8,48,1,7,0,56,0,talking-car safety mandate hit unexpected pothole opposition
1,2,9,38,0,8,0,47,0,study suggests extremely smart people loner
1,2,9,56,1,11,0,65,0,poll: democratic woman likely block unfriend someone politics
1,3,1,83,3,16,2,84,0,"'water world' found 39 light year away represents leap forward search aliens, scientist say"
1,3,8,52,4,8,0,60,0,progressive prepping anti-trump woman march making pussyhats
1,1,7,41,0,6,0,48,0,woman unknowingly photographed engagement
1,1,7,29,0,6,0,36,0,white men experienced racism sexism
1,2,2,39,2,10,2,41,0,top 10 best selling comic book time [video]
1,3,11,71,3,12,0,82,0,"alleged grooming gang charged multiple rape, child abduction, trafficking, drug offence"
1,2,7,35,0,6,0,42,0,five innovation could transform air travel
1,2,11,47,1,12,0,58,0,tom wheeler step fcc chairman day trump inauguration
1,3,18,58,4,16,0,76,0,idaho dems exec director: dnc train people shut mouth theyre white
1,3,6,33,2,8,0,39,0,student find key error sat given across u.s.
1,2,2,52,2,9,6,54,0,"co-op recall 165,000 chocolate santa battery found inside two"
1,1,9,33,1,9,2,42,0,29 camping recipe make look like genius
1,2,10,52,1,10,2,62,0,six chinese billionaire spring delivery fortune worth $47 billion
1,1,8,34,2,7,0,42,0,"stephen colbert went full ""hunger games"" last night"
1,1,9,37,2,7,1,46,0,improve gmail buzzfeed's 5-day inbox challenge
1,1,11,51,0,10,0,62,0,author wrote beautiful handwritten note inspiration
1,2,3,67,0,13,0,70,0,man rifle arrested dc restaurant targeted fake news conspiracy theory
1,1,17,65,1,14,0,82,0,indian pakistani using hashtag #profileforpeace send message love
1,1,10,49,0,9,0,59,0,sia proved voice completely incredible carpool karaoke
1,2,10,39,2,11,4,49,0,stumped holiday gift ideas? let forbes' 30 30 alumnus help
1,1,14,55,4,13,2,69,0,"15 mind-blowing thing probably know spencer heidi ""the hills"""
1,1,17,46,1,15,0,63,0,asked john water dating tip said ok sleep asshole
1,1,9,30,0,9,2,39,0,22 coloring book calm heck
1,2,14,47,1,14,1,61,0,owe again? 6 tip college senior facing student loan debt
1,1,8,20,0,7,0,28,0,kind old person
1,1,7,27,0,6,0,34,0,little gadget help posture
1,1,9,32,1,9,2,41,0,17 valentine's day card full hot love emotion
1,1,9,25,0,8,0,34,0,need talk sad puffin look
1,1,9,36,0,8,0,45,0,guess college major random question
1,1,11,36,3,10,0,47,0,"here's everything know merlin ""once upon time"""
1,1,7,28,0,7,2,35,0,12 way instagram like lauren conrad
1,1,6,29,1,6,2,35,0,19 style influencers kylie jenner
1,1,7,31,0,8,6,38,0,27 funniest tweet narendra modi 2015
1,1,6,29,0,7,6,35,0,14 influential canadian animal 2015
1,3,9,43,4,12,0,52,0,here's david bowie cast gandalf 'lord rings'
1,1,8,46,0,7,0,54,0,watch american try different international food combo
1,1,8,26,0,7,0,34,0,craziest illusion ever
1,1,8,36,0,7,0,44,0,favorite activity visiting family
1,1,5,24,0,5,2,29,0,21 struggle overthinker
1,1,14,54,3,13,0,68,0,"samuel l. jackson issue lightsaber battle ""the force awakens"""
1,1,10,39,1,9,0,49,0,beautiful love story see onscreen year
1,1,9,39,0,9,2,48,0,23 yahoo question destroy faith humanity
1,1,15,48,0,14,0,63,0,gwen stefani talked divorce depress crap
1,1,12,43,5,9,0,55,0,"new trailer ""x-men: apocalypse"" honestly next-level insane"
1,1,10,41,1,10,2,51,0,13 simple little thing try trouble sleeping
1,1,12,38,0,12,2,50,0,10 men morehouse give future son bae goal
1,1,9,34,1,9,2,43,0,16 new year's resolution book nerd relate
1,2,9,49,7,9,0,58,0,"valerie jarrett: trump victory soul-crushing, punch stomach"
1,1,8,26,0,7,0,34,0,best baby product amazon
1,1,9,32,0,8,0,41,0,bacon lover meet tiny piglet first time
1,2,12,44,0,11,0,56,0,new photo mysterious bright spot cere sharpest yet
1,1,11,49,0,10,0,60,0,watch boyfriend blindly guess hand belongs boyfriend
1,1,15,58,1,14,0,73,0,thousand people sharing facebook post two doctor saving man's life
1,1,8,32,1,8,2,40,0,16 thing filipino say vs. actually mean
1,1,10,27,3,9,0,37,0,"here's cast ""hey dude"" look like"
1,2,4,60,3,13,0,64,0,"public internet supposed lower prices. seattle, could work well."
1,1,9,37,0,9,2,46,0,18 celebrity really hot younger
1,1,14,53,0,13,0,67,0,need acknowledge niall underrated member one direction
1,1,8,30,0,8,2,38,0,19 adorably cute couple emmy red carpet
1,3,2,51,0,11,4,53,0,tweet perfectly sum terrifying 2017 already list
1,1,14,45,0,13,0,59,0,know oscar win based favorite lady gaga shoe
1,1,13,42,3,11,0,55,0,"making-of ""wet hot american summer"" ninety minute pure joy"
1,1,9,32,3,8,0,41,0,"here's coolest easter egg ""the force awakens"""
1,1,8,25,0,7,0,33,0,racist came halloween party
1,1,4,16,1,4,2,20,0,13 cat can't halloween
1,1,14,50,1,12,0,64,0,mark ruffalo jared leto went comic-con disguised hideous mask
1,1,5,24,0,6,4,29,0,12 absolute greatest 30 rock cameo
1,2,11,61,2,14,3,72,0,donald trump's first 100 day office president trump chris christie: try meatloaf
1,1,8,38,0,8,2,46,0,23 insanely relatable stage partying introvert
1,1,11,43,0,11,2,54,0,15 american finally found perfect reason move canada
1,1,9,35,1,9,2,44,0,34 musical baby name make want procreate
1,2,10,36,1,9,0,46,0,fake viral news story wrecked three peopleslives
1,2,1,49,2,9,0,50,0,"sacrificing sleep get top grade doesnt work, study find"
1,1,9,30,2,8,0,39,0,"dude, here's make clothes last longer"
1,2,8,31,1,8,2,39,0,31 heartwarming book youll everread
1,1,9,41,0,9,2,50,0,17 insanely delicious way cook butternut squash fall
1,3,3,51,5,11,2,54,0,'why baby jesus zap him?': 15 funniest outnumbered moment
1,2,13,73,6,13,0,86,0,congressional black caucus re-hang anti-cop police pig painting capital citing constitution
1,1,7,26,2,6,0,33,0,"good news, guy sweatpants season"
1,3,14,47,2,11,0,61,0,michael lewis: terrifies trump's presidency
1,1,8,33,1,8,2,41,0,21 world's powerful people youngster
1,1,5,24,0,4,0,29,0,watch britney spear paint leaf
1,1,8,30,1,8,2,38,0,21 photo green mango make drool
1,1,13,43,2,12,0,56,0,indians: need get married people want
1,2,8,39,0,8,0,47,0,five thing trump could quickly deregulation push
1,1,15,63,0,15,1,78,0,predict romantic future 3 question taste bollywood movie
1,1,5,24,0,5,2,29,0,17 practical thing every girl need
1,3,8,40,1,10,0,48,0,dad diys daughter's sleep onesie nasa space suit
1,1,10,44,1,9,2,54,0,16 show netflix definitely binge-watch weekend
1,1,9,22,2,8,0,31,0,"""toy car"" better real car"
1,1,7,19,1,6,0,26,0,said it: lorde audre lorde
1,3,16,59,2,14,0,75,0,internet turned old photo hema malini really giggle-worthy memes!
1,1,8,42,1,7,0,50,0,here's meg cabot learned situational depression
1,2,6,28,1,6,2,34,0,"literally 17 really, really goodideas"
1,1,10,24,1,9,0,34,0,here's get red sex
1,1,9,31,0,9,2,40,0,11 type hangover everyone least
1,3,2,37,1,7,0,39,0,we've learned far session hearing
1,2,16,56,6,13,0,72,0,"trailer nawazuddin's 'haramkhor', srk's inspiring speech world ent!"
1,1,7,33,1,7,2,40,0,17 thing everyone regret freshers' week
1,1,8,22,1,6,0,30,0,buzzfeed crossword: two pea pod
1,1,10,35,0,10,2,45,0,23 animal want everyone kindly step fuck back
1,3,17,50,2,13,0,67,0,video: french police flee armed mob week-long paris riot spread city centre
1,1,8,27,0,7,0,35,0,drunken photo iphone
1,2,11,37,0,11,0,48,0,kinky af map reveals popular sex toy state
1,1,7,39,0,7,2,46,0,17 absolutely perfect pickup line whiskey drinker
1,1,12,45,0,12,4,57,0,need talk incredibly amazing jennifer lopez look 2016
1,1,8,27,0,8,2,35,0,18 couple made believe love
1,1,7,25,0,6,0,32,0,biblical city live
1,1,12,43,1,10,2,55,0,21 three-ingredient snack make thanksgiving easy af
1,1,13,43,4,12,0,56,0,"guy wrote ""hamilton"" also wrote new ""star wars"" cantina song"
1,1,10,44,3,9,0,54,0,"new ""sports illustrated"" model magazine's curviest yet"
1,1,12,39,0,11,0,51,0,know snapchat secretly eating data
1,3,9,33,3,11,0,42,0,lake turned pink australia. one.
1,2,2,59,1,8,0,61,0,rising architectural star could change india's skyline forever
1,1,9,30,0,9,2,39,0,14 duet prove two voice better one
1,2,7,35,0,7,2,42,0,24 brutally honest confession sex therapist
1,3,2,45,3,10,0,47,0,news world's safest least safe airline revealed
1,2,4,33,2,8,0,37,0,russia two st. patrick day year
1,2,6,74,1,15,1,80,0,"house senate republican learned deal president trump, 4 simple reaction"
1,2,6,42,0,7,0,48,0,former gitmo detainee charged assault australia
1,1,9,35,0,9,2,44,0,21 little joy tall people never get experience
1,3,2,65,1,15,0,67,0,there's super easy way find trump tweeted given subject
1,1,9,35,0,8,0,44,0,kanye west wiz khalifa officially drama free
1,2,10,55,3,10,2,65,0,"inside magic leap, secretive $4.5 billion startup changing computing forever"
1,1,11,53,0,10,0,64,0,kathy griffin kristin chenoweth talk worst heckler story
1,1,7,47,1,5,0,54,0,transgender-cisgender couple talk relationship
1,1,11,45,3,9,1,56,0,kim kardashian's 6-year-old nephew comment deodorant
1,1,13,46,0,12,0,59,0,british rapper trying find father killed
1,3,13,38,5,14,0,51,0,bbc dad going viral: first line obituary
1,1,8,30,0,8,1,38,0,8 way use bi invisibility advantage
1,1,10,32,0,9,0,42,0,favourite david bowie song time
1,1,17,41,0,16,0,58,0,puppy wanted say hello bad got head stuck wall
1,3,11,63,5,13,0,74,0,"cuba: thug beat pregnant pro-democracy dissident belly, put father hospital"
1,3,10,54,3,9,0,64,0,gainor: terrifying medium talking openly assassinating trump
1,1,13,48,1,12,0,61,0,girl transformed back brace steampunk armor sick
1,3,1,53,1,10,2,54,0,table 19 review divorce unfunny wedding comedy
1,1,6,31,1,5,0,37,0,"honestly, goldilocks absolute worst"
1,3,3,66,3,15,6,69,0,"woman reviewed 40,000 rsums outline 8 annoying mistake see"
1,2,1,64,0,11,0,65,0,simple badge helping social medium user talk mental illness
1,1,10,39,1,9,0,49,0,"teachers, actually want christmas year"
1,1,9,62,3,8,0,71,0,"cara delevingne look horrifically unrecognizable ""suicide squad's"" enchantress"
1,1,2,13,0,1,0,15,0,lesbian princess
1,1,10,28,1,9,0,38,0,worst pick line ever heard
1,1,11,48,0,10,0,59,0,disney princess hair matching outfit kind magical
1,1,8,33,0,8,2,41,0,11 reason leslie knope queen compliment
1,2,7,41,2,10,4,48,0,california birth rate fall lowest level history 2016
1,3,6,81,4,18,0,87,0,world's powerful passport revealed: germany take top spot (but uk u trail far behind)
1,1,10,32,0,10,2,42,0,17 way get holiday spirit disney world
1,1,10,35,3,10,2,45,0,"27 ""real life"" magazine headline went way, way far"
1,1,11,37,2,10,0,48,0,"""gilmore girls"" quote heart need right"
1,1,10,31,0,9,0,41,0,guess city enters new year first
1,3,4,23,0,7,5,27,0,9 beauty trend leave behind 2016
1,1,8,27,0,8,2,35,0,13 book make believe ghost
1,1,10,28,2,10,2,38,0,"22 picture make say ""i need adult"""
1,1,9,28,0,9,2,37,0,21 pumpkin recipe get fall spirit
1,3,8,43,4,10,3,51,0,google give $11.5 million combat racial bias justice system
1,3,13,51,1,11,0,64,0,"veteran wisconsin va hospital may infected hepatitis, hiv"
1,1,14,45,1,14,0,59,0,i'm iphone person actually love new android phone
1,1,6,29,0,6,1,35,0,7 awesome idea easy weeknight dinner
1,1,10,39,1,10,2,49,0,24 tweet make feel better student debt
1,2,7,81,2,21,0,88,0,revealed: perfect way cook rice perfectly fluffy never stick bottom pan
1,2,17,54,1,16,0,71,0,people came together help widowed old man find fishing buddy sotouching
1,1,10,43,1,9,0,53,0,here's first look benedict cumberbatch doctor strange
1,1,8,23,0,7,0,31,0,tell u time peed
1,3,13,54,7,13,0,67,0,cnns borger: today worst perilous day trump young presidency
1,1,5,18,0,4,0,23,0,shut catcallers
1,2,4,44,2,13,0,48,0,hoping get u -- trump banned
1,3,14,61,4,16,0,75,0,"director benny ""boom"" douglas reveals unknown actor playing tupac 'all eyez me'"
1,1,11,18,1,8,0,29,0,wtf would kid said f*ck
1,1,8,37,0,8,2,45,0,65 thing make british people feel slightly guilty
1,1,8,32,0,8,2,40,0,44 thing every emo kid think holiday
1,1,7,24,0,8,6,31,0,23 dance move changed life 2015
1,2,18,31,1,11,4,49,0,nfl power rankings: 32 team stand heading week 16
1,3,9,42,1,9,0,51,0,watch doug aitkens mirrored ranch house transform time
1,1,7,17,0,6,0,24,0,earned porn star name
1,1,12,60,0,11,0,72,0,photographer take discarded shopping list turn freaky recipe
1,1,10,40,2,9,0,50,0,"woman wrote feminist version ""hotline bling"""
1,1,9,32,1,9,2,41,0,21 vine funny even though
1,1,16,44,0,12,0,60,0,leonardo dicaprio vaped sag award internet lost mind
1,1,10,35,0,10,2,45,0,15 stylishly sexy tall guy make feel thing
1,1,10,42,1,10,4,52,0,everything need know netflix's original series 2016
1,3,3,61,2,13,0,64,0,look man's face melania trump's latest tweet actually perfect
1,1,10,42,0,10,1,52,0,7 crucial photo strategy everyone big head know
1,1,8,30,0,8,2,38,0,17 time internet told truth money
1,1,7,28,0,6,0,35,0,fictional character look like
1,2,3,16,0,3,0,19,0,adulthood happens
1,1,11,36,2,10,0,47,0,"facebook post ""lost dog"" surprise ending"
1,1,12,41,1,11,1,53,0,7-picture test reveal true difficulty life
1,2,5,58,3,11,0,63,0,sundance review: 'ingrid go west' instagram horrorshow fear
1,3,4,56,1,12,1,60,0,deadpool 2: director tim miller break silence left sequel
1,2,15,44,2,14,2,59,0,"25 photo remind hot leonardo dicaprio was, is, always"
1,1,14,40,0,12,0,54,0,know age based favorite horror movie tv show
1,1,10,30,0,7,0,40,0,celebrity first famous bff
1,1,7,23,0,6,0,30,0,pug pun brighten day
1,1,7,31,1,7,2,38,0,18 filipino word can't translate english
1,1,8,33,3,5,0,41,0,"what's funniest ""spongebob squarepants"" quote"
1,1,6,19,0,5,0,25,0,sign awkward guy like
1,3,14,51,1,12,0,65,0,charlize theron keanu reef kinda sorta shit-talked thegym
1,1,8,32,0,7,0,40,0,fictional couple partner
1,1,7,23,0,9,8,30,0,35 movie turning 10 year old 2016
1,1,12,56,0,11,0,68,0,lego reportedly responds request inclusivity new toy wheelchair
1,3,11,46,1,11,1,57,0,fox news tucker carlson interview caitlyn jenner first 8pm show
1,1,9,27,0,9,2,36,0,10 awesome thing make duct tape
1,3,8,40,1,10,4,48,0,best luxury-car instagram feed follow 2017
1,3,3,63,3,12,3,66,0,"105-mph-throwing michael kopech, breaking speed limit well within law"
1,1,10,28,0,9,0,38,0,well actually know law rugby
1,1,10,33,0,10,2,43,0,21 cat still figuring whole cat thing
1,1,6,31,3,5,0,37,0,tell u yourself(ie): kaitlin doubleday
1,1,9,39,2,9,2,48,0,21 picture people who've never period understand
1,1,8,39,0,8,2,47,0,19 conveniently portable item change life
1,1,11,57,0,11,2,68,0,11 time bollywood star bravely opened deepest personal struggle
1,1,6,29,0,6,2,35,0,14 adorable image dog wearing trouser
1,2,6,62,3,15,0,68,0,"freedom caucus want gop health-care bill, getting"
1,1,10,35,0,10,2,45,0,20 small thing gender dysphoria get
1,2,15,47,1,14,0,62,0,"sunil grover writes open letter pm modi, urge get dawood nabbed"
1,1,7,29,2,6,0,36,0,"search next ""battlestar galactica"""
1,1,10,40,2,9,0,50,0,"hogwarts house character ""gilmore girls"""
1,1,12,38,0,12,4,50,0,time 2015 miley cyrus reminded u smoke weed
1,1,12,33,2,11,0,45,0,"vine ""hotline bling"" meme need see"
1,1,7,29,0,7,2,36,0,17 insanely awesome starbucks need see
1,1,4,20,1,4,2,24,0,"17 people holding signs, ranked"
1,1,6,28,0,5,0,34,0,adult guess crayola crayon color name
1,1,14,38,1,12,0,52,0,game posted lovely photo junk instagram v-day
1,1,10,36,2,9,0,46,0,kylie jenner's lip kim kardashian's butt
1,3,14,49,2,11,0,63,0,"kashmiri scholar threatened, forced leave bit pilani top story"
1,1,9,29,0,8,0,38,0,honest advice love body
1,1,13,36,2,12,0,49,0,"well know lyric ""love story"" taylor swift"
1,1,14,42,0,13,0,56,0,know zodiac sign based image ben wyatt choose
1,1,8,25,0,7,0,33,0,much earn working home
1,1,7,28,0,7,2,35,0,19 reason date someone short
1,1,11,42,1,11,0,53,0,malin akerman play world's hardest game would rather
1,1,12,38,3,11,0,50,0,"played hilarious game ""badu badon't"" erykah badu"
1,1,12,26,2,9,2,38,0,"11 time abby sciuto fashion icon ""ncis"""
1,3,15,62,1,14,0,77,0,coldplay's chris martin stop melbourne concert midway let guy propose girfriend
1,1,8,34,0,8,2,42,0,17 dessert guaranteed turn chocoholic
1,1,12,33,0,10,0,45,0,know favorite tv show based zodiac sign
1,1,14,40,4,13,0,54,0,"oh god, there's going ""friday night lights"" reunion texas"
1,1,21,60,1,20,0,81,0,guy made joke car's tape player iphone internet mocking
1,1,14,31,0,9,0,45,0,john boyega actually cutest part baftas
1,1,10,43,3,9,0,53,0,"here's beautiful detail ""notting hill"" probably missed"
1,2,6,54,1,11,0,60,0,cold war photo spark amazing coincidence reddit| latest news video
1,1,10,40,0,10,2,50,0,22 perfect valentine people time feeling
1,1,8,38,1,9,4,46,0,18 throwback fairy winkle toy '90s kid remember
1,1,6,25,0,5,0,31,0,career actually
1,1,10,38,3,10,2,48,0,"75 thought watching ""star wars: force awakens"""
1,3,16,68,8,16,0,84,0,fxs american crime story explore lewinsky sex scandal right-wing plot tear bill clinton
1,1,10,31,0,10,2,41,0,17 easy slow cooker soup warm right
1,1,4,19,0,3,0,23,0,awkward selfie stick prank
1,1,8,19,0,7,0,27,0,much anime otaku
1,1,11,41,0,10,0,52,0,happy birthday iconic carefree woman planet
1,1,16,28,3,11,0,44,0,"henry viii, edward vi, mary i, elizabeth"
1,2,0,46,0,9,2,46,0,10 way beat holiday stress fitness nutrition
1,1,11,32,0,11,2,43,0,23 photo way true hangover
1,1,9,29,0,9,2,38,0,17 thing black people deal daily basis
1,3,13,53,2,12,0,66,0,jennifer lawrence itchy butt almost killed someone 'hunger games' set
1,1,7,31,0,6,0,38,0,mad max furiosa tutorial kandee johnson
1,1,7,31,0,9,1,38,0,8 soup toddy save sick day
1,1,13,52,4,12,0,65,0,"cool throwback original ""mission impossible"" ""rogue nation"""
1,2,1,40,0,8,2,41,0,home 10 market selling like hotcake
1,3,11,38,0,11,2,49,0,29 product help organized home dream
1,2,2,54,3,10,1,56,0,8-year-old drive younger sister mcdonald's craving burger
1,1,10,34,0,11,6,44,0,27 important thing cat internet 2015
1,1,12,46,1,11,0,58,0,couple revealed baby's gender epic way possible
1,3,10,49,1,10,0,59,0,actress lisa edelstein us alan thickes death attack donald trump
1,1,7,19,0,7,2,26,0,25 thing forgot used
1,1,9,29,0,8,0,38,0,type candle light right
1,1,11,38,1,10,0,49,0,there's amazing new beauty box catering woman color
1,1,13,50,2,12,0,63,0,"fred armisen southern accent ""the tonight show"" impressive"
1,3,16,52,0,14,0,68,0,india may able buy defence equipment russia u sanction
1,1,14,40,0,13,0,54,0,cat hidden serious new york time photo obama
1,3,8,32,0,8,2,40,0,37 cleaning basic probably know
1,1,7,23,0,7,2,30,0,26 lazy brilliant way get drunk
1,3,13,66,0,12,0,79,0,trafficking victim studying become lawyer fight injustice others
1,3,14,57,7,13,1,71,0,fs1s cowherd slam sellout kaepernick: wheres courage youre free agent?
1,3,6,24,2,5,0,30,0,"sorry america, tax arent high"
1,3,9,40,5,11,0,49,0,watch dying marine trump general mattis: give em hell
1,1,9,38,2,9,2,47,0,"23 iconic professor snape moment ""harry potter"""
1,1,8,27,0,8,2,35,0,13 animal way gangster
1,2,9,48,1,11,2,57,0,goldman sachs alum turn virtual reality sell $57 million mansion
1,1,7,22,1,6,0,29,0,"diwali, explained brown dad"
1,1,4,19,0,3,0,23,0,long distance best friend
1,1,14,51,0,13,0,65,0,bronzers blush actually look amazing woman color
1,1,9,46,3,8,0,55,0,"director joseph kahn defends taylor swift's ""wildest dreams"" video"
1,3,3,31,1,7,0,34,0,india pakistan set water wars?
1,1,15,51,0,14,0,66,0,guy cosplays deadpool every year almost funny ryan reynolds
1,1,11,36,0,12,6,47,0,23 people absolutely idea 2015
1,1,13,42,1,12,0,55,0,guy's cheese vine perfectly sum silly daily mail
1,2,25,44,1,12,0,69,0,delingpole: noaa scandal give trump perfect excuse drain climate swamp
1,1,6,21,0,5,0,27,0,celebrity body part
1,2,1,38,3,6,4,39,0,"3,600 guest ghana's record-breaking dinner table"
1,1,8,39,2,9,6,47,0,"15 absolutely stunning wedding venue cost less $3,000"
1,1,7,30,0,7,2,37,0,27 weirdest celebrity picture time
1,1,8,37,0,8,2,45,0,27 cat picture life literally terrible
1,1,6,24,2,6,2,30,0,19 face recognise lazy
1,1,12,46,1,11,0,58,0,monkey india adopted puppy they're adorably inseparable
1,1,14,56,0,13,0,70,0,kristen bell dax shepard dancing africa restore faith love
1,1,9,41,2,9,2,50,0,"couple performed ""up"" theme 60th anniversary"
1,1,9,37,3,8,0,46,0,"remember halloween costume ""the office?"""
1,2,8,37,0,9,0,45,0,best luxury pot accessory high class smoke
1,3,16,56,3,16,0,72,0,"sonakshi sinha, brother take dig amaal armaan malik, get kickass reply"
1,1,10,38,0,9,0,48,0,facebook privacy notice going around total farce
1,1,10,33,0,10,2,43,0,26 time kim kardashian shut family
1,1,12,49,0,11,0,61,0,two appetizer must serve thanksgiving dinner year
1,1,6,30,0,7,6,36,0,12 sassiest anderson cooper comeback 2015
1,1,11,55,2,10,0,66,0,"inside china's memefacturing factories, hottest new gadget made"
1,1,17,58,2,15,0,75,0,"michael j fox christopher lloyd crashed ""jimmy kimmel live"" marty mcfly doc brown"
1,1,8,20,0,7,0,28,0,allowed dog
1,1,14,46,1,11,0,60,0,"omg, genius inflatable mattress save much money forever"
1,1,7,19,1,6,0,26,0,here's fry seafood home
1,1,8,30,1,8,2,38,0,22 question monster like dog
1,2,8,36,0,8,2,44,0,26 infuriating thing happen horror movie
1,2,4,60,2,9,0,64,0,"donald trump reference ""nazi germany"" tweet intelligence agency"
1,3,10,46,2,10,0,56,0,beauty blogger give mom cancer stunning makeover [video]
1,2,12,52,4,11,0,64,0,"many american 'believe' evolution, climate change vaccine"
1,1,8,26,1,6,2,34,0,17 thing people understand ocd
1,3,8,49,2,10,2,57,0,muslim mob rape 15 christian woman revenge attack conversion
1,2,9,45,1,10,0,54,0,"biggest change obamacare made, may disappear"
1,3,8,51,0,10,0,59,0,mom blasted encouraging toddler pole dance disturbing video
1,3,4,40,2,7,0,44,0,rice favor mean lean national security council
1,1,15,58,0,14,0,73,0,photoshopped away feature insecure happened
1,3,1,64,0,12,0,65,0,genetic makeup make online dating perfect men terrible woman
1,1,9,37,2,9,2,46,0,26 thing understand oldest child
1,2,16,51,2,16,5,67,0,"youth paid r 34,000 iphone, fraudster duped sending parcel full paper"
1,2,3,47,2,9,0,50,0,iraq 'witch hunt' lawyer phil shiner could avoid paying debt
1,3,4,26,3,7,0,30,0,"met fiancee tinder. yes, tinder."
1,1,7,33,0,7,2,40,0,22 struggle people zero athletic ability
1,1,9,30,0,9,2,39,0,12 acapella christmas song get mood
1,1,12,45,1,11,0,57,0,here's genius new tool actually help get perfect eyeliner
1,1,13,40,0,10,2,53,0,17 book lgbt character actually change life
1,1,10,32,1,8,0,42,0,guess non-princess disney gal said
1,1,13,32,0,12,0,45,0,turned flat goddamn ball pool
1,1,11,41,1,11,2,52,0,"sorry, 11 reason dudley dragon better barney"
1,3,12,39,2,12,2,51,0,"buy thing mansion, find youll live 10years"
1,1,6,27,0,5,0,33,0,thanksgiving christmas
1,1,11,55,2,10,0,66,0,"andrew garfield transformed one ""harry potter"" character another"
1,1,17,35,0,11,0,52,0,look wedding photo without yelling omg wtf
1,1,13,47,1,12,0,60,0,time talk recast dumbledore literally worst
1,1,6,22,0,6,2,28,0,27 professor got last laugh
1,1,7,22,0,7,2,29,0,19 thing woman love wine get
1,1,11,35,0,10,0,46,0,show u best handmade gift kid given
1,1,8,24,0,7,0,32,0,happens get drunk
1,1,11,20,2,9,0,31,0,"know tv show ""a"""
1,2,12,63,2,13,0,75,0,"illinois second grader adore school janitor, line get yearbook autographed yahoo"
1,2,4,47,2,9,1,51,0,five burning question 'stranger things' season 2
1,3,4,20,2,6,1,24,0,music box session #7 little cub
1,2,11,36,1,11,2,47,0,27 unique fun date idea youll wish thought offirst
1,1,5,34,0,5,2,39,0,17 people accidentally ruined thanksgiving
1,1,11,39,0,10,0,50,0,male rapper soulmate based zodiac sign
1,1,9,24,0,8,0,33,0,make top secret club
1,1,10,33,2,10,2,43,0,"17 piece oreo art beautiful ""mona lisa"""
1,2,4,17,1,6,4,21,0,2016: year canada fan
1,1,13,27,1,11,0,40,0,ja rule ashanti ja rule j.lo
1,2,3,72,2,13,2,75,0,sherlock season 4 episode 2 review: benedict cumberbatch's detective drama take dark turn
1,2,1,49,0,9,0,50,0,man washing massive monster truck mistaken plane crash
1,2,12,42,3,9,0,54,0,cnn crew caught joking donald trump plane crashing (video)
1,1,6,17,0,5,0,23,0,well match color
1,1,7,32,0,7,2,39,0,31 apartment hunting tip everyone need know
1,1,6,36,0,6,2,42,0,16 honest confession sexual frustation
1,1,8,36,0,7,0,44,0,new wonder woman movie officially look amazing
1,2,3,59,1,9,0,62,0,sun criticises newcastle's reporter blacklist special back page
1,1,12,38,0,11,0,50,0,selfie mindy kaling wearing pimple cream u
1,1,8,36,2,7,0,44,0,"""friends"" costume wear halloween"
1,1,8,24,0,8,2,32,0,13 sign might badass winter cat
1,2,0,40,0,6,1,40,0,9 surprising way meditation change brain
1,2,8,32,2,8,4,40,0,trump warns 'pocahontas' may run president 2020
1,1,11,30,1,9,5,41,0,"taylor swift donated 25,000 book nyc school need"
1,1,12,33,0,11,0,45,0,know name dog based sign
1,1,13,46,2,13,2,59,0,"23 reason ""the princess bride"" important movie life"
1,1,8,28,0,8,2,36,0,11 thing people anxiety want know
1,1,16,48,2,15,0,64,0,"craig david sang updated version ""fill in"" people really"
1,2,14,70,5,13,0,84,0,"trump pick enemy, accuses china currency manipulation. chinese medium say he's 'inexperienced'"
1,1,20,46,0,19,0,66,0,guy see one eye bought dog one eye one wanted
1,1,5,28,0,5,2,33,0,13 tech resolution everyone make
1,3,10,39,0,11,0,49,0,one kind trader well egypt pound weakens
1,2,16,51,3,13,0,67,0,american naval drone could tell u future u.s.-china relation
1,2,9,38,2,10,1,47,0,7 time shannen doherty inspired u never give [video]
1,2,9,37,0,9,0,46,0,new study cast doubt theory anne frank betrayed
1,1,10,32,1,9,0,42,0,act around friend vs. best friend
1,3,10,30,2,8,3,40,0,100-year-old man teach u leadership
1,3,14,64,2,12,2,78,0,thai man broadcast murder 11-month-old daughter live facebook committing suicide
1,1,8,24,0,7,0,32,0,powerful image world war
1,1,13,50,4,12,0,63,0,"kanye west's ""gold digger"" secretly predict he'd end kim kardashian"
1,1,16,54,0,15,0,70,0,five jet crew member suspended allowing sonu nigam sing flight
1,1,6,29,0,7,6,35,0,17 popular song lyric everyone misheard 2015
1,1,8,22,1,7,0,30,0,person's famous mom dad
1,3,13,58,2,13,0,71,0,"dj khaled planning something major chance rapper, justin bieber, migos"
1,1,8,42,0,8,2,50,0,19 clever appetizer guaranteed impress party guest
1,1,7,36,0,7,2,43,0,19 gross kitchen habit probably definitely
1,1,10,43,1,9,0,53,0,man take stunning photo saskatchewan's sky
1,1,10,44,3,9,0,54,0,"first photo ""gilmore girls"" reboot prof lorelai aged"
1,3,6,44,1,10,0,50,0,thought mike ashley hard work for? meet jennifer hardy
1,3,14,52,2,12,0,66,0,earning power: here's much top influencers make instagram youtube
1,2,3,50,1,10,0,53,0,revealed telegraph: mystery sherlock baby name
1,1,5,21,0,5,2,26,0,23 reason never eat breakfast
1,1,10,36,1,7,0,46,0,"ellen absolutely grilled ben higgins, aka bachelor"
1,2,5,73,2,13,0,78,0,scottish politician nicola sturgeon called dangerous woman britain
1,1,11,36,0,9,2,47,0,15 reunion destination college bffs agree
1,1,13,53,1,12,0,66,0,word association test tell realistic idealistic
1,1,8,23,0,7,0,31,0,get oscar oscar isaac
1,2,10,50,3,10,0,60,0,steve harvey reveals holiday plan new year resolution [video]
1,1,13,50,2,12,0,63,0,"college marching band shut amazing ""hello"" cover"
1,1,13,27,0,11,0,40,0,match iconic hat tv show film
1,1,6,26,0,6,2,32,0,27 subtle tasteful white ink tattoo
1,2,9,34,1,9,0,43,0,one trick let's add live photo instagram
1,1,13,46,2,13,2,59,0,"15 thing never knew cast ""pride prejudice zombies"""
1,1,14,41,3,14,2,55,0,"15 gary busey dance move can't wait see ""dancing stars"""
1,1,11,43,0,10,0,54,0,boyfriend man butternut squash wearing sunglass
1,2,5,21,1,4,2,26,0,grace vanderwaal's 10 best cover
1,3,8,29,0,7,0,37,0,ten simple habit get promoted
1,2,11,46,3,10,2,57,0,sweden: asylum seeker forced 10-year-old watch porn raping
1,3,8,39,1,8,0,47,0,fix iphone cable stylish waywith electrical tape
1,1,8,29,2,8,2,37,0,"17 food guaranteed excite ""star wars"" fan"
1,1,11,49,1,9,0,60,0,people took twitter share deeply personal #intersexstories
1,3,8,43,0,9,0,51,0,china investor see silver lining stock bond tumble
1,2,12,43,2,11,0,55,0,giving mood? write check charity without strategy
1,2,13,54,7,12,0,67,0,"beyonce-adele's powerful grammys' speeches, taimur ali khan's new pic ent!"
1,1,9,35,0,9,0,44,0,beautifully inclusive ad make ugly cry
1,2,7,68,2,16,1,75,0,ceo dippin' dot responded 5 year angry tweet trump's press secretary
1,1,12,39,4,11,0,51,0,"guess start cry ""it's wonderful life?"""
1,1,8,32,0,9,6,40,0,18 grilled cheese sandwich made u drool 2015
1,1,10,13,0,6,0,23,0,bf female bff
1,1,10,38,1,11,6,48,0,21 time 2015 neil patrick harris's family cuter
1,1,7,26,0,6,0,33,0,video game weapon
1,1,9,33,0,9,2,42,0,19 treat wish could eat lorelai gilmore
1,3,8,41,1,7,0,49,0,investigation drake thirst female comedian
1,1,4,9,0,3,0,13,0,han
1,3,10,43,0,9,0,53,0,got brave tried new starbucks fruitcake frappuccino
1,3,9,48,3,11,0,57,0,laura ingraham: left pushing protest hope powder keg moment
1,1,8,28,0,7,0,36,0,delicious ice pop get drunk
1,1,9,31,0,9,2,40,0,31 incredibly helpful tip hack new baby
1,1,8,38,0,8,2,46,0,16 time bollywood star gave intense vacation goal
1,1,8,30,0,8,4,38,0,proof steven tyler coolest grandma 2015
1,1,11,44,3,10,0,55,0,"we, two regular people, tried meal prepping here's happened"
1,1,10,25,0,10,2,35,0,27 little dog want good week
1,1,12,49,1,12,2,61,0,25 genius tweet guaranteed make laugh clueless sport
1,3,4,62,0,16,0,66,0,original story beauty beast lot darker think list
1,1,7,33,0,7,2,40,0,21 picture girl never understand
1,1,8,36,0,8,2,44,0,31 reason potato best thing thanksgiving
1,1,9,35,1,8,0,44,0,what's romantic movie scene involving meal
1,1,8,27,2,8,2,35,0,"15 reason link ""zelda"" perfect man"
1,3,9,40,3,11,0,49,0,"youre behind retirement savings, here catch"
1,1,10,29,2,9,0,39,0,"well remember lyric ""no scrubs"""
1,1,10,34,3,10,2,44,0,"23 time dr. lance sweet best character ""bones"""
1,1,6,20,2,5,0,26,0,booze vs. weed: superior
1,1,8,30,0,7,0,38,0,obsessed favourite band
1,1,11,32,0,10,0,43,0,way eating pumpkin pie
1,1,8,31,1,7,0,39,0,what's best place buy tomboyish clothing
1,1,7,33,2,7,2,40,0,"13 woman show ""unflattering"" outfit"
1,1,13,38,0,12,0,51,0,six guy inevitably danced club
1,1,7,31,2,6,0,38,0,"""friends"" character would clash"
1,1,9,36,0,9,2,45,0,26 genius tip keeping shit together college
1,1,6,26,0,6,2,32,0,23 insanely clever response ex text
1,1,9,34,0,8,0,43,0,sport would compete olympics
1,1,11,46,0,11,2,57,0,21 important reminder anyone went breakup year
1,2,15,48,2,14,0,63,0,youre wrong dont think chihuahua best dog goodearth
1,2,11,52,4,11,0,63,0,donald trump question sick guy barack obama wire tapping campaign
1,3,4,43,3,6,0,47,0,"snapchat's privacy standard lag google, facebook, apple"
1,1,8,24,2,7,2,32,0,19 time zac efron proved he's insta-god
1,1,8,27,0,8,2,35,0,26 fantastic gift gamer life
1,1,13,38,0,13,2,51,0,18 worst thing say someone life toronto
1,1,9,28,0,8,0,37,0,happens proposed
1,1,14,48,3,12,0,62,0,"jojo released ""say love"" video truly emotional experience"
1,1,10,37,0,10,2,47,0,13 time tina belcher harry potter person
1,2,3,43,2,9,4,46,0,"winter olympics: big air, mixed curling among new 2018 event"
1,1,8,24,0,7,0,32,0,demi lovato miley cyrus
1,2,12,41,1,13,2,53,0,chris long say visit white house honor super bowl 51 win
1,3,6,60,3,13,0,66,0,message bottle perfect christmas gift (paid content coca-cola)
1,1,10,40,0,10,2,50,0,23 tweet horoscope make laugh every time
1,3,7,34,0,7,0,41,0,donald trump think susan rice committed crime
1,1,10,49,0,10,2,59,0,19 time joey tribbiani perfectly summed relationship food
1,1,6,16,3,4,0,22,0,"""pac-man"" ghost"
1,1,7,21,0,6,0,28,0,guy friend get naked bare
1,1,12,53,0,12,1,65,0,phone notification would look like 8 million follower
1,2,3,71,3,17,0,74,0,"pakistan, five girl killed fun. story took even darker twist."
1,3,1,43,1,8,0,44,0,doctor's honest account losing first patient
1,2,1,44,1,9,0,45,0,able cryogenically freeze organ one day?
1,1,11,37,1,10,0,48,0,guess zodiac garbage person date
1,3,13,44,1,11,0,57,0,fourth-graders turned math lesson lit songever
1,2,1,73,3,15,0,74,0,"liquor sale dropped weed legal, people still go out, new analysis say"
1,2,14,56,0,14,1,70,0,woman help man abandoned mother reclaim life homeless 3 year
1,1,8,31,0,8,4,39,0,astonishing photo award 2015
1,1,11,34,1,10,0,45,0,here's happens mix beer mac cheese
1,3,4,59,0,15,0,63,0,rise donald trump isi common might think
1,3,12,48,1,11,0,60,0,"navjot singh sidhu join congress, get warm welcome rahul gandhi"
1,2,2,81,1,17,0,83,0,company make america's engagement ring plan open bunch store close even
1,1,13,34,1,10,2,47,0,18 secret astronaut nasa tell
1,1,14,41,0,13,0,55,0,chair lift broke banff skier rappel rope
1,3,7,25,2,8,0,32,0,siri ready super bowl you?
1,1,9,23,0,10,6,32,0,17 video made sob desk 2015
1,1,15,41,0,14,0,56,0,kid wore messi plastic bag shirt going meet hero
1,3,3,31,0,9,0,34,0,new cash clunkers could way
1,1,7,19,0,6,0,26,0,kardashian jenner
1,1,9,24,0,9,2,33,0,16 puppy cast cute hurt
1,1,12,53,0,11,0,65,0,woman us makeup make chilling statement gender stereotype
1,1,14,54,0,13,0,68,0,video dying dog nursed back health heartwarmingly beautiful
1,1,9,30,0,10,6,39,0,21 weirdest news story new jersey 2015
1,2,1,38,0,5,0,39,0,happens narcissist become parent
1,2,10,50,1,10,2,60,0,"24 illustration make really, really nostalgic school"
1,2,9,37,5,9,0,46,0,u.s. soccer star abby wambach: playing turf nightmare
1,2,2,42,2,7,1,44,0,5 gutsy highlight carrie fisher's one-woman show
1,2,5,27,0,5,2,32,0,23 actually hilarious joke aboutlying
1,1,12,41,0,10,0,53,0,holy shit guy look exactly like young leonardo dicaprio
1,1,11,32,0,10,0,43,0,know zodiac sign based thing like
1,2,11,41,4,8,0,52,0,brazil's tainted-meat probe worry world: quicktake q&a
1,3,4,34,1,4,0,38,0,remembering north korea's christian martyr
1,1,7,29,0,7,2,36,0,10 thing spanish major tired hearing
1,3,8,32,1,7,0,40,0,would hook historical hotties?
1,1,8,29,0,7,0,37,0,study final watch netflix
1,1,10,27,1,9,0,37,0,here's adopting pet best idea ever
1,1,13,44,1,13,3,57,0,child lost parent 9/11 sent powerful message hope paris
1,1,16,74,0,17,2,90,0,make 27 hilarious photo michael scott saying absolute wrong thing without laughing
1,2,4,45,0,8,0,49,0,elizabeth bank tapping red queen vein inspiration
1,1,12,56,0,11,0,68,0,one direction released heartbreaking new track upcoming album
1,1,13,41,0,11,0,54,0,match selena gomez music video youtube comment
1,1,10,26,0,9,0,36,0,well really know map canada
1,1,11,14,0,9,5,25,0,fan 5sos 1975
1,2,9,44,2,11,3,53,0,u.s. deploy 300 marine taliban hotbed train afghan soldier
1,2,10,40,0,10,2,50,0,10 amazing cooking hack make life way healthier
1,1,11,49,1,10,0,60,0,priyanka chopra's accent helping solve biggest identity crisis
1,3,8,33,2,8,0,41,0,can't people smell asparagus pee?
1,1,8,40,0,8,2,48,0,marceline vampire queen rank 13 favorite vampire
1,3,5,17,0,5,0,22,0,billionaire la la land
1,1,15,67,0,14,0,82,0,romanian photographer document beauty around world currently killing india
1,1,10,33,0,9,0,43,0,new song play repeat weekend
1,3,2,28,0,7,4,30,0,lion unleash new look 2017
1,1,14,51,1,13,0,65,0,there's part facebook profile might forgotten people see
1,1,7,31,0,7,2,38,0,24 orange cat adorable self
1,2,2,31,1,6,2,33,0,26 clichs middle-class christmas
1,1,12,31,1,11,0,43,0,like write hyped book year
1,2,4,60,0,10,0,64,0,michael moore reveals plan major protest donald trump inauguration
1,1,14,45,1,14,2,59,0,17 moment real anybody who's totally closet
1,2,15,63,1,14,0,78,0,acupuncture effectively treat chronic pain depression that's good news many
1,1,8,30,1,9,4,38,0,28 song early '00s forgot existed
1,2,11,37,3,10,0,48,0,rand paul: somebody go jail trump intel leak
1,1,14,41,0,13,0,55,0,new film capture life like two black men tottenham
1,1,10,46,0,9,0,56,0,hogwarts house random disney character belong
1,1,7,35,0,7,2,42,0,27 time nadia aboulhosn right everything
1,1,8,32,3,8,2,40,0,"14 time fiercely linda ""bob's burgers"""
1,2,16,61,1,16,1,77,0,shoe thrown punjab cm prakash singh badal election rally 5 story today
1,1,8,30,0,8,2,38,0,minor minor character 30 rock
1,1,6,27,1,5,0,33,0,what's worst audition horror story
1,2,11,50,3,9,0,61,0,"double-edged sword: home price keep rising, home inventory keep falling"
1,1,14,48,3,11,1,62,0,woman perfect response people body-shaming 8-year-old girl
1,1,7,27,0,7,2,34,0,15 awesome gift anyone love boob
1,3,5,26,0,5,2,31,0,16 sibling absolutelysavage
1,2,9,40,0,11,4,49,0,free wine fountain bold way wine change 2017
1,2,11,49,1,12,1,60,0,seattle jogger share 5 self-defense tip drew defeat rapist
1,1,13,39,0,12,0,52,0,spinach artichoke dip need life
1,3,3,46,1,9,0,49,0,paris unrest: banlieue youth see french state enemy
1,3,12,51,1,9,0,63,0,civic nationvoice: happens michelle obama surprise dc student
1,3,1,73,2,13,0,74,0,village vigilante informs illegally parked car dubbed 'prat' furious trader
1,1,7,24,0,6,0,31,0,mexican candy like
1,1,8,29,0,8,2,37,0,21 dog thankful best friend
1,2,9,38,2,10,0,47,0,ed sheeran's videos: vote favorite
1,1,10,35,3,10,2,45,0,"carrie bradshaw's 23 iconic line ""sex city"""
1,2,3,27,1,6,0,30,0,man president trump's ear
1,2,4,66,2,14,0,70,0,casey anthony trial dissected new documentary weekend. why?
1,1,12,31,0,11,0,43,0,name john green book cover art
1,3,4,29,1,5,6,33,0,america's richest entrepreneur 40 2016
1,3,9,38,0,9,2,47,0,listen 13 woman share powerful reason marched
1,1,12,43,0,11,0,55,0,know female disney character based zodiac
1,1,9,32,0,9,2,41,0,22 greatest thing ever happen snapchat
1,2,2,69,1,13,0,71,0,oscars: test knowledge iconic film role nearly went different actor
1,1,11,42,0,10,0,53,0,know future celebrity husband based birth month
1,1,9,39,1,9,2,48,0,18 picture prove small canada's population
1,2,8,32,0,7,0,40,0,three question ask quitting job
1,3,1,62,2,20,0,63,0,found sick bear cub faced choice let die risk life save it.
1,1,13,45,2,12,0,58,0,"asked couple try other's hobby pretty, pretty cute"
1,1,9,36,2,9,2,45,0,"23 ""parks rec"" question impossible answer"
1,2,3,35,2,6,0,38,0,brain can't remember color business insider
1,1,16,35,3,11,0,51,0,"""mr.robot"" cast gave u title sequence deserve nycc"
1,3,16,74,4,15,0,90,0,australia 'no country indians'. latest racial attack indian priest stabbed inside melbourne church!
1,1,12,30,4,10,2,42,0,"12 way ""today's special"" wtf kids' show ever"
1,1,8,47,0,8,2,55,0,14 deliciously insane way celebrate national cheeseburger day
1,1,17,43,4,12,2,60,0,"10-year-old wrote letter encouraging troop kill ""those isi fucks"""
1,1,10,34,3,9,0,44,0,"look rashida jones' ""flip rewind"""
1,2,5,23,0,5,1,28,0,7 home purchase worth splurge
1,2,8,31,0,9,0,39,0,jail time walk fame trump star smasher
1,2,12,49,2,12,0,61,0,greg ip: three economic puzzle less puzzling real time economics
1,2,1,63,1,11,0,64,0,friends' plan trick teacher identical haircut sweetest thing
1,3,9,38,1,7,0,47,0,democrat gutierrez blame chicago gun violence nra
1,1,13,51,2,12,0,64,0,"""pretty little liars"" hunk valentine based zodiac"
1,2,10,35,2,10,0,45,0,believe bad sh*t people say diet coke
1,1,8,37,0,8,2,45,0,16 thing one tell taking antidepressant
1,1,13,52,3,13,2,65,0,"41 thing probably know ""harry potter prisoner azkaban"""
1,1,12,48,1,11,0,60,0,veteran heartwarming response little girl's question
1,1,10,39,0,10,2,49,0,21 thing happen get drunk colleague
1,3,1,75,0,16,0,76,0,facebook term service force user tell site soon change phone number
1,1,11,40,0,10,0,51,0,know age based opinion disney villain
1,1,11,30,0,10,0,41,0,many animal want squad
1,1,11,44,2,10,0,55,0,"hogwarts house ""parks rec"" character belong"
1,3,5,59,2,11,0,64,0,martin luther king jr.'s daughter take pepsi one heartbreaking tweet
1,1,6,18,0,5,0,24,0,think might snap
1,1,7,26,1,6,2,33,0,10 life-changing thing try december
1,3,11,34,2,11,0,45,0,new year resolution? let u help stick
1,3,1,60,2,12,4,61,0,"survive 2017: believe protest, barricade uterus tax"
1,1,10,45,0,9,0,55,0,hilarious comic change see disney princess
1,3,11,43,1,11,0,54,0,"savage af kid start fire, take shot trump live television"
1,1,10,36,1,10,2,46,0,33 dress pocket gonna want wear right
1,3,7,31,3,8,4,38,0,"eight good thing happened 2016 (yes, really)"
1,1,8,27,0,7,0,35,0,sherlock holmes doctor
1,2,11,55,1,10,1,66,0,cox businessvoice: 7 way telecom technology futureproof business
1,2,10,47,1,10,2,57,0,15 hardest relationship question thatll really make youthink
1,1,9,44,0,9,2,53,0,impress fellow 90 kid fresh prince basketball jersey
1,2,4,35,0,8,0,39,0,weird name cia give hacking tool
1,1,9,44,1,8,0,53,0,probably applying sunscreen wrong entire life
1,3,7,27,3,8,0,34,0,lupe fiasco gizzle link 'jump' video
1,1,13,47,4,11,0,60,0,"according ""fantastic beasts"" muggles called muggles u.s"
1,3,1,37,0,7,0,38,0,teach sex education young offender
1,1,15,52,2,13,2,67,0,17-year-old built bridge underprivileged kid could get school safely
1,1,14,21,2,9,2,35,0,12 late night sex line ad made sfw [still nsfw]
1,2,12,48,0,13,0,60,0,bubba watson sink wild putt back turned hole u open practice
1,3,5,27,0,6,5,32,0,6 powerful personal finance trend 2017
1,1,9,35,1,9,2,44,0,39 weird thing find every british family home
1,1,10,43,0,9,0,53,0,actually remember disney channel show theme song
1,1,10,37,3,10,2,47,0,"'90s kid learn lyric ""macarena"" really"
1,1,10,35,0,9,0,45,0,meet brownie put brownie shame
1,2,9,46,0,11,1,55,0,6 craziest thing saw go inauguration weekend
1,1,11,36,0,10,0,47,0,new song listen repeat weekend
1,1,12,46,4,11,0,58,0,"people prove 'baby, cold outside' banned forever"
1,1,13,35,1,9,0,48,0,what's favorite book great lgbt lead character
1,2,2,60,0,11,0,62,0,woman share inspiring photo meth addiction list
1,1,9,43,3,8,0,52,0,"psst, free idea: let's stop sexualising underage bollywood kid"
1,3,3,51,1,10,2,54,0,top linkedin exec share best career advice 20-somethings
1,2,2,43,2,8,0,45,0,"randy howard, country singer, dy country song death"
1,2,3,22,1,3,0,25,0,hallmark queen christmas
1,1,12,35,0,12,2,47,0,15 tee shirt people put hot sauce hot sauce
1,1,6,25,0,6,2,31,0,17 people slayed eyeshadow game
1,2,9,47,2,9,0,56,0,mermaid instructor? canine masseuse? oddest hotel job earth
1,1,8,23,0,7,0,31,0,sign mom might cool
1,1,11,44,3,10,0,55,0,"""star wars"" films' blatant special effect change"
1,1,8,29,0,8,2,37,0,16 fairy tale cottage actually stay
1,1,5,19,0,5,2,24,0,11 weird thing brain
1,1,4,23,0,3,0,27,0,australian try japanese candy
1,1,6,47,0,6,2,53,0,21 hilariously unapologetic confession chipotle addict
1,3,3,64,3,13,0,67,0,money minute: paying student debt saving retirement come first?
1,1,10,32,2,9,0,42,0,"match quote ""full house"" character"
1,1,9,35,2,8,0,44,0,try guy ruin childhood (with weird costumes)
1,1,10,40,2,9,0,50,0,"people struggled eating disorder see ""fat"""
1,1,4,17,2,3,0,21,0,"blowing ""the leftovers"""
1,1,10,35,0,10,2,45,0,11 far gift stoner friend sure appreciate
1,1,4,28,2,4,2,32,0,"17 incredible ""degrassi"" fashion moment"
1,1,7,37,0,7,2,44,0,21 reason daniel norris absolute human perfection
1,1,9,31,1,9,2,40,0,20 face perfected love gossip
1,1,9,27,0,10,6,36,0,29 song totally forgot used love 2003
1,3,3,51,1,13,5,54,0,"knotts berry farm ride trap 21 people 100 foot air, official say"
1,2,14,38,5,12,0,52,0,cnns lemon chicago torture video: dont think evil
1,3,10,52,1,10,0,62,0,jack dorsey: current twitter pattern similar arab spring
1,1,6,18,0,5,0,24,0,feeling right
1,2,2,80,3,18,8,82,0,"vladimir putin admits 2016 difficult year, hope people become magician stop 2017 bad"
1,1,9,35,0,8,0,44,0,dress officially sexy halloween costume
1,1,17,55,0,16,0,72,0,woman love harry potter much buy book every country visit
1,3,8,28,3,6,0,36,0,dj khaleds baby winning instagram [video]
1,1,17,69,0,16,0,86,0,jimmy kimmel introduced famous julia robert bunch civilian also named julia robert
1,1,5,17,1,4,0,22,0,"brave you, actually"
1,3,13,67,1,13,0,80,0,huffpo remove article banning white men voting discovering author doesnt exist
1,1,13,49,0,12,0,62,0,moment starbucks barista deaf customer going viral
1,2,7,54,0,7,0,61,0,trump administration solicits border wall proposal contractor
1,2,11,47,0,10,0,58,0,building community way better career networking
1,1,7,30,2,6,0,37,0,"""south park"" character actually"
1,1,14,48,0,13,0,62,0,megan fox break instagram fast share adorable picture son
1,3,21,58,2,18,0,79,0,smitten sunny leone shoot 'laila main laila' srk damn real relatable
1,3,11,50,1,10,0,61,0,facebook post prof ridiculous womens clothing sizesare
1,1,5,17,0,4,0,22,0,weirdest fear
1,1,4,23,0,3,0,27,0,aggravating air travel mishap
1,1,8,24,0,7,0,32,0,many penis emojis
1,1,13,50,0,12,0,63,0,video make think twice wearing headdress coachella
1,1,12,49,0,11,0,61,0,orangutan rolling ground laughing make fucking day
1,1,10,37,2,11,6,47,0,"17 reason nadiya ""bake off"" best british person 2015"
1,3,1,29,1,5,0,30,0,woman's freedom teach u
1,1,10,34,1,8,0,44,0,jade little mix tried prank-call taylor swift
1,3,15,35,2,10,0,50,0,that's there's little diamond patch backpack
1,1,9,29,0,9,4,38,0,harry style justin bieber 2015
1,1,9,31,0,7,0,40,0,shondaland show actually
1,2,2,45,1,9,1,47,0,1st drug okd movement disorder caused certain med
1,1,9,37,0,9,2,46,0,12 animal christmas ornament cute word
1,2,16,57,2,16,0,73,0,movie tv show stream youre snowed today nyt watching watching logo search
1,2,8,35,3,8,0,43,0,nate silver: really liberal medium bubble
1,1,13,48,2,12,0,61,0,"candy carson singing ""national anthem"" thing need today"
1,2,1,47,1,9,4,48,0,woman reclaimed place fashion spotlight 2016
1,1,12,53,0,11,0,65,0,hundred indian posting selfies cow protest slaughter
1,3,11,52,2,10,0,63,0,"retirement questions, answered: keeping pace know"
1,1,11,45,3,9,0,56,0,here's selena gomez-justin bieber mashup waiting
1,1,11,37,0,10,0,48,0,identify disney princess blob color
1,1,11,32,0,11,2,43,0,16 picture make want move sri lanka
1,1,11,32,2,8,0,43,0,a$ap rocky coolest instagram ever seen
1,1,8,38,0,7,0,46,0,evil mythical creature match zodiac sign
1,3,10,32,2,7,4,42,0,mlb team's biggest 2017 early-season question mark
1,3,10,70,6,11,0,80,0,hillary spokesman: clinton campaign didnt appreciate profound impact breitbart effect
1,1,9,40,1,9,2,49,0,question '90s determine actual age
1,1,10,35,0,8,2,45,0,19 friendship bracelet bff seriously need
1,3,1,50,0,10,4,51,0,winner loser biggest state political battle 2016
1,3,10,36,0,10,1,46,0,9 thing elizabeth taylor taught u art love
1,1,14,50,0,13,0,64,0,jose bautista offered prize dressing like people went
1,1,15,42,3,12,2,57,0,89-year-old man tried stand-up comedy first time smashed
1,1,10,38,0,10,2,48,0,10 insanely delicious smoothy fuel trip gym
1,1,8,54,0,8,2,62,0,19 scrumptious thanksgiving casserole guaranteed impress guest
1,1,11,53,2,10,0,64,0,"american reveal funniest, bizarre experience they've india"
1,1,5,27,0,5,2,32,0,13 burning question ketchup lover
1,1,10,25,0,10,2,35,0,21 gift best friend also dog
1,1,12,57,0,11,0,69,0,carrie brownstein amy poehler spontaneously helped couple get married
1,2,7,46,0,7,0,53,0,california city pass unanimous resolution impeach trump
1,1,14,42,1,13,0,56,0,porn set look like people sex
1,1,10,24,1,7,0,34,0,hardest nhl logo quiz ever take
1,2,12,36,5,13,1,48,0,"young thug, 2 chainz, wiz khalifa pnb rock ""gang up"" new track"
1,1,5,15,0,5,2,20,0,17 dog demand cuddle
1,1,8,38,1,6,0,46,0,sign buzzfeed's crossword newsletter reminder
1,1,9,38,0,9,1,47,0,9 thing never knew fabulous angela bassett
1,1,8,42,1,8,2,50,0,17 embarrassing church horror story make cringe
1,1,9,32,0,8,0,41,0,tried flavoured lube happened
1,1,13,42,4,10,0,55,0,"lady gaga matt bomer's ""ahs: hotel"" bloody orgy choreographed"
1,2,1,31,2,4,0,32,0,champion 'unofficial countryside'
1,1,10,38,1,9,0,48,0,viola davis's daughter dressed mom halloween
1,3,8,47,0,8,0,55,0,father murder child facebook live committing suicide
1,1,10,37,0,10,2,47,0,15 hilarious tweet college life india
1,2,1,37,0,9,0,38,0,tap best bargain wine today
1,2,12,46,0,11,0,58,0,airbus reveals new modular cabin concept could change fly
1,2,15,56,2,14,0,71,0,shah rukh khan opinion woman empowerment everyone need read right now!
1,1,7,44,0,7,2,51,0,34 hilarious nickname chinese people given celebrity
1,1,13,45,0,13,4,58,0,disney parody biggest movie 2015 series cute film poster
1,1,18,66,0,17,0,84,0,someone need invent app play nickelback song stop stalking ex online
1,1,9,41,2,8,0,50,0,"""the force awakens"" character match zodiac sign"
1,1,8,27,1,5,1,35,0,9 painfully true sex-pectations v reality
1,1,12,36,2,12,1,48,0,"match season 5 ""gilmore girls"" quote said"
1,2,8,32,3,7,0,40,0,bay area public radio mourns obamas food legacy
1,1,10,51,1,10,2,61,0,20 creepily fascinating thing scotland yard's hidden museum crime
1,1,15,42,2,14,0,57,0,"like eat durian, stinky scary king fruit"
1,1,15,58,0,14,0,73,0,kardashians manipulated medium become famous family world
1,2,12,41,6,9,0,53,0,louis c.k. accused plagiarizing snl birthday clown skit (video)
1,1,12,53,1,11,0,65,0,flawless pic sofia vergara joe manganiello's honeymoon
1,2,12,50,0,11,0,62,0,hilarious dad taught twin daughter scare people hotel hallway
1,2,3,52,5,13,0,55,0,p.k. subban crashed street hockey game -- made young fan's day
1,1,15,56,0,14,0,71,0,food porn industry never huevos rancheros recipe
1,1,7,25,0,7,2,32,0,22 hero give eternal light
1,3,17,55,2,16,0,72,0,woman's viral poem powerful take happened bengaluru new year's eve
1,1,11,44,1,10,0,55,0,color test determine introvert extrovert
1,1,12,40,0,11,0,52,0,doc brown recorded special message back future day
1,2,12,55,0,14,2,67,0,richard sherman waited 11 month rip cam newton something last season
1,1,10,27,0,9,0,37,0,men bond film named like woman
1,1,8,24,2,7,2,32,0,19 snapchats people l.a. would send
1,2,9,27,1,8,0,36,0,guess dog lookingat?
1,2,7,82,1,17,0,89,0,girl net: leading uk sex blogger reveals maintaining anonymity helped lead mental breakdown
1,1,10,35,0,9,0,45,0,guess video game terrible summary
1,1,10,26,0,10,1,36,0,7 way style braid suck hair
1,1,9,23,0,8,0,32,0,talk show guest
1,1,12,44,1,11,0,56,0,here's glenn close want end stigma around mental illness
1,3,11,35,0,10,0,46,0,six record show one bradman
1,3,6,37,5,10,0,43,0,'star wars: last jedi' trailer: mean?
1,1,6,25,0,6,2,31,0,16 question kylie jenner
1,1,10,29,2,9,0,39,0,"cast ""the l word"" aged incredibly well"
1,1,8,30,0,8,2,38,0,21 tweet prove instagram worst
1,1,10,36,0,9,0,46,0,watch trans guy celebrate first chin hair
1,2,7,41,0,7,2,48,0,52 thing mildly thrill twentysomething grandma
1,1,11,32,0,11,2,43,0,15 way take leftover queso de bola next level
1,3,8,41,1,7,0,49,0,poll: george soros incredibly unpopular native hungary
1,1,9,37,0,8,0,46,0,woman removed healthy breast ovary
1,1,6,16,0,5,0,22,0,furiosa rey
1,1,8,35,0,8,2,43,0,23 thing girl small boob understand
1,1,7,16,0,8,6,23,0,21 time gay men got wrong 2015
1,1,11,25,1,10,0,36,0,know lipstick lip gloss fan
1,3,9,64,1,10,0,73,0,"burlesque dancer fired, investigated secret service trump assassination tweet"
1,1,10,44,0,9,0,54,0,know relationship status based favorite couple
1,2,14,62,0,13,0,76,0,doctor reveal stent maker striking secret hospital deal sell inflated price
1,1,9,35,0,9,2,44,0,11 awkward moment face holiday
1,1,12,45,1,11,0,57,0,quick question: beauty secret indian mum told
1,1,6,25,1,5,2,31,0,thing make 20-somethings feel old
1,3,9,37,2,8,0,46,0,think twice 'like' viral facebook post
1,3,1,29,0,4,0,30,0,dutch election explained tulip
1,3,14,61,2,14,0,75,0,"charisma, demonetisation more, modi wave stormed rival top story"
1,2,6,32,0,8,0,38,0,caitlyn jenner brooklyn high school
1,1,7,16,0,7,2,23,0,10 tip help get sleep
1,3,12,47,2,11,2,59,0,salary chronicles: changed industry instantly got $41k raise
1,1,12,45,1,11,0,57,0,identify film using half characters' face
1,1,8,30,0,8,2,38,0,21 time tumblr user helped feel less alone
1,1,5,17,1,5,2,22,0,22 hero wear cape
1,1,8,36,1,7,0,44,0,public service announcement: zayn snapchat
1,2,4,57,1,11,0,61,0,everyone else reacted theresa may's snap general election list
1,1,11,38,1,10,0,49,0,tell u craziest thing done impress crush
1,1,10,40,0,10,2,50,0,28 time naya rivera flawless person instagram
1,3,10,37,4,9,0,47,0,nancy pelosi: dont think democrat want new direction
1,1,10,34,0,10,2,44,0,22 time someone fucked hoped one would notice
1,1,12,49,1,11,2,61,0,26 asian beauty product totally spend hard-earned money
1,1,11,40,0,11,2,51,0,17 thing need know cutting calorie lose weight
1,1,11,44,3,9,0,55,0,"infographic make all-male ""vanity fair"" photo even worse"
1,1,11,38,1,10,0,49,0,here's favourite fall boy album say
1,1,9,44,1,8,0,53,0,here's dietitian actually eat healthy without going broke
1,1,8,32,0,8,2,40,0,17 time animal kingdom summed single
1,1,10,38,0,10,2,48,0,30 gooey delicious dip make freak nasty proud
1,1,7,43,0,7,2,50,0,23 heartbreakingly adorable amigurumi make
1,2,10,43,0,9,0,53,0,hilarious reason daniel radcliffe cast harry potter
1,3,12,52,2,9,0,64,0,vmwarevoice: making spirit bright: top mobility trend holiday season
1,3,7,43,1,7,0,50,0,three arrested woman rape livestreamed facebook
1,1,9,47,0,9,2,56,0,17 cosplayers get real importance fictional character
1,3,3,38,0,9,0,41,0,policeman dressed woman hide
1,1,6,23,0,7,6,29,0,21 people embraced weird 2015
1,1,6,20,0,5,0,26,0,christmas spirit
1,2,17,73,5,15,1,90,0,"8-month-old pak brother donates marrow save toddler sister's life bengaluru, becomes youngest donor ever!"
1,1,10,25,0,9,0,35,0,know song need hear right
1,1,11,46,1,11,2,57,0,favorite '90s cartoon character would look like real life
1,3,8,35,0,7,0,43,0,startup help green startup clinch deal
1,3,5,60,2,14,4,65,0,fashion award 2016: gigi hadid get emotional crowned model year
1,2,3,71,4,15,0,74,0,donald trump read book successful people read much
1,1,8,35,0,7,0,43,0,tinker bell actually worst disney character
1,2,5,37,1,8,0,42,0,texas gop elector announces vote trump
1,1,10,33,0,9,0,43,0,match katy perry song album
1,2,11,48,6,14,0,59,0,bloomberg sanctuary cities: law law obey law
1,3,1,39,1,9,0,40,0,"try obsess giant, fluffy cat"
1,1,8,45,0,8,2,53,0,11 greeting card desperately need canadian thanksgiving
1,1,11,28,0,8,2,39,0,34 time celebrity men gave u intense dilf goal
1,1,10,46,0,10,2,56,0,33 slightly unexpected awesome thing thankful
1,2,7,48,1,7,0,55,0,airport security checkpoint optical illusion business insider
1,1,5,16,0,4,0,21,0,suck flirting
1,1,6,27,0,7,6,33,0,13 favourite television moment 2015
1,3,10,48,2,9,0,58,0,here sasha absent president obamas farewelladdress
1,1,12,45,0,12,2,57,0,18 offensive thing ever happened swiss chalet
1,1,6,27,0,6,2,33,0,21 cat really regret decision
1,1,6,20,0,5,0,26,0,guy better boyfriend
1,1,11,28,2,10,2,39,0,26 time p.k. subban scored hat trick heart
1,3,3,64,3,17,2,67,0,tried 23andme's new genetics test know company caused stir
1,3,1,76,2,13,0,77,0,money pouring world's hottest investment product nearly record-setting pace
1,1,13,46,1,12,0,59,0,steph curry's new baby daughter blast first basketball game
1,1,8,35,0,8,2,43,0,19 passive aggressive note deserve damn medal
1,1,7,13,1,5,0,20,0,arthur d.w
1,1,5,23,4,4,0,28,0,"""durarara!!"" character"
1,1,5,21,0,5,2,26,0,17 mindblowing way eat bagel
1,1,14,47,3,11,2,61,0,23 thing understand low-key obsessed mac lipstick
1,3,2,62,5,15,0,64,0,there's tiny red button trump's desk here's happens press
1,1,5,23,1,4,0,28,0,what's fall romance forecast
1,3,1,70,0,18,0,71,0,woman washing hair less three time week first time decade
1,1,7,26,0,7,2,33,0,27 happy gift people love jamaica
1,1,10,34,1,10,4,44,0,favorite black celebs looked like 2006 vs.
1,2,8,26,0,8,2,34,0,16 ice cream cocktail need life
1,2,8,38,3,11,0,46,0,european union want build wall russia
1,1,5,17,0,6,6,22,0,14 hottest topic 2015
1,1,10,35,4,9,0,45,0,"zac efron wore ""bae watch"" shirt ""baywatch"" rehearsal"
1,1,9,38,1,9,2,47,0,17 reason jos. louis ultimate culinary delight
1,1,12,38,0,11,0,50,0,hot men taking shirt putting back
1,1,8,25,0,6,0,33,0,shondaland world belong
1,1,6,20,0,7,6,26,0,25 time ed miliband blessed u 2015
1,1,12,34,2,10,0,46,0,j.k. rowling tweet based zodiac sign
1,1,8,32,0,8,2,40,0,17 instagram photo every short girl relate
1,3,8,27,1,7,0,35,0,here's robot labor best everyone
1,1,6,31,0,6,2,37,0,36 sign actually deserve attention
1,3,12,44,4,13,0,56,0,mariah's 'all want christmas you': gift keep giving
1,2,1,44,3,7,0,45,0,"princeton cancel men's swim season ""vulgar"" post"
1,1,10,40,1,9,0,50,0,kid's demonstration perfect pitch blow away
1,3,8,38,0,9,0,46,0,secret service put atlantic blast fake news
1,3,14,57,5,13,0,71,0,"walking dead t-shirt deemed 'racist' pulled stores, fan pleased"
1,3,5,56,4,13,0,61,0,"time saudi arabia: even boris johnson get right, he wrong"
1,3,7,42,1,6,0,49,0,ten incredible picture showcase astronomy's future
1,1,9,34,1,8,0,43,0,internet freaking woman's shirt
1,3,10,36,0,10,2,46,0,26 thing hospital true fornurses
1,3,13,46,2,11,1,59,0,"7 earth-size planet orbit dwarf star, nasa european astronomer say"
1,1,10,60,2,9,0,70,0,"madeleine albright remembers awesomely weird ""gilmore girls"" guest appearance"
1,3,9,40,1,8,4,49,0,2017 nfl draft: predicting landing spot every quarterback
1,1,12,33,0,11,0,45,0,couple find story met add
1,1,8,20,2,8,3,28,0,"lola zoey ""zoey 101"""
1,1,12,33,2,11,0,45,0,"rihanna drake cute ""work"" video hurt"
1,1,8,26,2,7,0,34,0,"airbnb ""netflix chill"" utopia"
1,1,9,28,3,8,0,37,0,"black twitter chill ""the wiz live!"""
1,1,7,23,0,7,1,30,0,7 sign grew brother
1,1,8,39,0,8,2,47,0,12 crazy delicious recipe feed avocado obsession
1,1,7,30,0,7,2,37,0,37 thing donald trump probably today
1,3,6,78,1,17,0,84,0,trump truck: u president health care bill pulled congress floor
1,1,10,38,0,9,0,48,0,kendall jenner posed topless look like goddess
1,1,12,37,0,11,0,49,0,depending look scientology great year
1,3,13,73,12,15,0,86,0,"mike barnicle: delegitimization presidency taking hold now, like, trump president? really?"
1,1,11,42,0,10,0,53,0,amazing african baby name make want conceive
1,3,8,52,1,11,5,60,0,college football 2017: projecting record every power 5 conference team
1,1,10,38,0,9,0,48,0,need talk fucking delicious empanadas
1,3,5,18,3,4,0,23,0,maher: trump mentally ill
1,3,12,47,3,11,0,59,0,photo series document life china's 'left behind' child
1,1,16,51,2,13,0,67,0,"fyi, there's man kolkata supply america drug execute criminal"
1,3,8,28,0,9,6,36,0,10 city worker earn least 2017
1,1,8,29,0,8,2,37,0,18 booty call confession real
1,1,10,50,0,10,2,60,0,24 euphoric experience anyone slightly obsessed cooking
1,3,1,67,2,14,2,68,0,1.8 million teen reading book text message thanks start-up
1,1,8,42,1,8,2,50,0,14 beautiful powerful picture mumbai's pride parade
1,1,13,20,0,8,0,33,0,people ride io hawk first time
1,1,12,25,2,10,0,37,0,"ok, time vote: song summer"
1,3,14,54,6,12,0,68,0,philippines: duterte appointing u.s. envoy dont feel like sending one
1,1,10,37,0,9,0,47,0,guess personality based favorite dog
1,1,7,39,0,6,0,46,0,disney character sparked sexual awakening
1,1,15,47,1,15,3,62,0,guess happens try eat 50 mcdonald's nugget 5 minute
1,1,9,35,0,9,2,44,0,21 time seth rogen spat hilarious truth twitter
1,1,12,36,1,11,0,48,0,actually like live anxious person
1,1,9,24,0,10,6,33,0,16 dude still going single 2016
1,1,11,41,0,11,2,52,0,20 time aidy bryant literally cutest person world
1,3,13,43,0,10,2,56,0,19 amazingly delicious sweet subscription box sign asap
1,2,1,56,1,10,0,57,0,bionic leg smart slacks: exoskeleton could enhance u
1,2,13,30,1,14,9,43,0,11 job pay $100k best place work 2017
1,1,10,40,2,10,2,50,0,"16 thing every ""star wars"" fan need successful christmas"
1,3,7,46,0,8,0,53,0,hundred islamic state volunteer returned britain
1,2,10,49,2,10,0,59,0,"video: woman freed islamic state burn face veils, smoke cigarette"
1,1,12,46,2,12,2,58,0,17 photo see curious cuba's actually like
1,1,9,27,0,8,0,36,0,app best thing comic reader
1,3,16,48,2,10,0,64,0,cbs offer pathetically slimy correction milo white nationalist lie
1,1,10,45,0,9,0,55,0,picture association test determine true inner age
1,1,8,23,0,8,2,31,0,13 kid wayyy swag
1,1,15,69,4,13,0,84,0,"christopher walken reading edgar allan poe's ""the raven"" make literary-loving heart explode"
1,1,14,34,0,12,0,48,0,dog practicing prancing front tv cute
1,1,5,15,0,4,0,20,0,would text back
1,1,5,12,1,3,0,17,0,sign broke af
1,1,7,24,0,6,0,31,0,good spelling actually
1,1,13,37,1,11,2,50,0,29 wtf look victoria's secret fashion show
1,1,12,46,2,11,0,58,0,"remember detail first episode ""gilmore girls"""
1,3,2,43,0,9,0,45,0,united airline hate result new poll
1,3,7,31,3,8,0,38,0,dan savage: melania trump ugly inside
1,1,8,41,0,8,2,49,0,19 kardashian pregnancy moment way relatable
1,3,17,41,0,16,2,58,0,27 name never name kid unless want huge db
1,1,6,29,0,6,2,35,0,21 thing picky eater understand
1,3,3,60,2,11,0,63,0,theyll home christmas: five homeless child get holiday surprise
1,3,7,29,3,10,0,36,0,daily: rise far right europe
1,1,8,36,2,7,0,44,0,"rainbow bagel store shut ""indefinitely"""
1,1,13,53,2,12,0,66,0,"occupation ""the bachelor"" actually life"
1,1,12,34,2,11,2,46,0,"17 time schmidt ""new girl"" best character tv"
1,1,15,46,3,14,0,61,0,here's find uber passenger rating (if really want know)
1,1,13,45,1,12,0,58,0,making wrong thing rice cooker entire time
1,1,10,36,0,9,0,46,0,people drink coffee digested animal
1,2,7,34,2,9,4,41,0,blasting 2017: whats star space travel
1,1,4,14,1,3,0,18,0,people swear
1,3,7,37,3,7,0,44,0,"mexico, syria, trump: wednesday evening briefing"
1,2,1,45,0,8,0,46,0,messy psychology awkward personal text
1,2,0,52,0,11,1,52,0,8 apps help improve mental physical health
1,2,9,33,1,8,0,42,0,kendall jenner falling literal head?
1,2,7,35,2,7,0,42,0,roommate wanted. trump supporter need apply.
1,1,7,33,0,7,2,40,0,28 time tumblr told truth hypochondria
1,3,6,27,0,5,0,33,0,rising interest rate affect bond
1,3,6,31,0,6,0,37,0,sugar helped hook america cigarette
1,1,13,41,0,12,0,54,0,remember headliner opening act
1,1,10,31,1,8,2,41,0,24 miss j. alexander reaction gifs situation
1,3,6,39,4,7,0,45,0,geraldo rivera: nordstroms stabbed ivanka back
1,1,9,32,1,8,0,41,0,what's best college drunk food spot america
1,1,10,47,0,10,2,57,0,18 steampunk tattoo transport alternate universe
1,1,11,62,1,10,0,73,0,"photo perfectly capture extreme, exhausting life amateur bodybuilder"
1,2,12,60,2,15,0,72,0,american airline unveils cheaper ticket big catch: here need know
1,1,8,29,0,8,2,37,0,name last 15 world series champion
1,1,16,63,2,15,0,79,0,"someone made video comparing indrani mukerjea case plot point ""game thrones"""
1,1,7,44,0,6,0,51,0,urban dictionary definition motivational poster
1,1,7,26,0,7,2,33,0,18 cat happy
1,1,11,43,2,11,2,54,0,"26 way world different ""twilight"" came life"
1,1,6,24,0,6,2,30,0,17 reason halloween kind suck
1,2,3,42,0,9,0,45,0,train row almost pull kosovo serbia rail
1,1,9,38,0,9,2,47,0,23 greatest thing ever happened facebook
1,1,7,18,0,6,2,25,0,22 people smooth af
1,1,3,19,0,2,0,22,0,skeleton makeup tutorial
1,1,4,20,0,4,2,24,0,25 movie unsimulated sex
1,1,8,27,2,7,0,35,0,"well remember ""a christmas story"""
1,1,7,32,1,7,2,39,0,24 thing find every hipster restaurant
1,2,9,33,0,9,2,42,0,19 sean spicer tweet really make youthink
1,1,5,11,3,4,0,16,0,"i'm muslim, i'm"
1,3,1,72,1,17,0,73,0,teenager walking hour work police stop changed life
1,1,8,37,0,7,0,45,0,guess much extravagant wedding really cost
1,1,10,30,0,10,2,40,0,15 best way actually dress body type
1,1,10,31,0,10,4,41,0,2015 slang term based zodiac sign
1,1,9,30,0,8,0,39,0,know original name famous brand
1,1,7,31,1,7,2,38,0,23 people who've done job beautifully
1,2,7,35,0,7,0,42,0,confidence high economic gain elusive
1,1,8,22,0,7,0,30,0,pick right slice pizza
1,3,8,32,1,8,2,40,0,"18 picture make student laugh, thencry"
1,1,9,31,0,8,2,40,0,25 sign bodypump rapidly taking life
1,3,12,67,0,13,0,79,0,hill remove article islam lindsay lohan pressure islamic advocate
1,1,9,33,0,8,0,42,0,well really know chocolate chip cooky
1,1,11,37,0,11,2,48,0,17 picture real people hate group chat
1,1,9,25,2,8,0,34,0,"well know ""the devil wear prada"""
1,1,7,23,0,6,0,30,0,worst way get caught cheating
1,2,2,56,0,11,0,58,0,new cookie causing seriously weird side effect list
1,2,9,34,2,8,0,43,0,everything need know 'dragon ball super'
1,2,12,53,1,10,0,65,0,"usf basketball team accidentally leaf troy holston, geno thorpe airport"
1,1,10,48,0,10,2,58,0,23 ridiculously hilarious rumour went around school
1,1,9,23,0,8,0,32,0,know disney movie food
1,1,11,43,0,10,0,54,0,story alan rickman rupert grint bonding lovely
1,2,11,51,3,11,0,62,0,deadly attack near u.k. parliament; car plow victim westminster bridge
1,1,10,38,0,9,0,48,0,couple famous musical match love life
1,1,14,50,1,13,0,64,0,watch kendall kylie jenner pretend karaoke friend's music video
1,1,11,24,1,11,2,35,0,would survive day life '90s kid
1,3,2,45,1,9,0,47,0,republican health plan mean taxes?
1,1,13,43,0,13,1,56,0,9 disney movie would much better set scotland
1,1,6,24,0,5,0,30,0,people review new barbie body
1,1,11,36,0,10,0,47,0,broadway stage musical movie musical
1,1,9,49,0,9,2,58,0,19 incredibly satisfying picture people really love eyeliner
1,1,10,51,3,9,0,61,0,celebrity read mean tweet themselves: music edition (part three)
1,1,7,23,1,6,0,30,0,"ferrell new, badass santa"
1,1,9,31,0,9,2,40,0,21 animal embarrassing mom
1,2,11,40,0,10,0,51,0,actually teach employee great attitude
1,1,14,40,0,14,2,54,0,take look back biggest black friday toy past 20 year
1,1,14,46,3,13,0,60,0,"wounded veteran's service dog best man, it'll make bawl"
1,1,12,45,1,12,2,57,0,21 tweet way real anyone who's obsessed instagram
1,1,9,31,0,9,2,40,0,25 spectacular fast food fails time
1,1,10,42,1,10,2,52,0,27 time adele proved actually realest celebrity
1,1,21,65,0,20,0,86,0,know picture billy ray cyrus want get framed mantel based one question
1,3,3,59,1,11,0,62,0,app want warn undocumented immigrant raid trump's america
1,1,14,52,0,13,0,66,0,mall santa everything could make autistic child feel comfortable
1,1,5,14,0,4,0,19,0,lego piece
1,1,6,21,0,7,6,27,0,25 drab celebrity look 2015
1,1,7,32,0,6,0,39,0,bang make celebrity bangable
1,3,3,59,4,13,0,62,0,"first trailer new 'spider-man' reboot here, look awesome"
1,3,8,26,0,8,2,34,0,keep working 60 beyond
1,1,10,40,2,9,0,50,0,"final three houseguest win ""big brother"""
1,1,5,19,0,4,0,24,0,average actually
1,1,7,23,0,6,0,30,0,many cuban dish tried
1,1,6,25,0,7,6,31,0,20 celebrity made difference 2015
1,1,11,40,5,9,2,51,0,"31 behind-the-scenes photo ""grease: live"" might missed"
1,1,9,28,0,8,0,37,0,well actually see color yellow
1,1,8,33,1,8,2,41,0,23 beach believe actually exist india
1,1,7,46,0,7,2,53,0,19 heartbreaking confession addicted instagram
1,1,6,29,1,5,0,35,0,profile nightmares: evil clown
1,1,12,44,3,12,2,56,0,"39 thing probably know ""back future"" trilogy"
1,1,16,50,0,15,0,66,0,really hot guy look like love child zayn liam one direction
1,1,6,22,0,5,0,28,0,emotional logical
1,2,5,31,2,6,1,36,0,'game thrones' season 5 finale prediction
1,1,18,47,1,17,0,65,0,dog riding bike helmet cutest damn thing see day
1,3,5,34,1,7,4,39,0,billboard music awards: photo 2017 nominee
1,1,11,46,0,10,0,57,0,identify premier league footballer eye
1,1,10,31,1,9,0,41,0,jason biggs' apple pie legacy life son
1,1,8,40,2,8,2,48,0,"21 time ""gilmore girls"" cast redefined friendship goal"
1,1,7,22,3,7,2,29,0,"23 picture make say ""huh."""
1,3,9,22,0,8,2,31,0,29 way make home look elegant af
1,3,9,25,0,8,0,34,0,learned draw black people likeme
1,1,9,28,0,10,6,37,0,24 picture show 2016 terrible start
1,1,12,45,0,12,2,57,0,17 people simple thing restore faith humanity
1,1,12,41,2,11,0,53,0,"belong chuck bass nate archibald ""gossip girl"""
1,1,9,25,0,8,0,34,0,drake got new tattoo honor toronto
1,1,12,37,0,11,0,49,0,know taste men based one horror movie question
1,1,10,42,1,9,0,52,0,john legend kissing chrissy teigen's baby bump couple goal
1,1,13,36,1,12,0,49,0,here's best cement ad ever see whole life
1,2,8,37,1,7,0,45,0,watch live: white house welcome new england patriot
1,3,2,63,0,12,0,65,0,watch people face greatest fear put iphone underwater purpose
1,1,9,30,3,7,0,39,0,"character ""uta prince-sama"""
1,1,15,45,3,14,0,60,0,"boston man yelling ""sea monstah"" best thing see today"
1,1,8,19,1,7,0,27,0,what's best song sex
1,1,8,14,0,7,0,22,0,tell wig
1,3,6,35,2,6,0,41,0,duke approves safe space illegal immigrant
1,1,9,27,1,9,2,36,0,guess early '00s song lyric
1,1,8,29,0,7,0,37,0,regina george lord voldemort
1,3,1,45,3,9,0,46,0,internet fault youre jerk politics
1,3,10,48,4,10,2,58,0,report: trump could roll back $1.7 billion worth dodd-frank regulation
1,1,10,35,0,9,0,45,0,real housewife based birth month
1,1,12,46,2,11,0,58,0,"know favorite holiday song based favorite ""frozen"" song"
1,1,5,16,0,4,0,21,0,hottest sock tech
1,1,14,57,1,13,0,71,0,here's everyone reacted jennifer lawrence amy schumer golden globe
1,1,10,39,0,10,2,49,0,13 thing learned decided start eating vegetable
1,1,10,39,4,9,0,49,0,"here's justin bieber's ""sorry"" video fucking amazing"
1,1,12,44,3,10,0,56,0,"conan o'brien shared touching remembrance david bowie ""conan"""
1,1,10,41,1,10,2,51,0,23 struggle people wear contact lens never get
1,1,10,43,0,10,2,53,0,22 karl pilkington quote perfect instagram
1,1,11,38,0,11,2,49,0,24 hilarious tweet food story life
1,1,8,33,0,7,0,41,0,picture test reveal ideal partner
1,1,10,44,1,10,2,54,0,14 picture everyone who's indian wedding recognise
1,3,10,43,0,9,0,53,0,someone obsessed christmas movie pas thisquiz
1,1,8,27,1,8,2,35,0,19 way know friend teacher
1,1,4,25,0,4,2,29,0,27 woman sexily consuming chocolate
1,3,8,29,1,7,0,37,0,there fragrance smell like fear
1,1,9,25,0,8,0,34,0,everyone go ikea food
1,3,3,50,0,11,1,53,0,8 ted talk change think human psychology
1,1,12,49,1,11,0,61,0,meet one filthiest female character see onscreen year
1,3,2,28,3,4,0,30,0,'golden girls'-inspired caf open
1,1,12,55,0,11,0,67,0,artist behind iconic disney film drawing virtual reality incredible
1,3,3,87,6,19,0,90,0,cant beat me!: dutch beatbox champion challenge baby niece join hilarious result
1,1,5,18,0,5,1,23,0,8 weird thing gamers
1,1,10,33,0,9,0,43,0,famous alien based zodiac sign
1,3,3,50,0,9,0,53,0,likely reason three lion decapitated south africa
1,1,14,44,1,13,0,58,0,"get slow cooker out, rib going make happy"
1,1,6,11,0,6,6,17,0,27 best tv quote 2015
1,3,2,43,2,10,0,45,0,well know world's religions? take quiz
1,2,1,45,0,9,0,46,0,unsecured car fall back moving ferry water
1,3,1,63,1,10,0,64,0,holiday travel season come end series head-scratching incident
1,3,9,38,0,9,2,47,0,19 thing make solo travel little less intimidating
1,3,6,55,5,12,0,61,0,oscar-nominated score 'moonlight' 'la la land' came together
1,1,8,38,2,7,0,46,0,"answer obscure ""friends"" trivia question"
1,3,15,54,1,14,2,69,0,ranking every ex-boyband song last 20 year really awful really great
1,1,8,30,0,8,2,38,0,17 sign may actually addicted hajmola
1,1,8,40,0,8,2,48,0,14 question british people french language
1,1,4,19,0,3,0,23,0,thought pedicure
1,3,1,75,4,19,0,76,0,stock 'rare state' here's happens get expensive right
1,3,10,29,2,10,2,39,0,going pas quiz 30
1,1,8,26,2,8,2,34,0,"22 reason ""love actually"" good movie"
1,1,9,40,0,9,2,49,0,15 phrase basically sex socially anxious people
1,3,2,59,0,12,0,61,0,dog valiantly trying catch toy get photoshop battle deserves
1,3,13,46,0,9,0,59,0,two mtsu football player suspended puppy abuse video surface
1,1,9,40,0,9,2,49,0,24 breathtaking spot need visit western australia
1,2,10,47,1,10,0,57,0,"gabby giffords, mark kelly target arizona new gun control group"
1,1,8,35,0,7,0,43,0,know bodily fluid match personality
1,1,12,40,0,11,0,52,0,much would chris traeger like based zodiac sign
1,1,7,28,0,6,0,35,0,recent album accurate title
1,1,5,15,2,4,0,20,0,breaking up: woman vs. men
1,1,9,39,0,8,0,48,0,disney princess allergy make cry
1,3,10,44,1,12,0,54,0,see world greatest place one month flying cruise
1,3,10,34,3,8,5,44,0,2017 nfl mock draft: matt miller's final 7-round prediction
1,1,9,31,1,8,2,40,0,surefire 59-step plan avoid star war spoiler
1,1,12,40,1,9,0,52,0,celebrated thanksgiving celebs ama's red carpet
1,1,10,20,0,9,0,30,0,know pair white van
1,1,11,38,0,10,0,49,0,actually live based taste pizza
1,1,12,53,0,12,2,65,0,23 heartbreaking hilarious thing people wish could say bully
1,1,10,29,0,8,0,39,0,identify uk airport air
1,1,16,59,4,15,0,75,0,"people complaining ""the wiz"" seem forgotten ""the wizard oz"" exists"
1,1,10,41,0,10,2,51,0,21 time internet super accurate aunt uncle
1,1,8,36,0,8,1,44,0,9 disney character whose contouring game point
1,3,5,81,4,14,0,86,0,"donald trump could banned twitter, company says, president-elect's facebook probably safe"
1,1,8,30,3,8,2,38,0,"27 funniest moment ""whose line anyway?"""
1,3,11,39,4,10,0,50,0,that's said: steve carell trolled 'office' fan bad
1,1,9,37,1,8,0,46,0,identify celebrity face
1,1,13,40,0,12,0,53,0,country singer make music game boy spare time
1,3,6,23,0,5,0,29,0,city worker flocking
1,1,10,23,3,8,0,33,0,"would die ""scream: tv series"""
1,1,11,42,1,11,2,53,0,'90s fashion trend bring back based zodiac
1,3,12,44,0,11,0,56,0,dallas cowboy fan get best revenge dumped text
1,1,10,48,2,8,2,58,0,27 ridiculously weird thing kid actually got trick-or-treating
1,3,8,48,2,10,0,56,0,u michigan professor claim english language sexist
1,3,15,60,0,12,0,75,0,two female ptv anchor get banned voicing opinion workplace harrasment
1,1,4,21,0,7,1,25,0,peel apple 3 second
1,2,2,56,4,11,0,58,0,"scott pruitt's signature read 'penis' no, exaggerating"
1,2,14,55,1,13,0,69,0,"tamil nadu farmer protest, arm racket busted delhi must read story"
1,1,13,34,2,12,0,47,0,amber rose's world we're lucky living
1,1,11,42,0,10,0,53,0,know favorite dog breed based random question
1,1,11,35,2,10,0,46,0,"planet ""star wars"" galaxy would hail"
1,2,4,54,6,9,0,58,0,syfy's 'the magicians' 'some g*ddamn magic' brooklyn installation
1,1,12,41,0,11,0,53,0,solve tricky tribute puzzle classic board game
1,1,2,9,0,2,1,11,0,9 period hack
1,1,10,42,0,9,0,52,0,celebrity around world paid tribute david bowie
1,1,7,33,1,7,2,40,0,19 sign slightly obsessed cabin sock
1,1,12,38,1,11,0,50,0,"open letter taquero, greatest human world"
1,3,3,55,2,12,0,58,0,"eve royal ascot, racing world attention turn new doping fear"
1,2,8,39,0,8,0,47,0,happened venezuela outlawed currency
1,1,13,44,2,13,2,57,0,"cat spent 17 year ""rodent control officer"" aboard famous ship"
1,3,18,60,1,16,1,78,0,"trailer jagga jasoos, arshad warsi congratulates akshay jolly llb 2 ent"
1,1,6,19,0,6,4,25,0,much accomplish 2015
1,1,6,32,1,6,2,38,0,here's 10 people visualize depression
1,1,9,29,0,9,2,38,0,13 chart perfectly sum big butt
1,3,6,26,1,6,0,32,0,great mystery behind tesla rally
1,1,14,37,1,11,0,51,0,"omg guys, dress version mermaid pillow"
1,1,11,37,1,10,2,48,0,17 free way make grown-up apartment freaking cozy
1,3,12,48,1,9,2,60,0,jpmorgan chasevoice: 10 digital marketing tip small business owner
1,1,14,61,0,13,0,75,0,indian dancer sex reassignment surgery live boyfriend pakistan
1,1,14,49,0,13,0,63,0,drake dancing bollywood music best thing internet right
1,1,8,31,2,7,0,39,0,"character ""the good dinosaur"""
1,2,13,75,2,13,0,88,0,student claim suspended challenging muslim professor teaching jesus wasnt crucified
1,1,9,41,1,9,1,50,0,hailee steinfeld reveals 6 way learned love
1,1,9,38,2,9,1,47,0,"remain calm chris pine teased ""princess diary 3"""
1,3,11,33,2,9,3,44,0,ufc 210 cheat sheet: daniel cormier vs. anthony johnson ii
1,1,12,29,0,12,6,41,0,15 tv show movie came back dead 2015
1,1,14,37,3,13,0,51,0,"here's cast ""the fresh prince bel air"""
1,1,8,26,2,9,6,34,0,"17 time ""game thrones"" fan freaked 2015"
1,1,15,44,0,14,0,59,0,grant gustin else done looking hot beanie
1,3,1,62,1,10,0,63,0,bark help parent monitor kids' online activity preserve privacy
1,1,9,49,1,9,2,58,0,13 annoying little problem trans woman expect transition
1,2,1,37,0,8,1,38,0,personal spending jump 3 month
1,1,11,43,4,9,0,54,0,people got facial extractions....and pretty gross
1,3,8,30,0,8,2,38,0,19 disney movie paused rightmoment
1,2,4,59,0,10,0,63,0,carpool karaoke christmas special come glorious festive twist
1,1,8,28,0,7,0,36,0,hilary duff hillary clinton
1,1,10,32,3,10,2,42,0,"time jackie kelso kissed ""that 70's show"""
1,1,12,29,1,7,0,41,0,alert: pierce brosnan looking hotter ever
1,3,11,28,3,8,0,39,0,tiffany co.: trump tower killing business
1,1,12,35,2,10,1,47,0,puppy tested new bb-8 toy everything need
1,1,12,42,1,11,0,54,0,"rihanna talk chris brown, think rachel dolezal kind hero"
1,3,11,34,1,8,3,45,0,watch: 400 migrant storm spanish enclave north africa
1,1,9,33,2,9,2,42,0,20 thing understand ever anal sex
1,1,9,32,1,8,1,41,0,9 bearded guy slayed no-makeup makeup look
1,1,14,54,0,13,0,68,0,justin bieber might revealed recent song selena gomez
1,1,7,31,0,7,2,38,0,31 stocking stuffer every harry potter fan
1,1,13,47,1,13,2,60,0,14 struggle every person who's last friend get married
1,3,11,36,0,11,1,47,0,8 pair sock probably drawer right
1,2,8,47,0,7,0,55,0,cardiologist prescribing mindfulness heart health
1,3,1,32,0,7,0,33,0,alcohol body brain
1,3,8,37,5,9,3,45,0,warren: im troubled obama getting $400k wall street
1,1,12,56,3,11,0,68,0,"kelly clarkson's ""game thrones"" christmas card snatched holiday throne"
1,1,11,34,0,10,0,45,0,sincere ode uno everyone ever existed
1,1,9,29,0,8,0,38,0,guess gilmore girl cry
1,3,13,45,0,11,0,58,0,chinese carmaker think finally win america suv
1,3,10,41,1,9,0,51,0,report: ai predicts patient die heart failure
1,3,12,51,2,9,0,63,0,centurylinkvoice: new product launch: testing water social medium
1,2,7,33,0,7,2,40,0,23 question probably lesbianmovies
1,3,8,31,2,6,0,39,0,much college-basketball team worth?
1,1,10,40,1,9,0,50,0,word search test determine get married
1,1,8,32,0,7,0,40,0,insufferable family right
1,1,11,30,3,9,2,41,0,"14 picture ""hsm"" zac efron took today"
1,2,1,38,0,8,2,39,0,top 50 hospital gouge patient
1,1,7,31,2,5,0,38,0,what's all-time favorite halloween movie
1,1,8,26,0,7,0,34,0,lady gaga song anthem
1,1,4,23,0,4,2,27,0,21 horrifying image animorphs
1,3,17,48,2,12,0,65,0,inside mit incubator: really like learn entrepreneurship mit
1,1,11,38,0,11,2,49,0,20 shirtless guy man bun make feel thing
1,1,10,53,0,9,0,63,0,word association test determine personality magazine
1,1,10,30,0,10,2,40,0,look like graduate 79 year late
1,1,12,50,0,11,0,62,0,gwendoline christie showed emmy looking like literal goddess
1,1,10,38,3,9,0,48,0,"band slayed cover justin bieber's ""sorry"""
1,1,10,43,0,9,0,53,0,watch one man get transformed three tim burton character
1,2,2,47,1,8,0,49,0,cambodia breast milk: debate mother selling milk
1,1,5,13,3,4,0,18,0,"i'm bisexual, i'm"
1,1,10,36,1,10,2,46,0,17 time internet nailed like scorpio
1,1,9,36,0,9,2,45,0,19 reason everyone need use damn turn signal
1,1,6,23,0,5,0,29,0,fast food fried chicken taste test
1,2,14,57,4,16,4,71,0,watch e! news season 2017 excerpt free online inside beyonce's fabulous life yahoo view
1,2,5,28,0,7,6,33,0,20 epic celebrity trump meltdown 2016
1,2,2,54,1,12,2,56,0,"uk teacher becomes one youngest people die dementia, aged 40"
1,1,8,29,1,8,2,37,0,20 attractive men white
1,1,12,40,0,12,2,52,0,25 thing understand went college texas
1,1,8,33,1,7,2,41,0,27 fucked-up thing people actually ate child
1,3,7,38,2,8,0,45,0,read cover story: happened richard simmons?
1,1,16,51,0,15,0,67,0,watch people stop everything save baby elephant well cry happy tear
1,2,5,42,4,10,3,47,0,"job hunting? 180+ opening new york, london, hamburg"
1,2,14,60,4,9,0,74,0,"#oscarssowhite creator still waiting lgbt romantic comedies, disabled superheroes"
1,1,7,26,0,7,2,33,0,25 time halsey queen instagram
1,1,10,40,0,10,1,50,0,5 reason lawsuit taylor swift make sense
1,1,7,26,0,7,2,33,0,23 thing every music nerd find funny
1,1,13,55,2,12,0,68,0,"librarian decorated cupboard stair look like ""harry potter"""
1,1,6,14,0,5,0,20,0,well see color
1,1,7,33,0,7,2,40,0,23 christmas morning treat family love
1,1,10,39,1,9,0,49,0,here's pee smell horrible eat asparagus
1,1,11,45,0,12,6,56,0,19 important thing happened 2016 golden globe award
1,1,8,21,0,8,2,29,0,13 way body go wrong space
1,1,7,40,0,7,2,47,0,17 book perfectly capture immigrant experience
1,1,10,29,1,8,0,39,0,"so, buzzfeed newsletter hot guy"
1,1,14,30,0,10,0,44,0,best tip managing adhd work
1,1,9,36,0,9,2,45,0,44 breathtaking shot michael mann movie
1,3,1,78,1,17,0,79,0,"australia capacity ride wave, financial crisis make way shore"
1,1,9,35,0,8,0,44,0,spinach artichoke app change life
1,1,10,39,1,8,0,49,0,"lauren, tom hank found fordham university student id"
1,1,13,51,0,12,0,64,0,kendall jenner gigi hadid transformed homeless kid hot model
1,2,5,29,0,6,0,34,0,mariah carey nye performance fiasco
1,3,10,37,1,8,0,47,0,video: homeowner shotgun lie wait intruder
1,1,16,57,0,15,0,73,0,taylor swift reversed female opinion become famous pop star world
1,3,10,59,2,10,0,69,0,"ex-teacher admits sleepover student, playing strip basketball others"
1,2,8,52,0,9,0,60,0,spotify executive confirmed british victim sweden terror attack
1,1,13,43,0,12,0,56,0,tell famous person body double hanging
1,1,10,35,4,9,0,45,0,"character ""you, me, apocalypse"""
1,3,13,59,2,12,0,72,0,pa police: hillary fan bashed elderly woman head chair election argument
1,1,9,42,1,8,0,51,0,show that's breaking new ground queer representation
1,1,12,36,1,13,6,48,0,"26 thing taylor swift 2008 would never, ever"
1,1,8,30,0,8,2,38,0,14 crucial tip anyone wash face
1,3,1,20,0,5,4,21,0,ten exhibition see 2017
1,3,9,33,4,8,0,42,0,maher: trump tax plan prof mental illness sad
1,1,7,27,2,6,0,34,0,"song ""revival"" actually"
1,2,14,55,2,14,2,69,0,"17 nurse reveal worst thing people got stuck penises, vaginas, butt"
1,1,9,31,4,6,4,40,0,here's another really good 2015 end-of-the-year mashup
1,1,16,63,0,15,0,79,0,incredible social experiment reveals many way india keeping woman dark
1,1,9,39,0,8,0,48,0,ace extremely difficult color matching quiz
1,3,9,39,0,9,0,48,0,dem rep moulton warns possible nuclear war russia
1,1,8,28,0,9,6,36,0,32 time tumblr truly nailed star sign 2015
1,1,5,21,0,4,0,26,0,romantic proposal
1,1,7,28,0,7,2,35,0,17 thing overachiever want know
1,1,10,40,0,10,2,50,0,31 wonderful local store midwest shop online
1,1,16,57,4,16,4,73,0,"here's ""back future"" got right wrong 2015, according neil degrasse tyson"
1,1,12,47,0,11,0,59,0,people twitter reacted jose mourinho leaving chelsea
1,1,9,45,0,9,2,54,0,24 time internet completely accurate midterm week
1,1,11,37,0,12,6,48,0,39 product help embrace inner cat lady 2016
1,1,7,38,0,7,2,45,0,28 thing literally everyone without realizing
1,1,16,44,2,12,0,60,0,"well ""dash dolls"" malika khadijah haqq actually know"
1,3,2,54,3,10,0,56,0,stay-at-home dad affected career? share story
1,1,16,46,5,14,0,62,0,"guess s.o.'s star sign based fave ""legend zelda"" character"
1,2,18,52,2,17,0,70,0,"easier start company india shutting down, thanks maze law"
1,1,10,39,0,10,2,49,0,16 cookie sandwich change way eat dessert
1,1,7,26,0,7,2,33,0,24 secret male model never tell
1,3,6,32,0,7,0,38,0,style evolution sasha malia obama
1,1,5,10,0,4,0,15,0,guy hate
1,1,14,58,2,13,2,72,0,15 lazy delicious pumpkin spice latte-flavored dessert want make right
1,3,12,34,4,9,0,46,0,u.s. actually get drug supply: quicktake q&a
1,3,2,50,0,10,0,52,0,man want make dating great trump supporter
1,1,8,24,0,8,2,32,0,15 dog want goddamn rain stop
1,2,4,21,0,4,1,25,0,6 trick mastering conflict
1,1,11,24,0,10,0,35,0,one way get creepy guy away
1,3,3,56,2,13,0,59,0,here's sudden bank love snapchat still hate twitter
1,2,18,68,5,15,2,86,0,"doomsday clock move 30 second closer midnight, two-and-a-half minute away apocalypse!"
1,3,4,50,1,10,0,54,0,frank martin even sure frank martin story
1,1,11,31,1,9,1,42,0,9 celebrity #tbt photo may missed week
1,1,9,32,2,8,0,41,0,"entire ""street fighter v"" cast ranked design"
1,1,9,37,1,7,0,46,0,basic food-sharing etiquette damn heathen
1,1,11,43,2,11,2,54,0,29 face immediately recognize ever gyno
1,1,8,24,0,7,0,32,0,guess movie family
1,3,3,59,1,10,0,62,0,cinnabon fails galaxy terrible tweet carrie fisher's death
1,1,7,40,0,6,0,47,0,woman acne get incredible makeup transformation
1,1,14,47,1,14,2,61,0,44 photo president first lady obama make miss bae
1,1,4,21,0,4,2,25,0,17 secretly healthy drunk food
1,2,12,32,0,12,2,44,0,17 easy dinner cook eat wholeweek
1,3,1,24,0,5,0,25,0,flirt relationship
1,2,6,77,1,15,0,83,0,cheers! secret finding perfect champagne christmas choosing one big bubble
1,1,12,48,4,11,0,60,0,"lady gaga's ""american horror story: hotel"" outfit rock"
1,1,11,38,2,10,0,49,0,"meet ashlee simpson evan ross' new baby girl, jagger snow"
1,3,7,35,0,7,0,42,0,former vogue model found dead apparent suicide
1,1,18,30,0,13,4,48,0,gabrielle union look exactly age 42 26
1,1,11,34,0,11,2,45,0,21 tumblr post way real uni student
1,1,7,30,1,7,2,37,0,21 sign addicted goddamn iphone
1,3,2,64,2,10,0,66,0,"tacky weddings: marriage proposals, dance routine asking guest money"
1,1,11,34,2,10,0,45,0,"trailer ""star trek beyond"" show u new villain"
1,1,8,29,0,8,4,37,0,biggest moment twitter 2015
1,1,9,41,0,9,2,50,0,15 stunning north carolina town absolutely need visit
1,1,9,25,0,9,2,34,0,31 kid honest good
1,3,3,45,1,10,0,48,0,here's preemptive strike north korea would go
1,1,7,49,0,7,2,56,0,16 chart perfectly illustrate filipino twentysomething life
1,1,10,43,0,9,0,53,0,celebrity tree christmas morning
1,1,8,26,0,8,2,34,0,13 way makeup habit make sick
1,3,7,29,4,6,0,36,0,"puff, puff, pass: wiz khalifa's highest lyric"
1,2,2,62,2,14,0,64,0,"someone tried mail box deadly horror australia, geez creepy"
1,1,8,33,0,7,0,41,0,last minute halloween costume idea pet
1,2,4,22,0,4,0,26,0,bond market slide intensifies
1,2,3,35,2,8,4,38,0,"2017: new year, weird stuff parliament house"
1,1,12,43,0,12,2,55,0,21 legit cool thing star war fan actually want home
1,3,0,30,0,6,2,30,0,14 way become charismatic leader
1,1,11,41,0,11,2,52,0,21 fucking thing british woman love swearing know true
1,1,9,28,0,9,2,37,0,31 brilliant way dress pound chicken
1,1,14,41,3,12,2,55,0,like lesbian couple 20-plus-year age difference
1,3,11,21,2,7,0,32,0,stock drop: here's need know
1,1,12,25,1,12,3,37,0,16 thing see go tim hortons 6 a.m
1,1,10,33,0,9,0,43,0,keep ruth bader ginsburg workout
1,1,7,34,0,8,6,41,0,23 adorably awkward thing shawn mendes tweeted 2015
1,1,11,25,0,9,2,36,0,12 easy diys make fair lovely
1,1,14,54,1,13,0,68,0,makeup artist transforms lip tiny piece art incredible
1,3,3,55,0,10,0,58,0,april ryan asked important question trump presidency
1,3,7,42,1,10,0,49,0,"trump order wall built, congress hold checkbook"
1,1,7,29,0,7,2,36,0,22 adorable dog collar every dog owner need
1,1,11,30,1,10,0,41,0,mad libs: woo crush love poem
1,1,10,51,0,9,0,61,0,professional fitness instructor tried boxing first time
1,3,10,62,4,13,0,72,0,brooks: trump making conclusion populism bannon-ism working
1,1,6,30,0,6,2,36,0,19 painful confession artist
1,3,15,54,1,14,0,69,0,need see climate change hurt mother earth? let google timelapse show
1,3,4,52,0,9,0,56,0,racist troll guilty harassing labour mp antisemitic post
1,1,5,15,0,4,0,20,0,french name
1,1,8,18,2,5,0,26,0,"""vampire diaries"" bff"
1,1,14,37,1,11,0,51,0,"life crazy rich people send space, wtf"
1,1,12,43,3,12,2,55,0,"22 tweet ""fifty shade grey"" make laugh every time"
1,1,13,42,2,12,0,55,0,"would ""harry potter"" wand core based zodiac sign"
1,1,8,27,1,8,2,35,0,22 simple ring give feel
1,2,2,24,3,6,8,26,0,africa's week pictures: 21-27 april 2017
1,1,10,38,2,8,0,48,0,guess ex-boyfriend's name three question
1,1,10,39,1,9,0,49,0,feel comfortable going home holiday
1,1,9,41,1,8,0,50,0,surprised celebs mistletoe here's happened
1,2,6,30,0,7,3,36,0,100 day covering president donald trump
1,3,8,81,1,16,0,89,0,updated: brief incomplete list dumbest thing presidential campaign ever spent money
1,2,10,31,1,9,0,41,0,time found new iced tea recipe
1,3,14,48,0,11,1,62,0,kanye west reschedules yeezy season 5 debut criticism cfda bos
1,2,1,66,3,13,0,67,0,first-born child really cleverest thanks parent
1,1,9,33,1,9,2,42,0,22 time dog embodied like sibling
1,3,4,64,7,15,1,68,0,he dead. soon too: father accused throwing 7-month-old son bridge
1,1,9,40,0,9,2,49,0,26 infomercial fails guaranteed make laugh every time
1,1,14,56,3,14,2,70,0,"22 fred george weasley moment make laugh, cry, everything"
1,3,3,61,0,15,0,64,0,bill nye back blow mind science new netflix show trailer
1,1,9,33,0,9,2,42,0,19 thing people wear makeup tired hearing
1,3,7,29,0,6,0,36,0,rand paul want susan rice congress
1,2,2,53,2,11,0,55,0,apple new music service compare whats right
1,1,8,38,1,8,2,46,0,17 biggest surprise year's oscar nomination
1,1,9,39,0,8,0,48,0,name sondheim musical character
1,1,15,54,3,14,0,69,0,"one person probably never noticed britney spears' ""piece me"" music video"
1,1,5,16,0,4,0,21,0,makeup item
1,3,4,27,1,3,0,31,0,amazon revolutionize shipping?
1,1,10,36,1,9,2,46,0,34 non-american musician need add playlist
1,1,9,28,0,9,2,37,0,11 reason adult best thing ever
1,3,12,65,5,13,0,77,0,washington post flip conservative wh access: whats legitimate news outlet?
1,1,10,39,2,9,0,49,0,"parents, what's worst thing went wrong halloween"
1,1,12,48,1,11,0,60,0,meghan trainor perfectly summed u new year's resolution
1,1,8,30,0,7,0,38,0,poem helped depression
1,1,7,29,0,6,0,36,0,christmas movie actually best
1,1,6,33,0,6,2,39,0,19 extremely satisfying moment book lover
1,1,7,33,0,7,1,40,0,7 easy fall dinner actually satisfying
1,1,13,31,2,12,0,44,0,"need talk big death ""once upon time"""
1,3,18,59,3,17,0,77,0,"govt reacts viral video, order probe suffering soldier, enough?"
1,2,7,42,4,10,0,49,0,terrifying recreation 'full house' intro using 'gta v'
1,1,12,36,0,11,0,48,0,pretended salad tinder happened
1,2,4,73,2,15,0,77,0,"venture capitalist deep, deep denial sound like: theranos backer tim draper"
1,1,5,21,0,4,0,26,0,national star war spoiler day
1,1,12,49,1,12,1,61,0,9 difference hanging new friend vs. best friend
1,3,11,57,0,13,0,68,0,pagan priest win right wear goat horn license photo religious reason
1,1,9,35,0,9,2,44,0,17 time internet perfectly summed libra
1,2,8,40,3,9,0,48,0,cliff sims: house healthcare bill still work progress
1,1,9,35,3,8,0,44,0,"hardest ""pretty little liars"" quiz ever take"
1,1,10,42,1,10,2,52,0,21 thing every guy know black girlfriend's hair
1,1,10,31,0,9,0,41,0,aziz ansari best joke golden globe
1,2,1,61,0,11,1,62,0,flight attendant reveal 5 annoying thing people airplane
1,3,5,23,2,5,0,28,0,india growth doesnt story
1,1,8,40,0,7,0,48,0,julianne moore bust redhead myth stephen colbert
1,1,9,30,1,9,2,39,0,"22 piece winter fashion advice, told cat"
1,1,7,31,1,7,2,38,0,"14 canadian sex positions, drawn canadian"
1,1,10,45,1,10,2,55,0,18 confession proposal make glad single
1,1,8,35,0,8,2,43,0,17 confession people struggle save money
1,3,2,64,2,15,0,66,0,uh-oh: favorite aloe vera product might aloe vera
1,1,7,27,2,6,0,34,0,"people try ""superfoods"" first time"
1,1,15,21,1,6,0,36,0,attention: aziz ansari chilling india
1,1,9,43,0,8,0,52,0,riley curry make modeling debut absolutely adorable
1,2,10,42,0,10,0,52,0,much extra beer pizza consume march madness
1,2,8,28,2,8,1,36,0,panic: 7 thing getting fired
1,3,7,33,0,7,2,40,0,18 time chrissy teigen totally owned johnlegend
1,1,7,27,1,7,2,34,0,remember obscure '00s boy band
1,2,5,31,1,6,0,36,0,australia's aaa credit rating doomed
1,1,14,61,2,13,0,75,0,"kim kardashian tracee elli ross playing ""never ever"" unexpectedly hilarious"
1,1,13,42,0,12,0,55,0,taylor swift song would titled honest
1,3,2,38,1,7,0,40,0,mosul: biggest battle anywhere planet
1,1,10,38,2,8,0,48,0,one-legged guy's halloween costume crack
1,3,2,55,0,13,0,57,0,secret successful lot easier think list
1,1,8,30,2,7,0,38,0,"well really remember ""living single"""
1,1,12,43,2,11,0,55,0,"montreal canadiens sang beautifully bad version ""let go"""
1,3,3,55,0,10,0,58,0,player rise fantasy baseball draft hot spring training
1,1,11,46,1,10,0,57,0,gross video montreal show flush condom
1,1,12,38,2,11,0,50,0,"well remember lyric ""start something new"""
1,3,9,48,2,8,0,57,0,'wheel fortune' contestant give hilariously smutty wrong answer
1,1,9,29,0,8,0,38,0,tell old fucking penny
1,2,14,55,2,13,0,69,0,virat kohli michael clarke's heart attending phil hughes' funeral
1,1,10,28,2,9,0,38,0,"dear men america, cold wear short"
1,2,9,39,0,12,0,48,0,watch artist carve hotel suite ice one minute
1,1,11,39,0,11,2,50,0,10 reason starbucks red cup magical thing ever
1,2,4,31,1,9,0,35,0,tom ford dress melania trump
1,1,12,40,3,12,2,52,0,"22 tweet ""lord rings"" make laugh every time"
1,3,3,85,0,15,0,88,0,simple illustration reveals everything need know connection trump russia
1,3,10,35,3,9,0,45,0,finish every single quote titanicquiz?
1,1,11,53,2,10,5,64,0,"41,000 indian petitioned censor board gender-sensitive rating"
1,2,2,33,0,7,6,35,0,10 hottest neighborhood america 2017
1,1,10,41,0,10,2,51,0,12 amazing photo make feel insignificant
1,1,8,21,0,7,0,29,0,know emo band sang
1,3,1,23,0,5,0,24,0,man titanium chest
1,1,14,41,2,13,0,55,0,"look like philae, little robot landed comet, dead"
1,1,9,34,1,8,0,43,0,cashier's random act kindness going viral
1,1,7,22,0,6,0,29,0,outfit say
1,3,3,31,1,8,1,34,0,9 thing know air force one
1,2,12,46,0,12,2,58,0,17 time chris pratt anna faris funniest parent twitter
1,1,14,53,0,13,0,67,0,anne hathaway totally lost composure premiere saw mariah carey
1,3,2,59,5,11,0,61,0,"obama commuted sentence. masked gunman executed him, police say."
1,1,9,40,1,9,1,49,0,8 thing know alcohol freshers' week
1,1,13,49,3,12,0,62,0,"here's would happen character ""harry potter"" internet"
1,1,12,34,0,11,2,46,0,17 bold af hidden hair color actually wear work
1,2,11,23,2,7,0,34,0,ubsvoice: live expensive city?
1,1,12,38,0,11,0,50,0,zac efron dominated stage snoopy high school play
1,1,10,34,0,9,0,44,0,weekend gaming convention told snapchat
1,1,20,40,0,14,0,60,0,found babe sitting behind jake tapper gop debate
1,1,8,32,1,8,6,40,0,23 heart-shattering breakup song 2015
1,1,7,25,0,6,0,32,0,young adult book title honest
1,1,10,41,0,10,2,51,0,21 tumblr post masturbation get every time
1,1,13,45,0,11,4,58,0,iconic celebrity gif based biggest 2015 achievement
1,2,15,58,1,14,0,73,0,"brutally killing kangaroo metal pipe, two men jailed australia"
1,1,11,48,0,10,0,59,0,artist perfectly captured awkward straight people sex comic
1,1,13,39,3,12,0,52,0,"here's start running, stick it, totally hate"
1,1,8,40,2,8,2,48,0,"17 confession biggest ""american horror story"" fan"
1,3,8,37,2,7,0,45,0,here's alton brown's trick cooking pasta perfectly
1,1,13,42,2,13,2,55,0,what's delicious thing eat atlanta less $10
1,1,8,24,0,7,0,32,0,taylor swift damn emmy award
1,1,9,34,0,8,0,43,0,know personality based birth season
1,1,10,43,0,9,0,53,0,remember whose music video celebrity starred
1,2,10,24,1,9,0,34,0,eat thing one twobites?
1,2,1,21,1,6,0,22,0,"shear sheep, win"
1,1,7,19,0,8,6,26,0,25 reason 2015 year geek
1,1,7,35,0,7,2,42,0,24 picture prove kid invented asshole
1,1,6,25,0,6,2,31,0,21 secret anyone dating actor know
1,1,10,41,0,9,0,51,0,guess urban dictionary definition word
1,3,10,36,0,9,0,46,0,people twitter losing butter debate
1,1,6,36,0,5,0,42,0,democratic candidate looked oddly familiar
1,1,9,41,1,8,0,50,0,five question determine still single
1,1,9,27,3,9,4,36,0,"cast ""sherlock"" victorian age vs. 2016"
1,1,5,20,0,5,2,25,0,12 thing make guy jealous
1,1,13,46,1,11,0,59,0,little mix shut body-shamers perfect way possible
1,3,10,36,0,10,2,46,0,25 best place buy inexpensive home decoronline
1,2,9,37,2,7,0,46,0,jimmy kimmel know who's really replacing bill o'reilly
1,1,6,18,2,5,0,24,0,"well remember ""juno"""
1,3,10,34,3,9,0,44,0,another 'you' parallel universe?
1,3,0,45,0,9,5,45,0,7 chain dominate restaurant industry 2017
1,3,2,53,1,10,0,55,0,trump's executive order climate change mean world
1,1,8,35,0,7,0,43,0,people react controversial article consent
1,1,9,43,0,8,0,52,0,everyone feel personally attacked people chewing
1,1,13,49,1,12,0,62,0,there's hidden card humanity card people finding
1,1,13,15,0,9,0,28,0,elf dilf need thing
1,2,0,40,0,11,2,40,0,10 thing one tell take rowing
1,1,6,29,0,6,2,35,0,53 thing mildly thrill british people
1,3,8,35,0,7,0,43,0,merkel pay migrant million leave germany
1,1,6,20,0,7,6,26,0,21 best mindy kaling tweet 2015
1,1,11,39,2,11,2,50,0,"21 lady killed ""essence"" street style block party"
1,1,7,43,0,7,2,50,0,13 black woman share postpartum depression experience
1,1,11,46,0,10,0,57,0,american kid tried candy around world questioned life
1,2,2,68,1,13,0,70,0,london attack: photo woman wearing hijab bypassing victim may show full story
1,1,8,36,0,8,2,44,0,22 hilarious tweet exhausted time
1,1,9,32,1,9,2,41,0,remember '00s pop star sang lyric
1,3,1,50,0,7,0,51,0,prosecutor say big retailer deceiving shopper
1,1,11,44,2,10,0,55,0,"people mad cosmo called kardashians ""first family"""
1,1,9,26,1,8,4,35,0,type show binge-watch 2016
1,3,13,44,0,12,0,57,0,america sent back syrian woman trying visit sick mother
1,3,2,54,3,9,0,56,0,burger king's secret fried chicken 'color guide' discovered
1,1,10,31,0,10,2,41,0,18 thing date besides netflix chill
1,1,9,42,0,8,0,51,0,family embarrassing term bathroom stuff
1,3,9,39,1,9,2,48,0,13 theory pixar movie thatll really make think
1,1,8,38,1,6,0,46,0,star share hilarious pre-golden globe moment
1,1,5,25,1,4,2,30,0,24 spectacular one-tier wedding cake
1,1,10,36,2,10,2,46,0,"21 thing happened visited set ""friends"""
1,1,18,66,5,16,0,84,0,"dad brilliant response ""small-minded"" commented approve son's costume"
1,3,5,26,3,5,0,31,0,report: iranian chant death trump
1,1,8,32,0,8,2,40,0,17 time wednesday addams truly spoke soul
1,3,3,83,0,18,0,86,0,italian tv presenter give viewer real news flash forgets sitting behind glass desk
1,1,17,59,1,16,0,76,0,watch asif confess like breakup best friend becomes massive meme
1,1,14,56,3,11,2,70,0,moment 92-year-old baby great-granddaughter totally adorable
1,1,14,45,0,11,0,59,0,make gifs smiling actor without squealing
1,1,12,38,0,10,0,50,0,know pet peeve based favorite buzzfeed badge
1,3,11,56,1,10,0,67,0,jeff sessions: recuse future hillary clinton investigation
1,2,1,66,4,10,0,67,0,world's biggest industrial company can't stop talking 'going digital'
1,1,10,31,1,9,0,41,0,know single based zodiac sign
1,2,7,26,0,7,1,33,0,7 reminder ridiculous xfl
1,1,7,30,1,5,0,37,0,roommate tell long-held secret
1,1,6,27,0,6,2,33,0,17 reason emily gilmore masterpiece
1,1,12,48,3,10,0,60,0,ombre-beige season's new nail trend grossly disappointing
1,1,16,55,1,14,0,71,0,asked non-italians react picture italian thing happened
1,1,11,33,2,8,2,44,0,"12 burning question ""fuller house"" need answer asap"
1,1,11,50,3,10,0,61,0,"taylor swift's acoustic version ""blank space"" leave breathless"
1,1,6,8,0,3,0,14,0,hate pda
1,1,8,24,0,8,2,32,0,21 insane way start day egg
1,1,17,56,0,16,0,73,0,old friend senior dog sanctuary best facebook page ever need follow
1,1,11,33,2,11,3,44,0,"22 time geralt rivia ""the witcher 3"" looked sexy af"
1,1,14,48,4,11,0,62,0,"ryan reynolds got dunked ""ellen"" raise money make-a-wish foundation"
1,1,10,30,2,8,0,40,0,here's make-ahead meal plan anyone cook
1,3,3,60,1,13,0,63,0,"viral moment, lauren duca dealing worst internet"
1,2,4,73,0,17,0,77,0,photo edward snowden bucket chicken caused lot controversy list
1,1,11,39,1,11,2,50,0,11 people definitely work point life
1,3,11,55,2,10,0,66,0,"retirement questions, answered: exceeding goal know"
1,3,2,53,4,12,0,55,0,colleague asked sign out. here shouldnt.
1,2,9,45,1,8,0,54,0,trump phone call taiwan president spark china complaint
1,3,7,22,0,7,0,29,0,war tax return heat
1,2,8,26,1,8,4,34,0,here's tax refund delayed 2017
1,1,7,15,2,5,0,22,0,t.s. eliot poem
1,2,8,29,1,7,0,37,0,samsung may fine chief's arrest
1,3,9,34,4,10,2,43,0,"always wanted little fat baby, say mom 13-pounder"
1,1,12,38,0,12,2,50,0,10 time martha stewart exactly campy wanted
1,3,15,49,2,14,0,64,0,"england's smallest castle sale, look like house dream"
1,1,7,42,0,7,2,49,0,21 recipe completely transform boring leftover
1,2,15,46,0,14,0,61,0,corgi went museum third birthday looked veryhappy
1,1,8,35,3,8,2,43,0,"18 notable butt bosch's ""garden earthly delights"""
1,1,15,50,0,14,0,65,0,video woman motorbike saving kitten traffic terrifying
1,1,7,38,0,7,2,45,0,26 hilarious reason people actually cried drunk
1,1,10,52,0,10,2,62,0,27 school supply give intense elementary school flashback
1,1,9,34,0,9,2,43,0,25 thing people feel confident sex
1,2,8,35,1,8,2,43,0,23 meme get existential crisis
1,2,2,88,2,14,0,90,0,"scientist begin sending message aliens, despite warning could trigger earth destruction"
1,1,6,33,1,6,2,39,0,adorable animal advent calendar: december 21
1,3,15,59,1,14,0,74,0,"private hospital reuse disposable meant single use, still make pay"
1,1,12,25,0,7,0,37,0,literally bunch funny oitnb quote
1,1,11,38,2,10,0,49,0,"remember lyric ""one week"" barenaked lady"
1,1,6,35,0,6,2,41,0,21 stunning photo newfoundland labrador
1,1,9,25,0,9,2,34,0,17 image candy true work art
1,3,2,38,0,8,0,40,0,ball brother came rule basketball
1,1,6,20,0,5,0,26,0,christmas song hater
1,1,9,37,0,9,2,46,0,13 small victory anyone going home holiday
1,1,10,47,1,8,0,57,0,sharon osbourne tweeted something really weird shaquille o'neal
1,2,4,58,3,12,4,62,0,"ok, calling it: little boy star 2016's heartwarming christmas video"
1,2,1,47,0,10,1,48,0,3 play sport everybody talking today
1,1,13,40,3,11,0,53,0,"all-time favorite jim dwight prank ""the office"""
1,1,8,27,2,8,1,35,0,"well remember season 1 ""friends"""
1,1,13,34,4,12,0,47,0,"there's fun new parody ""mr. men little miss"" book"
1,3,8,28,0,9,6,36,0,21 way make life infinitely better in2017
1,1,5,32,0,5,2,37,0,17 struggle smartypants understand
1,1,12,38,1,11,0,50,0,probably qualify astronaut even know
1,1,8,22,0,7,0,30,0,worst person world
1,1,8,32,0,7,0,40,0,white people get stressed talking race
1,2,1,26,0,5,4,27,0,currency got crushed 2016
1,1,17,44,0,16,0,61,0,history chocolate make want go get bar right
1,2,9,50,1,8,0,59,0,donald trump really like presidential portrait makeover
1,1,11,46,0,10,0,57,0,got fake bang inoculate actually getting bang
1,1,10,37,0,9,0,47,0,oreo marshmallow treat stuff dream made
1,2,8,29,0,8,2,37,0,14 perfect japanese word need yourlife
1,1,8,21,0,7,0,29,0,make friend adult
1,2,7,45,1,8,0,52,0,leah remini's reddit ama reveals juicy secret scientology
1,3,8,40,0,8,1,48,0,7 weirdly gripping medical story actuallytrue
1,1,9,42,2,9,3,51,0,"103 ""game thrones"" quote make perfect instagram caption"
1,1,10,49,0,9,0,59,0,awesome grandparent changed wedding photo booth game
1,1,10,40,1,9,0,50,0,artist made tattoo come life mesmerizing
1,2,12,44,3,12,0,56,0,"newest spring beauty launch loved katy perry, j.lo"
1,1,8,39,0,8,2,47,0,17 real struggle christmas divorced parent
1,1,9,36,0,9,2,45,0,19 gorgeous fluffy chow chow follow instagram
1,2,13,39,4,13,0,52,0,let take moment laugh funny park recphotos
1,3,5,43,1,9,0,48,0,"jimmy butler want return, hope bull keep rajon rondo"
1,1,8,30,1,8,2,38,0,31 thing actually save cold
1,1,12,42,1,12,2,54,0,man growing fingernail 62 year crazy
1,1,7,30,0,7,2,37,0,17 dog really pleased
1,1,8,30,0,8,2,38,0,15 insanely cool gift sane person refuse
1,1,9,28,0,8,0,37,0,taste dessert say
1,1,8,29,0,8,2,37,0,17 tiny necklace cute function
1,1,10,36,0,8,2,46,0,17 impossibly easy kitchen diys look expensive
1,2,3,50,1,6,0,53,0,merriam-webster stay relevant national conversation
1,1,8,21,1,8,1,29,0,buy $1 country
1,3,16,44,0,16,1,60,0,6 breakup line need master get rid clingy thing life
1,1,10,39,4,9,0,49,0,"here's ""mona lisa"" look like celebrities' brow"
1,1,4,18,2,5,6,22,0,"89 enchanting ""1989"" cover"
1,2,9,28,1,8,2,37,0,ranking nba's top 50 free agent summer
1,1,8,24,0,8,2,32,0,23 mum took snapchat little far
1,2,18,55,4,18,0,73,0,"sridevi, nawazuddin akshaye khanna set put edge seat 'mom'"
1,1,6,17,0,6,1,23,0,9 helpful thing bad day
1,3,13,55,1,13,2,68,0,11 thing probably didnt know national endowment art helpedcreate
1,2,10,40,0,9,0,50,0,da clear fresno officer fatal shooting unarmed teen
1,1,8,35,0,8,2,43,0,23 picture devastate anyone love food
1,1,9,36,1,9,2,45,0,19 celtic name beautiful want child
1,2,8,33,3,9,0,41,0,ted koppel sean hannity: bad america
1,1,16,21,0,11,0,37,0,ed sheeran hell night mtv emas
1,3,8,29,3,9,0,37,0,annoying useful yourboobs?
1,1,15,52,1,14,0,67,0,serena williams give best answer reporter asks smiling
1,1,9,39,0,9,2,48,0,15 essential product anyone want eat healthier
1,2,13,32,0,11,0,45,0,know tv show watch based yourmood
1,1,6,26,1,5,0,32,0,definitive ranking nando's food
1,3,8,40,0,11,0,48,0,type parent likely child autism
1,1,8,26,2,7,0,34,0,"lana del rey ""honeymoon"" song"
1,3,12,50,5,13,0,62,0,flying? bad romance? expect lady gagas super bowl halftime show
1,1,15,55,1,14,0,70,0,man walk first time year paralysis incredibly inspiring
1,1,10,30,3,9,0,40,0,"well remember kid ""hey arnold!"""
1,1,11,36,0,11,2,47,0,19 weird wonderful gift wine lover life
1,1,12,35,0,12,2,47,0,19 thing girl lazy beauty routine know true
1,1,9,43,0,8,0,52,0,cartoon network released first original mobile game
1,3,3,48,0,11,0,51,0,body found search missing teen gold coast water hole
1,2,10,61,0,12,5,71,0,3 american foreign policy option 2016 presidential candidate need choose among
1,3,7,22,0,5,0,29,0,tv writer obsess chicago
1,2,7,35,2,9,0,42,0,mom's maternity acroyoga world yahoo
1,1,9,36,2,9,2,45,0,"19 time ""how met mother"" hilariously mocked canada"
1,2,9,59,4,10,0,68,0,limbaugh: preposterous believe russian influence trump election
1,1,6,18,0,6,2,24,0,16 text miami
1,1,6,15,0,5,0,21,0,pick right guy
1,1,9,24,0,8,0,33,0,job would disney movie
1,1,13,42,0,13,2,55,0,45 people somehow managed get hand stuck fucking jar
1,1,8,35,0,7,0,43,0,aaron tveit walk u career milestone
1,1,6,14,1,5,0,20,0,ex vs. new crush
1,3,11,60,4,11,0,71,0,trump spokeswoman: medium constantly want talk something doesnt exist
1,1,9,34,1,8,0,43,0,"welp, go bethenny frankel neon red hair"
1,1,9,26,0,8,2,35,0,25 buzzfeed post parent want write
1,1,14,48,3,13,0,62,0,"end last night's ""walking dead"" proof glenn definitely alive"
1,1,8,33,2,8,2,41,0,17 people probably get money's worth
1,1,9,39,0,8,0,48,0,superstitious people go ghost hunting first time
1,1,8,26,0,8,4,34,0,gossip headline happen 2015
1,1,11,38,0,10,0,49,0,many ice cream flavor actually tried
1,2,12,51,1,10,0,63,0,russia appears defend michael flynn super-weird message twitter
1,1,10,37,0,10,2,47,0,21 confession southerner going school north
1,2,20,67,2,17,0,87,0,"thane call centre scam mastermind arrested, air india, fia lift ban gaikwad must read"
1,3,7,38,1,8,0,45,0,west virginia: bluest state became reddest
1,1,8,25,1,7,4,33,0,15 aim struggle '00s teen remember
1,3,6,21,0,6,6,27,0,15 top paying certification 2017
1,1,13,53,1,11,0,66,0,woman got post-mastectomy tattoo reclaim body breast cancer
1,1,15,36,3,13,0,51,0,"mash-up boston guy seeing fish ""the heart sea"""
1,3,1,56,2,11,0,57,0,kitchen gadget review: coconut grater ugly pleasure flesh
1,3,14,72,0,13,0,86,0,car mishap kill model sonika chauhan leaf bengali actor vikram chatterjee critically injured
1,1,13,37,0,14,5,50,0,one woman got 11 tattoo week show 100 year inked history
1,1,8,25,0,7,0,33,0,two sun bear roly poly cuties
1,2,1,37,0,7,0,38,0,man buried alive speaks beyond grave
1,1,11,29,0,10,0,40,0,word day thanks queen amy poehler
1,3,4,21,0,4,0,25,0,style secret southern men
1,1,9,26,0,8,0,35,0,know barbie ken last name
1,1,12,33,2,11,0,45,0,"like howard raj ""the big bang theory"""
1,2,1,39,0,5,0,40,0,schoolboy work experience discovers planet
1,1,9,43,0,9,2,52,0,23 delightfully weird office item every medical nerd love
1,1,9,31,1,9,2,40,0,19 pair sister whose style want steal
1,1,9,30,2,9,2,39,0,"22 ""legend zelda"" tattoo blow away"
1,1,14,46,2,12,2,60,0,happens ask 12-year-old brother dating advice
1,1,10,41,1,8,0,51,0,dog accidentally ran half-marathon placed seventh
1,1,6,13,0,5,0,19,0,ode humble dal
1,1,4,15,0,3,0,19,0,nobody like hand job
1,3,15,73,4,13,0,88,0,listen breitbarts aaron klein: un anti-israel resolution may inspired palestinian terror campaign
1,1,10,43,0,9,0,53,0,definitely need following january jones instagram
1,2,14,60,6,13,0,74,0,watch: 'logan' hugh jackman 'special message' team cricket india australia!
1,2,0,41,0,9,1,41,0,6 way help child thrive dyslexia
1,2,13,44,0,10,0,57,0,sudden weather change brings snowstorm uae gulf state
1,1,8,36,1,6,0,44,0,tell u educational non-traditional path
1,1,10,36,0,9,0,46,0,ayesha curry sparked debate woman dress
1,1,8,40,0,8,2,48,0,13 song probably liked feminist awakening
1,3,3,31,2,5,0,34,0,boil christmas veg? sprout nonsense
1,3,4,27,2,5,0,31,0,boy discovers new planet grindtv.com
1,1,7,21,1,7,2,28,0,"top 12 divas, ranked laugh"
1,1,9,39,1,8,0,48,0,here's would happen flight attendant honest
1,1,7,26,1,7,4,33,0,hardest 2000s music quiz ever take
1,1,8,37,1,8,2,45,0,"29 impossibly stylish cat gifts, order awesomeness"
1,2,3,41,1,6,0,44,0,alan cartwright murder: teen denies killing cyclist
1,1,11,33,5,9,0,44,0,"cast ""brooklyn nine-nine"" play ""never ever"""
1,1,7,24,2,6,0,31,0,"character ""mob city"""
1,1,11,39,0,11,2,50,0,13 people seem really struggling wine thing
1,2,8,50,1,8,0,58,0,ohio anti-fracking organizer get jail voter registration fraud
1,1,7,29,0,7,2,36,0,23 picture look exactly like life feel
1,3,2,40,2,7,0,42,0,paid sex break boost sweden's fertility rate?
1,1,8,14,1,6,0,22,0,lazy s.o
1,3,12,68,4,11,0,80,0,"scene loserpalooza: anti-trump protester destroy property, set fires, attack police"
1,1,9,40,0,10,2,49,0,21 amazing product everyone hate everyone need
1,1,11,40,0,10,0,51,0,woman get real worst part period
1,1,8,19,1,6,2,27,0,pigskin blanket: nfl week 12 pick
1,1,12,50,0,11,0,62,0,artist made adorable illustration best pickup line
1,1,12,38,0,11,0,50,0,hero bride responded car crash wedding dress
1,1,9,37,1,9,2,46,0,24 thing know always hosting dinner party
1,1,14,37,0,13,0,51,0,guess chore need based zodiac sign
1,1,8,41,2,7,0,49,0,"""harry potter"" cover reimagined daniel radcliffe"
1,1,10,38,0,9,0,48,0,name christmas movie distorted scene
1,1,6,27,0,6,2,33,0,13 totally genius birthday cake kid
1,1,8,29,0,7,0,37,0,jimmy fallon stephen colbert
1,1,13,54,0,12,0,67,0,five question determine milkshake bring yard
1,1,7,29,0,6,0,36,0,actually deserve christmas
1,1,11,35,0,10,0,46,0,north west took bun rocked natural curl
1,1,10,46,3,9,0,56,0,"one direction's new music video ""perfect"" actually perfection"
1,1,11,39,0,10,0,50,0,louisiana sheriff scare living shit
1,1,10,44,1,9,0,54,0,piglet puppy's unlikely friendship melt heart
1,3,4,48,1,9,0,52,0,"highly touted nfl prospect accused sex assault, lawyer say"
1,1,5,16,0,4,0,21,0,gotham girl
1,2,5,65,4,11,0,70,0,david foster denies planning donald trump's inauguration: 'i politely declined'
1,1,9,32,0,9,2,41,0,19 picture prove drunk actual genius
1,1,11,33,0,11,2,44,0,21 photo prove anyone rock pair duck boot
1,3,9,42,5,11,0,51,0,laura dern handle lightsaber new star wars? [video]
1,1,5,17,0,4,0,22,0,percent vegan
1,1,9,24,0,8,0,33,0,best video game time
1,1,14,49,1,14,2,63,0,29 place shop wedding online wish knew sooner
1,1,18,56,5,17,0,74,0,"list romantic jim pam episode ""the office"" binge-watch valentine's day"
1,3,6,49,2,8,0,55,0,makeup blogger's dad nail anti-lgbtq bigot perfect response
1,1,5,14,0,4,0,19,0,defense going
1,1,10,39,2,8,0,49,0,what's all-time favorite book american south
1,1,14,52,4,13,0,66,0,"here's happens watch many ""sherlock"" episodes, annoy mom"
1,3,9,23,1,7,2,32,0,ice arrest 51 austin two-day op
1,1,10,40,2,10,2,50,0,"19 moment prove ""step brothers"" funniest movie ever"
1,2,6,36,1,6,0,42,0,brent musburger: olbermann stick sport
1,3,5,43,2,12,0,48,0,late icon turn camera 'i heath ledger'
1,2,2,85,1,19,3,87,0,free good gnome? woman baffled 100 garden ornament turn front garden overnight
1,1,11,37,5,10,0,48,0,"huge difference ""fight club"" ""mr. robot"""
1,3,17,48,4,14,0,65,0,justin timberlake reveals decided leave *nsync: 'i growing it'
1,1,9,34,0,8,0,43,0,guess book terrible drawing
1,1,10,37,1,10,1,47,0,company ship potato love note friend $8
1,3,2,64,1,14,0,66,0,overwhelmed trump presidency barely move
1,1,11,51,0,11,2,62,0,21 deliciously warming west african dish eating winter
1,3,9,39,2,7,0,48,0,report: drew careys son started fire outside deploraball
1,1,7,32,0,6,0,39,0,kid confess feeling crush
1,3,1,63,4,13,0,64,0,"taboo recap: season one, episode four magic, nitrous oxide incest ritual"
1,3,14,45,0,13,0,59,0,found insane indoor slide gotta seethis
1,1,14,46,0,13,0,60,0,ryan reynolds flew halfway across world see blake lively day
1,1,9,36,1,9,3,45,0,21 easy 3-ingredient snack actually good
1,1,7,21,0,7,1,28,0,8 sign raised south
1,1,10,31,1,10,2,41,0,early '00s pop diva based zodiac
1,2,12,52,5,10,0,64,0,"south carolina's twitter troll duke loss, post link 'diddukewin.com'"
1,3,10,40,0,10,2,50,0,54 fact disney movie actually blow yourmind
1,1,7,29,1,7,2,36,0,19 cozy onesies want wear everywhere
1,1,10,34,0,10,2,44,0,21 tweet disney make laugh loud
1,2,12,37,2,12,2,49,0,11 thing woman much better 'beautiful'
1,1,11,38,0,11,2,49,0,16 beautiful quote make fall love paris
1,1,11,36,1,10,0,47,0,st. vincent say designed guitar room boob
1,2,2,46,3,7,0,48,0,"can't sleep? insomniac try camping, say scientist"
1,3,9,48,0,10,0,57,0,monumentally expensive quest pull alaskan oil miracle
1,1,7,25,0,6,0,32,0,willow smith officially model
1,1,7,17,0,6,0,24,0,full crap house
1,1,10,24,1,9,0,34,0,kiss right guy new year's eve
1,3,3,54,4,7,0,57,0,"performing ""self-therapy"" grammy-nominated artist gallant"
1,1,13,42,1,12,0,55,0,tried become best friend one week here's happened
1,3,13,64,5,13,5,77,0,"despite 30,000+ unsolved cases, bengaluru police hunting cow attacked constable's mother"
1,1,17,54,2,16,0,71,0,reason wrong think little mix everything
1,1,14,39,0,13,0,53,0,kid dad teaching dog howl adorable
1,1,6,15,0,5,0,21,0,think pug cute
1,2,7,22,1,6,0,29,0,pas lie detectortest?
1,1,10,43,0,9,0,53,0,identify disney movie background
1,2,11,60,1,10,0,71,0,katy perry hilariously troll orlando bloom's instagram jennifer aniston joke
1,1,14,59,0,13,0,73,0,photo toilet around world highlight human right sanitation
1,2,13,38,0,13,1,51,0,3 longest flight world faint heart
1,1,7,34,0,7,2,41,0,watch 19 male celebrity speak language
1,1,10,33,1,10,2,43,0,here's weeknight pasta make 20 minute
1,1,9,28,1,7,0,37,0,pas cat-themed art history quiz
1,1,5,15,0,4,0,20,0,spam email
1,1,9,29,0,8,0,38,0,choice whiskey say
1,3,3,53,2,14,2,56,0,25 coolest car 'the fast furious' movie
1,1,12,44,1,11,0,56,0,cooking wrong thing crockpot whole time
1,1,7,20,2,7,2,27,0,"34 ""i laughed hard cried"" story"
1,1,10,48,0,10,2,58,0,23 word mean something completely different get engaged
1,3,9,27,1,9,0,36,0,"odds, one match needed"
1,3,9,24,1,8,0,33,0,know car youre going buynext
1,1,8,18,1,7,0,26,0,said it: kendall ken doll
1,1,9,32,0,10,6,41,0,12 people regret asking internet help 2015
1,2,1,50,1,12,2,51,0,fit 40: osteopathy course turned crack addict
1,1,11,45,3,9,0,56,0,"cast ""hamilton"" next real-life historical character"
1,3,1,35,3,6,0,36,0,inside world's 'flying eye hospital'
1,1,8,16,1,8,3,24,0,trash scale 1-10
1,3,7,43,1,8,0,50,0,left alinsky plan destroy trump administration
1,1,10,36,0,9,0,46,0,disney princess based birth month
1,1,13,38,1,12,0,51,0,michael b. jordan hot handle new movie trailer
1,1,10,43,1,9,0,53,0,adele pranked employee jamba juice everything
1,3,20,69,12,18,0,89,0,"trump: fighting fake news shouldnt allowed use anonymous sources, cnn clinton news network"
1,1,16,57,0,14,0,73,0,leonardo dicaprio blushed real hard watched make face lady gaga
1,1,8,24,0,8,2,32,0,27 time actually paid clumsy
1,1,10,32,0,10,2,42,0,67 jay z lyric need instagram caption
1,3,3,62,2,11,0,65,0,starbucks downtown washington. coffee shop much better.
1,2,13,56,1,14,1,69,0,pakistan finally start build first warship 5 major story today
1,3,4,61,3,13,0,65,0,"mike hall's death last time tragedy unfolds via google maps, expert say"
1,1,8,28,0,7,0,36,0,guess celebrity sister
1,2,8,42,1,7,0,50,0,play ball! independent baseball major league business
1,1,13,42,3,11,0,55,0,"youth football player quit game ""whip/nae nae"""
1,2,5,25,2,7,0,30,0,abc news quiz: much recall?
1,2,8,25,1,7,0,33,0,fucking christmas movie ornot?
1,1,3,15,0,2,0,18,0,quiet guy nightmare
1,1,10,35,0,10,2,45,0,17 worst thing could say someone chicago
1,3,12,53,4,12,0,65,0,lingerie photo two different best friend important [video]
1,1,8,29,0,8,2,37,0,21 thing sweary girl tired hearing
1,1,8,26,0,8,2,34,0,25 awesome way show state pride
1,1,7,27,0,7,2,34,0,12 map british people find funny
1,1,16,66,0,15,0,82,0,kate winslet keep oscar bathroom people practice acceptance speech
1,3,10,46,9,9,0,56,0,"nikki haley: syrian people dont want disgusting, war criminal assad"
1,1,6,29,1,7,6,35,0,24 time denny's completely owned twitter 2015
1,1,11,41,1,11,2,52,0,12 famous writer told u book they're thankful
1,1,5,22,0,4,0,27,0,shopping habit normal
1,1,12,34,4,11,0,46,0,"never guess ""e"" chuck e. cheese stand"
1,1,7,26,0,6,0,33,0,would amortentia smell like
1,3,3,27,0,6,0,30,0,avoid mariah carey meltdown
1,1,11,30,1,10,2,41,0,21 thing happened really shit p.e
1,1,11,35,0,11,2,46,0,19 tumblr post prove pet pure world
1,1,11,34,0,10,0,45,0,look water way watching
1,3,8,28,1,8,0,36,0,siri finances? digit say trust
1,2,2,83,1,14,0,85,0,tech incubator started google tackling world's biggest geopolitical issue online
1,1,11,26,0,10,4,37,0,talk woke matt mcgorry 2015
1,2,9,33,1,9,2,42,0,23 picture prove living damnfuture
1,3,3,73,4,12,0,76,0,"apple release 'clips', snapchat-like app could signal augmented reality ambition"
1,1,7,29,0,7,2,36,0,19 gadget every adult need kitchen
1,3,14,38,3,11,0,52,0,bbc dad robert e. kelly give another interview bbc [video]
1,1,9,43,1,8,0,52,0,john krasinski's view fatherhood explode ovary
1,2,9,27,1,8,0,36,0,report: megyn kelly make nbc debut june
1,2,9,35,1,8,0,44,0,guess age technology preferences?
1,3,8,54,3,8,0,62,0,donald trump responds president obamas many inflammatory statement
1,2,2,40,2,9,0,42,0,two men shoot giant firework other. fun.
1,2,7,46,3,10,0,53,0,limbaugh: verge genuine constitutional crisis
1,3,3,43,3,7,0,46,0,president trump's 'obamacare nightmare' word
1,2,4,26,1,7,0,30,0,kind fraud would fall for?
1,1,6,21,0,5,0,27,0,genderqueer feminist
1,2,2,31,4,6,0,33,0,chairman zhang's flatpack skyscraper
1,2,2,44,2,5,0,46,0,breakthrough ebola vaccine prof highly protective
1,1,10,28,1,10,2,38,0,19 thing say someone text back
1,3,9,68,1,19,0,77,0,get fit fifteen minutes: simple exercise home get heart racing
1,1,17,59,0,16,0,76,0,mom caught little girl turning baby sister zebra permanent marker
1,1,8,26,0,8,2,34,0,20 time mamrie hart damn funny
1,1,12,45,0,10,0,57,0,ian mckellen got choked reading beautiful coming letter
1,2,5,20,0,6,0,25,0,woman really think men
1,2,7,30,0,7,2,37,0,21 skincare product might help acne
1,1,10,45,0,9,0,55,0,everything need know homemade popcorn crunchie bar
1,1,8,37,0,8,2,45,0,19 small award anyone anxiety deserves receive
1,1,10,31,0,9,0,41,0,eat nothing pizza every single meal
1,3,2,15,1,2,0,17,0,mayonnaise cafes? ew
1,3,15,72,3,16,2,87,0,"avid photographer marathon runner, 10 important fact n chandrasekaran, new tata son chief"
1,1,15,52,2,14,0,67,0,"sarah palin said amazingly bizarre thing ""stop iran deal"" rally"
1,3,8,32,1,8,0,40,0,bright idea hedge fund managers: nothing
1,1,11,35,0,10,0,46,0,inside new feminist show need watch right
1,2,9,44,1,8,2,53,0,15 life-changingly useful kitchen product knowabout
1,1,8,29,0,8,6,37,0,50 favorite buzzfeed community post 2015
1,2,3,62,1,11,0,65,0,potential sinister motif behind donald trump's voter fraud lie
1,2,5,72,1,13,0,77,0,detailed security footage show alleged journey tom brady's stolen super bowl jersey
1,1,11,57,1,11,2,68,0,19 word mean something completely different obsessed makeup
1,1,13,45,2,13,2,58,0,"""50 shades"" twitter account one every nerd waiting"
1,2,7,44,0,8,0,51,0,street photographer port authority capture another era
1,3,1,56,0,13,0,57,0,day two men talking cancer radio made nation stop
1,3,5,61,2,12,0,66,0,trump able order u.s. strike syria without congressional approval
1,1,10,57,0,9,0,67,0,artist perfectly reimagined disney animal human personality
1,1,11,46,0,10,0,57,0,woman paralyzed waist became aerial performer
1,2,3,11,0,4,0,14,0,tie scarf
1,1,13,48,1,11,0,61,0,adele went makeup-free cover rolling stone look incredible
1,2,9,55,1,10,2,64,0,facebook engineer arrested allegedly soliciting sex 15-year old girl
1,1,5,23,0,4,0,28,0,people holding rabbit
1,2,17,60,2,16,0,77,0,"authority completely failing revive it, here's say yamuna dead"
1,3,1,29,0,6,0,30,0,owl husky puppy best friend
1,1,14,51,1,13,0,65,0,here's beauty ad would look like used advertised product
1,1,10,37,1,9,0,47,0,find what's missing tough crossword
1,2,7,35,0,9,0,42,0,state aim lure college dropout back school
1,3,4,49,2,10,0,53,0,wait over: uk greatest ever sportsperson revealed
1,1,12,57,1,11,0,69,0,caption lindsay lohan's instagram amazing completely mind boggling
1,1,12,60,3,11,0,72,0,"alanis morissette updated ""ironic"" lyric modern struggle hilarious"
1,2,1,48,1,8,0,49,0,here's difference psychopath sociopath
1,1,7,22,0,6,0,29,0,piece human garbage
1,1,5,28,0,4,0,33,0,huntsman look absolutely bonkers
1,1,20,63,0,19,0,83,0,neil patrick harris kid singing morning make wish part family
1,1,8,23,0,7,0,31,0,justin bieber steal man
1,1,11,44,0,10,0,55,0,five question tell percentage muggle
1,3,7,28,0,10,6,35,0,36 song help give 2017 fresh start need
1,1,7,31,0,7,2,38,0,11 christmas card mexican mom would send
1,3,4,17,1,4,4,21,0,top-selling album 2016
1,1,8,24,1,7,0,32,0,know drunk christmas
1,1,10,44,0,9,0,54,0,celebrity photographer turn lens homeless people
1,1,8,22,2,7,0,30,0,"""teen wolf"" pack belong"
1,1,11,36,1,9,0,47,0,one-question quiz tell gullible
1,3,1,39,0,8,0,40,0,guy throw middle marriage proposal
1,3,9,43,1,8,0,52,0,james corden suggests new catchphrase america's economy
1,1,12,23,0,7,2,35,0,14 celebrity name always google
1,1,6,28,2,6,2,34,0,"19 hilarious tweet ""the hunger games"""
1,1,11,42,0,11,2,53,0,19 movie would way different parenting
1,1,8,25,0,7,0,33,0,many logo recognize
1,1,8,34,0,8,2,42,0,29 insanely delicious indian recipe need try
1,3,5,24,1,5,2,29,0,heartbreak hits: top 30 breakup song
1,3,4,13,2,4,2,17,0,00s trend mustgo?
1,3,1,47,1,7,2,48,0,11 celebrity who've made cameo appearance neighbour
1,1,10,45,2,10,4,55,0,24 forgotten trend mid-'00s teen girl slightly obsessed
1,1,6,13,0,7,5,19,0,6 way get shape 2016
1,1,10,30,2,9,0,40,0,"""bake off"" look like around world"
1,1,9,33,1,8,2,42,0,29 real-life childhood fear make laugh
1,1,7,26,4,6,0,33,0,"""daredevil"" ""jessica jones"""
1,1,4,25,0,4,2,29,0,29 hilarious literary internet pun
1,1,9,28,0,8,2,37,0,18 fix small problem annoying af
1,2,10,52,1,10,0,62,0,carjacker murder motorist couldnt steal car stick shift
1,2,8,42,1,11,0,50,0,article attack trump say medium didnt cover
1,1,11,34,0,11,2,45,0,31 thing kid high school teacher know true
1,3,2,44,1,9,4,46,0,memoriam: remembering notable figure lost 2016
1,1,7,34,0,6,0,41,0,people tell childhood story santa claus
1,2,3,37,0,9,4,40,0,celebrate tax day 2017 deal freebie
1,1,8,29,0,8,2,37,0,30 thing need know david koechner
1,2,7,32,1,8,0,39,0,real democracy lover please stand up?
1,1,12,37,2,12,4,49,0,"know fave ""1989"" song based calvin harris choose"
1,1,10,41,2,9,0,51,0,"amy schumer beautifully crashed ""game thrones"" cast photo"
1,1,14,38,0,12,2,52,0,16 diys make old toy growing overrated
1,3,12,55,2,11,0,67,0,youtube hoaxster adam saleh claim delta flight booted speaking arabic
1,1,6,32,0,7,6,38,0,25 incredibly beautiful wedding cake 2015
1,1,10,42,1,9,0,52,0,one music question determine get married
1,2,10,53,5,8,0,63,0,truth behind medias new favorite euphemism: muslim-majority country
1,1,5,11,1,3,0,16,0,bored af
1,1,13,36,2,12,0,49,0,"well actually know lyric ""bidi bidi bom bom"""
1,2,9,41,1,8,0,50,0,meet leonard kim: homeless personal branding expert
1,1,10,37,0,10,2,47,0,12 hilarious holiday stock photo make sense
1,3,2,48,0,9,0,50,0,everything know far stockholm terror attack
1,3,15,56,5,14,0,71,0,seen image 'pregnant' trump spooned vladimir putin? here means!
1,1,11,35,2,10,0,46,0,"europa league team ""game thrones"" location"
1,1,6,31,0,6,2,37,0,18 reason gryffindors absolute worst
1,3,11,40,2,10,0,51,0,diversity 'selfish' goal mobile gaming company
1,1,7,36,0,6,0,43,0,moment relationship becomes long distance
1,3,1,63,2,16,0,64,0,"normal think people agree you, might head"
1,1,7,28,0,7,3,35,0,100 year zombie evolution amazing
1,1,13,34,2,12,0,47,0,"woman named baby ""uber"" gave birth uber"
1,1,11,29,1,11,2,40,0,17 blind dog make day lil' bit better
1,1,11,43,0,10,0,54,0,tell difference yoga pose sex position
1,3,9,46,0,10,0,55,0,makeup challenge putting unknown beauty brand map
1,3,6,53,0,7,0,59,0,republican unfazed controversy surrounding cabinet nominee
1,3,12,46,2,10,0,58,0,people swooning husband gift makeup-lovingwife
1,2,16,55,1,15,0,71,0,"randeep hooda talk gurmehar case, mandira bedi adopt girl ent"
1,3,13,53,0,14,0,66,0,patriot player may skip white house visit team win super bowl insider
1,3,1,28,1,5,0,29,0,one family's life wilderness
1,3,7,45,1,8,0,52,0,indiana kellogg snack plant expected close september
1,1,9,28,0,9,2,37,0,13 iconic playboy cover time
1,3,2,46,0,11,0,48,0,europe man woman get civil partnership
1,2,4,55,0,9,0,59,0,bmx star turn abandoned silverdome decaying playground
1,1,8,22,1,8,2,30,0,10 food know nut
1,1,4,23,0,4,2,27,0,12 wildly awkward sex confession
1,2,2,50,0,12,0,52,0,see every photo friend ever liked facebook
1,1,11,30,1,10,0,41,0,"oh god, cake change color turn"
1,2,13,32,2,13,0,45,0,open data key open market era ai cio journal.
1,3,12,43,1,11,0,55,0,here's awesome thing election day pantsuit
1,1,7,22,0,6,0,29,0,realize every guy taken
1,1,8,30,1,8,2,38,0,22 highly sexual word know needed
1,3,4,76,5,17,0,80,0,treasury secretary worried robot taking jobs. here could wrong.
1,1,12,38,1,11,0,50,0,gave musician elf shelf here's happened
1,1,10,40,0,9,0,50,0,pet name bestow upon significant
1,1,8,14,0,6,0,22,0,know gf touch
1,1,9,32,0,8,0,41,0,guess celebrity related
1,1,14,73,2,14,1,87,0,"official trailer ""zoolander 2"" dropped feature benedict cumberbatch without eyebrow"
1,1,13,36,3,11,0,49,0,"happens dude low-key ""the bachelor"""
1,1,8,31,0,8,2,39,0,12 struggle real queer vampire
1,1,8,32,0,7,0,40,0,majestic photo give spacegasm
1,1,11,37,1,11,2,48,0,11 reason kanye west sad height
1,1,13,48,1,12,0,61,0,graphic novel perfectly describes like teenage girl
1,3,8,43,4,8,0,51,0,schumer: wish democrat hadnt triggered nuclear option
1,1,7,21,0,6,0,28,0,taylor swift adele
1,3,5,58,1,14,0,63,0,"watching porn first date make likely go well, study find"
1,2,9,31,1,9,0,40,0,productive person guide little bit lsd
1,1,13,39,1,10,0,52,0,identify movie based main character's bff
1,3,6,27,0,5,0,33,0,asian star risk blinding trader
1,3,3,63,1,11,0,66,0,"duped fake news story, pakistani minister threatens nuclear war israel"
1,1,18,45,1,12,0,63,0,need talk perfection leonardo dicaprio's baftas suit
1,1,6,34,0,5,0,40,0,moment relationship becomes official
1,1,15,59,0,15,2,74,0,photo dog dressed 12 different disney character totally make smile
1,1,11,39,0,11,2,50,0,17 people get texting actually worst thing ever
1,2,13,47,2,12,0,60,0,parent threw lit divorce party make split lessawkward
1,1,5,21,0,6,6,26,0,21 badass thing bollywood 2015
1,1,7,34,2,6,0,41,0,"well actually remember ""halloweentown"""
1,3,1,64,3,14,0,65,0,'they could long gone:' tiny clue vast scale hunt escaped murderer
1,1,5,22,2,4,0,27,0,"""aristocats"" kitten"
1,1,8,39,0,8,2,47,0,17 completely insane thing happened hostel
1,2,6,34,0,8,0,40,0,universe bubble every champagne bottle
1,1,8,36,0,8,2,44,0,27 hilarious food pun every book nerd appreciate
1,1,9,35,0,8,0,44,0,british people try american candy first time
1,1,7,40,0,7,2,47,0,38 celebrity celebrating birthday december
1,1,6,24,3,5,0,30,0,tell u yourself(ie): jon glaser
1,1,9,33,0,9,2,42,0,17 time netflix chill greatest meme ever
1,1,13,41,1,12,0,54,0,baby got really confused babysat dad's twin
1,1,7,17,1,5,0,24,0,jacob tremblay's dad dad af
1,3,6,25,1,7,4,31,0,golden globe 2017: tv snub surprise
1,2,15,56,0,14,0,71,0,people screaming guy hilariously called mom lying onfacebook
1,1,10,33,1,8,0,43,0,ava duvernay's barbie important one ever
1,3,10,49,3,11,0,59,0,andrea mitchell: obama admin hope box trump russian sanction
1,1,10,41,0,10,2,51,0,12 lucius beebe quote restore faith urbanity
1,3,7,23,1,5,0,30,0,poll: cnn brand continues plummet
1,1,10,25,2,9,0,35,0,like date can't sex
1,1,12,37,4,11,0,49,0,"""would rather"" game ""home alone"" almost hard"
1,1,9,36,1,9,1,45,0,people said celebrity 9 year ago vs. today
1,2,10,53,4,11,0,63,0,behar: trump limited vocabulary appeal people afraid thing
1,1,8,34,2,7,0,42,0,"ever wonder go making ""steven universe"""
1,2,6,35,0,6,0,41,0,fresh arrest south korean political scandal
1,2,12,38,0,10,0,50,0,british blue chip snub investor call show ceo pay ratio
1,1,8,30,2,7,0,38,0,"""harry potter"" would different canada"
1,1,3,20,0,2,0,23,0,seasonal allergy problem
1,1,9,33,0,9,2,42,0,15 ginger dessert make time christmas
1,2,7,29,0,6,0,36,0,build respect difficult people
1,2,8,50,2,7,0,58,0,police: chicago torture victim parent received taunting message
1,1,10,35,0,10,2,45,0,13 roommate secret make want live alone
1,1,11,34,1,9,0,45,0,know mcdonald's order based birth month
1,3,3,52,2,12,0,55,0,six women. three nursing homes. man accused rape abuse
1,1,11,31,2,10,0,42,0,"guy take picture ""jersey devil"""
1,1,13,38,1,12,0,51,0,best shah rukh khan tribute video see day
1,1,13,59,0,12,0,72,0,selena gomez reveals underwent chemotherapy people thought rehab
1,1,12,39,1,10,0,51,0,best cable-cutting device people broke hell
1,1,11,38,2,10,0,49,0,"kanye west called taylor swift ""fake"" leaked audio"
1,1,8,37,0,8,2,45,0,22 secret hotel breakfast waiter supposed keep
1,3,2,51,2,12,1,53,0,"9 way new ""beauty beast"" different original"
1,3,12,35,1,12,4,47,0,here woman used internet 2016 give thefucks
1,1,6,27,1,6,2,33,0,19 secret wedding caterer tell
1,3,11,69,2,10,0,80,0,peter thiel obtained new zealand citizenship possibly 'exceptional circumstances'
1,1,7,27,1,7,4,34,0,"best book 2015, according goodreads"
1,1,4,19,1,3,0,23,0,what's personal slogan
1,1,8,33,0,7,0,41,0,gorgeous man travel world eating pizza
1,2,15,50,1,12,0,65,0,"kanpur train accident could linked isi, dawood ibrahim say bihar police"
1,1,6,21,0,7,6,27,0,23 deepest zayn malik tweet 2015
1,1,12,34,0,11,0,46,0,know kind parent based one question
1,2,1,47,0,9,0,48,0,portable smart scooter might better car
1,1,4,16,1,3,0,20,0,what's sex patronus
1,3,2,43,4,7,0,45,0,"holograms, mistrust 'fake news' france's election"
1,2,8,33,0,9,6,41,0,17 celebrity opened mental health in2016
1,1,10,48,0,10,2,58,0,26 seriously awesome gift true london underground fan love
1,1,9,40,0,9,2,49,0,13 weirdly random thing indian uploaded porn site
1,1,11,43,3,10,0,54,0,"know spend christmas based ""friends"" question"
1,1,6,31,1,7,5,37,0,27 genuine product 100% completely legit
1,1,9,34,0,8,2,43,0,15 vintage photo christmas display around uk
1,3,4,43,2,11,0,47,0,drove uber? rented home? tax tip
1,1,9,39,0,8,0,48,0,award winning photo wild animal hilarious
1,1,10,32,0,10,2,42,0,11 quote harry potter help cope loss
1,1,13,51,1,12,0,64,0,here's recycle beer bottle make totally cool drinking glass
1,3,3,57,4,17,0,60,0,"apple want make one product u.s., able buy"
1,3,3,45,1,9,0,48,0,latest: trump say agrees medium opposition party
1,1,14,41,0,14,2,55,0,22 time tina fey amy poehler shut sexism best damn way
1,1,6,24,3,5,0,30,0,tell u yourself(ie): luke bryan
1,1,8,27,1,7,0,35,0,makeup instagram vs. makeup real life
1,1,10,41,3,9,0,51,0,"demoed ""yoshi's woolly world"" adorably ridiculous"
1,3,3,47,1,11,0,50,0,pictures: men competing love desert chad
1,3,10,36,0,10,2,46,0,15 funny tweet anxiety way true
1,1,15,54,0,14,0,69,0,watch woman surprise girlfriend news kidney donor
1,3,0,37,0,10,1,37,0,5 way get credit score dump
1,1,8,26,3,9,5,34,0,"24 time jess ""new girl"" 100% actually"
1,1,14,48,3,13,0,62,0,"everyone think alan rickman's role ""galaxy quest"" best one"
1,1,10,32,0,8,0,42,0,tv couple significant
1,2,1,53,0,8,0,54,0,conniving carmaker caused diesel air pollution crisis
1,2,9,35,0,9,1,44,0,4 simple way woman help woman succeed business
1,2,7,66,1,12,0,73,0,people whove multiple marriage confess really feel divorce
1,1,10,33,2,9,0,43,0,"remember lyric ""imagine"" john lennon"
1,1,13,49,2,11,0,62,0,"kate mckinnon made ryan gosling burst laughing ""saturday night live"""
1,1,11,53,0,11,2,64,0,27 indian aside priyanka chopra appeared hollywood project
1,1,8,34,1,7,0,42,0,definitive ranking lady gaga's music video
1,3,2,59,2,12,0,61,0,basically every college student netflix (but guess many pay it)
1,1,8,30,0,8,2,38,0,18 old people living goddamn life
1,1,9,27,2,7,0,36,0,amy poehler's biggest fear making j-lo mad
1,1,11,40,1,11,2,51,0,19 thing know messy one relationship
1,1,7,31,0,7,2,38,0,19 decadent treat worth breaking diet
1,2,1,25,2,4,0,26,0,'bambi' rescued frozen lake
1,2,4,50,2,10,0,54,0,gop hunt new trump donor drove million low-profile firm
1,1,12,44,1,11,0,56,0,celebrity compete wrap battle here's happened
1,1,7,41,0,7,2,48,0,18 time squidward perfectly captured dating struggle
1,2,11,43,0,11,1,54,0,6 unforgettable moment made u fall love virat kohli
1,1,9,39,1,9,2,48,0,25 parent share parenting hack can't live without
1,1,10,34,2,9,0,44,0,"really, really need talk harry styles' hair"
1,1,9,30,1,9,2,39,0,21 scruffy men get hot bothered
1,1,8,31,0,8,2,39,0,16 truly useful tool beginner cook
1,1,12,51,4,11,1,63,0,"animator reimagined ""spirited away"" 8-bit video game incredible"
1,1,7,32,0,7,2,39,0,21 amazing cocktail anyone love citrus
1,1,10,36,0,10,2,46,0,21 struggle real people blush easily
1,3,2,31,1,5,2,33,0,cruise europe's 11 beautiful river
1,1,7,22,1,7,2,29,0,world's shortest man died 76
1,1,12,51,1,11,0,63,0,everyone need read facebook post america's muslim sikh
1,1,7,36,0,6,0,43,0,allison williams look super different bang
1,3,3,30,0,8,0,33,0,big part american dream dying
1,1,6,17,0,5,0,23,0,trying keep plant alive
1,1,8,34,0,9,6,42,0,literally 25 thing happened walmart 2015
1,1,11,37,1,10,0,48,0,thing men stereotypically here's went
1,1,11,48,1,10,0,59,0,here's happened people tried bharatnatyam first time
1,1,8,40,1,8,2,48,0,17 time grant gustin's instagram melted goddamn heart
1,2,14,59,0,13,0,73,0,dude spotted running around detroit kangaroo people question
1,3,2,63,1,13,0,65,0,one restaurant group stand big winner trump cut everyone's tax
1,3,1,55,2,13,0,56,0,optical illusion confusing internet work out?
1,1,11,26,0,9,2,37,0,28 diy candle help brave cold
1,1,13,39,0,12,0,52,0,guess hogwarts house based like
1,2,14,44,6,14,1,58,0,"7 essay read week: black joy, god, literally canteven"
1,1,12,35,3,11,0,47,0,"guy ""are one?"" would perfect match"
1,1,12,39,0,11,0,51,0,video sum every tech support person want say
1,2,10,55,0,10,2,65,0,palestinian authority name youth camp terrorist killed 38 israeli
1,1,14,39,3,13,0,53,0,"well know lyric ""smooth"" santana ft. rob thomas"
1,2,12,37,1,10,0,49,0,"phil simms may farted away career cbs, literally"
1,1,14,45,1,10,0,59,0,serena williams went tubing colton haynes omfg flawless
1,1,5,34,0,5,2,39,0,17 thanksgiving turkey mistake everyone make
1,2,3,39,0,6,2,42,0,10 trickiest goldman sachs interview question
1,1,10,32,2,9,0,42,0,"need watch ""jane virgin"" right second"
1,3,3,31,1,6,0,34,0,tip last-minute super bowl trip
1,3,3,49,0,10,0,52,0,naked kansa city man arrested minivan rap battle killing
1,1,12,40,0,12,2,52,0,15 pet look much like food make uncomfortable
1,1,6,20,0,5,0,26,0,friend say
1,1,5,20,1,5,2,25,0,17 life's awesome moment
1,1,8,30,0,7,0,38,0,know height based random question
1,1,11,48,1,11,2,59,0,37 fact probably never knew macy's thanksgiving day parade
1,1,14,53,1,13,0,67,0,mom perfectly capture like pregnant hilarious comic
1,1,10,38,0,10,2,48,0,29 tweet facebook make laugh every time
1,1,10,29,0,9,0,39,0,sex move try man tonight
1,1,7,38,1,7,2,45,0,literally 17 picture christopher meloni's butt
1,3,7,34,0,8,2,41,0,10 bizarre claim people make avoid paying tax
1,1,11,46,0,10,0,57,0,hollywood couple adopt based first initial
1,1,9,31,1,7,0,40,0,stylish tv lady's wardrobe raid
1,2,1,47,2,10,2,48,0,there's 20% chance particular form synesthesia
1,3,2,44,3,12,2,46,0,woman strong healthy 90. here it.
1,1,8,25,0,7,0,33,0,pick right celeb best friend
1,2,11,39,3,8,0,50,0,here's tension flaring gibraltar: quicktake q&a
1,1,7,26,0,6,0,33,0,always google date
1,3,1,50,0,10,0,51,0,dentist reveals effective way whiten teeth
1,1,10,23,1,5,0,33,0,here's everyone attended baftas
1,1,6,21,2,5,0,27,0,"well remember ""grease"""
1,1,6,21,0,5,0,27,0,taller barack obama
1,3,9,25,0,7,0,34,0,glass bottom sky pool look scary af
1,1,6,21,1,5,0,27,0,can't hide emotion
1,1,14,61,0,14,2,75,0,21 time neil patrick harris david burtka gave u serious relationship family goal
1,1,8,26,0,7,0,34,0,jessica ashlee simpson lyric
1,3,10,42,0,13,6,52,0,top 15 artist mention instagram 2016
1,1,11,33,2,11,6,44,0,19 new thing j.k. rowling taught u harry potter 2015
1,1,10,38,0,9,0,48,0,happens internet turn superhero
1,3,3,36,0,9,2,39,0,10 best place american live canada
1,1,10,33,0,10,2,43,0,25 time blue ivy shit together better
1,2,4,51,1,10,0,55,0,round world record: french sailor thomas coville set new mark
1,3,6,70,2,18,0,76,0,revealed: world's eight richest men worth half rest planet
1,2,7,84,1,15,0,91,0,"russia reinstate monarchy appoint putin royal emperor, say influential moscow churchman"
1,1,9,32,0,8,0,41,0,badly taking one direction hiatus
1,2,12,36,2,13,4,48,0,year surprises: look back nbc news best feature 2016
1,1,10,43,1,10,2,53,0,28 photo prove we're living darkest possible timeline
1,3,7,16,1,6,0,23,0,make soup nyt cooking
1,1,10,39,1,10,2,49,0,12 insanely silly secret santa gift break bank
1,3,9,46,0,9,0,55,0,populism developed world trump em geopolitical risk rise
1,2,3,41,1,9,0,44,0,snow rescue swiss alp dry start winter?
1,1,8,29,0,8,2,37,0,17 photo literally morning
1,1,11,48,2,10,0,59,0,"""gilmore girls"" fan design beautiful poster inspired show"
1,3,2,64,2,15,0,66,0,"picture show insecure men be, worse thought list"
1,1,10,61,0,9,0,71,0,sonakshi sinha snapchatted doodling accidentally drew kim kardashian
1,2,7,24,3,7,0,31,0,whats year oscar swag bag?
1,1,6,20,1,4,0,26,0,buzzfeed crossword: drop beat
1,1,9,23,0,9,2,32,0,24 kid dire need exorcism
1,1,7,38,0,7,2,45,0,21 dessert prove bourbon make everything better
1,3,12,52,1,11,0,64,0,"mark zuckerberg running political campaign, elected office"
1,2,7,36,2,9,1,43,0,foolin around: 7 book comic humorist
1,1,4,18,0,4,2,22,0,11 award nurse deserve
1,3,7,32,2,9,0,39,0,forget netflix chill. try pure flix pray.
1,1,10,38,0,10,2,48,0,21 truth people like animal human
1,2,4,70,2,13,0,74,0,rachel dolezal: right activist's story say white modern america
1,1,8,31,0,8,2,39,0,21 photo real indecisive people
1,2,4,45,2,8,0,49,0,carrie fisher's ash carried prozac-shaped urn
1,3,1,61,2,14,0,62,0,scientist created fluid negative mass tell us?
1,2,7,24,1,6,0,31,0,big data pick next doctor?
1,2,12,36,0,12,4,48,0,bad lip reading nail look back 2016 nfl season
1,1,10,37,0,11,4,47,0,19 reason nintendo 64 greatest console time
1,1,11,38,0,10,0,49,0,everything need know man behind lord varys
1,1,12,45,1,12,2,57,0,18 thing everyone who's relationship sephora know true
1,1,14,46,0,14,2,60,0,21 picture way real people grew strict parent
1,1,9,39,3,8,0,48,0,"everyone's freaking season premiere ""arrow"""
1,3,2,33,1,6,0,35,0,president trump's tech policy mystery
1,2,11,48,1,8,0,59,0,simon schuster childrens author publish letter protesting milo
1,2,7,36,1,10,2,43,0,classic '80s trend make huge comeback
1,1,11,32,1,10,0,43,0,"likely struck meteorite, really"
1,1,12,50,1,11,0,62,0,video perfectly illustrates always phone
1,1,18,38,1,10,0,56,0,everyone who's obsessed ina garten husband jeffrey
1,2,3,44,4,8,0,47,0,'yolocaust': behave holocaust memorial?
1,1,7,30,0,7,2,37,0,19 photo terrify makeup addict
1,3,15,56,2,14,2,71,0,"threatening disclose big names, gujrat man declared 14k cr go cold turkey!"
1,3,10,43,1,10,2,53,0,24 couple let bad weather ruin engagement photo
1,1,7,31,1,6,0,38,0,here's bollywood dressed halloween
1,2,1,52,1,14,5,53,0,ask experts: 9 book help stand equality 2017
1,3,5,67,4,14,2,72,0,god's finger azure window: 11 natural landmark lost element (and vandalism)
1,1,9,31,0,8,0,40,0,know vice based three question
1,1,8,36,2,7,0,44,0,"""real housewives"" cast actually join"
1,1,8,40,1,8,2,48,0,17 problem people who've diarrhea understand
1,1,11,38,2,9,0,49,0,"well actually remember ""the lizzie mcguire movie"""
1,1,18,55,2,17,0,73,0,"dude follows wife around world came back india, he's still killing"
1,2,8,29,0,8,2,37,0,17 joke smartest people willget
1,1,9,22,2,8,2,31,0,match quote '90s rom-com
1,1,10,43,2,9,0,53,0,"asos remove ""slave"" shirt pictured black model amid backlash"
1,1,10,27,0,9,0,37,0,made ridiculously big cat fort cat
1,2,12,58,2,11,0,70,0,"fox: trump surveilled nomination, agency info blocked nunes week"
1,2,2,48,4,10,1,50,0,8-bit 'jurassic park' go back time old-school video game
1,2,13,41,1,12,0,54,0,restaurant comfort food make want kidagain
1,1,7,20,0,7,2,27,0,16 super chill dog love sun
1,1,10,34,0,10,2,44,0,21 time red forman realest fucker planet
1,3,14,49,6,13,0,63,0,'anxiety sensitivity' real. here's know caught spiral.
1,3,3,62,0,10,0,65,0,supreme court relives horrific murder shocked washington decade ago
1,2,9,42,1,8,0,51,0,"democratic party losing moderate members, say gallup"
1,3,6,62,2,12,0,68,0,barack obama's final white house party line-up make donald trump jealous
1,3,2,58,0,12,0,60,0,watch first round french presidential election
1,2,2,56,3,13,0,58,0,"popular android apps time shock (lol, really)"
1,1,6,26,0,6,2,32,0,24 time coriander fucking worst
1,1,11,57,0,10,0,68,0,marathon couple found mystery woman photographed engagement
1,1,10,35,2,9,0,45,0,what's best grilled cheese shop ever eaten
1,1,9,34,0,8,0,43,0,make healthy cauliflower fried rice
1,3,8,38,0,11,4,46,0,grain salad might key healthier eating 2017
1,3,2,64,1,12,0,66,0,adult legoland fan really angry they're allowed kid playground
1,1,4,8,0,4,4,12,0,peak 2015
1,1,9,34,1,8,0,43,0,lady gaga's david bowie tattoo huge beautiful
1,2,19,53,6,18,0,72,0,lowry: paul ryan think trump sign gop bill thats way going work
1,1,4,13,1,4,2,17,0,'90s toy honest
1,3,15,31,0,14,2,46,0,19 little thing ok people u
1,1,8,41,0,7,0,49,0,artist reimagined disney princess britney spear
1,1,8,25,1,8,6,33,0,43 stunning red-carpet look 2015
1,1,8,25,2,7,0,33,0,"well know ""pretty little liars"""
1,3,4,25,0,6,2,29,0,25 famous woman waxing shaving
1,2,15,56,1,16,4,71,0,equity 101: 3 thing every founder need know giving away piece startup
1,1,11,57,4,10,0,68,0,"noma dumezweni called criticism hermione ""ignorant"" ""unimaginitive"""
1,1,12,46,2,11,3,58,0,7 honest piece advice scientist 90-year-old nobel laureate
1,1,8,28,0,7,0,36,0,name every chemical romance song
1,1,9,32,3,9,1,41,0,"7 response asked ""when kids?"""
1,1,12,44,1,12,2,56,0,downton abbey star michelle dockery's partner died age 34
1,2,7,49,1,10,0,56,0,"best christmas movie netflix, including die hard home alone"
1,1,8,30,0,7,0,38,0,proof braid look best rainbow hair
1,1,8,20,0,7,0,28,0,big scotch whisky fan
1,3,9,56,4,12,0,65,0,alec baldwin mock donald trump slogan make american great russian
1,1,8,43,0,7,0,51,0,someone illustrated leslie knope compliment rock
1,2,1,41,0,7,0,42,0,initial jobless claim fell expected
1,1,6,29,0,5,0,35,0,single people take honest holiday photo
1,1,12,52,0,11,0,64,0,jessica chastain wrote fire essay gender equality hollywood
1,1,16,60,2,15,0,76,0,"case wondering, david beckham look like dressed freddie mercury"
1,1,11,54,1,10,0,65,0,"meet claire, globetrotting dog visit abandoned place across europe"
1,1,11,44,0,11,2,55,0,21 time british people confused hell everyone twitter
1,1,18,36,0,14,0,54,0,gave kevin hart ice cube bff test hilarious af
1,1,10,41,2,9,0,51,0,what's craziest experience ever vibrator
1,2,10,36,2,8,0,46,0,ftc warns social medium influencers stop stealth ad
1,1,12,39,0,12,2,51,0,17 photo prove snoop dogg greatest hair time
1,2,3,46,2,8,1,49,0,"boy, 2, throw tantrum encounter queen elizabeth"
1,1,12,37,0,11,0,49,0,know want christmas based zodiac sign
1,2,11,43,1,10,0,54,0,guy sang mariah carey's christmas smash great reason
1,2,2,60,4,13,0,62,0,watch world's first ever monster truck front flip. know love it.
1,2,1,53,1,11,0,54,0,powerful image show like read dyslexia
1,1,16,56,0,16,2,72,0,12 incredible photo icelandic glacier make want go right
1,1,13,60,0,13,2,73,0,17 hilarious tumblr post make question everything know language
1,1,11,51,1,11,4,62,0,jennifer lawrence's favorite moment 2015 getting drunk amy schumer
1,1,13,66,2,12,0,79,0,"discontinued starbucks polar bear cooky getting dragged another ""war christmas"""
1,1,12,40,0,12,2,52,0,22 tweet therapy make laugh loud
1,3,9,52,2,11,0,61,0,pope francis tell mother go ahead breastfeed child church
1,1,9,27,2,10,4,36,0,25 movie '00s bad they're good
1,1,8,39,0,8,2,47,0,25 time rainn wilson seriously hysterical twitter
1,3,3,46,0,9,0,49,0,new german poll show unexpected challenge merkel
1,1,5,24,0,5,2,29,0,22 thing latina mom understand
1,2,1,29,2,6,2,30,0,11 valentine's gift f*ck buddy
1,1,6,37,0,6,2,43,0,27 underrated parenting product actually work
1,3,4,42,2,5,0,46,0,canada's project naming: identifying unidentified
1,1,6,29,0,5,0,35,0,asexual people answer question
1,1,13,48,0,12,0,61,0,dude built giant cardboard fortress middle office
1,3,7,34,1,6,0,41,0,"nativity scene could offend muslims, priest say"
1,1,8,27,1,6,0,35,0,need talk joseph gordon-levitt
1,3,2,57,1,14,0,59,0,"might know it, kiwi city total street art wonderland"
1,3,2,49,1,9,0,51,0,daughter death made something terrible facebook
1,2,19,62,1,18,0,81,0,"trailer raees out, dilip kumar thanks fan wishing speedy recovery ent"
1,1,10,41,0,9,0,51,0,household ingredient actually skin
1,1,8,31,0,8,2,39,0,19 first close mum daughter go
1,1,16,54,3,16,2,70,0,"guy covered ""sorry"" 20 different way i've never wanted hear apology"
1,2,3,88,2,17,0,91,0,want live longer? avoid sex: nun stronger immune system less vulnerable infection
1,1,14,55,1,13,0,69,0,woman help faint boyfriend surprised proposal
1,1,7,32,2,5,0,39,0,where's best family-friendly vacation spot
1,1,13,36,1,12,0,49,0,eddie redmayne going dad happier
1,1,10,39,0,9,0,49,0,important writing tip neil gaiman
1,2,3,70,1,12,0,73,0,scottish independence referendum: nicola sturgeon said really meant
1,1,12,40,0,12,2,52,0,18 greatest photo taken place inside photo booth
1,1,12,29,0,12,2,41,0,27 tip hack get tiny home
1,1,10,35,0,9,0,45,0,kate hudson goldie hawn mom daughter goal
1,1,11,33,2,10,0,44,0,take *get* crossword puzzle
1,1,8,32,3,7,0,40,0,"""the emperor's new groove"" character"
1,2,10,56,2,11,0,66,0,"despite decline american marriages, couple still pay nation tax"
1,1,11,40,0,10,0,51,0,human new york parody account orcs everything
1,1,12,46,0,11,0,58,0,people open take medication mental health
1,3,13,73,0,15,0,86,0,public university threatened punish student refusal remove trump sign dorm window
1,3,1,50,0,9,0,51,0,teen faked proposal free food everything
1,1,10,35,1,9,0,45,0,woman look much like angelina jolie scary
1,1,8,32,0,7,0,40,0,book helped manage anxiety
1,1,8,29,0,8,2,37,0,33 fact probably need know tinder
1,2,6,33,1,8,0,39,0,baby carrot healthful carrots?
1,1,11,26,0,9,0,37,0,tv town would perfect fit
1,3,9,42,6,9,0,51,0,fact check: spicers pre-emptive attack nonpartisan c.b.o.
1,1,11,61,0,10,0,72,0,kate winslet criticised actress speaking publicly pay inequality
1,1,11,45,3,10,0,56,0,"""making murderer"" filmmaker think steven avery guilty"
1,3,5,32,0,10,7,37,0,135 police officer killed line duty 2016
1,1,8,28,1,7,0,36,0,trap questions. answer
1,1,13,45,3,12,0,58,0,"bunch people texting ex adele's ""hello"" lyric"
1,2,12,26,4,8,4,38,0,"d.c. area ice roundup net 82, including ms-13 member"
1,2,14,57,0,15,0,71,0,dad ballet daughter thing need watch today
1,1,8,25,0,7,2,33,0,17 adorable reading nook cosy af
1,3,2,22,0,4,0,24,0,meeting lebanese drug lord
1,2,13,60,0,13,0,73,0,nyc man allegedly pushed army veteran oncoming traffic charged murder
1,1,11,47,0,11,2,58,0,21 weird report coming british columbia concerned
1,3,4,66,2,13,3,70,0,saturday morning fever: getting drunk bloody mary dancing louisiana 8.30am
1,1,7,28,2,6,0,35,0,"celeb danish, norwegian, swedish"
1,1,12,47,0,11,0,59,0,tried get away wearing fancy sweatpants four different way
1,2,9,48,2,10,2,57,0,"illegal immigration fell 67 percent trump, say fmr. border chief"
1,1,7,28,0,6,0,35,0,celebrity life coach
1,1,5,26,0,4,0,31,0,couple prove opposite attract
1,1,8,24,0,7,0,32,0,brave enough date werewolf
1,1,7,23,1,7,2,30,0,many iconic '70s film seen
1,1,12,37,2,11,0,49,0,"rare cat ""neko atsume"" based zodiac"
1,1,9,32,0,8,0,41,0,chicken nugget dream made
1,1,16,47,2,13,0,63,0,"""pll"" cast reveals character like five year future"
1,1,13,56,1,12,0,69,0,bajirao mastani's flaw make perfect tribute great indian storytelling
1,1,8,20,0,9,6,28,0,26 people way worse 2015
1,1,7,31,0,6,0,38,0,food natural genetically modified
1,3,7,18,0,6,0,25,0,best rap verse month
1,1,5,15,0,4,0,20,0,fancy pant
1,1,17,40,0,16,0,57,0,story love time war melt mush feel
1,1,14,50,0,13,0,64,0,jennifer lawrence nervous first sex scene got drunk
1,1,9,41,1,9,2,50,0,25 family halloween costume convince kid
1,3,10,66,2,10,0,76,0,biographer claim barack obama called america racist society unpublished manuscript
1,1,15,63,3,12,0,78,0,here's mouthwatering step-by-step guide making insanely delicious fried chicken
1,3,2,28,1,6,0,30,0,pop future black british
1,1,10,41,0,10,2,51,0,21 delicious affordable thing need eat nashville
1,3,12,55,1,15,0,67,0,man stung painful insect earth hard watch
1,1,12,31,0,11,0,43,0,look like get tased slow motion
1,1,9,20,1,8,6,29,0,15 foolproof diys want try 2016
1,1,8,27,1,7,0,35,0,what's best fast food burger america
1,1,12,50,0,11,0,62,0,fan sharing touching beautiful artwork tribute david bowie
1,2,4,33,0,6,0,37,0,selena gomez weeknd spotted kissing
1,1,10,34,1,10,2,44,0,15 christian care starbucks cup
1,3,8,48,1,7,0,56,0,venezuela mysterious stock inflow leaving trader perplexed
1,1,8,32,0,7,0,40,0,adorable nickname give dog
1,1,10,33,1,9,0,43,0,know plan spending valentine's day
1,3,7,37,0,7,0,44,0,grenade attack swedish suburb leaf one injured
1,1,14,56,0,13,0,70,0,american listened coke studio first time pretty damn impressed
1,1,8,37,0,7,0,45,0,gum commercial making people everywhere weep
1,1,7,23,0,6,0,30,0,name next child
1,1,10,43,3,9,0,53,0,"""date rape"" bloomingdale's ad causing mass outrage online"
1,1,12,49,1,12,2,61,0,12 corporate mascot childhood cool thought
1,1,6,24,1,5,0,30,0,sign dating wrong person
1,1,7,33,0,7,2,40,0,17 secret olive garden employee never tell
1,1,21,66,3,18,0,87,0,jennifer lawrence's real-life best friend called tv find replaced amy schumer
1,2,4,39,2,8,0,43,0,afghanistan: successful group been?
1,2,4,61,3,13,0,65,0,trump wasnt happy state department finalists. heard new name.
1,1,8,35,0,9,6,43,0,17 people absolutely killing dreamforce 2015
1,1,9,39,0,9,2,48,0,21 thing everyone scared spider understand
1,1,5,23,0,6,6,28,0,29 celebrity 2006 compared
1,1,8,34,0,8,2,42,0,21 text everyone anxious definitely sent
1,2,4,46,4,10,2,50,0,nfl alternate realities: biggest draft 'what if?' 32 team
1,1,12,50,3,10,0,62,0,"couple too-real conversation jealousy, sexuality, honesty"
1,2,5,22,0,6,0,27,0,brew ultimate iced tea
1,1,7,20,0,7,2,27,0,27 happiest cat world
1,2,2,54,3,9,1,56,0,9 up-and-coming healthy fast food chain scare mcdonald's
1,1,12,45,0,11,0,57,0,know celebrity boyfriend based one question
1,1,11,42,0,11,2,53,0,25 amazing gift anyone spends time snacking
1,2,3,9,3,4,4,12,0,"wear $3,074 bra?"
1,3,15,51,2,14,0,66,0,"course louis ck joke suicide, abortion race new netflix special"
1,2,10,63,4,11,0,73,0,university wisconsin-madison: problem whiteness course meant offensive
1,1,6,24,7,5,0,30,0,"f#@k, marry, kill: ""divergent"" edition"
1,1,11,50,0,11,2,61,0,24 hilariously true tweet retail worker plastic bag charge
1,1,12,49,1,11,0,61,0,two adorable little girl found mark ruffalo's lost phone blizzard
1,3,8,34,1,9,0,42,0,protect tax refund scammer yahoo
1,2,4,47,1,10,2,51,0,pearl harbor: wound war still hurt 95yo japanese veteran
1,1,14,50,2,13,0,64,0,"canada created burger melted reese's peanut butter cups, tried"
1,1,12,41,1,11,0,53,0,couple got ancestry traced go planned
1,2,16,50,3,15,0,66,0,love harry potter wont able get post withoutcrying
1,1,8,20,0,7,0,28,0,grow
1,1,16,55,2,13,0,71,0,"bryan cranston tried send dvd ""breaking bad"" international space station"
1,1,11,37,2,11,2,48,0,19 photo really laugh adult
1,1,11,44,0,11,2,55,0,15 secret puppet builder jim henson company never tell
1,1,9,32,1,8,2,41,0,19 life-altering way put booze cake together
1,2,8,44,2,9,0,52,0,heartbreaking: terminally ill boy dy santa's arm insider
1,1,7,29,1,7,2,36,0,16 thing know happened dementia
1,1,7,26,2,6,0,33,0,"""laguna beach"" romance ship"
1,1,14,58,1,12,0,72,0,guess kardashian/jenner sister favorite based three question
1,1,9,33,1,9,2,42,0,identify '80s movie based screencap
1,1,12,39,0,11,0,51,0,latina beauty queen named new face revlon
1,1,7,25,3,6,0,32,0,"people think ""look latina"""
1,2,3,41,2,9,0,44,0,what's deal yahoo changing name altaba?
1,1,11,41,0,11,2,52,0,28 thing make impossibly happy matter mood
1,1,7,31,0,7,2,38,0,23 perfect gift anyone obsessed butt
1,3,12,46,0,11,0,58,0,playlist hopefully help get next four year
1,1,19,54,4,17,2,73,0,"65-year-old man's typewriter destroyed angry cop, internet got new one"
1,1,14,42,0,13,0,56,0,emma watson starting feminist book club want name
1,2,9,39,3,9,3,48,0,ranking 124 episode 'it's always sunny philadelphia'
1,1,10,33,0,9,0,43,0,rock rescued adorable new puppy labor day
1,1,12,37,0,11,0,49,0,reminder really meant militant feminist
1,2,4,64,1,14,0,68,0,"attractive people u come from, according dating app hinge"
1,1,8,28,0,8,0,36,0,well know country africa
1,1,8,25,0,8,2,33,0,23 powerful photo week
1,1,7,31,1,6,0,38,0,here's actually start exercising
1,3,3,47,1,11,0,50,0,anatomy miracle: patriot came back dead
1,1,8,17,0,6,0,25,0,tv mom mom
1,1,10,44,2,9,0,54,0,"hogwarts house ""gilmore girls"" character belong"
1,2,9,30,2,9,1,39,0,5 fall beauty trend rock right [video]
1,1,5,35,0,5,2,40,0,32 ridiculously clever group halloween costume
1,1,4,12,0,3,0,16,0,evolved
1,1,17,43,0,16,0,60,0,dad four girl total meltdown learned son
1,3,2,57,0,12,0,59,0,insane end oscar sent false message racial progress
1,1,8,30,0,7,0,38,0,thought waiting get tested
1,1,8,31,0,7,0,39,0,dad everywhere fallen love adele
1,1,6,23,0,5,0,29,0,people try define yiddish word
1,2,7,41,1,7,0,48,0,india microloan meltdown taught one entrepreneur
1,1,5,25,0,4,0,30,0,delicious pull apart bread recipe
1,1,11,59,0,10,0,70,0,couple totally shocked father adorable pregnancy announcement
1,1,9,39,1,9,2,48,0,19 healthy drink bartender hate ordering
1,2,14,52,1,13,0,66,0,someone created meme coloring book everything never knew weneeded
1,2,1,56,1,12,0,57,0,free college tuition could become reality least state
1,1,6,32,0,6,2,38,0,27 important question teacher asked
1,1,10,38,0,10,2,48,0,27 worst thing going stock photo university
1,1,9,27,0,8,0,36,0,many food court place eaten
1,1,12,40,1,11,0,52,0,people flipping adele's flip phone new video
1,3,7,40,3,9,2,47,0,dubai $36 billion plan build world biggest airport
1,2,9,55,3,12,0,64,0,pelosi: think press accomplice undermining election
1,3,2,63,1,12,2,65,0,11 people thing celebrate valentine's day besides significant
1,1,10,33,1,10,6,43,0,21 people took passive-aggressive new level 2015
1,1,10,47,0,10,2,57,0,31 ridiculous thing people bought drunk grocery shopping
1,1,10,32,0,8,0,42,0,many spongebob face recognize
1,1,12,50,0,11,0,62,0,artist leaving cool little joke across london year
1,1,8,32,0,6,0,40,0,famous youtuber valentine
1,2,14,66,6,15,2,80,0,"fmr clinton spox: comey letter decisive without it, hillary clinton would 45th president"
1,3,6,65,2,12,0,71,0,dr karl: get pregnant pregnancy? featured story additional story
1,1,5,16,0,6,6,21,0,24 best fiction book 2015
1,1,6,25,4,5,0,31,0,"character ""haikyuu!!"""
1,3,4,64,4,16,0,68,0,megyn kelly one highest-paid host tv here's salary rank
1,1,12,43,0,12,5,55,0,9 thing tv movie actually understand latino 2016
1,1,10,47,1,9,0,57,0,anne hathaway's birthday instagram caption random amazing
1,1,8,23,1,7,0,31,0,here's look like hiding yawn
1,3,3,47,3,9,0,50,0,xenomorphs back first trailer 'alien: covenant'
1,1,12,29,0,8,0,41,0,solve crossword buzzfeed bff
1,1,6,34,0,6,2,40,0,13 basic cooking technique everyone know
1,1,9,28,0,8,0,37,0,match iconic costume quote
1,3,11,36,9,11,0,47,0,"t.i. kanye west's trump meeting: 'what f*ck doing, man?'"
1,1,9,20,0,8,0,29,0,life without cat v life cat
1,2,10,29,3,9,0,39,0,"miley cyrus next album going weird,yall"
1,2,4,46,1,10,0,50,0,english sound people speak english list
1,1,10,40,0,10,2,50,0,24 candy cane themed dessert better boyfriend
1,1,6,24,0,6,2,30,0,32 reason milan absolute worst
1,1,5,14,0,3,0,19,0,buzzfeed love test
1,1,10,35,0,10,2,45,0,28 impossibly cute way cover body outer space
1,2,7,42,1,10,0,49,0,"denmark, passage rule immigration called cake"
1,1,6,31,2,7,4,37,0,"23 picture people 5'5"" never understand"
1,2,8,46,1,8,0,54,0,airbus-boeing speed race increasingly take place ground
1,3,9,31,0,9,4,40,0,know relationship status in2017
1,1,2,12,0,1,0,14,0,unrequited love
1,1,10,29,0,10,2,39,0,17 way make shower best place earth
1,2,11,54,1,11,0,65,0,oscar shocker: warren beatty faye dunaway read wrong best picture winner
1,3,9,54,1,11,2,63,0,trudeau effect: canadian distrust government first time 17 year
1,1,9,41,1,8,2,50,0,17 glorious bacon-wrapped food sexually awaken
1,1,14,63,1,13,0,77,0,gorgeous set photo upcoming film legendary trans activist marsha p. johnson
1,1,9,28,0,8,0,37,0,prefer broadway show movie
1,3,1,47,0,10,0,48,0,state give best return tax dollar
1,1,7,24,1,9,8,31,0,15 song believe turning 10 2016
1,2,1,46,2,9,0,47,0,"apple said secretly working diabetes ""holy grail"""
1,1,9,32,1,8,0,41,0,guess smashed valentine's day candy
1,1,9,40,0,9,2,49,0,16 celebrity family adorable instagram
1,1,17,49,1,16,0,66,0,"pair twin got married another pair twins, officiated pair twin"
1,2,12,39,0,11,0,51,0,favorite book character real feel
1,1,16,43,0,15,0,59,0,man allegedly threw semen woman way work
1,1,5,20,0,4,0,25,0,show u colorful tattoo
1,1,10,33,0,9,0,43,0,green dot test know easily get jealous
1,1,12,49,2,11,0,61,0,here's everything need know year's best picture nominee
1,1,13,44,0,12,0,57,0,personalize adult coloring book name
1,1,6,39,3,7,5,45,0,"25 thing totally, definitely, 100% absolutely happened"
1,1,8,47,2,8,1,55,0,9 image donald trump photoshopped ~millennial situations~
1,1,9,33,0,9,2,42,0,25 picture prove pumpkin spice gone far
1,1,13,64,2,13,2,77,0,23 thing understand committed relationship hair straightener
1,1,11,35,0,10,0,46,0,green gummy bear lying whole life
1,1,9,38,1,8,0,47,0,woman tropical eye makeup mesmerizing
1,1,7,19,0,7,2,26,0,15 way terrible person
1,3,4,41,1,9,1,45,0,woman ireland marking christmas january 6?
1,1,14,51,4,14,0,65,0,"couple's ""half half"" photo help share life spite distance"
1,1,5,22,0,4,0,27,0,disney princess pinay
1,1,8,25,0,8,2,33,0,11 chart way real singer
1,2,7,23,4,4,0,30,0,u.s. economy full-tank conundrum
1,2,10,33,7,10,0,43,0,"president says, ill kill video nytimes.com"
1,3,10,42,0,9,0,52,0,carbon xprize turning airborne trash treasure
1,2,12,64,2,11,0,76,0,"another kerala man host lavish wedding daughter, recreates delhi's akshardham temple"
1,3,10,63,4,13,0,73,0,madeleine albright: trump message america first america partner
1,1,11,41,2,12,4,52,0,32 thing understand went university '90s
1,2,9,36,1,9,2,45,0,22 gift dude actually want valentine day
1,1,15,40,1,14,0,55,0,"fed boring humans, town trying elect cat mayor"
1,1,11,32,1,10,0,43,0,favorite part man's face say
1,1,12,25,0,11,0,37,0,part cat need know
1,1,8,32,1,8,2,40,0,25 marvelous gift make better person
1,1,9,43,1,9,2,52,0,19 thing people naturally loud never understand
1,1,9,32,0,8,0,41,0,remember color eye celebs
1,1,15,50,0,14,0,65,0,natasha lyonne fred armisen make debut couple emmy award
1,1,14,24,1,9,0,38,0,"fyi, dj mustard called dj mustard"
1,2,5,40,1,8,0,45,0,watch: greg maddux go incognito prank kris bryant
1,1,7,33,0,7,2,40,0,24 beautiful little phrase tattoo
1,2,1,57,0,11,0,58,0,mystery man donates wedding dress touching note late wife
1,2,1,78,2,15,0,79,0,"uber block employee work chatting popular anonymous app, app's developer say"
1,1,10,38,1,10,2,48,0,46 literary baby name make want child
1,2,10,50,5,9,2,60,0,justin amash: obamacare 2.0 constituencyexcept political class
1,2,9,28,3,7,0,37,0,dirty dancing: see photo abc remake
1,1,8,29,0,7,2,37,0,21 insanely colorful meal healthy af
1,3,11,60,1,9,0,71,0,obama administration allows anti-israel un resolution settlement pas
1,3,8,31,1,7,0,39,0,donald trump's approval rating toilet
1,1,9,28,0,9,2,37,0,17 people want election
1,3,2,56,1,12,2,58,0,got sweet tooth? waiting 25 second remove craving chocolate
1,2,5,18,0,6,6,23,0,46 powerful photo of2016
1,3,2,64,2,16,0,66,0,one want think losing parent. planning make worse.
1,1,8,27,0,8,2,35,0,25 perfect outfit wear fall wedding
1,1,11,43,0,11,1,54,0,8 great wall china review make question humanity
1,1,14,48,2,13,0,62,0,"""secret sister"" gift exchange facebook illegal also hoax"
1,3,2,66,1,15,0,68,0,free brain power: fretting wear could ruining life
1,1,8,26,0,8,2,34,0,23 simple way literal worst today
1,1,8,30,0,8,1,38,0,7 quick tip anyone trying eat healthier
1,1,5,15,0,4,0,20,0,dad actually
1,1,17,49,0,15,0,66,0,tv host accidentally told pier morgan could sit face live air
1,1,13,38,0,12,0,51,0,one reason get rid smartphones
1,1,8,30,1,8,2,38,0,17 awkward moment jew christmas
1,1,10,33,0,9,0,43,0,guess actual scout badge
1,3,2,42,0,9,0,44,0,los angeles top list dog attack mail carrier
1,1,5,31,1,5,2,36,0,22 kourtney kardashian's deepest thought
1,1,7,20,0,8,5,27,0,8 trans trope need retire 2016
1,3,13,58,3,12,5,71,0,30-something entrepreneur giving 100 year-old automotive industry tune-up
1,3,2,58,3,11,0,60,0,apple might totally redesign next iphone here's everything know
1,1,6,18,0,5,0,24,0,make right choice
1,1,9,24,0,6,0,33,0,tlc show match zodiac sign
1,1,4,14,0,3,0,18,0,chicken nugget king
1,1,14,46,0,13,0,60,0,beardless guy got fake beard day found hairy alter ego
1,1,9,30,2,10,2,39,0,17 snow day recipe cook (or drink) right
1,1,9,53,2,8,0,62,0,amul's new cartoon perfectly mock jayalalithaa's relief sticker debacle
1,1,9,35,1,9,1,44,0,rihanna no. 1 single michael jackson
1,3,1,37,0,6,0,38,0,eight food superpower immune system
1,3,10,52,2,11,0,62,0,"best eco-friendly superyachts, toy tender help save planet"
1,1,9,34,2,8,0,43,0,"anyone else notice visible penis ""the martian"""
1,3,9,33,0,9,2,42,0,10 thing anyone love introvert need know
1,2,12,41,4,8,0,53,0,worldstarhiphop founder lee q odenat's cause death revealed
1,1,8,41,0,8,2,49,0,17 type holiday hangover illustrated crappy snowman
1,1,12,36,1,12,1,48,0,7 way men think women's leg move bad porn
1,3,10,55,2,9,0,65,0,ten questionable federal govt expenditure greater trump border wall
1,1,9,40,0,9,2,49,0,16 underrated mumbai street food change life
1,1,9,34,0,9,2,43,0,23 thing people wheelchair cope
1,1,12,34,2,12,2,46,0,"21 gift every ""back future"" fan future"
1,1,7,34,0,7,2,41,0,14 horror movie would actually terrify woman
1,1,11,45,0,10,0,56,0,know favorite holiday tradition based one question
1,1,9,31,0,8,0,40,0,like queen cersei queen margaery
1,2,6,32,1,7,0,38,0,ann coulter: silence lamb congress
1,2,9,45,4,9,0,54,0,"lansing, michigan, longer declare sanctuary city"
1,2,10,36,0,10,2,46,0,12 piece advice aziz ansari love anddating
1,3,3,62,1,15,0,65,0,man made sexist joke wife. got ultimate revenge list
1,2,3,48,2,10,0,51,0,obama's big trade setback ominous sign business insider
1,1,12,43,0,11,0,55,0,biggest session drummer time ready spotlight
1,1,12,54,0,11,0,66,0,french montana wearing slipper beach make feel uncomfortable
1,1,12,52,1,11,0,64,0,sephora minnie mouse collection every disney lover's dream come true
1,1,11,40,0,11,2,51,0,15 cheap super creative way decorate home map
1,1,14,48,2,11,0,62,0,know tv show binge-watched based relationship status
1,1,9,38,1,9,2,47,0,17 tweet whole food actually make laugh
1,2,1,25,2,5,0,26,0,russia art 'kompromat'
1,3,9,32,1,8,2,41,0,19 anti-memes people evolved pastmemes
1,1,9,50,1,8,0,59,0,hillary clinton's campaign accidentally tweeted pizza anal
1,1,6,27,0,6,2,33,0,16 beautiful quote inspire
1,1,6,26,2,5,0,32,0,"""scream queens"" character"
1,2,7,48,0,8,0,55,0,facebook censor iconic statue neptune containing nudity
1,1,11,39,0,9,0,50,0,tried youtube makeup tutorial happened
1,1,6,20,0,5,0,26,0,penis horror story
1,1,9,41,0,8,0,50,0,liam hemsworth chris hemsworth valentine
1,3,11,55,2,12,1,66,0,supreme court's latest national anthem conundrum 5 major read today
1,2,2,42,2,8,0,44,0,tim tebow's debut give fan wanted: heroic
1,1,12,46,0,11,0,58,0,zodiac perfect match based favourite video game
1,1,10,38,0,10,2,48,0,10 celebs drinking fountain youth
1,1,9,40,2,7,0,49,0,television's first asian-american action hero letdown
1,1,8,34,0,8,2,42,0,18 gift idea people obsessed fluffy thing
1,1,8,30,0,7,0,38,0,alexander hamilton aaron burr
1,1,11,37,0,10,0,48,0,would never front significant
1,1,9,32,2,8,0,41,0,"""harry potter"" deathly hallows"
1,1,13,42,0,12,0,55,0,know celebrity crush based first letter name
1,3,3,68,1,16,0,71,0,gallery country island earth best
1,1,10,23,0,10,2,33,0,24 rule woman first date man
1,1,9,32,0,9,2,41,0,find 23 chameleon hiding forest
1,1,7,23,0,6,0,30,0,actually smarter crow
1,1,8,29,1,8,2,37,0,27 perfect print wall wish buy
1,1,6,42,2,6,2,48,0,"17 outrageosly funny ""cards humanity"" combination"
1,1,10,36,2,9,0,46,0,"actor best ""game thrones"" themed birthday"
1,2,5,27,0,8,6,32,0,11 memorable pop culture moment 2016
1,1,11,47,2,10,0,58,0,rashida jones understand half movie woman
1,1,8,35,2,7,0,43,0,"zodiac sign ""high school musical"" character"
1,1,16,32,2,12,0,48,0,psa women: everyone going like that's ok
1,3,14,58,2,18,3,72,0,13 thing know chart week: little big town brings taylor swift back no. 1
1,1,12,40,1,11,0,52,0,apparently chance rapper going kanye's new album
1,3,9,46,5,9,0,55,0,"republican party, kong: skull island: friday evening briefing"
1,1,10,44,1,9,0,54,0,androgynous model changing face victoria's secret
1,1,13,53,0,12,0,66,0,arsenal praised premier league club raise money refugee
1,3,16,52,6,15,0,68,0,"official, neil nitin mukesh play aamir khan's role dil chahta hai. wait, what?"
1,1,10,29,0,9,0,39,0,know got wanted christmas
1,1,9,32,0,8,0,41,0,many british dessert tried
1,3,3,23,0,4,0,26,0,dwindling odds coincidence
1,1,8,36,0,8,2,44,0,25 thing teetotaller twenty get
1,1,7,31,0,7,2,38,0,21 time completely betrayed crisp
1,1,11,43,0,10,0,54,0,people losing shit new mysterious adele advert
1,1,8,27,0,7,0,35,0,much spend mental healthcare
1,2,17,61,4,15,0,78,0,"mukesh khanna dropped major hint shaktimaan's comeback tv yes, we're excited!"
1,1,7,31,0,7,2,38,0,35 totally brilliant way eat chocolate
1,1,11,39,1,10,0,50,0,disney valentine's day card give bae
1,3,6,20,0,5,0,26,0,star goldman trader go cold
1,3,11,40,2,9,0,51,0,morgan stanleyvoice: auto insurer road nowhere?
1,1,4,14,3,4,2,18,0,"30 word ""fart,"" ranked"
1,3,9,43,3,13,3,52,0,kerry trump: problem policy made 140 character
1,3,8,41,1,11,2,49,0,poll: 49 percent approve job trump president
1,2,3,66,1,14,4,69,0,group giving away 4200 joint trump's inauguration smoking list
1,3,2,45,2,9,0,47,0,type 'ceo' iphone keyboard sexist surprise
1,1,9,33,1,8,0,42,0,what's favorite food based zodiac sign
1,3,17,52,2,14,0,69,0,"bollywood's mr india anil kapoor stand atm queue, pose picture fan"
1,2,12,43,2,12,3,55,0,"100 days, donald trump hasnt done much except show signature"
1,1,8,39,1,8,2,47,0,19 christmas eve tradition probably know
1,1,8,37,0,7,0,45,0,watch gay men give lesbian wardrobe makeover
1,3,16,58,3,12,0,74,0,"mahira khan's video go viral, virat-anushka engaged entertainment"
1,2,10,32,1,9,0,42,0,beat infuriating z geographyquiz?
1,1,11,51,0,10,0,62,0,steven avery sent handwritten letter local news station prison
1,1,10,31,0,9,0,41,0,scandal would olivia pope fix
1,1,8,29,1,6,0,37,0,pumpernickel mini-pig give life
1,1,12,43,2,13,2,55,0,20 thing need know famous bed bath beyond coupons*
1,1,10,38,2,8,0,48,0,curly-haired women: tell u incredible hair tip
1,1,10,35,3,10,4,45,0,"$2,000 rent get san francisco vs. everywhere else"
1,1,6,25,0,6,2,31,0,17 winter hack canadian swear
1,3,1,50,3,11,1,51,0,"follow passion wrong, 7 habit need instead"
1,1,9,30,0,8,0,39,0,taco epitome cheese cheese
1,3,9,33,3,8,0,42,0,long would survive 'the belko experiment'?
1,3,10,56,4,13,0,66,0,ivanka trump booed womens event berlin: president champion family
1,1,12,36,0,11,0,48,0,amazing wine glass make look drunk feel
1,1,9,40,0,8,0,49,0,clever artist make hilarious collage dog
1,2,8,54,1,10,0,62,0,celebrity turned drove support nationwide women's march
1,1,11,42,0,10,0,53,0,dunder mifflin employee based zodiac sign
1,1,7,31,0,7,2,38,0,26 incredible thing people love yellow
1,1,5,19,0,6,6,24,0,19 best nonfiction book 2015
1,1,8,24,0,7,0,32,0,much instagram cliche
1,1,13,48,3,12,0,61,0,"""great detective pikachu"" game come america scream"
1,2,14,51,3,13,0,65,0,"yazidi activist: islamic state cut open friend, raped baby, raped"
1,2,9,43,1,9,2,52,0,paris police: 16 arrested kim kardashian west jewelry heist
1,1,7,23,0,6,0,30,0,bad review movie poster
1,1,14,56,1,13,0,70,0,dog groomer's insanely cute instagram account take happy place
1,1,11,38,3,10,0,49,0,"stop listen ""golden girls"" remix"
1,1,9,36,0,9,2,45,0,17 time internet perfectly summed gemini
1,1,13,33,1,11,0,46,0,watch guy write book real-time right
1,1,8,36,0,8,2,44,0,29 tweet every single hairdresser relate
1,1,11,45,0,11,2,56,0,13 chart make total sense people impostor syndrome
1,1,4,9,0,3,0,13,0,pet died
1,1,5,17,0,4,0,22,0,monday monday
1,1,14,65,0,13,0,79,0,controversial boxer tyson fury stripped heavyweight title two week winning
1,3,7,36,0,7,2,43,0,11 quick fact potential government shutdown
1,2,8,32,0,8,4,40,0,common password 2016 truly terrible
1,2,16,66,2,14,0,82,0,"unhappy officials' presentation development works, pm modi walk meeting midway"
1,3,8,31,1,7,0,39,0,milky way collide andromeda?
1,1,5,23,1,5,2,28,0,18 time siri handle canada
1,3,6,82,3,22,0,88,0,"chaps, blood type letting bed? men a, b ab four time likely suffer impotence"
1,1,7,36,1,6,2,43,0,29 thing non-germans find bewildering germany
1,3,9,37,1,11,0,46,0,happens skin wear makeup gym?
1,3,8,23,1,8,2,31,0,39 gift youd buy money noobject
1,3,2,40,2,6,0,42,0,hidden cost made-in-america retail bargain
1,1,6,27,3,6,2,33,0,"angelica pickles' best 18 line ""rugrats"""
1,1,10,39,2,9,0,49,0,"""hamilton"" character based zodiac sign"
1,1,12,47,0,11,0,59,0,new yorker released perfect cartoon tribute alan rickman
1,1,9,38,0,7,2,47,0,22 insanely adorable diy decoration holiday party
1,3,10,35,0,9,0,45,0,single best way stay motivated every single day
1,2,2,59,3,9,0,61,0,student creates enormous 'simpsons' portrait college's wintry lawn
1,3,4,14,2,5,0,18,0,desk want know
1,1,10,52,2,9,0,62,0,"probably missed adorable foreshadowing ""parks recreation"""
1,3,10,29,1,10,4,39,0,genius get 13/13 visual riddlequiz
1,2,2,64,2,15,0,66,0,dozen couple went top fertility clinic. may used wrong sperm.
1,1,8,23,0,8,2,31,0,10 jean hack keep look point
1,3,12,54,0,10,0,66,0,hollywood pr firm sunshine sachs cancel christmas party trump
1,1,9,19,5,8,2,28,0,"18 time ""house m.d."" got way, way real"
1,1,10,28,0,10,2,38,0,15 time canadian cop much fun job
1,2,10,44,1,12,4,54,0,"police shoot tear gas disperse hot 97 summer jam crowds, 61 arrested"
1,3,2,30,0,5,0,32,0,trump rooster statue erected china
1,3,14,56,4,13,0,70,0,"jayalalithaa's health, modi win 'person year' award must read story"
1,1,6,20,0,6,2,26,0,16 sibling last laugh
1,1,10,28,1,9,2,38,0,15 perfect mug anyone love good f-bomb
1,1,13,46,2,13,1,59,0,answer 3 question we'll guess bad new year's hangover
1,3,1,33,0,9,2,34,0,19 way make mac run faster right
1,1,10,22,2,7,0,32,0,dear harry styles' pant amas:
1,1,5,21,0,5,2,26,0,23 photo guaranteed upset
1,3,1,42,0,10,0,43,0,hero mom sends son care package full garbage
1,1,11,41,0,11,2,52,0,21 tweet contact lens make laugh loud
1,1,10,27,0,10,4,37,0,think win 2015 emmy award
1,1,5,11,0,5,2,16,0,vito died 59
1,1,16,60,4,14,0,76,0,"woman's viral video heartbreaking experience cashier true, wal-mart say"
1,1,8,24,0,7,0,32,0,one way using nutella
1,1,9,31,0,9,2,40,0,15 cute way let everyone know love manatee
1,1,11,50,0,11,2,61,0,31 book help better understand mental illness disorder
1,3,9,39,2,7,0,48,0,world largest mutual-fund firm want europe action
1,2,11,52,2,10,0,63,0,blake lively ryan reynolds' newborn daughter's name totally adorable
1,1,8,33,0,8,2,41,0,24 wife crushing whole marriage thing
1,1,15,64,2,14,0,79,0,"isolated vocal track freddie mercury david bowie singing ""under pressure"" amazing"
1,1,8,39,0,8,2,47,0,23 photo people straight hair never understand
1,3,10,38,3,10,0,48,0,"stop everything, cast harry potter groupchat"
1,1,9,28,0,8,0,37,0,queen based zodiac sign
1,3,11,55,5,13,0,66,0,fiona apple sings trump nut roasting open fire charity concert (video)
1,1,8,20,0,8,2,28,0,15 thing may may amaze
1,1,13,51,0,12,0,64,0,warwick rower dating based favorite disney movie
1,1,13,37,2,10,0,50,0,would get chanel-o-ween based birth month
1,1,8,32,0,7,0,40,0,acceptable way serve sweet potato
1,1,5,26,1,3,0,31,0,people try holiday-themed cocktail
1,1,8,41,0,7,0,49,0,eddie redmayne occasionally pay rent drama student
1,1,8,24,2,7,0,32,0,"well actually know ""star wars"""
1,3,12,33,1,8,0,45,0,"disney could sell espn, due massive subscriber loss"
1,2,9,39,5,9,4,48,0,"'star wars,' 'justice league' biggest blockbuster 2017"
1,1,17,57,0,16,0,74,0,girl whose entire family got killed act arson want card christmas
1,1,6,22,0,6,2,28,0,21 crock pot dump dinner winter
1,2,11,30,0,11,2,41,0,21 people forgot word made shit
1,1,9,30,0,9,2,39,0,find horoscope week october 26
1,2,1,74,3,14,0,75,0,"police decide man touching woman's thigh bus harassment, ridiculous reason"
1,1,9,36,2,9,1,45,0,"8 halloween costume ""game thrones"" fan get"
1,1,10,38,0,10,2,48,0,33 dwight schrute joke still make laugh every time
1,1,7,24,0,6,0,31,0,adele frenchie want say hello
1,1,6,21,0,6,2,27,0,12 time adulting hard
1,1,13,32,0,10,0,45,0,bffs tried sensual yoga time life
1,1,12,38,2,12,2,50,0,"18 clever imgur post ""back future"" fan love"
1,3,1,50,2,8,0,51,0,teenage asylum seeker fighting life 'savage' attack
1,1,11,52,0,10,0,63,0,gay lesbian battle putting together ikea furniture
1,1,13,62,0,12,0,75,0,restaurant selling sandwich named alleged rapist violent men
1,1,10,42,0,10,4,52,0,know relationship status based opinion 2015
1,2,8,27,0,8,2,35,0,16 kid straight horrormovie
1,1,10,40,2,8,2,50,0,17-year-old artist created incredible map literature
1,2,7,20,1,7,6,27,0,fintech 50 2016: future money
1,1,5,29,1,5,2,34,0,11 thing definitely googled
1,3,1,67,1,12,0,68,0,"cheater likely unfaithful partner multiple times, say study"
1,1,7,28,1,6,0,35,0,dear people sober january
1,2,1,58,2,12,0,59,0,"smartphone know lot you, mental health?"
1,1,11,31,0,10,0,42,0,dress gym without looking like tool
1,2,2,37,1,7,2,39,0,gallery world's 18 greatest city food
1,2,6,26,2,8,4,32,0,300-year quest make foolproof 1 coin
1,1,13,47,0,11,0,60,0,female tv character soulmate based favorite food
1,1,11,42,0,11,2,53,0,39 essex sentence confuse fuck everyone else
1,1,8,22,0,7,0,30,0,pas viral quiz ever
1,2,11,33,1,9,0,44,0,exclusive: patient extreme form tb sent nih
1,2,10,44,2,9,0,54,0,"pair google home device claim theyre human, quote nickelback"
1,1,5,25,0,5,2,30,0,23 joke hilariously british
1,1,17,52,7,14,0,69,0,"mom's parody weeknd's ""i can't feel face"" totally nail back-to-school life"
1,1,10,42,0,10,1,52,0,9 way save sanity wednesday thanksgiving
1,1,8,34,0,8,2,42,0,24 way chrissy teigen slaying pregnancy game
1,1,11,34,0,10,0,45,0,little boy driven around furry best friend
1,1,9,33,1,9,2,42,0,26 time ryan reynolds' tweet made laugh loud
1,1,6,9,0,4,0,15,0,sex iq
1,2,3,74,1,14,0,77,0,badass woman exercising maya angelou's poetry inspiration need today
1,3,5,30,0,10,6,35,0,19 thing happened first time 2016
1,1,19,63,1,18,0,82,0,i'm start rumor andi dorfman chris harrison dating based two photo
1,3,1,45,1,8,0,46,0,advert motorcycle television?
1,1,9,32,0,9,2,41,0,22 thing tell best friend right
1,3,4,47,3,10,2,51,0,"mixed message: 84 lumber's super bowl ad spur outrage, confusion"
1,1,4,24,0,3,0,28,0,goldendoodle halloween
1,1,9,39,0,9,1,48,0,4 way easily remove stubborn price sticker gift
1,2,3,24,0,4,0,27,0,apple carplay going wireless
1,3,6,27,0,6,0,33,0,kim kardashian scare sunday night
1,3,14,57,0,14,0,71,0,tucker grill nyc dem one immigration question liberal answer insider
1,1,17,34,7,16,4,51,0,"p. diddy's ""i need girl (part one)"" best r&b song early 2000s"
1,1,11,37,0,10,0,48,0,new adele song going slay entire existence
1,1,9,30,2,8,2,39,0,21 picture make sense non-cat people
1,1,9,18,1,7,0,27,0,know bf's face touch
1,1,10,39,2,9,0,49,0,"""degrassi"" character based zodiac sign"
1,1,10,30,0,9,0,40,0,forgot find husband black university
1,1,4,20,0,5,6,24,0,28 bros absolutely crushed 2015
1,3,7,32,1,7,0,39,0,"charge hijab hate hoax, say prosecutor"
1,3,11,49,1,10,0,60,0,"man stranded roadside, unknowingly get help raider qb derek carr"
1,1,9,25,0,8,0,34,0,year imagined end closet
1,1,10,48,2,9,0,58,0,"video share fascinating theory ""fallout"" game"
1,1,9,29,3,7,0,38,0,"hey, mcdonald's: fix damn ice cream machine"
1,1,7,32,1,6,2,39,0,21 adorable stuffed animal grown-ass adult
1,1,9,32,4,9,2,41,0,"""mean girls"" premiere peak '00s here's proof"
1,1,6,29,1,5,0,35,0,kim kardashian's amazing placenta
1,3,10,32,0,10,2,42,0,31 useful thing subscribe onamazon
1,1,13,40,2,10,0,53,0,"mini ""arrested development"" reunion sag award"
1,1,7,15,3,6,0,22,0,"""u up?"" text mean"
1,1,9,40,0,9,2,49,0,21 reason american forever indebted british
1,3,6,36,1,7,0,42,0,building board game empire disney shoulder
1,1,10,28,1,9,0,38,0,sob try yoga pose home
1,1,8,30,1,8,2,38,0,13 wise life lesson mindy kaling's new book
1,1,5,25,0,5,2,30,0,17 celebrity black people know
1,3,2,22,1,6,2,24,0,russia: fall rise 25 year
1,3,13,47,1,9,0,60,0,first picture noaa's newest weather satellite incredible
1,1,9,58,2,8,0,67,0,cardboard caviar: documenting homelessness london's bourgeois borough
1,2,19,48,5,12,0,67,0,update: 'serial' team releasing new true-crime show inevitably binge
1,2,9,43,0,12,0,52,0,roman sarcophagus rescued humble duty flower pot
1,1,12,40,0,11,0,52,0,cute handbag designed hide smell weed
1,1,7,43,1,6,0,50,0,boyfriend try girlfriends' sexy halloween costume
1,1,9,47,0,9,2,56,0,21 beautiful wedding dessert better traditional cake
1,1,10,38,0,10,2,48,0,48 thing mildly thrill everyone work office
1,3,15,54,0,14,0,69,0,troll try test gospel singer kirk franklin twitter loving clap back
1,1,8,28,0,7,0,36,0,video game cheat code
1,1,6,7,0,3,0,13,0,std
1,1,9,39,1,8,2,48,0,17 people prove gap-tooth smile totally contagious
1,1,11,42,0,11,2,53,0,21 picture perfectly capture mumbai city love
1,1,12,45,1,11,0,57,0,put sandra bullock billy bob thornton's friendship test
1,1,5,24,0,5,2,29,0,11 thing introvert know
1,1,9,34,0,9,2,43,0,27 time amazon packaging needed chill fuck
1,1,4,12,0,3,0,16,0,could friend
1,1,6,26,1,6,2,32,0,19 sign finally becoming adult
1,1,6,24,0,6,2,30,0,17 picture guaranteed make sad
1,1,12,39,1,9,0,51,0,great news: adele britney spear practically bffs
1,1,9,31,0,8,0,40,0,reminder jennifer lopez real human
1,1,11,40,0,11,2,51,0,26 thing learn date someone love harry potter
1,1,8,28,2,8,2,36,0,"18 thing ""back future"" forgot predict"
1,3,8,38,1,7,0,46,0,day life: balancing productivity creativity
1,1,11,34,1,10,0,45,0,bet can't figure gwen stefani younger
1,2,6,36,0,6,0,42,0,backflip catch attempt rooftop end horribly
1,3,11,54,3,14,0,65,0,"abc news quiz: jean-claude van damme parliament, ned kelly tax dancing"
1,3,15,58,3,14,2,73,0,"luxurious house also world's safest, withstand 20-kiloton nuclear blast"
1,1,6,28,3,5,0,34,0,tell u yourself(ie): demetri martin
1,1,9,29,2,8,0,38,0,"hell happening ""life derek"""
1,3,4,45,0,10,0,49,0,u virgin island paying people visit year
1,3,6,49,0,10,0,55,0,coretta scott king letter elizabeth warren trying read
1,2,15,56,2,14,0,71,0,"lake australia turn pink, look good picture advisable swimming"
1,1,8,31,0,8,2,39,0,28 time adele actually fucking best
1,1,8,35,0,7,0,43,0,raw photo capture first moment motherhood
1,1,9,32,2,8,0,41,0,"emily field ""pretty little liars"""
1,1,15,51,4,14,0,66,0,"""real housewife beverly hills"" ""real housewife new york"""
1,2,3,49,4,11,0,52,0,oscars: everything need know (and thing don't)
1,3,7,35,0,9,0,42,0,deal health care congress go recess
1,1,10,37,0,10,2,47,0,15 snapchats real anyone relationship
1,1,7,37,1,6,2,44,0,23 thing super-organised people understand
1,3,9,62,0,9,0,71,0,planned parenthood donated california ag behind investigation videomakers
1,2,13,54,1,12,0,67,0,pak defense minister threatens nuke israel reading fake news article!
1,1,9,31,1,9,2,40,0,20 thing happen squad
1,1,13,47,3,13,2,60,0,"17 word different meaning ""friday night lights"" fan"
1,1,13,47,3,11,0,60,0,"buzzfeed's ""another round"" podcast newsletter sign"
1,3,7,34,1,7,2,41,0,table tennis player engage epic 10-minute rally
1,1,12,48,2,11,0,60,0,lola 'kalyeserye' based really hard question
1,1,13,55,1,12,0,68,0,woman recreated dan bilzerian's instagram photo half naked men
1,1,4,14,0,4,2,18,0,14 free piece advice
1,3,16,70,8,13,0,86,0,"obamacare architect gruber: aca opponent havent hurt law, theyve heard misinformation"
1,3,4,40,0,7,0,44,0,sol campbell plan london mayor bid conservative
1,3,2,56,1,11,0,58,0,feeling tired? young woman among risk iron deficiency
1,3,9,36,0,9,4,45,0,portugal country everybody visiting 2017
1,1,5,31,0,4,0,36,0,condiment match personality
1,2,8,47,0,10,0,55,0,boston bombing survivor marry firefighter rescued
1,1,9,18,2,8,0,27,0,jar jar binks j. j. abrams
1,1,13,49,1,12,0,62,0,dad built incredible tree fort daughter's bedroom
1,1,9,40,0,9,2,49,0,25 delicious thanksgiving dessert go easy sugar
1,2,1,75,5,17,4,76,0,"'anti-aging' remedy bogus, here's know aging 20 60"
1,2,2,36,0,7,2,38,0,russia bath lotion kill 48 drinker irkutsk
1,1,8,31,2,7,0,39,0,"""high school musical"" song title honest"
1,1,9,35,2,9,1,44,0,9 science story can't miss: bad pharma edition
1,1,15,50,0,14,0,65,0,guess fave disney villain song based fave taylor swift song
1,2,9,44,3,9,0,53,0,"health care, immigration ban, north korea: tuesday briefing"
1,2,7,68,4,17,0,75,0,"want neighbor obamas, ivanka trump jeff bezos? here cost you."
1,1,9,22,2,9,4,31,0,"39 time ""30 rock"" smartest show tv"
1,2,3,37,1,6,0,40,0,best honeymoon destination business insider
1,2,5,46,1,12,0,51,0,star wars: bluff way new rogue one movie
1,1,10,35,0,10,2,45,0,20 gift every wannabe mermaid need ask year
1,1,11,34,0,10,0,45,0,john cena giant hand play tiny tortoise
1,2,9,41,1,9,0,50,0,youtube meet boob tube europe network chase young
1,1,9,30,4,8,0,39,0,"""parks recreation"" ""the office"""
1,3,12,63,4,15,0,75,0,tom cotton: powerful elite reap benefit constant influx low-skill labor
1,1,13,51,2,11,0,64,0,stop whatever right drool korean-style nacho
1,1,14,43,1,13,0,57,0,what's best vacation spot need figure life
1,2,5,63,1,12,0,68,0,"ancient chaco society passed power elite women, new dna evidence find"
1,1,9,37,2,9,2,46,0,"23 important life lesson ""the hunger games"" taught u"
1,1,15,47,3,15,3,62,0,tom brady look like he's 100% moved son's hockey game since bronco loss
1,1,9,35,0,8,0,44,0,woman openly share love stretch mark
1,1,8,28,0,8,2,36,0,13 random christmas rap song ever
1,1,12,50,4,10,0,62,0,"j.k. rowling celebrated finishing ""harry potter"" graffitiing hotel room"
1,1,12,43,2,11,0,55,0,"probably missed one detail fifth ""harry potter"" book"
1,2,3,45,1,10,0,48,0,jeb bush campaign ran course even began
1,2,6,55,4,14,4,61,0,brit award 2017: they? watch? presenting performing?
1,3,7,17,1,6,0,24,0,best city texas?
1,3,4,49,5,10,0,53,0,"again, 'boss baby' 'beauty' battle box office dominance"
1,2,4,57,5,16,1,61,0,'am risk hacked?' need know 'vault 7' document
1,1,3,20,0,3,2,23,0,10 mouthwatering pizza fact
1,1,14,29,0,12,0,43,0,got mac lover try pc happened
1,1,8,35,0,7,0,43,0,small thing frustrate anything
1,2,12,47,5,14,0,59,0,caddell: trump white house going ryan government?
1,1,7,23,0,6,0,30,0,disney nickelodeon kid
1,2,2,29,2,9,8,31,0,"17 best job america pay $100,000"
1,1,6,25,0,7,6,31,0,22 mesmerizing space photo 2015
1,3,6,39,0,10,0,45,0,bbc trolled trump best possible way list
1,1,12,32,1,11,0,44,0,bought insane star war toy
1,2,11,43,0,10,0,54,0,adrien broner arrest video released fighter shot suv
1,3,12,47,4,10,1,59,0,7-year-old's impersonation taylor swift accurate creepy
1,1,6,27,0,6,2,33,0,21 delicious way celebrate mardi gras
1,1,10,37,0,9,0,47,0,british musician based zodiac sign
1,3,10,34,3,10,2,44,0,"22 picture make say damn nature, youscary"
1,1,11,46,0,11,4,57,0,official ranking taylor swift leaving arriving place 2015
1,1,14,55,2,13,0,69,0,"brit try fail label united states, thanksgiving tradition"
1,1,5,21,0,4,0,26,0,daring people try daring shot
1,3,11,46,0,12,1,57,0,9 thing trump said since election might make putin smile
1,1,6,19,1,6,2,25,0,18 cat believe book
1,3,2,45,2,8,0,47,0,"three ""killer apps"" could help human colonize mar"
1,1,8,37,2,8,2,45,0,"36 alternate ""hocus pocus"" title truly accurate"
1,1,9,30,0,8,0,39,0,gift get year
1,1,11,37,3,10,0,48,0,"michael b. jordan got laid fuck filming ""creed"""
1,1,6,29,1,6,2,35,0,21 thing never noticed disneyland
1,1,12,43,0,11,0,55,0,man surprised wife white christmas dream
1,2,4,41,1,11,3,45,0,10 thing samsung galaxy s8 iphone can't
1,1,9,27,0,8,0,36,0,much halloween fan actually
1,3,1,46,1,8,0,47,0,here's important exported good every state
1,3,9,38,3,8,0,47,0,"taiwan, italy, joe mcknight: friday evening briefing"
1,3,7,34,1,7,1,41,0,apple's impressive new technology iphone 8
1,1,9,32,0,8,0,41,0,spot real simpson character
1,2,1,45,1,8,0,46,0,extravagant wedding attended?
1,3,7,37,1,6,0,44,0,scientists: asian pollution causing west coast smog
1,1,13,50,3,11,0,63,0,"trailer joel mchale's ""emoji movie"" hilarious terrifying"
1,1,7,27,0,7,2,34,0,19 thanksgiving dip feed crowd
1,1,8,30,0,8,2,38,0,25 cringeworthy band photo time
1,1,7,37,0,7,2,44,0,26 brilliant gift english nerd appreciate
1,2,2,44,2,8,4,46,0,"magaluf 2015: bucking broncos, budgie smuggler new law"
1,2,6,54,6,11,0,60,0,crucial choice 'self/less' movie clip: would want ryan reynolds' body?
1,1,12,38,0,11,0,50,0,guess zodiac sign based pattern choose
1,1,11,59,4,10,0,70,0,"seven years, someone finally completed ""american ninja warrior's"" final course"
1,1,11,40,1,10,0,51,0,mysterious hand justin bieber's photo belong
1,1,9,36,1,8,0,45,0,hardest premier league badge quiz ever take
1,1,7,24,0,8,4,31,0,21 dinner need 20 minute make
1,1,8,31,0,8,2,39,0,21 insane gadget make iphone even cooler
1,1,11,45,2,9,2,56,0,13-year-old kid making thousand reselling supreme hat tee
1,3,8,43,2,8,0,51,0,pregnant zika: one woman fearful journey childbirth
1,2,1,41,0,10,0,42,0,two worst high dive ever see
1,1,10,32,1,8,0,42,0,watch man transform entire k-pop group
1,3,10,45,0,9,0,55,0,surprising personality trait nail biter common
1,1,12,41,2,11,3,53,0,19 reason taraji p. henson #1 imaginary celebrity bff
1,1,8,32,0,8,2,40,0,17 situation made better holiday
1,1,13,37,0,12,0,50,0,dude take hamster daily walk tiny leash
1,1,10,34,1,10,2,44,0,"26 hilarious tweet work way, way real"
1,3,1,61,5,14,0,62,0,dry cleaner 'gave away' woman's wedding dress help track down?
1,1,10,33,6,9,0,43,0,"poll: better, ""harry potter"" ""game thrones"""
1,1,15,41,0,14,0,56,0,happens marry brownie cookie oven
1,3,6,24,0,5,0,30,0,machine eating wall street
1,1,10,38,0,9,0,48,0,guess avril lavigne video one screenshot
1,1,6,29,0,6,2,35,0,19 expert parenting tip every parent need
1,1,9,39,2,6,0,48,0,three-ingredient no-bake cake insanely delicious
1,1,9,27,0,9,1,36,0,3 toxic type friend get rid
1,2,8,16,0,7,2,24,0,top 50 edm love song time
1,1,9,30,2,7,2,39,0,17 useful wedding cheat sheet bride-to-be
1,1,8,30,0,8,2,38,0,21 time roseanne conner basically u
1,2,8,40,1,11,0,48,0,conglomerate feel heat china anger south korea
1,2,7,47,0,8,0,54,0,instagram launching redesigned website bigger photo
1,1,11,52,2,10,0,63,0,"kanye west finally tweeted something lovely north, obviously"
1,1,13,37,0,12,0,50,0,know love life like based single question
1,3,1,58,2,12,0,59,0,olympic gold medal-winning rower can't get mortgage buy home
1,2,15,53,3,13,1,68,0,u plan futuristic #makeinindia combat chopper 5 news story new year's eve
1,3,10,48,1,12,0,58,0,delingpole: trump use art deal kill paris climate treaty
1,1,10,32,0,10,1,42,0,9 hottest guy earth ruined soul patch
1,2,6,64,3,11,0,70,0,here metro inauguration day womens march ridership number really mean
1,1,10,24,1,9,0,34,0,what's love life right
1,1,9,33,1,8,2,42,0,24 clever way decorate store-bought pumpkin pie
1,3,4,59,2,11,2,63,0,sean spicer's 11 worst moment since becoming trump's press secretary list
1,2,8,30,0,7,0,38,0,free iphone space hidden trick
1,1,13,42,0,12,0,55,0,pocket kitten real know
1,1,12,34,0,11,0,46,0,lana del rey song based zodiac sign
1,1,10,29,1,7,2,39,0,17 mind-blowingly delicious noodle try nyc
1,1,9,28,2,9,2,37,0,"16 worst possible response ""i love you"""
1,2,12,41,1,11,0,53,0,pretend buy expensive shit well guess exactage
1,1,13,57,0,12,0,70,0,iphone trick allows access information medical emergency
1,1,6,34,0,6,2,40,0,36 backstage celebrity instagrams emmy
1,1,7,37,0,7,2,44,0,12 bizarre christmas tradition around world
1,3,8,28,1,8,2,36,0,"33 twitter joke very, veryfunny"
1,1,9,31,0,8,0,40,0,much miserable bastard actually
1,1,10,35,0,10,4,45,0,predict winner 2016 golden globe award
1,1,10,32,3,8,0,42,0,u.s. navy vet played battleship pretty
1,2,3,54,1,7,0,57,0,please enjoy russell crowe's perfectly zen smartphone photography
1,3,2,42,0,11,0,44,0,one believe much hair baby list
1,3,6,44,0,8,0,50,0,college midwest highest graduate salary
1,3,8,36,0,8,0,44,0,school get child eat vegetable
1,1,6,22,0,5,0,28,0,pas britishness exam
1,1,8,26,0,7,0,34,0,much guy know birth control
1,1,11,29,1,9,0,40,0,know first role a-list actor
1,1,14,40,0,10,0,54,0,identify tv show based imdb description
1,2,8,29,2,8,0,37,0,duck dynasty producer fired sued itv
1,1,12,54,1,11,2,66,0,21 hilarious tweet perfectly sum relationship co-worker
1,1,16,54,1,16,2,70,0,asked 17 travel pro best advice traveling solo here's said
1,1,13,38,1,10,0,51,0,here's rainbow snapchat filter irl halloween
1,1,8,27,0,7,0,35,0,much actually know makeup
1,3,4,59,3,9,0,63,0,palm beach confidential: inside trump's super-rich south florida social set
1,1,12,45,0,11,0,57,0,stranger talked sex would like
1,3,10,39,0,9,0,49,0,industry people stay job longest
1,1,9,42,0,8,0,51,0,turn classic thanksgiving food boozy cocktail
1,1,14,31,0,12,0,45,0,know mac pc based random question
1,1,10,27,2,9,0,37,0,"anyone crush sheik ""zelda"""
1,1,7,22,0,6,0,29,0,full christmas cheer
1,3,13,59,0,13,0,72,0,four staff member quit oklahoma va facility veteran maggot wound dy
1,2,5,36,3,9,6,41,0,business insider 2016 car year: 15 finalist
1,2,8,29,1,4,0,37,0,"milo cameraman assaulted, equipment broken"
1,2,8,31,0,9,6,39,0,top 10 business trend drive success 2017
1,1,11,51,1,10,0,62,0,adele lady gaga's hot bodyguard leave compulsively thrusting
1,2,16,56,3,16,2,72,0,"eight men money 3.7 billion people, that's half world put together"
1,1,17,57,0,16,0,74,0,mom went viral son recorded listening nicki minaj first time
1,1,5,15,0,4,0,20,0,famous car
1,1,8,48,0,8,2,56,0,17 seemingly harmless bathroom habit actually disgusting
1,1,16,63,1,15,0,79,0,zendaya coleman completely changed hair shoot everything need life
1,2,6,26,0,6,1,32,0,8 food warning label
1,2,1,48,0,7,0,49,0,heartbreaking image reveal dream refugee
1,2,6,23,0,5,0,29,0,top myth sun protection
1,3,17,55,2,15,1,72,0,govt ban bbc 5 year national park making 'malicious' film kaziranga
1,1,6,33,1,6,2,39,0,adorable animal advent calendar: december 19
1,1,4,10,0,3,0,14,0,guy
1,2,15,76,4,15,0,91,0,jesse watters: armour rip steph curry contract criticizing company trump support
1,3,3,57,4,11,2,60,0,"saint 'hype man' jarrius robertson, 15, miss draft get liver transplant"
1,2,14,59,4,14,0,73,0,kristen bell defends celebrity activism: im less allowed share believe
1,3,7,45,1,9,0,52,0,protecting president: secret weapon hefty price tag
1,1,12,39,1,10,0,51,0,meet woman run raddest non-girl scout troop around
1,1,12,39,0,11,0,51,0,guess zodiac sign based nail polish choice
1,1,12,42,1,11,0,54,0,here's actually reuse wedding dress beautiful way
1,1,16,39,0,15,0,55,0,bei bei baby panda waved camera make happy
1,2,5,75,0,17,2,80,0,quarterback prospect started 13 game college suddenly become key nfl draft
1,1,10,36,0,10,2,46,0,28 tweet wedding make laugh loud
1,1,9,44,0,9,2,53,0,15 powerful cocktail guaranteed get holiday
1,1,8,24,0,7,0,32,0,freshman senior year
1,3,3,76,2,18,0,79,0,fabric reopens: spent five hour nightclub amazed harassed
1,1,9,35,0,8,0,44,0,music video starring dog fucking insane
1,2,11,42,2,11,0,53,0,odd lots: old-school chess shop survives modern new york
1,2,2,64,0,9,0,66,0,agatha christie festival host cookery demonstration poisonous twist
1,1,8,32,1,7,0,40,0,what's funniest infomercial fail time
1,1,7,24,0,7,2,31,0,18 cat proving liquid
1,1,14,36,2,11,0,50,0,mom took laugh-out-loud photo baby magazine
1,1,7,35,0,7,2,42,0,21 barbie computer game totally forgot existed
1,3,9,43,0,9,2,52,0,16 thing everyone know buying engagementring
1,1,11,32,0,11,2,43,0,21 awesome thing ever happen target
1,1,13,38,3,12,0,51,0,"nathan sykes play game ""never ever"" adorable"
1,1,10,34,0,9,0,44,0,much halloween changed year
1,3,1,37,0,7,0,38,0,way technology already spying
1,1,9,34,0,8,0,43,0,got drunk made super bowl trophy
1,3,13,38,3,9,0,51,0,"rezekne, latvia, fret trump nato stance, war russia"
1,3,13,51,2,11,0,64,0,milo bill maher: breitbart publishing exciting gay editorial
1,3,8,36,0,9,2,44,0,10 geographically remote place get away
1,1,8,28,0,8,2,36,0,21 reason soup best food ever invented
1,1,14,53,6,13,0,67,0,"love drake's ""hotline bling"" video, probably gonna love guy's stuff"
1,3,6,29,3,5,0,35,0,what's favorite christmas album? vote!
1,1,8,30,3,7,0,38,0,"katy perry allowed read ""harry potter"""
1,3,13,68,3,13,0,81,0,"senator schumer, gillibrand helped indian athlete currently charged sex abuse enter u.s."
1,2,11,26,1,10,0,37,0,type drunk new yearseve?
1,1,6,28,0,7,3,34,0,10 gin cocktail 4 ingredient fewer
1,3,10,40,1,8,1,50,0,h-1b visa overhaul could actually benefit big tech company
1,1,7,27,1,6,2,34,0,14 life-changing way bake avocado
1,3,14,56,1,13,0,70,0,fifty shade green: fanfiction went dirty little secret money machine
1,1,8,43,0,8,2,51,0,34 insanely delicious way cook potato thanksgiving
1,2,6,30,0,6,0,36,0,chinese actress sued intense stare
1,1,6,24,2,5,0,30,0,"zodiac sign ""favorite things"""
1,2,12,55,3,12,0,67,0,watch: adam pacman jones kick reporter asking arrest interview
1,2,9,45,0,9,0,54,0,kentucky teacher get prison time sex underage student
1,1,8,24,0,8,2,32,0,15 body trend next big thing
1,1,14,49,0,13,0,63,0,amy poehler tina fey make epic return hillary clinton sarah palin
1,1,13,43,2,12,0,56,0,"woman trying reclaim saree america, working"
1,1,9,27,0,8,1,36,0,5 ya book reading january
1,1,8,36,1,8,6,44,0,18 eye-popping science instagrams follow 2016
1,3,11,35,1,7,0,46,0,naacp vow oppose trump voter fraud investigation
1,1,7,21,1,7,1,28,0,8 way prove san diego
1,2,1,44,0,9,1,45,0,7 hidden iphone trick power user know
1,3,8,40,1,11,2,48,0,around world 27 burgers: best brooklyn bali
1,2,4,59,3,13,0,63,0,arsene wenger made decision arsenal future: 'you soon know'
1,2,2,29,0,7,2,31,0,17 job amy schumer better
1,1,7,27,0,7,2,34,0,24 thing bisexual people relate
1,2,3,31,2,7,0,34,0,"michel roux jr, here recipe tipping"
1,1,5,25,0,5,2,30,0,18 hilarious tweet going vegan
1,1,11,34,0,10,0,45,0,know feel astrology based sign
1,1,8,25,1,7,0,33,0,love best friend
1,2,8,38,4,9,0,46,0,"police swarm willsboro, n.y., search escaped killer"
1,1,7,31,0,7,2,38,0,16 chocolate chip cooky prove god exists
1,1,9,28,0,9,2,37,0,15 piece sushi sin nature
1,3,3,54,1,11,0,57,0,facebook telling everything know list
1,1,13,33,0,12,0,46,0,penny giant waste money must stopped
1,1,13,49,1,12,0,62,0,rebel wilson want one direction fan know grope harry style
1,1,16,37,3,15,0,53,0,"well know lyric ""i can't feel face"" weeknd"
1,1,11,24,0,9,2,35,0,26 tweet way real indian
1,1,8,28,0,9,6,36,0,19 piece shitty taxidermy sum 2015
1,1,7,22,0,6,0,29,0,team michael team rafael
1,1,11,49,3,10,0,60,0,"martin scorsese's impression robert de niro ""goodfellas"" perfect"
1,1,7,35,1,8,4,42,0,23 unforgettable thing '00s teen every autumn
1,2,13,62,1,12,0,75,0,bride call wedding watching groom's reaction guest leaving without dinner
1,3,5,68,1,15,0,73,0,one thing wall street intern value bank get business insider
1,1,11,43,2,11,2,54,0,"15 stage surviving australian summer told ""the simpsons"""
1,1,12,54,2,10,0,66,0,demi lovato's impression fetty wap christina aguilera mind-blowing
1,1,12,51,1,10,0,63,0,last-minute halloween costume based three question
1,3,8,28,0,7,0,36,0,married couple look alike
1,2,1,48,0,7,0,49,0,diplomatic assassination long tragic history
1,1,12,42,1,11,0,54,0,dude dress beard every holiday glorious
1,2,9,59,5,9,0,68,0,transgender activist: preference kid single-sex shower room prejudiced
1,1,7,31,0,6,0,38,0,please stop recording concert phone
1,1,7,34,0,7,2,41,0,21 thing college kid actually want christmas
1,1,6,33,1,6,2,39,0,23 chilling fact disney's haunted mansion
1,2,1,58,1,13,2,59,0,"11 weirdest food try, according internet list"
1,3,11,31,1,10,0,42,0,predict much time waste yourphone?
1,1,7,41,0,7,2,48,0,17 international starbucks item need immediately
1,1,4,19,0,3,0,23,0,chrissy teigen pregnant
1,3,1,22,1,3,0,23,0,uganda's child stunt actor
1,1,11,44,0,11,2,55,0,15 important reminder anyone want lose weight year
1,1,8,43,0,8,2,51,0,14 struggle everyone hate touched understand
1,3,3,38,1,7,0,41,0,john travolta can't read teleprompter grammys
1,2,13,70,2,15,0,83,0,"sander trump: promise american people cut social security, medicare medicaid"
1,1,11,58,1,10,0,69,0,here's glorious photo voldemort dancing enthusiastically photocall
1,1,10,46,1,9,0,56,0,"soulmate tom hiddleston really, really good impression"
1,3,4,50,1,12,0,54,0,looked hundred millennials' cv learned
1,3,11,48,1,11,1,59,0,startup secure? 3 basic cybersecurity tip startup
1,1,11,43,0,11,2,54,0,17 offensive thing people say someone small boob
1,1,9,18,1,7,0,27,0,know gf's face touch
1,1,5,21,1,4,0,26,0,what's genius camping hack
1,1,5,20,0,5,2,25,0,11 deeply confused cat sock
1,1,9,34,0,8,0,43,0,guess winchester brother cry
1,1,11,28,0,10,0,39,0,would end wes anderson movie
1,1,10,44,0,9,0,54,0,upon time made two extremely exciting announcement
1,1,11,36,0,10,0,47,0,color test determine like sex
1,1,13,38,1,12,0,51,0,wish could take dog home see dance
1,3,10,35,0,10,2,45,0,16 gift people always need charge theirphone
1,1,6,28,0,6,2,34,0,23 magical gift every black girl deserves
1,3,9,54,2,11,2,63,0,report: twitter overbills advertiser video bug increase ad metric 35%
1,1,12,40,3,11,0,52,0,"couple's ""drunk history"" version met pure gold"
1,1,10,39,0,10,2,49,0,laser razor want bring shaving 21st century
1,2,7,33,0,9,4,40,0,unique look 2017 golden globe award
1,3,1,58,0,10,0,59,0,harrowing video warns teen danger speaking stranger online
1,3,6,20,1,7,0,26,0,ready math whiz camp?
1,1,9,26,0,9,2,35,0,19 dad thing dad christmas
1,1,13,39,0,12,0,52,0,rihanna drake shoot music video new album
1,1,7,25,1,9,8,32,0,28 thing believe turning 20 2016
1,1,12,45,0,11,0,57,0,know favorite female celeb based favorite male celeb
1,2,3,75,3,16,0,78,0,prince harry try old 'shoulder tap' prank schoolboy fails spectacularly list
1,1,3,10,0,4,6,13,0,17 best moment 2015
1,3,10,74,1,12,0,84,0,read heartbreaking story people affected trump's unconstitutional immigration ban
1,3,5,67,3,12,0,72,0,white house defends president trump golf habit argues different obamas
1,2,5,35,1,6,4,40,0,celebrity christmas trees: 2016 edition
1,3,13,48,1,10,0,61,0,chicago review book editor say milo word could inspire terrorism
1,2,3,13,1,4,0,16,0,tv mum you?
1,3,3,42,2,9,0,45,0,geekiest sign 'stand science' rally
1,1,11,55,1,10,0,66,0,thierry henry's reaction brendan rodgers sacked utterly brilliant
1,1,14,54,3,13,0,68,0,"miley cyrus planning nude concert everyone's naked spewed ""milk"""
1,1,6,36,0,5,0,42,0,christmas cookie match personality
1,3,11,41,1,10,0,52,0,"new graphic novel stunning, honest meditation loss"
1,2,5,73,4,15,0,78,0,google uber alum created doctor's office that's like apple store meet 'westworld'
1,3,14,41,3,13,0,55,0,"one like saggy batwings, toned arm"
1,1,5,20,0,4,0,25,0,guy try pinterest leaf hack
1,2,10,28,0,10,2,38,0,10 subtle detail woman turn man
1,1,11,32,3,10,0,43,0,"well know lyric ""the christmas song?"""
1,1,9,31,0,9,2,40,0,17 time rihanna taught talk fuckboys
1,1,10,38,2,10,2,48,0,"27 reason paris geller true heroine ""gilmore girls"""
1,1,7,25,0,7,2,32,0,24 time twitter went way fucking far
1,3,6,80,3,17,0,86,0,jealous wife chop husband's penis pair scissors growing 'tired womanising'
1,1,9,47,0,8,0,56,0,identify famously awful premier league footballer
1,1,8,39,1,7,0,47,0,definitive ranking ellie goulding's music video
1,2,11,47,1,10,0,58,0,bedtime world successful people might surprise
1,3,8,31,0,8,1,39,0,2 chart debunk bullish case stock
1,1,6,33,0,5,0,39,0,tampon instruction actually helpful
1,1,12,29,1,12,3,41,0,get 100 quiz fucking moron
1,3,6,34,4,5,0,40,0,sanders: obamas wall street speech unfortunate
1,2,9,49,2,8,0,58,0,mexican national arrested sex-for-money underage girl bust
1,3,1,50,0,9,0,51,0,robot might saving world demographic disaster
1,1,7,33,0,7,2,40,0,50 powerful picture american history
1,1,10,34,1,9,0,44,0,shade room coming gossip industry's wig
1,2,6,25,1,6,0,31,0,topshops graphic tee major typo
1,1,6,22,0,5,0,28,0,addicted wikipedia
1,1,8,29,2,7,2,37,0,day 5 buzzfeed's 7-day clean eating challenge
1,2,1,49,0,10,0,50,0,birth month may predict risk certain disease
1,1,12,50,0,11,0,62,0,disney villain based question disney movie
1,2,4,60,4,12,3,64,0,'outlander' season 3: 10 burning question claire jamie's reunion
1,1,9,38,0,8,0,47,0,extremely chill video game succulent
1,3,7,29,1,7,1,36,0,7 expert shopping tip thatll save youmoney
1,1,10,35,1,9,2,45,0,23 t-shirt guaranteed impress cat person
1,1,10,33,3,9,0,43,0,"let's take moment appreciate ""save last dance"""
1,1,12,51,1,11,2,63,0,15-second video mumbai marathon leave totally mesmerised
1,1,19,54,4,17,0,73,0,people v. o.j. simpson reminds u time know kardashians
1,3,2,54,1,10,1,56,0,iphone 8 important new feature finally confirmed
1,3,8,63,3,16,0,71,0,"watch saturday ncaa tournament game tv, online even youve cut cord"
1,1,30,19,3,12,2,49,0,"10 excuse use play hooky ""star wars: force awakens"""
1,1,9,30,2,8,0,39,0,"well actually know ""the addams family"""
1,1,9,36,2,8,0,45,0,"""queen sappy love songs"" delilah conquered radio"
1,1,10,30,0,9,2,40,0,16 reality growing explained tv show
1,1,11,39,0,11,2,50,0,14 graph real student social anxiety
1,2,12,32,1,8,2,44,0,17 limited-edition beauty product need buyasap
1,1,12,43,2,12,2,55,0,"21 picture prove ""star wars"" stuff getting control"
1,1,8,36,0,6,0,44,0,leonardo dicaprio character soulmate
1,2,4,47,4,10,0,51,0,'the powerpuff girls': see first image series' return
1,1,9,24,0,8,0,33,0,going third wheel forever
1,1,10,41,1,9,0,51,0,two huge broadway star covered selena gomez amazing
1,3,11,36,1,10,0,47,0,five thing know gop health care plan score
1,1,10,32,0,9,0,42,0,color test determine old soul
1,1,12,38,0,11,0,50,0,guess sensitive based one question
1,3,1,54,0,11,0,55,0,beauty guru got follower troll guy using makeup tool
1,1,8,28,0,8,2,36,0,14 small lie best friend tell
1,3,3,58,6,8,0,61,0,"'inspiring, determined, kind': london schoolgirl describing?"
1,1,8,33,0,8,2,41,0,17 meme way real thirtysomethings
1,3,2,34,3,7,0,36,0,'jeopardy!' writer come clue
1,3,9,39,2,13,0,48,0,voice rural america (or not) go college
1,2,16,45,4,13,0,61,0,"kerry ingram, aka shireen 'game thrones,' alive well twitter"
1,1,9,25,0,9,2,34,0,15 way brain fool daily basis
1,3,5,83,1,17,0,88,0,"steve kerr gave kevin durant ruthless assignment thunder, worked way planned"
1,3,3,44,0,9,0,47,0,little boy adorably sweary reaction trying vr
1,1,9,41,2,10,6,50,0,"21 time ""the tonight show starring jimmy fallon"" totally owned 2015"
1,1,14,42,1,13,0,56,0,girl used makeup turn gigi hadid good
1,1,11,41,1,9,0,52,0,kerry washington said important address abortion tv
1,2,5,35,2,8,0,40,0,genuinely believable cgi actor? wont belong
1,3,8,74,3,16,0,82,0,exclusive: powerful briton america really like donald trump's white house
1,1,7,33,2,7,2,40,0,"26 important dating takeaway ""master none"""
1,1,8,35,0,8,2,43,0,15 honest confession female star war fan
1,1,8,34,0,8,2,42,0,23 reason christmas florida actually best
1,1,15,47,0,14,0,62,0,new video dwarf planet make feel like fucking astronaut
1,1,8,29,0,8,2,37,0,21 worst thing people ever smelled
1,1,12,40,1,11,1,52,0,8 best thing saw first-ever broadway fan convention
1,3,3,66,0,11,0,69,0,kim kardashian surround northern light triumphant return
1,1,10,36,0,10,2,46,0,15 image prove britney spear queen target
1,1,12,42,0,12,1,54,0,8 thing help talk family eating disorder
1,3,7,42,2,9,3,49,0,report: 2.65 percent immigrant italy refugee
1,3,15,34,1,11,0,49,0,sapvoice: bot help find right gift year
1,1,8,33,1,8,4,41,0,21 thing every self-respecting guy 30
1,1,10,42,1,10,2,52,0,24 tweet introverted make laugh loud
1,3,17,49,4,13,2,66,0,"teen rob 16-year-old girl, push nyc subway tracksgood samaritan help"
1,3,7,36,0,8,0,43,0,injury put teen athlete path addiction
1,1,12,39,1,11,0,51,0,here's makeup look incredible picture
1,2,15,56,1,13,0,71,0,rachel maddow cable news host list most-streamed primetime program
1,1,10,42,0,10,2,52,0,19 insanely cute tray help keep thing organized
1,1,5,18,0,6,6,23,0,22 deep question ponder 2016
1,1,8,25,1,8,2,33,0,19 thing find college dorm
1,2,3,44,2,11,4,47,0,what's store europe 2017? look possible scenario
1,1,10,32,0,9,0,42,0,like ina garten giada de laurentiis
1,3,7,41,3,6,0,48,0,"sander admits obamacare deductibles, premium high"
1,2,8,33,1,8,2,41,0,13 secret muppets probably dontknow
1,3,11,31,1,11,4,42,0,2000s disney star make say holy shit i'm old
1,1,9,30,0,9,2,39,0,18 photo way real makeup artist
1,3,7,39,3,8,0,46,0,"trump, free-form leader, experiment invite drama"
1,1,6,17,0,5,0,23,0,artist grammy
1,1,12,27,1,11,2,39,0,17 thing might get poc fan marvel
1,3,12,49,0,12,2,61,0,24 underrated tourist attraction need see instead usualones
1,1,9,22,2,8,0,31,0,"well know intro ""daria"""
1,1,4,19,0,3,0,23,0,horoscope october
1,2,1,56,0,11,0,57,0,graphic show vulnerable every type job automation
1,2,6,23,0,7,2,29,0,14 easy way save money spring
1,1,8,32,0,8,2,40,0,23 time eating eggnog better drinking
1,1,7,34,1,6,2,41,0,22 hilarious closed-captioning moment
1,1,8,30,2,8,4,38,0,"taylor swift ""1989"" tour outfit would rock"
1,1,8,28,1,7,0,36,0,hook habit like everyone else's
1,1,7,38,0,6,0,45,0,carolina panther mascot absolutely purrfect
1,1,11,40,0,11,2,51,0,21 experience better sex people love food
1,1,7,27,0,7,2,34,0,19 thing fall boy fan understand
1,2,14,48,1,13,0,62,0,"tried backless, strapless bra see actually worth"
1,1,13,47,0,12,0,60,0,chrissy teigen announced sex baby people flipping
1,1,11,30,3,10,0,41,0,"""star wars"" fan art know needed"
1,1,6,25,0,6,2,31,0,19 people look like macklemore
1,2,1,52,0,8,0,53,0,high street shop secretly track customer using smartphones
1,1,12,41,0,12,2,53,0,one direction cancelled gig 30 minute due start
1,1,10,34,0,10,2,44,0,guess age gender 10 question
1,1,9,39,1,8,0,48,0,hardest european capital city test ever take
1,1,8,36,0,8,2,44,0,22 fantastic podcasts make commute less shitty
1,1,5,21,0,5,2,26,0,19 boyfriend must stopped
1,2,10,38,0,11,7,48,0,100 hilarious tweet prove 2016 year teenager
1,3,13,52,2,13,2,65,0,"20 pup celebrating ""national puppy day"" know need right"
1,3,5,56,2,13,0,61,0,"amid uproar nate parker, one talking casey affleck?"
1,1,9,26,0,8,0,35,0,guess first cell phone
1,1,14,44,0,13,0,58,0,emma bunton taking selfie baby spice thing ever happen
1,3,0,29,0,7,2,29,0,15 great excuse go tonight
1,1,9,36,0,9,2,45,0,simple leopard halloween makeup 10 minute
1,1,6,21,0,5,0,27,0,stay home school
1,1,8,27,0,8,2,35,0,23 thing never say short woman
1,1,11,37,0,11,2,48,0,23 annoying thing happen rest life
1,1,9,39,3,9,4,48,0,"2016 critics' choice ""best picture"" nominee see"
1,3,14,65,1,13,0,79,0,"soldier suicide probe, shashi tharoor british colonial history must read story"
1,3,18,65,0,17,0,83,0,sachin tendulkar may test hundred also joint record holder missing
1,3,15,49,2,13,0,64,0,'pokmon go' probably get back lost feature snapchat lawsuit
1,1,10,35,0,10,2,45,0,16 photo desis give intense squad goal
1,3,20,49,3,16,2,69,0,18 yo chennai boy bag nasa 'moon' prize proposing elevator earth moon!
1,2,1,42,1,9,0,43,0,held ransom engagement ring?
1,1,6,20,0,5,0,26,0,katniss furiosa
1,1,6,28,0,6,2,34,0,17 truth book lover understand
1,2,11,45,2,10,0,56,0,former 'brady bunch' star fire report homophobic rant
1,3,6,22,2,6,0,28,0,bad job interview? ask do-over
1,1,12,51,4,11,0,63,0,"here's ""harry potter"" characters' eye actually supposed look like"
1,2,9,42,3,9,0,51,0,trump to-do list: expect unexpected president
1,1,5,18,0,4,0,23,0,eyesight score
1,1,11,32,1,11,2,43,0,10 book get mood valentine's day
1,1,11,30,0,8,0,41,0,matching tattoo get bff
1,1,13,58,2,12,0,71,0,"know favorite ""inside out"" character based favorite disney character"
1,1,12,46,5,9,0,58,0,"artist painted lin-manuel miranda's ""hamilton"" ten-dollar bill"
1,1,10,35,0,9,0,45,0,jake gyllenhaal break heart new movie
1,1,11,33,0,11,2,44,0,12 emojis mom wish could send right
1,1,9,34,2,8,0,43,0,"""harry potter"" wizarding school would go"
1,3,8,38,1,8,1,46,0,2pac's former bodyguard claim know killed rapper
1,1,11,44,0,11,2,55,0,26 hilarious tweet birth control get every time
1,2,1,30,2,8,4,31,0,whats whats retiree 2017
1,1,9,38,0,9,2,47,0,21 dating struggle told weird clothing label
1,1,12,45,1,11,0,57,0,know approximate age based popular movie seen
1,1,8,19,1,6,2,27,0,pigskin blanket: nfl week 14 pick
1,1,11,35,0,11,3,46,0,250 nun cycled way kathmandu new delhi
1,2,7,56,1,9,0,63,0,hundred thousand demonstrator attend womens march washington
1,2,12,47,3,12,0,59,0,katy perry: kiss girl christian upbringing
1,1,10,35,2,10,2,45,0,"28 best ""saturday night live"" character time"
1,2,0,33,0,7,2,33,0,10 thing watch national signing day
1,1,9,28,2,8,0,37,0,"lyon brother ""empire"" fine"
1,2,12,65,1,13,0,77,0,"tebow launch several homer batting practice, first day mets spring training"
1,2,1,61,0,10,0,62,0,monster machine split tree incredibly satisfying watch
1,3,12,44,1,9,0,56,0,tony robbins: happiness depends mastering two skill
1,1,9,28,0,9,2,37,0,37 hilarious shaq tweet time
1,1,11,34,0,11,2,45,0,21 best thing ever happened apple store
1,1,10,52,1,9,0,62,0,designer reinvented disney princesses' shoe amazing
1,1,15,34,2,11,2,49,0,"25 time ""oitnb"" cast ultimate squad goal emmy"
1,1,2,17,0,1,0,19,0,germophobe struggle
1,1,10,26,1,10,4,36,0,17 music fact make '00s kid feel old af
1,3,2,39,0,8,0,41,0,least free country mapped list
1,3,6,28,0,6,0,34,0,pillow contain dead bug poop
1,1,7,35,1,8,5,42,0,paris hilton's 8 hottest halloween costume 2000s
1,1,9,44,0,9,2,53,0,21 insanely creative halloween costume friend
1,1,8,30,0,8,2,38,0,23 time tumblr kept real mental health
1,3,17,59,0,16,0,76,0,guy winning heart stopped pizza delivery midway rescue lost dog
1,1,7,21,1,6,2,28,0,19 last-minute elf shelf idea
1,3,5,58,4,15,0,63,0,tyronn lue uneven cavs' loss hawks: 'games like come back bite you'
1,2,12,64,1,13,3,76,0,6 reason old-school idealism constantly challenged 21st century material world
1,1,11,22,1,7,0,33,0,"fyi, tom myspace living dream"
1,3,9,49,0,9,1,58,0,9 important difference busy productive
1,1,6,20,0,5,0,26,0,well know sandwich
1,1,14,59,0,13,0,73,0,instagram account satirizing fancy dining actually work canadian chef
1,3,10,42,1,11,0,52,0,"donald trump love tweet, economist flock"
1,1,15,40,3,14,0,55,0,"excited new ""star wars"" movie see art"
1,2,11,54,2,10,0,65,0,donald trump cabinet pick disagree president-elect key issue
1,1,13,38,0,12,0,51,0,canadian dad insane elf shelf photo shoot
1,1,12,37,0,11,0,49,0,cosmo wrote men way write woman
1,1,10,43,0,9,0,53,0,ultimate guide getting published literary magazine
1,2,4,58,3,10,0,62,0,"three-day wedding celebration? learn restraint, say country life"
1,1,9,29,0,8,0,38,0,favorite science fact time
1,1,11,45,1,10,0,56,0,here's proof beauty brand model actually look exactly
1,2,9,60,1,11,0,69,0,watch live: briefing attorney united airline passenger forced plane
1,1,9,36,0,9,2,45,0,17 thing everyone strong eyebrow know true
1,1,7,41,0,7,2,48,0,21 pressing concern australian american food
1,1,17,53,0,16,0,70,0,john lewis christmas ad resulted lot people sobbing mess
1,1,7,22,1,6,0,29,0,here's make bracelet
1,1,11,35,0,11,2,46,0,27 art history photo funny good
1,1,8,30,2,7,0,38,0,"long would survive ""runway"" magazine"
1,1,8,41,1,8,2,49,0,23 historic picture macy's thanksgiving day parade
1,1,8,28,0,8,2,36,0,10 italian dish nonna would proud
1,1,9,48,4,8,0,57,0,boyfriend shaved girlfriends' legs... anyone survive
1,1,7,31,1,7,2,38,0,17 word pronouncing wrong year
1,1,4,19,0,5,6,23,0,25 time drake completely 2015
1,3,8,37,1,9,2,45,0,14 recipe weve actually tried loved thismonth
1,1,18,54,1,17,0,72,0,"sikh guy became part racist meme, internet helped turn hero"
1,2,9,43,2,9,0,52,0,syrian airfield strike: tomahawk land attack missile?
1,1,7,19,0,9,8,26,0,31 album 20 year old 2016
1,2,10,37,0,9,0,47,0,drake finally dropped new album people areshook
1,1,8,31,0,8,1,39,0,7 healthy eating trick try week
1,1,5,15,1,4,0,20,0,can't focus
1,3,10,42,0,9,0,52,0,republican seem reject whole concept insurance
1,1,15,41,0,14,0,56,0,wore food face instead makeup see anyone would notice
1,1,10,27,1,10,2,37,0,10 recipe make cry adele's new album
1,1,13,52,1,12,0,65,0,everyone's obsessed completely wild video kid playing kazoo
1,2,2,62,5,15,0,64,0,became mother-in-law's carer handle stress job
1,1,8,15,0,6,4,23,0,omg movie scene 2015
1,1,5,16,2,4,0,21,0,"""white chick"""
1,1,9,41,0,9,2,50,0,26 heavenly pumpkin dessert better pumpkin pie
1,1,6,19,6,7,2,25,0,13 horror comic @#$%&!
1,1,10,42,0,10,2,52,0,27 way transform favorite college snack real food
1,1,11,38,0,11,2,49,0,21 thing everyone worked welsh pub remember
1,1,12,36,0,11,0,48,0,disney gift get disney fan life
1,2,16,57,5,13,0,73,0,"barkley: muslims, immigrants, lgbt people getting feel black people feel like"
1,1,8,31,0,7,0,39,0,crazy bullshit donald trump say next
1,1,16,33,0,14,0,49,0,dj khaled got lost sea jet ski shit got real
1,1,9,35,0,8,0,44,0,nail polish brand actually stay nail
1,1,12,40,0,12,2,52,0,22 picture prove asos conspiring turn u cher
1,1,14,58,1,14,2,72,0,17 face perfectly sum every black girl's transition relaxed natural hair
1,1,15,46,0,14,0,61,0,put song holiday party want everyone murder
1,1,10,32,0,10,4,42,0,grandma hit sickest beer pong shot 2016
1,3,15,47,1,16,6,62,0,"tamil nadu man deposit r 246 crore black money, pay nearly r 110 crore tax"
1,1,9,41,0,9,2,50,0,25 tumblr post make socially awkward people cringe
1,3,9,30,0,9,2,39,0,17 photo taken right moment
1,3,2,52,1,11,0,54,0,here everything right filter twitter abuse
1,2,9,46,3,9,0,55,0,"pakistan: muslim rape woman, torch house grab father property"
1,1,12,58,0,11,0,70,0,photographer took wildly different picture one guy backstory
1,3,2,67,1,16,0,69,0,grim truth behind photo reveals really like mother list
1,3,11,59,3,16,2,70,0,look mind gen. james mattis: 15 quote trump secretary defense pick
1,3,16,68,4,13,0,84,0,common interview serena williams discus legendary career espn's 'the undefeated in-depth'
1,3,9,25,4,6,0,34,0,"hate hoax: man faked kkk crimes, abduction"
1,1,12,39,1,11,0,51,0,soap opera actress tried hate viola davis's emmy speech
1,2,18,57,5,13,0,75,0,"sunny-srk's item song raees, kareena-taimur's morphed photo go viral ent"
1,1,14,38,0,14,4,52,0,caitlyn jenner moment felt proud woman 2015
1,1,8,31,0,8,2,39,0,15 thing dentist actually want know
1,2,12,58,2,12,0,70,0,driver keep commuter jingling way christmas-themed public bus yahoo
1,1,10,42,1,10,2,52,0,17 cheating revenge story make glad single
1,3,3,62,1,15,0,65,0,man quit booze coffee two years. happened next list
1,2,2,59,1,13,0,61,0,report terminally ill boy died santa's arm called question
1,3,5,22,0,5,0,27,0,political risk moving asia
1,1,7,26,0,7,2,33,0,15 reason arjun kapoor perfect man
1,1,10,31,0,9,0,41,0,people buying amazon week
1,3,11,54,3,11,0,65,0,"swedish mail delivery suspended go zone incident, safety concern"
1,1,11,35,0,10,0,46,0,know hogwarts house based thing hate
1,1,8,40,0,8,1,48,0,5 people reveal happens behind perfect instagram
1,1,9,27,0,9,2,36,0,21 picture sum end semester
1,1,13,43,0,12,0,56,0,drowning wombat saved lake fisherman caught net
1,1,9,36,2,8,2,45,0,17 time lin-manuel miranda proved he's complete genius
1,3,1,47,0,10,2,48,0,real parent reveal 16 kid expense worth money
1,1,8,26,2,8,2,34,0,"""big brother 17"" house guest best"
1,1,20,50,2,16,0,70,0,blog full hairy ball landscape make want gouge eye (nsfw)
1,3,13,40,2,11,0,53,0,here's what's actually going missing black girl dc
1,1,8,32,0,8,2,40,0,17 bitchy text contact lens would send
1,3,3,40,1,4,0,43,0,deconstructing president trump's jobless number
1,3,14,52,2,14,0,66,0,course nicki minaj's ex safaree something say remy ma's dis track
1,1,13,53,0,13,2,66,0,trainer intentionally gained 70 pound could help client lose weight
1,1,7,30,0,6,0,37,0,woman hurt vagina biking
1,1,12,57,3,10,0,69,0,"marvel reveals carrie-anne moss playing genderbent character ""jessica jones"""
1,3,11,33,2,11,0,44,0,trump dossier fake -- reason
1,1,8,14,0,5,0,22,0,member bts
1,1,14,49,1,13,0,63,0,live craven universe scott disick wikipedia page
1,1,7,32,0,6,0,39,0,disney voice looked like character
1,1,8,30,0,8,2,38,0,18 thing need know drinking coffee
1,1,12,48,2,11,0,60,0,stop listen michelle obama's girl power playlist
1,1,14,50,0,13,0,64,0,lingerie model born without leg us skateboard get around
1,1,8,38,0,7,0,46,0,pattern quiz determine social behavior
1,2,1,45,1,8,0,46,0,"child play, even harshest environment"
1,1,10,32,0,10,2,42,0,25 halloween cake scare shit
1,3,8,42,3,12,3,50,0,"michael porter jr. score, mom averaged 58.7 ppg h senior"
1,1,13,48,1,11,0,61,0,oscar-nominated actor hook based one question
1,3,2,47,1,8,0,49,0,big mistake anti-trump protester could making
1,1,8,36,0,9,6,44,0,11 insane thing happened pennsylvania 2015
1,1,12,49,0,11,0,61,0,halloween movie watch right based three question
1,2,5,32,0,7,0,37,0,build instant rapport interview
1,3,7,26,0,8,6,33,0,57 product amazon reader loved in2016
1,1,8,21,1,7,0,29,0,new year's eve like
1,1,8,24,0,6,0,32,0,american pas uk driving test
1,1,8,29,0,8,2,37,0,35 food pretty much sum childhood
1,1,8,44,0,8,2,52,0,33 healthy eating habit lazy college student appreciate
1,2,3,46,1,8,0,49,0,"economy healed obama, unhappy voter chose trump"
1,1,9,28,0,9,2,37,0,21 nerdy thing need home right
1,1,9,34,1,9,2,43,0,airplane food economy vs. first class 20 airline
1,1,9,27,0,9,2,36,0,24 photo way real book lover
1,1,9,34,0,10,2,43,0,19 reason dog actually best part party
1,1,8,19,0,7,0,27,0,type guy ideal man
1,2,2,48,0,8,0,50,0,new course getting woman australian politics
1,2,16,41,4,15,0,57,0,"build ideal breakfast we'll tell type a, b, c"
1,1,13,42,0,12,0,55,0,know celeb boyfriend based first letter name
1,1,15,59,0,14,0,74,0,comedy duo surprisingly helpful office hack make work life better
1,2,6,48,4,10,0,54,0,seahawks gm richard sherman trade talks: 'we've opened door'
1,1,10,33,2,8,0,43,0,woman tie-dyeing hair pretty crazy
1,3,13,54,2,12,2,67,0,future learning: skateboarder suddenly became crazy good mid-80s
1,1,10,35,0,9,0,45,0,seth rogen say perfect thing dick pic
1,1,13,36,0,11,0,49,0,book everyone love tv much literature
1,2,10,47,2,7,0,57,0,#cyborgtrumpproblems aim find donald trump's major malfunction
1,1,8,29,1,8,2,37,0,well identify '00s teen movie
1,1,10,48,0,10,2,58,0,23 thing people borderline personality disorder want know
1,1,5,27,1,5,2,32,0,here's 12 awkward christmas gift story
1,3,2,39,3,8,0,41,0,trump's order abortion policy: mean?
1,2,5,46,0,9,0,51,0,many syrian welcomed u strike assad regime target
1,1,8,29,0,6,0,37,0,easy pizza pinwheel delicious af
1,2,8,30,1,8,2,38,0,31 photo thatll make every nurse laugh outloud
1,1,7,29,0,7,2,36,0,16 lesson learned south indian movie
1,1,12,51,0,11,0,63,0,rob kardashian gave u look inside kitchen cabinet refrigerator
1,1,9,36,7,9,0,45,0,"erykah badu's ""phone $$$$"" everything ever needed"
1,3,16,64,1,15,0,80,0,"one killed, many injured stone pelter clash army demand body kupwara attacker"
1,1,7,23,3,6,0,30,0,completely f@#% makeup
1,1,6,31,0,6,2,37,0,27 wedding idea mermaid getting married
1,1,13,46,1,12,0,59,0,need talk selena gomez victoria's secret fashion show
1,1,12,45,0,11,0,57,0,movie shot vancouver actually set vancouver
1,1,11,35,0,11,2,46,0,38 time tom hardy melted heart love dog
1,1,12,51,0,11,0,63,0,adoption agency need volunteer snuggle take care baby
1,3,10,38,2,6,1,48,0,paycomvoice: 3 finance-technology skill cfo seek
1,1,8,32,0,8,2,40,0,18 thing never applying makeup
1,1,10,32,0,9,0,42,0,crush think based one question
1,2,8,76,2,20,6,84,0,"super bowl 2017 movie trailers: expect, ghost shell fast furious 8 transformer 5"
1,3,8,50,4,10,2,58,0,poll: 60 percent adult hopeful optimistic america future
1,1,7,31,0,7,2,38,0,23 tweet every single person identify
1,1,16,57,1,15,0,73,0,woman refused change facebook picture french flag going viral
1,1,12,57,0,11,0,69,0,tracy morgan receives standing ovation emmy traumatic brain injury
1,1,13,45,2,11,2,58,0,23-year-old went blind one eye wearing cheap color contact
1,1,8,30,0,8,2,38,0,21 blender failed hard failed
1,1,12,32,3,11,0,44,0,"people can't get hot new ""daily show"" host"
1,1,7,27,0,7,2,34,0,13 cuties ready sweater weather
1,3,6,79,5,15,0,85,0,"adam saleh: youtube star 'wasn't speaking arabic phone kicked delta flight', passenger claim"
1,3,3,35,0,9,4,38,0,complained uk ad 2016
1,3,7,40,1,7,0,47,0,debating befriending tomi lahren isnt progress
1,1,7,38,0,7,2,45,0,28 unexpected halloween costume make
1,1,17,56,0,16,0,73,0,tiny hamster enjoying tiny doughnut make enjoy day tiny bit
1,1,12,37,0,11,0,49,0,two footballer set make history coming gay
1,1,21,0,0,2,0,21,0,please stop subtweeting
1,1,10,40,0,10,2,50,0,17 incredible yurt getaway need chill vibe
1,1,9,34,0,8,0,43,0,people turning peanut butter kid meme
1,1,8,25,2,8,2,33,0,what's horoscope week oct. 19
1,1,8,43,0,8,2,51,0,19 confession people feel guilty masturbating
1,1,9,26,1,8,2,35,0,guess kind 20-something
1,2,5,76,0,14,0,81,0,former jump contestant louise hazel tell athlete quit competition get hurt
1,1,13,47,0,12,0,60,0,america ferrera thrilled longer latina primetime
1,1,7,27,0,6,0,34,0,kanye west throwdown tweet
1,2,2,46,1,12,4,48,0,must-see movie going win oscar 2017
1,1,7,34,0,7,2,41,0,17 perfect product embracing inner kanye
1,1,6,33,0,5,0,39,0,ultimate character v character showdown
1,1,11,37,0,10,0,48,0,try guess chip smashed
1,2,13,51,0,12,0,64,0,meet chinese company want intel personalized medicine
1,3,6,34,0,8,0,40,0,found best chocolate truffle world
1,2,12,55,1,10,0,67,0,"nba prospect emmanuel mudiay show athleticism, skill predraft workout"
1,2,10,46,2,8,0,56,0,cheated. ex-girlfriend heartbreaking question
1,1,15,50,0,15,2,65,0,18 tweet health insurance make laugh cry time
1,3,9,34,1,8,0,43,0,pas basic american sign languagetest?
1,1,8,25,0,7,0,33,0,james bond austin power
1,2,2,66,3,16,0,68,0,trump promised biggest tax cut history. here big would be.
1,1,11,47,0,10,0,58,0,england want football fan sing french national anthem week
1,2,9,33,1,8,0,42,0,company quietly raise prices?
1,3,1,78,0,16,0,79,0,school ban pupil spending much time toilet police called rowdy protest
1,2,4,21,0,5,4,25,0,star spent christmas 2016
1,1,13,44,2,12,0,57,0,"character ""jessica jones"" looked like comic"
1,1,8,43,0,8,2,51,0,17 insanely delicious dessert anyone obsessed maple
1,3,3,46,1,7,0,49,0,meet cannabrand: first ever marijuana marketing brand
1,3,5,25,0,5,0,30,0,surgeon stay focused hour
1,3,4,34,1,6,0,38,0,russia clamping jehovah witnesses?
1,1,12,48,2,11,2,60,0,favorite '90s pop-punk anthem recreated amazing video
1,1,10,45,0,10,2,55,0,17 incredibly important life lesson learn winona ryder
1,1,9,36,2,9,2,45,0,"35 question want ""gilmore girls"" revival answer"
1,2,9,23,3,5,0,32,0,star wars: episode viii title revealed
1,2,2,74,2,17,0,76,0,"jeremy corbyn suddenly fastest gun west, he's firing wrong target"
1,2,4,22,1,6,0,26,0,red vs. blue america marriage
1,1,11,36,0,10,0,47,0,mona lisa turned cara delevingne date
1,3,9,31,1,9,0,40,0,college football ref team?
1,3,7,63,1,11,0,70,0,"lebron james get heated tristan thompson ot timeout, later apologizes"
1,1,12,41,0,11,0,53,0,know marvel superhero based zodiac sign
1,2,1,42,0,6,0,43,0,robot could revolutionize grocery store
1,1,10,21,0,8,3,31,0,nyc looked like 100 year ago
1,3,6,27,1,7,0,33,0,new dinner tab: labor surcharge
1,1,14,44,2,13,0,58,0,"emma watson badass mission rescue boyfriend ""colonia"""
1,3,7,33,0,7,0,40,0,oscar mistake cast unwanted spotlight pwc
1,1,12,41,0,12,2,53,0,22 tweet way funny anyone hate wearing jean
1,1,10,46,0,9,0,56,0,justin bieber walked painfully awkward spanish interview
1,2,13,33,1,12,0,46,0,best way explain job family get
1,3,3,41,2,7,0,44,0,cyclone debbie: expect evacuating
1,1,12,37,2,11,0,49,0,"egg, bean, cheese pita pizza better burrito"
1,1,9,31,2,8,0,40,0,"cast ""the office"" disney character"
1,1,17,51,1,16,0,68,0,hair makeup done like kim kardashian week here's happened
1,1,11,47,4,10,0,58,0,"first ""grease: live"" teaser absolutely electrifying"
1,1,5,22,0,5,1,27,0,3 homemade nut butter cup recipe
1,1,8,32,0,7,0,40,0,woman wearing plastic bag onesies taiwan
1,1,12,39,1,10,0,51,0,kendall jenner super excited dj khaled's snapchat
1,1,10,36,0,10,2,46,0,17 confession people dumped worst way
1,1,15,51,0,14,0,66,0,tried makeup eraser claim remove makeup water
1,1,12,43,0,12,2,55,0,65 brutally honest question secretly want ask first date
1,1,7,32,0,7,2,39,0,19 hilarious disney post totally nailed
1,1,4,12,0,2,0,16,0,buzzfeed edit news
1,3,2,20,0,4,0,22,0,marie kondo cleaning
1,3,4,43,0,9,0,47,0,rose new favorite star war character
1,1,13,61,0,12,0,74,0,transgender teen get emotional speaking future self powerful video
1,3,4,48,1,10,0,52,0,france's liberal macron court expat uk battle vote
1,1,8,29,0,8,1,37,0,7 fact history blow mind
1,1,10,37,0,8,2,47,0,24 perfect gordon ramsay gifs perfect every situation
1,3,1,31,1,8,0,32,0,"oh hell yeah, look big turtle"
1,1,11,32,0,10,0,43,0,pro con student thirty
1,1,9,34,1,8,0,43,0,thing absolutely sure kid
1,3,8,45,1,8,0,53,0,greatest grilled cheese sandwichand history behind
1,1,10,30,0,9,0,40,0,read got iphone christmas
1,1,10,42,0,9,0,52,0,guess personality based resting bitchface
1,1,12,48,3,11,0,60,0,"""friends"" creator can't stress enough reboot never happen"
1,2,11,37,0,10,0,48,0,date food label may actually start make sense
1,1,9,39,0,9,2,48,0,21 time michael clifford realest person twitter
1,1,8,28,0,7,0,36,0,men tried groom eyebrow
1,1,13,35,1,12,0,48,0,dating look like early vs. long time
1,1,15,55,2,15,1,70,0,9 woman wearing exactly they've told totally awesome
1,3,16,59,6,11,0,75,0,nasa's juno spacecraft captured never-before-seen photo jupiter's surface they're epic
1,1,10,46,0,10,2,56,0,19 incredibly important reason watch rugby world cup
1,1,16,45,1,13,0,61,0,watch google's ceo dissing hell outta real madrid like true barca fan
1,1,8,33,2,7,0,41,0,"""gotham"" character would best friend"
1,2,10,43,1,10,2,53,0,34 meme understand cat rule everything around
1,3,2,56,1,14,0,58,0,armour created shoe tell tired run
1,1,8,41,0,7,0,49,0,underrated makeup brand everyone know
1,1,12,33,0,11,0,45,0,take quiz could use laugh today
1,3,6,66,2,11,0,72,0,"mexican newspaper slam american spring breaker ""shocking"" build wall chant"
1,1,7,34,0,6,0,41,0,japanese woman try geisha halloween costume
1,1,11,35,0,10,0,46,0,word search find image thinkstock
1,2,5,41,1,8,0,46,0,stephen hawking: jeremy corbyn disaster labour
1,1,9,37,2,9,2,46,0,"21 ""friends"" fact legitimately make feel old"
1,3,9,48,2,10,0,57,0,"crazy, expensive stock market speculators, investor"
1,1,8,47,0,8,2,55,0,13 powerful story college student living depression
1,1,7,33,0,7,2,40,0,19 secret television runner never tell
1,1,11,45,0,10,0,56,0,latina beauty blogger everyone lookout
1,1,9,32,0,9,2,41,0,17 thing vegetarian south deal
1,3,11,44,2,10,0,55,0,here's really try new starbucks unicorn drink
1,1,8,33,0,7,0,41,0,hardest thanksgiving poll ever take
1,1,8,33,1,6,0,41,0,show u health fitness-inspired tattoo
1,1,7,34,0,7,2,41,0,19 influential canadian youngster
1,1,9,48,3,8,0,57,0,"white goodman's quote ""dodgeball"" motivational poster"
1,3,7,36,1,6,0,43,0,sarah silverman: military help overthrow trump
1,1,9,32,0,10,6,41,0,39 funniest text straight white boy 2015
1,1,9,39,1,9,2,48,0,17 photo thanksgiving make laugh loud
1,1,10,32,0,10,2,42,0,29 baller as winter coat might able afford
1,1,9,33,2,9,2,42,0,"21 picture ""the hobbit"" fan think funny"
1,1,8,29,0,7,0,37,0,puppy eat peanut butter first time
1,2,14,53,4,14,0,67,0,nyts thomas friedman: fear lot american getting addicted trump
1,3,9,46,0,8,0,55,0,german town receives bomb threat cancelling turkish rally
1,1,6,30,0,5,0,36,0,quentin tarantino made christmas card
1,1,10,41,1,9,0,51,0,body chart little girls' role model horrifying
1,1,8,31,0,7,0,39,0,well remember past bonnaroo lineup
1,1,11,39,0,10,0,50,0,happens abuela try speak english
1,1,11,39,1,9,0,50,0,rachel bilson kristen bell new mom-friend goal
1,1,7,31,0,7,2,38,0,16 way totally bisexual visibility week
1,1,9,35,0,9,2,44,0,25 picture true absolutely good reason
1,1,14,53,0,13,0,67,0,tom hardy explained shut reporter asked sexuality
1,3,12,30,2,10,0,42,0,"eagle armed gopro hunt fox, intense"
1,1,11,32,0,11,2,43,0,21 thing tidy people deal daily basis
1,3,11,40,0,11,1,51,0,4 way entrepreneur use technology stay fit road
1,1,11,47,0,11,1,58,0,7 hot guy music video definitely follow instagram
1,3,7,81,2,18,0,88,0,revealed: unexpected unwanted ingredient food beef yoghurt bone sugar
1,2,11,45,4,11,2,56,0,13 christmas tradition around world thatll make sayhuh?
1,1,9,37,1,9,2,46,0,19 clever gift anyone who's constantly phone
1,1,9,35,1,8,0,44,0,best thing that's happened cereal since cereal
1,1,8,31,1,6,0,39,0,kind pop-tart match personality
1,3,7,41,1,9,0,48,0,mexico potential weapon trump declares war nafta
1,3,7,40,3,6,0,47,0,married people actually healthier? complicated.
1,1,8,24,0,7,0,32,0,hook actually messed movie
1,1,7,34,0,7,2,41,0,17 truth female best friend understand
1,1,11,35,0,10,0,46,0,know favorite pop song based zodiac sign
1,2,5,55,2,14,0,60,0,steve irwin's son robert show he's chip old block tonight show
1,3,1,48,1,10,2,49,0,11 highest-paying job best company america
1,1,12,43,1,12,2,55,0,"39 amazing thing make fall love portland, maine"
1,1,9,33,3,7,0,42,0,"extra ""black-ish"" totally radicalized"
1,3,1,42,1,8,0,43,0,living without lung six day save woman life
1,3,2,24,1,5,0,26,0,syria war: risking escape
1,1,11,32,2,10,0,43,0,"well remember lyric ""school rock"""
1,1,11,39,0,10,0,50,0,subtle tattoo get based zodiac sign
1,1,9,35,1,9,2,44,0,16 photo capture like renting toronto
1,3,21,67,5,18,0,88,0,"pc indian imdb's popular celebrities' list, original humma humma singer slam new song ent!"
1,1,10,23,0,10,2,33,0,21 time used call cell phone
1,3,2,31,2,4,0,33,0,inside london's oldest cigar merchants'
1,2,3,59,1,9,0,62,0,"germany hunt possible accomplice berlin suspect, arrest tunisia"
1,1,12,40,1,11,2,52,0,17 real struggle anyone grew super-fine hair
1,1,9,35,1,9,2,44,0,21 people one thing they'd change hollywood
1,1,8,28,0,7,0,36,0,major city actually live
1,1,12,48,1,10,0,60,0,mom hilariously call dysfunction school drop-off line
1,3,10,26,2,9,0,36,0,old person young personsbody?
1,1,7,21,1,8,4,28,0,22 thing emo girl owned '00s
1,1,11,42,4,10,0,53,0,"sorry america, ""harry potter sorcerer's stone"" wrong"
1,1,7,30,0,7,2,37,0,17 real thing perpetually late people
1,1,11,41,0,10,0,52,0,guess favorite animal based favorite actor
1,3,12,64,4,12,0,76,0,"zuckerberg hit trump immigration policies, say america must keep door open refugee"
1,1,11,44,0,10,0,55,0,canadian teenager autism inspiration need
1,3,3,53,2,10,0,56,0,russian ambassador killed turkey: know assassin?
1,1,8,22,1,8,2,30,0,19 dog want summer end
1,1,11,30,0,10,0,41,0,kimmy gibbler whip nae nae
1,1,11,37,3,10,0,48,0,"maid honor's ""ice ice baby"" wedding toast flawless"
1,2,17,59,3,13,0,76,0,"disney bos say political bias abc news espn, complaint completely exaggerated"
1,1,7,20,0,6,0,27,0,like papyrus sans
1,1,4,12,1,4,4,16,0,cereal cool 2016
1,3,12,45,1,12,2,57,0,12 ridiculously cool playground thatll make want kidagain
1,1,8,20,1,7,0,28,0,want go therapy
1,3,11,51,1,11,0,62,0,designer melania trump inaugural ball gown loved working
1,1,15,38,0,12,0,53,0,know cat gif make smile based birthstone
1,1,11,42,2,10,0,53,0,"well remember halloween party episode ""friends"""
1,1,11,41,1,10,2,52,0,19 insanely kawaii cat-themed product idea needed
1,1,5,23,0,5,2,28,0,19 better name everyday thing
1,3,0,67,2,14,3,67,0,"15 habit self-made millionaires, man spent 5 year studying rich people"
1,1,12,51,2,11,0,63,0,"cara delevingne hit back robb stark called ""unprofessional"""
1,3,12,47,1,12,1,59,0,workout wear athleisure style: 7 way workout style season
1,1,9,33,1,7,0,42,0,adorable baby gorilla born rare c-section
1,1,6,25,0,5,0,31,0,struggle sleepwalker
1,1,11,44,1,11,2,55,0,44 model walking victoria's secret fashion show
1,1,11,41,0,11,2,52,0,28 david cameron pig pun make squeal laughter
1,2,11,55,5,10,0,66,0,do-nothing congress: democrat pivot gun control blocking pro-gun bill
1,2,15,57,4,13,0,72,0,"here's wechat's parent company tencent celebrated new year, fake b*lowjob game"
1,2,4,14,2,5,4,18,0,iphone x: coming 2017?
1,1,11,53,2,10,2,64,0,14 beautifully weird spider-man vine make question existence
1,1,12,54,4,11,0,66,0,"chelsea handler's netflix series racism, drugs, marriage, robot"
1,1,8,29,2,9,6,37,0,"17 time ""steven universe"" heart 2015"
1,1,7,41,2,6,2,48,0,15 gorgeous london-inspired tattoo absolutely love
1,1,11,31,0,10,0,42,0,new dad baby put snapchats shame
1,1,7,32,0,7,2,39,0,17 time tumblr made u laugh thanksgiving
1,1,11,39,0,11,2,50,0,57 vintage photo couple make believe love
1,1,7,26,2,6,0,33,0,"chanel ""scream queens"""
1,2,8,39,1,8,2,47,0,28 savage kardashian burn still recovered
1,1,10,46,1,9,0,56,0,read inspiring post robin williams' daughter depression
1,1,9,33,0,8,0,42,0,celebrity zodiac sign
1,3,2,34,5,9,7,36,0,"blame wage turtle doves: '12 days' cost $34,363"
1,1,16,46,2,15,0,62,0,"girl play sansa stark ""game thrones"" crush ryan gosling"
1,1,9,36,0,8,0,45,0,obscure thing make sexy halloween
1,1,8,20,1,8,2,28,0,16 cat care like
1,1,10,30,2,9,0,40,0,"get excited second season ""master none"""
1,2,1,46,0,10,0,47,0,twitter user share list user block
1,1,12,41,0,11,0,53,0,gave masturbation month completely changed u
1,1,6,21,0,7,6,27,0,21 calendar get excited 2016
1,2,5,62,3,12,0,67,0,"d.c. post twitter versus everybody else post twitter, visualized"
1,1,6,24,0,5,0,30,0,would zooey deschanel name
1,2,13,36,1,13,1,49,0,5 mistake make know want next
1,1,14,38,0,10,4,52,0,backstage celebrity picture 2016 baftas
1,2,3,37,1,6,0,40,0,nigeria's starving child fled boko haram
1,1,13,52,0,12,0,65,0,urban decay released gwen stefani palette people losing mind
1,1,10,33,0,9,0,43,0,really delicious way enjoy acorn squash
1,1,7,21,0,7,2,28,0,43 pet need home christmas
1,1,8,40,0,8,1,48,0,7 insanely delicious way eat leftover halloween candy
1,1,12,33,0,11,0,45,0,disney allows dying fan see new star war early
1,3,2,37,1,8,1,39,0,2 dope queens: podcast pair reign supreme
1,3,4,43,1,8,0,47,0,colin cowherd right: matthew dellavedova worst
1,1,5,16,0,4,0,21,0,doctor taste test
1,1,9,32,0,8,0,41,0,taylor swift lyric life motto
1,1,11,50,0,10,0,61,0,artist making traditional oil painting london grime artist
1,1,10,28,1,9,0,38,0,time talk good olive garden
1,2,9,46,0,9,0,55,0,islamic state teen jailed attacking jewish teacher france
1,2,1,68,0,15,0,69,0,entrepreneur stopped chasing every new idea could focus one big goal
1,3,9,39,2,9,0,48,0,al gore visit trump tower seeking area common ground
1,1,15,40,2,14,0,55,0,"got advice margaret cho, real think"
1,1,15,60,1,14,0,75,0,stop everything watch grandma try virtual reality first time
1,2,3,70,2,14,0,73,0,silicon valley couple save animal slaughter take look inside farm
1,1,10,48,4,9,0,58,0,"everyone's freaking girl's amazing ""sexy gandalf"" costume"
1,1,10,42,0,10,2,52,0,15 turkey fact make sound smart thanksgiving
1,1,5,8,3,4,0,13,0,"i'm fat, i'm"
1,1,12,45,4,11,0,57,0,"called luke's phone number ""gilmore girls"" here's happened"
1,1,17,39,1,14,0,56,0,dr. zizmor retired one nyc ever clear skin
1,1,15,48,0,14,0,63,0,john stamos blessed world photo bare as paper magazine
1,1,13,37,2,12,0,50,0,here's tell friend they're going bridesmaid
1,3,12,55,2,14,2,67,0,sen. menendez ally dr. salomon melgen found guilty 67 count medicare fraud
1,1,11,51,3,10,0,62,0,"hot topic's new ""the nightmare christmas"" collection super spooky"
1,1,10,37,1,9,0,47,0,need stand together defend zac efron's mustache
1,3,5,42,2,8,0,47,0,"enjoy noaa's vital satellite imagery, still"
1,1,10,32,3,8,0,42,0,"well actually know ""x-files"" mythology"
1,3,3,66,1,15,0,69,0,woman find swastika painted front door cover harry potter quote
1,1,14,37,0,14,1,51,0,used crap new iphone 6 happened
1,1,12,46,0,11,0,58,0,holy moly polite canadian crowd celebration ever
1,2,2,37,1,7,0,39,0,social medium video: avoid automatic play
1,3,12,50,1,10,3,62,0,"va dentist resigns possibly infecting 600 veteran hiv, hepatitis"
1,1,11,20,0,10,0,31,0,cat cat
1,3,1,64,0,11,0,65,0,weirdest insult politician threw government year
1,1,12,40,0,12,1,52,0,7 craziest science study ig nobel award
1,3,7,41,2,6,0,48,0,italy struggling economy world healthiest people
1,3,14,40,3,11,0,54,0,"team mma weirdest thing seeno seriously, check"
1,1,13,37,1,12,0,50,0,know haunt people ghost based zodiac
1,1,10,45,2,9,0,55,0,"horrifyingly satisfying photo ""baby foot"" haunt"
1,1,16,53,3,15,0,69,0,"american filmmaker get visa india, he's directing film skype"
1,3,1,52,1,10,0,53,0,make sure startup destroy personal life
1,1,11,24,0,11,4,35,0,like new york mets fan 2015
1,1,6,16,1,5,0,22,0,jessie j. song
1,1,7,33,0,7,2,40,0,21 cozy sanctuary shelter adulthood
1,2,1,79,4,17,0,80,0,'you belong here' solicitor caught film launching racist attack woman young son
1,2,2,48,1,8,0,50,0,florida woman's toilet clogged iguana florida
1,3,9,41,1,11,0,50,0,"officer pull speeding student, teach tie tie"
1,3,3,42,4,9,4,45,0,"clemson tiger welcomed home 6,000: 'our fan uncommon'"
1,1,9,23,0,7,0,32,0,dj khaled miranda sings
1,1,11,38,3,9,0,49,0,j.k. simmons really headbutt lupita nyong'o oscar
1,1,8,44,0,8,2,52,0,16 delightful picture stormtroopers enjoying day
1,3,8,27,0,8,2,35,0,15 way make extra money using mobile apps
1,1,10,34,1,10,2,44,0,26 picture real anyone who's college
1,3,14,62,6,15,0,76,0,maher: look like russia installed trump crime family loot destroy america
1,1,11,42,0,9,2,53,0,17 thing twentysomethings watched bet never forget
1,1,7,32,0,6,0,39,0,would city survive zombie apocalypse
1,1,13,38,0,12,0,51,0,strange case woman whose skin turned book
1,2,9,40,3,11,1,49,0,"dont act age, act like millennial: 5 lesson leverage"
1,3,1,30,1,6,0,31,0,world's worst tax haven
1,2,1,71,0,16,4,72,0,man reunited vintage car last drove 1950s current owner track
1,1,9,38,3,7,0,47,0,"remember david bowie ""spongebob squarepants?"""
1,1,12,44,0,11,0,56,0,three question determine kind man turn
1,1,12,54,0,12,2,66,0,38 gorgeous quote literature might help cope depression
1,1,11,35,3,10,0,46,0,"color test determine sexy, hot, cute"
1,1,10,40,0,10,2,50,0,27 hilariously simple idea would make world fun
1,2,5,26,0,4,0,31,0,weaponized police drone coming
1,1,11,39,2,10,0,50,0,"well actually remember ""home alone"" booby trap"
1,1,10,45,0,9,0,55,0,lesbian watched critiqued lesbian porn traumatic
1,2,3,50,3,10,0,53,0,european debt crisis: greece that's drowning debt
1,3,11,34,2,6,0,45,0,sapvoice: high-tech investment make smart city
1,2,9,34,6,10,0,43,0,great wall star matt damon: im believer wall
1,1,10,31,0,10,2,41,0,19 picture like dream love arcade
1,1,7,30,0,7,2,37,0,13 dad joke guaranteed slay halloween
1,1,9,34,0,8,2,43,0,26 youtube comment actually make laugh
1,1,12,59,0,11,0,71,0,britney spear hilariously pranked bodyguard help neil patrick harris
1,1,6,28,0,5,0,34,0,couple reveal biggest pet peeve
1,1,11,52,3,9,0,63,0,dear white people: here's well-intentioned halloween advice india
1,1,14,48,0,14,4,62,0,official sonic hedgehog twitter lost mind 2015 amazing
1,1,6,32,0,5,0,38,0,brit respond question australian
1,1,10,34,2,9,3,44,0,22 thing happen date 6-foot-something man
1,1,4,19,0,3,0,23,0,people try rainbow doritos
1,1,7,21,2,6,0,28,0,"would die ""scream queens"""
1,1,8,32,0,8,2,40,0,17 clever product make chore suck less
1,3,10,34,0,10,2,44,0,11 thing know becoming uber lyft driver
1,1,7,29,2,6,0,36,0,"""project runway"" choose right winner"
1,1,11,29,0,10,0,40,0,movie use prove good taste
1,1,8,28,0,7,0,36,0,much actually know cooking
1,1,12,53,2,11,0,65,0,here's people furious facebook's indian flag profile photo
1,1,11,43,1,10,0,54,0,"star sign actually say you, according science"
1,3,3,51,2,12,0,54,0,golden age d.c. sport star hanging puppy
1,1,9,38,0,9,2,47,0,19 accessory anyone love sleep people
1,1,13,52,1,12,0,65,0,emma watson responds jennifer lawrence's pay equality essay lovely way
1,1,12,44,0,11,0,56,0,need say hilariously awkward yukon government ad
1,1,13,40,0,12,0,53,0,adorable polar bear cub sleeping u morning
1,3,1,54,0,10,0,55,0,united kick bride groom heading wedding flight
1,1,10,31,0,9,0,41,0,predict future based eye color
1,3,12,61,0,14,0,73,0,teacher placed administrative leave past adult film star exposed
1,3,20,56,2,21,1,76,0,"govt planning ban buying car, parking 5 read today"
1,1,9,23,0,8,0,32,0,earthling alien
1,1,6,33,1,6,2,39,0,17 productivity hack probably try
1,1,17,51,0,16,0,68,0,canadian groom ever left wedding plow guest snow storm
1,1,8,34,0,8,2,42,0,15 indian beauty secret whole world know
1,1,6,21,0,6,2,27,0,29 best college bar america
1,1,6,28,1,5,0,34,0,people try snapchat's new selfie filter
1,1,7,34,2,6,0,41,0,"hogwarts student ""mean girls"" character"
1,3,1,59,2,13,0,60,0,"dark times, image glorious message resistance futile"
1,1,13,32,0,12,0,45,0,recipe mud hen bar need see today
1,1,11,36,0,10,0,47,0,gadget make believe future food
1,3,11,48,7,10,0,59,0,lisa kudrow apparently wasnt f**kable enough one friend guest star
1,3,8,40,1,10,0,48,0,kid battling cancer board flight north pole yahoo
1,1,11,38,0,10,0,49,0,know favorite music genre based zodiac sign
1,3,5,33,1,8,0,38,0,kinder surprise egg illegal us?
1,3,2,47,2,8,0,49,0,dying cancer: could location determine fate?
1,1,7,31,0,7,2,38,0,29 healthier version best fall dessert
1,3,10,66,7,15,0,76,0,axelrod: indisputable ferocity opposition obama function race
1,3,13,56,4,14,0,69,0,credit suisse: 'danger signals' stock market top we're watching
1,1,10,33,0,8,0,43,0,remember anderson cooper reality tv host
1,1,11,38,0,11,2,49,0,30 tip buying selling clothes ebay like champion
1,2,7,26,0,7,1,33,0,7 thing woman avoid catcallers
1,1,6,36,0,6,2,42,0,22 brutally honest confession veterinarian
1,3,19,61,3,16,0,80,0,"pak arrest 'indian spies', bbc banned national park five year must read"
1,1,6,26,0,5,0,32,0,people make ideal starbucks cup
1,3,7,46,4,10,0,53,0,"deep amazon, remarkable beach (and ant-eating) experience"
1,2,18,68,3,21,4,86,0,netflix uk u new february 2017: santa clarita diet american crime story: people v oj simpson
1,1,11,46,1,11,2,57,0,17 people literally idea they're getting christmas
1,1,12,38,0,12,2,50,0,19 thing lazy girl hate getting ready know true
1,1,8,34,1,9,4,42,0,35 thing totally memory trigger '80s kid
1,1,9,35,2,8,0,44,0,here's girlfriend's period want know
1,1,10,33,1,9,0,43,0,where's best place buy punk grunge clothes
1,3,7,32,1,7,0,39,0,triple h endorses joel embiid all-star game
1,2,8,42,2,11,6,50,0,"beauty fitness influencers make $300,000 per post"
1,2,5,35,0,8,0,40,0,jeb bush spoke angela merkel germany
1,1,12,22,0,8,2,34,0,11 time ruby rose changed mtv emas game
1,3,1,17,1,3,0,18,0,teachersleave?
1,1,9,37,0,9,2,46,0,37 cozy sweater people literally always cold
1,1,6,30,0,5,0,36,0,taking antidepressant first time
1,1,8,21,0,7,0,29,0,guess ron swanson mad
1,3,13,39,3,12,0,52,0,take quiz well tell final fantasy hero youare
1,1,8,32,0,8,2,40,0,23 cocktail make forget booze
1,1,10,31,0,10,2,41,0,12 chart speak anyone stay late
1,1,7,40,0,7,2,47,0,34 question stephenie meyer need answer immediately
1,1,10,46,1,9,0,56,0,beloved children's cartoon character hook
1,1,8,23,2,8,2,31,0,"""12 day christmas"""
1,1,9,32,0,9,2,41,0,13 easy bedroom upgrade change way sleep
1,2,9,47,2,14,2,56,0,"ranked: 18 worst new tv show year far, according critic"
1,3,13,41,1,13,4,54,0,best argument saving public medium made mr. rogers 1969
1,1,16,23,1,7,2,39,0,21 perfume definitely real thing
1,3,15,54,1,14,0,69,0,people freaking teen foot punctured phonecharger
1,3,13,67,3,12,0,80,0,"'queen' director vikas bahl denies sexual harassment allegations, say feeling victimised"
1,1,10,15,1,7,2,25,0,"19 time asos went way, way far"
1,1,11,61,0,11,2,72,0,14 disgustingly honest confession couple enjoy gross thing together
1,1,10,33,1,9,0,43,0,pretend u pretending exist
1,1,7,22,1,7,2,29,0,27 easy meal break bank
1,1,6,24,0,6,2,30,0,11 struggle hot sauce lover know
1,1,9,36,0,9,2,45,0,17 ridiculous text sibling sent
1,1,12,55,0,11,0,67,0,canada looked like ridiculously long election started
1,3,1,64,1,12,0,65,0,"mom thought newborn cold, noticed sign something serious"
1,1,10,36,0,9,0,46,0,know procrastinate based zodiac sign
1,1,10,43,0,9,0,53,0,erykah badu effortlessly threw shade iggy azalea last night
1,2,2,41,4,12,0,43,0,"'baby brain' real? yes, way may think"
1,1,11,44,3,10,0,55,0,"bride's ""certificate purity"" causing huge debate online"
1,1,11,40,1,10,0,51,0,cemitas mexico's delicious dish try
1,1,11,29,3,10,0,40,0,"cast ""st trinian's"" look like"
1,1,8,33,2,7,0,41,0,"actually best ""jessica jones"" character"
1,1,9,24,0,9,2,33,0,33 tip best sex life
1,1,12,45,0,11,0,57,0,marilyn monroe based favorite ice cream flavor
1,3,2,52,5,11,0,54,0,phil jeanie -- basketball's ultimate power couple -- call quits
1,2,2,42,3,8,0,44,0,woman striking smiling today. here why.
1,1,11,31,1,10,0,42,0,know virgin based single question
1,1,9,42,1,10,4,51,0,18 gloriously cringeworthy thing '00s girl hair
1,3,9,55,3,9,0,64,0,"nationwide crackdown, italy announces zero tolerance illegal alien"
1,2,0,74,1,12,2,74,0,10 super-successful people share toughest sacrifice made achieve goal
1,2,13,44,1,9,0,57,0,sapvoice: one solution turn shipping delay advantage
1,1,10,32,0,9,0,42,0,disney song based zodiac sign
1,2,8,34,0,8,1,42,0,9 cult skincare product really trulywork
1,3,3,61,4,11,2,64,0,advice revealed: worst airline baggage charge (including 78 backpack)
1,3,2,43,0,8,0,45,0,college student actually use tinder
1,1,8,24,0,8,2,32,0,14 way healthyish eater right
1,1,11,33,2,10,2,44,0,21 funny t-shirt wear knocked
1,1,10,44,0,9,0,54,0,watch darling kitten sibling get confused cone
1,3,1,45,1,7,0,46,0,employer hiring grad in-demand major
1,1,8,29,0,7,0,37,0,disney movie directed tim burton
1,1,7,37,0,6,0,44,0,joey tribbiani quote motivational poster
1,1,14,42,5,13,0,56,0,"said it: ron swanson ""parks rec"" stanley ""the office"""
1,1,9,23,0,9,2,32,0,12 sign grew next slate quarry
1,1,8,25,0,7,0,33,0,country mouse city mouse
1,1,8,39,1,8,2,47,0,68 beautiful temporary tattoo want keep forever
1,1,9,35,0,8,0,44,0,people laughing salad something else
1,1,9,31,0,8,0,40,0,know first child conceived
1,1,18,57,2,17,0,75,0,time settle all: what's best chocolate candy could get halloween
1,1,11,34,0,10,0,45,0,oreo popcorn movie snack need right
1,1,14,42,0,11,0,56,0,mariah carey getting mac collection incredible
1,2,10,59,0,10,0,69,0,notre dame student complain mike penny announced commencement speaker
1,1,10,51,5,9,0,61,0,"meet alice wonderland's daughter disney's ""descendants: wicked world"""
1,3,18,69,5,17,0,87,0,"denver muslim murder charge say acted solely pleasure allah, cbs say motive still unclear"
1,1,8,46,0,8,2,54,0,21 borderline orgasmic experience anyone love cleaning
1,3,7,35,1,9,0,42,0,everything need know women's march
1,2,1,61,6,13,0,62,0,youre using freezer wrong here right way stock frozen food
1,1,15,47,2,16,4,62,0,"24 reason never movie greater ""10 thing hate you"""
1,2,11,57,3,10,0,68,0,"russian diplomat assassin sister say police school, gulen, radicalized"
1,1,12,37,0,11,0,49,0,zayn malik bleached hair grown big beard
1,2,13,55,2,15,0,68,0,let's watch kid rock shoot foreign-made grill sky shotgun insider
1,1,11,43,1,10,0,54,0,steven avery's new lawyer publicly arguing case twitter
1,3,6,27,3,5,0,33,0,sleeping beauty syndrome? [video]
1,1,8,43,1,7,0,51,0,video perfectly capture sriracha lover's struggle
1,2,12,57,1,13,3,69,0,here's happens accidentally buy girlfriend 144 pair fuzzy sock
1,2,2,70,0,18,0,72,0,spoken language world one plant use talk list
1,1,14,45,2,14,2,59,0,"11 time constance wu ""fresh boat"" best response life"
1,1,9,28,0,9,1,37,0,8 way eat way diwali week
1,1,9,28,0,9,2,37,0,21 people really know life
1,1,6,30,0,6,2,36,0,literally 20 picture tom hiddleston
1,1,8,33,2,8,0,41,0,dude like watching sport
1,2,10,42,0,10,2,52,0,22 totally real totally hilarious way thing got name
1,1,11,35,0,10,0,46,0,guess zodiac sign animal choose
1,2,7,33,3,6,0,40,0,lindsey graham warns trump dont empower russia
1,1,12,45,0,11,0,57,0,one question determine whether live new york
1,1,5,24,1,5,4,29,0,13 insanely easy 10-minute pizza snack
1,1,11,41,0,10,0,52,0,fictional character based taste music
1,3,5,23,2,6,4,28,0,2016 archduke franz ferdinand
1,1,9,36,0,9,2,45,0,19 gift work spouse would actually love receive
1,2,2,59,4,11,0,61,0,dont play identity politics! primal scream straight white male
1,3,9,44,2,8,0,53,0,amazon flying warehouse idea isnt even biggest challenge
1,1,12,60,0,11,0,72,0,famous landmark photoshopped look like zombie apocalypse chilling
1,1,8,35,0,8,2,43,0,21 unrealistic standard beauty set art history
1,3,7,76,2,12,0,83,0,donald trump: post-election euphoria russia begin fade featured story additional story
1,1,12,50,1,11,0,62,0,answer five question we'll tell celebrity husband
1,3,8,54,1,8,0,62,0,report: trump may designate muslim brotherhood terrorist organization
1,3,4,59,6,10,0,63,0,enjoyed whole absurdity it': paleontologist review jurassic world.
1,2,4,43,1,10,0,47,0,"come israel, stake high jared kushner"
1,1,5,15,0,6,6,20,0,38 awkward cat 2015
1,1,9,41,0,9,2,50,0,32 container make want organize immediately
1,1,10,40,2,9,0,50,0,"nicki minaj blasted farrah abraham ""teen mom"" twitter"
1,1,7,24,0,7,2,31,0,46 best stoner meme internet
1,1,5,28,1,3,0,33,0,#chickentweet motivational poster
1,1,5,16,0,4,0,21,0,trust friend
1,1,8,24,1,7,0,32,0,everything mami's house lie
1,1,11,49,0,11,4,60,0,bollywood celebrity looked damn good 2016 umang mumbai police show
1,2,18,58,1,16,0,76,0,m dhoni's wife sakshi give back harsh goenka comment former skipper
1,2,7,70,8,18,8,77,0,"15 notable member mar-a-lago, trump's 'winter white house' cost $200,000 join"
1,3,14,45,2,14,1,59,0,tell someone them? 8 subtle hint
1,1,11,40,3,12,4,51,0,"49 lyric adele's ""25"" need deep instagram caption"
1,1,9,44,2,9,4,53,0,27 forgotten trend early-'00s girl slightly obsessed
1,1,10,39,1,8,0,49,0,rainbow-inspired hummus almost gorgeous eat
1,1,12,51,2,11,0,63,0,"everyone whose sexual awakening caused david bowie ""labyrinth"""
1,1,8,27,0,7,0,35,0,michael strahan kelly ripa
1,1,6,29,0,6,2,35,0,21 inexpensive way upgrade bedroom
1,3,2,57,2,13,0,59,0,new podcast 'serial' team going next obsession
1,1,8,49,0,8,2,57,0,24 hilarious tweet perfectly capture existential despair
1,1,12,46,1,11,0,58,0,there's incredibly creepy new app brings picture life
1,1,8,35,1,7,0,43,0,pinterest actually porn director's best friend
1,1,7,22,0,6,0,29,0,member girl aloud
1,1,7,31,0,7,2,38,0,19 tooth fairy idea borderline genius
1,1,9,41,0,9,1,50,0,9 tip dealing depression anxiety university
1,1,12,29,0,9,0,41,0,gifs drew period rage
1,1,10,34,1,10,2,44,0,17 food question know needed answer
1,1,11,36,3,11,2,47,0,"well remember lyric sum 41's ""still waiting"""
1,1,10,31,0,9,0,41,0,well really see different shade red
1,1,8,40,0,8,2,48,0,31 gorgeous furniture upgrade grown apartment
1,2,16,60,3,12,1,76,0,tragedy: former nfl star todd heap accidentally kill 3-year-old daughter moving truck
1,1,11,36,2,11,2,47,0,"15 ""gossip girl"" book plotlines never made show"
1,1,7,28,0,6,0,35,0,pas basic trigonometry quiz
1,1,7,29,0,6,0,36,0,adele lyric describes love life
1,1,12,37,0,12,2,49,0,27 best response random guy tell smile
1,3,10,42,2,8,0,52,0,credit-card thief move online chip thwart in-store fraud
1,1,7,26,1,7,2,33,0,22 people definitely get job
1,1,7,21,0,6,0,28,0,know secret talent
1,1,13,37,3,10,0,50,0,"killer mtv's ""scream"" stack movie"
1,1,22,57,1,13,0,79,0,indian redditors responded perfectly college's alleged list bizarre rule female
1,1,7,25,0,5,0,32,0,question australian uk
1,2,9,47,3,9,0,56,0,"podesta group loses alphabet, google parent company, client"
1,1,14,34,1,12,0,48,0,get pumped work feeling lazy af
1,2,10,38,2,9,0,48,0,money grow trees: financial basic kid
1,1,12,46,0,11,0,58,0,people keep making huge facebook chat people name
1,3,9,30,1,8,0,39,0,"women, period trigger living hell"
1,3,3,33,2,7,0,36,0,claus' claws: mom say santa insulted son
1,1,7,25,1,7,2,32,0,23 place believe england
1,1,10,44,1,10,2,54,0,15 iconic item everyone love kim kardashian's cry face
1,2,1,59,2,13,4,60,0,"2016s politics pop culture, woman came limit created men"
1,1,9,31,0,8,0,40,0,ranking creepiest kid horror movie
1,3,1,50,2,11,2,51,0,"women's memory begin decline 50s, claim new study"
1,1,9,37,0,8,0,46,0,craziest story past lottery winner
1,1,10,35,1,10,2,45,0,'00s movie leading lady based zodiac
1,1,9,36,0,8,0,45,0,actually prefer chris pratt chris hemsworth
1,1,13,41,0,13,3,54,0,man handed 100 love note stranger honor late wife
1,3,3,78,1,14,0,81,0,uber executive sure sound defensive taking fall uber's harassment crisis
1,1,7,19,1,6,2,26,0,17 life-changing way eat twix
1,3,6,19,0,6,1,25,0,7 small change try week
1,1,6,25,0,6,4,31,0,2015 movie match zodiac sign
1,3,1,34,0,7,1,35,0,9 best electric motorcycle buy
1,1,7,32,0,7,2,39,0,16 hilarious disney vine totally nailed
1,1,11,44,0,10,0,55,0,girl snapchatted disney princess awesome
1,3,12,44,2,10,0,56,0,liberal answer breitbart news loses ceo even launch
1,1,8,47,0,8,2,55,0,21 heartbreaking confession working retail holiday
1,1,8,22,1,7,0,30,0,peter pan's lost boy
1,2,6,34,0,6,2,40,0,14 strangely satisfying video melting cheese
1,1,13,47,3,14,5,60,0,moment waiting for: 100 year hamster beauty 60 second
1,2,7,34,0,6,0,41,0,nicole scherzinger new katnisseverdeen
1,1,10,35,2,9,0,45,0,"""game thrones"" character best"
1,1,17,65,0,16,0,82,0,every piece evidence prof anna faris chris pratt cutest family existence
1,1,18,65,1,15,0,83,0,someone please teach bbc tennis works; keep reporting hingis double match alone
1,1,7,32,0,7,2,39,0,22 time supermarket got completely hand
1,3,9,47,0,9,0,56,0,border patrol agent rescue migrant thrown river smuggler
1,1,11,43,1,10,0,54,0,miss piggy kermit can't business meeting without drama
1,1,8,32,0,8,2,40,0,29 los angeles sentence really mean
1,1,10,50,0,10,2,60,0,29 thing late twentysomethings stay hostel understand
1,1,11,38,0,12,2,49,0,12 struggle everyone common last name relate
1,1,13,56,1,12,0,69,0,jennifer lawrence revealed going making directorial debut
1,3,13,47,2,11,0,60,0,think rom-com couple stayed together movie ended?
1,1,10,38,0,9,0,48,0,many premier league football ground
1,2,7,37,1,8,0,44,0,"promotions, manager must learn shift gear"
1,1,5,18,0,5,2,23,0,18 pic thanksgiving
1,1,12,53,2,11,0,65,0,"illustrated ""home alone"" storybook make excited christmas"
1,1,8,32,3,7,0,40,0,"tried animal balls, brains, udders, tongue"
1,1,8,13,0,5,0,21,0,omg cloud emoji
1,1,11,42,2,10,0,53,0,"south park reveals canadian alphabet time, guy"
1,1,12,40,0,12,4,52,0,need talk biggest problem buying thing 2015
1,1,14,41,0,11,0,55,0,diy magnetic jar holder save much cabinet space
1,1,7,37,1,5,0,44,0,non-canadians try identify canadian celebrity
1,2,2,37,2,5,0,39,0,driverless truck threaten job 'trumpland'
1,1,14,40,0,10,0,54,0,photo series share experience lgbt people faith
1,1,7,24,0,6,0,31,0,empire rebellion
1,1,13,51,0,12,0,64,0,genius baby us pillow master class creative problem solving
1,1,9,33,0,9,2,42,0,38 cozy cocktail guaranteed warm fall
1,1,15,44,1,13,0,59,0,people set memorial bus-stop cat viciously killed
1,1,14,35,0,11,0,49,0,color quiz tell husky bff
1,1,12,52,0,12,2,64,0,21 celebrity wax figure perfectly sum relationship bos
1,1,14,61,1,14,0,75,0,rescue worker pulled stop make grandmother's birthday wish come true
1,1,9,38,1,9,2,47,0,26 picture people work never understand
1,1,19,49,0,16,0,68,0,girl learned hard way always test diy face mask hand
1,1,6,35,0,5,0,41,0,leadership quality suit personality
1,1,8,23,0,8,2,31,0,21 spooky date idea boo
1,1,11,40,0,10,0,51,0,everything need know longest movie ever made
1,1,10,36,1,9,0,46,0,pinterest tell product's price drop
1,1,8,29,0,8,2,37,0,21 lush product actually say
1,1,10,37,2,9,0,47,0,what's weirdest united state law ever heard
1,3,2,42,1,7,0,44,0,"patton oswalt say heart condition, med killed wife"
1,1,11,41,3,10,0,52,0,"karachi's diwalis getting quieter year, here's"
1,1,10,43,0,10,2,53,0,19 thing everyone naturally thick eyebrow know true
1,3,7,24,1,7,0,31,0,euro could break upor saved
1,1,6,28,0,5,0,34,0,dumb thing patient told doctor
1,1,6,21,0,6,2,27,0,16 redhead truth told tweet
1,1,11,36,1,10,0,47,0,blac chyna get future's name tattooed hand
1,1,11,35,0,12,6,46,0,19 sassiest response woman gave men tinder 2015
1,1,15,56,4,13,0,71,0,"adam woodyatt upset #howsadam moment happen ""corrie"" live episode"
1,1,12,21,1,9,2,33,0,16 parent lgbt kid get
1,1,9,28,4,8,0,37,0,"""hey arnold"" actual ""football head"""
1,1,5,27,2,4,0,32,0,"""halloweentown"" creature"
1,2,2,49,4,11,0,51,0,social sickie sure-fire way avoid christmas party
1,1,7,33,1,7,2,40,0,15 vibrator horror story make cringe
1,1,6,29,0,6,2,35,0,15 totally wild confession sex tape
1,1,11,50,0,10,0,61,0,ariana grande flawlessly shut sexist comment radio interview
1,1,15,40,3,16,8,55,0,"2015 great i'ma let finish, 2006 best music time"
1,1,12,39,0,11,0,51,0,teenager porn star name confused twitter
1,3,15,52,5,14,2,67,0,10-year-old cannot get passport unless 'abusive' father sign form
1,1,10,39,2,10,2,49,0,"17 tweet make every indian girl go ""ohmygod yaaaaaa"""
1,1,9,37,0,9,2,46,0,32 tweet single guaranteed make laugh
1,2,8,24,0,8,1,32,0,5 thing could decide super bowl li
1,1,9,24,1,9,2,33,0,17 text get drake moved
1,1,15,53,1,14,0,68,0,here's would look like arranged divorce way arrange marriage
1,3,1,39,1,6,0,40,0,"hidden, floating sanctuary built artist"
1,3,2,68,0,17,0,70,0,london startup nested raise wee bit money buy home skim sale
1,2,14,49,2,13,0,63,0,"man hang girlfriend's dupatta, say joke gone wrong"
1,1,13,46,1,14,6,59,0,"going 16 biggest food trend 2016, according pinterest"
1,2,7,31,1,7,2,38,0,definitive ranking best '90s comedy
1,1,11,39,3,9,0,50,0,"one mind-blowing detail missed ""the little mermaid"""
1,1,15,46,0,12,0,61,0,nfl team support season based football team
1,1,7,31,0,7,2,38,0,23 word spelled differently canada
1,2,10,47,1,11,0,57,0,here's happens try block mark zuckerberg facebook
1,1,6,24,0,6,2,30,0,16 struggle smoker relate
1,1,8,43,2,7,0,51,0,"hard lesson catherine hardwicke learned ""twilight"""
1,2,4,47,2,9,0,51,0,moby say he'll dj trump's inauguration one condition
1,1,5,19,0,4,0,24,0,disney villain real life
1,1,14,51,2,13,0,65,0,"watch ""family feud"" answer steve harvey called favorite time"
1,2,9,27,1,7,0,36,0,meatball meat recipe nyt cooking
1,1,8,17,0,6,2,25,0,26 adorable mug give bff
1,1,9,30,0,9,2,39,0,19 thing every person stay late know
1,1,11,43,0,10,2,54,0,24 relationship problem real people anxiety
1,3,5,65,0,17,0,70,0,biggest name let go espn latest round layoff
1,1,9,22,1,7,0,31,0,said it: shia labeouf kanye west
1,1,8,26,0,7,0,34,0,zayn malik posted photo gigi hadid
1,3,12,47,2,13,0,59,0,dont sweat it: easy hairstyle give zero excuse skip gym
1,2,2,63,3,8,0,65,0,"'policemen without uniform' assaulting citizen belarus, protestors claim"
1,1,18,66,2,17,0,84,0,"thousand people sharing ""humans bombay"" post child rare genetic disorder"
1,1,6,32,0,6,2,38,0,23 thing teacher actually want christmas
1,1,10,37,2,9,0,47,0,"moment ""the simpsons"" always make ugly cry"
1,1,7,51,2,7,2,58,0,"17 unforgettable childhood moment playing ""crosscountry canada"""
1,1,8,40,1,8,2,48,0,23 thing definitely find every mexican household
1,1,6,21,0,6,2,27,0,21 way completely win dating
1,1,10,42,0,9,0,52,0,badass graphic novel ever created published
1,1,12,36,0,11,0,48,0,need stop look happy reindeer right
1,1,9,27,0,8,0,36,0,guess content makeup bag
1,1,13,41,1,13,2,54,0,19 thing cool emo teen definitely cool
1,1,8,33,3,8,2,41,0,"another round, episode 31: gon' get blackness"
1,2,11,33,0,11,2,44,0,spelling genius get 10 timedquiz
1,3,10,52,3,10,0,62,0,donald trump's administration wealthiest modern u.s. history
1,1,11,45,0,11,2,56,0,31 hilarious tweet eating healthy get every time
1,1,6,33,0,6,2,39,0,13 animal totally nailing halloween thing
1,2,17,60,2,16,0,77,0,"sussanne arent trying set example, say hrithik roshan friendship"
1,1,10,35,0,10,2,45,0,17 photo prove person need
1,1,13,46,2,12,0,59,0,"already terrified pigeons, video get"
1,1,13,37,0,12,0,50,0,know emoji use based zodiac sign
1,1,9,38,1,9,2,47,0,17 wicked item bring inner disney villain
1,1,8,26,0,7,0,34,0,painkiller know pain
1,1,16,42,1,15,0,58,0,tell cat dog person based taste avenger
1,2,9,47,1,7,0,56,0,ebay billionaire-backed startup try unravel rickshaw route
1,1,8,38,0,8,2,46,0,23 hilarious tumblr post student totally get
1,1,6,19,0,5,0,25,0,target walmart
1,1,11,38,1,10,0,49,0,life like justin bieber's nude leaked
1,1,14,44,1,12,0,58,0,harry potter-themed bar opened pay respect
1,1,14,46,3,12,0,60,0,people got snail facial first time...and pretty scary
1,1,4,16,0,3,0,20,0,ruin everything
1,3,10,32,1,9,0,42,0,even remember real color theselogos?
1,3,1,31,1,7,1,32,0,carry 5 thing wallet
1,1,7,26,0,7,2,33,0,25 time hipster britain went damn far
1,2,7,40,2,8,0,47,0,cavaliers' lebron james weighs nba's rest conundrum
1,3,7,53,1,12,0,60,0,wikileaks document dump tell u cia's frankfurt base
1,1,15,40,0,14,0,55,0,two rat fought slice pizza new york city
1,1,5,23,0,5,2,28,0,23 first tweet famous author
1,1,8,19,1,6,1,27,0,pigskin blanket: nfl week 7 pick
1,2,3,42,2,10,1,45,0,5 thing google's pixel phone iphone can't
1,1,16,58,3,15,0,74,0,"bride say outraged missed part honeymoon ""damaged"" passport"
1,1,12,45,0,11,0,57,0,tested four different mascara see one last longest
1,1,9,32,2,7,2,41,0,30 life-changing crock-pot recipe make fall
1,1,13,37,1,9,0,50,0,new gray burger mcdonald's everyone saying wtf
1,1,13,49,0,12,0,62,0,uplifting aerial photo beach italy remind summer
1,2,7,77,1,17,1,84,0,"great british bake finalist andrew smyth channel 4, male baker secret creative cake"
1,1,10,41,0,9,0,51,0,scary story tell dark reimagined millennials
1,1,10,33,0,10,2,43,0,18 sweary scottish word need use right
1,1,9,26,0,8,0,35,0,fear talking phone normal
1,3,9,49,6,11,0,58,0,bruce springsteen: racism genie wont go back bottle trump
1,2,11,42,1,10,0,53,0,"sunday church, group want saturday activism"
1,3,17,60,2,13,0,77,0,sapvoice: make sure hiring algorithm legal: four machine learning question ask
1,1,10,46,0,10,2,56,0,19 time woman perfectly demonstrated slay fuckboys tinder
1,1,10,34,1,9,0,44,0,look critics' choice award red carpet
1,1,8,40,1,8,1,48,0,9 halloween costume actually require costume
1,1,10,33,2,8,2,43,0,sign buzzfeed's 10-day best semester ever course
1,3,15,42,1,13,0,57,0,pics: le pen go sea clash macron fishing policy
1,1,10,26,2,9,0,36,0,"best ""star trek"" movie time"
1,1,10,41,4,8,0,51,0,j.k. rowling revealed writing another children's book
1,3,2,72,0,14,0,74,0,two irish student stole masterpiece worth million act political protest
1,3,1,16,0,4,0,17,0,week picture
1,1,8,24,1,7,0,32,0,member pope's squad
1,2,6,56,1,14,0,62,0,here's cold linkedin message prompted ceo give sender job
1,1,8,27,0,7,0,35,0,movie squad friend
1,2,15,55,2,14,0,70,0,little boy accidentally tell mom every parent need hear (but never does)
1,2,6,61,2,10,0,67,0,"hugh brown photograph artisan miner pakistan, india, bolivia indonesia"
1,1,14,24,2,11,0,38,0,snl cut skit last week's show gem
1,1,10,32,0,9,0,42,0,guinea pig way better instagram
1,1,14,46,0,13,0,60,0,kelly ripa got walk fame star everything adorable
1,1,10,39,0,10,2,49,0,16 gorgeous poem help cope depression
1,1,18,36,0,15,0,54,0,lot dapper af celebs gq men year award
1,1,3,11,1,4,2,14,0,9 best wine $9
1,3,8,40,0,8,0,48,0,swedish police officer torn patrol car riot
1,1,12,54,0,12,2,66,0,13 indian told u worst experience moral policing college
1,3,10,39,1,9,0,49,0,here's talking money improve bottom line
1,1,12,38,0,10,0,50,0,woman surprised proposal buzzfeed video
1,1,14,48,1,13,0,62,0,everyone listen lady gaga's speech wanted quit music
1,2,3,41,2,9,0,44,0,diverse place america? think
1,1,12,37,0,11,0,49,0,tyler joseph josh dun twenty one pilot
1,1,6,24,0,6,1,30,0,9 show stopped watching year
1,2,11,43,2,9,0,54,0,actually know difference mary-kate andashley?
1,1,7,18,0,6,0,25,0,game show go
1,3,1,45,1,8,0,46,0,im concerned child longer employable
1,2,10,55,1,11,0,65,0,report: grand jury hear testimony bill de blasio fundraising probe
1,1,9,29,0,8,0,38,0,inside joke share family
1,1,19,28,2,11,0,47,0,"rita os want remake ""lady marmalade"" ok"
1,2,11,48,0,11,1,59,0,5 thing new investor know investing marijuana stock
1,1,11,42,1,11,2,53,0,"17 image perfectly sum life really, really cold weather"
1,1,11,31,1,9,2,42,0,11 celebrity #tbt photo may missed week
1,2,11,49,0,12,0,60,0,howard schultz earned half billion dollar nine year
1,2,9,55,2,10,0,64,0,"psychic attempt prove he's immortal, accidentally stab death"
1,2,1,39,0,6,0,40,0,protect lightning strike
1,2,1,32,0,5,1,33,0,5 trump myth illegal immigration
1,2,2,63,3,12,0,65,0,comcast want new cellphone carrier. here everything need know.
1,2,10,37,4,8,6,47,0,"15-year-old boy discovers new planet 1,000 light-year earth"
1,3,16,68,2,15,4,84,0,"kjo played kanganas nepotism remarks, oscar 2017 full winner list entertainment"
1,1,9,43,2,8,0,52,0,"hogwarts house ""hannibal"" character belong"
1,1,13,35,2,8,0,48,0,mark ruffalo stop fanboying year's baftas
1,1,10,41,0,9,0,51,0,literally bunch shirtless dude wearing santa hat
1,1,8,35,1,8,0,43,0,going start seeing live photo facebook
1,1,9,29,0,8,0,38,0,lady worst babysitter world
1,3,8,46,0,9,0,54,0,outspoken billionaire work salvage tech empire china
1,2,5,52,2,11,0,57,0,prepping paris: watch boeing's dreamliner put amazing show
1,1,9,31,3,8,0,40,0,"disney's new ""frozen"" plane epitome chill"
1,3,11,44,0,10,0,55,0,literally every time meryl streep nominated anoscar
1,1,10,33,0,11,6,43,0,17 album prove 2005 actually golden era emo
1,1,9,39,1,8,2,48,0,16 hilarious revelation wine-lovers relate
1,1,11,35,0,9,1,46,0,8 thing happen bff start dating someone
1,1,10,34,0,9,0,44,0,serena van der woodsen hannah horvath
1,2,13,41,1,13,1,54,0,9 reason need travel solo least lifetime!
1,3,13,51,1,13,2,64,0,"even 32 years, bhopal gas tragedy victim continue wait justice"
1,1,6,23,3,5,0,29,0,tell u yourself(ie): jake lacy
1,3,2,51,4,10,0,53,0,making 'beast' beautiful: anxiety could useful?
1,2,2,40,0,7,0,42,0,china create new economic zone outside beijing
1,1,5,23,0,5,2,28,0,22 slightly wrong name animal
1,1,10,35,1,9,2,45,0,16 killer halloween look pull year-round
1,1,14,49,0,13,0,63,0,toddler best reaction found adam levine married
1,1,7,42,1,7,2,49,0,18 confession husband wives' pregnancy
1,1,7,23,0,6,0,30,0,pawnee city hall mural
1,1,12,33,1,9,0,45,0,kylie jenner's instagram pose
1,2,2,45,0,12,2,47,0,40 car prove geneva best auto show world
1,1,10,42,0,11,6,52,0,24 time ruby rose phoebe dahl defined relationship goal 2015
1,1,12,39,0,11,0,51,0,guy fined burping loudly amusement park
1,1,12,43,2,11,0,55,0,"fan sang ""happy birthday"" david bowie day death"
1,2,10,34,3,9,0,44,0,michael moore: trump right enter white house
1,1,9,27,0,9,2,36,0,24 way add geometry home decor
1,3,2,41,3,8,0,43,0,obama's economic recovery ended. here's
1,2,7,40,0,7,2,47,0,15 mansplaining story mansplained fuckinghard
1,1,8,25,0,8,2,33,0,56 thought ghosted
1,2,8,24,1,8,4,32,0,many movie actually see in2016?
1,3,1,35,1,10,0,36,0,need law turn phone
1,1,10,32,0,8,0,42,0,animated tv show family live
1,1,11,45,3,10,0,56,0,what's embarrassing thing done doctor's office
1,1,7,19,0,7,4,26,0,top bottom 2016
1,1,10,43,3,10,2,53,0,"81 thought ""american horror story: hotel"" premiere"
1,1,7,22,0,7,2,29,0,16 time chewbacca club
1,1,14,44,3,13,0,58,0,"channing tatum lip syncing ""let go"" everything expect"
1,1,12,36,0,11,0,48,0,feel atheist highly religious society
1,3,0,42,2,9,6,42,0,18 hottest under-the-radar startup watch 2017
1,1,7,38,2,7,2,45,0,21 picture understand introverted
1,1,8,36,3,8,2,44,0,"another round, episode 29: what's reparation tab"
1,2,9,43,0,10,0,52,0,health insurer list demand affordable care act killed
1,1,7,25,0,6,0,32,0,actor leading man
1,3,4,63,3,12,0,67,0,watch mike penny try defend trump false claim million voted illegally
1,1,11,44,2,10,0,55,0,new genre trans women's memoirs: life beyond identity
1,1,12,45,1,10,0,57,0,here's leonardo dicaprio movie really talking
1,1,14,51,2,13,0,65,0,"scary, real, video show anyone get diagnosed cancer"
1,1,7,23,0,6,0,30,0,best underrated game app
1,1,7,31,1,7,1,38,0,9 thing girl short hair understand
1,1,9,30,0,8,0,39,0,list thing need chill immediately
1,2,11,60,1,12,0,71,0,warrior dis russell westbrook twitter matchup kevin durant?
1,1,5,18,1,5,2,23,0,random '80s movie
1,2,2,48,0,14,1,50,0,people die january 1 time year
1,1,8,31,3,7,2,39,0,"23 reason re-watch ""the social network"""
1,1,4,29,0,4,2,33,0,17 hilarious literary thanksgiving pun
1,1,11,41,1,10,0,52,0,here's halloween costume wear based job
1,2,11,42,3,11,2,53,0,19 joke mr. brightside guaranteed make youlaugh
1,1,10,36,0,10,2,46,0,17 reason people exercise night right
1,2,4,26,1,4,4,30,0,2017 investment guide: trumponomics
1,1,13,48,3,11,0,61,0,"what's underrated place shop fun, bright plus-size clothing"
1,1,7,39,1,7,6,46,0,21 time neville longbottom out-longbottomed 2015
1,3,8,28,2,6,1,36,0,entire stadium cheered 2-year-old
1,1,10,32,2,9,0,42,0,"like chanel hester ""scream queens"""
1,1,7,27,0,6,0,34,0,drunk people drunk dial loved one
1,1,11,34,0,10,0,45,0,gay men ask lesbian woman question want know
1,1,9,34,2,9,3,43,0,here's 100 year men's grooming trend look like
1,1,10,40,2,9,2,50,0,25 gluten-free dessert make forget flour
1,1,13,36,1,11,0,49,0,here's shonda rhimes biggest troll tv right
1,1,8,32,0,8,2,40,0,16 ferret better hair game donald trump
1,2,2,46,0,11,0,48,0,google doc tool show every edit person ever made
1,1,9,38,0,9,2,47,0,31 people really nailing whole marriage thing
1,1,10,39,1,9,0,49,0,man's insane makeup art straight mesmerize
1,1,8,40,1,8,2,48,0,'90s pop culture reference kid never understand
1,1,12,41,2,11,0,53,0,"""high school musical"" song based zodiac sign"
1,1,8,39,0,8,2,47,0,22 excellent reason ban round system immediately
1,1,6,19,0,6,4,25,0,recipe 2015
1,1,8,40,1,7,2,48,0,14 genius last-minute halloween costume idea redhead
1,1,7,35,0,7,2,42,0,16 confession hairdresser never tell
1,1,5,36,1,5,2,41,0,"12 filthy french euphemisms, translated literally"
1,1,11,46,1,10,0,57,0,stop watch justin bieber serenade selena gomez
1,1,12,50,4,11,0,62,0,"call dora explorer, rob ""around"" kardashian's thanksgiving"
1,2,10,30,2,9,0,40,0,build wedding well tell youresingle
1,1,10,40,1,9,0,50,0,here's bald eagle always photographed side
1,1,9,30,0,9,2,39,0,21 photo way real makeup addict
1,2,3,26,1,6,0,29,0,icy u road pile-up caught camera
1,1,9,28,0,8,0,37,0,new song jam weekend
1,1,18,73,0,17,0,91,0,cara delevingne annie clark together london fashion week literally make heart ache joy
1,1,8,40,2,7,2,48,0,14 gluten-free thanksgiving dish change life
1,1,17,56,0,15,0,73,0,ellen degeneres scared shit emily blunt dressed lady liberty
1,1,10,32,2,9,2,42,0,"26 time ""the osbournes"" funniest family tv"
1,1,8,25,0,7,0,33,0,barry allen oliver queen
1,1,8,38,0,8,2,46,0,31 beautiful dog tattoo every dog lover appreciate
1,1,12,40,1,11,0,52,0,believe much mini crossword finish
1,3,9,68,3,12,4,77,0,"rasmussen: 82 percent republicans, 54 percent independent back trump refugee moratorium"
1,1,12,42,1,12,4,54,0,here's minimalist look best bollywood movie 2015
1,1,9,39,1,9,4,48,0,"2015, toronto truly revealed enduring love raccoon"
1,2,9,53,0,10,0,62,0,russell westbrook dodge question kevin durant hilarious way
1,1,12,39,1,12,2,51,0,"22 mesmerizing, mundane photo day life darth vader"
1,2,11,50,1,12,0,61,0,go again: obama sends arm trade treaty senate ratification
1,2,5,22,2,4,0,27,0,justin trudeau anti-trump?
1,2,7,29,0,7,4,36,0,practical car crossover 2017
1,1,10,38,0,10,2,48,0,14 powerful quote make hopeful future
1,3,7,33,5,9,2,40,0,prison break: 5 thing know season 5 [video]
1,3,9,15,2,11,13,24,0,"made $20,000 2016 2015"
1,1,5,20,0,6,6,25,0,21 important selfies 2015
1,1,8,28,0,7,0,36,0,pick right canadian best friend
1,1,8,25,0,6,0,33,0,queen riri might dating travis scott
1,3,10,36,0,10,2,46,0,22 pure kind post soothe troubledsoul
1,1,9,45,2,7,2,54,0,19 parent share nightmarish trick-or-treating story
1,1,12,40,0,11,0,52,0,eggnog pie greatest thing ever happen holiday
1,1,11,48,2,10,0,59,0,"ryan phillippe come amy schumer deleted ""trainwreck"" scene"
1,1,11,44,2,10,0,55,0,"""twilight"" author rewritten book reverse gender"
1,1,7,33,0,7,2,40,0,34 young adult novel diversify bookshelf
1,1,11,43,1,10,2,54,0,28 creepy tim burton costume inspire low-key goth lady
1,1,6,25,0,5,0,31,0,defense oatmeal raisin cooky
1,1,7,37,0,7,2,44,0,89 thought everyone wedding dress shopping
1,1,13,54,1,13,2,67,0,17 horribly awkward phone sex confession make want stick sexting
1,1,9,44,2,9,2,53,0,"15 ""american horror story"" question impossible answer"
1,1,10,31,2,9,0,41,0,what's worst thing ever put mouth
1,2,4,47,1,11,0,51,0,snapchat's ipo reveals much cost make man disappear
1,1,5,27,0,5,2,32,0,21 button facebook really need though
1,3,7,33,2,8,3,40,0,marijuana helped world's top hedge fund gain 145%
1,2,4,31,0,5,4,35,0,2017 horoscope favorite dealmakers
1,3,1,46,1,8,0,47,0,wacky gift tech-savvy person everything
1,1,7,32,0,7,2,39,0,16 message basically sext parent
1,1,8,37,0,9,6,45,0,17 beautifully illustrated picture book 2015
1,1,12,39,0,12,1,51,0,4 animal sum feel like monday break
1,1,12,34,1,11,0,46,0,tell axe murderer one question
1,1,11,45,1,10,0,56,0,like play pictionary comic professional
1,1,11,43,0,10,0,54,0,store actually closed thanksgiving day
1,3,5,56,5,13,6,61,0,wapo food top 20 recipe 2016 (warning: scrolling make hungry.)
1,1,13,45,3,12,0,58,0,"what's biggest thing want see ""gilmore girls"" revival"
1,1,13,50,1,12,0,63,0,here's justin trudeau walking wrong way escalator eternity
1,1,12,45,4,9,0,57,0,"attention, texas transplants: h-e-b selling product online"
1,1,16,54,1,14,0,70,0,watch woman talk struggle two-time survivor child sexual abuse
1,1,15,40,4,12,0,55,0,"someone made ""in-n-out pie"" beautiful revolting mess"
1,1,9,32,0,9,2,41,0,19 edible shot make holiday season
1,3,2,51,4,13,0,53,0,'the world two dimensional': like able smell
1,1,10,31,0,9,0,41,0,kind pasta eat aziz ansari
1,3,3,36,1,7,0,39,0,zara larsson: pop star sleep paralysis
1,1,15,43,1,14,0,58,0,lo mein recipe easy able open restaurant
1,2,9,43,3,9,0,52,0,save typing time hidden web-address suffix key [video]
1,1,9,56,3,8,0,65,0,"nobody's satisfied ""hamilton"" ticket lottery website completely failed"
1,1,9,36,0,8,0,45,0,sorry everyone jack dawson actually worst
1,2,2,64,1,11,0,66,0,there's internet language dedicated entirely talking dog list
1,1,11,42,1,9,0,53,0,woman leading crusade tell asian-american story
1,1,10,30,1,9,0,40,0,rigged crane game ever see
1,1,15,38,2,14,0,53,0,"wrong time listen ""all want christmas you"""
1,2,12,61,3,11,0,73,0,"trump immigration order mark worst day since japanese internment, say seattle mayor"
1,1,8,31,2,8,2,39,0,"18 perfect response someone text ""k"""
1,1,12,37,0,11,0,49,0,man us obituary ask people vote donald trump
1,2,3,20,0,3,0,23,0,dating schizophrenia
1,3,3,70,1,14,4,73,0,man behind one 2016's best documentary uncovered disturbing new youtube trend
1,1,11,35,0,10,0,46,0,know favorite pop star based zodiac sign
1,3,1,59,1,12,0,60,0,"eating protein salty food lunch cause food comas, say new study"
1,1,8,32,0,7,2,40,0,23 leonardo dicaprio face basically
1,1,11,40,0,10,0,51,0,netflix based emoji preference
1,1,11,44,3,10,0,55,0,"high school friendship shape us, according ""paper towns"""
1,3,16,59,6,15,0,75,0,"zaheer-sagarika's love story, lipstick burkha get 'a' certificate ent"
1,1,9,48,1,9,2,57,0,17 picture everyone who's slightly obsessed tea understand
1,1,8,35,0,8,2,43,0,18 thing people live alone never understand
1,1,7,15,0,6,0,22,0,much grinch
1,1,9,42,2,9,2,51,0,"21 time ""harry potter"" accurately described end semester"
1,2,6,35,0,5,0,41,0,waterfall wedding proposal go horribly wrong
1,1,10,32,0,9,0,42,0,dog could chill election
1,1,11,39,1,11,2,50,0,name iconic '90s music video single screencap
1,1,10,36,0,9,0,46,0,cher shuts twitter troll cher way possible
1,1,15,46,0,14,0,61,0,dog kept watch trapped best friend week help arrived
1,1,8,41,2,8,2,49,0,"22 reason need start watching ""outlander"" immediately"
1,1,10,35,0,10,2,45,0,26 funniest thing people said sleep
1,1,7,30,1,6,0,37,0,like jewish christmas
1,1,8,35,2,7,0,43,0,"star war cast member ""star wars"" impersonation"
1,3,5,31,3,4,0,36,0,frozens original ending finally revealed
1,2,0,67,1,12,4,67,0,10 reason mid-20s night completely different teenage clubbing day
1,1,14,50,1,13,0,64,0,couple saved injured squirrel he's living christmas tree
1,1,9,34,0,9,2,43,0,18 powerful science photo month
1,1,10,51,0,10,2,61,0,19 insanely delicious healthy way enjoy gingerbread breakfast
1,1,8,33,0,8,2,41,0,31 decadent apple dessert make swoon
1,1,10,45,0,9,0,55,0,man went snowboarding time square blizzard
1,2,1,54,1,12,2,55,0,right way say 15 brand name mispronouncing time
1,1,12,39,0,12,2,51,0,21 thing happen decide grow short hair
1,1,10,31,0,9,0,41,0,taste french fry say
1,1,11,21,0,8,0,32,0,find best bbq texas
1,2,16,44,1,13,1,60,0,5 thing isros world record launch make proud indian
1,3,11,57,3,11,0,68,0,sessions: improper tax credit payment mostly mexican could fund border wall
1,1,8,24,0,7,2,32,0,20 cat ready af thanksgiving
1,3,12,30,1,11,0,42,0,here day life ed sheeran lookslike
1,1,8,41,0,7,0,49,0,three minute chocolate chip cooky everything
1,1,12,59,0,12,2,71,0,17 beautifully untranslatable hindi word add vocabulary right
1,1,14,41,0,12,0,55,0,pose like jenny mccarthy donnie wahlberg red carpet
1,1,11,39,0,10,0,50,0,guess favorite disney movie based zodiac
1,1,2,17,0,2,2,19,0,10 cheating confession
1,1,10,26,0,9,0,36,0,need talk sexy jared keeso
1,1,9,29,0,9,2,38,0,17 beaver want feminist ally
1,2,3,53,2,11,1,56,0,'game thrones' fan deciphers tiny reflection season 7 promo
1,3,2,74,3,15,0,76,0,"hip hurting? evolved walking four leg standing up, say scientist"
1,3,11,28,1,12,4,39,0,nbc turn 90: look back 42 iconic show
1,1,12,61,1,11,0,73,0,anne hathaway come jennifer lawrence's defense phone scolding incident
1,1,8,31,2,7,0,39,0,"know classic ""star wars"" character"
1,3,8,30,1,8,2,38,0,10 great pop song march might've missed
1,1,7,22,0,6,0,29,0,hell redhead emoji
1,1,11,41,2,11,2,52,0,"29 thing would different ""love actually"" set today"
1,2,3,50,1,8,0,53,0,liberal cheerleading warmongering donald trump?
1,2,1,29,1,8,4,30,0,many celebrity dying 2016?
1,1,16,42,1,13,0,58,0,kfc's colonel sander unicorn either ruin give life
1,3,1,53,3,11,0,54,0,"next time thinking planning quirky first date,"
1,1,10,35,0,9,0,45,0,know disney princess mom wish
1,1,7,23,0,6,0,30,0,couple try make laugh
1,1,13,35,0,12,0,48,0,guess michael scott andy dwyer quote
1,1,8,34,0,9,6,42,0,29 husband crushed whole marriage thing 2015
1,2,7,41,1,7,0,48,0,little kid break opponent's ankle nasty crossover
1,2,8,35,0,9,0,43,0,italian might economic loser era euro
1,3,11,57,2,11,0,68,0,wapo: gun sale dropping except among minority scared trump administration
1,1,11,50,1,10,0,61,0,love actually brings together every fandom ever actually lovely
1,1,16,63,2,13,0,79,0,best joke internet queen elizabeth ii became britain's longest-reigning monarch
1,2,10,37,1,10,2,47,0,seiu budget slashed $90 million union fear trump
1,1,11,42,3,10,0,53,0,"let's take moment appreciate daveed diggs ""hamilton"""
1,2,12,37,3,13,5,49,0,"get paying tax honestly r 14,806"
1,1,7,28,1,7,2,35,0,24 world's insane record attempt
1,1,10,35,1,10,2,45,0,14 thing book nerd relate valentine's day
1,1,5,29,0,4,0,34,0,adult revisit imaginary friend
1,3,14,63,6,13,0,77,0,"gamers angry 'for honor' paywall, ubisoft insists player 'meant unlock everything'"
1,3,1,56,1,12,2,57,0,here's much average family 40 saved retirement
1,1,12,34,1,9,0,46,0,favourite nhl team's logo changed time
1,1,13,42,0,11,0,55,0,guess one direction music video youtube comment
1,1,7,20,0,6,0,27,0,know disney song
1,1,13,39,2,10,0,52,0,"would accepted kkt sorority ""scream queens"""
1,1,16,62,0,15,0,78,0,grandma perfect response finding granddaughter engaged woman
1,1,6,26,0,6,2,32,0,19 thing look exactly like caillou
1,1,10,32,0,9,0,42,0,identify food extreme close
1,1,8,33,3,7,0,41,0,"aziz ansari's ""master none"" nail race perfectly"
1,1,14,38,1,11,0,52,0,fyi: buy stuffed toy favourite indian food
1,3,6,35,4,9,0,41,0,gun n' rose yell 'hello sydney' melbourne crowd
1,1,7,29,0,7,2,36,0,31 iphone game playing already
1,1,12,44,4,11,0,56,0,"remember ""crazy funky junky hat"" ""wizards waverly place"""
1,2,10,51,3,11,0,61,0,stephen colbert perfect 'dumbass' answer kid rock's badass grill
1,1,9,23,0,6,0,32,0,buzzfeed la halloween
1,1,7,29,0,7,2,36,0,19 food never invented
1,1,11,38,0,10,2,49,0,26 time ellen degeneres scared crap famous people
1,3,5,54,0,12,2,59,0,six important question theresa may dodged 17 minute marr show
1,1,10,50,4,9,0,60,0,"hardest ""national lampoon's christmas vacation"" quiz ever take"
1,1,17,51,0,16,0,68,0,mom imagine would look like mom spoke everyone talk kid
1,3,11,52,1,12,0,63,0,sasha obama pretty good reason skipping dad's farewell address
1,1,3,9,0,3,2,12,0,21 dog named bob
1,3,0,21,0,5,6,21,0,100 funny joke 100 comedian
1,1,8,40,1,8,2,48,0,18 unsettling wikipedia page totally freak
1,3,11,40,0,8,0,51,0,opec threatened tiny oklahoma town soaring supply
1,1,12,44,0,11,0,56,0,chillest lizard history animal kingdom
1,1,11,46,0,10,0,57,0,everyone calm canada solved dog pant question
1,2,11,38,0,11,2,49,0,18 documentary leave smile yourface
1,1,11,43,1,11,2,54,0,19 insanely delicious nutella treat blow new year's diet
1,1,11,41,0,10,0,52,0,belle sebastian album listen right
1,1,11,43,0,11,2,54,0,11 animal trying get home thanksgiving via turtle taxi
1,1,12,46,2,10,0,58,0,actually impossible j.lo look anything flawless
1,1,7,25,1,6,2,32,0,10 life-changing thing try october
1,1,11,38,0,10,0,49,0,social network using based mood
1,1,9,34,2,9,2,43,0,"17 thing zac efron wore ""high school musical"" ranked"
1,2,1,28,0,6,0,29,0,sun totally smiling dad
1,3,5,23,2,5,2,28,0,10 private foundation do's don'ts
1,3,9,59,2,9,0,68,0,steven mnuchins defining moment: seizing opportunity financial crisis
1,1,8,38,1,8,2,46,0,16 thing people hawai'i wish mainlanders would stop
1,3,3,76,3,16,0,79,0,"con man lied way princeton. decade later, found squatting mountain shack."
1,1,10,32,2,9,0,42,0,"well remember intro ""danny phantom"""
1,1,19,31,0,13,2,50,0,19 time ab soto slayed ever slay life
1,3,15,63,2,14,0,78,0,remember iconic sequoia tree california could drive through? collapsed!
1,3,4,46,2,8,0,50,0,international women's day: meet granny going school
1,1,10,30,1,9,2,40,0,21 thing non-harry potter fan know true
1,1,10,34,0,10,2,44,0,21 picture prove canada real country
1,1,11,39,0,11,2,50,0,25 reason trip costa rica could actually change life
1,1,15,39,2,15,3,54,0,"spare $400, go ahead spend new year eve olive garden"
1,1,11,42,0,11,2,53,0,15 time musician made really hard concentrate music
1,1,10,45,0,9,0,55,0,magical wizard democratic presidential debate
1,1,11,36,1,10,0,47,0,coloring book need breakup
1,2,11,59,3,10,0,70,0,"reading, writing, required silence: meditation changing school student"
1,1,13,60,1,12,0,73,0,photo indian shortlisted world's biggest photography contest
1,3,2,37,3,10,0,39,0,blind date: met eye
1,1,9,37,0,8,0,46,0,popstars actually wrote song
1,1,9,28,0,8,0,37,0,identify dog breed picture
1,3,2,55,4,12,0,57,0,"black go town, ally-oop gone wrong between-the-legs pas"
1,3,3,32,1,5,0,35,0,russian mystic rasputin murdered?
1,1,6,21,0,6,1,27,0,7 adorable pup met snapchat
1,2,1,41,0,7,0,42,0,best photograph theme empowerment
1,1,8,46,1,6,0,54,0,watch iconic mexican-american beauty look throughout history
1,1,14,59,1,14,3,73,0,"500 storm trooper invade great wall china, star war hype crush global resistance"
1,2,3,60,2,11,6,63,0,"antique roadshow guest discovered family heirloom worth 150,000"
1,1,15,47,0,14,0,62,0,added group chat eight stranger got incredibly weird
1,2,16,62,5,18,4,78,0,"watch e! news season 2016 excerpt free online top duet real-life couples, ranked yahoo view"
1,1,11,45,1,10,0,56,0,zadie smith's productivity tip make focused person
1,2,2,48,0,9,0,50,0,shaq furnishes home atlanta girl survived dog attack
1,1,10,35,0,9,0,45,0,zodiac date based zodiac sign
1,3,8,65,3,11,0,73,0,trump's america donald trump press conference: six question u president-elect
1,3,5,29,0,7,2,34,0,25 powerful passport world
1,3,11,48,2,10,2,59,0,"dieselgate: 13 vw manager indicted around world, big guy unbothered"
1,1,14,37,2,12,0,51,0,fun: story modern-day lynching
1,2,14,57,2,12,2,71,0,bangalore football stadium 12-feet-long snake ball player remain scared
1,1,10,45,0,9,0,55,0,freestyle crossword test knowledge pop culture
1,1,12,42,0,12,2,54,0,23 tweet lawyer trial make laugh loud
1,2,27,28,2,10,0,55,0,#shkrelopoulos: martin shkreli guest star milo uc davis event
1,3,2,54,3,11,0,56,0,creepy nashville get new stalker story line?
1,3,1,59,0,12,0,60,0,horrible tale pantless plane passenger leave tear
1,1,9,35,1,9,2,44,0,many iconic early '00s movie actually seen
1,1,9,45,1,8,0,54,0,five question determine getting married
1,1,9,29,0,9,2,38,0,17 time pop culture gave nod black college
1,1,10,31,0,9,0,41,0,match flame test colour element
1,1,5,26,1,5,2,31,0,10 leftover makeover believe
1,1,9,18,0,7,0,27,0,get puppy
1,1,13,50,1,12,0,63,0,paul walker's daughter found perfect way remember late father
1,1,9,33,0,9,2,42,0,21 adorable thing need pig favorite
1,1,12,37,0,11,0,49,0,know date based favorite dog breed
1,1,5,16,1,5,4,21,0,reminder: life 2001
1,3,12,47,3,11,1,59,0,brexit scotland: indyref2 appears likely uk divorce eu loom
1,1,10,25,1,8,2,35,0,17 diys people can't keep plant alive
1,1,7,17,2,6,0,24,0,"here's draw hand, maybe"
1,1,14,43,0,13,0,57,0,bride shared special wedding dance man saved life
1,2,9,38,0,11,3,47,0,new vaccine could slow disease kill 600 child day
1,1,8,45,0,8,2,53,0,19 prehistoric pendant necklace every dinosaur lover want
1,1,16,37,1,13,0,53,0,woman bffs cut hair turn great
1,3,6,29,0,6,0,35,0,five question ask jamn ibrico
1,2,6,25,0,6,0,31,0,bibi netanyahu make trump chump
1,3,2,69,1,14,0,71,0,biggest company world excited one trump's key economic plan
1,1,11,38,0,9,0,49,0,basically everyone need try working dj khaled
1,3,0,44,0,11,2,44,0,15 skill hard learn pay forever
1,3,1,46,5,8,0,47,0,"high heel row: government response 'a cop-out', say worker"
1,1,6,27,0,5,0,33,0,beauty product named honestly
1,1,11,30,1,12,6,41,0,15 thing 2015 five year ago
1,2,9,45,1,9,0,54,0,sword-wielding man dressed joker arrested virginia
1,1,14,37,2,13,0,51,0,"cast ""made chelsea"" would look like dog"
1,2,2,14,0,5,6,16,0,10 artist watch 2017
1,1,13,37,0,12,0,50,0,sea otter learned use inhaler got asthma
1,2,9,35,0,8,0,44,0,fan grab foul ball barehanded wearing gopro
1,1,6,22,0,7,6,28,0,23 art design enraptured u 2015
1,1,13,40,1,12,0,53,0,girl's secretly dyed hair giving u much life right
1,1,7,22,0,7,2,29,0,22 guaranteed way piss human
1,1,13,37,1,12,0,50,0,woman yoga pet goat almost cute
1,1,8,25,0,7,0,33,0,musical girl group would
1,1,12,34,1,11,0,46,0,"perfect world, would win grammys year"
1,2,4,39,1,7,0,43,0,russia's youtube generation getting news
1,1,8,40,1,8,2,48,0,24 ridiculous sex rumour went around people's school
1,1,14,46,0,13,0,60,0,story reporter killed air taking sundance
1,3,5,31,0,9,0,36,0,emma watson turned la la land
1,1,6,15,0,5,0,21,0,asian squat
1,1,10,36,2,9,0,46,0,thing black people invent
1,3,10,36,6,9,0,46,0,"mccain: trump point, dossier leak totally wrong"
1,1,10,44,0,10,2,54,0,10 mundane thing fall actually terrifying
1,3,3,47,0,11,0,50,0,matter google home identify voice
1,3,9,30,0,9,2,39,0,11 happy little thing make smile week
1,2,7,17,1,6,0,24,0,cold outer space
1,1,12,43,4,10,0,55,0,"rejected love interest ""the o.c."" boyfriend"
1,1,12,34,0,9,0,46,0,remember wwf tag team childhood
1,1,9,19,0,8,6,28,0,18 wtf photoshop fails 2015
1,1,6,41,2,6,2,47,0,"21 ""pocahontas"" tattoo breathtakingly beautiful"
1,3,8,40,0,11,0,48,0,photo tourist barefoot teen going viral
1,3,9,34,1,9,2,43,0,28 thing youll understand alabrador
1,1,8,36,0,8,2,44,0,17 time oprah relatable billionaire ever
1,2,5,55,2,10,4,60,0,golden globe 2017: watch jimmy fallon's star studded opening musical number
1,1,6,23,0,6,2,29,0,26 question cat need answer
1,1,13,31,2,11,0,44,0,take color test see big old dumb-dumb
1,1,7,25,0,7,2,32,0,21 sign raised indiana jones
1,1,14,29,1,12,0,43,0,one r&b song need listen fall
1,1,6,13,1,4,0,19,0,elmo's twitter lit af
1,3,3,35,1,8,0,38,0,ivanka trump brand go here?
1,1,12,49,1,11,0,61,0,kelly rowland's latest instagram pic epitome black girl magic
1,3,8,61,3,10,0,69,0,study: islamic kindergarten lead parallel society extremism austria
1,1,7,33,0,7,2,40,0,17 amazing christmas jumper simply must
1,1,7,33,0,7,2,40,0,21 thing costco food lover understand
1,3,11,43,4,13,0,54,0,haley: one un talking president tweet
1,1,14,52,1,13,0,66,0,mature middle schoolers talk like date middle school
1,2,13,53,3,11,0,66,0,"hollywood agency caa host diversity summit j.j. abrams, kerry washington"
1,1,6,31,0,6,2,37,0,12 chart sephora lover understand
1,3,12,60,1,14,0,72,0,killing kim jong nam: malaysia probe firm north korea sanction violation
1,3,9,52,2,11,0,61,0,"tim raines, jeff bagwell, pudge rodriguez elected baseball hall fame"
1,3,1,44,2,7,0,45,0,"""eraser challenge"" social medium game dangerous kid"
1,1,16,62,1,15,0,78,0,tattoo artist retouched wife's tattoo trans son reflect true identity
1,1,8,22,0,7,0,30,0,queen elsa jack frost
1,1,6,12,2,5,0,18,0,date: guy vs. girl
1,1,11,47,0,10,0,58,0,cara delevingne opened struggle mental illness
1,2,2,38,0,8,0,40,0,u family stranded south side border fence
1,1,6,30,0,5,0,36,0,disney prince male pattern baldness
1,1,9,29,0,10,1,38,0,7 easy way get better making food
1,3,10,46,3,11,3,56,0,rep. gohmert first 100 days: trump big mistake trusting congress
1,3,17,61,1,18,1,78,0,idea vodafone merge form largest operator india 5 major story day
1,3,5,45,2,12,0,50,0,abc news quiz: much remember week was?
1,1,10,41,0,10,2,51,0,25 time billy eichner hilarious person twitter
1,3,9,37,2,8,0,46,0,like inside disney world's new private cabana
1,2,12,44,0,11,0,56,0,twitter turned old photo meryl streep incredible meme
1,1,10,42,0,10,2,52,0,17 picture leave one important question
1,1,4,22,0,5,4,26,0,30 celebrity turning 30 year
1,3,17,53,0,16,0,70,0,wriddhiman saha prof thorn flesh aussie fluent hundred
1,1,10,31,0,10,4,41,0,everyone fell love niall horan 2015
1,1,8,42,1,8,2,50,0,10 insanely delicious cheesecake believe vegan
1,1,12,40,2,12,2,52,0,"16 blind audition ""the voice"" give feel"
1,1,5,21,0,4,0,26,0,american santa try mince pie
1,2,7,27,2,9,6,34,0,25 thing 90 kid said 00s kid wouldnever
1,1,7,27,0,7,2,34,0,17 biggest hoverboard fails time
1,3,7,50,1,7,0,57,0,cartel-linked mexican border governor booted political party
1,2,11,40,1,10,0,51,0,woman sneaking picture rock's butt human goal
1,1,7,35,0,6,0,42,0,leslie knope quote motivational poster
1,2,2,48,1,8,0,50,0,health care could behind canada's longer life expectancy
1,1,15,51,3,12,0,66,0,neil degrasse tyson hilariously shut b.o.b's argument earth flat
1,1,10,41,6,9,0,51,0,"we're halfway election! here's we've, um, learned"
1,3,1,47,0,9,0,48,0,third grader time silly homework nonsense
1,1,12,34,1,11,0,46,0,"umm, turn delhi literally full dick"
1,1,8,22,0,8,2,30,0,21 way forget ex good
1,2,10,60,1,11,0,70,0,report: andrea bocelli running trump inauguration boycott threat
1,2,13,50,1,13,2,63,0,10 reason world must something south sudan's famine right
1,1,10,39,0,10,2,49,0,23 hilarious tweet coffee get every time
1,1,10,42,0,10,2,52,0,20 wonderful local store northwest shop online
1,1,10,37,0,9,0,47,0,match britney spear song album
1,1,6,20,0,5,0,26,0,season best season
1,1,14,44,1,14,1,58,0,"5 step help woman survive horror movie, told malin akerman"
1,1,11,36,0,8,0,47,0,tell difference mac lipstick
1,3,9,37,3,10,0,46,0,visit myanmar capital now! there still lot see
1,3,14,48,2,10,0,62,0,adpvoice: organization stack health benefit spending?
1,3,14,66,3,15,0,80,0,"teen vogue ignores truth trayvon martin shot beating zimmerman, race"
1,3,5,23,0,6,0,28,0,take great vacation photo
1,1,7,37,0,7,2,44,0,23 healthier version favorite holiday treat
1,1,10,32,0,10,2,42,0,13 thing wish knew got period
1,1,10,34,0,10,2,44,0,10 celebrity red carpet look world
1,2,10,49,0,9,0,59,0,brown ot joe thomas troll united airline controversial video
1,2,1,39,0,10,0,40,0,get stained glass look home
1,2,9,46,1,13,2,55,0,pew survey: police support gun right gun control 3 1 margin
1,3,1,13,1,2,0,14,0,sushi healthy?
1,1,7,28,0,7,2,35,0,13 horror game actually scare
1,3,17,65,4,16,0,82,0,"nick young talk kendrick lamar's best album, kobe trashing sneaker origin ""swaggy p"""
1,1,8,22,2,7,0,30,0,gay guy: thought vs. real life
1,3,15,36,3,13,0,51,0,"indian find easier get u green card, here's how."
1,1,13,46,0,12,0,59,0,know disney princess dislike based zodiac
1,1,9,32,1,8,0,41,0,what's funniest tumblr post twin
1,1,9,44,0,9,2,53,0,53 important question internet spider snake
1,3,9,32,2,9,0,41,0,got instagram like kylie kendall?
1,3,10,39,0,9,0,49,0,vine star thriving even platform death
1,1,7,24,0,7,2,31,0,13 spellbooks witch life
1,1,9,29,2,9,2,38,0,"17 time nick ""new girl"" hating people"
1,1,14,46,4,12,0,60,0,"j.k. rowling splitting ""harry potter cursed child"" two play"
1,1,10,42,1,9,0,52,0,food test determine actually maryland
1,1,8,32,2,7,0,40,0,"new series ""serial"" unexpectedly arrived"
1,3,14,47,6,13,0,61,0,george fox news shake-up: feeling mr. oreilly replaceable
1,1,11,39,4,10,0,50,0,"one direction played ""never ever"" got ~scandalous~"
1,1,7,30,0,7,2,37,0,13 halloween decoration got way real
1,1,8,35,2,8,2,43,0,"17 reason brandy black history, present, future"
1,1,11,27,1,10,0,38,0,what's worst thing bug ever done
1,1,20,57,3,17,0,77,0,"ruby rose nina dobrev slated join deepika padukone ""xxx: return xander cage"""
1,1,6,23,0,7,6,29,0,29 time reached peak blackness 2015
1,1,6,16,0,5,0,22,0,many cat catch
1,1,9,44,0,9,2,53,0,32 illustration anyone think woman make badass knight
1,3,7,50,1,8,1,57,0,9 scapegoat progressive blame hillary clinton stunning loss
1,1,6,27,3,5,0,33,0,tell u yourself(ie): taylor kinney
1,1,9,38,0,8,0,47,0,kitten got together cutest playtime ever
1,1,5,27,0,5,2,32,0,19 thing student experienced
1,1,10,36,3,10,2,46,0,"17 time ben h. ""the bachelor"" adorable instagram"
1,1,9,38,2,9,2,47,0,"20 ""game thrones"" question impossible answer"
1,3,18,41,3,14,0,59,0,rnc chair: gop base walk away midterm border wall built
1,1,9,25,3,6,0,34,0,"""ahs: murder house"" character"
1,1,7,25,2,6,0,32,0,"much actually love ""hamilton"""
1,3,5,38,2,8,0,43,0,reality check: million vote illegally us?
1,1,13,32,3,10,0,45,0,"dutch ""killjoys"" kick-ass woman tv"
1,1,10,41,2,10,4,51,0,"artist claim taylor swift stole artwork promote ""1989"""
1,1,11,43,0,11,2,54,0,21 thing everyone grew catholic family understand
1,1,7,22,0,8,6,29,0,16 text 2016 actually dying send
1,3,10,40,0,9,0,50,0,people perfect vision get thesemazes
1,1,11,40,0,10,0,51,0,straight men asked gay men question life sex
1,3,6,52,1,11,0,58,0,searching origin universe earth driest desert
1,1,12,49,0,12,2,61,0,25 product kitchen actually worth spending money
1,2,1,43,3,10,0,44,0,took (and took) retaken penalty time?
1,1,10,37,0,10,2,47,0,27 gorgeous wedding cake almost pretty eat
1,2,10,35,3,12,0,45,0,already magic wand protect fish -- let's use
1,1,11,32,1,11,2,43,0,37 science fact know start year
1,3,3,58,4,11,0,61,0,caused chaos: netanyahus medium war nearly split government
1,1,6,22,0,5,0,28,0,wild way people use placenta
1,1,9,36,2,8,0,45,0,"new ""alice wonderland"" movie look really creepy"
1,3,7,36,3,6,0,43,0,atlantic fake news: fetal heartbeat imaginary
1,1,6,24,0,6,2,30,0,18 hot delicious slow cooker stew
1,1,10,32,2,8,0,42,0,shame amber rose's morning-after game
1,1,8,38,2,7,2,46,0,15 harper lee-inspired tattoo we'll never forget
1,2,6,25,1,5,0,31,0,style minimalist eclectic?
1,1,5,22,0,6,6,27,0,15 mouthwatering recipe try 2016
1,1,8,31,1,8,2,39,0,"meaning life, according 19 normal people"
1,3,6,23,0,5,0,29,0,nba playoff challenge
1,1,10,35,0,8,0,45,0,classic playstation dude take bed
1,3,8,41,3,8,0,49,0,global warming good say president trump science guru
1,1,17,53,3,15,0,70,0,"got's natalia tena play hardest game would rather ""game thrones"" fan"
1,1,8,49,1,7,0,57,0,here's canadian american celebrated thanksgiving
1,3,2,79,1,13,0,81,0,free-range egg crisis prevented government finally agrees farmer let chicken outside
1,1,12,33,0,8,0,45,0,people shared ptsd really look like
1,1,6,27,0,5,0,33,0,grocery store fried chicken taste test
1,3,7,26,0,7,1,33,0,6 honest mistake get fired
1,1,7,36,2,6,0,43,0,"first ""shadowhunters"" footage seriously cool"
1,1,9,48,0,8,0,57,0,friendly reminder smoke detector totally radioactive
1,1,12,43,0,12,2,55,0,19 picture sum absolutely ridiculous finding job
1,2,1,55,1,12,0,56,0,here's fish chip could soon replaced squid chip
1,1,5,22,0,4,0,27,0,show u regrettable tattoo
1,1,11,39,0,10,0,50,0,know favorite dog breed based favorite snack
1,1,8,26,1,6,0,34,0,kale life-changing total disgrace
1,1,8,31,1,7,2,39,0,11 thing ginger really want non-gingers know
1,2,10,59,6,9,0,69,0,"schwarzenegger quits celebrity apprentice one season, cite show baggage"
1,3,2,51,0,12,0,53,0,happens eat potato entire year list
1,1,10,44,0,10,2,54,0,18 time kelly kapoor perfectly captured struggle life
1,3,11,31,0,11,2,42,0,27 thing help take best shower yourlife
1,1,10,38,1,9,0,48,0,taylor swift's music video love interest
1,1,11,38,2,11,2,49,0,"15 thing never knew cast ""pretty little liars"""
1,1,6,26,0,6,2,32,0,11 classic movie line alan rickman
1,1,8,30,0,7,0,38,0,rashida jones defended hot mom twitter
1,1,7,31,1,6,2,38,0,27 low-carb dinner actually delicious
1,3,6,31,3,6,0,37,0,"ferguson effect real, police survey find"
1,1,7,37,0,7,2,44,0,13 perfect gift naughty friend appreciate
1,3,0,31,0,8,2,31,0,10 job make happy rich
1,1,10,43,0,10,2,53,0,17 confession backpacker make laugh loud
1,2,3,44,0,7,0,47,0,deshaun watson allegedly asked leave tuscaloosa bar
1,1,8,39,1,8,2,47,0,40 celebs probably know attended black college
1,3,3,44,1,10,1,47,0,samsung galaxy s8 teardown show easy repair
1,2,10,25,1,8,0,35,0,well actually know usstates?
1,1,8,25,0,8,2,33,0,24 powerful photo week
1,2,9,29,3,9,0,38,0,you. american less sex.
1,1,11,42,0,10,0,53,0,henry cavill asked kid liked batman superman
1,1,9,36,0,8,0,45,0,name movie three screenshots
1,1,12,37,0,11,0,49,0,fucking clue origin meme
1,1,8,22,0,7,0,30,0,get green card america
1,1,10,40,0,9,0,50,0,etsy store sell stylish loungewear geek
1,1,7,30,0,7,2,37,0,13 kanye west quote kid classroom poster
1,2,8,33,1,7,0,41,0,amazon's new credit card primed disrupt retail
1,3,0,36,2,8,1,36,0,7 car-buying tip thatll get best deal
1,1,18,39,3,13,0,57,0,"bet can't name every dwarf ""snow white seven dwarves"""
1,2,10,46,3,10,3,56,0,magna carta: everything need know 800-year-old document
1,1,12,45,1,11,0,57,0,know favorite christmas movie based hungry
1,1,11,35,0,10,0,46,0,day life revealed serial killer
1,1,6,24,0,6,2,30,0,20 reason zendaya flawless queen
1,1,13,43,3,11,0,56,0,"there's place ride falkor ""the neverending story"""
1,1,5,14,0,4,0,19,0,posh fridge
1,2,1,51,1,9,0,52,0,british singer's open letter racist encounter train
1,1,8,37,0,8,2,45,0,14 badass historical woman name daughter
1,3,13,56,2,13,0,69,0,"actress sarah wynter: gop want allow concealed carry blind, mentally ill"
1,1,12,40,4,9,0,52,0,"awesome look behind-the-scenes concept art ""aladdin"""
1,1,8,36,1,8,2,44,0,21 time blue ivy's hair stunted toddler everywhere
1,3,9,36,2,7,0,45,0,amazon third-party seller get ripped hacker
1,1,10,28,0,9,0,38,0,two way look mirror
1,1,9,44,0,8,0,53,0,got eyebrow extension transformation unreal
1,3,8,33,1,7,0,41,0,would eat adorable chocolate baby groot?
1,1,11,46,1,10,0,57,0,name today's hottest canadian celebrity according dad
1,2,13,47,5,12,0,60,0,"ok official! science back saying 'once cheater, always cheater'"
1,1,8,40,2,8,2,48,0,"21 time ""the sims"" gave unrealistic dating expectation"
1,3,20,37,5,12,6,57,0,"fake news: cnn claim gop trying remove $200,000 tax firearm suppressor"
1,2,10,42,1,9,0,52,0,"top beach world, according national geographic"
1,2,8,36,2,8,1,44,0,obama g-7 leaf iraq prime minister abadi hanging
1,1,11,30,0,10,0,41,0,help find halloween costume son
1,1,8,24,0,8,2,32,0,18 adorable dog ready fall
1,3,6,52,0,8,0,58,0,grandmother accidentally knitted something nsfw list
1,1,8,18,0,7,0,26,0,win grammy oscar
1,2,18,61,1,17,0,79,0,"brother kept mocking disturbing sleep, hacked piece full public view"
1,1,7,37,0,7,2,44,0,23 undeniable sign life revolves around fandom
1,3,7,33,1,8,0,40,0,"besieged syria, mother carry added burden"
1,2,3,46,2,11,3,49,0,marketing genius mad man? man sell sneaker $132k
1,1,9,22,2,8,2,31,0,21 thing get vain af
1,2,7,32,2,6,0,39,0,instagram habit like everyone else's?
1,2,2,24,4,5,2,26,0,man behind india's '$74m wedding'
1,2,1,30,0,7,2,31,0,10 valuable brand world
1,1,7,24,1,7,2,31,0,16 people allowed fly
1,1,8,30,0,7,0,38,0,tried condom challenge
1,3,2,52,1,9,0,54,0,one disney popular brand investor really worried
1,3,13,46,4,11,0,59,0,trump's libertarian pal understand fda -- reality
1,3,16,66,6,17,0,82,0,"brzezinski: obama foreign policy seems shaky ever, syria history tragic"
1,1,10,30,2,9,0,40,0,"match ""orphan black"" quote clone"
1,1,11,36,0,10,0,47,0,red dot test determine easily get angry
1,3,4,69,3,11,0,73,0,"wa bushfire contained lives, home threatened gwindinup, south-east bunbury"
1,3,12,38,2,8,0,50,0,twitter seriously lol-ing fbi's holiday message
1,1,8,34,2,8,1,42,0,"5 album cover kanye west consider ""waves"""
1,3,1,53,0,8,0,54,0,online quiz help undocumented immigrant find free legal help
1,2,5,28,1,6,0,33,0,most-loved ceo america
1,2,4,49,1,10,0,53,0,automate me: use gmail template answer email quicker
1,1,9,38,1,7,0,47,0,mcdonald's made happy meal toy thirtysomethings
1,3,14,36,5,13,0,50,0,lana del reys new lust life album: here know far
1,1,13,49,3,13,2,62,0,33 tweet lesbian make wet yourself... laughter
1,2,4,17,1,4,0,21,0,love michelle obama
1,1,12,40,0,12,2,52,0,18 post prove coconut oil answer problem
1,1,13,36,1,12,0,49,0,"adele cut hair short bob, look flawless ever"
1,3,8,35,0,8,2,43,0,23 movie definitely watch breakup
1,2,10,44,1,11,0,54,0,work life balance reality? company make possible
1,1,5,23,0,5,2,28,0,15 mountain climb beginner
1,3,8,50,1,11,2,58,0,18 picture celebrity bridesmaid remind alone
1,1,10,32,0,9,0,42,0,zodiac sign based zodiac sign
1,2,8,27,3,7,0,35,0,chinah share video 'even love' premiere
1,3,1,47,2,9,0,48,0,short film teenage mother pure 'heartbreak'
1,1,14,49,2,13,0,63,0,"""jessica jones"" scene reminder hero story really"
1,1,10,29,0,9,0,39,0,quiz brighten crap day
1,1,6,33,1,6,2,39,0,adorable animal advent calendar: december 10
1,1,10,40,1,10,2,50,0,21 picture accurately describe like alive
1,3,0,24,0,5,6,24,0,17 biggest business story 2016
1,1,11,47,0,10,0,58,0,guess zodiac sign based personal characteristic
1,1,8,29,2,7,0,37,0,"character ""the white queen"""
1,3,3,58,1,14,0,61,0,uk weather latest: snow cold set continue freeze end next week
1,2,5,23,3,7,4,28,0,what's best music video 2016? vote!
1,1,10,37,2,9,2,47,0,31 tweet mcdonald's make laugh every time
1,3,2,40,1,8,3,42,0,5 financial new year resolution people 30
1,1,7,35,0,7,2,42,0,13 climate scientist make optimistic
1,2,10,36,1,10,0,46,0,snape probably still alive fan theory prof
1,1,9,28,0,9,2,37,0,10 anime series need watch die
1,2,1,43,1,8,0,44,0,brainwash using sense smell?
1,2,9,27,1,8,0,36,0,find boner hidden bones?
1,1,11,32,0,10,0,43,0,got aura photographed saw
1,2,4,49,1,13,4,53,0,fox news poll: summer vacation 2016 presidential candidate
1,1,10,42,2,9,0,52,0,"answer tough question ""the princess bride"""
1,1,7,20,0,6,0,27,0,pas texas food test
1,3,4,59,0,14,0,63,0,war planet ape trailer see caesar go battle human
1,1,6,20,0,5,0,26,0,guess festive drink
1,1,11,43,0,10,0,54,0,pinterest account look like right new year
1,3,2,38,0,8,2,40,0,top 15 american city young college grad
1,2,4,62,5,16,0,66,0,new mom flew miami get brazilian butt lift. didnt survive surgery.
1,1,11,40,2,10,0,51,0,"identify ""game thrones"" character eye"
1,1,8,41,0,8,2,49,0,17 depressingly real struggle dating generation text
1,1,13,42,4,12,6,55,0,here's help india's 19-year-old sprinter get 2016 olympics
1,1,14,48,5,12,0,62,0,"black mirror creator david cameron's piggate: ""i try predict this"""
1,1,8,38,0,9,6,46,0,21 thing give early 2000s tweens severe flashback
1,1,6,18,1,8,8,24,0,18 best moment '90s kid 2015
1,1,12,38,0,11,0,50,0,kid explaining love make laugh cry
1,1,13,53,0,12,0,66,0,woman photoshopped stereotypical comic book pose got weird
1,1,13,46,0,13,2,59,0,42 yahoo question make nervous future planet
1,1,7,21,0,7,2,28,0,13 way secretly nap office
1,3,2,75,3,16,0,77,0,came alive moment: watch victorious boy celebrate end chemotherapy
1,3,7,23,0,8,6,30,0,12 important meme of2016
1,3,2,52,2,11,0,54,0,"good news: regular sex benefit mental health,"
1,1,10,36,1,10,2,46,0,25 thing believe people tried sneak plane
1,3,1,53,0,11,0,54,0,basket perfect people want shop solitude
1,1,11,44,2,10,0,55,0,"super hot guy secretly played chewbacca ""the force awakens"""
1,1,11,31,0,10,0,42,0,wish knew went college
1,1,12,36,1,12,1,48,0,well know lyric 5 second summer's song
1,3,4,70,1,15,0,74,0,chicago bulls' memorial former gm hit odd snag wore sleeved jersey
1,1,9,30,3,9,0,39,0,"priest, rabbi, imam discus gay right"
1,1,9,30,0,9,2,39,0,20 sex toy partner actually use
1,2,1,26,1,4,0,27,0,worst fast-food meal sodium
1,1,8,37,0,7,0,45,0,robert pattinson grown humongously bushy beard
1,2,5,24,3,7,0,29,0,what's really weed? cnn video
1,2,7,35,1,6,0,42,0,brilliant italian dish tried
1,3,2,61,4,17,0,63,0,"there's need walk train, live building. come you."
1,3,2,28,0,5,1,30,0,7 iphone photography tip apple
1,3,8,52,3,10,0,60,0,pelosi: tillerson suited revered position secretary state
1,2,13,49,4,15,0,62,0,dont call tesla killer lucid electric car might exactly
1,3,11,49,6,10,2,60,0,"washington post: paul ryan ally alarmed, angered 25-year-old julia hahn"
1,1,7,26,0,6,0,33,0,animal new favorite
1,1,8,22,0,8,1,30,0,5 neon eye makeup look need try
1,1,11,36,0,9,2,47,0,40 reaction gifs guaranteed help deal fuckboys
1,1,7,33,0,6,0,40,0,halloween candy match zodiac sign
1,1,7,23,1,6,2,30,0,43 life-changing book need read
1,1,15,45,0,14,0,60,0,meet male model working help people learn love skin
1,1,8,32,0,7,0,40,0,harry potter spell gibberish
1,1,11,39,0,10,0,50,0,chilaquiles greatest food ever try
1,1,12,38,1,11,0,50,0,what's best thing someone ever done sex
1,1,7,28,0,6,0,35,0,guess favorite disney villain
1,1,11,40,0,11,2,51,0,21 feeling everyone ever stepped foot school know
1,2,8,30,1,6,0,38,0,singular single-malt whiskey born usa
1,1,11,38,2,11,2,49,0,"76 thought starting ""freaks geeks"" first time"
1,1,12,19,0,8,0,31,0,feel like adhd
1,3,8,41,3,8,0,49,0,almost half criminal suspect munich non-germans
1,3,3,74,1,14,0,77,0,gordon ramsay among host michelin-starred chef cook food waste new restaurant
1,1,9,20,0,8,0,29,0,get puppy baby
1,1,8,24,1,6,0,32,0,mean filipino-american
1,3,10,49,1,12,4,59,0,trump slashing obama regulation save $10 billion next 20 year
1,1,12,47,1,11,0,59,0,korean pop star can't stop falling stage performance
1,1,6,24,0,7,6,30,0,19 breakfast changed game 2015
1,1,9,41,2,9,2,50,0,"18 insanely cute gift buy ""your person"" immediately"
1,1,5,18,0,4,0,23,0,percent single
1,2,1,39,1,7,2,40,0,10 christmas food tradition never heard
1,1,10,37,0,9,0,47,0,classic rock band based birthstone
1,1,10,47,0,10,2,57,0,20 ridiculously awesome piece furniture wish could afford
1,1,12,52,3,12,2,64,0,"11 time selena gomez's ""hands myself"" video made question homosexuality"
1,2,17,30,1,8,0,47,0,watch: iranian milo fan confronts protester uc davis
1,2,6,18,1,7,4,24,0,2017 pivotal year k-pop
1,3,10,46,0,9,0,56,0,breakthrough could save ocean harmful oil spill
1,1,7,40,0,7,2,47,0,12 unexpectedly bizarre moment british court case
1,1,10,36,1,10,2,46,0,13 moment understand mexican mom
1,1,8,39,3,7,0,47,0,"ultimate ""american horror story: hotel"" drinking game"
1,1,8,22,0,6,0,30,0,tv character alter ego
1,3,3,71,5,12,0,74,0,chrisette michele defends performing inauguration: cant present silent
1,1,6,26,3,5,0,32,0,tell u yourself(ie): jenny mollen
1,1,9,31,1,9,0,40,0,little girl bulldog become best friend
1,1,12,47,6,11,0,59,0,"make ""harry potter"" hilarious replacing every ""wand"" ""penis"""
1,1,10,41,2,9,0,51,0,"one direction played ""tattoo roulette"" got pretty tense"
1,3,3,66,4,9,0,69,0,fact-checking donald trump lawyer said president-elects finance
1,3,2,79,3,17,0,81,0,cure chocoholics: scientist say need 'imagine forest' want curb craving
1,2,4,40,2,8,0,44,0,"new ""carpool karaoke"" prime time special coming may"
1,2,9,62,5,11,0,71,0,whoopi: trump administration value really much different talibans?
1,2,3,53,0,10,0,56,0,spanish uk resident feared insurance rule would force leave
1,1,11,41,2,11,2,52,0,"13 ""gilmore girls"" storyline fan demand see revival"
1,1,9,30,0,8,0,39,0,need see insanely sexy cartoon lion
1,2,2,36,3,9,0,38,0,carry sexting? thats way help kid
1,2,3,68,0,15,0,71,0,ancient greek memory test help remember left key list
1,3,8,43,1,10,0,51,0,"trump certified president, faith spotted eagle get vote"
1,1,12,36,0,12,2,48,0,18 truth closet hit close home
1,2,2,35,1,4,0,37,0,rupert murdoch's controversial tweet
1,3,8,37,0,8,1,45,0,5 fitness goal even busiest entrepreneur keep
1,2,3,35,0,9,0,38,0,truck blown powerful gust wind u
1,1,18,66,0,17,0,84,0,woman used periscope first time felt like catcalled internet
1,3,2,51,2,7,0,53,0,road discovering britain's eccentric lay-by business
1,2,11,37,1,11,2,48,0,19 picture prove moved far away godslight
1,1,8,34,0,8,2,42,0,21 recipe people obsessed pancake
1,3,17,67,0,16,0,84,0,marathon runner helped competitor finish race winning heart internet
1,1,11,46,0,10,0,57,0,daniel craig rachel weisz set whole new relationship goal
1,1,14,54,3,13,0,68,0,"watch exclusive first trailer zac efron robert de niro's ""dirty grandpa"""
1,2,2,78,5,12,0,80,0,hotel instagramagedon: inside hotel world's jaw-dropping (and photogenic) pool
1,1,10,37,0,10,2,47,0,17 time ryan gosling made almost forget breathe
1,1,8,31,1,8,2,39,0,17 easy weeknight pasta dairy
1,3,1,56,1,9,0,57,0,dastardly college basketball trick play all-time classic
1,1,8,23,0,10,8,31,0,19 viral video 10 year old 2016
1,1,10,48,0,9,0,58,0,chris pratt literally look completely different new beard
1,1,11,44,0,10,0,55,0,mini peanut butter cheesecake epitome food porn
1,1,20,53,0,14,0,73,0,matt mcgorry dascha polanco oitnb reunited emmy people freaked
1,2,9,35,1,9,0,44,0,google found one question cant yet answer
1,2,2,55,1,10,0,57,0,australia brink becoming completely cashless society?
1,3,3,46,5,9,2,49,0,'jeopardy!' champion poke fun warriors' blown 3-1 final lead
1,1,16,42,0,15,0,58,0,asked bunch people define good body happened
1,3,11,29,0,12,6,40,0,27 people failed 2016 even rest ofus
1,1,12,39,0,11,0,51,0,know age favorite pizza based single question
1,1,7,31,0,7,2,38,0,18 thing everyone beard understand
1,3,10,40,1,8,0,50,0,soros group behind massive anti-trump tax day protest plot
1,3,2,46,1,11,0,48,0,"detroit icon dies, hidden good deed come light"
1,1,10,36,0,10,2,46,0,25 incredible greek island need see die
1,1,9,39,4,9,2,48,0,"49 fact probably know ""bridget jones's diary"""
1,1,6,26,0,5,0,32,0,belle literally fucking worst
1,3,4,43,1,12,3,47,0,daily 202: price loyalty trump high rising
1,1,5,16,0,4,0,21,0,miss friend
1,3,5,33,2,7,0,38,0,"crash brothers? steph kd, finding way"
1,2,3,21,1,5,0,24,0,video: spot american
1,1,9,31,0,9,2,40,0,15 people brought laziness whole new level
1,2,5,20,1,5,0,25,0,chef recipe getting fit
1,1,17,59,2,16,0,76,0,help u settle debate that's quietly tearing india apart: bum spray front back
1,3,13,45,3,12,0,58,0,john kerry exit memo claim al-qaeda shadow obama
1,3,8,37,0,8,2,45,0,12 weather climate concept confuse public
1,2,0,67,0,15,2,67,0,21 amazing photo show life like coldest inhabited town earth
1,2,11,27,0,8,0,38,0,everything need know dnc race
1,1,8,27,0,7,0,35,0,seasonal allergy dybbuk
1,1,9,36,0,9,2,45,0,17 french fry creation better boyfriend
1,3,3,48,1,10,0,51,0,would happen donald trump try bring back torture?
1,1,12,47,1,11,0,59,0,niall horan's new glass causing everyone lose damn mind
1,1,13,45,3,11,0,58,0,"we, non-celebs, acted like celebs instagram happened"
1,2,1,65,1,13,0,66,0,"guy hunt space rocks, sell enormous profit collector"
1,2,7,27,2,6,0,34,0,u.s. intelligence got wrong cyber bear
1,1,9,28,1,10,6,37,0,31 thing look like penis 2015
1,2,5,76,1,13,0,81,0,american channel president trump ring becomes mexico biggest wrestling villain
1,1,13,50,0,12,0,63,0,canadian cop giving dad winter driving advice facebook
1,1,7,33,0,7,2,40,0,26 tweet catholic find sinfully funny
1,2,4,46,4,9,0,50,0,pentagon 'lily pad' strategy could increase u.s. troop iraq
1,3,2,18,3,5,8,20,0,africa's top shots: 17-24 march 2017
1,2,10,43,2,10,2,53,0,22 meme understand graduate college
1,3,11,35,0,10,0,46,0,quiz reveal percent old young youare
1,2,5,29,1,6,6,34,0,national signing day 2017: 10 biggest takeaway
1,1,4,17,0,3,0,21,0,thanksgiving
1,1,9,29,0,8,0,38,0,weird food habit growing
1,1,12,36,1,10,0,48,0,new ferrell-themed bar new york city amazing
1,3,2,26,1,4,0,28,0,diesis video ist nicht verfgbar.
1,3,13,47,1,12,0,60,0,soulja boy reveals sad reason he's beefing chris brown
1,2,2,43,3,6,0,45,0,trump presidency: opponent boosted 'rage donation'
1,1,8,26,2,5,0,34,0,"""snl"" character match zodiac"
1,1,15,57,5,14,0,72,0,"david parnes james harris take ""which 'million dollar listing' agent you?"" quiz"
1,3,9,49,2,10,0,58,0,"listen: firework erupt trump, clinton aide clash harvard forum"
1,1,9,27,0,9,2,36,0,19 thing could buy money object
1,1,11,45,0,10,0,56,0,kind relationship deserve based personality
1,2,6,50,1,14,0,56,0,face mlb's steroid era getting closer hall fame
1,2,1,46,1,7,0,47,0,philadelphians reeling city's new sugary drink tax
1,1,6,20,1,5,0,26,0,here's hookup anyone
1,1,9,33,2,9,2,42,0,"16 magical pumpkin ""harry potter"" fan need see"
1,1,13,49,0,12,0,62,0,facebook post lack chennai rain coverage going viral
1,1,13,43,0,13,2,56,0,21 thing need baby hufflepuff ravenclaw
1,2,10,55,2,10,4,65,0,america's richest celebrity 2016: george lucas lead steven spielberg oprah
1,1,13,50,0,12,0,63,0,john krasinski talking much love emily blunt destroy
1,1,15,44,2,13,0,59,0,"actress played cho chang hated hair ""hp"" kiss scene"
1,2,11,59,1,15,5,70,0,"prince tee vivienne westwood, 5 vintage trend making comeback 2017"
1,1,9,32,1,8,0,41,0,really happens girls' bathroom
1,1,6,24,1,5,0,30,0,everyone who's standing kesha
1,2,10,30,4,10,2,40,0,"23 rihanna meme thatll make say me, amrihanna"
1,1,6,24,0,6,4,30,0,coolest product 2015
1,3,10,32,1,5,0,42,0,spdrvoice: get smarter gender intelligence
1,1,6,27,0,6,2,33,0,22 secret zookeepers never tell
1,1,8,31,1,8,2,39,0,13 disturbing picture ever see
1,3,11,72,4,18,2,83,0,"retired builder, 65, knock bizarre upside house despite wife dismissing idea 'crazy'"
1,2,7,39,0,7,0,46,0,jogger give literal answer name spelling question
1,2,5,50,1,12,0,55,0,ashton kutcher blew kiss john mccain lol happening?
1,1,8,40,0,8,2,48,0,16 jackie chan stunt perfectly capture twenty
1,1,13,51,4,12,0,64,0,"""mario bros."" theme song actual lyric they're goddamn inspiration"
1,1,11,33,0,11,2,44,0,32 time lady gaga slayed shit u instagram
1,1,12,37,0,12,2,49,0,17 reason right thing date scorpio
1,1,12,28,1,12,4,40,0,pick new year's cat find 2016 hold
1,3,8,32,4,10,0,40,0,might make right; right does.
1,3,3,62,1,13,0,65,0,secret life father christmas: chat poo request sibling
1,1,10,46,0,9,0,56,0,spicy slow cooker carnitas perfect weeknight dinner
1,3,7,41,4,7,0,48,0,celebrity beg congress obstruct donald trump (video)
1,1,7,31,1,6,0,38,0,complete evolution donald trump's hair
1,1,7,20,1,7,4,27,0,know whether sex 2016
1,2,4,27,0,6,0,31,0,making yoga exercise democracy
1,2,10,39,2,9,0,49,0,new york time release new ad campaign entitled truth
1,3,3,14,0,5,6,17,0,20 best episode 2016
1,3,1,45,1,6,0,46,0,disaster inspired multi-billion dollar business
1,1,13,34,0,12,0,47,0,best photo kid freaking santa
1,1,7,23,0,6,0,30,0,would respond text
1,2,10,41,1,12,0,51,0,middle class enough deserve health care tax break?
1,1,6,14,0,5,0,20,0,wild sex life
1,2,2,43,3,7,0,45,0,democrat worried 'nuclear option'
1,2,13,50,2,15,5,63,0,here's need know budget 2017 5 important story today
1,2,7,42,2,7,0,49,0,gwyneth paltrow offer tip achieving orgasm equality
1,1,11,42,0,11,2,53,0,17 confession dating thirty way real
1,3,4,67,2,15,0,71,0,here's george w. bush trying best figure poncho work inauguration
1,1,14,62,2,13,0,76,0,"adele, jennifer lawrence, emma stone set friendship goal epic proportion"
1,1,13,42,0,12,0,55,0,advice wish someone told got married
1,1,13,51,2,12,0,64,0,"people never seen ""star wars"" guess character name fail adorably"
1,1,6,21,1,6,2,27,0,24 history's epic last word
1,1,12,50,2,11,0,62,0,"remember hogwarts house minor ""harry potter"" character"
1,1,11,51,0,11,2,62,0,19 people thirsty anderson cooper democratic debate
1,1,7,21,0,6,0,28,0,optimist pessimist
1,1,8,27,1,9,5,35,0,19 time fry laurie 100% right life
1,3,9,47,0,9,0,56,0,morning joe stalwart tired hillary clinton blaming others
1,1,6,25,1,7,5,31,0,24 time anna kendrick 100% actually
1,3,4,22,3,5,0,26,0,come adp private payroll ...
1,1,11,43,0,10,0,54,0,public safety reminder throw old singing birthday card
1,3,10,43,2,11,0,53,0,"odell beckham jr. let loose, dance colt mascot pro bowl"
1,3,13,41,2,13,2,54,0,21 picture youll get youve ever blood come yourvagina
1,1,9,31,0,9,2,40,0,15 way work harder actually see result
1,1,13,57,0,12,0,70,0,kerry washington accused cultural appropriation reacted best way
1,3,8,46,1,9,0,54,0,jordan spieth score quadruple bogey masters' opening round
1,3,7,46,0,6,0,53,0,controversial chinese economist uncovering tough truth
1,1,10,36,0,10,2,46,0,23 horrifying old photo keep awake night
1,3,5,83,4,10,0,88,0,"physiotherapy, chiropractic osteopathy: what's difference? featured story additional story"
1,3,13,48,1,13,2,61,0,30 piece lingerie make question even need real clothes
1,3,7,33,2,7,0,40,0,attention span shorter goldfishs?
1,1,5,17,0,4,0,22,0,zodiac sign bagel
1,1,10,38,0,9,0,48,0,color test determine like masturbate
1,1,8,28,0,7,0,36,0,meredith grey izzie stevens
1,2,6,52,2,9,2,58,0,destination #wearenotafraid: 45 reason always love london
1,1,16,63,3,15,0,79,0,"called ""indian piece shit,"" student wrote moving facebook post racism"
1,1,5,13,3,4,0,18,0,"i'm homeless, i'm"
1,1,13,36,0,12,0,49,0,watch kid cry slow motion santa try laugh
1,1,10,35,1,8,2,45,0,17 people who've personally victimized gps
1,1,12,20,3,7,0,32,0,"abc according ""law order: svu"""
1,1,14,60,4,12,0,74,0,"hindu leader protesting ""x-men: apocalypse"" comparing villain lord krishna"
1,3,5,30,2,7,0,35,0,vote: team deserved spot cfp?
1,3,9,32,0,9,2,41,0,20 weird german word way better inenglish
1,2,20,66,3,19,0,86,0,ever wondered what's exact time need sleep wake refreshed morning? here's answer
1,3,3,34,2,8,0,37,0,way out: can't delete mastodon account
1,1,9,47,0,9,2,56,0,27 portrait wes anderson movie beautifully striking
1,1,8,33,1,8,0,41,0,here's kermit miss piggy actually broke
1,2,10,68,3,12,0,78,0,frank gaffney: leader like merkel still scratching head motivation jihadis
1,1,7,29,3,6,0,36,0,"here's halloween ""scream queens"" rule"
1,3,2,29,0,5,0,31,0,adidas finally became cool
1,2,12,71,2,14,0,83,0,"merkel stand migrant policy new year speech, say germany fight terrorism compassion"
1,1,9,39,0,9,2,48,0,34 tweet guaranteed make football fan laugh every time
1,1,11,23,2,8,0,34,0,"belong hogwarts ""ahs"" coven"
1,1,5,26,1,5,2,31,0,16 cute practical valentine's gift
1,2,3,55,2,13,0,58,0,march madness team 'good luck charm' melt heart
1,1,11,39,3,11,2,50,0,"here's cast ""hannah montana"" look like 10 year later"
1,1,12,40,0,11,0,52,0,color test determine friend group
1,2,7,20,0,6,0,27,0,quit working nailsalons
1,2,10,53,0,9,1,63,0,7 fintech company helping millennials dominate finance year
1,2,5,14,0,6,6,19,0,10 best video game 2016
1,1,4,16,0,3,0,20,0,dentist honest
1,1,9,32,0,8,0,41,0,celeb person think look like
1,2,12,49,1,13,2,61,0,20 bollywood celebs received death threat price money stardom
1,1,11,36,1,10,0,47,0,take food test prove real californian
1,1,9,27,1,5,0,36,0,kardashian/jenner bff
1,1,12,37,1,11,0,49,0,guy filmed music video wrist amazing
1,3,5,66,1,15,0,71,0,"see stanford overtook harvard selective college us, one chart"
1,1,13,34,0,12,0,47,0,dudley cow got new prosthetic leg happy
1,3,10,34,1,9,0,44,0,negotiate person play fair
1,1,13,43,1,11,0,56,0,woman stood public blindfolded bikini promote self-love
1,3,14,63,1,13,0,77,0,whistleblower soldier leak video jawan uniform washing senior's personal car
1,1,6,21,0,5,0,27,0,worst cooking fail
1,3,3,29,0,6,0,32,0,rampaging deer caught shopper u
1,3,1,34,0,7,2,35,0,10 effective ad campaign year
1,2,4,69,1,15,0,73,0,"presumably tired picking foreigners, daily mail found new target list"
1,1,8,35,2,8,2,43,0,"22 incredible ""first"" picture history"
1,2,9,44,0,10,6,53,0,19 couple 2016 perfectly nailed whole relationshipthing
1,1,9,35,0,9,2,44,0,17 tumblr post yoda guaranteed make laugh
1,2,9,41,6,8,0,50,0,rosie odonnell urge melania trump: divorce donald flee
1,1,11,25,0,13,10,36,0,37 best street cat 2015 also 2014
1,1,8,33,0,8,2,41,0,19 picture perfectly sum becoming adult
1,1,10,28,2,9,0,38,0,here's phone's storage full
1,1,6,13,3,5,0,19,0,"i'm atheist, i'm"
1,3,4,67,4,13,0,71,0,pristine white littered blue timo liebers arctic photography
1,2,5,42,2,9,0,47,0,secret santas: inside hidden online world st. nick
1,1,7,31,1,7,2,38,0,12 sign relationship
1,1,18,68,1,16,0,86,0,john krasinski awkward night golden globe sitting leonardo dicaprio's table
1,2,10,67,3,13,0,77,0,russian fighter plane intercepting unarmed u.s. jet came within ten foot mid-air collision
1,1,9,45,1,9,2,54,0,21 time renato nicoli sampaio's instagram made beyond thirsty
1,3,14,56,0,12,0,70,0,wedding invitation swachh bharat logo leaf pm narendra modi impressed
1,1,8,30,0,8,2,38,0,24 greatest grad school meme internet
1,3,10,49,1,10,0,59,0,digital immortality: technology bring loved one back life
1,1,10,43,1,10,2,53,0,27 struggle people big boob never understand
1,1,5,34,0,5,2,39,0,17 polite suggestion canadian superheroes
1,1,16,44,4,15,0,60,0,"junior high version ""attack titan"" cute, want eat"
1,1,12,49,3,12,2,61,0,"15 valentine's day gift people love ""making murderer"" attorney"
1,1,17,49,0,16,0,66,0,woman finding high school crush hot new girlfriend u
1,3,3,70,2,12,3,73,0,"logan: fox premiere 40 minute wolverine 3, early reaction overwhelmingly positive"
1,1,10,38,1,8,0,48,0,mini pop-tart recipe awaken childhood soul
1,1,6,32,2,5,0,38,0,millennials work: expectation vs. reality
1,1,11,39,0,10,0,50,0,guess oscar nominated movie short clip
1,3,2,78,1,17,0,80,0,incredible campaigner women's right died might even know name list
1,1,12,39,1,12,2,51,0,17 thing kylie jenner three year ago she'd never
1,1,7,24,1,6,2,31,0,17 life-changing way eat candy cane
1,1,6,20,0,5,0,26,0,badass movie lady
1,1,13,51,0,12,0,64,0,little girl gave grown woman dating advice pretty fantastic
1,3,6,49,4,11,0,55,0,david einhorn's big idea gm winning many investor (gm)
1,1,7,21,0,7,1,28,0,7 easy dinner idea try week
1,3,6,28,3,7,0,34,0,"new detail ""flip flop"" stars' divorce"
1,1,9,42,0,8,0,51,0,still old disney cartoon insanely gorgeous
1,1,7,26,0,6,0,33,0,usher justin timberlake
1,3,9,46,2,9,1,55,0,'unshakeable' tony robbins 5 biggest mistake investor make
1,3,2,50,1,12,0,52,0,shouldnt wear green tie television list
1,2,7,35,0,8,1,42,0,5 way smart assistant transform morning
1,2,1,45,2,10,0,46,0,put party shoe time political hedonism
1,3,2,48,1,12,3,50,0,4 tip help enroll obamacare dec. 15 deadline
1,1,12,40,1,11,2,52,0,23 two-sentence horror story scare hell
1,3,1,33,1,8,4,34,0,best high-paying job every state 2017
1,3,8,61,5,16,0,69,0,taboo star tom hardy provides update mad max: fury road sequel: 'it's matter when'
1,3,11,35,0,11,1,46,0,8 thing science say become little happier
1,1,7,24,2,6,0,31,0,"character ""red oaks"""
1,1,9,45,1,9,2,54,0,24 struggle people eat constantly never understand
1,1,12,45,0,12,1,57,0,9 thing wish someone told relationship twenty
1,3,10,51,3,11,0,61,0,peter schweizer: clinton foundation shell former self two year
1,1,9,37,0,8,0,46,0,trick finally fix god awful hanger strap
1,2,12,41,0,11,0,53,0,people giant cat living house oh mygoodness
1,2,4,38,3,7,0,42,0,"""jurassic world"" us bad science business insider"
1,1,6,17,0,5,0,23,0,drink jammie dodger
1,1,9,36,2,8,0,45,0,"""jessica jones"" character team"
1,1,10,42,0,9,0,52,0,band shot stunning music video entirely smartphones
1,3,3,16,1,2,0,19,0,anti-inauguration
1,1,10,39,0,10,2,49,0,11 time tumblr combined love animal video game
1,1,17,64,2,16,0,81,0,"man named ""phuc dat bich"" posted passport photo facebook banned multiple time"
1,1,15,45,0,14,0,60,0,clip woman swarmed baby otter make day much better
1,1,9,43,0,10,6,52,0,27 reaction definitely 2016 golden globe nomination
1,1,11,50,2,10,0,61,0,"listen incredible isolated vocal david bowie singing ""starman"""
1,1,11,36,1,9,2,47,0,20 buzzfeed article probably ok never finished
1,1,7,21,4,6,0,28,0,"vs. now: cast ""aquamarine"""
1,1,5,14,1,4,0,19,0,"dude, hang"
1,1,7,16,0,6,0,23,0,soup salad
1,3,9,37,3,7,0,46,0,labour mp: russian hacker probably swayed brexit vote
1,1,12,42,0,11,0,54,0,guy totally nailed modern day aladdin would look like
1,1,9,23,2,6,0,32,0,"abc according ""the hunger games"""
1,1,12,37,1,11,0,49,0,cancer survivor lost leg slow
1,3,6,39,1,8,0,45,0,high tempo: assessing pace trump presidency
1,1,10,39,4,9,0,49,0,"kanye west sang ""gold digger"" ""american idol"" audition"
1,3,7,72,2,17,0,79,0,even kid rock look embarrassed what's going picture trump's white house list
1,1,6,19,0,6,1,25,0,7 easy dinner make week
1,3,10,53,6,9,0,63,0,"nyt: fake news backfire breitbart, conservative appropriated term"
1,2,8,36,0,8,2,44,0,23 country feel transgenderrights
1,3,0,23,0,7,2,23,0,20 apps get
1,1,9,26,0,9,2,35,0,17 hot breakfast need warm
1,1,10,42,0,9,2,52,0,22 buzzfeed reader share actually spent snowstorm
1,2,11,46,1,10,0,57,0,"one thing donald trump find underrated, according tweet"
1,2,11,40,1,11,4,51,0,"watch guy play entire 2017 oscars, impression"
1,1,11,42,0,11,2,53,0,31 delightfully weird gift medical nerd life
1,1,9,38,0,8,0,47,0,listen woman talk honestly loving body
1,3,5,27,0,6,0,32,0,medium failed disrupt medium
1,1,13,39,2,12,0,52,0,"sexy calendar anyone ""thing"" redhead men"
1,1,10,43,2,9,0,53,0,"internet decided favourite ""force awakens"" couple"
1,1,9,31,0,8,0,40,0,open letter possible future mass shooter
1,3,10,29,0,8,0,39,0,joe biden strong word betsy devos
1,1,19,41,0,18,0,60,0,carried around sack flour week see would good parent
1,1,5,21,0,4,0,26,0,people try iconic asian snack
1,1,12,38,0,12,2,50,0,guess kind person 10 question
1,1,9,28,1,8,2,37,0,24 tumblr post pop-punk fan laugh
1,1,10,42,0,10,2,52,0,27 perfectly magical gift hermione granger life
1,1,10,37,1,10,2,47,0,23 insanely haunted place scare shit
1,3,2,43,2,6,0,45,0,massively hyped video games: expectation vs. reality
1,1,12,48,0,12,5,60,0,literally 10 photo selena gomez looking flawless z100 jingle ball
1,1,10,42,0,10,2,52,0,32 time scottish twitter funniest place internet
1,2,18,47,8,13,0,65,0,"top chef host padma lakshmi call milo neo-nazi, call berkeley riot victory"
1,1,8,38,2,7,0,46,0,"""dragon ball z"" character realistic proportion"
1,3,1,25,1,3,0,26,0,uganda's enterprising bag lady
1,1,7,22,1,6,0,29,0,working suck
1,1,7,37,2,7,2,44,0,"21 confession obsessed ""high school musical"" fan"
1,2,7,47,1,11,0,54,0,unicef helping child victim peacekeeper sex abuse?
1,1,13,36,0,12,0,49,0,amy schumer thanking smokey eye emmy u
1,2,5,54,1,12,0,59,0,"bill nye tyler, creator dropped hottest theme song ever"
1,1,13,39,0,12,0,52,0,people met pet rat first time lost damn mind
1,1,8,33,1,8,2,41,0,29 celestial accessory moon
1,2,12,66,1,11,0,78,0,"demonetisation illegal, journalist twitter account hacked must read story"
1,3,4,21,2,3,0,25,0,panda wrestle snowman [video]
1,1,10,34,0,10,4,44,0,north west penelope disick best squad 2015
1,1,10,40,0,10,2,50,0,17 street artist bring anarchy instagram feed
1,1,9,36,1,8,0,45,0,here's happened dude tried sanitary pad
1,1,6,40,0,5,0,46,0,income disparity impact romantic relationship
1,3,10,38,0,10,2,48,0,18 act kindness restore faith inhumanity
1,3,10,42,2,11,0,52,0,"nightly news syria crown jewel, aleppo city ruin"
1,1,4,11,0,3,0,15,0,bitchy
1,1,7,21,0,8,6,28,0,13 reason 2015 year period
1,1,8,30,0,7,0,38,0,pumpkin spice product real fake
1,3,1,54,2,13,0,55,0,tough crowd work joke stand-up comedian share tip
1,1,10,40,0,9,0,50,0,pas seriously difficult john green book quiz
1,3,8,67,1,15,0,75,0,"donald trump cause u power collapse, say man correctly predicted fall ussr"
1,3,2,54,2,10,0,56,0,drone footage desert 'super bloom' make frigid thursday
1,1,8,33,0,8,2,41,0,17 hilarious gift parent given kid
1,3,7,55,1,9,0,62,0,iranian musician cancel sxsw performance donald trump's travel ban
1,1,8,27,0,7,0,35,0,much stereotypical person
1,3,4,50,2,7,0,54,0,hungary copying russia targeting soros-backed university?
1,1,7,35,0,7,2,42,0,14 unbelievably rude card dickhead brain
1,3,6,77,2,20,0,83,0,bos dysfunctional dark? bad manager come two form make life misery
1,3,1,37,0,5,0,38,0,gunshot survivor bare photographer
1,1,11,35,3,9,0,46,0,"year's biggest breakout star film, tv, theater"
1,1,8,26,3,7,0,34,0,"we're geeking ""star trek"" news"
1,1,4,23,1,4,1,27,0,7 recipe abuelita's kitchen
1,1,12,37,1,11,0,49,0,know upstate new york based one question
1,1,13,49,0,12,0,62,0,modi keep bizarre thing pose photo child
1,1,9,33,0,8,0,42,0,people try virtual reality porn first time
1,3,12,31,2,11,0,43,0,want surf active volcano? here's
1,1,10,41,0,9,0,51,0,guess favorite holiday question food
1,3,2,36,0,7,0,38,0,truth uninsured rate america
1,3,5,17,2,5,4,22,0,meet riley: 2017 gerber baby!
1,2,5,40,2,8,0,45,0,vote: nfl team disappointing season?
1,1,11,37,0,10,0,48,0,know born based favorite animal
1,1,6,19,0,5,0,25,0,drunk food
1,2,9,28,2,8,0,37,0,solar job they're cracked
1,2,9,48,3,9,0,57,0,former clinton campaign adviser: trump dystopian super villain
1,1,15,48,2,14,0,63,0,"""suite life zack cody"" character based zodiac sign"
1,2,1,41,2,8,0,42,0,here's never deep-fry frozen turkey
1,1,4,14,2,3,0,18,0,"""bro"" really mean"
1,1,9,34,1,7,0,43,0,test determine word-sensitive
1,3,4,82,0,16,0,86,0,british journalist getting lot praise american question trump list
1,1,5,16,1,5,1,21,0,here's 3 way make hummus
1,2,12,67,3,14,0,79,0,juan williams: dems run risk looking like hypocrite accepting election result
1,3,5,54,1,9,0,59,0,alien: covenant prometheus link revealed new cinemacon footage
1,1,7,31,1,7,2,38,0,11 favorite actors' first headshot
1,1,3,11,0,2,0,14,0,emojis word
1,1,14,35,1,11,0,49,0,know hungry based reaction gifs
1,1,10,40,2,10,2,50,0,"25 question ""harry potter cursed child"" need answer"
1,3,11,42,1,12,0,53,0,michelle obama get leaf white house?
1,1,11,43,0,10,0,54,0,ridiculous rumour went around school
1,2,5,21,1,5,0,26,0,america best state live
1,1,9,31,0,9,2,40,0,28 essential item every guy need fall
1,1,10,40,1,9,2,50,0,23 confession short guy prove body-shaming real
1,1,10,42,1,10,2,52,0,15 people legitimately believe they're part jedi order
1,1,9,30,0,9,2,39,0,30 thing might know emilie de ravin
1,2,7,67,1,12,0,74,0,no-show prince william prince harry traditional christmas eve football match
1,1,7,31,0,7,2,38,0,19 thing true carb lover understand
1,1,8,35,1,7,0,43,0,said it: daenerys targaryen cersei lannister
1,3,2,29,2,5,0,31,0,'mother' ganges becomes legal person
1,2,1,63,3,13,0,64,0,sears bigger problem plunging sale nobody's talking
1,1,12,54,3,11,0,66,0,"what's unluckiest, weirdest stupidest way failed driving test"
1,2,1,43,1,10,0,44,0,help world's ocean stay pure clean
1,1,14,51,3,13,0,65,0,"first trailer ""captain america: civil war"" finally destroy"
1,3,10,39,2,9,0,49,0,here womens march organizer want happennext
1,1,7,33,0,7,2,40,0,31 terrifying horror film stream october
1,1,11,39,0,10,0,50,0,know thanksgiving side based zodiac
1,2,14,37,3,11,0,51,0,pretend order in-n-out well reveal
1,1,7,27,2,6,2,34,0,22 sign middle-aged time
1,1,11,36,1,10,2,47,0,17 last-minute super bowl recipe need life
1,1,9,26,1,8,0,35,0,someone's tickling
1,1,11,38,0,10,0,49,0,anna kendrick tweet based zodiac sign
1,2,9,39,1,9,0,48,0,beauty trend youre going see everywhere fall
1,2,2,66,3,10,0,68,0,"dramatic testimony, witness describes pa. trooper's dying moment ambush"
1,1,8,31,1,7,0,39,0,there's new taylor swift meme sweeping tumblr
1,1,7,25,0,6,0,32,0,woman friend
1,3,8,31,0,7,0,39,0,colour test reveal currentmood
1,1,11,43,0,11,2,54,0,14 time tumblr little accurate hogwarts house
1,2,12,38,1,9,1,50,0,promo: 5 essential tech addition holiday travel gear
1,1,6,25,0,5,0,31,0,disney princess lived canada
1,2,9,31,0,8,0,40,0,cannot get surreal hiddenbeach
1,1,10,41,0,9,0,51,0,real guide finding hairstyle flatters face
1,1,12,38,4,12,0,50,0,"year years' cover ""toxic"" dancing seat"
1,3,6,84,5,17,0,90,0,'like scene jurassic park': massive alligator 'humpback' stroll past stunned tourist florida park
1,1,8,35,0,7,0,43,0,floating bonsai tree look like actual magic
1,3,17,70,2,16,0,87,0,"meet wheelchair bound harman sidhu, man behind supreme court order liquor ban along highway"
1,1,10,37,0,10,2,47,0,21 hilarious thing people done high
1,2,9,30,0,8,0,39,0,pancake never come fluffy
1,1,9,26,1,8,0,35,0,what's best way flirt social medium
1,2,8,59,2,10,0,67,0,german purchase illegal gun grenade defend migrant
1,3,5,31,2,7,0,36,0,here's china see iran business insider
1,3,2,30,1,7,1,32,0,guy faced america's top 5 fear
1,1,8,38,0,8,2,46,0,15 insanely delicious pumpkin beverage try fall
1,1,8,16,2,5,2,24,0,17 life-changing way eat pb&j
1,2,1,49,0,7,0,50,0,opening movie title sequence pure masterpiece
1,2,7,45,1,9,0,52,0,obamas final interview president air history channel
1,1,14,29,1,12,1,43,0,$1 usd get food around world
1,1,9,26,0,9,2,35,0,24 people truly born job
1,1,18,41,0,18,1,59,0,mom chef cook see make better dish 2 kid judge
1,3,7,43,3,7,0,50,0,kasich: completely getting rid obamacare acceptable
1,3,4,42,3,10,1,46,0,7 detail may missed sunday's 'the walking dead'
1,1,8,39,0,8,2,47,0,21 moment actually appreciate little thing
1,3,14,54,2,12,0,68,0,gap internationalvoice: vision results: lead growth company
1,3,14,48,1,13,0,62,0,"star war shopkins, hottest toy holiday season"
1,2,9,30,2,8,0,39,0,"new england cant lose, make hater crazy"
1,1,9,32,1,7,0,41,0,asked people self-care routine
1,2,2,47,0,10,0,49,0,smart way think trade deficit mexico
1,1,9,21,2,8,6,30,0,"59 time celebrity made go ""wtf"" 2015"
1,3,7,23,0,7,2,30,0,17 sign totally caffeinemom
1,1,9,30,0,9,2,39,0,19 picture prove kid better u
1,1,9,45,0,8,0,54,0,couple met online revisit first conversation
1,1,6,25,0,5,0,31,0,ranch really go everything
1,1,12,36,0,11,0,48,0,could last day messiest party earth
1,1,8,35,3,7,0,43,0,"ashley salter, bachelor's onion queen, engaged"
1,3,18,65,0,17,0,83,0,school cute way telling student wear uniform gender identifywith
1,1,11,38,3,11,1,49,0,"7 essay read: superhero, sex shops, black genius"
1,1,13,57,2,11,0,70,0,"leonardo dicaprio almost saved ""star wars"" prequels playing anakin skywalker"
1,2,2,61,1,12,0,63,0,shark never sleep: scarier thing beach shark attack
1,1,11,31,3,10,0,42,0,"finn poe ""star wars: force awakens"""
1,2,3,55,2,9,0,58,0,accidental tom hardy lookalike 'gutted' meeting
1,1,9,29,0,9,2,38,0,23 thing buy one weirdo love winter
1,3,8,27,0,9,6,35,0,11 cutest couple 2017 goldenglobes
1,1,13,46,0,11,2,59,0,32 amazing diy costume prove halloween actually meant teen
1,2,9,24,3,7,0,33,0,"warm-hearted cold, hardbitch?"
1,3,12,59,6,12,0,71,0,liberal celebrate knockout weak white b**ch ronda rousey white privilege
1,1,11,44,0,11,2,55,0,10 swoonworthy recipe seem fancy actually easy make
1,1,17,42,0,14,0,59,0,uzo aduba attended sag award guy went prom
1,1,6,31,0,5,0,37,0,couple honestly updated facebook
1,3,8,37,1,10,0,45,0,church norway split state new year day
1,1,9,27,1,9,2,36,0,17 celebs prove long hair way
1,3,5,22,0,5,0,27,0,get child good dirty
1,2,15,71,1,15,0,86,0,"woman detained dfw airport allegedly smuggling raw animal brains, animal part luggage"
1,3,3,56,2,10,0,59,0,dreaming frugal christmas? meet people whove stopped shopping
1,1,8,26,1,7,2,34,0,22 thing non-baby people relate
1,2,7,22,0,7,1,29,0,5 smart way spend tax refund
1,1,6,22,0,5,0,28,0,intensely long island
1,1,8,45,1,9,4,53,0,10 celebrity look exactly like '00s disney channel character
1,1,6,28,0,5,0,34,0,kardashians wrote greeting card
1,1,17,51,0,16,0,68,0,worst time year patient polite man internet begun
1,1,9,35,0,9,2,44,0,14 drink lindsey graham would drink oval office
1,1,12,44,2,11,0,56,0,"new trailer ""orange new black"" look seriously intense"
1,2,9,23,6,8,0,32,0,watch: snl pay tribute obama dont go!
1,1,6,23,0,5,0,29,0,ultimate bob dylan trivia quiz
1,3,7,31,3,9,6,38,0,"19 post prove tumblr 50% batshit, 50% wonderful"
1,1,9,49,0,9,2,58,0,14 time mindy lahiri perfectly described relationship food
1,2,2,44,3,11,0,46,0,woman film: still man's world behind camera?
1,1,13,41,4,12,0,54,0,"poll: scariest character ""are afraid dark?"""
1,1,12,44,0,12,4,56,0,know 2015 album best represents year based one question
1,2,2,44,4,11,2,46,0,gallery britain's 20 'crap' town love
1,1,5,17,0,4,0,22,0,girl instagram
1,2,8,18,0,5,0,26,0,espn super bowl li expert pick
1,2,3,49,2,8,0,52,0,sumo's next superstars? mongolia wrestling powerhouse
1,1,13,42,1,12,0,55,0,never forget hilary duff sucked dude's thumb music video
1,2,4,49,2,11,4,53,0,"nears 2016 bid, louisiana bobby jindal hit political bottom"
1,1,7,31,1,7,2,38,0,17 kid messing around christmas
1,1,5,19,0,4,0,24,0,intuitive really
1,1,10,51,1,9,0,61,0,"julianne moore cry time square, make tourist uncomfortable"
1,2,12,45,0,12,4,57,0,passion 2017 world baseball classic help fuel future mlb need
1,2,10,19,0,8,1,29,0,5 easy diy tip really need totry
1,1,10,40,0,10,2,50,0,17 time spencer boldman perfect man instagram
1,2,9,50,1,10,0,59,0,"untested developer picked wrong time, wrong place wrong neighbor"
1,1,8,36,0,8,2,44,0,15 thing everyone great memory understand
1,2,3,52,1,8,0,55,0,zhou yongkang trial expose chinese officials' link mystic
1,1,9,35,1,8,2,44,0,19 absolutely stunning make-up look try autumn
1,1,7,29,1,7,2,36,0,29 thing need mysteriously evil
1,1,9,35,4,6,0,44,0,here's lonely sister-in-law's newest christmas card
1,1,9,27,2,8,0,36,0,poll: what's best karaoke song time
1,2,13,54,4,21,12,67,0,"13 thing know chart week: ed sheeran no. 1 artist 100, hot 100 billboard 200"
1,1,13,45,0,13,2,58,0,15 chill as bedroom make want sleep alarm
1,2,4,9,0,2,4,13,0,nhl valuation 2016
1,3,2,50,1,11,0,52,0,much country debt rest shoulder list
1,1,11,45,0,11,2,56,0,11 question never ask someone long term relationship
1,1,8,31,1,9,4,39,0,29 toy every '90s boy secretly wish still
1,1,9,43,0,9,2,52,0,22 completely bizarre part people school nativity play
1,1,11,32,0,10,0,43,0,first song danced wedding
1,1,7,41,0,7,2,48,0,18 undeniable thing filipino christmas season
1,1,7,27,1,8,5,34,0,watch 80 year women's eyewear 120 second
1,3,8,37,1,8,2,45,0,35 gift wanderlust-obsessed person yourlife
1,1,10,33,0,10,2,43,0,22 thing every guy start losing hair
1,1,9,25,0,9,2,34,0,21 dog book cute word
1,2,9,72,2,16,0,81,0,diabolical teen choice awards? look happened one direction zayn malik.
1,1,9,28,0,8,0,37,0,choice spiral say
1,3,5,14,0,7,8,19,0,16 meme turn 10 in2017
1,3,3,71,0,12,0,74,0,device dramatically improve wifi signal speed throughout home
1,1,14,45,0,13,0,59,0,tell u tiny wonderful thing thankful year
1,1,9,35,4,8,0,44,0,"would rather: ""star wars: force awakens"" edition"
1,1,12,38,3,11,0,50,0,halle berry's worst (but also best) red carpet look ever
1,1,7,32,1,6,0,39,0,here's real reason pirate wore eyepatch
1,1,10,26,0,9,2,36,0,30 sport movie get pumped af
1,1,14,52,0,13,0,66,0,guess whether celebrity cooking show
1,1,15,35,0,10,0,50,0,puerto rico opened dress code lgbtq student
1,2,1,20,0,4,0,21,0,woman world united
1,1,7,15,0,6,0,22,0,fox hound
1,1,6,26,1,5,0,32,0,"hallelujah, gigi hadid single"
1,2,1,41,2,10,1,42,0,9 apocalyptic movie get mood 'logan'
1,3,3,57,4,15,6,60,0,"oscar 2017: 10 thing need know, epic mix-up viola davis speech"
1,1,9,36,2,8,0,45,0,"two ""supernatural"" brother hottest"
1,1,8,40,1,8,2,48,0,18 reason disney's prince philip deserves damn credit
1,1,10,39,0,9,0,49,0,iphone colour say sex preference
1,1,6,33,1,6,1,39,0,adorable animal advent calendar: december 3
1,1,9,38,1,8,0,47,0,let's real people definitely banging hogwarts
1,2,17,41,3,11,0,58,0,plus-size guy tried asos new plus-size line men totallyslayed
1,1,10,31,1,9,2,41,0,22 genius running hack cold af outside
1,1,9,27,0,7,2,36,0,19 amazing diy gift look expensive
1,2,8,35,0,7,0,43,0,bionic leaf make fertilizer sunlight air
1,3,3,45,2,8,2,48,0,sources: 49ers plan offer kyle shanahan head-coaching job
1,1,9,25,0,9,2,34,0,31 cat want watch world burn
1,1,11,47,0,10,0,58,0,starbucks frappuccino try based zodiac sign
1,1,15,44,0,14,2,59,0,13 swoonworthy tv wedding vow want steal big day
1,1,7,29,2,7,2,36,0,40 yankee candle we're really glad exist
1,1,20,60,0,19,0,80,0,photo trauma nurse cuddling son work going viral right reason
1,1,14,42,0,14,2,56,0,36 photo italy fifty make want time travel
1,3,5,30,0,6,0,35,0,wrestlemania story collide ring
1,2,9,29,3,9,2,38,0,"19 picture make stoner say wow,yup"
1,1,10,30,0,9,0,40,0,learned celebrate eid al adha america
1,1,10,45,2,10,2,55,0,19 word actually understand unless long island
1,1,13,40,4,10,0,53,0,"rachel green ""friends"" appeared ""snl"" everything"
1,3,1,48,0,11,0,49,0,sleep doctor reveals fall asleep faster
1,2,2,44,0,7,0,46,0,afghan restaurant run domestic abuse survivor
1,1,14,37,0,10,0,51,0,internet think anime bad photoshop beat isi
1,1,14,44,2,12,0,58,0,time u realize leonardo dicaprio need oscar
1,3,3,13,1,2,0,16,0,successful?
1,1,8,23,2,7,0,31,0,"would ""star wars"" porn name"
1,1,11,38,0,10,0,49,0,hilariously accurate guide dog owner new york city
1,3,1,31,2,6,4,32,0,11 skill every 24-year-old learn
1,3,17,44,1,15,1,61,0,pm modi queen elizabeth ii get watch baahubali 2 us!
1,2,4,50,0,12,0,54,0,teen crashed bmw find honesty best policy
1,3,3,44,1,8,0,47,0,french election: getting estate vote marseille
1,1,6,32,1,7,2,38,0,26 struggle english scottish couple face
1,3,9,32,1,8,2,41,0,27 weird af kitchen product didnt knowexisted
1,2,3,34,0,7,0,37,0,apple reveals new music app rival spotify
1,1,8,37,1,7,0,45,0,valentine's day anthem match birth month
1,3,1,40,3,5,0,41,0,italian woman 'returns mixed-race surrogate baby'
1,1,10,32,0,10,2,42,0,55 picture inspire layer fall
1,2,11,55,1,12,0,66,0,investigation fbi's handling clinton email probe explained
1,2,14,62,3,12,1,76,0,"teenager chop 8-year-old schoolmate pieces, throw heart inside school revenge"
1,1,7,45,0,7,2,52,0,21 fearful confession people entering new relationship
1,1,14,48,7,13,0,62,0,"tiffany ""new york"" pollard's reaction david bowie's passing is... one kind"
1,1,12,33,0,10,2,45,0,32 thing happen bff also soulmate
1,2,12,58,0,11,0,70,0,kit harington judging jon snow impersonator better winter finally coming
1,3,16,55,3,13,0,71,0,nasa astronaut enough spacesuit wear astronomical problem!
1,3,14,47,2,13,0,61,0,everything wanted know sex therapy (but afraid ask)
1,1,15,49,1,14,0,64,0,asked married couple try other's hobby happened
1,1,9,41,1,8,0,50,0,here's actually happens start lifting weight
1,1,13,47,3,12,0,60,0,"here's everything need know ""star wars"" three minute"
1,1,16,51,2,14,2,67,0,30-year-old man change email address name taylor swift
1,3,2,59,1,12,0,61,0,tina fey message college-educated white woman voted
1,1,12,33,2,11,0,45,0,"well remember ""i know last summer"""
1,2,8,41,2,8,0,49,0,famous celebrity pet account instagram [video]
1,1,9,35,0,9,2,44,0,22 tweet band actually make laugh
1,3,12,30,3,10,0,42,0,"irs annual report card in, isnt pretty"
1,1,13,47,1,12,2,60,0,17 real-life confession taxi driver give many feel
1,1,10,38,1,9,0,48,0,celebrity's twitter bio based zodiac
1,1,8,26,0,7,0,34,0,apple spice pumpkin spice
1,1,8,34,1,8,2,42,0,29 people clearly understand food work
1,1,8,29,1,6,0,37,0,non-prince disney guy soulmate
1,1,11,36,0,10,0,47,0,everyone want wear cat ear halloween
1,1,4,27,0,4,2,31,0,11 horrifyingly cute halloween emojis
1,1,8,38,0,7,0,46,0,surprised kid dream christmas present
1,1,12,30,2,11,0,42,0,"guy epic ""cha cha slide"" dance ever"
1,3,4,34,3,7,1,38,0,"round 1 takeaways: qb heists, brown lament,"
1,1,10,38,1,10,2,48,0,21 store love addicted urban outfitter
1,1,13,48,0,12,0,61,0,story behind dog lost ear heartbreaking inspiring
1,3,4,39,4,9,0,43,0,jeb bush trump: stop saying thing arent true
1,1,6,33,0,5,0,39,0,crossword audiophiles everywhere
1,1,12,47,2,11,2,59,0,20 cavity-inducing snack beg mom elementary school
1,1,6,35,0,6,2,41,0,20 startling boob confession everyone see
1,2,5,72,4,17,0,77,0,gran can: reckon old get fit? middle-aged woman make think
1,1,9,35,0,9,2,44,0,29 incredibly delicious way eat egg every meal
1,1,10,48,2,9,0,58,0,st. vincent waitressed sister's dallas restaurant weekend
1,2,7,38,2,9,2,45,0,donald trump's tweet reimagined early '00s emo song
1,3,6,48,2,9,0,54,0,fatherly advice: kris bryant's dad suggestion lavar ball
1,3,4,55,1,9,0,59,0,trump could learn george washington first executive order
1,1,9,37,3,8,0,46,0,"hardest ""harry potter"" spelling test ever take"
1,3,4,49,2,8,0,53,0,amazon change name westminster tube station 'webminster'
1,1,9,39,1,8,0,48,0,what's one literary magazine everyone need life
1,1,10,45,0,11,2,55,0,23 cheap upgrade actually increase value home
1,3,12,53,3,11,0,65,0,hillary clinton defies trump immigration restrictions:
1,1,10,31,0,10,2,41,0,19 reason costco could ever want need
1,1,6,18,0,5,0,24,0,well actually see
1,1,7,30,0,6,0,37,0,combination hogwarts house
1,1,13,48,0,12,0,61,0,five question test determine world live
1,1,6,19,0,7,6,25,0,18 best play musical 2015
1,1,13,28,2,12,0,41,0,(and why) man lived car year
1,1,17,41,1,15,0,58,0,wore crop top week plus-size woman happened
1,1,10,40,1,10,2,50,0,19 hilarious tweet god make laugh every time
1,3,13,52,1,12,0,65,0,gauri khan share first glimpse ranbir kapoor's swanky new bachelor pad
1,1,10,23,1,10,4,33,0,emo teen's life like 2006
1,2,14,65,5,13,0,79,0,amy schumer netflix special flooded one-star reviews: ive migraine funnier
1,3,6,25,4,7,0,31,0,daily: story bashar al-assad
1,3,16,37,3,13,0,53,0,"lol wow, people absolute ""how bow dah""meme"
1,2,4,62,3,13,2,66,0,wrote rachel dolezal headline. 14 others youll probably read today.
1,3,18,60,6,13,0,78,0,"bamn organizer yvette felarca: fascist milo starting movement genocide, must stopped"
1,1,8,32,1,7,0,40,0,hardest weasley family quiz ever take
1,2,15,51,0,10,0,66,0,uc berkeley investigates alleged employee assaulted milo fan riot
1,3,11,39,0,10,0,50,0,chris pratt handle body shamers chris pratt way
1,1,10,30,0,10,2,40,0,19 reason low power mode best thing ever
1,1,12,33,1,13,4,45,0,19 thing '00s girl grew rom coms relate
1,1,5,25,0,4,0,30,0,celebrity share height
1,3,4,64,1,12,0,68,0,gorgeous pool swim around world business insider deutschland
1,3,3,21,0,5,0,24,0,ford got right trump
1,1,7,28,0,7,2,35,0,15 thing marwaris tired hearing
1,1,10,32,0,9,0,42,0,woman using dead fish makeup accessory
1,1,3,16,0,3,2,19,0,16 taylor swift pumpkin
1,1,10,54,5,8,0,64,0,"vanessa hudgens' heart-wrenching performance ""grease: live"" wowed everyone"
1,1,11,39,1,10,0,50,0,read wikipedia page want sleep tonight
1,3,12,31,3,12,5,43,0,21 thing 100% happen move s.o.
1,1,13,50,0,12,0,63,0,disney couple significant based zodiac
1,3,11,56,2,12,0,67,0,krauthammer explains dems skipping inauguration 'not good sign' insider
1,1,10,40,0,10,2,50,0,17 impossibly tiny glass make feel crazy fancy
1,3,10,21,0,10,6,31,0,16 tv show thankful in2016
1,3,2,48,3,11,0,50,0,"""basic economy"" airline fare save money, come cost"
1,1,7,30,3,6,2,37,0,17 problem understand tall-ish
1,1,13,44,2,13,2,57,0,"17 compelling reason crush brett dier ""jane virgin"""
1,1,8,43,0,8,2,51,0,19 eggless breakfast actually healthy delicious
1,1,6,19,0,7,6,25,0,17 beauty hack try 2016
1,1,12,42,2,11,0,54,0,"vine new york ""celebrity big brother"" fucking perfect"
1,1,10,32,0,9,0,42,0,every star war fan need see disneyland
1,3,2,45,2,13,4,47,0,best 2016: get dose best feel-good story year
1,1,10,29,0,9,0,39,0,fact may know day history
1,1,12,51,0,11,0,63,0,couple proof anonymous commenters terrible people
1,2,5,55,3,11,0,60,0,snowden file 'read russia china': five question uk government
1,1,8,26,0,9,6,34,0,16 young indian watch 2016
1,1,8,15,0,6,0,23,0,well know ya book
1,1,9,34,1,8,0,43,0,tell u funniest reason skipped workout
1,1,5,21,0,4,0,26,0,believer play ouija board
1,1,11,44,2,10,2,55,0,19 cringe-worthy audition horror story ever hear
1,3,7,39,2,7,0,46,0,amazing prom dress frustrated curvy girl [video]
1,1,11,45,2,10,0,56,0,"""breaking bad"" character soulmate based zodiac"
1,1,8,35,1,7,2,43,0,34 movie-inspired cake film fan appreciate
1,1,12,43,0,11,0,55,0,mancan wine exists masculinity fragile fuck
1,3,9,22,1,6,0,31,0,cia secret history nowonline
1,1,10,45,3,9,0,55,0,"hogwarts house ""grey's anatomy"" character belong"
1,3,13,33,1,12,0,46,0,warrior ii: yoga pose tone butt
1,3,6,39,1,7,4,45,0,flashback: chuck schumer considered refugee pause 2015
1,1,10,39,0,10,2,49,0,19 way throw kid ultimate birthday disneyland
1,2,11,54,2,13,3,65,0,child used sleeping mother's fingerprint buy $250 worth pokemon gear
1,1,4,13,0,4,2,17,0,22 best adele meme
1,1,6,25,0,6,2,31,0,54 absolute worst thing fall
1,2,10,42,0,9,0,52,0,nicki minaj post joking pregnancy photo twitter loses
1,1,4,21,2,3,0,25,0,"please stop saying ""literally"""
1,1,10,39,1,9,0,49,0,busy philipps' elf shelf creation absolute genius
1,1,5,13,0,4,0,18,0,chill
1,1,9,33,0,9,2,42,0,27 reason watch local news often
1,1,6,23,0,6,2,29,0,12 creative way use selfie stick
1,1,12,46,0,11,0,58,0,mainland europe better christmas everyone else
1,3,1,47,0,7,0,48,0,drunk pilot face prison sentence pleading guilty
1,1,5,12,2,4,0,17,0,i'm asexual i'm
1,1,10,36,0,9,0,46,0,one question determine dirty mind
1,2,3,46,2,10,0,49,0,fiery reaction crazy 'game thrones' twist
1,3,8,33,1,8,4,41,0,2017 ncaa tournament: top nba draft prospect watch
1,1,10,45,0,10,2,55,0,15 people personally victimized winter salt stain
1,1,16,45,0,15,0,61,0,competed make best pizza wolfgang puck total mess
1,2,13,63,2,15,4,76,0,"walter cronkite award dub jake tapper, jorge ramos, katy tur best reporter 2016 election"
1,1,10,30,0,8,0,40,0,image hiv affect life around world
1,3,3,58,0,9,0,61,0,redditor trolling conservative sneaky website
1,1,9,30,0,8,0,39,0,asked food stylist review cheap burger
1,1,7,29,2,6,0,36,0,"character ""the blacklist"""
1,1,9,39,2,9,2,48,0,here's 12 celebrity look like drake's beard
1,3,9,28,1,8,0,37,0,talk mahershala ali aminute?
1,3,7,34,3,7,0,41,0,volkswagens diesel scandal: charged?
1,1,14,45,1,13,0,59,0,guess get married year based favorite emoji
1,1,7,26,0,5,0,33,0,gaston lefou probably fucking
1,1,9,22,0,8,0,31,0,woman try diva cup first time
1,1,9,32,1,10,5,41,0,15 thing people 100% sure kid
1,1,8,29,0,8,2,37,0,23 type hummus guaranteed blow mind
1,1,8,25,0,8,2,33,0,17 bunny sad people
1,1,9,30,0,7,2,39,0,19 popsicle stick diys actually awesome
1,2,11,41,2,11,0,52,0,equal pay day reminds u gender wage gap myth persists
1,2,6,20,0,6,0,26,0,hate tax
1,1,9,30,2,10,4,39,0,15 song loved (but forgot about) 10 year ago
1,1,14,44,1,13,0,58,0,donald trump vs. bernie sander debate might ever get see
1,3,12,58,2,13,1,70,0,"report: hillary, 6 aide access classified state dept info leaving office"
1,2,11,52,1,11,0,63,0,poll: half college student believe student loan forgiven
1,1,10,38,4,9,0,48,0,"hardest ""america's next top model"" quiz take today"
1,1,12,35,1,12,2,47,0,17 thing need know meet new bae's kid
1,1,9,27,0,9,2,36,0,28 kid whose future burn bright sun
1,3,2,51,0,10,2,53,0,gun killing fell 40 percent connecticut passed law
1,1,10,36,1,10,2,46,0,17 geography pun bad they're kind wonderful
1,2,10,50,1,9,0,60,0,behind scene bloomberg businessweek's epic explanation code
1,2,10,32,2,9,0,42,0,"year on, answer probe prince's death"
1,1,14,40,0,13,2,54,0,33 thing shia labeouf said student lift oxford union
1,2,3,62,2,13,4,65,0,meryl streep's hilarious reaction oscar mix-up perfect meme 2017
1,3,13,43,1,12,0,56,0,stopped using makeup washing hair ive never feltbetter
1,1,12,37,1,11,0,49,0,see emma stone superhero movie that's happening
1,1,9,30,0,9,2,39,0,17 photo give raging hockey boner
1,2,7,31,2,8,0,38,0,gaza tunnel millionaire fall hard time
1,3,6,38,3,6,0,44,0,davos: redistribution answer scary populism
1,1,7,38,2,7,2,45,0,"22 actual relationship lesson ""love actually"" taught u"
1,1,13,34,0,9,0,47,0,canadian woman opened thanksgiving nope
1,1,11,43,1,12,4,54,0,10 people lost 50+ pound share best tip getting started
1,1,8,26,0,7,0,34,0,actually know write cursive
1,2,15,41,4,15,0,56,0,weeknd nav neck model 'some way' video: watch
1,1,8,34,1,8,2,42,0,19 dorm room tip get instantly organized
1,1,6,31,0,5,0,37,0,drake album match personality
1,1,10,35,1,8,0,45,0,"dear academy, please give leo dicaprio fucking oscar"
1,1,14,53,1,13,0,67,0,everyone hate red cup they're filled dunkin donut
1,3,4,43,0,10,0,47,0,movie tv quote everyone get wrong list
1,1,8,35,2,7,0,43,0,what's worst christmas gift ever received
1,1,8,25,0,8,2,33,0,21 time tumblr got real kylo ren
1,3,15,49,3,14,0,64,0,"people pretty sure weeknd took shot justin bieber nav's ""some way"""
1,1,7,20,0,6,0,27,0,pas basic mar quiz
1,2,10,28,0,9,0,38,0,nuclear test teach u moon
1,2,10,26,0,9,0,36,0,know age state based yourmani
1,1,10,40,2,10,2,50,0,13 photograph teens' bedroom show live
1,1,16,60,0,15,0,76,0,guy celebrated bachelor party alone rest wedding party got stranded
1,1,12,49,0,11,0,61,0,introverted teen released relatable album year
1,1,9,30,0,9,2,39,0,33 picture glory day warped tour
1,1,8,30,0,7,0,38,0,unnatural color dye hair
1,1,9,40,0,8,0,49,0,wounded vet honored purple parking space
1,2,22,40,1,10,0,62,0,full remarks: milo delivers speech press conference amid video scandal
1,1,12,34,0,13,6,46,0,19 thing everyone owns flip phone 2015 know true
1,3,14,61,5,12,1,75,0,"2-yr-old's father, maj satish dahiya, died fighting terrorist handwara yesterday"
1,1,10,29,0,9,0,39,0,would use switch turn sperm
1,1,9,33,1,9,2,42,0,19 thing happen dating picky eater
1,1,10,41,2,9,0,51,0,"recognise ""goosebumps"" book original cover"
1,1,10,43,1,10,2,53,0,22 thing celebrity couple life normal people
1,2,3,39,1,10,0,42,0,going kabul: little joy shadow fear
1,1,13,54,0,12,0,67,0,web series helping trans teen find personal definition beauty
1,1,13,24,0,12,4,37,0,find big reality tv fan 2015
1,1,10,36,0,9,0,46,0,food encase sweet gelatin year
1,1,5,14,0,5,7,19,0,106 memorable tv death 2015
1,1,7,24,0,7,2,31,0,19 gift laziest person know
1,3,8,31,0,9,6,39,0,15 cheap beauty product worth buying in2017
1,1,9,19,0,8,0,28,0,power player big baby
1,1,6,23,3,5,0,29,0,tell u yourself(ie): tone bell
1,2,4,26,4,6,4,30,0,presenting: 2016 version guess who?
1,1,7,32,0,8,6,39,0,25 thing 2015 probably already forgot
1,3,3,53,2,8,0,56,0,nerd-shamers perverts: university challenge going viral
1,3,6,76,5,16,0,82,0,trump's america supreme court: 'nuclear option' republican planning use it?
1,2,11,45,4,11,0,56,0,"d.c. homeless double national avg, living cost soar record high"
1,2,1,36,1,8,4,37,0,here's many hour hedge funders worked 2016
1,3,15,57,2,15,2,72,0,alibaba's jack donates $20 million fund scholarship program mark friendship
1,1,11,29,3,8,0,40,0,"#blessed life kaskade, edm's voice reason"
1,1,7,35,0,6,0,42,0,new starbucks drink basically butterbeer
1,1,13,39,0,13,2,52,0,11 steamy lyric make see selena gomez new light
1,1,8,33,0,8,2,41,0,22 photo prove britain fictional country
1,2,12,45,1,11,0,57,0,odd lots: sneaker tell financial market work
1,3,4,57,0,13,1,61,0,3 key provision gop healthcare bill cause expert concern
1,1,14,44,2,11,0,58,0,"tv show binge-watch, based favorite curse word"
1,1,10,38,1,9,0,48,0,panic! disco album best fit personality
1,1,6,22,0,5,0,28,0,older couple give love advice
1,2,9,40,1,9,1,49,0,4 thing probably wrong swimsuit
1,1,7,42,0,7,2,49,0,24 completely bewitching tim burton inspired wedding idea
1,1,11,37,0,10,0,48,0,fox say duo skewer pentatonix capella
1,3,8,35,0,7,0,43,0,texture test reveal secretambition
1,1,10,34,0,9,0,44,0,go nut looking chewie drawing
1,2,10,37,3,10,0,47,0,stash cash -- one surprise away going broke
1,1,15,52,0,14,0,67,0,poor pup injured porcupine response warm heart
1,1,15,48,2,14,0,63,0,"bunch men made pinterests dream wedding super cute, bro"
1,1,10,33,0,10,2,43,0,31 reason fennel new food mascot fall
1,3,10,42,0,11,4,52,0,17 picture show different coachella 10 year ago
1,1,13,55,2,13,2,68,0,"16 product probably slightly obsessed ""high school musical"""
1,1,9,35,0,9,2,44,0,22 thing people shop daiso understand
1,1,7,32,0,7,2,39,0,16 magical way cook thanksgiving turkey
1,1,12,45,0,11,0,57,0,gay artist quite literally schooled someone sent hate mail
1,3,1,61,0,8,0,62,0,answering question new collective bargaining agreement
1,1,11,49,0,11,2,60,0,23 thing ridiculously valuable school worthless
1,1,9,39,1,9,2,48,0,22 obnoxiously cozy thing help embrace cold
1,1,13,43,0,12,0,56,0,golden globe red carpet look based zodiac sign
1,2,9,38,0,9,0,47,0,get authentic experience every time travel
1,3,16,45,3,11,0,61,0,exclusive: cdc chief frieden: end america's growing opioid epidemic
1,2,11,41,5,8,0,52,0,"donald trump meet big-pharma, vow big-time price change"
1,3,2,45,0,9,4,47,0,hottest trend 2017 according pinterest
1,2,1,43,1,8,0,44,0,young person thinking entering politics?
1,1,9,26,1,10,6,35,0,33 time lady gaga proved like u 2015
1,1,10,32,0,11,6,42,0,21 reason 2015 worst year canada ever seen
1,3,10,62,1,10,0,72,0,fake news: guardian caught deceptively editing quote julian assange interview
1,1,13,40,0,12,0,53,0,touching photo bride service dog going viral
1,3,3,41,2,12,0,44,0,"often snow uk, getting rarer?"
1,1,7,28,2,6,0,35,0,"""the force awakens"" character"
1,2,8,52,2,9,0,60,0,"american pharoah land sport illustrated cover, incredible"
1,3,15,23,1,7,0,38,0,two minute money: tackle credit card debt
1,1,9,41,0,9,2,50,0,17 time internet perfectly summed sagittarius
1,1,16,72,3,15,0,88,0,"weekly gossip roundup: jon hamm split jennifer westfeldt, chris hardwick get engaged,"
1,1,14,39,0,12,0,53,0,woman wore cargo short week decided ok
1,1,10,46,0,9,0,56,0,eerie photo capture oddball beauty suburban america
1,1,11,32,1,10,2,43,0,13 pedro infante song listen drunk af
1,1,14,38,0,13,0,52,0,body cam footage show vehicle plow cop car head
1,1,8,32,0,8,2,40,0,17 struggle every clean roommate know true
1,2,11,34,2,10,1,45,0,6 reason abc news unqualified label fake news
1,3,10,29,2,7,1,39,0,amazon ceo jeff bezos world 2nd-richest man
1,1,5,18,0,4,0,23,0,crappy roommate
1,1,9,40,0,9,1,49,0,5 astronaut told u terrifying moment space
1,1,5,30,0,4,0,35,0,dating struggle extroverted lady
1,1,6,28,0,6,2,34,0,19 thing mildly irritate farmer
1,1,7,38,0,7,2,45,0,24 hilarious tweet every grammar nerd appreciate
1,3,9,41,2,10,2,50,0,"many 48 million twitter account arent people, say study"
1,3,16,56,1,15,0,72,0,big b snub australian medium compare kohli trump one epic tweet!
1,1,10,34,0,9,0,44,0,returned childhood mall found nightmare
1,1,8,37,0,8,1,45,0,6 assault survivor story break heart
1,2,1,44,2,9,0,45,0,handle care: readers' photo theme tender
1,1,8,44,0,8,2,52,0,14 heartbreaking confession people sexless marriage
1,1,13,39,2,12,0,52,0,"kate winslet told settle ""fat girl"" part teenager"
1,3,5,39,0,8,0,44,0,know air defense identification zone
1,3,8,46,1,7,0,54,0,catholic bishop: church shield illegal immigrant
1,1,10,37,6,7,0,47,0,"dear ""walking dead"" fans: you-know-who definitely dead"
1,1,8,23,0,7,0,31,0,dev shah tom haverford
1,3,3,38,1,7,0,41,0,russia tune ukraine's eurovision show
1,2,6,50,0,11,0,56,0,woman marched conservative mp well donald trump
1,1,7,16,1,6,0,23,0,guess love
1,1,14,44,0,13,0,58,0,know kind instagrammer based choice emoji
1,1,7,23,0,7,2,30,0,25 picture sum cashier
1,1,10,41,1,9,0,51,0,"might want rethink juice cleanse, science"
1,1,11,51,0,11,1,62,0,7 disgusting thing subway offensive period underwear ad
1,3,8,60,3,7,0,68,0,twitter confirms shadowbanning: user receive account limiting notification
1,2,9,41,1,8,0,50,0,great moment roomful men legislating women's body
1,1,10,35,2,10,2,45,0,"27 vintage picture austin way ""cool"""
1,1,11,35,1,10,2,46,0,10 way help victim #chennairains right
1,1,7,36,0,7,2,43,0,24 obscenely awesome product decorate space
1,2,8,25,0,8,1,33,0,9 gross food choice need make
1,1,8,28,0,7,0,36,0,date david gandy jamie dornan
1,1,10,31,0,9,0,41,0,cat breed never knew existed
1,1,14,30,0,11,0,44,0,know gif make laugh based age
1,1,9,47,2,9,2,56,0,23 thing understand slightly obsessed michael
1,2,11,44,1,11,0,55,0,know sasha obama skipped dad's farewell address insider
1,1,11,37,0,8,0,48,0,anushka sharma psa everyone celebrating diwali
1,1,14,59,0,13,0,73,0,harry potter fan paying forward leaving heartfelt note future reader
1,1,10,30,1,9,0,40,0,here's list wig adele snatched week
1,1,7,31,1,6,2,38,0,34 dressed-up animal already halloween
1,2,3,78,1,14,0,81,0,nine weirdest easter tradition around world: bunny hunting real crucifixion
1,1,7,11,0,7,6,18,0,16 best ya book 2015
1,1,10,34,2,9,0,44,0,"zac efron twerking ""ellen"" make feel thing"
1,2,12,31,2,11,0,43,0,give straight: thing sandwich ornot?
1,1,8,26,0,7,0,34,0,guess letter added
1,1,7,31,1,7,2,38,0,21 wedding photo want pin immediately
1,3,3,59,5,12,0,62,0,"beloved character still couple 'sequel' 'love, actually'"
1,1,8,31,0,8,1,39,0,9 chart makeup lover totally relate
1,1,8,21,0,8,2,29,0,23 pret problem know true
1,1,12,45,0,11,0,57,0,know celeb resemble based three question
1,1,10,37,0,10,2,47,0,18 thing happen best friend come town
1,1,6,18,2,6,2,24,0,"well remember ""30 rock"""
1,1,12,34,0,11,0,46,0,get perfect score ron hermione quiz
1,1,4,17,5,5,8,21,0,celebrities: (2014) (2015)
1,2,1,43,1,8,0,44,0,killer whale human go menopause?
1,1,10,39,0,9,0,49,0,cringeworthy telenovela death time
1,3,11,77,6,19,0,88,0,"'i do, did, i'm done': hilarious divorce cake couple ordering celebrate end marriage"
1,1,8,28,0,7,0,36,0,quiz tell communicate
1,1,10,34,0,9,0,44,0,celeb boyfriend based birth month
1,1,7,29,1,5,0,36,0,buzzfeed crossword: acting like director
1,3,15,24,1,5,0,39,0,delingpole: bread cause global warming shock
1,1,13,51,0,13,2,64,0,19 confession capture feel like insecure relationship
1,1,5,22,0,5,2,27,0,17 bird complete asshole
1,1,10,43,1,9,0,53,0,taraji p. henson absolutely slayed golden globe red carpet
1,3,14,50,4,13,0,64,0,venus williams compared 'gorilla' commentator he's dropped!
1,1,10,38,1,9,0,48,0,oprah shonda rhimes reveal marriage
1,1,5,19,0,6,6,24,0,21 adorable puppy 2015
1,1,10,38,0,10,4,48,0,match celebrity baby name 2015 famous parent
1,1,11,25,0,8,2,36,0,13 reason malia obama need attend hbcu
1,1,8,35,0,8,2,43,0,19 mashups prove human ingenuity know bound
1,1,14,33,2,12,0,47,0,"identify show looking old ""tv guide"" cover"
1,1,9,24,0,8,0,33,0,want know tyler ford
1,1,7,23,0,7,3,30,0,100 important fails time
1,1,6,29,2,5,0,35,0,"ultimate ""scream queens"" drinking game"
1,1,9,41,0,8,0,50,0,rock literally wore perfect halloween costume
1,1,8,23,0,7,0,31,0,brand fast food nacho best
1,1,9,31,1,8,0,40,0,tell model's famous parent
1,3,11,46,0,10,0,57,0,flight attendant say new uniform making themsick
1,2,1,16,0,4,0,17,0,sex toy made
1,1,10,45,1,10,2,55,0,17 insanely beautiful makeup idea feeling look
1,1,9,38,2,10,6,47,0,"21 reason ""unbreakable kimmy schmidt"" best comedy 2015"
1,3,1,39,1,8,0,40,0,here figure full retirement age
1,1,9,33,2,9,2,42,0,11 woman drake better drake (on halloween)
1,1,10,48,2,9,0,58,0,relationship holidays: expectation vs. reality
1,3,10,44,3,11,1,54,0,"savage meme inspired kendrick lamar's ""the heart part 4"""
1,1,9,38,0,9,2,47,0,22 tumblr post hilariously sum video game culture
1,2,6,24,3,6,0,30,0,would ulysses received today?
1,3,16,42,2,10,0,58,0,watch: heart-stopping rescue kitten come within whisker death
1,1,7,23,0,7,2,30,0,15 rude text tear would send
1,1,14,44,1,13,0,58,0,there's shadow church san francisco look like sideboob
1,1,8,33,0,7,0,41,0,netflix original series star
1,1,12,41,0,11,0,53,0,know animated kindred spirit based zodiac
1,1,8,27,0,7,0,35,0,much actually know baking
1,1,9,34,0,9,2,43,0,23 image college student fucking done
1,1,9,39,1,9,1,48,0,"9 photo successful career women, according medium"
1,1,15,44,4,15,3,59,0,like pay $2.99 month kylie jenner's official app
1,3,9,65,2,11,0,74,0,professor disciplined sexual misconduct singing beach boy song student
1,2,9,28,1,9,2,37,0,17 teacher extra itll make yousmile
1,3,1,39,1,8,4,40,0,here's way technology impacted life 2016
1,1,6,18,2,5,0,24,0,whoa: celine dion's son grew
1,1,11,35,0,11,1,46,0,9 safety tip keep pet happy healthy fall
1,3,1,54,6,14,0,55,0,'i'd heartbeat' story stay-at-home dad
1,1,8,29,0,9,6,37,0,19 time buffalo bill fan lost mind 2015
1,2,0,40,1,7,1,40,0,7 wearable saving babies' life around world
1,1,10,41,0,10,1,51,0,9 thing people unusual career goal tired hearing
1,1,11,43,1,10,0,54,0,samantha bee created rape threatline troll genius
1,1,12,41,1,12,4,53,0,2016 britney spear backflip vega show
1,1,9,42,0,9,2,51,0,69 thought everyone dating long term relationship
1,1,6,18,0,5,0,24,0,know dream mean
1,1,9,46,0,9,2,55,0,19 inspiring confession people beat anorexia bulimia
1,1,9,35,1,9,2,44,0,11 piece wisdom read whenever feeling
1,1,13,56,1,12,0,69,0,nick offerman megan mullally really puzzle totally adorable
1,2,9,41,2,11,0,50,0,"trump new ban leaf spot refugees, even hunted"
1,2,16,51,3,13,0,67,0,speaker ryans last-minute change mean gop must pas ryancare know whats
1,1,16,48,0,15,0,64,0,life look like owe entire life student loan debt
1,1,13,45,1,12,0,58,0,here's bunch thing never say engineering student
1,1,10,37,0,9,0,47,0,kitten trying wear hat failing insanely cute
1,3,1,56,0,14,1,57,0,6 way push online activism real world trump era
1,1,17,44,3,15,0,61,0,"think ""post be"" one greatest r&b collaboration time"
1,1,9,40,1,8,0,49,0,here's happens baked potato nacho collide
1,2,16,62,0,15,0,78,0,hate crime african continue another man thrashed badly mob greater noida
1,1,15,61,1,14,0,76,0,sikh man's tweet paris terror attack captured religion
1,3,5,72,4,15,0,77,0,former wall streeter master sommelier here's advice great-tasting wine
1,2,9,50,1,11,0,59,0,report: assassin waited garage hour kill top hamas terrorist
1,3,13,50,1,10,1,63,0,adpvoice: 4 way organization around world helping working mother
1,3,4,44,2,8,0,48,0,zealandia: eighth continent new zealand?
1,1,7,23,0,8,6,30,0,16 thing dude need stop wearing 2016
1,1,6,14,0,5,0,20,0,part world
1,1,8,28,0,8,2,36,0,19 item anyone love burger need
1,1,11,42,0,11,2,53,0,22 tumblr post remind harry potter fan hilarious
1,1,15,60,2,13,0,75,0,taraji p. henson embraced natural beauty went weave-less fashion magazine
1,2,10,41,0,9,0,51,0,mesmerizing food quiz reveal shouldlive
1,3,6,35,1,9,4,41,0,2017 golden globes: vote best worst dressed
1,3,12,51,4,11,0,63,0,floyd mayweather vs. conor mcgregor: money say potential bout 'very close'
1,1,12,55,6,10,1,67,0,"7 essay read: school racist, ""depressiongrams,"" #shoutyourabortion"
1,1,17,60,0,16,0,77,0,gay porn star rapper became vine famous liveblogged arrest facebook
1,1,5,32,1,5,2,37,0,17 disney accessory want immediately
1,1,10,36,2,11,4,46,0,11 song '00s disney channel kid heard way long
1,1,10,31,0,9,0,41,0,molly crabapple writer made writer
1,3,3,78,8,14,0,81,0,"new 'justice league' trailer here, omg, omg, breathe, please everyone breathe, akjsdhfgkas;"
1,1,10,28,3,7,4,38,0,first end-of-the-year mashup 2015 arrived
1,2,2,19,3,5,0,21,0,come fed minute ...
1,2,10,53,3,13,0,63,0,gutfeld: massive bomb sent 'mother messages' north korea insider
1,3,3,62,0,10,0,65,0,critical lastpass security hole would allow hacker steal password
1,1,11,41,0,11,2,52,0,23 tweet mall santa guaranteed make laugh
1,1,10,36,1,9,0,46,0,here's happens tomboy wear dress week
1,1,12,41,1,11,0,53,0,show really interested tinder swiping
1,2,7,72,2,15,0,79,0,"tony robbins, steve case, magic johnson others invested million pro gaming team"
1,1,5,15,0,4,0,20,0,dad actually
1,1,8,37,2,7,0,45,0,"""boogie nights"" character kindred spirit"
1,1,8,33,1,8,2,41,0,14 dog definitely peek present
1,2,13,46,3,12,2,59,0,nba player power rankings: b/r's top 30 shooting guard halfway point
1,1,10,39,1,10,4,49,0,glorious mashup 2015's biggest movie blow away
1,2,14,58,3,15,0,72,0,sessions: met russian time discus political campaign
1,1,9,33,0,8,0,42,0,disney movie way accurate badass
1,1,16,44,0,15,0,60,0,shia labeouf asking fan call phone touch soul
1,3,1,49,0,10,0,50,0,medical drone could next wave emergency response
1,1,7,31,0,6,0,38,0,halloween party drink spook friend
1,1,8,32,0,8,2,40,0,11 beautiful florida beach town need visit
1,2,2,35,0,5,0,37,0,good alternative palestinian state
1,1,11,44,0,10,0,55,0,iconic britney spear song based three question
1,1,11,43,0,12,6,54,0,37 time scottish twitter funniest place internet 2015
1,1,12,45,1,11,0,57,0,kanye west also reference kim kardashian's sex tape new album
1,2,4,22,2,6,4,26,0,2017 oscar number [video]
1,2,10,47,1,12,0,57,0,snack bar push price envelope find consumer dont push back
1,3,9,51,2,9,0,60,0,free credit score? necessarily. credit bureau busted deception
1,2,5,53,2,12,0,58,0,person shut twitter troll hard even j.k. rowling approved
1,3,11,60,2,11,0,71,0,utah lawmaker pas measure calling congress abolish u.s. education department
1,1,8,35,2,7,0,43,0,"new ""being canadian"" movie hilariously honest"
1,1,8,33,2,5,0,41,0,what's favorite halloween-themed tv episode
1,1,9,33,2,8,0,42,0,"well remember ""unfabulous"" theme song"
1,1,9,38,2,9,2,47,0,"21 little detail probably missed ""the fifth element"""
1,3,5,22,2,5,0,27,0,modi diamond's best friend
1,1,12,44,1,11,0,56,0,adele's collaborator say third album
1,1,8,37,3,7,0,45,0,"what's favorite ""parks recreation"" moment ever"
1,1,14,46,0,13,0,60,0,high school student shut epic lip dub video
1,3,4,74,2,18,0,78,0,body language expert reveals nine way spot liar (and get away telling fibs)
1,1,13,50,2,10,0,63,0,"let's honest, gop candidate lindsey graham dazzlingly beautiful eye"
1,1,9,47,1,9,4,56,0,instagram account recreating 2015's greatest hit barbies
1,1,10,25,0,9,0,35,0,know much old toy worth
1,3,16,49,1,14,0,65,0,somali hijabi model walked kanyes yeezy fashion line badassaf
1,2,3,41,0,9,0,44,0,going harder donald trump expected
1,2,6,50,0,10,0,56,0,pick every trophy given home depot college football award
1,1,10,36,0,9,0,46,0,know canadian city actually live
1,2,9,57,1,10,0,66,0,brandon darby: border patrol agent feel betrayed trump administration
1,1,7,23,1,7,2,30,0,many iconic '00s film seen
1,1,14,42,0,13,0,56,0,lion got wheelbarrow zoo pretty whimsical
1,1,6,19,0,7,6,25,0,24 photo prove rock 2015
1,2,9,28,0,9,1,37,0,5 nba trade want see deadline
1,1,6,35,0,6,2,41,0,23 incredibly thoughtful gift everyone want
1,1,12,48,0,11,0,60,0,canadian kid welcoming refugee make feel feel
1,1,10,44,0,9,0,54,0,hilarious harry potter comic show snape always sucked
1,1,11,39,1,10,0,50,0,color test predict much longer single
1,1,12,46,1,10,0,58,0,friendly reminder biggest a-hole television canadian
1,1,15,49,3,15,1,64,0,"first trailer ""my big fat greek wedding 2"" finally perfect"
1,2,5,36,0,6,0,41,0,brandon spike released new england patriot
1,1,5,21,0,5,2,26,0,17 cat enjoying finer thing
1,3,1,40,0,8,2,41,0,54 hilariously bad amazon movie review
1,2,14,50,1,12,0,64,0,buffalo wild wing behind marreese speights' nba final missed dunk
1,2,13,47,2,11,0,60,0,one politician taking action u.s. marine nude photo scandal
1,1,11,42,0,10,0,53,0,quiz determine song personal catwalk jam
1,1,6,33,0,6,2,39,0,13 hanukkah fails undeniably hilarious
1,2,17,60,3,14,0,77,0,"people judged weight post-pregnancy, say shilpa shetty fat-shaming new mother"
1,1,10,44,0,9,0,54,0,kylie jenner officially way popular kim kardashian
1,1,4,23,0,4,2,27,0,29 perfect gift ginthusiasts
1,2,1,57,0,14,0,58,0,video guy punching kangaroo face quite story behind
1,1,15,59,0,14,0,74,0,john stamos julianne moore acted soap opera entirely using taylor swift lyric
1,3,3,34,1,8,0,37,0,malaysia north korea friendship ice
1,1,15,37,0,11,0,52,0,game mash make middle school dream come true
1,3,9,27,4,7,0,36,0,nbc news head: opposition party
1,3,1,51,1,12,0,52,0,piece cake escaped corporate life launch fintech app
1,1,16,56,1,14,0,72,0,leonardo dicaprio's face lady gaga walked accept award everything
1,1,13,58,0,12,0,71,0,interview jennifer lawrence jennifer lawrence thing happen
1,1,13,49,2,12,0,62,0,"reporter responded vulgar comment awesome ""your mama"" joke"
1,1,13,46,1,12,0,59,0,people dressing pet beanie baby almost much
1,1,10,37,0,10,2,47,0,17 tweet trying eat healthy pretty funny
1,1,10,37,0,9,0,47,0,identify disney character eye
1,3,1,36,0,7,1,37,0,7 february game get excited
1,1,8,30,1,7,0,38,0,here's actually eat healthier year
1,1,11,45,0,11,2,56,0,11 chart speak anyone really fucking love swearing
1,1,10,33,0,9,0,43,0,grossest thing internet week
1,2,8,50,0,8,0,58,0,vanderbilt football team star sorority recruitment video spoof
1,3,1,62,2,11,0,63,0,"plunge oil prices, hope fade group long-beleaguered worker"
1,3,3,44,2,10,0,47,0,boyfriend cheated using skype sex. matter?
1,1,5,19,0,6,5,24,0,8 animal may survive 2016
1,1,10,27,1,9,0,37,0,know many time sex week
1,2,6,21,1,5,0,27,0,actually worstsister?
1,3,3,60,2,16,7,63,0,"top investment expert $487 billion fund outlook 2017, europe trump"
1,1,9,35,0,9,2,44,0,16 truth people get major anxiety texting
1,1,6,19,0,5,0,25,0,people state drive
1,1,12,38,0,11,2,50,0,19 vintage photo sean connery make thirsty af
1,3,13,69,3,14,4,82,0,politifact pull 2014 mostly true rating john kerrys claim eliminating syrian chemical weapon
1,1,13,38,0,12,0,51,0,one perk vegetarian one ever talk
1,1,9,39,0,9,2,48,0,25 incredibly honest reason people waiting sex
1,3,7,38,1,6,0,45,0,panetta: trump cannot govern executive order
1,1,9,39,0,9,2,48,0,watch 80 year halloween costume three minute
1,1,6,23,2,6,2,29,0,"17 time ""steven universe"" made cry"
1,1,7,32,1,6,2,39,0,23 sign completely obsessed youtube
1,2,14,58,2,13,0,72,0,report: mitt romney fired; trump chooses exxon ceo rex tillerson secretary state
1,1,9,29,3,7,0,38,0,"listen buzzfeed's new podcast ""the tell show"""
1,1,15,37,1,11,0,52,0,anyone who's received free granola bar asos order
1,1,12,49,0,12,2,61,0,27 halloween costume men probably make tingle
1,1,7,31,0,7,1,38,0,7 reason shower sex logistical nightmare
1,1,9,45,0,8,0,54,0,guess celebrity fragrance description
1,1,9,33,0,9,2,42,0,14 reason wish duchess cambridge
1,1,12,45,2,11,0,57,0,"guess ""pretty little liars"" episode based screencap"
1,1,9,34,0,8,0,43,0,turn different person driving
1,1,9,24,0,8,0,33,0,like vampire werewolf
1,2,11,33,2,10,4,44,0,"29 time ""13 reason why"" cast irl friendship goal"
1,1,9,27,0,9,2,36,0,29 insane traffic jam world
1,1,8,15,0,5,0,23,0,gop even stand
1,1,10,40,3,10,2,50,0,"13 ""grease: live"" secret learned sitting audience"
1,1,10,38,1,9,0,48,0,here's actually find cheapest flight ever
1,1,10,36,2,9,2,46,0,21 confession people can't put e-books
1,1,11,43,0,10,0,54,0,ice cream bite everyone screaming ice cream
1,2,2,34,1,6,1,36,0,6 takeaway trump's address congress
1,1,12,33,0,12,2,45,0,23 people tell u rooting mets
1,1,11,41,2,10,0,52,0,"know hate ""harry potter"" movie adaptation"
1,1,4,10,1,3,0,14,0,what's air
1,1,8,31,1,9,6,39,0,popular '90s phrase bring back 2016
1,2,2,46,0,7,0,48,0,denzel washington fake news information overload
1,2,2,48,2,7,0,50,0,google photo app dramatically improves user video
1,1,11,41,1,11,2,52,0,17 gorgeous gallery wall want recreate home
1,1,12,46,1,10,0,58,0,ava duvernay slayed elle magazine cover breathtaking
1,1,13,48,0,13,2,61,0,21 black people give best advice taking care mental health
1,1,9,34,0,9,2,43,0,23 way cover black history month pride
1,1,14,45,0,13,0,59,0,ruby rose single question need answer
1,1,12,47,3,9,0,59,0,here's mark wahlberg pull-up slow motion funsies/hardsies
1,3,13,65,2,14,0,78,0,russell westbrook tell teammate talk kevin durant thunder/warriors game?
1,1,6,26,3,5,0,32,0,tell u yourself(ie): david anders
1,1,12,40,0,12,1,52,0,food stylist gave u 5 tip make normal food look amazing
1,1,8,28,0,7,0,36,0,would room requirement show
1,2,2,44,2,8,0,46,0,"people sharing ""ugly duckling"" photo list"
1,1,6,24,0,6,2,30,0,18 holiday mug cake worth feasting
1,1,7,45,0,7,2,52,0,27 breathtaking alternative traditional wedding bouquet
1,1,9,34,1,9,2,43,0,35 thing never going get christmas
1,1,9,35,0,9,2,44,0,23 beautiful cake make dream come true
1,1,8,32,0,7,0,40,0,lazy costume wear halloween
1,1,11,40,0,10,0,51,0,kristen wiig pretending peyton manning much
1,1,4,30,0,4,2,34,0,14 important sigils twentysomethings
1,1,4,16,0,3,0,20,0,common word brain fart
1,1,8,25,1,7,0,33,0,sang it: trace adkins dustin lynch
1,1,13,41,2,11,1,54,0,meet 4-year-old twin taking modeling world storm
1,3,2,36,0,7,1,38,0,5 book richard branson think read
1,1,13,40,0,12,0,53,0,solve puzzle want get hazed famous figure
1,1,7,22,0,6,0,29,0,real life like telenovela
1,1,8,39,0,8,2,47,0,27 incredibly wonderful product people love fall
1,1,11,34,0,10,0,45,0,color test determine type sex like
1,1,9,40,0,9,2,49,0,13 divine way cook pomegranate holiday season
1,1,10,27,3,9,2,37,0,19 guy hot then...who even hotter
1,1,13,46,0,12,0,59,0,chocolate abuelita best hot chocolate ever try
1,1,10,33,0,9,0,43,0,justin bieber broke record set beatles
1,2,2,63,0,13,0,65,0,hottest aussie city coldest day people really freaked
1,3,7,36,0,9,5,43,0,top employer say millennials need 4 skill 2017
1,3,11,37,0,10,0,48,0,aclu sue indiana town cross top christmas tree
1,2,8,29,1,8,2,37,0,00s quiz reveal age andlocation
1,1,12,45,0,11,0,57,0,beautiful dance tell breakup story emotional way
1,1,5,18,0,4,0,23,0,weird thing gay couple
1,3,8,23,1,7,0,31,0,remy taking shot nicki minaj?
1,3,1,30,0,7,0,31,0,pippa party end party
1,1,6,20,0,5,0,26,0,ready christmas
1,1,12,37,1,10,0,49,0,mozart jungle next show binge-watch
1,2,8,34,0,8,2,42,0,23 product everyone hate everyone need toown
1,1,7,26,1,7,2,33,0,31 gift people freakin' love fruit
1,1,9,27,0,9,4,36,0,delicious meal made 2015
1,1,6,15,0,5,0,21,0,girl crush
1,1,10,34,2,9,1,44,0,here's 3-ingredient cheese dip make minute
1,1,10,46,1,9,0,56,0,zendaya's reaction magazine photoshopping body perfect
1,1,9,35,2,8,0,44,0,"hogwarts house would ""glee"" character"
1,2,3,26,1,5,0,29,0,apple update iphone mac software
1,1,10,39,0,9,0,49,0,guess famous author gave writing advice
1,1,7,33,2,7,6,40,0,25 2015's highest-paid musician according forbes
1,1,6,14,0,5,0,20,0,live matrix
1,3,8,40,3,11,0,48,0,boy's letter father heaven land woman's yard yahoo
1,1,6,27,3,5,0,33,0,tell u yourself(ie): dexter darden
1,3,1,63,0,14,3,64,0,sarcastic kid cynical joke happen turn 100
1,1,10,44,0,9,0,54,0,people emptying giant stuffed bear climbing inside
1,1,10,41,3,9,0,51,0,woman pranked awful makeovers... hilarious
1,2,5,75,1,13,0,80,0,"franklin graham tony campolo, evangelical leader splitting gay marriage"
1,1,9,33,1,8,2,42,0,15 thing every grown-ass woman
1,1,9,32,0,9,2,41,0,16 reason addams family best family ever
1,2,10,48,1,10,2,58,0,22 mindblowing book anyone who slightly obsessed truecrime
1,1,6,28,2,5,0,34,0,"alphabet according ""gilmore girls"""
1,1,9,38,1,9,2,47,0,18 badass portrait glamour's woman year award
1,3,1,41,0,9,0,42,0,child allergy emergency
1,1,12,35,0,10,2,47,0,11 quote friendship make text bff
1,1,8,35,1,8,2,43,0,19 unexpected music mashups know needed
1,1,10,38,1,9,0,48,0,what's personality type based opinion egg
1,1,13,33,0,12,0,46,0,know type person based poop
1,1,8,25,0,7,0,33,0,fairy based zodiac
1,1,10,37,2,9,2,47,0,17 thing know better-looking sibling
1,1,14,18,0,9,6,32,0,29 wtf moment 2016 baftas
1,1,9,42,0,8,0,51,0,teriyaki chicken pineapple boat actually easy
1,3,8,27,6,8,0,35,0,"oh, no, snowing! whats poor portland do?"
1,1,9,49,0,8,0,58,0,moroccan responding police harassment hilarious meme
1,1,6,28,1,6,2,34,0,17 photo mushroom weirdly enjoy
1,2,4,42,1,9,0,46,0,lawyers: trump sell dc hotel taking office
1,1,8,32,1,8,2,40,0,23 thing people wish they'd done twenty
1,1,8,26,2,7,0,34,0,football vs. wife: know better
1,1,12,62,0,11,0,74,0,beautiful piece trans artwork offer glimpse diverse trans experience
1,1,11,25,0,9,0,36,0,name tv show intro alone
1,1,8,32,0,8,2,40,0,18 thing people love christmas december
1,2,3,41,2,8,0,44,0,u truck driver 'loses marbles' indiana highway
1,1,12,33,1,11,0,45,0,teen's text prank parent work genius
1,3,2,51,1,10,0,53,0,reason entire canadian town's water turned hot pink
1,1,9,34,0,8,0,43,0,know bodily talent based three question
1,1,11,42,2,10,0,53,0,"blake lively, taylor swift, kangaroo took selfie together"
1,3,6,42,4,9,0,48,0,britain first: day uk's anti-islam alt-right group
1,1,8,48,0,7,0,56,0,recovering addict talk stigma surrounding addiction
1,1,14,54,0,13,0,68,0,video bridge collapsing show dangerous chennai flood
1,1,10,33,2,9,0,43,0,"marry kylo ren finn ""force awakens"""
1,1,13,50,0,13,0,63,0,santa refused wake sleeping baby took adorable photo
1,1,6,21,1,6,2,27,0,13 valentine's day card gay men
1,3,3,43,7,11,1,46,0,'game thrones' season 7 get release date...and ice?
1,3,5,24,0,5,0,29,0,manifesto end boring meeting
1,1,6,20,0,5,0,26,0,finish music pun
1,1,7,33,1,6,2,40,0,27 last-minute stocking stuffer every fandom
1,1,11,32,0,11,4,43,0,2015 year shibas proved meme
1,1,5,19,1,6,4,24,0,31 '90s product still find
1,1,12,40,0,11,0,52,0,tried five week ballet fitness happened
1,1,9,21,2,7,2,30,0,"19 gifs make say ""ahhhhhhh"""
1,1,14,48,0,14,2,62,0,19 picture prove bin bag greatest halloween costume time
1,1,9,34,2,8,0,43,0,"identify language ""hellos"""
1,1,16,64,2,14,0,80,0,queen jojo slayed faves (except adele) powerful tonight show performance
1,1,6,21,0,6,2,27,0,18 cat ready christmas
1,1,11,30,0,10,0,41,0,fill blank master p lyric
1,3,14,47,7,13,0,61,0,"jorge ramos: america country, theirsand going leave"
1,1,9,41,0,9,2,50,0,25 adorable presidential pet photo melt heart
1,3,9,35,0,9,2,44,0,21 top secret device dangerous world ofspies
1,1,15,49,3,13,0,64,0,"goddam internet lip-dub olivia ""the bachelor"""
1,2,9,60,3,12,0,69,0,erdogan: european headscarf ban started clash cross crescent
1,2,2,55,4,11,0,57,0,"aarhus, denmark: see, plus best restaurants, bar hotel"
1,3,2,48,3,10,0,50,0,nicki minaj 'baby bump photo' sends singer's fan frenzy
1,2,1,77,2,15,2,78,0,android malware: 38 new phone tablet found pre-installed virus sold
1,3,1,50,2,10,0,51,0,'orange goo' used armor soldier football player
1,3,1,42,1,7,0,43,0,could app really replace contraceptive pill?
1,1,10,30,0,9,2,40,0,23 hot af male model sexually awaken
1,1,13,34,1,11,0,47,0,got bunch stranger give u netflix log-in
1,2,9,39,1,9,0,48,0,golfing trump? better leave ego clubhouse
1,1,10,28,1,10,2,38,0,18 thing know could san diego
1,1,14,41,3,11,0,55,0,"episode ""law order: svu"" watch halloween"
1,3,4,82,1,12,0,86,0,picture show starving bulgarian orphan's incredible transformation adopted u woman
1,3,4,48,4,9,2,52,0,carmelo anthony: open phil's criticism prefer 1-on-1 variety
1,1,9,27,0,9,2,36,0,19 awesome new book need read fall
1,2,12,45,1,12,0,57,0,obamas last full day job filled nostalgia thank call
1,1,7,40,2,5,0,47,0,what's best australian-inspired halloween costume
1,1,13,30,2,13,4,43,0,"""home alone"" would like set 2015"
1,3,7,60,0,10,0,67,0,wwe superstar charlotte flair reveals wrestlemania fitness diet plan
1,3,4,32,0,8,0,36,0,trump changed oval office far
1,1,8,23,0,7,0,31,0,pro con living florida
1,3,6,35,3,7,0,41,0,"no, fisher-price happy hour playset real"
1,1,17,51,0,16,0,68,0,mariah carey peak mariah carey posing beach red full body wetsuit
1,2,17,9,2,6,3,26,0,two minute money: saving $100 month
1,1,9,29,3,8,0,38,0,"here's star ""casper"" look like today"
1,3,9,29,1,6,0,38,0,vmwarevoice: five thing come security
1,3,5,25,0,5,2,30,0,19 hilarious holiday pun aboutbooks
1,1,10,47,1,10,2,57,0,here's 19 painfully handsome male model look like without makeup
1,1,9,25,1,7,0,34,0,learned accept self-harm scar
1,2,2,65,1,13,0,67,0,search dream greenhouse: instagram given glasshouse new life
1,1,10,33,1,10,2,43,0,18 people fucked work day
1,3,8,38,2,7,2,46,0,23 essential song anti-valentines dayplaylist
1,2,14,58,1,14,2,72,0,27 really wholesome celeb encounter story thatll make want meet youridols
1,3,7,25,2,3,0,32,0,bbc news (world)verifizierter account
1,1,6,22,0,6,2,28,0,13 picture brighten bad day
1,1,11,34,0,11,4,45,0,anne hathaway wear hat 2015 year
1,1,10,32,0,10,2,42,0,18 sweary british word need use right
1,1,9,34,0,9,2,43,0,guess grade level 10 simple question
1,1,8,32,0,8,2,40,0,17 time internet got real instagram
1,2,21,49,7,15,0,70,0,"kassam cpac slam establishment media: ive sweden, guy dont get it!"
1,2,16,55,2,17,3,71,0,"forget modi's 50 day deadline, take 4 month get enough currency bank"
1,2,8,49,2,9,2,57,0,poll: 55 percent voter support trump refugee resettlement freeze
1,1,13,38,1,11,0,51,0,here's gift buy someone based favorite tv show
1,2,2,50,0,12,0,52,0,animated map earth would look like ice melted
1,1,8,35,0,7,0,43,0,simple test reveal dominant emotion
1,1,10,39,0,9,0,49,0,actually see difference black blue
1,1,11,30,0,11,2,41,0,17 insanely cool thing hot glue gun
1,1,7,36,1,6,2,43,0,23 disney-themed kitchen gadget definitely need
1,1,6,35,0,6,1,41,0,9 deliciously fabulous way enjoy chimichurri
1,1,12,40,0,11,0,52,0,recent kanye west tweet based birth month
1,1,8,31,0,7,0,39,0,much actually love christmas movie
1,1,15,35,4,10,0,50,0,"well remember ""slutty pumpkin"" episode ""himym"""
1,1,10,52,2,9,6,62,0,32 behind-the-scenes entertainment feature 2015 deserve another look
1,3,4,10,0,5,6,14,0,16 image life in2007
1,1,12,44,2,12,2,56,0,"27 moment ""the simple life"" belong damn history textbook"
1,2,5,50,0,8,0,55,0,controversial trump aide bannon elevated wh security council
1,1,6,28,1,5,0,34,0,unscramble celebrity's name
1,3,2,42,3,6,0,44,0,sydney's controversial bar curfews: worked?
1,1,9,30,0,10,6,39,0,17 genius ingredient make better cook 2016
1,1,10,39,0,10,2,49,0,21 ridiculously cute british irish baby name
1,2,2,52,0,8,0,54,0,aleppo christian celebrate holiday hope peace returned
1,1,13,40,2,12,0,53,0,"can't stop laughing tweet kajol, come laugh"
1,1,15,63,0,14,0,78,0,famous person justin bieber randomly ran famous person adam sandler street
1,3,15,50,4,16,0,65,0,men harder time aging thought. here deal [video]
1,2,12,47,1,10,0,59,0,promo: toyota photographer anthony supreme get know unknown
1,1,10,36,0,10,1,46,0,check 5 simple trick mess friend
1,2,2,61,2,14,0,63,0,what's gender pay gap industry? new government tool let find
1,1,10,35,2,10,2,45,0,"14 incredible ""game thrones"" tattoo die"
1,1,7,28,0,7,2,35,0,31 thought everyone bad haircut
1,1,6,24,0,5,0,30,0,nativity scene member
1,2,12,39,5,8,0,51,0,hillary clinton: sean spicer guilty everyday sexism (video)
1,2,9,44,2,11,5,53,0,"obama oversees year mass regulation, record 97,000 page red tape"
1,2,7,40,1,8,2,47,0,hong kong seaside mansion bought estimated $86 million
1,1,15,51,1,14,0,66,0,picture india's popular office make want quit job
1,1,8,22,1,6,0,30,0,way diet prof broke af
1,1,10,34,2,9,0,44,0,*probably* el chapo escape prison next
1,1,11,36,0,10,0,47,0,stuffed bhurji pav breakfast game
1,1,8,40,0,8,1,48,0,9 vitiligo transformation prove power makeup
1,2,8,33,4,10,4,41,0,china give hedge fund brother no.1 5 1/2 year prison
1,1,11,45,2,10,0,56,0,"people twitter really confused ""the ghost ladbrokes"""
1,1,11,33,0,10,0,44,0,los angeles looked like glory day
1,1,7,39,0,7,2,46,0,21 time george costanza actually twentysomething
1,1,10,41,1,9,0,51,0,what's favorite school subject based zodiac sign
1,1,7,19,0,6,0,26,0,netflix chill
1,1,13,37,0,12,0,50,0,free app best thing happen email since gmail
1,2,6,24,0,6,2,30,0,17 extremely festive way getdrunk
1,1,9,30,0,9,2,39,0,35 thing hit right childhood
1,3,19,52,4,11,0,71,0,exclusive clinton sex accuser slam hypocritical medium bill oreilly coverage
1,1,10,36,1,9,2,46,0,13 thing friend post-natal depression
1,1,10,34,0,9,0,44,0,know zodiac sign based favorite song
1,1,19,50,0,17,2,69,0,wwe issued apology kurt angle wiping nose indian flag 17 year ago
1,1,14,47,2,13,0,61,0,"thought watching ""harry potter"" first time"
1,1,9,51,0,9,2,60,0,14 confession single dad heartwarming heartbreaking
1,1,26,30,1,8,0,56,0,#cockroachesandcher important hashtag century
1,1,8,28,1,5,0,36,0,ariana grande mac's newest spokesperson
1,1,6,28,1,7,6,34,0,51 america's instagrammed place 2015
1,1,7,33,0,6,0,40,0,outlander made big casting announcement
1,2,1,52,0,8,0,53,0,fascinating example cannibalism exist today
1,2,11,55,2,10,0,66,0,"daughters' tragic diagnoses, parent raise money fight batten disease"
1,1,7,29,0,6,0,36,0,absolute favorite pixar movie
1,1,15,43,0,14,0,58,0,aunty ji swinging park remind never grow
1,1,10,29,0,9,0,39,0,big christmas film fan actually
1,1,12,32,2,11,2,44,0,21 chart help get shape lazy af
1,1,8,31,0,8,2,39,0,16 important thing know getting puppy
1,1,9,33,0,8,0,42,0,breakfast look like around world
1,3,3,43,3,10,0,46,0,battle west mosul: bomb 'fall like rain' front line
1,1,10,38,3,10,2,48,0,"15 thing happen people think ""look latina"""
1,3,12,40,0,11,0,52,0,fast food wrapping packaging bad health
1,1,11,37,0,10,0,48,0,pro gamers compete vet shooting range
1,1,10,39,0,11,6,49,0,20 time amandla stenberg carefree black girl 2015
1,1,11,35,0,10,0,46,0,know zodiac sign based favorite pop star
1,1,6,17,0,5,0,23,0,thing still ask dad
1,3,8,40,2,10,0,48,0,carmelo anthony's day knicks coming end?
1,1,8,28,1,7,0,36,0,girl shed hair everywhere
1,1,8,41,1,8,2,49,0,18 celebrity snapchat account change snap life
1,1,13,49,2,12,0,62,0,here's little girl's sketch sent one photographer epic journey
1,1,13,51,2,13,2,64,0,"33 charming moment ""wallace gromit"" make laugh every time"
1,2,11,29,4,7,0,40,0,msnbcs ruhle: conway break glass ceiling
1,1,9,31,1,9,2,40,0,17 thing recognize grew florida
1,3,9,41,0,8,0,50,0,trump administration hit small farmer bad news
1,2,9,41,0,9,2,50,0,11 inspiring story people bounced back failing
1,1,9,31,0,9,0,40,0,actually want say first date
1,3,2,67,3,17,0,69,0,"man confessed punching baby boy death, police say. may face charges."
1,3,9,40,4,12,2,49,0,dem sen menendez: trump great wall hate waste $20 billion
1,3,16,48,2,13,0,64,0,here's look transgender model anjali lama's coolest moment lfw
1,2,1,58,0,12,4,59,0,paris ban car registered year 2000 bid combat city pollution
1,1,12,48,3,10,0,60,0,"hogwarts house character ""brooklyn nine-nine"" belong"
1,1,6,35,0,6,2,41,0,21 misconception extrovert want set straight
1,1,11,42,0,10,0,53,0,fantastic magical beast based zodiac sign
1,1,16,49,0,15,0,65,0,jesse sexy metcalfe yard sale living life full regret
1,1,4,17,1,3,0,21,0,who's unknown caller
1,1,13,63,1,12,0,76,0,reminder: donald trump ran president would randomly tweet celebrity
1,2,4,19,1,4,0,23,0,cut-back crew iss launch
1,1,9,32,0,8,0,41,0,denim habit compare everyone else
1,1,7,31,0,6,0,38,0,actually name pixar character
1,1,8,37,0,8,2,45,0,29 enchanting image guaranteed make day better
1,2,6,76,2,14,0,82,0,carrigan's suicide spark there's campaign mental health program school
1,1,10,29,1,10,2,39,0,19 picture sum life bad math
1,3,2,44,1,11,4,46,0,year music died: remembering icon left u in2016
1,1,4,23,1,3,2,27,0,21 second-day hairstyle tutorial
1,3,0,56,1,9,1,56,0,9 history's greatest philosopher reveal secret happiness
1,2,8,46,2,9,0,54,0,desperation set house hunter toronto red-hot market
1,1,10,32,2,9,0,42,0,there's cheeky nando's music video insane
1,1,13,51,1,12,0,64,0,here's happened people tried chicken waffle first time
1,3,13,47,4,12,0,60,0,ideal choice donald trump confirms gen. john kelly dhs secretary
1,3,9,14,1,8,2,23,0,35 best gift buy ath&m
1,1,12,45,2,11,0,57,0,there's lot missing johnny depp tom hardy's gangster movie
1,1,5,23,1,4,0,28,0,chipotle actually good
1,1,6,24,0,5,0,30,0,stereotypically mum mum
1,1,10,27,0,9,0,37,0,make seafood stew warm every heart
1,2,2,37,2,6,0,39,0,make norway world's happiest country?
1,1,11,43,0,10,0,54,0,dad shut videobombing daughter dancing
1,1,11,41,0,10,0,52,0,amy schumer amy poehler perfect together emmy
1,1,8,35,0,8,2,43,0,23 people totally nailed black lipstick trend
1,1,3,24,0,2,0,27,0,modern relationship struggle
1,1,7,32,2,5,0,39,0,dylan o'brien's tweet motivational poster
1,3,7,30,0,8,0,37,0,carrie fisher laid rest prozac pill urn
1,2,1,31,1,5,0,32,0,secret history women's football
1,2,12,48,3,14,0,60,0,critic say trump appointee dodge huge tax bill. thats case.
1,1,13,39,1,11,0,52,0,stunning portrait sf make want call frisco
1,1,12,44,0,12,2,56,0,19 fabulous hack make shoe look fit perfectly every time
1,1,11,37,1,10,0,48,0,"stranded mars, vegetable would eat"
1,1,11,46,0,11,2,57,0,19 powerful photo capture havoc wreaked chennai rain
1,2,2,48,1,11,0,50,0,syria conflict: biblical river heart water war
1,1,18,70,1,17,0,88,0,two huge whale wanted hang dude paddleboarded surprisingly cutest
1,3,11,44,5,11,0,55,0,"maher: ill accept garland supreme court, pick stolen"
1,2,11,44,1,13,0,55,0,drill: intern barack michelle obama
1,1,13,36,0,13,4,49,0,four hollywood icon made proud woman 2015
1,1,11,40,0,10,0,51,0,three question tell makeup brand use
1,1,10,30,0,11,6,40,0,24 people failed fuck social medium 2015
1,3,8,35,1,9,0,43,0,help suffering syria's civil war
1,1,8,29,0,8,2,37,0,24 giant salad make feel amazing
1,3,6,30,1,5,0,36,0,politico: hillary clinton running
1,1,12,46,1,11,0,58,0,here's help friend recovering eating disorder
1,3,7,47,0,8,0,54,0,transgender star eligible male female oscar category
1,3,7,68,2,14,0,75,0,jenna jameson: porn star launch anti-muslim rant apparent defence ku klux klan
1,1,13,39,0,11,2,52,0,15 reason north west penelope disick cutest bffs
1,3,9,40,1,8,0,49,0,successful people agree: valuable asset
1,1,5,18,0,4,0,23,0,spooky actually
1,1,10,35,1,10,6,45,0,19 totally amazing body-shaming clap back 2015
1,1,7,27,0,7,2,34,0,25 gift people obsessed ocean
1,1,8,28,0,9,6,36,0,15 bengali thing happened 2015
1,1,9,39,0,9,2,48,0,16 hilarious dieting fail confession way real
1,3,8,28,2,7,0,36,0,american syrah: ever rival pinot noir?
1,1,11,35,2,9,0,46,0,know personality based t.v. show opinion
1,3,10,34,2,8,0,44,0,delingpole: epa scott pruitt get eaten alive fox
1,1,10,34,0,10,2,44,0,19 secret people work office never tell
1,1,18,54,0,17,0,72,0,police officer showed routine call ended falling love puppy
1,1,12,36,0,11,0,48,0,crazy sex tip try based zodiac sign
1,1,12,46,3,11,0,58,0,"couple share house ""unicorn"" beyond adorable"
1,1,13,59,1,13,4,72,0,scientist discover new specie bat that's actually collection since 1983
1,1,11,29,0,7,0,40,0,shia labeouf gif match zodiac sign
1,1,15,48,0,14,0,63,0,good samaritan gave shirt back cold shivering stranger
1,3,3,44,0,10,0,47,0,new star war episode title mean think
1,1,11,43,0,11,2,54,0,17 vine prove mashups never longer six second
1,1,9,23,0,8,0,32,0,like lana del rey halsey
1,1,9,34,0,8,0,43,0,george amal clooney adopted cutest dog ever
1,1,9,23,0,8,0,32,0,guess age based apps
1,1,9,27,0,9,2,36,0,21 time mall failed hard failed
1,2,5,16,1,4,0,21,0,gm food cultivating fear
1,3,19,45,3,11,0,64,0,exclusive trump single dating site let trump supporter find love online
1,1,14,55,0,13,0,69,0,lady gaga support paris attack victim stepping french flag colour
1,1,10,39,0,9,0,49,0,identify skate logo teenage year
1,1,12,42,0,11,0,54,0,video beautifully show difficult read lip
1,2,5,55,0,11,0,60,0,kansa lawmaker compared planned parenthood nazi death camp
1,1,14,40,0,13,0,54,0,tried living like ina garten week become better spouse
1,2,18,66,6,18,0,84,0,"donald trump get royally trolled man 'really makes' iphones honest, hilarious"
1,1,12,41,0,11,0,53,0,three bold lip color look like six different skin tone
1,1,16,50,1,15,0,66,0,cop took care sick woman's five child went hospital
1,1,12,36,2,10,2,48,0,read charming letter david bowie sent 14-year-old fan
1,2,2,54,2,8,0,56,0,traditional cure threatening myanmar's wildlife picture
1,1,7,23,1,6,2,30,0,21 cat sway non-believers
1,3,3,62,1,13,0,65,0,photo earth peaking saturn's ring make feel small
1,2,11,54,0,12,0,65,0,horrifying video show teen jumping death snapchat stunt gone wrong
1,1,8,23,0,8,2,31,0,21 squirrel need back eff
1,3,9,49,0,8,0,58,0,marathon investigator derek murphy reveals catch cheater
1,1,7,19,1,6,0,26,0,anchor e! news
1,1,13,55,1,12,0,68,0,everyone who's watched parent freak company arrives
1,1,6,26,0,6,1,32,0,9 comeback feminist would proud
1,1,10,31,0,9,0,41,0,epic netflix chill story ever
1,1,10,30,0,10,2,40,0,13 thing think next time say sorry
1,1,12,32,2,11,0,44,0,"cast ""how single"" debunk dating rule"
1,1,7,29,4,6,2,36,0,"28 flower-inspired baby name ""rose"""
1,1,13,56,0,12,0,69,0,california city change name san bernardino bernie sanderino dream
1,1,10,34,0,10,2,44,0,15 penis horror story make want vomit
1,1,7,37,0,6,0,44,0,pretty little liar quote motivational poster
1,1,18,57,1,17,0,75,0,made friend wear left shark costume entire super bowl here's happened
1,1,14,48,1,13,0,62,0,paris hilton's phone case greatest phone case ever protect phone
1,1,10,35,0,9,0,45,0,super hot doctor cat pure purrfection
1,1,15,56,1,14,0,71,0,"tiger cub found roaming street southern california, search owner"
1,1,13,46,1,12,0,59,0,open letter anyone who's ever tweeted anything mean rock
1,1,14,47,0,14,2,61,0,asked 25 non scot react scottish thing deeply hilarious
1,1,10,36,0,9,0,46,0,diverse world london seen bus window
1,1,8,43,1,7,2,51,0,23 wildly entertaining wedding-night story real people
1,1,9,28,0,8,0,37,0,pizza ring party food deserve
1,1,9,33,1,10,4,42,0,33 beautiful thing home cost less $40
1,2,11,40,2,11,0,51,0,county flipped obama trump. voter feel now?
1,1,9,38,3,9,2,47,0,"10 reason we're psyched renewal ""scream queens"""
1,1,7,26,2,6,0,33,0,what's laziest thing ever done
1,1,7,29,0,6,0,36,0,really happened favorite band
1,1,13,50,2,12,0,63,0,"joss whedon, tim burton, anne rice appearing vampire documentary"
1,2,2,43,0,9,0,45,0,girl scout take mantle truth advertising
1,1,11,36,4,9,0,47,0,"here's need know ""color-melting"" hair"
1,3,9,42,1,9,0,51,0,"sage northcutt, max holloway go ham houston rocket mascot"
1,3,5,86,2,22,0,91,0,spot what's wrong photo? image six woman sofa leaf internet state confusion
1,2,8,54,1,10,1,62,0,arkansas face another hurdle upcoming 8 execution finding witness
1,1,9,35,0,9,2,44,0,21 crockpot soup guaranteed help brave cold
1,1,9,37,2,8,0,46,0,what's best family halloween costume ever
1,1,6,32,0,6,2,38,0,12 presidential candidate dog twin
1,3,5,50,2,11,1,55,0,logan: ryan reynolds seen wolverine 3 think it'll win oscar
1,1,10,42,0,9,0,52,0,worried golden retriever thought lost teddy bear
1,1,8,45,1,7,2,53,0,27 thing kid russian-speaking household understand
1,1,10,44,0,9,0,54,0,look beautiful haunting photo african wildlife
1,1,11,31,4,11,1,42,0,"remember woman lou bega's ""mambo no. 5"""
1,1,9,41,0,9,2,50,0,26 instagram account give guy serious style goal
1,3,8,36,1,11,0,44,0,luke skywalker want see end jedi?
1,1,15,58,3,14,0,73,0,"someone calculated much money jim spent pranking dwight ""the office"" crazy"
1,1,9,31,0,9,2,40,0,33 impossibly cute way cover body book
1,1,13,53,1,12,0,66,0,taylor swift's birthday message ed sheeran probably cutest thing ever
1,1,9,30,2,9,2,39,0,10 rare pepe gift prove normie
1,1,10,30,0,9,0,40,0,people need uzo aduba life
1,1,8,39,4,6,2,47,0,"13 creepy behind-the-scenes photo ""edward scissorhands"""
1,3,13,58,0,12,0,71,0,udya chopra royally trolled twitter comparing fairness cream hair colour
1,2,6,34,0,7,0,40,0,lola cat survives migrant crossing italy
1,1,12,34,2,11,0,46,0,know get new iphone? take quiz
1,1,9,29,0,8,4,38,0,favorite reality tv moment 2015
1,1,7,35,0,6,0,42,0,ultimate superman moral decision making quiz
1,1,14,35,0,13,0,49,0,need help bob saget decide get lasik
1,1,8,36,0,8,2,44,0,23 situation everyone grew shy understand
1,1,13,34,0,12,0,47,0,bunch woman wore pant emmy perfect
1,3,3,52,2,12,0,55,0,destination go colombia late
1,1,10,46,0,10,2,56,0,21 chocolate booze combination better valentine
1,2,5,29,1,6,2,34,0,trump approval rating jump 50 percent
1,1,10,47,2,8,0,57,0,"ellen degeneres hilariously scared selena gomez ""taylor swift"""
1,1,8,32,0,7,0,40,0,american try canadian candy first time
1,1,8,37,2,7,0,45,0,what's comfiest halloween costume ever worn
1,1,7,27,1,8,6,34,0,29 emo song thought since 2007
1,2,2,49,3,10,0,51,0,family hostage told keep quiet. shouldnt.
1,3,5,24,1,5,4,29,0,world's ethical company 2017
1,1,11,35,2,10,0,46,0,here's make birthday cake ever need
1,1,9,23,0,9,1,32,0,9 thing know wear bra
1,1,11,40,1,10,0,51,0,mumbai musician's new song new favourite jam
1,2,14,49,1,13,0,63,0,marine response daughter asking pride flag sotouching
1,1,13,52,0,12,0,65,0,jennifer aniston justin theroux make red carpet debut husband wife
1,2,9,25,2,9,2,34,0,"15 sign are, without doubt, target mom"
1,1,15,39,6,14,1,54,0,"9 year since j.t. died ""degrassi"" we're still"
1,1,11,36,1,11,2,47,0,23 reason luke cage marvel bae we've waiting
1,3,12,31,1,11,0,43,0,pretend write book well guess old
1,1,6,29,1,6,2,35,0,"35 awesome reason visit denver, colorado"
1,1,14,51,2,12,0,65,0,made mouth-watering pasta six way going instantly crave pasta
1,2,7,35,2,6,0,42,0,here boob arent perfectly symmetrical
1,1,7,34,2,6,0,41,0,chelsea handler (probably) never get married
1,1,4,21,0,3,0,25,0,american try mincemeat pie
1,1,9,53,0,9,2,62,0,20 painfully honest confession woman polycystic ovary syndrome
1,1,17,59,2,16,0,76,0,"teaching daughter's hair, single dad started class teach others"
1,1,12,35,0,12,2,47,0,11 thing right make winter feel less awful
1,1,10,39,2,9,0,49,0,what's funniest reason cried period
1,1,7,24,1,6,0,31,0,hardest food quiz ever take
1,1,11,42,0,10,0,53,0,broadway musical see based birth month
1,1,7,30,1,6,2,37,0,47 lazy-girl beauty hack everyone know
1,1,10,27,0,9,0,37,0,people go therapy want know
1,1,12,38,1,10,0,50,0,clip-on man bun absolutely must stopped
1,2,6,54,2,11,1,60,0,6 usb-c accessory let new macbook actually connect stuff
1,1,7,26,0,7,4,33,0,much actually remember 2006
1,3,9,41,0,10,0,50,0,airline swim cash leave airport worker high dry
1,2,16,46,2,15,0,62,0,"here's chai really is, settle score tea"
1,2,12,39,2,12,2,51,0,"19 tweet dog funny, pure, goddamn true"
1,1,9,35,0,10,6,44,0,16 indie song early 2000s totally forgot
1,1,5,17,0,4,0,22,0,sex attractive
1,1,9,35,0,8,0,44,0,woman found freedom going braless entire week
1,2,3,53,2,9,0,56,0,simple truth: coal-fired generator future australia
1,2,14,49,3,12,0,63,0,report: court document show fbi used best buy geek squad gather evidence
1,1,9,31,0,9,2,40,0,12 powerful science photo week
1,1,13,51,1,12,0,64,0,elle may changed women's magazine game february cover
1,1,8,39,0,8,2,47,0,26 cat working towards destruction patriarchy
1,2,10,37,4,9,0,47,0,forget wine. china's booze market liquid cake
1,3,11,41,0,11,2,52,0,28 teeny tiny gift prove good thing come small package
1,1,11,38,0,10,0,49,0,know favorite disney song based birth month
1,1,11,39,5,11,1,50,0,"here's everything know ""game thrones"" season 6 (so far)"
1,1,13,35,0,12,0,48,0,lauren conrad redhead look good hurt
1,1,9,38,1,9,2,47,0,19 tweet relationship cute vomit
1,2,5,71,3,16,0,76,0,"rank outsider seized white house. defend constitution, trample it?"
1,1,7,19,0,6,0,26,0,feminist meninist
1,1,8,40,0,8,1,48,0,7 inanimate object actively plotting u
1,3,6,43,1,8,2,49,0,kellogg shutter 39 distribution center layoff loom
1,1,6,25,0,7,6,31,0,37 important puppy picture 2015
1,1,14,36,1,11,0,50,0,wtf fuck going harry styles' trouser right
1,1,13,18,0,7,0,31,0,much really know cake
1,2,9,39,0,9,2,48,0,51 picture guaranteed make every teacherlaugh
1,1,3,16,2,2,0,19,0,"""learning"" blackness"
1,1,7,32,1,8,6,39,0,24 iconic moment craig david's instagram 2015
1,1,10,33,0,9,0,43,0,badass witch based birth month
1,2,1,38,0,8,0,39,0,newly found planet could right life
1,1,10,37,1,9,0,47,0,what's embarrassing thing dad ever done
1,2,7,41,1,9,0,48,0,dwyane wade compare game jimmy butler lebron james'
1,1,7,25,0,7,2,32,0,11 beautiful fucking baby name made
1,3,20,43,2,10,0,63,0,fake news: cnbc cite left-wing politifact clinton russian uranium story
1,3,5,21,0,5,0,26,0,teen nearly blinded hair dye
1,2,11,37,0,11,2,48,0,21 thing know prefer dirty eating cleaneating
1,2,9,51,2,10,0,60,0,official: millennial driver reckless behind wheel
1,2,1,41,0,6,0,42,0,brutal dictatorship world keep ignoring
1,1,15,52,0,14,0,67,0,first time someone asked julia robert autograph toilet
1,1,9,33,1,8,0,42,0,"dang, two celeb couple filed divorce"
1,1,9,41,1,7,0,50,0,dj khaled's snapchat caption motivational poster
1,1,17,48,0,16,0,65,0,rock put one puppy sleep ate poisonous mushroom
1,3,2,75,2,15,0,77,0,researcher discovered caveman cleaned teeth. make want brush yours.
1,1,15,51,0,14,0,66,0,watch pup hilariously call sister leaving mess kitchen
1,1,10,41,1,10,2,51,0,"well know random, 16th century flemish proverb"
1,1,12,50,1,11,0,62,0,katy perry sang allison williams' wedding tom hank officiated
1,1,12,32,1,11,0,44,0,emily blunt fan john krasinski's hot new bod
1,3,8,34,2,8,2,42,0,faked news: guide 22 post-election hate hoax
1,1,9,46,1,8,0,55,0,people criticizing victoria's secret photoshop fail
1,1,10,39,1,9,0,49,0,puzzle everyone remember last night
1,2,4,40,2,8,0,44,0,'fresh prince' blue cover would make uncle phil proud
1,3,1,53,0,10,0,54,0,beer garden best place finally welcome spring
1,3,3,64,0,12,0,67,0,man rare genetic condition apert syndrome speaks becoming meme
1,3,8,30,2,8,2,38,0,"22 hilarious picture make go ""same"""
1,1,9,27,0,9,2,36,0,21 thing never say skinny girl
1,2,4,50,1,10,0,54,0,"salt bae voted, definitely deserves new photoshop battle"
1,3,10,42,1,10,2,52,0,23 accidental google image search thatll make pee alittle
1,1,8,26,0,8,2,34,0,18 way avoid holiday blue year
1,1,11,39,0,11,2,50,0,19 picture teach something life
1,1,7,22,1,6,0,29,0,here's easy way make jambalaya
1,1,9,34,0,9,2,43,0,16 picture way real sale associate
1,1,6,33,1,6,1,39,0,adorable animal advent calendar: december 5
1,1,10,38,0,8,0,48,0,ellen degeneres dressed kardashian halloween
1,3,4,40,0,7,0,44,0,milo yiannopoulos pretty rough president day
1,2,15,58,5,13,0,73,0,"czech president spokesman: trump protects country, exactly eu elite"
1,1,15,42,1,14,0,57,0,tell u zodiac sign we'll guess went bed last night
1,1,11,32,0,11,2,43,0,21 way cover home picture cat
1,3,14,43,2,11,0,57,0,samantha bee mock brain cancer patient cpac nazi hair
1,1,13,47,1,11,0,60,0,handy color chart burger king-induced green poop
1,1,15,62,1,14,0,77,0,dude asked natalie dormer feel looking like kermit frog's girlfriend
1,1,11,40,3,10,0,51,0,"there's new character named linkle upcoming ""zelda"" game"
1,1,6,27,0,5,0,33,0,sister tell worst fight story
1,1,12,37,1,12,4,49,0,what's gorgeous quote 2015 book read year
1,1,8,38,0,8,2,46,0,15 word mean something entirely different woman
1,3,18,71,0,17,0,89,0,chennai lad make forbes super achiever list invention save newborn jaundice
1,2,1,70,1,12,0,71,0,newscaster's terrified reaction u getting caught daydreaming work
1,3,10,60,4,9,0,70,0,"donte stallworth: athletes, actor precisely lead political discussion"
1,1,7,20,0,6,0,27,0,hair say
1,1,10,38,3,8,0,48,0,"gender-swapped ""harry potter"" would really look like"
1,1,8,23,0,8,2,31,0,23 gift clean freak life
1,2,7,21,0,6,0,28,0,flatter belly one move
1,1,14,54,1,13,2,68,0,lea salonga 33 epic filipino-americans got together big family photo
1,1,7,27,0,7,2,34,0,17 time shonda rhimes ruled damn world
1,1,13,49,1,12,0,62,0,"grab earphones, need hear magical cappella disney medley"
1,1,8,39,0,8,2,47,0,32 cute thing distract awkward thanksgiving
1,1,11,48,3,10,0,59,0,here's look illustration inside jason segel's children's book
1,3,5,75,1,18,0,80,0,"send bern unit, bernie sander poured hot fire bern sauce trump twitter"
1,1,10,30,0,9,0,40,0,fab drab celebrity look week
1,3,11,69,1,14,5,80,0,"judge considers ordering president donald trump double 50,000 refugee inflow united state"
1,1,7,32,1,8,4,39,0,23 thing '00s green day fan desperately wanted
1,1,10,29,0,10,2,39,0,44 brunch recipe make home save cash
1,3,3,64,2,15,0,67,0,"president iceland can't ban pineapple pizza, even wanted list"
1,3,8,39,1,8,2,47,0,21 amazingly gross product want buy immediately
1,3,8,33,2,11,4,41,0,"insecure, oj night of: tv tackled race 2016"
1,3,1,56,0,13,0,57,0,career fast food could make richer becoming lawyer
1,3,13,51,1,13,0,64,0,chocolate cheese quiz reveal next boyfriend belike
1,1,15,44,1,14,0,59,0,kris jenner got pie face knowing north west's middle name
1,3,4,26,0,8,4,30,0,ranking top 20 player sweet 16
1,1,9,25,1,10,4,34,0,27 gift $50 sea witch life
1,1,8,21,0,8,2,29,0,16 cat confused
1,2,11,59,1,10,0,70,0,police: facebook live murder suspect steve stephen killed pursuit
1,3,19,58,1,18,0,77,0,"sunil grover hit kapil sharma, milind soman swim dead sea ent world"
1,1,9,36,0,9,2,45,0,29 product anyone actually disney princess
1,2,11,39,2,10,0,50,0,people making meme trump person theyear
1,1,5,26,0,5,2,31,0,27 hilarious tweet donald trump
1,2,13,33,6,7,0,46,0,"mafia eu: farage blast bloc vindictive, nasty demand"
1,2,6,38,0,6,0,44,0,scientist make doomsday clock announcement video
1,2,2,49,2,11,0,51,0,"europe, creating post-gender world one small rule time"
1,1,7,22,0,7,2,29,0,18 pet damn respect book
1,1,10,42,0,10,2,52,0,21 spectacular place people love fall color must visit
1,1,9,34,0,9,2,43,0,42 movie talking award season
1,2,2,46,1,8,0,48,0,mcdonald's give consumer break today frozen meat
1,1,12,37,0,12,2,49,0,17 way squeeze little extra storage tiny kitchen
1,1,6,27,4,5,0,33,0,"what's funniest ""bob's burgers"" moment"
1,3,7,34,1,7,2,41,0,42 celebrity supporting womensmarch
1,1,10,39,1,9,0,49,0,food test determine really florida
1,1,7,37,0,6,0,44,0,daughter pranked parent tattoo
1,3,1,46,0,8,0,47,0,trump pick fossil fuel ally head environment agency
1,2,2,53,0,11,0,55,0,pilot walked away plane crash nose first maine highway
1,3,12,42,3,12,0,54,0,dhs secretary john kelly: marijuana factor drug war
1,1,10,21,1,9,0,31,0,here's roast leg lamb eid
1,1,8,26,2,8,2,34,0,"24 thing ""harry potter"" fan agree"
1,1,7,32,0,7,2,39,0,25 photo meat eater never understand
1,1,12,38,0,11,0,50,0,south vacay based zodiac sign
1,2,10,46,2,9,0,56,0,chef roast diner left note calling christmas music 'offensive'
1,2,1,61,3,10,0,62,0,"goodbye, geek glasses: aviator season biggest eyewear trend"
1,1,8,41,0,7,0,49,0,test random knowledge themeless crossword
1,2,3,48,1,10,0,51,0,here's reason united airline kick flight
1,3,1,59,1,10,2,60,0,17 incredibly useful google product service know existed
1,2,5,15,0,5,0,20,0,sex doll talk back
1,2,2,35,3,7,0,37,0,pakistan's bloody week: really blame?
1,3,14,34,0,14,4,48,0,take look biggest name music rang 2017
1,1,11,32,0,11,2,43,0,21 tweet funny anyone sister
1,1,11,49,0,10,0,60,0,photo could prove kardashians forgiven scott caitlyn
1,1,8,38,0,7,0,46,0,illustration speak anyone anxiety
1,1,8,32,0,8,2,40,0,17 snack convincing impression fry
1,1,7,22,0,6,0,29,0,girl try tinder first time
1,1,7,23,0,6,0,30,0,confession one got away
1,2,3,16,0,3,0,19,0,tuesday briefing
1,2,19,54,3,17,2,73,0,11-year-old girl dog heroically save mother goat baby dying snow!
1,3,8,39,0,8,2,47,0,19 extremely relatable moment chinese datingshow
1,1,9,34,0,8,0,43,0,made greeting card upstairs neighbor
1,1,11,34,0,10,0,45,0,started therapy could take better care
1,1,5,18,0,4,0,23,0,percentage dog
1,2,2,49,3,9,2,51,0,there's secret message buried inside nintendo's new $60 console
1,3,1,46,2,9,6,47,0,"alexandria sheriff, 59, chase murder suspect honored 2015"
1,1,9,29,2,8,0,38,0,"doctor ""doctor who"" best look"
1,1,8,28,0,7,0,36,0,people attracted
1,1,8,36,1,8,2,44,0,24 tweet college actually make laugh
1,3,0,37,1,6,2,37,0,18 life-saving fact everyone know
1,1,6,27,0,6,2,33,0,15 brilliant take macaroni cheese
1,2,13,52,2,11,0,65,0,eu court allows ban headscarf 'religious symbols' workplace
1,1,14,33,0,13,0,47,0,new mom woke coma heard baby cry
1,1,10,37,1,10,2,47,0,17 gift know scully's given mulder birthday
1,1,8,23,0,8,2,31,0,41 song need life month
1,3,6,79,2,14,0,85,0,second disaster: nail-biting photo around world capture moment impact
1,2,1,57,3,12,0,58,0,"young boy, devastating brain tumor parent anything"
1,3,9,29,1,8,0,38,0,house plant least likely kill?
1,1,6,34,0,6,2,40,0,19 thing indecisive people understand
1,1,9,32,0,8,0,41,0,know gender based five question
1,3,9,33,2,9,0,42,0,"take much smoking kill you, study find"
1,3,4,56,2,16,2,60,0,"inventor red solo cup, robert leo hulseman, died age 84"
1,1,6,27,0,5,0,33,0,sex toy match personality
1,1,15,17,2,10,6,32,0,"28 wtf, lol, omg viral video 2015"
1,1,6,17,0,5,2,23,0,15 people christmas af
1,1,10,39,1,9,0,49,0,name every one terry pratchett's discworld book
1,3,6,19,3,7,6,25,0,10 best r&b song 2016: critic's pick
1,3,2,59,0,12,0,61,0,engineer rigged device let control netflix mind
1,1,8,33,0,8,2,41,0,27 small yet crucial life lesson internet
1,1,11,50,3,9,2,61,0,22 behind-the-scenes photo backstage victoria's secret fashion show
1,1,9,33,0,9,2,42,0,31 elf shelf idea guaranteed win christmas
1,2,7,26,1,7,2,33,0,29 cat friggin holidaymiracle
1,1,12,53,0,10,0,65,0,macaulay culkin revealed kevin mccallister actually like today
1,1,7,23,0,7,4,30,0,favorite animal 2016
1,3,3,45,2,8,0,48,0,cat dad answer childrens growing unhappiness?
1,1,15,44,0,13,2,59,0,55 carly rae jepsen lyric definitely say new crush
1,1,10,36,0,10,2,46,0,11 robot certainly rise destroy human
1,2,3,36,4,8,0,39,0,d.c. activity fun youre high?
1,3,2,59,0,10,2,61,0,21 victorian christmas card suggest ancestor deeply weird
1,1,12,40,2,11,0,52,0,"minor character ""the office"" look like"
1,1,13,35,0,12,0,48,0,many iconic song time heard
1,1,8,26,0,8,2,34,0,23 vegan recipe need try autumn
1,2,15,51,1,13,0,66,0,two place india already living pm modi's dream cashless economy
1,2,10,41,3,9,0,51,0,best oscar dress youve probably never seen [video]
1,1,9,36,0,9,2,45,0,16 time eddie redmayne magical human alive
1,1,12,41,0,11,0,53,0,blue jay player date based zodiac sign
1,1,10,43,0,10,2,53,0,25 delightfully cozy gift anyone hate leaving house
1,2,9,54,1,13,0,63,0,dying man's last request cigarette glass wine granted hospital
1,1,9,34,0,8,0,43,0,taylor swift song actually life
1,1,9,43,1,9,1,52,0,1 terrible photoshop regis philbin princess leia's bikini
1,1,13,43,0,12,0,56,0,tried edible body paint grosser ever imagined
1,3,9,42,1,8,2,51,0,17 life-changing beauty product worth investment
1,1,8,20,0,7,0,28,0,make friend adult
1,3,4,28,1,5,0,32,0,obama really wiretap trump towers?
1,1,12,35,0,11,0,47,0,site show david bowie age
1,1,10,40,0,9,0,50,0,adele song perfectly sum miserable love life
1,1,9,34,0,9,2,43,0,21 time tumblr knew better knew
1,1,5,11,0,4,0,16,0,water bear
1,1,12,48,0,11,0,60,0,everyone fit slytherin hufflepuff house
1,1,13,40,2,11,2,53,0,17-year-old syrian refugee brought puppy way greece
1,1,9,34,2,9,3,43,0,"cast ""zoey 101"" basically dropped bombshell"
1,1,11,32,3,10,0,43,0,"feast eye really cute ""mr. robot"" gag reel"
1,1,18,48,1,18,2,66,0,27 thing eat social anxiety want talk anyone party
1,1,12,47,0,11,0,59,0,dad working baby prove fitness forever
1,1,7,32,0,6,0,39,0,breakfast food match zodiac sign
1,3,8,24,1,7,0,32,0,guess tall boyfriendis?
1,1,11,44,5,9,2,55,0,"13 magical ""harry potter""-inspired gift s.o. positively love"
1,1,8,36,0,7,0,44,0,cheesy brisket totchos ultimate snack
1,3,12,47,2,10,0,59,0,might prettiest harry potter-themed wedding ever see
1,3,12,62,1,11,0,74,0,harvard student inspiring facebook post jayalalithaa going crazy viral
1,3,11,44,1,10,0,55,0,jimmy kimmel burn jared kushner's foreign policy cred one line
1,1,7,31,0,7,2,38,0,29 playlist listen everything suck
1,1,12,49,1,10,0,61,0,meet pakistani-american artist taking stand normalise body hair
1,1,10,38,0,10,2,48,0,25 recipe prove bacon true star thanksgiving
1,1,7,45,2,7,2,52,0,"24 time ""arrested development"" perfectly described final week"
1,1,10,42,2,10,2,52,0,"10 iconic session ""carpool karaoke"" james corden"
1,1,10,29,0,8,0,39,0,watch shia labeouf watch movie
1,1,7,25,2,6,0,32,0,"remember lyric ""thriller"""
1,2,7,56,3,10,0,63,0,abc news quiz: trump's tax weatherill's slanging match frydenberg
1,1,11,53,0,10,0,64,0,amy schumer instagramming perfect response unwanted text
1,1,7,21,0,7,2,28,0,21 dog know exactly
1,1,10,32,0,9,0,42,0,well know periodic table element
1,1,9,34,1,9,2,43,0,19 thing need mildly obsessed stuff
1,3,7,32,0,7,2,39,0,23 quiz people totally obsessed food
1,1,9,28,0,9,2,37,0,27 reason paris capital world
1,1,8,19,1,7,2,27,0,50 creepiest place u.s
1,1,10,37,1,9,0,47,0,guess one direction's niall horan laughing
1,3,11,33,2,8,4,44,0,optimism among u.s. ceo show biggest increase since 2009
1,1,7,28,0,7,2,35,0,21 time tumblr got really awkward sex
1,1,9,15,0,6,0,24,0,well know hbo show
1,1,18,53,4,17,0,71,0,"remember lyric ""welcome tipton"" ""the suite life zack cody"""
1,1,19,54,0,18,0,73,0,cute kid hooked lie detector test front santa adorable
1,1,10,40,1,10,2,50,0,25 thing kylie jenner instagram people can't
1,1,10,44,0,10,2,54,0,15 wash day struggle woman natural hair understand
1,3,2,60,2,13,0,62,0,"azar chatroulette back dead, going viral nose"
1,1,6,18,0,7,6,24,0,30 moment made u proud 2015
1,1,9,25,0,8,1,34,0,teen tried text using t9 hated life
1,1,12,35,0,11,0,47,0,people tried goth week fucking epic
1,1,11,48,0,11,2,59,0,21 makeup tutorial help recreate iconic music video look
1,2,7,40,1,7,5,47,0,"facebook target 30,000 fake french account election"
1,2,9,47,4,9,1,56,0,"watch full pre-credits 'deadpool 2' teaser, courtesy ryan reynolds"
1,1,9,37,4,8,0,46,0,"sam smith's cover drake's ""hotline bling"" everything"
1,3,9,55,2,11,0,64,0,climate violence: stephen colbert depicts stephen miller head spike
1,2,7,33,5,8,1,40,0,ra-ra-ah-ah-ah: 7 best lady gaga song karaoke
1,2,12,44,4,9,0,56,0,msnbcs nance: trump pushing nation constitutional crisis
1,1,6,29,0,5,0,35,0,starbucks holiday beverage
1,1,10,35,2,10,2,45,0,"29 christmas present ""twin peaks"" fan life"
1,1,7,36,0,6,0,43,0,phoebe buffay quote motivational poster
1,1,10,26,0,10,4,36,0,know love life look like 2016
1,1,10,39,2,9,0,49,0,know exactly break new year's resolution
1,3,9,40,3,9,0,49,0,test ahead brazil president: quicktake q&a
1,1,7,29,0,6,0,36,0,people try chatroulette first time
1,1,12,36,2,11,0,48,0,hinds: lesson cool spain's new face garage rock
1,3,9,27,2,8,0,36,0,"""my child required share yours"""
1,3,5,68,2,16,0,73,0,'things ambien' subreddit wild ride sleepy trip snapchat funtimes
1,1,8,35,0,8,2,43,0,21 sign prove bookseller absolute best
1,1,9,33,2,9,1,42,0,"$1 trick help get amazing, even eyebrow"
1,3,1,55,1,12,4,56,0,"india gripped fictional girl, search trend 2016 reveal"
1,1,5,21,0,5,2,26,0,20 text require response
1,3,3,33,4,7,2,36,0,"bolivia's san pedro 'tourist prison', 20 year"
1,3,8,37,0,8,0,45,0,desiigner debut new haircut twitter going
1,1,8,28,1,7,0,36,0,said it: tyrion lannister ron swanson
1,1,9,28,1,9,2,37,0,"14 thing never, ever say lesbian"
1,1,10,29,3,9,0,39,0,"kesha's hyped guest star ""jane virgin"""
1,3,10,49,2,9,2,59,0,15 thing give every tender-headed black girl instant flashback
1,1,6,31,1,5,0,37,0,italian review europe's popular beer
1,1,12,44,1,12,2,56,0,13 way prove way interesting stupid super bowl
1,1,9,33,0,8,0,42,0,find dessert bake weekend
1,1,10,33,3,10,2,43,0,"guess song adele's ""25"" emojis"
1,1,8,25,2,7,2,33,0,19 thing make sense non-twins
1,1,16,26,1,11,2,42,0,35 celebrity photo see tv mtv emas
1,1,7,23,0,6,0,30,0,actually prefer dude dog
1,1,8,27,0,7,0,35,0,family facebook need hear
1,1,11,40,0,11,2,51,0,24 hilarious tweet mom make laugh loud
1,1,15,32,3,14,4,47,0,"$1,000 month rent would get around u.s"
1,1,9,39,0,9,2,48,0,27 superhero tweet guaranteed make laugh every time
1,1,15,57,0,16,2,72,0,picture matthew perry courteney cox everyone talking 10 year old
1,3,15,56,1,14,0,71,0,reason aaron finch dropped clash mumbai indian shock you!
1,2,10,52,0,9,0,62,0,steve bannon leaf national security council susan rice takedown
1,1,11,20,0,6,0,31,0,pitch story buzzfeed lgbt
1,3,9,32,2,8,0,41,0,gun control movie miss sloane bomb box office
1,2,2,72,3,9,0,74,0,"anti-ageing breakthrough: reprogramming body could extend lifespan, say scientist"
1,1,4,18,1,3,0,22,0,trainspotting: v
1,1,7,29,0,7,2,36,0,17 time pacey witter made heart flutter
1,1,10,44,0,9,0,54,0,problem caitlyn jenner bigger beauty standard
1,1,7,37,0,6,0,44,0,historical decade actually match style
1,1,13,47,2,12,0,60,0,"alice ""alice wonderland"" worst disney character time"
1,3,3,66,1,11,5,69,0,"current former player congratulate dirk nowitzki reaching 30,000 career point"
1,1,12,36,0,12,2,48,0,watch man react modern world 44 year prison
1,1,9,42,0,9,2,51,0,18 german shepherd puppy need snuggled immediately
1,1,8,30,0,8,2,38,0,15 people got dumped really terrible way
1,3,2,45,1,9,0,47,0,young thug's airport rant reveals misogynist dress
1,2,3,27,0,5,0,30,0,car fall los angeles sinkhole
1,2,2,34,2,5,0,36,0,strongest (and weakest) american city
1,3,3,73,4,13,0,76,0,someone tried attack 'liberals' picture. immediately regretted it. list
1,1,17,45,1,14,0,62,0,can't stop looking dashing silver fox appeared ndp rally
1,3,5,52,2,10,0,57,0,need binge-watch carrie fisher's final tv show immediately
1,1,11,40,0,10,0,51,0,look thanksgiving way watching
1,1,11,36,0,10,0,47,0,know date based netflix choice
1,3,1,45,1,12,1,46,0,businesswoman year 5 day shared house
1,3,1,23,1,3,0,24,0,feminism killing romance?
1,2,6,36,1,8,0,42,0,e ink unveils world's largest epaper display ce
1,1,11,31,0,8,0,42,0,stock photo represents work bff
1,1,9,42,1,9,2,51,0,23 thing probably say someone depression
1,1,10,36,0,9,0,46,0,security state look like manhattan
1,1,10,43,0,9,0,53,0,stranger kiss blindfolded guess look like
1,1,13,57,0,12,0,70,0,reese witherspoon called hollywood ageism sexism beautiful
1,2,9,24,3,6,0,33,0,career advice hbo's 'big little lies'
1,2,8,44,0,10,0,52,0,teen threw newborn window sentenced probation
1,1,11,37,0,11,2,48,0,22 celebrity dog dad cat lady warm heart
1,1,11,38,0,11,2,49,0,19 reason keep calm carry must stopped forever
1,1,5,20,0,5,2,25,0,22 thing single people get
1,1,11,45,2,11,2,56,0,"18 reason rose tyler undeniably best companion ""doctor who"""
1,2,9,51,3,9,0,60,0,obama deploying dozen-strong team keep tab trump administration
1,1,8,22,0,7,0,30,0,would make keating five
1,1,11,37,1,11,2,48,0,19 picture real can't pay attention
1,3,1,32,2,8,0,33,0,"young, gifted, cut stupid war"
1,1,13,42,2,11,0,55,0,tried spicest curry dish l.a. instantly regretted
1,3,3,65,1,10,0,68,0,white house staffer's tweet calling primary challenge open republican rift
1,1,12,37,2,11,0,49,0,"character ""the suite life zack cody"""
1,1,8,38,0,8,2,46,0,21 thing tim hortons employee secretly wished knew
1,1,6,12,1,4,0,18,0,j.lo song
1,2,4,27,0,4,0,31,0,arsenal need zlatan ibrahimovic
1,3,9,38,0,9,2,47,0,22 thing vagina want know masturbation
1,3,1,30,0,8,4,31,0,ugly next big trainer trend 2017
1,1,10,30,2,9,0,40,0,"check cool as worm, christmas tree"
1,2,5,15,2,6,1,20,0,2 way happier -- today
1,1,7,35,0,6,0,42,0,donald trump tweet motivational poster
1,2,9,41,2,10,0,50,0,whats wrong photo melania trump queen rania?
1,2,3,55,0,8,0,58,0,eric holder help investigate uber sexual harassment allegation
1,3,14,63,2,13,0,77,0,"internet expansion could cause earth's orbit fill dangerous space junk, warn expert"
1,1,9,31,1,9,2,40,0,17 easy magic trick blow kids' mind
1,3,2,45,1,9,0,47,0,red light need innovating? car company think
1,1,12,44,2,10,0,56,0,play drinking game spending holiday in-law
1,1,15,53,4,14,0,68,0,"""orange new black"" version ""twas night christmas"" awesome"
1,1,8,29,0,8,2,37,0,26 truly incredible thing ice cream
1,1,10,28,2,6,2,38,0,23 behind-the-scenes moment puppy bowl xii
1,3,1,60,2,11,0,61,0,platinum mining firm tell massacre families: can't afford house
1,1,13,39,0,10,0,52,0,identify footballer leg
1,1,9,22,2,9,4,31,0,year 2010 decade (so far)
1,1,9,37,0,8,0,46,0,much actually know ancient technology
1,1,8,30,0,9,6,38,0,21 incredible way eat ranch dressing 2016
1,1,11,31,1,10,0,42,0,food test prove real new yorker
1,3,8,43,2,7,0,51,0,australian stabbing machine robot help study knife crime
1,1,4,15,1,3,0,19,0,anne hathaway can't win
1,3,2,46,1,12,4,48,0,travel 2017: city country need see
1,1,9,51,1,8,2,60,0,15 picture renaissance woman spectacular gravity-defying boob
1,2,12,35,3,10,0,47,0,pentagon nato: want everyone pay fair share
1,1,12,46,0,11,0,58,0,tattoo artist make literally every person want get inked
1,1,8,35,2,7,0,43,0,"phoebe ""friends"" literally fucking worst"
1,1,16,54,3,15,0,70,0,try make homemade creme egg trouble worth
1,1,8,28,0,8,2,36,0,18 laziest employee ever meet
1,2,2,50,2,8,0,52,0,republican add obamacare confusion new 'repair' pitch
1,1,13,50,0,12,2,63,0,21 supporting tv character might even better main character
1,2,11,41,2,10,0,52,0,reviving law would mean end megabanks: quicktake q&a
1,1,11,32,0,11,4,43,0,know travel 2016 based sign
1,1,9,44,1,9,6,53,0,22 helpful tip completing buzzfeed's 2016 clean eating challenge
1,1,10,32,1,9,0,42,0,kris jenner like kylie got lip done
1,2,6,37,3,11,0,43,0,dash diet proven work. hasnt caught on?
1,3,2,61,3,15,3,63,0,news 38p pint burger less 2: cheapest city earth?
1,1,8,36,0,8,2,44,0,21 thing prove period actually pretty funny
1,1,8,33,0,7,0,41,0,eli manning incredible new nickname
1,3,10,39,2,11,0,49,0,here legal airline kick flight
1,3,4,53,1,12,0,57,0,trump got obama wire tap conspiracy theory? list
1,3,12,53,0,11,0,65,0,bill maher important message people interviewing donald trump
1,1,15,52,1,14,0,67,0,tiny canadian house tiny adorable corgi elevator can't handle
1,1,10,36,0,9,0,46,0,woman discus worst thing texting
1,1,7,25,2,6,0,32,0,"come ""fear walking dead"""
1,1,13,52,0,12,0,65,0,group soldier posed photo breastfeeding child uniform
1,1,11,50,1,10,0,61,0,canadian prairie cracking joke laughably cold
1,3,2,55,4,12,3,57,0,"president trump, here 100 day may ridiculous standard"
1,1,9,34,1,9,2,43,0,19 time ben whishaw proved he's flawless human
1,1,7,27,2,6,0,34,0,what's zodiac sign's ice cream flavor
1,1,15,50,2,13,1,65,0,make photo truck without laughing like 7-year-old
1,2,12,40,2,11,0,52,0,professional cuddler say 'the best job world'
1,1,7,22,0,7,1,29,0,7 sign think name bruce
1,3,12,48,0,11,0,60,0,calming picture test reveal people really like
1,1,6,17,2,6,4,23,0,"version ""1989"" best"
1,1,7,21,0,7,2,28,0,21 time thing got real fast
1,1,9,36,0,9,2,45,0,18 thing real people onychophagia
1,1,17,56,0,16,0,73,0,need discus kendall jenner flawless human new york fashion week
1,3,2,36,0,9,1,38,0,turn iphone 8 might pretty damn ugly
1,1,8,46,0,8,2,54,0,15 surprising actor unknowingly sparked sexual awakening
1,1,18,45,3,15,0,63,0,"look man play johnny abc's ""dirty dancing"" remake"
1,2,8,27,0,8,2,35,0,21 gift gwyneth paltrow yourlife
1,2,8,60,2,14,1,68,0,fast furious 8 star vin diesel finally comment dwayne 'the rock' johnson feud
1,1,12,31,0,9,0,43,0,literally bunch inspiring gifs rock
1,1,8,31,0,8,2,39,0,19 tweet nintendo make laugh
1,1,8,20,0,8,2,28,0,23 gift need ask year
1,1,9,31,0,8,0,40,0,know colour missing flag
1,1,13,42,3,10,0,55,0,clip perfectly capture difference u.s. u.k
1,1,7,30,1,8,4,37,0,17 early '00s kid show probably forgot
1,1,7,20,0,8,6,27,0,24 sound take back 2004
1,1,13,46,0,14,6,59,0,17 time 2015 cara delevingne annie clark made believe love
1,1,7,38,0,6,0,45,0,michelle tanner quote motivational poster
1,1,7,30,0,6,0,37,0,weird animal match zodiac sign
1,1,12,46,2,11,0,58,0,"still remember happened ""a series unfortunate events"""
1,1,12,44,0,12,2,56,0,14 confession people afraid admit believe god
1,1,10,50,1,6,0,60,0,twitter destroying brian williams #brianwilliamspopestories
1,1,10,44,1,10,2,54,0,"17 thing people really, really love music understand"
1,1,9,34,0,9,2,43,0,15 totally bizarre kind booze actually buy
1,2,1,31,1,9,5,32,0,"fed hike rates, see 3 rate hike 2017"
1,1,8,29,2,7,2,37,0,day 3 buzzfeed's 7-day clean eating challenge
1,2,11,44,2,12,1,55,0,believe woman suing chipotle $2 billion
1,3,3,49,1,8,0,52,0,couple announces pregnancy perfect bob ross-inspired way
1,1,7,24,0,6,0,31,0,well actually match color
1,2,8,30,2,7,0,38,0,megyn kelly discovered 'zone genius'
1,1,5,38,0,5,2,43,0,29 unbelievably cringeworthy teenage fashion fails
1,1,5,23,0,5,2,28,0,25 industrial decor idea rock
1,1,12,39,0,11,0,51,0,vine kid snake sharing lollipop mesmerizing
1,3,13,55,1,12,0,68,0,meet donald trump indonesia: another billionaire want president
1,1,13,38,2,12,0,51,0,"guillermo del toro take ""scary story tell dark"""
1,3,8,39,1,8,0,47,0,woman fight scammer parent money
1,1,8,25,0,8,2,33,0,23 truth old soul relate
1,2,9,75,2,18,0,84,0,pucker up! eight reason kissing good health burning calorie slowing aging
1,1,14,37,0,13,0,51,0,girl trying carry grocery u
1,1,10,28,2,7,0,38,0,brown-eyed parent blue-eyed kid
1,1,9,46,0,9,2,55,0,21 ridiculously cool gift college student never knew needed
1,3,12,53,0,13,4,65,0,watch spice girl emma bunton prank british airway customer red nose day 2017
1,3,3,34,2,7,2,37,0,route 45: inside one obama's favourite diner
1,1,11,34,0,11,2,45,0,29 super cool gift target still time get
1,2,10,33,0,10,1,43,0,7 time french montana put foot mouth
1,3,12,45,4,11,0,57,0,"""fixer upper"" fan helped couple adopt first baby [video]"
1,2,2,35,0,7,2,37,0,leonard fournette 12 pound lighter pro day
1,1,12,40,0,11,0,52,0,look like nicki minaj meek mill actually engaged
1,1,14,53,0,13,0,67,0,indian designer best response shamed wedding dress
1,2,3,55,0,8,0,58,0,mysterious metallic sound mariana trench finally identified
1,1,13,40,0,12,2,53,0,11 haunted hotel uk actually stay halloween
1,3,1,52,0,8,0,53,0,key way millennial homeowner differ generation
1,1,13,35,0,12,0,48,0,somehow shit ton people idea chris pratt
1,1,7,28,1,6,2,35,0,21 must-do thing disneyland halloween
1,3,12,39,1,12,2,51,0,"24 joke everyone internet way, way tooreal"
1,1,8,27,0,8,2,35,0,17 comic tired real
1,2,7,43,1,5,0,50,0,controversial turkish marriage guide allows wife-beating
1,1,13,23,0,9,2,36,0,13 thing ruby rose looked like mtv emas
1,1,10,48,2,10,2,58,0,"17 people seriously misunderstood meaning ""netflix chill"""
1,1,7,31,0,7,2,38,0,20 underrated actor deserve emmy love
1,1,7,32,1,6,0,39,0,chris hemsworth's first instagram post wild
1,1,8,34,0,8,2,42,0,18 text mom definitely sent college
1,3,10,35,2,11,5,45,0,"7 stock move watch 2017: chipotle, armour"
1,1,9,36,1,8,1,45,0,9 sex position spice long-term relationship
1,2,6,22,2,7,0,28,0,snoop dogg next ceo twitter?
1,1,7,20,2,6,0,27,0,"ellen, paige, ellen page"
1,1,10,37,0,9,0,47,0,literally bunch funny tweet celine dion
1,1,8,40,0,8,1,48,0,8 thing nobody tell graduation depression
1,1,14,32,0,13,0,46,0,wore skirt week man happened
1,1,16,53,1,13,0,69,0,here's happened english footballer harry kane labelled nfl team map
1,1,8,32,0,8,2,40,0,26 thing introvert sick tired hearing
1,1,9,41,0,8,0,50,0,changing one letter make halloween candy sound gross
1,1,8,41,0,8,2,49,0,23 time hannah simone absolutely flawless instagram
1,1,8,35,0,8,2,43,0,26 beautiful wedding photo inspire month
1,1,14,56,2,14,1,70,0,"4 question ""gilmore girls"" quiz determine kind coffee drinker"
1,1,12,44,4,9,0,56,0,"marv ""home alone"" sharing behind-the-scenes fact facebook"
1,1,6,30,1,5,0,36,0,celebrities' instagrams myspace
1,3,5,19,0,6,0,24,0,survived sarin gas attack
1,1,10,38,2,9,0,48,0,"first trailer ""independence day"" sequel"
1,1,12,47,0,12,2,59,0,22 disgusting thing people actually put mouth
1,1,5,23,2,4,2,28,0,23 dog who've out-dogged
1,1,13,47,1,13,2,60,0,21 thing know best friend actually grandma
1,1,15,52,3,13,0,67,0,"know favorite ""harry potter"" character based go-to ice cream flavor"
1,1,8,38,1,7,2,46,0,27 thing christmas-obsessed parent need right
1,1,9,38,2,9,2,47,0,21 word truly understand unless miami
1,3,3,43,0,11,0,46,0,week life white house press briefing room
1,1,12,38,2,11,0,50,0,"remember lyric ""time time"" cyndi lauper"
1,1,10,45,1,9,0,55,0,there's instagram account make fun instagram account
1,1,10,50,1,9,0,60,0,guy hilariously obsessing patti labelle's pie everything
1,1,9,32,0,8,0,41,0,pas sunday school test child
1,3,1,50,1,8,0,51,0,lecture child healthy eating
1,2,6,60,5,13,0,66,0,"like everyone 'game thrones,' steve bannon also think 'winter coming'"
1,1,13,39,2,12,0,52,0,here's listen wait fave's next album
1,1,9,36,1,8,0,45,0,kanye west's new fashion collection quite sight
1,1,11,33,2,10,2,44,0,26 breathtaking u.s. sight need see die
1,1,7,18,0,6,0,25,0,star war mean
1,3,13,50,8,14,0,63,0,ann coulter report card president trump first two weeks: give a+++
1,1,11,36,5,10,0,47,0,"disney's ""sleepy hollow"" ""wind willows"""
1,1,6,25,0,6,2,31,0,19 photo make absolutely sense
1,3,2,11,0,4,2,13,0,retire 40
1,1,10,35,0,10,2,45,0,28 tweet dieting make laugh loud
1,1,6,31,0,5,0,37,0,spam comment motivational poster
1,2,8,44,2,13,4,52,0,2015 nba final time cut cute golden state warriors' game
1,1,9,25,1,8,0,34,0,guess age
1,1,10,40,1,9,0,50,0,know valentine's day plan based random question
1,1,10,30,0,9,0,40,0,deserve join rank marauder
1,1,13,52,6,12,0,65,0,"guys, there's mashup called ""hotline bing"" chandler dancing ""hotline bling"""
1,2,8,36,1,9,0,44,0,"meet coach lady gaga, super bowl halftime star"
1,3,13,55,1,12,0,68,0,financial spring cleaning: employee benefit form keep toss
1,1,7,35,0,7,2,42,0,16 customer complaint guaranteed make laugh
1,2,9,48,1,8,1,57,0,paycomvoice: 3 thing employer know wage garnishment
1,1,12,40,1,11,0,52,0,meet san francisco cat helped save suicidal man's life
1,1,14,52,1,13,0,66,0,know spend valentine's day based favourite justin
1,3,16,44,1,15,0,60,0,"woman want taken seriously doctor, one thing"
1,1,16,56,1,15,0,72,0,taraji p. henson perfect reaction caught camera sings
1,1,9,43,2,8,2,52,0,"19 healthier, grown-up version favorite childhood food"
1,2,4,70,2,11,0,74,0,destination inside north korea: fascinating image world's secretive state
1,1,10,41,0,10,2,51,0,31 bride absolutely rocked short hair wedding day
1,1,13,39,0,12,0,52,0,never think pizza way trying dip
1,3,1,37,0,7,0,38,0,best holiday gift serious traveler
1,3,13,55,2,14,4,68,0,dnc deputy chair ellison: obama responsible party failure 2016
1,1,5,16,0,4,0,21,0,rihanna era
1,1,9,34,0,8,0,43,0,people tried salmon cooked dishwasher
1,2,2,47,1,14,0,49,0,"want end relationship, list"
1,1,6,21,0,6,2,27,0,21 time pit bull good people
1,1,5,12,1,3,0,17,0,single af
1,1,7,29,0,7,2,36,0,29 autocorrect fails never funny
1,2,4,14,0,5,4,18,0,best rap verse 2016
1,3,16,59,4,16,0,75,0,"guy shared distraught ex classmate's story bet, know someone like"
1,3,1,36,1,7,0,37,0,toxin fast food packaging?
1,1,5,18,0,6,6,23,0,27 best animal tweet 2015
1,1,13,49,3,13,0,62,0,"four musician played ""rock band"" first time here's happened"
1,3,8,59,3,9,0,67,0,dutch court: populist lawmaker wilder guilty incitement discrimination
1,2,30,46,1,14,0,76,0,justin theroux posted pic jennifer anistons birthday heart aremelting
1,1,5,17,0,4,0,22,0,people drink coffee
1,3,2,56,2,7,0,58,0,patient satisfaction survey fueling america's opioid epidemic?
1,1,11,41,1,10,0,52,0,here's happens photoshop men workplace
1,2,1,55,2,8,0,56,0,"grades, draft needs, offseason question every eliminated team"
1,1,7,32,2,6,0,39,0,"""oregon trail"" made twentysomethings"
1,3,1,65,0,13,0,66,0,internet porn creating generation men desensitised real life sex
1,1,18,59,0,17,0,77,0,bride honored father wedding dance four fellow police officer
1,1,8,32,0,7,0,40,0,disney villain song anthem
1,3,8,43,1,9,0,51,0,getting management see big idea ashford university
1,1,8,38,1,8,2,46,0,27 tweet starbucks actually make laugh
1,1,7,37,1,7,1,44,0,7 reason rey definitely luke skywalker's daughter
1,1,11,59,5,8,0,70,0,"joseph gordon-levitt spectacularly re-creates janet jackson's ""rhythm nation"" dance"
1,1,6,21,2,5,0,27,0,"""power up"" character"
1,1,10,35,1,10,2,45,0,"17 gifs, vine picture prove magic legit real"
1,3,11,25,1,6,0,36,0,lgbt anti-trump protest dc fizzle bigly
1,1,6,32,1,6,2,38,0,judah friedlander's opinion 15 random thing
1,2,13,71,4,16,6,84,0,"obama refused deport 820,000 illegal immigrant guilty murder, rape, drug offenses, crime"
1,2,8,37,1,7,0,45,0,recognize food different languages?
1,1,8,26,1,7,0,34,0,serious question: brad pitt
1,1,9,20,0,8,0,29,0,match boy boy band
1,1,11,27,2,10,0,38,0,"need talk merlin ""once upon time"""
1,1,6,31,0,6,2,37,0,18 boob actually christmas miracle
1,2,11,59,2,11,0,70,0,christian baker lost everything refusing gay wedding cake appeal verdict
1,2,13,34,3,12,4,47,0,"get 10/10 quiz, must work dunder-mifflin"
1,2,4,20,1,3,0,24,0,"honestly, rory gilmoresucks"
1,2,8,38,1,9,0,46,0,trump continues defend call taiwan's leader
1,2,9,40,4,9,0,49,0,victoria's secret angel unwind show? [video]
1,1,12,43,0,11,0,55,0,feel like recover maternal mental illness
1,1,12,37,0,11,0,49,0,tried stop using exclamation point hard
1,1,6,16,0,4,0,22,0,tv pineapple
1,3,6,18,0,6,2,24,0,40 biggest duet time
1,1,8,26,1,8,0,34,0,bath body work fall candle
1,1,5,28,0,4,0,33,0,drinking underage v drinking legally
1,3,14,56,7,15,0,70,0,brzezinski: trump ev fair square he completely elected people
1,1,7,25,1,8,6,32,0,24 kanye west's iconic tweet 2015
1,3,15,56,0,15,2,71,0,20 hidden message cartoon probably made messed person aretoday
1,1,10,37,3,9,0,47,0,"every ""high school musical"" song, ranked worst best"
1,3,11,58,1,11,0,69,0,rihanna shut azealia bank xenophobic instagram shade epic clapback
1,1,3,11,0,3,2,14,0,16 badass cat fort
1,1,6,26,3,5,0,32,0,tell u yourself(ie): derek theler
1,1,5,25,0,5,2,30,0,15 people underestimated cold
1,3,9,35,1,8,2,44,0,18 kid show seriously fucked-upmoments
1,3,5,25,0,5,1,30,0,7 way authenticity lead success
1,1,9,34,2,8,0,43,0,"well actually remember ""a different world"""
1,1,17,53,0,17,0,70,0,photographer took pic cat underneath show u side rarely seen
1,1,10,42,0,9,0,52,0,everyone whose sexual awakening caused johnny depp
1,1,7,41,0,6,0,48,0,people try making presidential candidate likable
1,1,15,40,3,14,0,55,0,"guess season ""how met mother"" based lily's hair"
1,3,14,58,2,14,2,72,0,"techie post people's detail gay sites, get nabbed 50 victim harassed"
1,1,11,43,0,10,0,54,0,george clooney drinking cup coffee sexually awaken
1,1,15,34,0,10,0,49,0,george clooney channing tatum took bff test omg
1,1,8,33,0,7,0,41,0,dystopian future actually belong
1,3,8,41,2,7,0,49,0,previously deported sex offender arrested near u.s. border
1,1,6,18,0,6,2,24,0,17 text sum drunk
1,1,7,27,0,6,0,34,0,taylor swift tattoo get
1,1,6,22,0,5,0,28,0,classic guitar riff
1,1,10,38,0,9,0,48,0,color test determine favorite type dick
1,1,14,42,4,13,0,56,0,"know ""elder scrolls"" race based play ""skyrim"""
1,3,11,54,6,9,0,65,0,cancer-stricken jeopardy! contestant dy one week episode air [video]
1,1,11,56,4,10,0,67,0,"""jeopardy!"" contestant tell biggest martial art actor apart"
1,1,8,21,0,7,0,29,0,sunset grilled cheese
1,1,12,47,3,11,0,59,0,"so, apparently giles ""buffy"" run kind animal rescue charity"
1,1,7,31,0,7,2,38,0,21 photo short girl definitely relate
1,1,15,48,0,14,0,63,0,kid tijuana crossed border every day go school america
1,1,10,25,2,9,0,35,0,"cast ""rugrats"" grew parent"
1,1,9,22,1,9,2,31,0,27 kid give fuck
1,1,6,27,0,6,2,33,0,43 thing mildly thrill student
1,1,6,24,0,6,2,30,0,27 time ellen throw back thursday
1,1,9,32,0,9,2,41,0,34 question secretly wish could ask ex
1,2,2,38,2,8,2,40,0,trump's 17 golf courses: everything need know
1,3,3,57,3,11,0,60,0,jericho tokyo: world's largest city history mapped
1,1,15,46,0,13,0,61,0,know actor marry based favorite ya book series
1,1,5,24,1,4,2,29,0,17 genius candy cane-flavored sweet
1,1,12,45,1,11,0,57,0,girl trying get harry styles' attention break heart
1,3,12,28,3,10,0,40,0,mccain: know confidence trump
1,3,2,55,2,14,0,57,0,east africa facing hunger crisis done? podcast
1,3,6,66,5,15,0,72,0,"brother forced trump executive order. monday, moved u.s."
1,1,11,43,0,10,0,54,0,figure secret texting acronym crossword
1,1,9,26,0,9,4,35,0,2015 meme based zodiac sign
1,1,6,43,0,6,2,49,0,18 heartbreaking confession people agoraphobia
1,1,10,39,0,10,2,49,0,18 random good deed restore faith humanity
1,1,8,33,0,8,2,41,0,31 really valid question nursery rhyme
1,1,8,13,0,5,0,21,0,pas ipa quiz
1,3,13,60,3,14,1,73,0,4chan find desecrates hidden flagpole shia labeoufs divide u stream
1,3,1,63,2,11,0,64,0,daily habit make brain happier according neuroscience
1,1,11,39,2,10,0,50,0,"here's therapy yourself, according therapist"
1,1,6,29,2,6,2,35,0,"21 step becoming obsessed ""hamilton"""
1,1,13,57,1,13,0,70,0,"hark, public library dueling death defend baseball team"
1,1,8,30,0,8,2,38,0,23 type drunk every british drinker
1,3,1,42,3,8,0,43,0,"facebook proves, yet again, terrible math"
1,3,13,61,7,13,0,74,0,devastated madonna break trump: havent good night sleep since election
1,2,7,51,4,9,0,58,0,check epic christmas light synced ac/dc's 'thunderstruck'
1,1,5,18,0,5,2,23,0,10 perk small boob
1,1,10,42,0,9,0,52,0,sweatpants overall making many feeling
1,1,11,39,1,11,2,50,0,29 thing make cringe hard never recover
1,1,8,25,0,7,0,33,0,know whether like cilantro
1,2,4,71,1,17,0,75,0,joke donald trump extremely rude condone even little list
1,2,2,78,0,16,0,80,0,white house sends satirical news story accident daily newsletter guy even read
1,1,12,38,3,9,0,50,0,here's t-rex riding soccer-playing horse course
1,2,8,29,1,7,4,37,0,highest-paid athlete 2016 every state
1,1,6,24,2,6,2,30,0,"27 time ""hamilton"" fandom joke"
1,1,10,43,1,9,0,53,0,puzzle everyone who's obsessed animated movie
1,3,10,51,2,11,0,61,0,emma watson book fairy leaving feminist gift around world
1,2,2,40,2,8,2,42,0,barack obama's evolution 10 year hip-hop lyric
1,3,1,34,2,8,6,35,0,"car likely last 200,000 miles?"
1,2,11,47,2,10,0,58,0,(basically) official arthur twitter called john legend
1,3,1,19,1,7,3,20,0,spend 129 date
1,1,9,29,0,8,0,38,0,shia based favorite hole
1,2,11,45,2,12,0,56,0,woman india still dont report sexual assault india real time
1,2,1,62,2,12,0,63,0,"medium use picture drunk girl alcohol stories, misled"
1,3,8,32,1,9,4,40,0,21 beauty mistake every '00s girl made
1,3,2,70,2,13,1,72,0,black mother tell texas police 7-year-old assaulted arrest instead
1,1,8,33,1,8,2,41,0,10 senior photo make glad graduated
1,3,14,55,6,15,0,69,0,democrat civil war: anybody give money [david brock] pissing rat hole.
1,3,3,47,1,9,0,50,0,earl thomas tweet he'll return next season seahawks
1,1,12,53,0,11,0,65,0,charity calendar french firefighter leave hot bothered
1,1,5,25,0,4,0,30,0,justin timberlake go hogwarts
1,2,5,43,1,7,0,48,0,facebooks ar announcement excite iphone fan
1,2,4,42,1,9,0,46,0,confident enough pre-order nintendo switch
1,1,10,33,0,10,2,43,0,15 ooey gooey snack take cheese next level
1,2,2,51,0,15,0,53,0,woman picture like list
1,3,12,49,4,11,0,61,0,silicon valley star t.j. miller accused smacking uber driver trump
1,1,17,57,0,16,0,74,0,little kid perfectly directing traffic middle jam new hero
1,1,9,31,0,8,0,40,0,halsey song sex tonight
1,3,6,27,0,6,2,33,0,49 gross thing girl secretlyenjoy
1,1,16,40,2,16,4,56,0,"cast ""the fresh prince bel air"" would look like 2015"
1,2,3,58,2,12,0,61,0,best (and geekiest) sign march science around world
1,1,14,42,3,14,2,56,0,"viola davis, misty copeland, tell u $10 bill"
1,1,15,44,1,14,0,59,0,hilary duff chopped hair really going want bob
1,1,6,30,0,5,0,36,0,adele quote motivational poster
1,3,2,54,1,11,0,56,0,sweden's badass bikini police officer quit job list
1,1,6,23,0,5,0,29,0,yearbook quote
1,1,8,27,3,7,0,35,0,"here's ""aladdin"" cast look like"
1,2,15,73,4,15,0,88,0,"pelosi: barring illegal immigrant citizenship respectful, worthy country"
1,3,6,43,0,9,0,49,0,six supreme court case justice neil gorsuch could rule
1,1,10,31,0,9,0,41,0,way read compare everyone else
1,1,7,21,0,8,6,28,0,29 best award show moment 2015
1,3,17,70,1,16,0,87,0,newly married woman murdered husband friend said handsome enough match
1,1,9,30,4,9,0,39,0,"netflix chill, netflix ~chill~ ;o"
1,1,8,27,0,7,0,35,0,red hot chili pepper member
1,2,7,41,3,7,0,48,0,"republicans, flynn, syria: thursday evening briefing"
1,1,13,43,1,12,0,56,0,here's young indian woman say jasleen kaur case
1,3,11,49,0,12,3,60,0,100 sex offender caught single border sector fiscal year
1,1,10,38,0,9,0,48,0,question tell u lost virginity
1,1,7,37,0,7,2,44,0,27 insanely delicious mexican recipe know
1,2,2,72,0,13,0,74,0,shocking story led louisiana ban charging rape victim hefty medical fee
1,1,10,44,0,9,0,54,0,everything need know chocolate cheese toastie
1,2,10,42,1,10,0,52,0,"blackrock, machine rising manager pick stock"
1,3,3,40,3,6,0,43,0,barack obama's race legacy: progressive divisive?
1,2,7,42,2,6,0,49,0,amazing celebrity biopic transformation [video]
1,1,12,44,2,12,2,56,0,22 thing understand holiday mum
1,2,3,52,0,11,0,55,0,parody account make twitter bearable era trump
1,2,1,44,2,7,0,45,0,housing crisis: empty nester's guide downsizing
1,1,6,28,1,6,2,34,0,'90s cartoon villain
1,1,13,47,1,12,0,60,0,happens new york fashion week's biggest queer runway show
1,2,8,44,2,8,2,52,0,"four killed, 16 injured jerusalem truck-ramming terror attack"
1,1,10,34,2,9,0,44,0,"spot real ""peanuts"" character fake"
1,1,6,17,0,7,6,23,0,21 parent made u laugh 2015
1,1,7,25,0,6,0,32,0,weird thought dentist
1,1,11,46,0,10,0,57,0,natalie portman look exactly like jackie kennedy new biopic
1,3,4,49,1,12,0,53,0,anarchy checkout: sex pistol credit card
1,3,13,39,5,11,0,52,0,full story behind 'la la land' 'moonlight' oscar mix-up
1,1,11,51,1,10,0,62,0,kim kardashian's posh spice costume blessed queen victoria
1,1,9,35,0,9,2,44,0,17 delicious food eating better skin
1,2,8,33,1,11,2,41,0,"need go oman now, 16 incredible photo"
1,3,1,49,0,9,0,50,0,uber tracking location even ride finished
1,1,11,34,0,11,2,45,0,15 year ago rob lowe looked exactly emmy
1,1,13,43,0,12,0,56,0,prince harry harry style met harry dream came true
1,1,6,20,0,6,2,26,0,19 dog total fuzz bucket
1,1,6,25,0,5,0,31,0,londoner actually told truth
1,1,9,34,1,9,4,43,0,official ranking oprah's harvest 2015
1,3,12,46,2,12,2,58,0,aggressive ad trump's '90s game show seems like campaign
1,1,7,29,0,7,2,36,0,24 time tumblr felt thing jeremy corbyn
1,3,7,45,0,7,0,52,0,house republican unveil bullet point obamacare repeal
1,3,8,41,2,7,0,49,0,disruptive innovation: reached buzzword status yet?
1,1,7,17,0,6,0,24,0,much spoil dog
1,2,9,47,1,10,0,56,0,japan's startup founder flocking seaside city japan
1,1,12,46,0,11,0,58,0,selena gomez cutest reaction taylor swift winning grammy
1,1,9,51,0,8,0,60,0,watch dramatically makeup trend changed throughout history
1,3,2,36,1,7,0,38,0,harvard putting puritan stocks?
1,1,3,23,0,3,2,26,0,13 lesbian sorority confession
1,3,11,34,1,10,0,45,0,make girl scout cookie faceoff?
1,2,8,45,2,11,0,53,0,watch cast 'stranger things' spit bar golden globe
1,1,7,30,0,6,0,37,0,disney channel original movie
1,1,13,55,1,13,2,68,0,19 word actually understand unless went university michigan
1,2,4,46,4,11,0,50,0,quiz: spot 'fake news' headline donald trump?
1,1,7,21,0,7,2,28,0,32 cute animal meet italy
1,1,11,38,3,10,2,49,0,"23 holiday-themed ""star wars"" jumper world"
1,1,16,58,4,14,0,74,0,"toy company re-created ""star wars"" trailer using toy incredible"
1,1,6,25,2,5,0,31,0,"""kim possible"" character"
1,2,14,57,4,12,0,71,0,white people shouldnt breed race-hate attacker spat baby avoids jail sentence
1,3,7,35,2,6,0,42,0,sideways toe-stretching defeat foot problems?
1,1,10,37,0,9,0,47,0,guess makeup product expensive
1,1,13,50,0,12,0,63,0,take cat literally everywhere genius pet carrier
1,3,1,28,0,6,4,29,0,health trend worth keeping 2017
1,1,7,36,0,7,2,43,0,23 temporary tattoo make halloween makeup easy
1,3,1,26,1,3,0,27,0,congressional immunity?
1,3,1,39,0,9,0,40,0,best beard style every face shape
1,1,6,25,0,6,2,31,0,12 type drunk friend everyone know
1,1,10,29,0,9,0,39,0,spent birthday alone fucking loved
1,1,6,25,2,6,2,31,0,"31 thought watching ""empire"""
1,1,6,24,0,7,6,30,0,17 important british meme 2015
1,3,8,39,2,9,0,47,0,iron fist star blame rise trump terrible review
1,3,8,36,0,9,2,44,0,25 best drama movie streaming netflix right
1,1,9,36,1,9,3,45,0,here's 100 year bollywood cinema four minute
1,1,8,19,1,6,0,27,0,try guy try k-pop idol makeup
1,3,1,34,0,9,5,35,0,top 8 climate change story 2017
1,1,9,26,1,9,2,35,0,28 charming way use kids' art decor
1,1,7,25,1,6,0,32,0,easiest pixar quiz ever take
1,1,10,44,0,10,2,54,0,10 ridiculously easy delicious soup perfect fall
1,1,12,38,2,11,0,50,0,"amber rose went in, literally, tweet kanye"
1,1,10,28,1,8,0,38,0,many shia labeouf's movie seen
1,2,2,64,1,12,0,66,0,list secret skipping queue world's crowded attraction
1,2,9,44,0,8,0,53,0,trump tap linda mcmahon run small business administration
1,1,11,31,2,10,1,42,0,9 struggle k-pop fan korean
1,3,13,67,3,13,0,80,0,washington capitals' social night fails epically mistake real picture face swap
1,3,2,67,1,10,0,69,0,man could soon handling america politically charged investigation
1,1,6,30,0,6,2,36,0,15 text everyone dread getting fall
1,1,9,49,0,8,0,58,0,incredible canadian instagram account literally kill
1,2,3,53,1,9,0,56,0,mysterious rumbling coming metro? listen
1,1,10,35,0,9,0,45,0,bad teenage fashion choice regret
1,1,16,48,1,15,0,64,0,santa held photo dead child honor grieving father's christmas wish
1,1,7,26,0,6,0,33,0,video might ruin christmas
1,1,17,61,0,16,0,78,0,two adorable guinea pig sharing blade grass might cause heart explode
1,1,8,31,0,8,4,39,0,celebrity joined twitter 2015
1,3,8,42,3,10,0,50,0,franklin graham: donald trump election hand god
1,3,8,47,1,10,1,55,0,8 management trick barack obamas staff learned white house
1,2,10,49,1,10,1,59,0,success real world: 7 daily behavior conscientious people avoid
1,1,13,52,1,11,0,65,0,astronaut tweeted awe-inspiring photo south india space
1,2,7,30,3,7,0,37,0,biden electoral vote objection:
1,2,1,69,4,18,0,70,0,here liquid top yogurt stop pouring
1,1,8,25,1,7,0,33,0,said it: david brent michael scott
1,3,5,53,2,12,0,58,0,great escape sholay: make film national favourite?
1,1,11,41,0,11,2,52,0,13 beautiful moving thing alan rickman ever said
1,2,9,20,1,8,1,29,0,irs audit trap 5 way steer clear
1,1,16,62,2,15,0,78,0,"happened guy ""first dates"" give hope socially anxious people everywhere"
1,2,8,35,1,7,0,43,0,netflix sign adam sandler second four-film deal
1,1,8,33,0,9,6,41,0,17 important welsh thing happened 2015
1,1,10,51,1,9,0,61,0,attention everyone: seem forgotten thanksgiving exists
1,1,6,23,1,5,0,29,0,single holiday
1,1,17,30,2,13,0,47,0,"well know lyric ""cake ocean"" dnce"
1,1,10,31,1,9,0,41,0,request post we'll literally write
1,2,2,42,2,5,0,44,0,ancient chinese tomb-sweeping festival go hi-tech
1,2,3,47,2,8,0,50,0,went horribly wrong adeles grammy performance?
1,2,2,37,2,7,1,39,0,7 coworking space childcare across u.s.
1,1,9,44,2,9,2,53,0,"24 perfect simon amstell comeback ""never mind buzzcocks"""
1,1,11,41,2,10,0,52,0,"additional episode ""making murderer"" made yet"
1,1,5,16,0,4,0,21,0,wild weekend
1,1,11,40,1,11,2,51,0,42 photo looked like inside kanye west's fashion show
1,1,10,45,2,7,0,55,0,everyone need stop body-shaming cheryl fernandez-versini
1,1,6,39,1,6,2,45,0,"28 reason absolutely everyone hate hamilton, ontario"
1,3,13,62,5,20,8,75,0,"13 thing know chart week: 'fifty shades' headed no. 1, adele top 10 billboard 200"
1,1,11,44,0,11,1,55,0,5 easy halloween costume make old bridesmaid dress
1,1,10,43,0,9,0,53,0,know whether relationship status change year
1,3,8,34,0,9,0,42,0,annual kitchen gift guide brave new world
1,2,14,52,3,13,0,66,0,"india's men need paternity leave much woman need maternity leave, here's"
1,1,11,44,1,10,0,55,0,feel better ever buzzfeed health beauty newsletter
1,3,23,40,2,12,0,63,0,dramatic video: fl police officer save toddler's life tax office insider
1,2,11,42,3,10,0,53,0,gop sen collins: house healthcare bill dead arrival senate
1,1,8,29,0,7,0,37,0,people try bull testicle first time
1,1,10,45,2,10,2,55,0,30 hilarious tweet understand thirty
1,1,6,30,0,5,0,36,0,celebrity actually soulmate
1,1,9,43,1,8,0,52,0,serious question: reese witherspoon give birth
1,1,11,47,0,11,2,58,0,18 gorgeous university campus make proud canadian
1,1,9,28,1,9,2,37,0,13 award deserve ever period
1,2,10,43,4,11,0,53,0,huffington post: could time deny white men franchise?
1,2,9,79,4,15,0,88,0,'i real-life mean girl': reformed bully share biggest regret searingly honest confession
1,1,3,15,0,2,0,18,0,stuffed monkey bread
1,1,9,39,1,8,0,48,0,men's grooming product actually worth money
1,1,12,36,0,11,0,48,0,real florida news headline something made
1,2,10,45,1,10,2,55,0,15 untold emergency room horror story make skin crawl
1,1,9,32,1,8,0,41,0,waka flocka flame vegan delightful
1,3,10,50,4,14,6,60,0,"fabio buying gun $200,000 gold coins, watches, stolen home"
1,3,7,36,2,6,0,43,0,"edel rodriguez: weaponized cover art, viral dissent"
1,2,9,45,1,8,0,54,0,nighttime routine thatll make productive tomorrow
1,1,17,42,0,12,0,59,0,ruby rose totally slayed mtv emas red carpet injuring leg
1,1,10,44,3,10,2,54,0,"21 confession biggest ""grey's anatomy"" fan internet"
1,1,9,17,0,6,0,26,0,know pronounce gif
1,1,15,55,4,13,0,70,0,"goku ""dragon ball z"" destroys ""street fighter ii"" character awesome video"
1,1,10,28,0,10,2,38,0,24 time kris jenner shut kid
1,3,4,61,3,12,0,65,0,everyone think belle doll look like justin bieber (and they're wrong)
1,1,9,45,1,8,0,54,0,here's actually eating thanksgiving leftover
1,3,3,44,3,10,2,47,0,celebrate 25 year 'wayne's world' wacky film fact
1,3,6,55,3,13,0,61,0,seth meyers lot question melania trump's 'vanity fair' cover
1,2,2,83,2,17,0,85,0,brexit high point democracy greatest fraud ever perpetrated british politics
1,1,11,38,0,11,2,49,0,19 thing romantic film terrible real life
1,1,13,44,0,13,2,57,0,20 picture prove mum way funnier give credit
1,1,8,31,2,7,0,39,0,"justin timberlake go island ""lost"""
1,1,12,32,5,10,0,44,0,"well remember first episode ""house, m.d."""
1,3,3,38,1,7,0,41,0,happens waxwork former u presidents?
1,1,10,39,0,10,2,49,0,29 hilarious fake book social medium need exist
1,1,11,38,1,10,0,49,0,drake responded adele said he'd anything want
1,2,2,45,0,12,0,47,0,true story five year old gave birth list
1,1,9,41,1,9,2,50,0,well remember '90s premier league goalkeeper
1,1,8,30,2,7,0,38,0,what's funniest tinder bio ever seen
1,1,14,35,4,13,0,49,0,"well remember ""i put spell you"" ""hocus pocus"""
1,1,11,22,0,8,2,33,0,21 thing people adhd want know
1,2,3,34,0,5,0,37,0,photographing russian empire colour
1,1,13,43,0,13,2,56,0,35 photo people taken moment got fright life
1,1,14,39,0,13,0,53,0,man wolfdog make want go hiking right
1,1,8,37,0,8,2,45,0,16 face latino recognize around holiday
1,1,9,41,4,8,0,50,0,"what's funniest ""it's always sunny philadelphia"" moment"
1,1,8,33,0,8,2,41,0,21 minimalist way store everything home
1,1,12,37,0,12,2,49,0,18 dating story make want ask crush
1,1,9,44,0,9,2,53,0,15 delicious dessert dip guaranteed satisfy sweet tooth
1,1,9,43,0,9,2,52,0,54 leather bag actual leather actually affordable
1,1,7,30,0,6,0,37,0,show u biggest halloween costume fail
1,1,11,44,1,11,2,55,0,27 gluttonous food eat new year's resolution kick
1,2,5,53,1,11,0,58,0,daily show's jordan klepper getting late night spinoff series
1,1,9,30,2,9,4,39,0,"""doctor who"" 2017 steven moffat step"
1,1,9,33,4,8,0,42,0,"""harry potter"" character ""game thrones"""
1,2,6,27,0,7,0,33,0,astronaut ring new year
1,1,10,26,0,10,2,36,0,24 tip real people use get fuck sleep
1,2,12,48,3,14,7,60,0,"nba player manages make $500,000 refusing shoot team's final 4 game"
1,3,3,52,1,10,0,55,0,map graphic mapped: country drink coffee
1,2,1,63,2,12,0,64,0,"australia cusp large-scale solar boom setup cost tumble, expert say"
1,2,2,60,0,11,0,62,0,dad make amazing disney princess costume daughter
1,2,4,26,4,7,0,30,0,"who, what, why: dog donate blood?"
1,3,7,21,1,8,4,28,0,"19 time forever 21 went way, way far"
1,1,7,34,0,7,2,41,0,34 charming accessory fairy tale lover need
1,1,9,36,0,8,0,45,0,need try bagel grilled cheese immediately
1,1,9,39,0,8,0,48,0,favorite superhero movie pas bechdel test
1,1,8,21,0,7,0,29,0,tell pop star older
1,3,12,61,3,10,0,73,0,"abc stephanopoulos: trump denial amid question competence, credibility"
1,2,18,53,2,13,0,71,0,"nasa's latest discovery matters, pm modi followed leader must read"
1,2,10,60,3,15,0,70,0,"gallery miss golden globe: looking back famous, obscure, mister"
1,1,20,53,1,17,0,73,0,jennifer lawrence's new movie basically bunch gifs search movie
1,1,17,45,1,16,0,62,0,amy adam walk look like shampoo commercial
1,3,12,47,3,11,0,59,0,"here ""keeping kardashians"" dealt parisrobbery"
1,1,14,46,3,13,0,60,0,"britney spears' ""my wish"" iconic christmas song time"
1,1,6,40,0,6,2,46,0,24 eating experience surprisingly disturbing
1,1,10,45,0,9,2,55,0,23 ridiculously clever halloween costume every tv lover want
1,1,10,46,0,10,2,56,0,16 truth people assign personality number letter
1,3,3,55,2,11,0,58,0,'terrifying' ryan gosling wax figure creeping internet
1,3,4,45,1,9,0,49,0,ranking five-star recruit currently nfl
1,3,3,53,2,17,7,56,0,"5 place u need make $100,000 afford home"
1,1,9,35,1,8,2,44,0,13 crazy-delicious pizza topping need life
1,3,1,47,1,9,0,48,0,here's marriage doctor popular joke
1,3,1,43,0,11,2,44,0,27 city worst quality life world
1,1,7,29,0,8,6,36,0,10 popular celebrity twitter 2015
1,1,11,36,1,10,0,47,0,children's book aim give black queer boy voice
1,1,10,26,0,10,2,36,0,leaving home 14 best thing ever
1,1,12,41,0,11,0,53,0,may single legendary selfie ever taken india
1,3,5,55,2,9,0,60,0,donald trump condemned republican 'respect' vladimir putin
1,3,4,71,0,11,0,75,0,holocaust remembrance yom hashoa journey dealing intergenerational trauma
1,1,11,36,1,10,2,47,0,19 picture way real all-girl friend group
1,1,12,36,2,11,0,48,0,"leslie knope ron swanson ""parks rec"""
1,2,10,41,1,12,1,51,0,5 time madonna badass said exactly thinking
1,1,6,18,0,6,2,24,0,30 quality good home cook
1,1,9,30,0,9,2,39,0,17 thing know date couple
1,3,1,40,0,7,0,41,0,ensure everyone guaranteed basic income
1,1,14,52,2,13,0,66,0,dog begging human's forgiveness cutest thing see today
1,2,6,28,0,8,4,34,0,14 fashion essential age 30
1,3,1,47,0,8,0,48,0,teen lost hand becomes unlikely basketball hero
1,1,11,40,2,10,0,51,0,"""harry potter"" character based birth month"
1,3,4,46,1,10,0,50,0,lebron james sound cavs' fifth loss seven game
1,3,7,18,1,5,0,25,0,rice pilaf recipe nyt cooking
1,1,9,47,0,9,2,56,0,32 picture perfectly sum elementary school experience
1,3,17,50,1,16,0,67,0,india china world leader pollution death time tie top
1,1,12,44,2,11,0,56,0,"young thug reading lyric song ""best friend"" everything"
1,2,4,70,0,10,0,74,0,national photographic portrait prize finalist share story behind picture
1,1,5,17,0,4,0,22,0,hogwarts college
1,3,13,54,0,13,2,67,0,christmas see bloody gang war mexico left 13 dead including six beheaded
1,1,11,40,0,10,0,51,0,match nigella sexual innuendo recipe
1,1,10,33,0,10,2,43,0,26 tweet sex make laugh every time
1,1,6,39,0,6,2,45,0,17 unexpectedly useful gift idea procrastinator
1,3,13,47,6,12,0,60,0,house card creator new script: flood trump dc hotel phone call
1,2,1,72,2,17,2,73,0,here's exactly say 10 awkward moment new relationship
1,2,10,36,3,10,6,46,0,1-in-25 uk muslim believe al qaeda carried 9/11 attack
1,2,9,31,0,9,1,40,0,7 family finance tip consider new year
1,1,14,45,0,13,0,59,0,pharrell asked bunch kid love reading adorable
1,1,13,44,4,12,0,57,0,"ultimate ""star wars"" fan got married line ""the force awakens"""
1,1,17,47,0,16,0,64,0,dad turned ridiculous thing end saying kid book
1,2,7,22,1,6,0,29,0,protect tax-id theft
1,2,7,39,3,7,0,46,0,"jeff sessions, obamacare, palmyra: friday briefing"
1,1,10,34,1,9,0,44,0,katy perry vs. brazilian fan probably rolling
1,1,6,26,0,6,2,32,0,18 picture prove cat evolving
1,3,16,62,1,16,2,78,0,11 thing probably didnt know funded help national endowment thearts
1,1,7,26,1,7,2,33,0,'00s disney channel mean girl
1,3,6,24,1,6,0,30,0,even donald trump cant save twitter
1,1,15,41,0,14,0,56,0,best wine bar every state want get classy drunk
1,1,8,28,2,7,0,36,0,"fright ""this halloween"""
1,1,9,29,0,9,2,38,0,21 reason one new york value
1,2,8,32,1,8,2,40,0,17 time american went hard valentinesday
1,1,15,44,0,12,0,59,0,could soon new tournament ml premier league
1,3,11,40,2,10,0,51,0,twitter vital struggling time: quicktake q&a
1,1,10,42,0,9,0,52,0,book illustrated quote author inspire
1,1,9,30,0,9,2,39,0,24 gift drink lover ask year
1,2,3,51,1,12,4,54,0,super bowl commercial 2017: grading best worst big game
1,2,11,41,0,11,2,52,0,17 people happy obama also internallysobbing
1,3,8,32,2,8,2,40,0,"10 expensive habit can, should, break today"
1,1,11,37,1,10,0,48,0,rainbow bagel can't keep shit together
1,2,9,38,2,8,0,47,0,morning routine compare everyoneelses?
1,3,10,39,2,11,0,49,0,got craving? here's body actually want eat
1,1,10,36,2,10,2,46,0,"28 ""new girl"" quote guaranteed make laugh every time"
1,1,14,53,0,13,0,67,0,everyone convinced brother sister folgers ad hooking
1,1,10,46,2,10,2,56,0,"25 funny, random, bizarre thing people actually asked google"
1,3,12,47,1,12,2,59,0,12 thing kendall jenner hat looked like marc jacob fashionshow
1,1,10,39,0,10,2,49,0,make 29 tweet without laughing
1,1,7,40,0,7,2,47,0,12 inspiring fashion illustrator follow instagram
1,1,8,28,0,8,2,36,0,15 place eat korean food london
1,1,10,37,1,10,2,47,0,22 picture people dog never understand
1,2,9,33,0,8,2,42,0,19 weird af question actually kinda makesense
1,1,12,45,0,11,0,57,0,ridiculous sex rumour went around school
1,1,8,28,0,8,2,36,0,17 thing one tell breast cancer
1,1,6,14,0,5,0,20,0,go work naked
1,3,8,45,5,9,0,53,0,mark levin congress: investigate obamas silent coup vs. trump
1,3,15,72,6,20,0,87,0,dem rep lewis: dont see trump legitimate president conspiracy part russian
1,1,12,41,3,11,0,53,0,tiny lion can't roar yet that's fine he's adorable
1,2,7,34,0,7,2,41,0,28 adorable christmas pajama wholefamily
1,1,8,45,0,8,2,53,0,12 card friend depression would actually appreciate
1,1,10,40,0,9,0,50,0,taylor swift track personal theme song
1,1,10,33,1,9,0,43,0,let's see obsessed makeup truly
1,2,2,70,1,13,0,72,0,"arctic showing stunning winter warmth, scientist think know"
1,3,11,52,0,10,0,63,0,indian bangladeshi border guard celebrated holi together
1,2,9,39,0,9,0,48,0,man dy car plunge new orleans parking garage
1,1,12,50,3,11,0,62,0,"we're obsessing weddings, let's learn talk marriage"
1,1,11,46,1,11,2,57,0,17 pair actually cute sweatpants keep comfy winter
1,1,11,47,0,10,0,58,0,lisa frank illustration used outline pointlessness
1,1,9,33,0,9,2,42,0,21 thing could stand appreciate little
1,1,7,27,1,5,0,34,0,meet inspiring plus-size pole dancer
1,2,9,41,2,10,2,50,0,"one hatchback, 68 ton meat: arrest end swiss smuggling case"
1,1,9,33,0,9,1,42,0,8 thing one tell working anxiety
1,3,3,55,1,11,2,58,0,north pole 50 degree hotter normal pre-christmas heatwave
1,2,16,56,4,15,0,72,0,rooster teeth started web's longest-running series -- made business
1,1,11,39,0,10,0,50,0,phone accessory make photo look sick hell
1,1,14,45,0,13,0,59,0,new dad proposed girlfriend right birth baby
1,1,8,31,0,8,2,39,0,23 product everyone love wine
1,1,8,28,3,8,2,36,0,"well remember ""the office"" season 1-3"
1,2,8,33,0,8,1,41,0,4 surprising reason bag eye
1,2,4,74,3,14,0,78,0,visited ralph lauren's soon-to-close flagship polo store saw brand struggling
1,1,4,11,0,4,4,15,0,year 2015 haiku
1,3,14,50,1,13,0,64,0,wondering job application? best way follow resume
1,1,13,47,4,12,0,60,0,"internet fucking up: patrick dewitt books, bubbles, bullshit"
1,1,14,53,3,13,0,67,0,"thousand people singing ""sweet child o' mine"" together sound like"
1,1,8,30,2,8,1,38,0,"9 ""ugly"" animal going extinct need love"
1,1,4,14,0,3,0,18,0,name disney fish
1,2,12,44,4,11,0,56,0,donald trump praise vladimir putin: 'i always knew smart!'
1,1,7,25,0,6,0,32,0,sally jack skellington
1,3,1,44,0,9,0,45,0,woman whose mum inspired track ethical food
1,1,11,41,0,11,2,52,0,24 picture make lose faith education system
1,1,7,20,1,6,0,27,0,emojis: fuck mean
1,1,6,22,0,5,0,28,0,hoverboard right
1,1,11,49,1,10,0,60,0,tom daley touching dustin lance black's butt somehow really precious
1,1,13,53,3,12,0,66,0,"one direction revisited natalie imbruglia's ""torn"" give feel"
1,1,12,40,0,11,0,52,0,photo grown men cat make heart explode
1,1,6,26,1,6,2,32,0,21 thing military spouse tell
1,1,11,47,1,10,0,58,0,what's actual age based favorite childhood gaming system
1,3,2,77,3,14,1,79,0,"game throne season 7 actor talk release date, something special happening premiere"
1,1,8,8,2,5,3,16,0,bb-8 r2-d2
1,3,7,61,1,14,0,68,0,"matthew dellavedova killed nba finals, internet turned meme"
1,1,11,44,5,10,0,55,0,"well remember lyric ""everybody (backstreet's back)"""
1,3,3,32,1,6,0,35,0,"happened last night, swede ask trump"
1,3,0,43,0,7,4,43,0,2016 reimagined brilliant spoof horror film trailer
1,1,4,21,0,3,0,25,0,perfect anywhere workout
1,1,8,27,1,7,2,35,0,19 thing everyone break-up
1,1,7,26,0,6,0,33,0,wale actually live
1,3,7,28,0,7,0,35,0,nfl way overthinking gif thing
1,1,9,43,0,8,0,52,0,rebel wilson dakota johnson answer dating question
1,1,9,24,2,5,0,33,0,dude re-create nfl's greatest play
1,2,7,30,0,7,0,37,0,general motor already lost tesla
1,1,9,37,0,9,2,46,0,23 ridiculously cool toy kid adult enjoy
1,2,9,35,1,9,1,44,0,kendrick lamar actually dropping april 7?
1,2,12,40,0,12,0,52,0,could wearing ivanka trump right even know
1,1,10,44,1,10,2,54,0,19 valentine's day treat actually better boyfriend
1,3,2,57,0,9,0,59,0,president obama cite triumph administration final speech
1,1,9,36,1,8,1,45,0,7 last-minute halloween costume make right
1,1,9,44,3,8,0,53,0,"drop everything, emo kids, jack's mannequin reuniting"
1,1,11,36,1,10,2,47,0,21 low-key thing wear show halloween spirit
1,2,15,73,4,14,2,88,0,"film fraternity mourns jayalalithaa's death, manish malhotra's star-studded 50th bday bash ent"
1,1,8,22,1,8,2,30,0,12 gift cat lover like
1,3,9,44,0,9,1,53,0,3 basic email mistake make look really unprofessional
1,3,10,50,1,11,0,60,0,"un, nikki haley become conscience trump administration"
1,1,6,19,1,7,5,25,0,27 vine 100% make laugh
1,1,13,40,2,12,0,53,0,"know giraffe sleep missing out, friend"
1,1,11,32,0,10,0,43,0,people get real best worst part sex
1,1,7,26,0,8,6,33,0,17 hilarious amazon review 2015
1,1,14,52,3,13,0,66,0,"here's obsessive tea drinker think new ""nespresso tea"" machine"
1,3,10,47,1,13,4,57,0,celebrity death 2016: many famous figure lost year
1,1,8,23,1,7,0,31,0,said it: donald trump kanye west
1,3,8,50,0,8,0,58,0,battle line drawn socially conservative legislation south
1,1,13,44,2,12,0,57,0,"literally bunch really funny ""lord rings"" tumblr post"
1,1,6,27,1,7,4,33,0,17 thing '00s disney kid remember
1,1,5,15,0,4,0,20,0,love feel like
1,2,1,19,2,5,1,20,0,"europe drug use, 2 map"
1,1,10,40,3,8,0,50,0,what's best last-minute halloween costume ever
1,1,14,47,1,13,0,61,0,asked guy going buy leona lewis's exclusive grindr album
1,3,5,35,0,7,2,40,0,11 riskiest dog breed homeowner renter
1,2,1,58,0,12,1,59,0,9 people discovered terrible ex really list
1,1,9,29,0,8,0,38,0,belong plastic chanels
1,3,4,59,0,12,0,63,0,second oscar nominee banned coming u attend award ceremony
1,1,8,15,0,8,6,23,0,21 bold af hair color try 2016
1,1,10,32,2,10,4,42,0,"sit back, relax, watch favorite vine 2015"
1,1,6,31,0,5,0,37,0,celebrity name according justin bieber
1,2,8,25,3,7,0,33,0,playbook u.s. china clash
1,3,9,48,3,10,0,57,0,worker slam insensitive plea chip director sailing boat
1,1,11,47,1,11,2,58,0,18 way upgrade instant noodle change college dorm life
1,1,10,40,0,9,0,50,0,beauty ad used actual product advertised
1,1,8,24,0,7,0,32,0,advice want little mix
1,2,1,54,1,10,0,55,0,"trump caught practicing speech, internet made joke"
1,1,6,21,2,5,0,27,0,can't tell flirting
1,2,1,89,2,19,0,90,0,danish dental student pull wisdom tooth naturally post video grisly procedure online
1,3,8,37,2,10,0,45,0,police use 'fake news' sting aimed california gang
1,1,5,25,0,5,2,30,0,19 fix every clothing emergency
1,1,11,30,0,10,0,41,0,name classic emo album cover art
1,1,10,48,0,9,0,58,0,fictional couple fictional significant
1,1,4,18,1,2,0,22,0,awesome irn-bru cocktail
1,2,9,39,1,8,0,48,0,actually masturbating like everybody else ornot?
1,3,1,69,1,17,4,70,0,goofy 1908 children's book trace path bullet literal hole page
1,1,11,39,0,10,2,50,0,24 leonardo dicaprio oscar joke might win one soon
1,1,8,38,1,7,0,46,0,everyone allowed celebrate halloween
1,1,11,27,0,11,6,38,0,19 starter kit help crafty af 2016
1,1,8,38,3,6,0,46,0,"""gotham"" cast gender-swaps iconic batman character"
1,2,2,40,1,8,0,42,0,saving edgecumbe's resident back lorry
1,1,10,40,0,9,0,50,0,disney character would look like instagram
1,3,11,37,0,11,2,48,0,10 easiest hardest city finding job right
1,1,15,48,3,14,0,63,0,"played drake future inspired ""jumpman"" game good"
1,2,9,41,1,8,0,50,0,everything need know google new smartwatches
1,1,10,41,0,9,0,51,0,anyone sexually attracted young bernie sander
1,1,8,30,0,8,2,38,0,24 tweet sex guaranteed make laugh
1,2,10,63,1,12,0,73,0,turley: trump making argument obama defense immigration executive order
1,1,8,30,0,9,6,38,0,15 badass feminist moment canada 2015
1,1,9,38,2,8,0,47,0,"""jurassic world"" deleted scene literally shit"
1,1,10,42,0,10,2,52,0,21 beautiful model bravely bared boob runway
1,2,6,68,4,16,0,74,0,"yes, 'game thrones' showrunners hated hbo's stupid melting ice stunt much"
1,2,9,26,4,6,0,35,0,nyt: amnesty long-term solution
1,3,8,25,3,7,3,33,0,27-year-old made $1 million last year
1,1,12,47,3,10,0,59,0,"well know job description ""the bachelor/bachelorette"""
1,2,7,22,1,8,0,29,0,want bet jeb bush running?
1,3,15,46,4,13,0,61,0,boss's go-to person turn nightmare (and escape)
1,1,10,39,3,11,2,49,0,"23 time andy dwyer ""parks rec"" wrong everything"
1,1,8,46,0,8,2,54,0,17 heartbreaking confession people unrequited love
1,1,14,50,1,13,0,64,0,here's look inside adult coloring book beauty natural hair
1,1,10,47,0,9,0,57,0,photographer immersed life homeless people
1,1,10,28,0,10,4,38,0,try get angry 2015 nail polish name
1,3,7,26,1,7,2,33,0,17 dick pic youd actually like toreceive
1,1,11,45,2,12,3,56,0,"13 thing definitely maybe happen ""game thrones"" season 6"
1,1,5,22,2,5,3,27,0,"237 different way spell ""caitlin"""
1,3,19,46,3,14,3,65,0,exclusive: lawmaker request probe $418m arm sale kenya obamas last day
1,1,14,41,0,12,0,55,0,bill murray came buzzfeed gave u damn good life advice
1,1,11,48,0,10,0,59,0,jack black tried halloween pinterest hack became master pinner
1,1,8,39,1,8,2,47,0,21 secret victoria's secret employee never tell
1,2,4,47,2,10,0,51,0,"warren stand? liberal icon tangling dems, base"
1,1,15,61,0,14,0,76,0,donald trump accidentally tweeted picture jeremy corbyn internet lost
1,1,7,30,3,6,0,37,0,tell u self(ie): sabrina carpenter
1,3,1,59,1,14,0,60,0,one top hedge fund launch year landed big-name backer
1,1,12,43,0,11,0,55,0,kendall jenner gigi hadid longer kind almost related
1,3,1,55,2,8,0,56,0,"advice conquering fear, year graduation speaker"
1,1,11,41,0,11,6,52,0,15 movie tv retrospective 2015 make nostalgic
1,2,18,60,2,17,0,78,0,"bollywood bid goodbye om puri, justin bieber perform india year ent!"
1,2,1,54,1,9,0,55,0,airline carry-on size suggestion could mean need new luggage
1,2,2,44,1,11,0,46,0,woman saved man life first date list
1,1,9,37,2,8,0,46,0,"""how grinch stole christmas"" character"
1,2,9,42,3,9,0,51,0,"we're friendly skies, emirate tell red-faced united"
1,1,7,26,0,7,2,33,0,21 picture make every dad angry
1,1,14,48,1,13,0,62,0,everyone's sharing picture crowd make point modern life
1,1,4,21,0,4,2,25,0,21 hilarious tweet pizza
1,1,9,32,0,8,0,41,0,dog love leaf love anything
1,1,7,31,0,6,0,38,0,compatible celebrity crush
1,2,8,33,0,8,2,41,0,18 meme super sensitive people relateto
1,1,13,51,2,12,0,64,0,"here's matilda would like hogwarts, according mara wilson"
1,1,7,27,0,7,2,34,0,16 iphone hack save battery
1,3,2,16,1,2,0,18,0,morgan stanley beats!
1,1,10,43,0,9,0,53,0,question determine style glass get
1,1,8,36,0,8,2,44,0,18 confession pubic hair surprise
1,1,11,37,0,11,2,48,0,17 simple reason fall wonderful time year
1,1,12,35,1,11,2,47,0,19 way look like giant-ass sleeping bag winter
1,1,14,45,0,13,0,59,0,girl pretended kim kardashian wore waist trainer week
1,1,4,27,0,4,1,31,0,6 struggle atheist understand
1,1,14,48,2,13,0,62,0,"ellen page get flirt julianne moore first ""freeheld"" clip"
1,1,7,17,0,6,0,24,0,nick joe jonas
1,1,8,28,0,9,1,36,0,7 easy fall dinner make week
1,1,10,42,1,9,0,52,0,bartender tell exactly annoys
1,3,6,29,1,6,0,35,0,inside le pen growing army discontent
1,1,15,51,2,14,0,66,0,"lot people sharing bizarre unexpected ""come dine me"" ending"
1,1,15,43,0,15,2,58,0,cappella group sang 30 best song year five minute
1,1,8,28,0,7,0,36,0,much grammar perfectionist
1,1,7,26,2,7,2,33,0,"22 reason ""clue"" favorite movie"
1,1,6,38,1,5,0,44,0,what's craziest bachelorette party experience
1,1,13,59,2,12,0,72,0,"aretha franklin performing ""a natural woman"" carole king leave speechless"
1,1,9,25,1,6,0,34,0,#duraghistoryweek joke
1,1,7,28,1,6,2,35,0,48 rule long-term female friend follow
1,1,10,29,1,10,2,39,0,21 movie show stream cold
1,1,9,43,0,9,2,52,0,19 funniest tweet famous phrase translated yoda speak
1,1,9,35,0,8,0,44,0,make thanksgiving stuffing dream
1,3,2,48,0,9,0,50,0,democrat aim rebuild blue political wall midwest
1,1,8,21,0,7,0,29,0,would rather race
1,1,12,32,0,9,0,44,0,edm artist based favorite pizza
1,1,10,44,1,10,2,54,0,17 sticky sweet strawberry treat make mouth water
1,3,17,68,6,17,0,85,0,"former hillary clinton surrogate james p. rubin: angela merkel, trump, leader free world"
1,3,8,32,1,7,0,40,0,radiohead's coachella set kind disaster
1,1,11,37,0,11,2,48,0,15 time viola davis role model damn world need
1,1,13,45,1,11,0,58,0,tested four long-wear lipstick see one lasted longest
1,1,6,28,1,6,2,34,0,18 delicious indian food curry
1,3,5,57,5,11,3,62,0,"new day, weekday 6-9am et 3-year-old's beaming adoption photo win internet"
1,1,10,28,0,10,2,38,0,17 sibling much trouble
1,1,13,44,0,12,0,57,0,bryan cranston married couple plane anything
1,3,12,44,2,12,2,56,0,britney spears' top 10 deep cuts: best song never single
1,1,8,22,0,9,6,30,0,28 meme pretty much sum life 2015
1,3,3,50,1,8,0,53,0,michelle obama meme internet's coping mechanism
1,3,7,44,2,7,0,51,0,jennifer garner looking forward helping president trump
1,1,12,37,4,9,0,49,0,"demi lovato adorably confused ""genes"" ""jeans"" bbc radio"
1,3,1,56,0,9,0,57,0,belgian astronomer found planetary system named beer
1,2,2,49,0,9,0,51,0,facebook failing remove obscene content page
1,1,6,22,1,6,1,28,0,britney spear 9 year ago vs. today
1,1,9,29,0,9,1,38,0,8 comic talking dog know truth
1,2,10,44,0,11,0,54,0,brutal knockout leaf mma fighter stiff board canvas
1,1,7,31,1,8,4,38,0,19 word '00s kid really understand
1,1,8,23,0,8,1,31,0,9 totally normal thing pig
1,1,10,41,3,11,2,51,0,"24 moment ""pride prejudice"" make heart melt"
1,1,6,19,0,6,2,25,0,21 time idris elba gave life
1,1,4,14,0,3,0,18,0,name disney bird
1,1,13,54,0,13,4,67,0,know 2016 presidential candidate find sexiest based birth month
1,1,6,27,1,5,0,33,0,macy's thanksgiving day parade quiz
1,1,8,31,2,7,0,39,0,"jennifer lawrence wore jacket say ""perv"""
1,1,8,28,0,8,2,36,0,22 adorable thing need love panda
1,2,0,73,0,17,1,73,0,2 dog incredible engagement photoshoot rest u might well give
1,1,10,35,0,9,2,45,0,25 real af struggle anyone work recognize
1,3,4,29,0,4,0,33,0,another journalist murdered mexico
1,1,10,36,1,9,0,46,0,what's best halloween costume kid ever worn
1,1,11,44,0,12,5,55,0,9 cringeworthy thing happen disney princess 2015
1,1,11,37,1,10,2,48,0,38 people share helped resist urge self-harm
1,3,12,26,5,7,0,38,0,msnbcs hunt sen warren: mcconnell sexist?
1,3,14,57,3,12,1,71,0,people appropriately freaking cause 2-year-old look like ed sheeran
1,1,14,35,4,9,0,49,0,"cover ac/dc's ""thunderstruck"" bagpipe fierce af"
1,3,11,49,0,11,1,60,0,5 simple tip help every millennial tax investment
1,1,5,25,0,4,0,30,0,everyday struggle germophobe
1,1,13,59,4,12,0,72,0,"next week's episode ""keeping kardashians"" address lamar odom's overdose"
1,2,1,52,1,11,0,53,0,"thank support, important ever"
1,2,15,57,0,11,0,72,0,australian police arrest man charge helping isi develop missile technology
1,1,12,35,0,12,2,47,0,12 tree would getting ton as human
1,3,3,41,1,8,0,44,0,divorce marriage age chart business insider
1,1,7,19,0,7,1,26,0,9 people play beer pong
1,1,9,41,2,7,2,50,0,15 life-changing stuffing guaranteed impress in-law
1,1,6,22,0,7,6,28,0,24 funniest tweet cat 2015
1,1,9,26,0,8,0,35,0,try guy try coding girl code
1,1,15,51,1,14,0,66,0,please drop everything tell u whether morning person night owl
1,1,12,41,4,10,0,53,0,got drunk (at work) kingfisher's new breezer-style drink
1,3,9,38,1,9,2,47,0,21 winter tip trick people thinking yourestylish
1,1,13,45,0,12,0,58,0,artist drew disney men justin bieber outcome glorious
1,1,11,52,1,10,2,63,0,21 last-minute punch cocktail get thanksgiving weekend
1,2,4,26,2,6,2,30,0,"closing bell, june 12 business insider"
1,2,7,36,1,10,0,43,0,would end tipping mean end good service?
1,1,12,51,0,11,0,63,0,emma watson finally responded noma dumezweni cast hermione
1,2,6,32,3,8,0,38,0,realestate yahoo news latest news headline
1,1,11,39,1,9,0,50,0,ryan reynolds mentored bunch x-men child deadpool
1,3,11,42,2,9,0,53,0,trump strong hand confirmation process: quicktake q&a
1,1,7,26,0,7,2,33,0,guess 25 common password
1,1,9,36,0,9,2,45,0,42 seriously useful tip every clean freak need know
1,1,14,48,0,13,0,62,0,daughter turning social medium realized mom lonely
1,2,13,41,0,12,0,54,0,girl perfect response asked wanted black doll
1,1,6,20,0,5,0,26,0,pick right roommate
1,1,13,47,0,13,4,60,0,facebook post love story 1970s gone massively viral
1,3,3,85,8,14,0,88,0,glass adjust eyes; world travel via container ship refugee videogamer-turned-football star
1,1,6,22,1,5,2,28,0,soup cancelled 22-year run
1,3,1,23,0,7,6,24,0,37 film get excited 2017
1,1,10,34,1,9,0,44,0,zayn malik's first solo single coming week
1,1,12,35,0,12,2,47,0,20 picture way real biryani addict
1,1,8,30,0,7,0,38,0,literally bunch really funny tweet
1,2,7,43,0,7,0,50,0,arnold schwarzenegger negged nickelback hit back
1,1,5,34,0,4,0,39,0,stereotypically twentysomething
1,3,11,47,1,13,0,58,0,bigger paycheck dont feel good thought would
1,1,8,26,2,8,2,34,0,"23 gift every ""legend zelda"" fan love"
1,1,7,19,0,6,0,26,0,know movie make cry
1,3,13,41,0,12,0,54,0,awesome sign march science
1,2,3,70,0,17,0,73,0,donald trump got behind wheel truck everyone making joke list
1,2,6,51,4,9,0,57,0,"floyd mayweather: fight conor mcgregor 'getting very, close'"
1,1,11,31,1,9,0,42,0,basic fall activity s.o
1,1,9,39,0,8,0,48,0,calculation student loan might real
1,3,13,70,2,16,4,83,0,billboard latin music award 2017: song know written songwriter year finalist
1,1,9,46,0,8,0,55,0,supercouple got married running chicago marathon
1,1,7,31,0,6,0,38,0,identify british regional accent
1,1,10,44,1,9,0,54,0,gloria steinem's dedication new book incredibly moving
1,1,12,50,3,12,1,62,0,"7 essay read: finding feminism, loss, brain surgery awake"
1,2,3,50,1,11,0,53,0,"third u millennials still live home, census report find"
1,1,8,37,0,7,0,45,0,adele absolutely nailed singing nicki minaj record
1,1,8,35,0,9,6,43,0,14 celebrity blessed u joining instagram 2015
1,1,13,56,2,12,0,69,0,"suzanne collins wrote touching letter saying goodbye ""hunger games"" series"
1,1,7,16,2,5,0,23,0,"high ""seinfeld"" iq"
1,1,6,22,1,5,0,28,0,sign old married couple
1,1,8,33,0,7,0,41,0,halloween town actually live
1,3,2,69,2,13,0,71,0,good office christmas party (without regretting everything next day)
1,3,3,39,0,9,6,42,0,13 biggest snub 2017 golden globe nomination
1,1,15,64,2,14,0,79,0,"muslim globally condemning islamophobia tweeting support paris ""i muslim"""
1,1,11,40,2,11,1,51,0,"match ""gilmore girls"" season 1 character quote"
1,3,11,28,3,10,0,39,0,"cast ""teen mom"" first season vs."
1,3,8,43,1,9,0,51,0,chart show new winner china's transition wealth
1,1,5,19,0,4,0,24,0,percentage jedi
1,1,6,17,0,7,6,23,0,22 mixtapes get ready 2016
1,1,14,39,4,13,0,53,0,"""fuller house"" teaser look lot like ""full house"""
1,1,10,35,3,8,0,45,0,what's best budget-friendly trip ever
1,1,5,29,0,4,0,34,0,struggle everyone contact know
1,1,15,55,0,14,0,70,0,sania mirza congratulated one greatest tennis player time
1,1,11,36,0,10,0,47,0,candy corn arranged look like actual corn may ruin
1,1,14,39,1,12,0,53,0,mindy kaling written u list favorite rom-coms
1,1,6,24,0,6,1,30,0,7 winter dinner anyone make
1,3,1,61,0,12,0,62,0,dash cam capture man rescuing teeny kitten wandered traffic
1,1,11,31,0,10,0,42,0,mixtape playlist type person
1,1,8,29,2,7,0,37,0,"new trailer ""the huntsman"" glorious"
1,1,10,49,0,10,2,59,0,15 item thirtysomethings would amazon shopping cart
1,1,9,16,1,5,0,25,0,rom-com movie bff
1,2,8,22,2,6,2,30,0,16-year-old made empire
1,1,13,38,0,13,2,51,0,22 thing seemed cool kid actually suck adult
1,1,12,35,1,11,0,47,0,like behind table comic convention
1,3,1,46,2,10,0,47,0,'weekend warrior' still good health
1,1,15,53,0,14,0,68,0,freak anyone think olivier martinez hoarding baguette
1,1,6,17,0,5,0,23,0,need talk brazil
1,1,9,27,1,8,0,36,0,man's hairy back make jaw drop
1,2,15,63,4,14,0,78,0,get computer complete italian teacher's summer assignment. regret it.
1,3,2,72,1,17,0,74,0,news never take shoe flight cabin crew revelation
1,1,6,27,0,6,4,33,0,everything donald trump looked like 2015
1,1,8,30,0,8,2,38,0,23 time hayley atwell gave u new glamour goal
1,2,15,63,2,15,0,78,0,rahul gandhi tweeted vacation twitter took upon troll mercilessly!
1,1,10,43,0,10,2,53,0,16 time club penguin perfectly summed college student
1,1,13,40,1,12,0,53,0,well remember ross's list reason date rachel
1,3,1,50,0,11,6,51,0,2016 ranking 10 innovative university world
1,1,11,30,0,8,0,41,0,diy fruit water make feel amazing
1,2,3,34,2,11,0,37,0,dont call donald trump liar even one
1,3,1,35,2,6,0,36,0,here babygrow thats making dad angry
1,3,8,27,0,9,6,35,0,27 song 2007 definitely youripod
1,1,10,38,0,9,2,48,0,15 tv character prove slytherins actually best
1,1,11,39,1,11,0,50,0,writer's book sold amazon thanks twitter army
1,1,13,40,0,11,0,53,0,ava duvernay would like remind diversity hard
1,1,12,48,0,11,0,60,0,difference freshman year senior year college
1,1,9,53,0,9,2,62,0,17 confession breast cancer survivor incredibly emotional
1,1,7,32,1,6,0,39,0,hardest musical decision ever make
1,1,15,41,2,14,2,56,0,21 thing get met best friend all-girls' school
1,3,0,57,0,14,2,57,0,11 photo little kid big dog fill heart joy
1,2,9,33,0,9,2,42,0,22 haiku pretty much parenting nutshell
1,2,1,59,0,9,0,60,0,prison officer acted unlawfully restraining inmate later died
1,1,5,26,0,5,2,31,0,29 italian dish everyone know
1,2,6,28,1,5,0,34,0,high-tech solar project fail deliver
1,1,11,37,0,10,0,48,0,know zodiac sign based favorite dog breed
1,1,9,36,0,9,2,45,0,17 thing people obsessed eye makeup relate
1,2,9,35,2,10,3,44,0,10 biggest problem season 7 'the walking dead'
1,3,14,48,1,14,2,62,0,19 thing youll get bad relationship bankaccount
1,1,8,36,0,8,2,44,0,18 problem people always cold understand
1,1,13,55,0,12,0,68,0,leaked snapchat allegedly show malia obama playing beer pong college visit
1,1,7,18,0,6,0,25,0,like salem binx
1,3,5,67,5,13,0,72,0,"d.b. cooper case baffled investigator decades. now, scientist new theory."
1,3,16,61,0,15,0,77,0,internet going bonkers ban j sharing friendly kiss friend sapna bhavnani
1,1,13,44,3,12,0,57,0,"match ""avengers: age ultron"" quote right character"
1,2,4,47,3,11,0,51,0,"yep, lyft gained user #deleteuber, know many"
1,3,11,36,4,10,0,47,0,alexei navalny want putin job. here hed
1,3,4,37,4,8,0,41,0,pete rose defends legal gambling: 'who hurting?'
1,1,8,33,1,7,0,41,0,prince harry's ginger beard deserves damn award
1,1,13,42,3,12,0,55,0,"brie larson's response called ""it girl"" make day"
1,2,7,38,0,7,0,45,0,jeff session slam deal monitor baltimore police
1,1,10,23,2,7,0,33,0,"otp ""scream queens"" best"
1,1,11,39,0,10,0,50,0,guess zodiac sign based fave celebrity
1,2,3,40,1,8,0,43,0,help u solve mystery kendall jenner's short
1,1,12,36,5,9,0,48,0,"omg, ""game thrones"" ""pocahontas"" literally"
1,1,7,34,0,7,2,41,0,17 thing super close sister understand
1,1,12,42,2,11,1,54,0,woman painting tiny 3-d sweater nail amazing
1,3,9,39,0,9,1,48,0,5 time rihanna coachella style better others
1,1,9,41,1,9,2,50,0,22 tweet job interview actually make laugh
1,2,9,36,1,8,0,45,0,donald trump managed make oscar screw-up
1,1,11,42,3,10,2,53,0,"13 time ""rupaul's drag race"" captured feel unemployed"
1,1,12,37,0,10,0,49,0,let shia labeouf show proper way wear sweatpants
1,1,8,29,1,7,2,37,0,10 top fashion tip stylish plus-size guy
1,1,8,31,0,7,0,39,0,snarky text sibling send
1,1,7,21,0,7,4,28,0,look 2016 golden globe
1,1,13,40,4,11,0,53,0,"triumph mistake got j.j. abrams ready ""star wars"""
1,1,10,54,2,9,0,64,0,someone illustrated leslie knope's compliment they're pretty damn cool
1,1,9,39,0,9,2,48,0,17 tumblr post teacher guaranteed make laugh
1,1,7,21,0,7,2,28,0,31 thing need cook october
1,1,13,40,0,13,2,53,0,19 super stylish thing dress like witch every damn day
1,1,9,26,1,8,0,35,0,like live best friend
1,1,8,30,3,8,2,38,0,"29 rachel green's iconic line ""friends"""
1,2,3,71,0,15,0,74,0,one powerful woman finance give career advice young wall streeters
1,1,14,50,1,12,0,64,0,leonardo dicaprio world's awkward high five golden globe
1,1,12,37,0,11,0,49,0,tried sexy donald trump costume disaster
1,1,14,40,2,11,0,54,0,"""the office"" gif based least favorite quality"
1,1,8,38,0,8,2,46,0,16 holiday recipe real healthy people actually eat
1,1,7,27,1,6,0,34,0,here's everyone keep journal
1,1,10,35,0,10,2,45,0,16 mac cheese dish better boyfriend
1,1,14,46,1,13,0,60,0,know waffle house ihop based seven question
1,3,12,39,4,9,0,51,0,tbss samantha bee: gop appealing exclusively white
1,2,10,42,1,11,0,52,0,new york require salt warnings; san francisco ban soda ad
1,3,2,59,2,11,0,61,0,mayim bialik something say people calling grown woman 'girls'
1,1,5,22,0,4,0,27,0,worst thing wedding
1,3,1,39,0,7,1,40,0,5 mistake american making money
1,1,7,18,0,6,0,25,0,kathie lee hoda
1,1,8,23,0,8,2,31,0,23 mom clearly meant mom
1,1,12,38,1,12,2,50,0,here's actually killer ab workout 15 minute
1,3,11,57,4,11,0,68,0,"rock share ultimate workout video, seriously intimidating [video]"
1,1,11,43,4,11,2,54,0,"25 word actually understand unless ""doctor who"" fan"
1,2,12,50,4,11,0,62,0,trump worst day president: celebs rejoice gop healthcare bill fails
1,3,3,79,0,14,2,82,0,isi fighter kill 15 people tricking mosul resident posing liberating iraqi soldier
1,1,6,21,0,5,0,27,0,struggle mixed race
1,1,12,36,0,11,0,48,0,like high school based zodiac sign
1,3,1,61,1,11,0,62,0,"skincare product waste money, according dermatologist"
1,2,7,70,1,13,4,77,0,oscar 2017: american ban syrian behind nominated film white helmet attending oscar
1,1,5,18,0,4,0,23,0,scylla charybdis
1,1,15,60,7,12,0,75,0,"here's eye-opening reminder j.k. rowling probably saying ""voldemort"" wrong"
1,3,2,48,1,8,0,50,0,judaism's definition death boost organ donation
1,1,14,50,1,13,0,64,0,"man shared photo tireless, devoted girlfriend show gratitude"
1,1,11,41,1,10,0,52,0,kelly clarkson's baby daughter teach u meditate
1,1,9,42,0,8,0,51,0,celebrity quote next instagram caption
1,1,9,44,0,8,0,53,0,people talk divorced parent holiday
1,3,9,44,2,8,2,53,0,"19 mystery small-town midwesterners never, ever solve"
1,1,5,22,0,4,0,27,0,chris hardwick got engaged
1,1,12,37,3,10,0,49,0,"genetic engineering big part ""x-files"" reboot"
1,3,7,22,3,6,0,29,0,van jones: clinton day
1,3,2,58,1,12,0,60,0,"prince william get squirted marathon runner, time life"
1,1,11,29,0,10,2,40,0,24 way creepy af bedroom dream
1,3,14,59,0,13,0,73,0,pune engineer mercilessly stabbed stopped biker riding wrong side
1,3,7,33,0,7,2,40,0,17 cake design absolutely stunning
1,2,15,56,0,14,0,71,0,grandma look like scarlett johansson got invited get drunk
1,1,6,27,2,4,0,33,0,buzzfeed crossword: freestyle time
1,1,14,41,4,12,0,55,0,"""harry potter"" parent s.o. based zodiac"
1,1,8,29,0,7,0,37,0,four major temperament
1,1,7,41,0,7,2,48,0,53 wonderfully pointless fact english language
1,1,10,43,1,8,0,53,0,disney channel halloween movie all-time favorite
1,3,10,34,2,10,0,44,0,rolls-royce british job ain't used
1,1,6,19,0,7,6,25,0,15 resolution make good 2016
1,3,0,59,1,8,1,59,0,9 high-profile entrepreneur endorsed universal basic income
1,1,13,47,1,13,2,60,0,19 struggle way real anyone who's ever hair extension
1,3,7,29,2,7,2,36,0,"21 ""simpsons"" quote perfectly sum life"
1,1,10,35,0,10,2,45,0,27 reason love peanut butter already
1,1,8,28,2,8,4,36,0,"version ""1989"" listening"
1,3,9,37,0,10,1,46,0,3 simple way elevate work wardrobe new year
1,1,10,42,0,10,2,52,0,11 brilliant outfit every man need see shaadi season
1,1,8,33,3,8,2,41,0,"""harry potter"" character instagram '90s"
1,1,10,45,1,10,2,55,0,26 reason engagement ring much better they're colorful
1,3,2,37,3,7,0,39,0,aleppo filmmaker: 'this could last message'
1,1,11,40,0,11,2,51,0,19 thing every woman shaved hair never want hear
1,1,14,43,0,13,0,57,0,kelly ripa katy perry might better katy perry katy perry
1,2,5,46,3,10,3,51,0,maps: america's $200 billion obesity problem state age group
1,1,11,41,2,11,2,52,0,"12 ""harry potter"" quote could totally desi life"
1,2,4,55,1,12,0,59,0,cup ben: chinese factory grant christmas wish boy autism
1,1,12,38,0,11,0,50,0,fake black friday movie trailer need real thing
1,1,14,42,1,13,1,56,0,5-second video aunty gym broken damn internet
1,3,8,44,0,7,0,52,0,everybody cry heartwarming christmasadvert
1,1,6,23,3,4,0,29,0,"""scooby-doo"" character"
1,1,12,43,0,11,0,55,0,willow costume queen totally nailed back future day
1,1,9,28,0,8,0,37,0,well remember game boy game
1,1,7,33,0,7,2,40,0,20 badass tattoo inspired health wellness
1,1,11,38,0,10,0,49,0,ad might feature cutest use spanglish ever
1,2,8,45,1,9,0,53,0,populist leader praise trump refugee ban model europe
1,1,12,35,0,11,0,47,0,photo hot men cat make feel thing
1,1,10,38,0,9,0,48,0,woman turned cruel meme seriously funny joke
1,2,6,36,4,6,2,42,0,18 major scandal obamas scandal-free presidency
1,1,13,45,1,12,0,58,0,someone claim posted fat jew's book online entirety
1,1,12,46,0,11,0,58,0,indian woman open first time harassed public
1,3,10,37,2,11,3,47,0,"31 thing actually happen episode 1 ""the young pope"""
1,1,10,30,0,10,1,40,0,7 quick easy dinner make week
1,2,11,41,0,11,2,52,0,19 urban legend childhood still scary ashell
1,3,11,40,7,10,0,51,0,"sheriff clarke: fake news started hand up, dont shoot lie"
1,1,7,19,1,7,2,26,0,17 image able unsee
1,1,13,43,2,12,0,56,0,"nintendo announced cloud ""smash bros"" lost mind"
1,1,4,20,0,4,2,24,0,17 brilliant slow cooker hack
1,1,11,41,0,11,2,52,0,36 seriously hot men cute cat melt completely
1,3,1,33,0,8,2,34,0,20 city lowest cost living
1,1,9,26,1,8,0,35,0,girl spends much money
1,1,9,42,0,9,2,51,0,25 hilarious tweet sweating everyone relate
1,1,9,39,0,9,1,48,0,7 dark disney origin story ruin childhood
1,2,4,15,1,3,0,19,0,inside t's beauty issue
1,1,10,34,0,10,2,44,0,15 time chris traeger inspired best self
1,1,11,38,2,9,0,49,0,here's know kate dicamillo's new novel
1,1,7,33,0,7,1,40,0,9 celebrity zombie undead fiction
1,1,11,35,0,10,0,46,0,know popular song hate based one question
1,1,11,26,4,9,0,37,0,"""made a.m."" song actually best"
1,3,5,49,2,8,0,54,0,"power rankings: rockets, spur jump ahead warrior stumble"
1,1,7,28,3,7,2,35,0,"17 chuckie finster's best line ""rugrats"""
1,1,9,31,0,9,2,40,0,find horoscope week november 23
1,1,17,39,1,14,0,56,0,"snoopy got star walk fame seemed little hungover, tbh"
1,2,19,66,5,19,0,85,0,"cbss dickerson: lack trust medium trump, press ruined reputation"
1,1,10,40,2,9,0,50,0,"guess ""the simpsons"" character color"
1,1,15,40,0,15,2,55,0,21 men tinder need log think done
1,2,3,56,1,11,0,59,0,erdoans ruthless drive power shaking divided europe
1,1,8,35,0,9,6,43,0,11 bollywood actress obviously took tumble 2015
1,1,10,54,2,10,2,64,0,"44 strange, ridiculous, bizarre thing overheard london underground"
1,1,9,31,2,8,0,40,0,"one thing never noticed ""home alone"""
1,1,13,47,3,12,0,60,0,"nicki minaj performed maya angelou's ""still rise"" inspire"
1,1,11,37,1,10,0,48,0,tell introvert extrovert color
1,2,14,45,1,13,0,59,0,people loving dog came surgery can't stop smiling
1,1,7,37,1,7,2,44,0,27 deceptively bad gift surprise friend
1,2,1,54,0,12,2,55,0,make limoncello four ingredient 10 day
1,1,8,40,0,7,0,48,0,everyone stop appreciate zac efron touching
1,1,10,32,0,8,0,42,0,turned linkedin profile dating profile
1,1,10,39,2,9,0,49,0,"mini ""sisterhood traveling pants"" reunion"
1,3,8,32,1,6,0,40,0,tiny spider-like creature roils big texas ranch
1,1,9,36,0,9,2,45,0,21 martini people definitely james bond
1,1,5,6,0,2,0,11,0,diy sugar wax
1,1,11,38,1,10,2,49,0,29 woman share life-changing beauty tip got mom
1,3,6,30,2,7,0,36,0,producer harry styles' album?
1,1,5,23,0,4,0,28,0,extremely spicy snack taste test
1,3,1,34,1,6,0,35,0,single mom's tax return message go viral
1,2,16,58,1,15,0,74,0,trump's link convicted felon stabbed man margarita glass got weirder
1,1,9,41,0,9,2,50,0,18 insane acne transformation prove power makeup
1,1,11,43,2,10,0,54,0,"review ""street fighter v"" another fighting game"
1,1,7,30,0,7,2,37,0,17 way eat healthier christmas season
1,1,11,31,3,11,2,42,0,"14 reason need get excited ""ash vs. evil dead"""
1,2,7,49,1,11,0,56,0,second-hand smoke affect baby get pregnant
1,1,10,32,0,9,0,42,0,know live based favorite food
1,3,9,34,1,8,0,43,0,trump's absurd defense wiretap claim
1,1,8,42,0,7,0,50,0,student honored veteran carrying coffin
1,1,16,40,0,15,0,56,0,adorable app ever collect cat
1,1,10,33,0,9,0,43,0,match actor animated film role
1,1,11,41,1,10,2,52,0,15 mind-blowing chicken nugget make quit fast food
1,1,10,54,2,9,0,64,0,"britney spear went hiking, slayed mountains, slaughtered stream"
1,1,12,47,0,12,2,59,0,22 funniest excuse people used justify skipping workout
1,1,7,38,0,7,2,45,0,27 underrated makeup brand everyone know
1,1,11,44,0,10,0,55,0,survive getting married parent divorced
1,1,7,38,0,7,2,45,0,31 halloween costume require absolutely skill
1,1,10,41,2,9,0,51,0,what's terrifying unsolved crime ever heard
1,1,12,44,0,11,0,56,0,dude pierced ear first probably last time
1,3,8,44,1,9,3,52,0,kohl store opening 107 hour straight christmas
1,3,4,51,2,9,0,55,0,'creepy' photo collage get martin shkreli suspended twitter
1,1,5,19,0,4,0,24,0,extinct animal
1,1,10,30,0,9,2,40,0,21 fierce af haircut look good anyone
1,2,1,48,0,7,0,49,0,pakistan honour killing continue despite tough new law
1,1,7,31,0,7,2,38,0,22 thing cat owner understand cat
1,1,10,44,1,9,0,54,0,here's young indian woman really think premarital sex
1,1,10,36,0,10,2,46,0,22 tip hiking kid every parent know
1,1,11,31,1,10,0,42,0,baby polar bear hitched ride mom's butt
1,1,8,27,0,8,2,35,0,23 thing everyone penis need know
1,1,13,47,1,12,0,60,0,guy invented extra long selfie arm weirdest thing ever
1,1,8,28,0,8,2,36,0,23 woman television need watching
1,1,7,25,1,6,0,32,0,what's weirdest thing dog
1,3,10,46,5,12,2,56,0,report: self-driving car hacked $43 laser pointer
1,2,12,43,1,12,3,55,0,watch vulnerable $140 quadcopter drone get hacked sky
1,1,9,42,3,9,2,51,0,18 valentine's day cupcake make forget single
1,1,6,26,0,6,2,32,0,17 totally genius way flavor popcorn
1,1,12,49,0,11,0,61,0,stop everything slay friend ultimate cheese toast
1,1,12,46,3,11,0,58,0,"adult coloring book screaming crayons?!"""
1,1,8,25,0,7,0,33,0,troye sivan shawn mendes
1,1,9,39,0,9,2,48,0,11 bowl oatmeal change breakfast forever
1,1,9,49,1,8,0,58,0,presidential candidate reimagined valentine's day card
1,1,11,41,1,10,0,52,0,group say french medium pronouncing guy's name wrong
1,3,2,32,0,6,0,34,0,turning twitter instead police
1,1,5,17,0,4,0,22,0,michael cera
1,3,10,36,1,11,5,46,0,"100 days, trump found 29 way screw regular american"
1,1,7,30,0,7,2,37,0,19 choker sexually awaken look
1,1,9,42,0,10,3,51,0,watch one woman transform 7 disney character 90 second
1,2,8,37,3,7,4,45,0,morgan stanleyvoice: investor party like 1999?
1,1,6,25,0,5,0,31,0,annoying part halloween
1,1,10,48,0,9,0,58,0,star war fan start hyperventilating amazing shoe
1,2,4,53,4,10,0,57,0,russell westbrook defends thunder teammates: 'don't try split u up'
1,3,7,29,2,7,2,36,0,17 perfect gift anyone love friend
1,1,10,42,2,10,4,52,0,19 thing happen 20-something high school teacher
1,1,7,29,0,6,0,36,0,version alanis morissette
1,1,11,52,0,11,2,63,0,14 instagrams prove shweta tripathi literally cutest human
1,3,13,51,0,12,0,64,0,big wave surfer interested tackling biggest monster
1,2,0,47,0,12,2,47,0,14 thing successful people first week new job
1,2,12,42,1,12,2,54,0,21 funny text wont able get withoutlaughing
1,2,4,23,2,4,0,27,0,what's next american pharoah?
1,1,10,25,0,9,0,35,0,guess type school went
1,1,11,43,0,10,0,54,0,fake trailer haunted bro movie actually terrifying
1,1,11,30,2,10,0,41,0,"""how met mother"" home live"
1,1,16,58,0,15,0,74,0,bengaluru hotel took underprivileged kid tour city christmas surprise
1,1,5,16,1,5,4,21,0,reminder: life 2006
1,1,7,23,0,6,0,30,0,make proper nepali goat curry
1,1,10,34,0,9,0,44,0,everyone think ulta best makeup store
1,2,2,41,2,8,0,43,0,milk miracle brought india standstill
1,1,14,59,1,13,0,73,0,cole sprouse revealed halloween costume year actually perfect
1,1,8,38,1,8,2,46,0,15 chocolate dessert console valentine's day
1,1,8,30,0,8,2,38,0,18 rotties actually big teddy bear
1,3,8,28,2,7,0,36,0,much hope alzheimer's drugs?
1,1,12,42,0,11,0,54,0,caramel apple tart drooling floor
1,1,11,43,0,11,2,54,0,21 craziest thing people done impress crush
1,3,13,44,1,12,0,57,0,someone made pea mayonnaise pizza people cant even look atit
1,1,9,23,0,8,0,32,0,much picky dater really
1,1,9,35,0,9,2,44,0,21 time instantly fell love kendall jenner
1,1,8,35,0,7,0,43,0,woman react awful sex advice throughout history
1,3,12,59,3,15,0,71,0,dem rep gutirrez: used number white woman complaining trump
1,1,12,39,2,11,0,51,0,"alarming number people think ""the martian"" true story"
1,1,12,51,3,12,2,63,0,"rewatched ""charlie's angels"" middle school best friend 15 year later"
1,3,13,57,2,14,0,70,0,fmr clinton campaign manager: trump aide talking russia much? insider
1,3,1,44,0,8,0,45,0,eye doctor explains eye twitch sometimes
1,1,10,25,0,9,0,35,0,light dark side force
1,3,18,63,4,22,8,81,0,watch e! news season 2016 excerpt free online best 2016: movie totally made u ugly cry yahoo view
1,1,8,31,0,8,2,39,0,31 book restore faith humanity
1,1,10,40,1,10,2,50,0,identify iconic '80s movie based screenshot
1,2,13,55,1,11,0,68,0,wife surprised husband amazing batman-themed family photoshoot
1,1,8,29,0,8,2,37,0,16 reason best friend best friend
1,1,6,35,0,6,2,41,0,17 healthier dessert actually delicious
1,1,11,38,1,11,2,49,0,19 thing saw every single time went grandma's house
1,1,11,33,2,10,2,44,0,12 low-carb bowl soup warm soul fall
1,1,12,50,2,12,2,62,0,18 thing understand easy target friendship group
1,1,11,34,0,11,0,45,0,drake jay z clearly blast warrior game
1,3,10,31,0,10,2,41,0,16 kid figuring life faster
1,1,10,26,0,9,2,36,0,11 music video make feel high af
1,3,20,67,2,17,2,87,0,"hyderabad cop catch 47 kid watching porn, isi beheading internet cafes, parade front medium"
1,2,9,41,4,10,0,50,0,american pharoah vs. secretariat: would win? daily fix
1,1,9,27,0,9,2,36,0,21 thing need love burger much
1,3,1,37,1,9,0,38,0,general election work?
1,1,7,42,0,7,2,49,0,21 borderline orgasmic moment every woman understand
1,1,11,29,1,10,0,40,0,robot nerd rubik's cube one second
1,2,11,45,0,11,2,56,0,23 underrated vacation spot around world visit youdie
1,1,4,13,0,2,0,17,0,buzzfeed press blog
1,1,8,32,0,8,2,40,0,17 boozy hot chocolate recipe make winter
1,3,4,32,0,8,0,36,0,look back life martin mcguinness
1,1,10,41,0,9,0,51,0,know favorite animal based random question
1,3,5,30,1,5,0,35,0,russia want immigrant world doesnt
1,1,10,37,0,9,0,47,0,guess number missing book title
1,1,12,41,1,12,2,53,0,new study show 92% college student prefer read paper book
1,1,13,39,2,12,0,52,0,"olivia ""the bachelor"" made beach left"
1,1,10,34,2,9,0,44,0,what's one thing sick hearing introvert
1,2,1,28,1,6,0,29,0,macron young achiever
1,1,12,55,1,11,0,67,0,ranveer singh talked facing casting couch uncomfortably real
1,1,15,47,0,14,0,62,0,woman best response husband asked mind
1,3,9,40,0,9,0,49,0,three tech trend impact small business lending
1,3,11,40,0,12,6,51,0,31 hilarious tweet totally sum crappy year 2016
1,1,16,47,2,14,0,63,0,answer five question we'll tell live u.s
1,2,11,48,0,13,0,59,0,nightly news confusing food label could soon thing past
1,1,6,15,3,5,0,21,0,"i'm immigrant, i'm"
1,2,12,44,2,11,0,56,0,hep alien performed gilmore girl theme song wasperfect
1,3,12,55,3,10,0,67,0,acting ag sally yates: justice department wont defend trump immigration order
1,1,5,20,0,4,0,25,0,christmassy house
1,1,9,39,1,8,2,48,0,31 two-person costume guaranteed halloween game
1,1,12,43,0,11,0,55,0,cat making biscuit magical thing ever
1,1,11,48,0,10,0,59,0,justin trudeau personally welcomed plane full refugee canada
1,1,9,39,0,9,2,48,0,22 question ask queer relative christmas
1,1,10,41,0,9,0,51,0,ingenious lego hack finally help math make sense
1,1,7,33,0,7,2,40,0,17 weird pizza crust actually brilliant
1,2,8,35,0,11,2,43,0,space scientist pay men stay bed 60 day
1,1,13,43,3,12,0,56,0,"here's voice ""the little mermaid"" look like real life"
1,1,6,15,0,3,0,21,0,bffs build blanket fort
1,1,8,22,3,7,0,30,0,"like hear ""just get better"""
1,1,10,41,2,10,1,51,0,"first teaser ""game thrones"" season 6 heartbreaking"
1,1,13,36,2,12,0,49,0,"bet never noticed detail ""the grinch"" kid"
1,1,10,35,0,9,0,45,0,know favorite fandom based zodiac sign
1,1,9,39,0,8,2,48,0,11 people look strikingly similar leonardo dicaprio
1,1,12,47,0,11,0,59,0,native american confessed feel america got real
1,1,12,30,0,11,0,42,0,tell real fake crime headline
1,1,15,48,0,14,0,63,0,polar bear got real snow play christmas went wild
1,1,14,41,0,13,0,55,0,guess kind sandwich based zodiac sign
1,1,16,52,0,16,2,68,0,video ron swanson drinking whisky 45 minute yule log need
1,1,12,49,0,11,0,61,0,canadian journalist chill retweeted taylor swift
1,1,10,40,0,9,0,50,0,best advice dating someone depression
1,2,8,32,0,9,6,40,0,28 perfect tweet woman 2017 oscar
1,1,11,38,2,11,4,49,0,top parenting search pinterest 2016 (so far)
1,1,7,18,0,7,4,25,0,going get married 2016
1,1,8,30,0,7,0,38,0,watch netflix october
1,3,1,71,0,13,0,72,0,revamped work wardrobe almost effort personal shopping service
1,1,10,32,2,9,0,42,0,"take look inside new ""doctor who"" coloring book"
1,1,8,28,0,8,2,36,0,17 place music lover go london
1,1,4,11,0,3,0,15,0,get bings
1,1,7,29,2,6,0,36,0,"character ""dance academy"""
1,1,10,36,0,10,2,46,0,19 tweet movie make laugh every time
1,1,16,40,1,13,0,56,0,"fyi, love child zayn liam one direction found"
1,1,9,36,2,7,0,45,0,delightfully spooky wedding venue every u.s. state
1,1,6,20,0,5,0,26,0,try guy try korean cooking
1,1,10,36,1,9,0,46,0,woman make tiny fake food incredibly cute
1,2,8,31,1,8,2,39,0,straight white man guide 21stcentury
1,1,8,23,1,9,4,31,0,20 sign grew miami '90s
1,1,11,49,2,10,0,60,0,britney spear instagram look like vs. pop stars' instagrams
1,2,16,47,1,15,1,63,0,6-point guide help ace selfie game even low light night
1,1,6,23,0,7,6,29,0,31 celebrity bulge went hard 2015
1,1,8,36,0,8,2,44,0,25 stereotype feminist sick tired hearing
1,1,9,33,2,7,0,42,0,black-ish tackle n-word season premiere
1,2,4,54,1,10,0,58,0,ariana grandes feminist twitter post brilliant career move
1,1,4,18,0,4,2,22,0,17 boozy crock pot cocktail
1,1,8,23,0,9,6,31,0,22 delicious way bring 2016 bang
1,1,5,18,0,5,2,23,0,15 water must stopped
1,1,10,32,2,9,0,42,0,"""star wars"" fan theory kylo ren perfect"
1,1,7,36,1,6,2,43,0,27 simply lovely wes anderson-inspired wedding idea
1,3,12,54,0,11,0,66,0,couple surprised bridal party rescue kitten wedding
1,1,8,29,0,8,2,37,0,22 time tumblr actually better sex ed
1,3,11,45,1,11,4,56,0,batman fan rejoice! six separate movie rumoured release 2019
1,2,10,44,1,10,0,54,0,cab driver praise john elway without realizing he's back seat
1,1,3,13,0,2,0,16,0,latino v hispanic
1,3,16,50,1,16,2,66,0,16 incredible photo shot drone give itch one right now!
1,1,9,30,0,8,0,39,0,dancing shiba make day every day
1,1,11,33,2,9,0,44,0,"buy working, adult-sized little tike car"
1,1,11,43,0,11,2,54,0,17 boozy ice cream treat actually make holiday season
1,3,6,63,1,11,0,69,0,aretha franklin slam dionne warwick comment whitney houston's funeral
1,1,4,13,0,3,0,17,0,formation
1,2,4,63,2,12,0,67,0,kim kardashian hint divorce long-awaited return instagram?
1,3,9,21,18,9,0,30,0,"new cia wikileaks trove, \_()_/, (_)"
1,1,8,20,0,7,0,28,0,guess age gay porn
1,1,8,14,0,4,0,22,0,ikea product
1,2,2,54,0,9,0,56,0,swimwear model becoming professional kickboxer list
1,1,9,36,0,9,2,45,0,19 slow internet connection text real
1,1,12,51,1,11,0,63,0,what's mortifying thing happened studying abroad
1,1,12,36,2,11,0,48,0,"""arthur"" voice actor look like real life"
1,3,13,60,2,14,3,73,0,"toilet, bride say people 110 village across haryana, punjab himachal pradesh"
1,1,9,37,1,6,2,46,0,22 hilarious #netflixphshows actually exist
1,1,9,37,1,8,0,46,0,justin bieber's new purple hair six instagram photo
1,1,7,41,1,6,0,48,0,what's annoying misconception sorority
1,1,7,14,0,5,0,21,0,worst tv mother
1,3,12,55,3,11,0,67,0,comedian lavell crawford apologizes saying gay men try p*ssy first
1,1,11,38,4,10,2,49,0,"13 people cast new all-female ""ocean's eleven"""
1,1,7,26,4,7,4,33,0,"what's best video taylor swift's ""1989"""
1,1,7,36,0,8,6,43,0,17 greatest supermarket substitution fails 2015
1,1,19,49,4,17,1,68,0,"3-year-old girl cancer sang ""let go"" bed help nurse"
1,1,13,54,3,12,0,67,0,there's hilarious reason everyone's sharing poster tom hardy's new film
1,1,12,36,0,11,0,48,0,guess artist based hit album cover art
1,1,5,18,0,4,0,23,0,black car banned
1,1,14,51,1,14,2,65,0,"24 awesome thing really wanted never got, still totally buy today"
1,1,6,24,0,6,2,30,0,15 super bowl snack worth feasting
1,2,8,41,2,8,0,49,0,swiss watch industry great digital disrupter?
1,3,13,47,1,12,0,60,0,internet freaking remy ma's savage nicki minaj dis track
1,1,6,23,0,5,0,29,0,famous blonde marry
1,2,1,40,0,9,2,41,0,expensive home buy 28 country
1,2,4,31,0,7,4,35,0,watch performance 2017 grammys
1,2,9,64,2,16,2,73,0,"tom hanks, david nott dustin hoffman: 10 men whose desert island disc must listen"
1,1,8,32,0,9,6,40,0,15 creative college essay prompt 2015
1,1,6,26,0,6,2,32,0,15 reason guacamole better boy
1,1,17,55,3,14,3,72,0,19-year-old creates jaw-droppingly realistic 3d art make double take
1,1,9,44,0,9,1,53,0,8 christmas miracle actually happened canada year
1,1,9,38,0,8,0,47,0,harry potter fanfic helped discover sexuality
1,1,8,29,1,8,2,37,0,19 thing probably ever see vega
1,1,10,35,0,9,0,45,0,guy invented rorschach test really hot
1,2,8,25,0,8,2,33,0,21 powerful photo thisweek
1,1,15,53,5,14,0,68,0,"director adele's ""hello"" video said reaction flip phone ""drives crazy"""
1,1,9,29,0,8,0,38,0,figure theme crossword
1,3,7,23,2,8,4,30,0,music headed 2017? here's peek
1,1,12,35,0,11,0,47,0,tip make sure never run condom
1,1,9,35,0,9,2,44,0,18 totally awesome gift chicagoan life
1,1,11,36,1,13,10,47,0,13 reason taylor swift's 1989 world tour best part 2015
1,2,1,63,4,16,2,64,0,"year, woman lived $1.2 million home sister corpse"
1,2,2,37,1,5,0,39,0,texas teacher suspended anti-trump stunt
1,2,3,28,0,5,0,31,0,stunning fall aaron hernandez
1,2,4,27,2,6,0,31,0,japanese driver buy u cars?
1,1,9,39,0,9,2,48,0,13 healthy thanksgiving trick one even notice
1,1,7,31,0,6,0,38,0,richard madden looking attractive horse
1,1,10,30,0,9,2,40,0,23 borderline genius way make home calm af
1,2,11,70,1,19,0,81,0,messy room affect sleep: hoarder take longer nod dozy daytime
1,1,9,37,0,8,0,46,0,hilary duff phone every twentysomething ever
1,1,7,23,0,7,2,30,0,14 apps help manage anxiety
1,3,12,55,3,13,3,67,0,"$206 phone case kendall jenner, hailey baldwin, model obsessed"
1,1,11,38,0,9,0,49,0,shondaland hunk date based zodiac
1,1,9,24,0,9,2,33,0,18 sale almost good true
1,3,6,32,2,8,0,38,0,disney go gay beauty beast remake
1,3,4,51,1,7,0,55,0,melbourne terrorist plot: alleged christmas day attack thwarted
1,1,10,15,1,5,0,25,0,what's great life
1,3,9,53,1,10,1,62,0,kristaps porzingis get revenge dwight howard 1-handed poster dunk
1,3,5,52,1,11,0,57,0,"two nba coach speak trump, listen"
1,1,6,29,0,6,2,35,0,19 reason chicken actually cutest
1,3,14,59,4,19,8,73,0,watch e! news season 2016 excerpt free online best 2016: hottest movie couple yahoo view
1,1,4,24,0,4,2,28,0,17 insanely relatable animal vine
1,1,10,32,3,10,2,42,0,"24 ""yo momma"" joke bad they're actually good"
1,3,3,41,1,10,0,44,0,spent christmas alone got exactly wanted
1,1,6,18,2,5,0,24,0,"""mean girls"" nun"
1,1,11,32,2,9,0,43,0,what's best mary-kate ashley movie time
1,3,12,44,3,12,2,56,0,25 valentine's day gift important person life (you)
1,1,10,51,0,9,0,61,0,everyone still haunted fucking shirley temple informercial
1,1,4,14,0,3,0,18,0,choose death
1,1,7,30,3,6,0,37,0,"character disney's ""recess"""
1,1,7,42,0,7,2,49,0,21 ridiculous way people actually injured
1,1,10,37,0,9,0,47,0,easiest way make vegan fettuccine alfredo
1,1,5,19,1,4,0,24,0,abuela know sick
1,1,11,50,0,10,0,61,0,blake lively ryan reynolds continue actual relationship goal
1,1,16,47,5,14,0,63,0,"people upset meryl streep's ""i'd rather rebel slave"" t-shirt"
1,2,16,48,2,14,1,64,0,great good enough: 6 essential stand mba applicant pool
1,1,13,54,2,13,2,67,0,11 way reality valentine's day live instagram expectation
1,2,7,24,4,9,4,31,0,helen mirren: 2016 big pile sh*t
1,1,15,57,3,15,2,72,0,"kenan thompson kel mitchell reunited ""the tonight show"" '90s dream came true"
1,1,12,42,4,12,2,54,0,"16 reaction real listened adele's ""hello"""
1,1,10,43,1,10,2,53,0,16 thing rebellious school definitely
1,3,1,58,1,13,0,59,0,today's first grader better big skill kid decade ago
1,1,16,50,2,15,0,66,0,"target pulling ""star wars"" shirt boy writes leia scene"
1,3,14,48,2,13,0,62,0,meet india's womens' ice hockey team still struggling ice rink
1,1,7,15,0,6,0,22,0,girl girl group
1,3,2,21,0,7,0,23,0,want home watch
1,1,9,41,0,9,2,50,0,18 confession people waiting marriage sex
1,1,10,32,0,10,2,42,0,13 thing happen hang frenemy
1,1,8,39,0,8,2,47,0,22 dog totally nailed geeky halloween costume
1,1,9,45,0,9,2,54,0,17 uncommon survival product actually change life
1,1,9,40,0,9,2,49,0,15 thing nobody think tell leaving university
1,1,8,41,2,7,0,49,0,"meet dhee, bangladesh's first lesbian comic book character"
1,3,2,34,0,4,0,36,0,corruption claim taint ukraine military
1,1,14,47,0,13,0,61,0,know favorite ed sheeran song based taylor swift choose
1,1,9,44,0,9,2,53,0,13 movie theater hack make moviegoing experience better
1,1,15,38,0,12,0,53,0,know animal gif make laugh based zodiac
1,1,13,39,2,12,0,52,0,"long would survive ""game thrones"" based sign"
1,1,3,14,0,3,2,17,0,11 bad sex confession
1,1,10,38,1,8,0,48,0,pick heart-shaped potato reveal potato soulmate
1,1,8,29,3,6,0,37,0,everyone stop appreciate t.i.'s fur jacket
1,3,5,53,1,10,0,58,0,people extremely confused bbc journalist's hand list
1,1,13,52,2,12,0,65,0,"zodiac date based favorite ""game thrones"" character"
1,2,2,52,0,12,0,54,0,facebook message prank genius way troll friend
1,1,12,44,0,11,0,56,0,know favorite britney spear song based zodiac sign
1,2,17,58,3,13,0,75,0,"ranveer-deepika's new year plans, salman beat srk world entertainment"
1,1,8,26,0,7,0,34,0,like dannii kylie minogue
1,2,12,68,1,13,0,80,0,"crushing loss, ronda rousey suddenly appears standing rock protest dakota pipeline"
1,3,6,24,0,6,0,30,0,next crisis come
1,2,2,57,0,9,2,59,0,destination 10 dish cannot leave netherlands without eating
1,3,13,66,3,14,0,79,0,gorka: story secretary state tillerson refuse eye contact diplomat fake news
1,3,3,73,5,15,0,76,0,professor called trump election act terrorism. became victim terror.
1,1,13,46,2,11,0,59,0,cara delevingne accused ripping indie brand's t-shirt
1,3,13,72,3,16,0,85,0,matt schlapp: kansa special election warning shot member congress used winning easily
1,1,9,25,0,9,2,34,0,22 dog want watch world burn
1,1,12,47,1,11,2,59,0,21 three-ingredient vegan dessert easy delicious
1,1,8,29,2,6,0,37,0,wiz live! made hate-watching obsolete
1,1,16,43,1,11,0,59,0,top-ranked olympic skier gu kenworthy come gay espn cover
1,1,11,47,0,10,0,58,0,horrifying cable company customer service story
1,3,5,28,0,7,2,33,0,25 expensive zip code america
1,3,4,14,1,4,5,18,0,mitt romneys e2 summit 2015
1,1,12,43,1,10,0,55,0,man changing autumn game patio-cleaning drone
1,2,2,86,3,18,0,88,0,teeth attack 'healthy' snacks: growing problem one many dentist failing treat
1,2,6,30,1,5,0,36,0,indiana town entire police force resigns
1,1,12,43,0,11,0,55,0,woman made photo series every stage mastectomy
1,2,2,29,1,5,0,31,0,reaction trump's top diplomat pick
1,2,9,40,0,11,3,49,0,new research show zombie would end human race 100 day
1,1,8,31,0,8,2,39,0,19 incredibly easy way get shit together
1,3,8,46,1,11,4,54,0,report: american 18 34 live parent spouse
1,1,7,24,0,7,2,31,0,17 thing child want know
1,2,2,41,3,10,7,43,0,100 woman 2016: indian woman 'loiter' public place night
1,2,1,65,0,13,2,66,0,psychologist identified 10 factor explain fall love
1,3,3,43,2,8,0,46,0,falcons' mohamed sanu positive in-flight role model
1,3,11,39,2,10,0,50,0,paul ryan every house republican (except one)
1,1,13,47,2,10,0,60,0,"ryan reynolds surprise mega ""deadpool"" fan ticket nyc premiere"
1,1,7,38,0,7,2,45,0,19 insanely gorgeous lipstick color worth every penny
1,2,6,55,2,10,0,61,0,george michael wham! baffled communist china inspired youth
1,1,10,34,2,10,2,44,0,"13 level prove ""super mario maker"" pure evil"
1,2,14,53,4,13,0,67,0,n.b.a. finals: golden state warrior get mad pull even cleveland cavalier
1,3,15,72,3,14,0,87,0,"prince charles urge brit think muhammad christmas, speaks aggressive populism"
1,3,3,35,2,8,3,38,0,triple j's hottest 100: everything need know
1,1,17,65,1,17,0,82,0,teen used actual scarlet letter clever way protest school's sexist dress code
1,1,12,39,1,11,2,51,0,15 tumblr post ya novel make laugh every time
1,1,10,45,1,9,0,55,0,viola davis give perfect response nancy grahn's criticism
1,1,8,34,0,8,2,42,0,22 picture prove everyone totally faking
1,3,1,37,2,6,0,38,0,man drive airport terminal 'for love'
1,1,8,19,1,6,1,27,0,pigskin blanket: nfl week 3 pick
1,3,3,57,1,10,0,60,0,native title: federal government move change act court ruling
1,1,9,28,0,9,2,37,0,26 phone note funny damn reason
1,3,9,25,1,8,0,34,0,would brown dwarf near u cook earth?
1,2,14,47,3,12,0,61,0,"welcome triple-double era: nba stars, legend shocked got"
1,1,11,39,0,10,0,50,0,identify romantic comedy based single quote
1,1,10,33,0,9,0,43,0,nirvana song based zodiac sign
1,3,4,43,2,7,0,47,0,rex tillerson: trump's top diplomat really belief
1,2,13,61,10,13,0,74,0,"watch: obama anger translator bid farewell: good luck healthcare a**holes, im"
1,1,10,52,0,10,2,62,0,15 hilarious tweet narendra modi hanging francois hollande
1,1,6,25,1,5,0,31,0,know disneyland rides' history
1,1,13,44,2,10,0,57,0,"leslie jones made lorne michael move seat ""snl"" audition"
1,1,7,40,0,8,6,47,0,26 time celebrity couple defined relationship goal 2015
1,1,6,19,1,5,0,25,0,fred savage can't go home
1,1,8,19,1,6,1,27,0,pigskin blanket: nfl week 5 pick
1,1,11,23,2,8,2,34,0,"21 time ""the crowd"" made literally lol"
1,3,7,42,2,9,2,49,0,elizabeth warren fails disclose $1.3 million line credit
1,1,6,15,0,4,0,21,0,furniture iq
1,1,7,13,0,6,0,20,0,much dick
1,3,10,50,4,12,0,60,0,conway chuck todd: going rethink relationship
1,2,6,22,0,7,6,28,0,29 beauty product try in2017
1,1,8,19,1,6,2,27,0,pigskin blanket: nfl week 17 pick
1,1,10,42,1,9,0,52,0,real place inspired disney's magic kingdom
1,1,9,40,0,9,2,49,0,29 time japanese twitter lost shit kawaii critter
1,1,10,35,0,10,2,45,0,29 snuggly thing keep comfy great outdoors
1,1,8,37,0,8,2,45,0,19 time twitter perfectly summed inner grandma
1,3,3,62,1,9,0,65,0,strange tale donald trump reported intelligence community overhaul
1,1,7,23,0,6,0,30,0,well know popular slogan
1,3,1,66,4,14,0,67,0,"butler team plane loses cabin pressure; coach say 'it scary, guy crying'"
1,3,8,36,2,8,0,44,0,italian vote pose test european central bank
1,2,6,54,2,9,0,60,0,donald trump's press secretary sean spicer's daft punk tweet resurface
1,3,25,49,3,16,0,74,0,delingpole: tom steyer deep russian call impaled vlad
1,1,11,42,0,11,2,53,0,19 reason british fast food way better american fast food
1,2,7,31,0,7,2,38,0,18 image woman truly understand
1,3,8,34,1,8,2,42,0,40 incredible thing didnt know emmastone
1,3,2,58,4,14,0,60,0,"no, customer 'always right': nice retail staff"
1,2,10,47,0,9,0,57,0,refugee developed smart jewelry protect woman assault
1,1,9,42,2,8,0,51,0,"hogwarts house ""friends"" character belong"
1,3,8,30,3,8,2,38,0,27 secret probably didnt catch rogueone
1,1,8,35,0,8,2,43,0,42 storage idea organize entire house
1,1,12,41,0,11,0,53,0,sid beagle running austin mayor mean business
1,1,12,42,0,11,0,54,0,cop ended delivering baby routine traffic stop
1,1,5,28,0,5,2,33,0,17 simply stunning sheer wedding dress
1,1,9,39,0,9,2,48,0,18 thing everyone chunky highlight relate
1,1,6,28,0,5,0,34,0,musical theatre character
1,2,4,12,1,4,0,16,0,safe dna?
1,1,15,46,0,14,0,61,0,react message show kind online dater
1,1,9,31,3,9,2,40,0,18 vegan mac 'n' cheese recipe make drool
1,1,12,39,0,11,0,51,0,woman share story really hurt vagina
1,1,15,59,1,13,0,74,0,faith hill responded tim mcgraw's marriage proposal adorable way possible
1,1,10,31,1,9,0,41,0,craziest thing seen dentist
1,1,9,49,0,8,0,58,0,child latino family reveal sacrifice parent made
1,1,9,37,0,9,2,46,0,14 reason rainbow color look gorgeous black hair
1,1,13,31,0,13,4,44,0,dog starring best elf shelf photo 2015
1,1,6,25,0,7,6,31,0,17 funniest tweet grammar 2015
1,2,2,65,0,14,0,67,0,kid toy detailed genitalia people want know list
1,1,9,34,0,8,0,43,0,native american said stuff white people say
1,1,10,40,0,9,0,50,0,eating pork avocado sandwich dinner
1,1,14,58,0,13,0,72,0,ariana grande reunited broadway composer jason robert brown feel good
1,1,6,31,0,6,2,37,0,22 thing every people person understand
1,2,4,74,0,15,0,78,0,woman threatened murder uncovered hair saudi arabia list
1,1,8,26,1,8,2,34,0,"20 year ago, winter looked like"
1,1,9,42,1,8,0,51,0,radiohead release rejected bond theme song haunting
1,1,6,16,0,5,0,22,0,need talk kesha
1,1,9,30,0,9,2,39,0,19 way make everyone work retail hate
1,3,2,52,2,9,1,54,0,7 heartwarming prediction 'love actually' reunion
1,3,6,25,0,6,1,31,0,5 smart way pull together
1,3,6,20,0,6,0,26,0,app like tinder weed
1,1,8,38,2,8,3,46,0,"106 ""star wars"" quote make perfect instagram caption"
1,3,2,64,1,12,0,66,0,"cook christmas turkey upside stop drying out, researcher claim"
1,1,9,29,0,10,6,38,0,26 state fair food 2015 blow mind
1,1,8,34,1,7,0,42,0,would rather: new year resolution edition
1,3,14,45,0,13,0,59,0,guy proposed high school sweetheart last day ofchemo
1,2,8,55,3,8,0,63,0,undercover journo report: migrant centre breeding ground terrorist
1,1,13,35,1,13,3,48,0,$100 night get airbnbs around world
1,1,9,29,1,8,0,38,0,hilary duff's son luca might actual angel
1,1,10,36,2,11,2,46,0,"24 word ""how met mother"" fan really understand"
1,1,7,39,0,7,2,46,0,25 mildly irritating thing drive introvert crazy
1,2,7,43,0,10,1,50,0,texas woman sentenced 8 year prison illegal voting
1,3,10,59,5,10,0,69,0,andrea mitchell: sean spicer first press briefing substantive responsive
1,1,12,47,0,11,0,59,0,oprah talking love bread leave weirdly inspired
1,2,11,40,4,10,0,51,0,parent doctor think a.d.h.d. preschool
1,2,2,61,1,15,0,63,0,there's story behind video man punching kangaroo head list
1,2,5,61,3,9,0,66,0,mashreads podcast: 'the shining' perfectly understands winter cabin fever
1,1,9,25,2,8,2,34,0,"31 time ""frasier"" wittiest show tv"
1,3,10,41,3,7,0,51,0,u.s. tobacco industry rebound near-death experience
1,3,8,36,1,8,0,44,0,brie larson's beautiful red gown hidden message
1,1,4,23,0,3,0,27,0,american try brazilian sweet
1,1,10,39,1,10,2,49,0,17 colorado trail every hiker's bucket list
1,1,15,45,0,13,0,60,0,lot people twitter mistakenly grieving dj named david zowie
1,1,8,30,0,7,0,38,0,female celebrity shoe size twin
1,1,10,44,2,9,0,54,0,"hogwarts house ""gossip girl"" character belong"
1,3,2,75,0,15,0,77,0,astronaut learning become space explorer one least likely place earth
1,1,3,14,1,2,0,17,0,trader joe's parking
1,3,9,42,1,11,0,51,0,"complete guide jewish food, earth mean"
1,2,9,41,2,10,0,50,0,win grammy best tropical latin album? vote!
1,1,7,40,0,7,2,47,0,17 mouthwatering risotto guaranteed change life
1,3,9,36,1,9,0,45,0,new makeup tool waste foundation
1,1,14,53,1,13,0,67,0,let's take moment appreciate uncontested queen julie andrew
1,3,4,73,0,17,0,77,0,take look employee company like facebook linkedin fun office
1,1,6,34,0,7,6,40,0,41 devastatingly british thing happened 2015
1,1,7,30,0,7,2,37,0,23 cat portrait describe life goal
1,1,8,24,0,7,0,32,0,deal anxiety college
1,1,10,26,1,9,0,36,0,tell us: ever snapped one work
1,1,11,47,0,10,0,58,0,taylor swift performing stagecoach actually weekend
1,1,10,33,0,9,4,43,0,improve life 2016 buzzfeed life challenge
1,1,7,22,0,6,0,29,0,baby koala joeys cute
1,1,13,36,0,13,2,49,0,15 easy thing help feel like shit
1,1,7,29,1,6,2,36,0,20-minute chicken recipe add arsenal
1,1,9,27,0,10,6,36,0,18 time james blunt took shit twitter 2015
1,1,8,35,1,8,2,43,0,17 photo perfectly sum snapchat vs. instagram
1,1,13,40,0,12,0,53,0,genius figured take perfect selfie dog
1,3,5,32,4,7,0,37,0,marine le pen: who's funding france's far right?
1,1,10,32,2,10,2,42,0,"24 ""back future"" tattoo blow mind"
1,3,6,31,0,6,4,37,0,lady antebellum reveals 2017 acm award nominee
1,1,8,23,1,7,0,31,0,oh god there's drake coloring book
1,1,11,31,0,9,2,42,0,21 thing everyone obsessed cv know true
1,1,8,34,1,6,0,42,0,off-brand halloween costume wear
1,2,6,64,2,12,0,70,0,"charles barkley laugh lebron james' barbs, stand critique cavalier star"
1,3,14,49,3,13,0,63,0,"dear marvel, need recast ""doctor strange"" guy waybetter"
1,2,12,31,0,10,1,43,0,5 gorgeous diy food gift one believe made
1,3,1,46,0,12,6,47,0,32 powerful economy world 2050
1,2,9,41,0,10,0,50,0,video capture delta pilot smacking woman break fight
1,1,9,38,2,8,0,47,0,"well remember ""the nightmare christmas"""
1,1,8,38,0,8,2,46,0,26 important nonfiction book reading
1,1,10,39,0,10,2,49,0,29 hilarious music tweet make laugh every time
1,1,13,42,2,13,2,55,0,"19 time barney stinson real romantic ""how met mother"""
1,1,10,38,0,9,0,48,0,type dance music match favorite cat breed
1,1,5,13,0,4,2,18,0,12 tree looking sexy af
1,1,7,34,1,6,0,41,0,definitive ranking babyface's greatest hit
1,1,17,57,4,16,0,74,0,"saw ""the force awakens"" without seeing ""star wars"" movie happened"
1,1,11,22,1,8,0,33,0,like ppd black woman
1,1,4,24,0,3,0,28,0,chocolate rainbow surprise cake
1,1,11,40,1,9,0,51,0,amandla stenberg co-wrote comic starring young black hero
1,3,12,41,2,10,0,53,0,next u.s. election happening sooner might think
1,1,6,31,0,6,2,37,0,23 satisfying gaming achievement
1,3,13,34,5,14,2,47,0,get 90% quiz youre fast furiousexpert
1,1,7,48,1,6,0,55,0,makeup artist's celebrity transformation spectacular
1,1,7,34,0,7,2,41,0,17 realization woman jean shopping
1,1,7,38,1,6,0,45,0,one tweet capture chennai's unbreakable spirit
1,1,12,49,0,11,0,61,0,pole dancing santa toy might worst christmas decoration ever
1,1,12,49,0,11,0,61,0,kid schooled stacey dash importance black history month
1,3,1,46,2,11,2,47,0,"plug in, tune out: 30 podcasts get holiday"
1,1,10,38,1,9,0,48,0,everything need know lush's bath bomb factory
1,2,1,28,1,6,0,29,0,get fooled phone fraud?
1,1,9,38,1,9,2,47,0,19 savory vegetarian dish warm winter
1,2,4,70,1,14,0,74,0,multiple sclerosis: new blood test identify type m treatment working
1,1,15,60,1,14,0,75,0,pitted budget luxury dry shampoo here's happened
1,3,12,39,0,13,5,51,0,5 student loan change could help pay debt 2017
1,2,10,33,1,8,0,43,0,santa monica firefighter us cpr save dog life
1,1,9,36,0,9,2,45,0,15 easy affordable stocking filler buy right
1,1,10,30,2,9,0,40,0,"oh god, rob kardashian might dating tyga's ex"
1,1,10,25,0,8,0,35,0,marvel tv show give shot
1,1,7,33,0,7,2,40,0,15 really random thing make adorable stamp
1,3,8,34,1,8,0,42,0,lawyer: racist note given black waitress fake
1,1,9,41,1,7,0,50,0,bernie sander impression out-bernies real bernie
1,3,3,62,1,11,3,65,0,destination british airway offering business class seat less 100
1,2,15,65,0,14,0,80,0,transgender cub scout nail donald trump wrong remove protection trans student
1,1,14,47,1,12,0,61,0,ta'rhonda jones auditioned role ramona singer perfect
1,1,10,41,2,9,0,51,0,let's congratulate twitter verifying kamaal r. khan
1,1,12,41,1,11,0,53,0,"today national working naked day, take clothes"
1,1,13,22,1,11,6,35,0,39 thing show tv 2015 emas
1,3,3,52,1,13,6,55,0,here's 10 wall street pro predicting stock market 2017
1,1,9,39,0,9,2,48,0,15 scrumptious oreo dessert literally worthy
1,1,8,31,0,8,2,39,0,26 product every whale lover need home
1,1,9,35,1,8,0,44,0,what's beautiful college campus world
1,1,15,48,0,14,0,63,0,angry cat rescued shelter taking internet
1,1,7,32,0,7,2,39,0,17 mildly infuriating people must stopped
1,2,11,39,0,10,0,50,0,people discovered perfect way mess cat
1,1,9,34,1,7,2,43,0,26 inspiring dog nyc's biggest halloween parade
1,1,8,26,1,7,0,34,0,said it: gene belcher chris griffin
1,3,11,39,1,10,0,50,0,weirdest christmas tree ever see
1,3,4,48,2,7,0,52,0,bisbol life: season-long celebration latino ballplayer
1,3,10,46,4,12,0,56,0,dem rep jeffries: jim crow niece nephew white house
1,2,15,45,2,13,0,60,0,man went abroad brought back disease u.s. doctor never seen
1,1,7,30,0,7,2,37,0,23 secret museum steward never tell
1,1,10,36,1,9,0,46,0,"men, stephen king really important message"
1,1,5,26,0,4,0,31,0,everyday item mexican origin
1,1,9,37,0,9,1,46,0,9 new fact prove hollywood diversity problem
1,1,12,43,2,11,0,55,0,"know plastic based ""mean girls"" halloween trivia"
1,1,7,21,0,6,0,28,0,know secretly hate adele
1,1,14,37,1,12,3,51,0,find hilarious dog gif 100% one question
1,3,2,43,3,6,0,45,0,'vanpacker' tourist irk council australia's coast
1,3,8,32,0,8,2,40,0,24 celebrity never knew barbie
1,2,23,21,2,11,0,44,0,stock slip end year: here's need know
1,1,7,32,1,6,2,39,0,18 ultra-personalized gift keep
1,1,10,38,0,9,0,48,0,guy recreated pizza rat people lost shit
1,1,10,17,1,7,0,27,0,iud me: lesbian love story
1,1,8,39,0,8,2,47,0,16 time bollywood star shut troll perfectly
1,1,10,57,1,9,0,67,0,hollywood actor performed monologue women's abortion story
1,1,5,19,0,4,0,24,0,struggle twin
1,1,12,56,0,11,0,68,0,people putting instant coffee spaghetti bolognaise reason
1,2,1,25,0,5,0,26,0,dropping acid saved life
1,3,14,34,2,10,0,48,0,flynn: trump jump shark dropped bombs?
1,1,10,44,0,10,2,54,0,21 insanely creepy santa claus photo may ruin christmas
1,1,13,42,0,12,0,55,0,demi lovato accused stealing sample new song
1,1,17,63,3,16,0,80,0,"guy watched ""breaking bad"" three day straight emotional roller coaster"
1,1,17,55,0,16,0,72,0,kanye west unknowingly fell love beck song dinner taylor swift
1,3,5,64,3,10,0,69,0,'moonlight' director barry jenkins' next project underground railroad
1,1,12,32,2,9,0,44,0,could pas defence dark art o.w.l
1,1,18,0,0,4,0,18,0,pooped pant
1,3,2,50,2,11,0,52,0,hell f*cking yes verizon's new unlimited data plan good deal
1,2,11,42,2,10,0,53,0,here's keep mumbai's seashore much polluted time
1,2,9,35,0,10,6,44,0,20 rising web development design blog follow 2017
1,1,8,32,2,8,2,40,0,"21 time tumblr funniest ""game thrones"""
1,1,9,32,0,8,0,41,0,celebrity zodiac sign
1,2,3,47,0,12,0,50,0,much coffee date ivanka trump cost
1,2,3,77,0,12,0,80,0,polish christmas advert grandfather learns english touch heart around world
1,1,7,31,0,7,2,38,0,19 picture smell like childhood
1,1,9,32,2,8,0,41,0,"michelle gomez took ""which doctor you"" quiz"
1,3,1,53,0,10,0,54,0,new dating app aim include people disability
1,1,7,25,0,6,0,32,0,tiny corgi hate tiny pumpkin
1,1,6,26,1,8,9,32,0,12 headline 2015 100% actually true
1,1,13,33,3,10,0,46,0,"well remember lyric lfo's ""summer girls"""
1,1,13,41,0,12,0,54,0,hollywood daddy based first letter name
1,1,9,35,2,9,1,44,0,well remember ted mosby's girlfriends? part 2
1,1,6,26,0,5,0,32,0,jimmy fallon keep getting injured
1,1,5,17,1,5,2,22,0,get '70s inspired nail
1,1,14,57,1,14,2,71,0,"thought watching season 11 premiere ""keeping kardashians"
1,3,11,41,3,8,0,52,0,dnc chair brazile: trump victory tainted russian intrusion
1,2,5,86,3,17,0,91,0,"trump asked african american lose. rural kentucky community, answer tangible."
1,3,2,63,2,15,0,65,0,young thug show music video shoot stop director
1,3,13,52,4,12,0,65,0,politifact: trump debt claim mostly false even though number factual
1,2,2,59,0,9,0,61,0,tesla finally begun producing battery massive gigafactory
1,3,6,61,2,12,0,67,0,joe greene would said 'goodbye' antonio brown facebook live incident
1,1,13,44,0,13,2,57,0,16 struggle way real people constantly pee
1,3,1,40,2,9,0,41,0,driver loses car parking garage -- six month
1,3,12,50,2,10,0,62,0,six nostalgic two-wheelers immortalised memories!
1,3,1,51,3,10,0,52,0,video woman's drug overdose go viral; speaking
1,1,8,42,1,8,2,50,0,25 beautiful vintage picture new orleans' vibrant culture
1,1,8,36,0,6,0,44,0,zendaya coleman officially newest covergirl
1,3,1,47,1,8,0,48,0,meet woman who's making consumer boycott great
1,3,2,50,3,10,4,52,0,"here's first look mercedes' new 1,000 horsepower hybrid supercar"
1,2,1,36,0,7,0,37,0,brewery give time new puppy parent
1,1,6,34,2,6,2,40,0,"24 unusual, subtle, beautiful scottish tattoo"
1,3,12,52,2,11,0,64,0,'boss baby' author say comparing trump infant character make total sense
1,1,11,32,0,11,2,43,0,27 best emo song add breakup playlist
1,1,7,29,2,6,0,36,0,"""inside amy schumer"" character"
1,1,14,46,1,13,0,60,0,zoo allowed tiny meerkat pup's outside first time
1,1,5,15,1,4,2,20,0,18 must-have shoe fall
1,1,4,19,0,3,0,23,0,slow cooker mexican dish
1,2,10,60,4,11,0,70,0,white house official: trump seeking reboot egypt relationship al-sisi visit
1,1,12,40,3,11,0,52,0,"celebrity read lyric ""sorry"" got freakin'"
1,3,16,61,1,15,0,77,0,people coming hilarious meme ruin united airline result savage!
1,3,14,36,0,14,2,50,0,19 thing know wear load makeup none atall
1,1,10,38,0,10,2,48,0,26 clever product make office much better
1,1,11,37,0,10,0,48,0,one question tell people love
1,1,11,34,0,11,2,45,0,36 thing make riding car much better
1,1,7,36,0,7,2,43,0,12 confession people struggle anxiety
1,2,11,66,1,12,1,77,0,9 actor underwent amazing transformation shocked u unrecognisable look
1,3,6,31,0,6,0,37,0,drake jennifer lopez fuel dating rumor
1,1,9,33,0,8,0,42,0,got snake massage actually relaxing
1,2,7,24,0,5,0,31,0,dj kool herc reminisces biggie
1,1,8,35,0,7,0,43,0,weirdest misheard christmas lyric time
1,1,9,19,0,8,0,28,0,know much virgin
1,1,9,33,0,9,2,42,0,14 similarity black hole love life
1,3,9,43,0,9,1,52,0,5 way scammer exploit facebook feed false information
1,3,10,55,4,13,2,65,0,"german foreign minister: trump, old world 20th century finally"
1,1,8,29,0,7,0,37,0,vincent crabbe gregory goyle
1,1,7,24,2,7,2,31,0,"23 funniest ""nancy drew"" game meme"
1,2,5,69,3,13,0,74,0,donald trump immigration ban: detained iraqi refugee say 'america land freedom'
1,1,9,28,0,9,2,37,0,27 big thing people letting go year
1,3,3,32,2,5,0,35,0,what's next women's march participant
1,3,14,48,4,16,3,62,0,"gujarat, government peon 3 flats, 3 land plots, 1 office space two cars!"
1,2,8,41,0,8,2,49,0,23 hilariously genius lie parent actually told theirkids
1,2,1,41,0,8,2,42,0,41 dead siberia drinking toxic bath essence
1,3,12,56,3,15,0,68,0,conway: dems time cry weep airport vote trump nomination
1,1,11,38,0,11,2,49,0,19 easy hot lunch idea warm freezing office
1,1,10,38,0,9,0,48,0,bradley cooper ryan gosling leading man
1,3,5,42,1,11,0,47,0,dab made atlanta hip-hop u congress
1,3,9,62,2,11,4,71,0,obamas state department sponsored 2016 meeting russian ambassador sen. session
1,2,10,41,2,9,0,51,0,star-studded guest list set obamas final white house bash
1,3,3,29,1,7,0,32,0,buyer wanted: tiny oregon town sale
1,2,16,59,3,14,0,75,0,"apple device can't hacked? researcher hack macbook pro, hijack touch bar prove point"
1,3,1,37,1,9,0,38,0,doctor wrong call too-busy mum
1,1,9,35,0,9,2,44,0,20 time olivia wilde realest person twitter
1,1,8,25,2,9,4,33,0,19 thing '90s kid they're old
1,2,1,40,1,11,0,41,0,raise profile work keep
1,3,2,29,2,5,0,31,0,"shaq flat-earther too, apparently"
1,3,17,69,2,16,0,86,0,identity mystery girl took everyone adventurous ride revealed. here's happened
1,3,1,55,3,11,1,56,0,"persistent 6-year-old boy see man lying parking lot, save life"
1,1,8,30,0,8,2,38,0,22 product every dog lover need life
1,1,9,34,1,8,2,43,0,15 game-changing eyeliner chart suck makeup
1,1,11,40,0,11,2,51,0,18 celebrity men actually really pleased see
1,1,14,55,3,12,0,69,0,oprah winfrey best possible response asked t.i.'s recent comment
1,2,4,42,0,10,0,46,0,one man worse twitter donald trump
1,1,6,24,0,6,2,30,0,26 movie ruin appetite
1,1,15,51,0,14,0,66,0,bride groom went kansa city royal playoff game wedding
1,1,8,40,1,7,2,48,0,30 halloween costume true pun-lovers appreciate
1,1,11,54,1,9,0,65,0,instagram caused outrage deleting post-mastectomy tattoo account
1,1,8,23,0,7,0,31,0,han solo indiana jones
1,3,1,51,0,9,0,52,0,earbuds let send text emoji facial exspressions
1,1,8,23,2,7,0,31,0,"tyra tiffany ""top model"""
1,2,6,24,1,6,0,30,0,"yes, trump held accountable"
1,1,12,39,0,11,0,51,0,guess lana del rey music video screenshot
1,1,9,38,1,9,2,47,0,22 celebrity face summed year's golden globe
1,1,12,57,2,12,2,69,0,"17 weird, gross, hilarious thing everyone school football team together"
1,1,5,17,0,4,0,22,0,annabeth chase
1,1,7,27,0,6,0,34,0,celebrity sugar daddy
1,1,12,36,3,9,0,48,0,"official ""ahs: hotel"" opening credit creepy hell"
1,1,13,28,0,12,0,41,0,lil bub new yule log video need see
1,2,11,42,2,10,0,53,0,people selling makeup dumpster dives. buy it?
1,2,1,50,0,7,0,51,0,four way technology transforming museum experience
1,1,11,46,1,11,2,57,0,28 chocolate peanut butter treat even better reese's
1,2,13,44,1,11,0,57,0,porn site rerouting utah user online sex-ed resource
1,1,10,50,1,10,2,60,0,17 face everyone who's experienced halloween cold understand
1,1,7,20,1,8,6,27,0,39 star get enough 2015
1,1,12,38,0,11,0,50,0,gave celebs fifth grade spelling test bombed
1,1,9,32,2,8,0,41,0,"learning say word ""depression"" saved life"
1,1,9,31,0,9,2,40,0,19 lie parent guilty telling public
1,1,11,44,1,10,0,55,0,model made history victoria's secret fashion show
1,2,6,49,2,12,0,55,0,russia turkey brokered peace syria -- sidelined u
1,1,15,59,2,13,2,74,0,one tweet helped indian railway ministry save 19-year-old human trafficker
1,1,6,13,3,5,0,19,0,"i'm democrat, i'm"
1,2,14,38,5,8,0,52,0,"left-wing anti-hate splc cheated tax laws, say legal complaint"
1,1,7,36,1,7,2,43,0,21 photo people skipped science understand
1,1,10,30,0,10,2,40,0,21 reason fall love cat person
1,1,8,32,0,8,2,40,0,25 art history snapchats make giggle
1,1,7,31,0,7,2,38,0,21 gardening project get winter
1,3,8,42,1,9,0,50,0,report: nicolas cage offered role ronald reagan biopic
1,3,6,61,1,10,0,67,0,three gop faction could doom republican obamacare replacement bill
1,1,13,48,1,11,0,61,0,extraordinary close-up photo animal eye look world
1,1,15,45,0,14,0,60,0,got drunk funeral industry find happens die
1,1,4,20,0,5,6,24,0,21 outfit 2000s girl lusted
1,1,11,40,2,10,0,51,0,"josh flagg josh altman ""million dollar listing"""
1,1,7,34,0,7,2,41,0,19 secret hotel receptionist never tell
1,2,13,23,2,8,0,36,0,espn's nfl mvp poll: derek carr take top spot
1,1,11,42,0,10,0,53,0,favorite classic video game mascot say
1,1,14,37,0,13,2,51,0,12 amazing ya book latino author wont able put
1,1,12,47,3,10,0,59,0,"congrats, denzel washington! actor receive cecil b. demille award"
1,1,9,38,2,8,0,47,0,"""friday night lights"" high school experience"
1,1,10,32,3,9,0,42,0,"new cafe every ""friends"" fan's dream come true"
1,1,11,36,0,10,0,47,0,struggle android user iphone world
1,3,1,42,0,9,1,43,0,5 easy trick make iphone storage last longer
1,1,15,51,0,14,0,66,0,know unnecessary chore parent make zodiac sign
1,1,12,58,2,11,0,70,0,here's what's wrong article claiming champagne improves memory
1,3,19,35,2,11,0,54,0,trappist worlds: invest backup planet earth?
1,3,9,56,3,8,0,65,0,hijab-wearing beauty contestant land prestigious modeling contract [video]
1,2,1,50,1,5,0,51,0,technology could redefine doctor-patient relationship
1,1,14,41,3,13,0,55,0,"student made best cover adele's ""hello"" may ever hear"
1,2,14,56,0,13,0,70,0,people losing student publicly roasted college two word
1,1,9,43,2,8,0,52,0,"celebrity reading lyric ""hotline bling"" hilarious"
1,2,4,37,1,6,0,41,0,ernesto zedillo: mexico thrive without trump
1,1,11,38,3,10,0,49,0,"here's need know woman ""transcendent"""
1,1,8,27,0,8,2,35,0,28 foolproof way eat pizza every damn day
1,1,12,46,1,12,2,58,0,23 time zayn malik's twitter profound place internet
1,1,14,37,1,14,2,51,0,22 thing way real girl like girl
1,1,12,31,0,9,0,43,0,hbo series watch based sign
1,1,6,25,0,5,0,31,0,badass anime character
1,1,9,25,0,8,0,34,0,much cheese addict really
1,1,10,24,0,10,6,34,0,25 fact 2015 make feel old af
1,1,13,37,1,8,0,50,0,#inmyskiniwin hashtag prof skin beautiful
1,1,7,35,0,7,2,42,0,24 bizarre animal named celebrity
1,1,8,42,2,8,2,50,0,"22 hilariously accurate moment ""being canadian"""
1,1,7,31,0,7,2,38,0,24 hillarious tweet perfectly sum life
1,3,19,61,3,17,0,80,0,steve o'keefe prof india's nemesis virat kohli's unbeaten streak test come end
1,1,11,40,0,10,0,51,0,new beauty trend us piece plexiglas color hair
1,3,11,57,1,11,2,68,0,"woman documented breast cancer diagnosis, 43 million people responded"
1,2,6,73,0,13,0,79,0,good morning america incredibly offensive way introducing hillary clinton list
1,1,13,41,0,12,0,54,0,know harry style tweet based birth month
1,1,10,33,0,9,0,43,0,guess magazine remove title
1,1,15,46,0,14,0,61,0,woman tried live like kylie jenner week exhausting
1,1,11,39,0,10,0,50,0,classic movie intro film essay
1,1,9,31,0,8,0,40,0,know christmas movie star
1,1,5,15,0,5,4,20,0,well remember 2015
1,2,7,30,1,6,0,37,0,attractive people earn fatter paycheck?
1,1,12,41,0,11,0,53,0,may first couple official wedding hashtag
1,3,19,55,0,18,0,74,0,team india need want come back series australia
1,1,8,31,0,8,2,39,0,16 london street food change life
1,1,9,31,3,8,0,40,0,"what's favorite ""mean girls"" quote time"
1,1,14,39,2,13,0,53,0,people know david bowie we're clear
1,3,3,62,2,8,0,65,0,toddler's misunderstanding inspires perfect new year's family tradition
1,1,3,16,1,3,0,19,0,snack makeover yogurt
1,1,8,32,2,8,2,40,0,"22 reason fan obsessed ""the walking dead"""
1,1,7,34,0,7,2,41,0,15 insane confession buckingham palace guard
1,1,5,25,0,4,0,30,0,american guess german curse word
1,3,5,75,2,12,0,80,0,isabel gayther: message appear missing london student's facebook page manhunt continues
1,1,8,30,1,8,1,38,0,what's horoscope week november 9
1,1,6,23,0,7,6,29,0,24 funniest animal post tumblr 2015
1,3,1,39,2,6,0,40,0,season's first marquee weekend reveal?
1,3,2,47,0,9,0,49,0,tony robbins explains key becoming business owner
1,1,7,29,0,7,2,36,0,19 gift every classical music nerd love
1,1,13,36,0,12,0,49,0,know country live based thing hate
1,1,10,21,2,7,0,31,0,"guess celebrity ""vpl"""
1,2,7,34,0,7,0,41,0,app want solve sneaker release problem
1,3,3,45,1,7,0,48,0,tim cook see augmented reality rivaling iphone's impact
1,1,11,36,0,10,0,47,0,quesadilla best thing ever worthy
1,1,8,39,0,9,5,47,0,5 ridiculous thing science claimed bearded men 2015
1,1,13,34,0,12,0,47,0,know iphone based emoji choose
1,1,9,31,0,8,0,40,0,color blot test reveal inner fear
1,1,6,25,1,7,5,31,0,18 teeny tiny silver necklace 100% need
1,1,9,33,1,8,0,42,0,show u best halloween costume ever made
1,3,3,28,0,6,2,31,0,10 book famous ceo loved reading
1,1,15,56,0,14,0,71,0,people got ear extracted first time grossly hilarious
1,2,17,39,3,14,3,56,0,28-year-old retired nyc net worth $2 million
1,1,11,44,1,10,0,55,0,"david brent quote picture brendan rodgers,"
1,1,9,39,0,8,0,48,0,guy draw octopus portrait vice president
1,1,10,36,3,9,0,46,0,"still know original ""sister, sister"" theme song"
1,1,9,37,0,9,2,46,0,27 annoying thing every bartender endure
1,1,7,35,0,7,2,42,0,24 annoying thing hairy girl understand
1,1,11,39,2,10,0,50,0,"meet pumpkin, orphaned raccoon think dog"
1,1,8,39,1,8,2,47,0,"15 photo prove goat underrated, majestic being"
1,2,10,39,0,9,0,49,0,netflix reinvents reality tv making show six time
1,1,10,34,0,10,2,44,0,16 reason people shower night right
1,1,13,47,2,12,0,60,0,"myth hymen virginity get busted ""adam ruin everything"""
1,1,9,36,2,9,2,45,0,"13 ""one tree hill"" question impossible answer"
1,1,8,35,0,8,2,43,0,21 totally unexpected holiday card send year
1,1,8,37,0,8,2,45,0,31 actually helpful tip dealing panic attack
1,1,9,31,2,10,4,40,0,"23 thing anyone whose love ""30 rock"" never died"
1,1,7,31,0,6,0,38,0,couple watch kiss slow motion
1,1,7,36,0,7,2,43,0,31 brilliant kitchen product holiday season
1,2,1,29,3,10,4,30,0,world 2016: much know? quiz
1,2,1,63,4,13,2,64,0,must-have 'fatbit' fitness gadget exaggerate step count 25% every day
1,2,6,32,0,8,0,38,0,wonder republican hid health bill
1,3,9,38,1,8,0,47,0,woman's powerful photo show danger tanning
1,1,8,37,0,8,1,45,0,8 picture calvin harris literally buying rug
1,1,8,28,0,8,2,36,0,24 time lucy hale heart instagram
1,1,9,55,4,8,0,64,0,"robert pattinson thought ""twilight"" character ""suicidally depressed"""
1,3,7,61,1,14,0,68,0,leading brain crazy pirouette: bridget riley de la warr pavilion
1,1,9,49,0,9,2,58,0,18 hilarious bollywood movie review commenters torrent site
1,1,9,38,2,9,2,47,0,"22 impossible ""who wore best"" question animal lover"
1,2,10,57,2,12,4,67,0,senate confirms dr. ben carson 58-41 lead housing urban development department
1,1,9,31,0,8,0,40,0,know favorite ryan based one question
1,1,13,63,1,12,0,76,0,"rihanna literally incredibly, amazingly beautiful dior paris fashion week show"
1,1,10,41,0,9,0,51,0,family photo everybody internet freaking
1,1,12,43,1,11,0,55,0,sandra bullock case flipping men's role woman
1,2,4,22,0,3,0,26,0,trouble screenshorts
1,1,6,22,0,6,2,28,0,17 creepy london walk must take
1,3,4,32,1,8,0,36,0,trail: brilliance night sky
1,2,10,44,3,10,2,54,0,50 cent talk kanye west hospitalization: 'you could see coming'
1,1,6,31,0,6,2,37,0,21 time adele actually fucking hilarious
1,1,11,39,1,10,0,50,0,what's underrated place get cute clothes work
1,1,10,41,1,9,0,51,0,here's feminist advice lucille ball gave carol burnett
1,1,6,21,0,5,0,27,0,need talk nickelback
1,1,14,44,0,14,2,58,0,50 cent let money talking instagram response rick ross
1,1,11,33,2,10,0,44,0,"arm glow new life goal, thanks lupita nyong'o"
1,1,11,51,4,10,0,62,0,"here's ""keeping kardashians"" addressed lamar odom's overdose"
1,2,0,36,1,7,1,36,0,6 low-sweat exercise beat summer heat
1,2,8,44,0,7,0,52,0,julianne hough get honest dealing endometriosis
1,1,10,28,0,9,0,38,0,celeb mom based birth month
1,1,8,34,1,8,0,42,0,here's actually buy black friday
1,3,13,66,2,12,2,79,0,france identifies 39-year-old suspected islamist shot officer paris attacker
1,3,8,30,1,8,2,38,0,17 way trick people thinking yourecool
1,1,10,33,0,10,1,43,0,9 toilet make choose shit pant
1,3,2,17,2,5,8,19,0,week pictures: 11-17 march 2017
1,1,10,43,1,9,0,53,0,trader joe's frozen food section basically lazy paradise
1,1,13,42,0,13,2,55,0,19 life hack make feel like shit together
1,3,12,45,3,12,2,57,0,23 joke youll find funny youre adult hasnt masteredadulting
1,1,11,25,0,8,0,36,0,well remember ne mario game
1,1,10,24,0,11,6,34,0,15 time try guy went little far 2015
1,1,8,29,2,7,2,37,0,day 1 buzzfeed's 7-day clean eating challenge
1,1,7,32,0,7,1,39,0,8 urban dictionary definition need know
1,1,5,27,0,4,0,32,0,shocking confession teen mother
1,1,9,35,1,8,0,44,0,what's absolute favorite song sing karaoke
1,3,2,54,1,10,0,56,0,worst holiday: guardian writer break nearly broke
1,3,7,79,3,14,0,86,0,homeless? starving? cheer up! great depression billboard told poor american lucky
1,1,15,49,1,13,0,64,0,beyonce jay-z singing along britney spear concert give life
1,1,11,35,1,9,2,46,0,19 thing understand multiple bffs
1,3,8,38,0,8,1,46,0,7 lesson small business learn tech startup
1,1,8,23,1,8,2,31,0,17 photo make sense men
1,1,10,34,1,10,2,44,0,17 time internet nailed like virgo
1,1,6,26,2,6,1,32,0,"""team fortress 2"" character"
1,1,10,29,2,9,0,39,0,"arlo spot ""the good dinosaur"""
1,1,9,34,2,8,0,43,0,"channing tatum ""lip sync battle"" jenna dewan tatum"
1,1,9,35,1,8,0,44,0,actually know much alcohol drinking
1,1,11,40,0,10,0,51,0,curry adorable family play date playground
1,1,4,22,0,4,2,26,0,24 incredibly useful iphone apps
1,1,10,30,2,9,0,40,0,"well remember ""one tree hill"" finale"
1,1,16,56,1,15,0,72,0,mom's shocking facebook photo show wary people kissing baby
1,1,11,34,1,11,1,45,0,5 woman tried bunch suit here's happened
1,1,14,54,0,13,0,68,0,happens little girl help men create perfect text crush
1,2,1,42,2,9,5,43,0,"nissan recall 56,000 cars, cite power steering"
1,2,10,52,0,10,0,62,0,meryl streep us lifetime achievement award speech bash donald trump
1,3,8,31,3,8,2,39,0,"17 ""family feud"" answer make feel smart"
1,2,1,52,1,16,0,53,0,lot way get rich one way stay way
1,3,2,64,1,10,0,66,0,embarrassing reason behind amazon huge cloud computing outage week
1,2,2,48,2,13,4,50,0,name woman 'most likely' get pregnant 2017 list
1,1,13,58,1,12,0,71,0,watch trans teenager's emotional reaction getting first dose hormone
1,1,8,13,2,3,0,21,0,*nsync vs. backstreet boy
1,1,7,21,1,6,0,28,0,late say something
1,1,7,38,1,7,6,45,0,25 life-changing thing chrissy teigen instagrammed 2015
1,1,10,29,1,7,0,39,0,"fyi, drake made one really hot basketball coach"
1,1,11,50,2,11,2,61,0,"18 photo prove ""harry potter"" actor actually character"
1,3,1,40,0,8,0,41,0,twitter going nut cheating ex video
1,1,6,33,1,6,2,39,0,adorable animal advent calendar: december 17
1,1,10,28,2,9,0,38,0,"well know first episode ""buffy"""
1,1,7,24,0,5,2,31,0,literally 17 awesome science gifs
1,1,9,29,1,8,0,38,0,what's weirdest punishment got kid
1,1,9,35,0,8,0,44,0,tried different meditation apps ease anxiety
1,3,9,36,0,9,2,45,0,12 obvious fact make strangelyhappy
1,1,8,43,0,8,2,51,0,19 totally underrated place get affordable jewelry online
1,1,11,34,4,11,2,45,0,"25 photo make makeup addict say ""oh god, yes!"""
1,3,12,29,1,8,0,41,0,draft do-overs every nfl team wish could
1,1,13,57,0,13,2,70,0,16 moment everyone bringing significant home meet family
1,2,2,44,1,8,0,46,0,syria: six simple question complicated conflict
1,1,8,19,1,6,1,27,0,pigskin blanket: nfl week 4 pick
1,1,6,20,1,6,0,26,0,quick easy vegan mac cheese
1,1,12,30,1,10,6,42,0,25 gif-worthy moment 2015 blue jay season
1,1,7,29,0,7,2,36,0,18 least productive member society
1,1,12,41,0,11,0,53,0,spot difference kate bush actual bush
1,3,1,51,0,10,0,52,0,washington line huge shipment political theater
1,2,1,41,3,8,0,42,0,snow stylish: ice-cool fashion shoot picture
1,1,7,27,2,8,6,34,0,"16 time 2015 proved ""harry potter"" never die"
1,1,13,45,1,9,0,58,0,asos's upcoming wedding dress line insanely pretty affordable
1,3,8,37,2,10,0,45,0,lou gehrig fixer-upper awaits buyer long run
1,2,12,44,0,9,0,56,0,jennifer lawrence rock short short apartment hunting nyc
1,3,18,66,0,16,0,84,0,u congressman say pakistan given single dollar unless act haqqani
1,1,8,26,0,7,0,34,0,black widow scarlet witch
1,1,16,48,1,16,6,64,0,"guy sent debra messing dick pic shared 257,000 twitter follower"
1,2,9,30,0,9,2,39,0,12 thing realize end relationship
1,1,7,22,0,7,2,29,0,30 thing need cook november
1,3,11,35,1,9,0,46,0,"cnn panic french election, admits le pen could win"
1,1,7,28,0,7,2,35,0,22 thing need know emetophobia
1,3,3,52,7,7,0,55,0,do-nothing congress graduate do-nothing-much congress
1,1,8,35,1,8,2,43,0,19 valentine's day sweet guaranteed get kissed
1,1,11,32,0,10,0,43,0,club mate hipster energy drink need try
1,1,7,16,0,6,0,23,0,went black college
1,3,10,33,1,10,0,43,0,divided america: die depends live
1,1,8,27,0,8,2,35,0,30 video make laugh every time
1,1,10,48,0,10,2,58,0,15 insanely delicious stuffed cooky better boyfriend
1,3,2,72,0,14,0,74,0,madonna give powerful speech woman music industry billboard award
1,1,10,45,0,9,0,55,0,everyone slightly obsessed texas roadhouse bread
1,1,6,22,1,5,0,28,0,gender politics: sex said
1,1,10,34,1,9,0,44,0,"thought hotel safe secure, think"
1,1,11,25,0,8,2,36,0,21 amazing holiday book need read asap
1,1,7,21,0,8,6,28,0,16 important dog vine 2015
1,1,10,41,0,9,0,51,0,need take new pottermore sorting quiz immediately
1,1,9,36,3,9,2,45,0,"26 hilarious ""elf"" quote make laugh every time"
1,3,15,50,2,14,0,65,0,here's world's richest cricket board dug grave sank deep
1,1,9,34,0,9,2,43,0,18 time people took modi obsession damn far
1,1,8,39,0,10,2,47,0,18 easy way become morning runner without even trying
1,1,9,40,0,8,4,49,0,proof national treasure shia labeouf transcended 2015
1,1,17,49,3,15,4,66,0,"1,000-year-old skeleton ripped earth storm blew giant tree"
1,1,7,25,1,8,4,32,0,15 rad lunch box every '90s girl begged
1,1,12,46,2,11,0,58,0,"""pretty little liars"" character based zodiac sign"
1,3,9,31,1,8,0,40,0,year's extreme weather one book
1,1,12,53,2,11,0,65,0,"here's proof one direction feel really, really awkward talking zayn"
1,1,8,41,0,7,0,49,0,introvert posted honest caption instagrams
1,1,7,36,0,6,0,43,0,video game couple match relationship
1,1,9,24,0,8,0,33,0,tell u time really fucked
1,1,15,50,1,14,0,65,0,carly rae jepsen recorded song simlish actually going love
1,1,6,25,0,5,0,31,0,wes anderson character
1,1,10,37,1,9,0,47,0,person write haiku valentine's day
1,1,14,40,1,12,0,54,0,dance-off meghan trainor taught man bun
1,2,7,60,1,12,0,67,0,champagne guy fawkes masks: inauguration party donald trump russia
1,1,10,35,0,9,0,45,0,fucked thing happen christmas
1,1,10,33,0,10,2,43,0,21 thing actually win lottery
1,1,12,35,4,11,0,47,0,"know lyric ""bullfrog love"" ""the office"""
1,1,13,51,2,12,0,64,0,ring 'ol cheating alarm: calvin harris spotted leaving grocery store
1,2,6,72,3,16,0,78,0,'not white woman' clothing line launched woman show vote donald trump
1,3,13,77,5,14,0,90,0,trumpocrat david mudcat saunders: charge racism white nationalism steve bannon insane
1,1,5,29,0,4,0,34,0,condiment suit personality
1,3,5,31,2,6,0,36,0,women's march washington: top moment
1,3,1,44,0,5,0,45,0,chinese billionaire offer biggest education prize
1,1,14,50,2,13,0,64,0,"everyone lot feeling ""hey arnold"" christmas special"
1,1,8,34,1,8,2,42,0,19 reason brazil still world's favourite team
1,1,3,14,0,2,0,17,0,people try kombucha
1,1,10,36,1,10,2,46,0,13 valentine's day card people bad feeling
1,1,10,35,0,9,0,45,0,telenovela hunk get hot bothered
1,3,1,72,3,14,0,73,0,small town coverup deputy use-of-force show happen video
1,1,3,16,0,2,0,19,0,sweatersexual
1,1,13,45,5,12,0,58,0,"mashup ""love yourself"" ""hands myself"" really, really good"
1,1,11,38,0,11,2,49,0,15 way relate squidward tentacle winter
1,1,7,26,0,6,0,33,0,nervous baseball fan
1,1,9,24,0,8,0,33,0,hole heart almost killed
1,1,10,43,0,10,2,53,0,22 tweet procrastination make laugh loud
1,2,11,42,5,10,0,53,0,nbc's 'hairspray live!': best social medium reaction show
1,1,18,51,2,17,0,69,0,"story saw james franco get live ""circumcision"" bar mitzvah"
1,1,14,42,2,13,0,56,0,"tom hank jimmy fallon act ""bridge spies"" truest form"
1,1,10,41,0,9,0,51,0,toronto opened nutella cafe people going hazelnut
1,1,12,25,2,9,0,37,0,"tbt taylor swift make go ""awww"""
1,1,5,32,0,5,2,37,0,15 bumper sticker twentysomethings need
1,3,8,34,0,8,1,42,0,5 susan rice scandal fact every american must know
1,1,12,47,3,11,0,59,0,"guys, there's tumblr that's dedicated cake bollywood movie"
1,1,11,34,2,11,2,45,0,"20 outfit ""mean girls"" one would ever wear"
1,1,11,39,0,10,0,50,0,city visit based taste chocolate
1,1,11,35,0,10,0,46,0,lady gaga outfit based birth month
1,2,11,38,2,11,4,49,0,'clean sleeping' expected biggest health rage 2017
1,3,14,45,2,14,0,59,0,woman's random act kindness dad daughter going viral
1,2,0,43,0,9,1,43,0,6 thing never store work computer
1,1,12,34,1,12,2,46,0,16 pet want bring lil' sunshine life
1,1,8,29,2,8,2,37,0,"21 time rose ""titanic"" terrible human"
1,1,7,26,0,6,0,33,0,classic car driving
1,1,11,37,0,11,2,48,0,iraq held first beauty pageant 40 year
1,1,8,25,0,8,2,33,0,17 thing girl love boob
1,1,7,24,0,6,0,31,0,next boyfriend like
1,2,1,58,0,8,1,59,0,5 shocking revelation tennessee teacher criminal complaint
1,3,10,46,1,11,0,56,0,time sunday's grammy award got political insider
1,1,9,37,0,8,0,46,0,actually remember cereal mascot look like
1,3,4,21,0,4,0,25,0,predict nfl playoff field
1,1,15,36,1,10,0,51,0,artist reimagined popular tv show all-poc cast
1,1,8,37,1,7,0,45,0,carrie fisher's french bulldog brighten day
1,1,10,31,0,9,0,41,0,best tip keeping weight
1,1,15,50,3,14,0,65,0,"believe much original ""wedding march"" sheet music sale"
1,1,10,38,0,10,2,48,0,12 way get bacon fix without giving cancer
1,1,9,31,0,8,0,40,0,guess celeb pixelated image
1,3,3,56,2,10,0,59,0,travel back black-and-white mac interface apple emulator
1,1,11,51,1,10,0,62,0,canadians: get post without viscerally enraged
1,2,13,27,3,11,0,40,0,"mariah carey yg link video ""i don't"""
1,1,8,34,1,8,2,42,0,'90s cartoon human eye may ruin childhood
1,2,11,43,1,10,0,54,0,"samsung phone caught fire, according samsung"
1,1,13,35,1,13,3,48,0,guy made root beer float scratch cost $900
1,1,11,34,0,11,2,45,0,21 thing anyone ever student relate
1,1,10,29,0,9,0,39,0,french braid bun damn pretty hurt
1,1,10,28,0,9,0,38,0,many cat find hiding photo
1,1,8,36,2,7,2,44,0,17 delectable no-bake dessert change life
1,3,9,38,0,9,1,47,0,8 gross thing happen share beauty product
1,2,8,26,3,8,0,34,0,mike lee: health care bill going fail
1,1,9,41,0,9,2,50,0,15 brutally honest tube badge every londoner need right
1,3,12,32,1,12,3,44,0,true crime expert get 7/10 thisquiz
1,1,9,40,1,8,0,49,0,watch gay indian man's stunning transformation drag
1,3,2,24,1,5,0,26,0,walmart buying brands?
1,1,10,41,3,10,2,51,0,"11 question every ""doctor who"" fan has, answered steven moffat"
1,1,10,30,0,9,0,40,0,jonathan cheban kind dick social medium
1,2,9,25,2,10,0,34,0,know ryan sharpay youare
1,3,2,40,1,8,0,42,0,justice sight india's riot rape survivor
1,1,8,37,0,8,2,45,0,21 kitchen gadget actually help eat healthier
1,2,5,48,4,10,0,53,0,eu fuss trump ambassador pick? he perfectly cast
1,1,7,28,2,6,0,35,0,"""the secret circle"" character"
1,1,7,45,1,7,2,52,0,21 mouthwatering breakfast casserole change life
1,1,15,57,2,14,0,72,0,"jennifer lawrence texted amy schumer looked ""pretty smart"" emmy"
1,1,6,25,1,4,0,31,0,kardashian-jenner girl
1,1,8,31,2,8,1,39,0,"8 time ""bake off"" restored faith humanity"
1,3,2,65,1,16,2,67,0,window lean head banger: 10 best position sleeping plane
1,3,9,34,0,9,2,43,0,39 fucking awesome gift anyone love toswear
1,1,9,35,0,9,2,44,0,10 quiz take family holiday season
1,1,11,32,0,11,2,43,0,17 picture sum life really skinny girl
1,1,13,31,3,12,0,44,0,"well know lyric ""it me"" shaggy"
1,1,6,17,1,5,0,23,0,honest: would hit
1,2,2,51,2,8,0,53,0,caught tech-handed: criminal snared stupidity
1,1,18,61,0,17,0,79,0,five sister photo shoot thank parent paying wedding
1,3,8,32,1,8,2,40,0,literally 17 dick joke thatll make laugh
1,2,3,46,0,10,0,49,0,view russia islam say politics
1,2,3,47,2,11,0,50,0,"trump want pipe built america, mean?"
1,1,13,49,3,12,0,62,0,"guy selling ""authentic"" fall leaves, people actually buying"
1,1,9,43,1,8,2,52,0,17 emotionally raw confession people low self-esteem
1,3,2,32,2,5,0,34,0,'star wars' location actually exist
1,1,10,31,0,10,1,41,0,8 new type goth better health goth
1,1,9,30,0,9,2,39,0,14 people totally saved phone
1,1,12,44,3,10,0,56,0,"adorable girl become ""spider-mable"" fight crime edmonton"
1,3,6,62,4,13,0,68,0,'you're joking' watch moment ian stewart arrested murdering helen bailey
1,1,10,31,0,10,2,41,0,24 picture make way much sense drive
1,1,13,34,0,12,0,47,0,went grammys last night learned
1,1,12,42,0,11,0,54,0,guess favorite girl scout cookie based zodiac
1,2,2,64,0,16,0,66,0,one thing never hair first thing morning list
1,3,4,52,1,8,0,56,0,jan gehl: architect responsible making melbourne liveable
1,3,1,66,4,13,1,67,0,"'famine mannequins', 7 time women's high street shop got totally wrong"
1,3,7,22,0,8,6,29,0,50 worst thing internet in2016
1,1,11,37,0,11,2,48,0,19 image way real anyone us instagram
1,3,5,18,2,7,4,23,0,best tour 2016? vote!
1,1,8,26,0,7,0,34,0,would friend blair serena
1,2,8,34,1,7,0,42,0,here's quantum computing change world
1,2,4,35,2,5,0,39,0,joe biden's favorite obama-biden meme revealed
1,2,3,44,1,9,0,47,0,developer tell facebook: fight fake news
1,2,5,52,3,10,1,57,0,"star war 9: carrie fisher digitally added, lucasfilm confirms"
1,2,10,51,3,11,0,61,0,stephen curry poke fun daughter riley's postgame antic 'family guy'
1,3,6,24,1,6,0,30,0,obamas' best pop culture moment
1,1,15,35,2,13,0,50,0,"new ""star wars"" tv spot give away secret han solo"
1,1,8,44,1,7,0,52,0,dog perfectly photobombed owners' engagement photo
1,1,9,28,0,10,6,37,0,23 thing improve mental health 2016
1,1,10,33,0,10,2,43,0,22 thing totally forgot used facebook
1,1,11,50,2,10,0,61,0,"hilarious ""harry potter"" comic ask james lily potter question"
1,2,8,40,0,10,0,48,0,power simple life change prevent heart disease
1,1,8,40,0,8,2,48,0,33 hilarious reason people actually cried period
1,1,10,38,1,10,4,48,0,here's save money 2016 clean eating challenge
1,1,9,36,0,8,0,45,0,played telephone pictionary got weird quick
1,2,7,30,2,6,0,37,0,new york's best wing festival amazewing!
1,1,10,27,0,9,0,37,0,two dog real life elsa anna
1,1,8,29,0,8,2,37,0,16 thing girl twenty
1,1,10,41,1,9,0,51,0,groundhog animal predict future
1,1,16,53,0,13,0,69,0,leonardo dicaprio turning ya novel address climate change movie
1,1,7,20,1,7,2,27,0,19 sign mum house
1,3,9,60,1,11,0,69,0,obama crush conspiracy: evidence russia tampered vote election
1,1,11,44,0,12,5,55,0,8 indian woman made headline 2015 calling wedding
1,1,10,34,1,10,2,44,0,24 picture perfectly prove bad
1,2,12,61,3,11,0,73,0,"'jimmy kimmel' asks warrior fan fake issues, get hilariously serious response"
1,2,10,35,1,9,0,45,0,earth's ocean warming lot faster thought
1,1,10,28,1,11,6,38,0,24 pop song help sing along 2007
1,1,7,32,0,7,2,39,0,actually name 12 classic cocktail
1,1,15,62,0,14,0,77,0,grossest thing internet week involves wrestler extremely strong junk
1,1,8,34,0,7,0,42,0,well actually know kourtney kardashian
1,3,3,70,0,13,0,73,0,ukip candidate gisella allen say would bring back death penalty guillotine
1,3,15,62,2,14,0,77,0,virat kohli's team make india proud thrashing england here's world reacted
1,2,5,30,0,5,1,35,0,7 people influencing canadian style today
1,1,7,31,0,7,2,38,0,27 kid totally nailed halloween thing
1,2,9,51,5,7,0,60,0,"roland martin: trump hoodwinked, bamboozled white working-class voter"
1,1,16,45,0,15,0,61,0,bow wow clue kill time grammys hilarious
1,1,11,43,0,10,0,54,0,stone cold steve austin try fancy cocktail first time
1,2,1,47,2,9,1,48,0,4-year-old made unlikely friend grocery store
1,1,13,46,0,12,0,59,0,iconic beatles ashram rishikesh open public
1,1,5,21,0,3,2,26,0,17 inexplicably delightful gifs
1,3,1,40,2,5,0,41,0,"social media, celebrities, transgender youth"
1,1,10,36,3,9,0,46,0,"remember ""northern downpour"" panic! disco"
1,1,10,35,0,11,6,45,0,22 hilarious tweet prove grindr worst 2015
1,3,9,45,0,10,0,54,0,ripcord remove pain paper cut robot digital filer
1,1,13,37,0,12,0,50,0,talked people preparing end world
1,1,6,28,0,6,2,34,0,12 reason masculinity terrible men
1,1,9,46,0,9,2,55,0,17 insanely creative cupcake guaranteed win halloween
1,3,6,29,0,5,0,35,0,five secret public speaking success
1,1,9,40,0,8,0,49,0,identify element periodic symbol
1,1,8,36,1,8,2,44,0,14 cat quite understand christmas thing
1,3,3,54,3,9,0,57,0,@work advice: supervisor body odor make meeting impossible
1,1,10,49,0,10,2,59,0,23 absolute nightmare makeup lover experienced point
1,1,10,39,0,9,0,49,0,guess favorite hobby based random question
1,1,11,42,1,11,2,53,0,steph curry predicted fate '90s burger king commercial
1,2,2,51,0,10,0,53,0,williams sister thank success
1,3,13,48,1,9,0,61,0,gap internationalvoice: every ceo know organic growth
1,2,13,44,1,12,0,57,0,"two woman get wild brawl walmart shampoo aisle, child joinsin"
1,1,14,45,1,14,1,59,0,woman best response tinder date asked $5 back
1,1,10,45,0,9,0,55,0,everyone talking genius couch netherlands
1,2,4,41,1,10,0,45,0,apple pay get much better business insider
1,1,11,42,0,10,0,53,0,man dy sucked plane engine mumbai airport
1,1,11,32,2,9,0,43,0,iggy azalea tried clap back t.i. twitter
1,1,9,25,3,8,0,34,0,"harry marv ""home alone?"""
1,3,10,40,3,9,0,50,0,cnn: obama fired parting shot towards israel netanyahu
1,2,3,66,0,13,0,69,0,science behind stop stalking ex facebook christmas
1,1,10,28,0,10,4,38,0,best thing happened 2015
1,1,8,26,0,8,2,34,0,16 reason take shath every day
1,1,5,20,0,5,2,25,0,22 thing messy couple know
1,2,8,41,0,11,1,49,0,7 cocktail make game throne finale go easier
1,1,8,22,0,7,0,30,0,well know earth space
1,1,10,44,1,10,2,54,0,17 hilarious bathroom wall message make pee pant
1,3,11,43,2,10,3,54,0,maha shivaratri pm modi inaugurates 112- foot tall adiyogi statue!
1,1,6,25,0,6,2,31,0,17 reason never wear makeup
1,2,7,26,1,6,0,33,0,food actually hipster ornot?
1,1,9,41,3,8,0,50,0,what's worst valentine's day present ever received
1,1,9,27,0,8,0,36,0,guess movie santa claus
1,3,5,67,3,12,0,72,0,human zoo: documentary shed light stolen aboriginal people 'treated animals'
1,3,17,58,4,14,0,75,0,self-styled godman 'builder baba' owned bar noida arrested multi-crore fraud case
1,2,11,44,0,11,2,55,0,17 white woman could play rachel dolezal inevitablemovie
1,1,9,37,0,8,0,46,0,match eyebrow celebrity owner
1,1,17,56,5,15,0,73,0,"seth rogen, joseph gordon-levitt, anthony mackie play epic game ""never ever"""
1,1,10,30,0,10,2,40,0,16 weird thing say grandkids
1,1,5,16,0,4,0,21,0,halsey song
1,3,8,35,0,10,2,43,0,13 great story nothing politics
1,2,1,35,0,6,2,36,0,24 thing consider taking adderall
1,3,9,36,3,8,0,45,0,"transgender officer help build trust, ease fear d.c."
1,1,19,66,2,18,0,85,0,"tweeted ariana frankie grande ""the new michael janet"" people freaked fuck"
1,3,12,47,0,11,0,59,0,agency trying remind federal worker still right
1,1,7,22,0,7,2,29,0,26 people left alone
1,3,6,27,0,5,0,33,0,pricey new drug promise eczema relief
1,3,7,33,2,6,0,40,0,use facebooks new snapchat-like feature
1,2,1,54,2,9,0,55,0,blockbuster assemble: mega movie survive digital era?
1,1,11,41,0,11,2,52,0,17 easy slow cooker snack eat watch sunday football
1,1,8,32,2,8,2,40,0,"21 ""harry potter"" fanfictions read die"
1,2,5,18,1,5,2,23,0,shawn mendes' 10 best deep cut
1,1,9,41,1,8,2,50,0,16 easy delicious recipe completely turkey-free
1,1,6,36,1,6,2,42,0,16 confession librarian surprise
1,1,12,42,1,11,0,54,0,know meet soulmate based one question
1,1,12,51,1,11,0,63,0,emotional neglect turning many pakistan's boy criminal
1,1,12,39,1,11,0,51,0,"picture avril lavigne bruce willis so, awk"
1,1,5,24,2,4,0,29,0,"""goldbergs"" character"
1,1,10,37,0,9,0,47,0,guess christmas movie amazon review
1,1,6,21,0,5,0,27,0,vagina horror story
1,1,6,25,0,6,2,31,0,27 people reached peak college
1,3,2,62,4,10,0,64,0,local praise 'hilarious' police facebook appeal man 'avoiding calls'
1,3,4,50,2,13,0,54,0,soon need card withdraw cash shady bank's atm
1,3,6,20,1,6,0,26,0,"stay shape, add squash"
1,1,12,37,0,12,2,49,0,15 problem people tired time know well
1,1,10,40,1,9,0,50,0,anyone considers monster lady gaga's
1,1,10,30,0,8,2,40,0,51 thing happen bff depression
1,3,6,40,0,8,0,46,0,successful sneaker reselling business
1,1,7,23,2,6,0,30,0,"""inside amy schumer"" amy"
1,1,11,45,2,11,2,56,0,26 thing actually make sense unless twenty
1,1,8,33,0,7,0,41,0,favourite emojis actually mean
1,1,9,34,2,7,0,43,0,what's best all-natural beauty product
1,1,11,34,2,8,0,45,0,kind chanel-o-ween gift actually deserve
1,2,2,63,1,14,0,65,0,"perfect male female bodies, according men woman list"
1,1,8,30,0,8,2,38,0,15 household item need replace right
1,1,8,35,0,8,2,43,0,22 secret teen magazine staffer never tell
1,1,6,22,2,4,2,28,0,24 healthy on-the-go breakfast idea
1,1,7,10,0,4,1,17,0,5sos guy
1,3,4,56,2,10,0,60,0,woman marched donald trump. they're running office
1,1,10,41,1,10,2,51,0,18 thing happen way younger sibling
1,3,3,39,1,8,0,42,0,berlin christmas market attack: know far
1,3,11,39,1,11,2,50,0,12 adult actor played teen vs. teen really looklike
1,1,12,43,0,11,0,55,0,kanye west called wiz khalifa twitter incredible
1,2,12,45,1,11,0,57,0,people love guy way solve dinner fight girlfriend
1,1,11,28,0,10,0,39,0,guess name based taste men
1,3,11,50,3,11,0,61,0,schumer: trump inaugural crowd booing doesnt speak kindly
1,1,8,40,1,7,2,48,0,21 last-minute halloween decoration make
1,1,13,42,0,12,0,55,0,best product get sephora gift card
1,1,5,20,1,4,0,25,0,woman talk men's nipple
1,3,9,30,0,8,0,39,0,shale boom turned world upside
1,1,6,25,0,6,2,31,0,19 tweet sum female friendship
1,3,1,59,1,13,0,60,0,baby's accidental fall changing table ended saving life
1,1,7,15,0,6,0,22,0,take joke far
1,1,7,21,0,7,2,28,0,17 dog want bed back
1,2,1,44,2,7,0,45,0,church's culture shame increasing abortions?
1,1,13,32,1,11,0,45,0,know movie like re-watch based age
1,1,11,29,0,11,2,40,0,15 people took nae nae whole level
1,1,6,29,1,5,0,35,0,david bowie's iconic fashion moment
1,2,7,30,1,6,0,37,0,lipstick toxic? gwyneth paltrow think
1,1,7,27,0,6,0,34,0,demi lovato mental health journey
1,1,10,32,2,9,0,42,0,"ranking winner ""top model"" worst best"
1,1,6,31,2,5,0,37,0,"""smallville"" changed tom welling forever"
1,1,17,57,2,16,0,74,0,"character ""the rocky horror picture show"" based taste hot dog"
1,2,15,58,4,17,4,73,0,watch e! news season 2016 excerpt free online inside kris jenner's holiday home yahoo view
1,1,10,26,1,10,2,36,0,22 cat we've point life
1,1,9,31,0,9,2,40,0,21 tweet brace way real
1,3,3,53,0,11,1,56,0,9 british irish christmas tradition need adopt right
1,1,9,36,0,9,2,45,0,21 thing boston university student know true
1,1,4,18,0,3,0,22,0,big batch breakfast bakes
1,1,16,47,2,16,2,63,0,"13 rare photo cast ""a cinderella story"" give feel"
1,1,10,29,0,9,0,39,0,weird thing secret crush
1,1,11,44,0,10,2,55,0,17 thing american student studying uk understand
1,1,12,43,5,12,0,55,0,"sascha radetsky look back ""center stage"" ahead ""flesh bone"""
1,1,7,38,1,6,0,45,0,gordon ramsay's insult motivational poster
1,1,11,35,1,10,0,46,0,stop look new pluto photo
1,3,4,58,2,13,0,62,0,young prince reimagining saudi arabia. make vision come true?
1,3,16,41,3,8,0,57,0,exclusive islamic state supporter celebrate berlin truck attack
1,1,5,12,0,5,2,17,0,12 stage gay sex
1,1,8,23,0,9,6,31,0,24 guy totally rocked man bun 2015
1,1,12,50,2,11,0,62,0,"lonely luke latest hilarious ""star wars"" parody twitter account"
1,1,12,41,0,12,2,53,0,answer 12 pressing star war question
1,2,1,43,3,11,4,44,0,"'message bottle' found 9,000 mile away tech twist"
1,1,12,34,1,11,0,46,0,best place get dope men's clothes cheap
1,1,9,35,0,8,0,44,0,gave american euro confused
1,1,15,52,3,14,0,67,0,"here's first look eddie redmayne ""fantastic beast find them"""
1,3,2,45,0,9,6,47,0,17 cheapest holiday destination outside europe 2017
1,1,7,25,0,6,0,32,0,much know supermodel
1,1,9,39,0,9,2,48,0,12 photo people million playing powerball
1,1,12,45,2,12,2,57,0,"name 30 mentioned character ""hunger games"" book"
1,2,2,57,1,7,0,59,0,unnoticed trend worry europe counterterrorism agency
1,1,9,34,2,7,0,43,0,sunset hair arrived drop-dead beautiful
1,1,9,25,0,8,0,34,0,much potato addict really
1,1,11,42,3,10,0,53,0,"well remember ludacris's rap ""glamorous"" fergie"
1,2,11,54,0,12,0,65,0,dad dancing ballet daughter steal heart insider
1,2,11,55,0,10,0,66,0,democrat target nunes reveals trump transition team surveilled
1,1,6,26,0,5,0,32,0,blondeney brunetteney
1,2,9,48,2,7,0,57,0,northwestern mutualvoice: make common investing mistake
1,1,6,21,0,6,2,27,0,21 time hipster went damn far
1,2,9,40,0,9,0,49,0,virtual reality bringing lost world back life
1,2,2,49,2,13,2,51,0,14 dish need try call d.c. foodie
1,1,9,25,1,8,0,34,0,job make everyone like
1,3,1,37,1,9,0,38,0,could close tech gender gap decade
1,2,1,22,0,6,0,23,0,way renting gap
1,2,8,33,1,8,1,41,0,9 question help find dream career
1,1,6,20,0,5,0,26,0,dirty minded really
1,1,7,35,1,6,2,42,0,19 picture non-bitchy people never understand
1,1,8,32,1,7,0,40,0,kylie jenner's snapchat going kill someone
1,1,5,20,2,4,0,25,0,"disney princess ""the crow"""
1,2,6,31,0,5,0,37,0,successful people spend weekend
1,1,14,27,2,9,2,41,0,"35 ""antm"" gifs perfectly sum working retail"
1,2,4,44,0,7,0,48,0,gop lawmaker suffers medical emergency near house floor
1,1,13,42,1,11,0,55,0,country truly think halloween u.s
1,3,9,38,0,11,1,47,0,people get best sleep 4 thing common
1,1,8,35,0,7,0,43,0,instagram star reveals truth behind photo
1,1,10,38,0,9,0,48,0,guess disney sidekick color
1,1,12,29,0,12,2,41,0,14 way theater kid help adult
1,1,8,29,2,9,3,37,0,"29 ""fallout 4"" easter egg blow mind"
1,3,11,48,2,12,0,59,0,pesticide prohibited britain. still exported?
1,3,1,54,3,14,0,55,0,safest way walk ice impersonate penguin here's
1,1,9,24,2,8,0,33,0,"chip joanna ""fixer upper"""
1,2,4,13,0,5,0,17,0,right way fall
1,1,5,17,0,4,0,22,0,funny actually
1,1,7,37,0,7,2,44,0,17 confession people never masturbated
1,1,10,34,0,9,0,44,0,zac efron taking swim lesson photo
1,2,1,33,3,6,0,34,0,"move hipsters, come ""yuccie"""
1,1,13,47,0,10,0,60,0,serena williams colton haynes new favorite celebrity bffs
1,3,1,60,2,10,0,61,0,here's deal behind viral parade dancing children's character
1,2,3,37,2,6,0,40,0,behaviourist's guide new year's resolution
1,1,8,23,5,7,0,31,0,"""laguna beach"" ""the hills?"""
1,1,14,47,2,11,0,61,0,marine responded donald trump's #muslimid comment perfect
1,2,4,74,4,16,0,78,0,"wsj: trump cling wiretap claim like drunk empty gin bottle, damaging credibility"
1,1,11,44,0,10,0,55,0,emma watson perfectly called sexism film industry
1,2,0,52,0,9,1,52,0,5 difference pocket sprung memory foam mattress
1,1,8,22,0,8,2,30,0,get engaged past 24 hour
1,2,13,42,1,13,2,55,0,here's ikea item cheaper 30 year ago
1,1,8,34,1,7,0,42,0,said it: jennifer lawrence katniss everdeen
1,2,17,59,1,16,0,76,0,loyal elephant refused abandon dead friend broke leg got shot!
1,3,3,38,1,8,0,41,0,could debbie reynolds died broken heart?
1,1,12,54,3,14,0,66,0,"gym teacher taught class cardio version ""nae nae"" everything"
1,1,3,15,0,2,0,18,0,detective play clue
1,3,7,40,2,7,0,47,0,norway move towards third gender option passport
1,3,6,31,1,8,2,37,0,25 best-paying job country
1,2,2,44,2,7,0,46,0,trump inauguration: full text new president's speech
1,3,3,39,1,6,0,42,0,beyond pizzagate: real conspiracy
1,1,9,29,0,8,0,38,0,match horror film screencap
1,3,8,42,2,8,0,50,0,sydney deliciously eclectic food scene? hit beach
1,3,6,21,0,6,2,27,0,13 sign deserve littlebreak
1,1,10,29,0,7,0,39,0,sign bff practically married
1,2,11,42,3,13,4,53,0,"66 thought watching season 5, episode 9 game ofthrones"
1,1,11,47,4,10,0,58,0,"kristen stewart talk honesty, privacy, new movie ""equals"""
1,1,5,27,0,5,2,32,0,15 truth feminist understand
1,1,9,34,2,8,0,43,0,saturday night live made fun taylor swift's #squad
1,2,9,38,1,9,4,47,0,"undertaker talk life, happiness 1000 funeral"
1,1,6,35,1,6,2,41,0,24 delicious thanksgiving dessert pie
1,2,4,48,1,6,0,52,0,quebec mosque attack: student alexandre bissonnette charged
1,1,8,28,0,8,2,36,0,27 secret waiter pub never tell
1,3,2,32,0,5,0,34,0,bernie sander launch podcast
1,1,9,37,0,8,0,46,0,couple tried sensual yoga thing got steamy
1,1,7,26,1,6,0,33,0,here's rapper got name
1,1,10,39,0,8,0,49,0,tv show lesbian imaginary girlfriend
1,2,12,54,5,9,0,66,0,exclusivekhizr khan: really animosity towards president-elect trump
1,1,12,34,0,11,0,46,0,taste candy say taste men
1,3,2,51,4,13,2,53,0,mom short wham! blazer 10 way update spring style
1,1,5,17,0,4,0,22,0,someone fart work
1,3,11,38,1,10,0,49,0,ten truly remote place bos cant track
1,2,11,66,0,11,0,77,0,shocking video appears show security guard attacking exotic dancer performance
1,3,0,55,0,12,1,55,0,5 year past century changed course human history
1,1,8,30,0,7,0,38,0,favorite golden girl say
1,1,11,38,3,9,0,49,0,siri conversation a.i. i'm horrified
1,2,8,34,0,8,3,42,0,literally 100 funny tweet sum parenting
1,2,8,35,4,7,0,43,0,palin: im extremely thankful trump elected
1,1,10,46,0,9,0,56,0,parent scaring child using new snapchat filter
1,2,10,42,0,9,0,52,0,copper price zigzagged wildly almost one trading
1,1,12,36,2,11,0,48,0,here's fun reminder there's thing gay blood
1,3,1,68,0,12,0,69,0,ice hockey team forced apologise violent mascot joke fight backfire
1,1,11,46,0,10,0,57,0,contouring fail reason khloe kardashian look different
1,1,6,31,0,6,2,37,0,26 ridiculously clever product secret
1,1,12,47,2,11,0,59,0,justin bieber's dad sent really awkward tweet son's penis
1,1,7,26,0,7,2,33,0,23 joke classic nerd laugh
1,2,11,45,0,10,0,56,0,george clooney reveals baby name amal already shot
1,1,13,32,1,12,0,45,0,first day frosh week vs. last day frosh week
1,3,2,37,3,7,0,39,0,"shhh! tell anyone, baseball changing"
1,1,10,35,0,10,2,45,0,22 struggle everyone life cat know well
1,3,15,60,2,14,0,75,0,delhi hosted india's first ever dog beer festival everything amazing!
1,1,8,26,1,7,2,34,0,10 movie shit-ton lesbian subtext
1,1,8,26,0,7,0,34,0,footballer weigh
1,1,10,32,1,9,0,42,0,stop add lady gaga snapchat
1,1,11,42,2,10,0,53,0,"well remember ""the vampire diaries"" murder house party"
1,1,8,32,0,8,2,40,0,26 biggest rebel entire fucking planet
1,1,15,61,4,14,0,76,0,"craig david turned justin bieber's ""love yourself"" soulful garage tune amazing"
1,3,5,54,4,11,0,59,0,john kent cooke didnt get father redskins. got something better.
1,1,8,39,0,7,0,47,0,spell commonly misspelled canadian word
1,1,9,43,2,7,0,52,0,plus-size clothing collaboration minimalist's dream
1,2,1,33,0,6,0,34,0,disrupting health care tricky
1,1,11,36,2,11,2,47,0,"21 ""sailor moon"" tattoo truly fall love"
1,2,15,45,2,16,1,60,0,modi's new year plan india 5 story need read today
1,1,9,39,2,8,0,48,0,"new ""suicide squad"" cast iconic animated character"
1,3,1,65,2,11,0,66,0,"parents, staying loveless relationship kid worth considering?"
1,1,15,55,1,14,0,70,0,"indian girl revealed kind porn like, choice may surprise"
1,3,15,55,3,14,0,70,0,muslim comedian mo amer travel eric trump scotland. come 'good news'
1,1,10,33,2,10,3,43,0,here's 100 year black men's hair trend look like
1,3,9,24,2,8,0,33,0,cnn problem. donald trump solved it.
1,1,8,35,1,9,6,43,0,19 wildest fanfics people stop reading 2015
1,3,1,24,0,7,4,25,0,2016 year time travel
1,1,10,35,0,9,0,45,0,know katy perry song match zodiac sign
1,1,13,32,2,13,2,45,0,19 photo make sense wear bra
1,1,10,42,0,9,0,52,0,actually make sleepy thanksgiving dinner
1,2,4,24,0,9,6,28,0,10 tech trend ce 2017
1,2,2,52,0,12,0,54,0,jim harbaugh share milk mail truck driver hit kid
1,1,13,44,0,12,0,57,0,couple met dating apps look back first message
1,1,10,27,2,10,2,37,0,"23 gift baby ""star wars"" geek life"
1,2,5,48,1,10,0,53,0,man threatens set fire outside bbc's london office
1,1,12,44,0,11,0,56,0,new empathy card make easier talk pregnancy loss
1,2,1,42,2,8,0,43,0,italy sex case dropped woman 'did scream'
1,1,9,27,0,8,0,36,0,spell name welsh village
1,1,8,31,0,8,2,39,0,19 problem polysexual people know true
1,1,7,26,0,7,2,33,0,horoscope week december 28
1,1,11,41,1,10,0,52,0,everyone who's sick tired washing goddamn hair
1,1,9,47,0,9,2,56,0,17 branch engineering summed cleverly minimalist poster
1,2,2,35,3,6,0,37,0,im really thinking: professor wife
1,1,14,52,3,13,0,66,0,"grace jones call rihanna, gaga, miley, co hilariously blunt new memoir"
1,3,8,38,1,8,0,46,0,could law excessive business travel?
1,1,10,39,1,9,0,49,0,solve crossword good seeing pattern
1,2,1,49,1,9,0,50,0,bizarre deep-sea ghost shark caught camera first time
1,1,9,29,0,8,0,38,0,cromwell sanderson sister
1,3,5,19,0,4,0,24,0,bike sharing go wrong
1,2,9,44,3,9,0,53,0,report: hillary clinton thinking running nyc mayor
1,2,13,45,7,12,0,58,0,"snls vladimir putin take credit trump election hooray, it!"
1,1,13,58,2,12,0,71,0,"kristen stewart think people ""do something"" lack gender equality"
1,1,11,31,0,10,0,42,0,north west sick mom taking picture
1,1,12,42,0,12,4,54,0,hairy canadian man made sexiest boudoir photo album 2016
1,1,10,41,1,9,1,51,0,two-thirds people actually herpes simplex virus type 1
1,2,16,47,0,13,0,63,0,tech ceo promising pay customer refund paycheck
1,2,2,51,1,8,0,53,0,berlin attack suspect slipped authorities' net
1,1,10,35,2,9,0,45,0,"well actually know lyric ""hamilton"""
1,1,13,53,1,12,0,66,0,pakistani comic book brings country's issue child marriage light
1,1,13,20,2,10,0,33,0,"tell band cover ""nme"""
1,1,10,41,1,10,2,51,0,"22 time people met celebrity really, really lovely"
1,3,8,39,1,8,4,47,0,student loan repayment: hottest employee benefit 2017
1,1,7,26,0,6,0,33,0,wild animal sexual nature
1,1,12,41,0,11,0,53,0,men watch men get vasectomy scarred life
1,2,8,55,3,13,1,63,0,netflix released 'orange new black' season 3 early business insider
1,1,10,43,2,9,0,53,0,people can't stop talking dude's awesomely nerdy hair
1,1,8,27,0,8,2,35,0,44 perfect song listen write
1,2,1,22,3,4,1,23,0,world's 'most colourful 5k run'
1,1,10,40,0,10,2,50,0,24 secret people work garden centre never reveal
1,1,16,54,2,14,2,70,0,14-year-old found next disney princess reaction amazing
1,2,4,33,1,9,0,37,0,ppe: oxford degree lot answer
1,1,12,46,2,11,0,58,0,"woman perfect response final question ""jeopardy"""
1,1,8,47,0,8,2,55,0,21 absolutely fucking perfect moment sporting caption history
1,3,2,44,1,8,0,46,0,one woman's journey thai village techno stardom
1,1,13,41,1,12,0,54,0,take moment appreciate ben whishaw's hair right
1,1,16,55,2,16,2,71,0,"emma stone lena dunham came 11 thing call ""sweetheart"""
1,2,9,44,0,9,0,53,0,vice president penny appears support eu freedom movement
1,3,7,64,8,17,6,71,0,"best movie 2016: moonlight, manchester sea southside make top 10"
1,1,12,34,0,11,0,46,0,fall boy song based zodiac sign
1,3,3,18,1,3,4,21,0,world's billionaire 2017
1,3,2,37,1,8,0,39,0,map world's drunkest country list
1,1,13,47,0,12,0,60,0,groom best man celebrated bromance photo shoot
1,1,8,35,0,8,2,43,0,11 time indian internet literally zero chill
1,1,9,28,0,8,0,37,0,make sheet pan salmon crispy kale
1,1,12,46,2,11,0,58,0,"""sherlock"" character soulmate based taste food"
1,1,8,40,1,8,2,48,0,19 question definitely wanted ask therapist
1,2,11,53,2,12,0,64,0,kemba candidates: team best positioned magical march run?
1,2,5,37,3,9,0,42,0,world cheered 'batkid'| latest news video
1,3,14,64,3,12,0,78,0,"keith-rochelle get engaged, justin bieber's mumbai concert may entertainment"
1,1,12,52,2,11,0,64,0,"fashion designer rachel roy new ""curvy"" collection inspiring woman"
1,2,10,45,3,13,2,55,0,ted cruz call $14 billion seized el chapo fund border wall
1,2,1,43,1,7,0,44,0,"breaking tournament field, region region"
1,1,8,35,0,7,0,43,0,amy schumer serena williams posed topless
1,1,9,27,4,8,0,36,0,"here's ""paw patrol"" terrible kids' show"
1,1,8,26,0,7,0,34,0,crush someone athletic
1,1,8,36,2,8,3,44,0,"100 time ""harry potter"" movie visually perfect"
1,1,6,19,0,7,6,25,0,52 powerful photo 2015
1,1,14,33,0,13,0,47,0,worked aquarium day learned
1,3,8,34,1,8,2,42,0,23 movie probably didnt know actuallytrue
1,1,10,29,0,9,0,39,0,guess name nail polish color
1,3,2,29,2,6,0,31,0,donald trump 'gaslighting' u
1,2,13,54,2,12,0,67,0,people dying hilariously lazy cashier drawing proudfamily
1,1,6,28,0,6,2,34,0,26 people completely failed cooking
1,1,5,21,0,4,0,26,0,classic cocktail
1,1,11,50,0,10,0,61,0,quiz tell breakfast cereal match personality
1,1,8,28,0,7,0,36,0,gift buy favorite geek
1,1,13,50,0,12,0,63,0,woman bikini waxed boyfriend give taste womanhood
1,3,2,46,1,7,0,48,0,little-known airline making travel mexico cheaper
1,3,5,43,0,9,0,48,0,youngest class twice likely take adhd medication
1,1,9,29,1,9,2,38,0,13 time harry potter gift deserve
1,3,17,46,4,16,0,63,0,"new ""lollipop lipstick"" trend yeah gonna me,dawg"
1,1,11,45,3,11,2,56,0,"15 impossible ""would rather"" question ever heard"
1,1,6,25,0,7,6,31,0,10 mesmerizing latte art video 2015
1,1,9,36,0,8,0,45,0,people read craziest shit grandma ever said
1,3,19,58,5,14,0,77,0,"msnbcs alter: obamas anti-israel president, look iran nuke deal policy"
1,1,5,35,1,4,2,40,0,14 irresistible pumpkin-scented beauty product
1,1,9,38,0,8,0,47,0,family finish freestyle crossword
1,3,1,50,0,10,0,51,0,probably top gingerbread house ever
1,1,9,47,2,8,2,56,0,19 stunning vintage-inspired engagement ring make swoon
1,1,12,53,1,11,0,65,0,"drop everything, justin bieber selena gomez released surprise duet"
1,1,13,40,1,12,0,53,0,know tall based popular food never eaten
1,1,7,21,0,7,2,28,0,21 hungry dog want food
1,1,5,31,0,5,2,36,0,55 thing slightly infuriate londoner
1,1,12,43,0,11,0,55,0,rainbow freckle new beauty trend future bright
1,2,7,27,0,7,2,34,0,19 thing people looked like thegrammys
1,1,16,52,3,15,0,68,0,"""harry potter"" character looked like first movie vs. last"
1,1,11,41,0,10,0,52,0,little prince trailer make feel feeling
1,1,11,45,0,11,2,56,0,15 instrumental cover pop song better original
1,1,8,49,1,7,0,57,0,woman's deliciously unhealthy instagram account hilarious
1,1,11,37,0,10,0,48,0,donald trump quote based zodiac sign
1,1,6,24,0,5,0,30,0,woman share first queer crush
1,2,10,40,0,7,0,50,0,court rule cnn racial discrimination lawsuit proceed
1,1,10,28,0,9,2,38,0,21 thing people think snail cute af
1,3,16,75,0,19,4,91,0,federal judge blocked trump travel ban rule plaintiff request double number refugee fy 2017
1,1,11,31,4,10,0,42,0,"here's cast ""she's man"" look like today"
1,1,11,44,0,10,0,55,0,stunning vintage photo reveal brief life artist eva hesse
1,3,2,42,1,7,0,44,0,"restaurant serf black, red yellow lego burger"
1,1,10,36,2,9,0,46,0,"""walking dead"" character eat zombie"
1,1,8,34,0,8,2,42,0,16 eyebrow product actually worth hype
1,1,10,45,0,9,0,55,0,choice christmas cupcake reveal darkest secret
1,1,8,26,0,7,0,34,0,music era actually belong
1,1,7,28,3,7,2,35,0,"19 picture make say ""seriously?"""
1,1,8,40,2,7,0,48,0,"""adventure time"" character match zodiac sign"
1,3,1,54,0,11,0,55,0,striking taxi driver troll news report rude fake name
1,1,4,20,0,4,2,24,0,23 flaw every sneakerhead
1,1,7,31,1,7,2,38,0,14 crazy trick actually make warmer
1,1,10,43,2,10,2,53,0,"31 funniest moment ever happen ""desperate housewives"""
1,1,14,33,2,11,2,47,0,"32 question every time watch ""fixer upper"" hgtv"
1,1,10,39,2,9,0,49,0,"""stitchers"" character based zodiac sign"
1,1,10,51,3,9,0,61,0,"president obama's ""comedians car getting coffee"" episode hilarious"
1,1,10,42,0,10,2,52,0,27 simple costume totally make day halloween
1,1,9,31,1,11,10,40,0,21 thing cool 2006 definitely 2016
1,1,5,23,0,4,0,28,0,men describe dream wedding
1,3,8,34,1,7,0,42,0,know using free tax-return service
1,1,9,26,0,8,0,35,0,music listen write
1,2,3,46,3,12,4,49,0,fyre festival take place 2018: 'we ourselves'
1,1,8,29,0,8,2,37,0,24 designer failed hard almost
1,1,10,36,0,9,0,46,0,brief reminder norman reedus really damn fine
1,3,1,54,0,10,0,55,0,fox instantly regret attempting pounce vole hiding snow
1,1,11,55,0,11,2,66,0,32 thing justin bieber definitely say whoever take instagram picture
1,1,10,32,1,9,0,42,0,closer look world india's dog pageant
1,1,12,42,0,10,2,54,0,15 picture accurately sum relationship bff
1,1,11,37,2,9,0,48,0,make veggie stir-fry that's even better takeout
1,2,3,58,0,10,0,61,0,minor leaguer buddy baumann get unfortunate haircut losing bet
1,1,11,32,1,10,0,43,0,one question tell real woman
1,1,8,35,2,6,0,43,0,twilight's bella edward gender-swapped
1,1,9,30,0,8,0,39,0,know bra size based random question
1,1,11,46,1,9,0,57,0,make delicious two-ingredient sauce go everything
1,2,7,26,0,6,0,33,0,getting fired worse divorce
1,1,7,23,1,6,0,30,0,let's talk peeing shower
1,3,14,66,4,13,0,80,0,plus-size mom received hate mail wearing leggings: experience gave immense strength
1,3,1,59,3,13,4,60,0,here's month-by-month timeline best time buy almost anything 2017
1,2,12,38,0,11,0,50,0,woman may soon lose ability get abortion viawebcam
1,1,7,30,0,6,0,37,0,need talk american thanksgiving
1,1,15,36,0,12,0,51,0,know gif make laugh based birth month
1,1,11,38,0,10,0,49,0,shah rukh khan sent paulo coelho amazing gift
1,1,12,30,0,11,0,42,0,know age based word hate
1,2,11,49,0,12,0,60,0,freezing genitals boost sex drive apparently thing people
1,1,10,34,1,10,2,44,0,36 regular people look much like celebs crazy
1,1,9,36,0,8,0,45,0,disney channel show actually like better
1,1,13,32,1,12,0,45,0,dog kept toy life cutest
1,3,1,47,0,10,0,48,0,lack sleep costing world billion dollar
1,3,2,55,1,10,0,57,0,blast past: collector investing retro jukebox
1,1,10,37,2,10,2,47,0,"14 perfect holiday gift ""community"" fan life"
1,1,12,37,3,9,0,49,0,"""american horror story: coven"" witch bff"
1,1,6,35,0,5,0,41,0,grandma get magical disney princess makeover
1,1,14,48,0,13,0,62,0,million people love elderly man waiting airport
1,1,9,37,0,8,0,46,0,asian woman watched asian porn horrified
1,1,6,24,0,6,1,30,0,7 time kidding
1,1,14,35,3,10,0,49,0,"need listen erykah badu's ""hotline bling"" remix asap"
1,1,8,34,0,8,1,42,0,8 totally different way relieve stress
1,1,10,37,0,9,0,47,0,movie think honest depression
1,1,12,43,1,11,0,55,0,hemsworth brothers' instagram war christmas gift u
1,2,8,48,2,10,0,56,0,twitter's next ceo? volunteer include rapper snoop dogg
1,3,1,59,1,12,0,60,0,here's happens brain body someone break heart
1,3,2,56,3,13,0,58,0,"finally, definitive proof obamas guy youd want get beer"
1,1,14,48,1,13,0,62,0,man's beautiful story wife make believe true love
1,1,16,73,0,15,0,89,0,married couple honest discussion relationship real age difference
1,1,9,23,0,8,0,32,0,tell text sext
1,2,2,31,2,8,0,33,0,'they escorted terrorist'
1,1,10,26,1,9,0,36,0,hear baby name vs. kid hear
1,2,12,55,0,12,0,67,0,mma fighter attempt spinning kick fails hilarious way possible
1,1,6,27,1,6,2,33,0,18 reason parent can't stand caillou
1,3,10,43,1,9,0,53,0,inside look justin timberlake's bai super bowl commercial
1,1,9,44,0,9,2,53,0,23 gendered product prove truly fragile masculinity
1,3,14,38,2,10,0,52,0,'hidden figures' already inspiring girl go stem
1,1,10,51,1,10,2,61,0,23 incredibly awkward situation understand dick massive
1,2,14,64,1,13,0,78,0,"swedish woman allegedly gangraped three young men, torture broadcast facebook live"
1,1,8,30,0,8,2,38,0,43 time obsessed tracee elli ross
1,1,9,34,0,9,2,43,0,16 maharashtrian food need life right
1,3,10,54,3,10,0,64,0,professor: stop calling people disagree white supremacist
1,1,13,54,0,12,0,67,0,instagram people putting object eyeball make cringe
1,2,7,44,0,8,0,51,0,designer lining dress melania trump inauguration
1,2,11,46,2,12,0,57,0,"pay up, slowpokes: state fine driver dawdle left lane"
1,1,7,33,0,7,2,40,0,21 mexican food moment oddly satisfying
1,1,8,39,0,7,0,47,0,rainbow brite color kid match personality
1,1,11,40,0,10,0,51,0,know favorite disney movie based favorite dog
1,1,8,20,0,6,2,28,0,14 time space trippier lsd
1,1,12,35,0,11,0,47,0,new hercules look like leather daddy man bun
1,1,9,18,2,8,0,27,0,"well know ""the last us"""
1,1,5,28,1,4,0,33,0,what's subconscious obsessed
1,3,12,42,2,13,0,54,0,sean hannity still upset ted koppel said bad america
1,1,8,32,0,8,1,40,0,7 healthy eating trick actually easy
1,1,7,26,2,7,2,33,0,"33 important thing learned ""ab fab"""
1,1,10,34,0,9,0,44,0,match iconic food home state
1,1,9,57,1,7,0,66,0,minimalist illustration actually mind-blowing optical illusion
1,1,15,47,2,14,0,62,0,david bowie's son revealed he's going father sweet cartoon
1,1,9,40,3,8,0,49,0,"well remember characters' superpower ""heroes"""
1,1,12,57,2,12,4,69,0,"seven year later, mumbaikars recall horrific event 26/11 terrorist attack"
1,2,0,34,0,7,2,34,0,22 way healthier minimal effort
1,1,7,25,0,7,2,32,0,17 text mom definitely sent
1,1,10,47,0,10,2,57,0,19 thing university new south wale student understand
1,1,6,26,0,6,2,32,0,12 life lesson barbershop taught
1,3,6,26,1,6,0,32,0,emirate airline running sky?
1,2,5,59,1,13,3,64,0,couple reveals pregnancy twin amazing photo 452 ivf needle yahoo
1,1,8,32,0,8,2,40,0,18 time taylor swift made u jealous instagram
1,1,8,42,0,8,2,50,0,19 horrifying thanksgiving family drama story
1,2,12,56,1,12,0,68,0,analysis: voting right advocate worried trump voter fraud probe
1,1,11,47,2,9,0,58,0,here's make bulleit bread pudding bourbon-soaked cherry
1,1,7,20,0,6,0,27,0,get rejected
1,2,1,30,2,4,0,31,0,new technology 'will detect potholes'
1,1,6,35,0,5,0,41,0,britney spear song reimagined telenovelas
1,3,6,32,1,5,0,38,0,six-time deportee arrested drunk driving
1,1,7,28,0,6,0,35,0,people natural hair really hear
1,1,15,23,1,9,2,38,0,47 hack people add/adhd use stay track
1,1,12,37,0,11,0,49,0,michael bay made real tragedy dumb action movie
1,1,6,13,3,5,0,19,0,"i'm feminist, i'm"
1,1,8,30,0,8,2,38,0,50 woman guaranteed make want short bang
1,2,9,40,1,8,0,49,0,christmas tradition compare everyoneelse?
1,1,9,50,0,9,2,59,0,20 heartbreaking confession people called wedding
1,1,14,51,0,13,0,65,0,country star jason aldean wore blackface halloween dress lil wayne
1,1,9,39,1,8,2,48,0,13 sushi-themed gift perfect anyone obsessed food
1,1,7,22,2,7,2,29,0,"28 moment make say ""nice"""
1,2,2,70,1,12,0,72,0,inside little-known monsanto campus scientist changing way eat
1,1,9,33,0,9,2,42,0,14 time people turned emojis munk debate
1,3,2,50,0,13,0,52,0,bagel started brawl train terrifying list
1,1,8,28,1,7,2,36,0,17 super-necessary hack anyone car
1,1,10,24,0,9,0,34,0,know age based taste men
1,1,10,48,0,9,0,58,0,calvin harris congratulated taylor swift cute instagram post
1,3,1,49,0,7,0,50,0,exercise scientist demonstrates proper bench press
1,1,18,59,1,18,3,77,0,rescue dog handler worked ground zero 9/11 honored amazing day
1,2,3,46,2,8,0,49,0,"north carolina-gonzaga firsts, big men bad ankle"
1,1,11,31,0,10,0,42,0,kid excited first day school
1,2,13,53,3,10,0,66,0,source: impending layoff send espn talent panic biblical proportion
1,3,9,36,1,7,0,45,0,grammys chock-full message resistance
1,1,8,32,0,7,0,40,0,crossword full fucked celebrity
1,1,11,41,1,10,0,52,0,parent actually using drone pull kids' teeth
1,1,11,33,0,11,2,44,0,23 time amy schumer got way real woman
1,1,12,33,3,10,0,45,0,"""x-files"" cast mulder fell love scully"
1,1,10,32,0,10,2,42,0,16 time amy schumer made u cry laughing hard
1,3,2,43,1,11,0,45,0,here's iphone tiny hole next camera
1,1,10,21,2,7,0,31,0,"would bff ""scream queens"""
1,1,6,28,1,5,0,34,0,evolution michael clifford's hair
1,3,6,26,1,6,1,32,0,8 way sabotaging job search
1,3,5,23,0,5,0,28,0,make tax reform bipartisan
1,1,6,22,0,5,0,28,0,guess favorite beatle
1,2,7,37,1,6,0,44,0,paper airplane drone thats nearly indestructible
1,3,9,48,1,11,0,57,0,need know trump statement israeli settlement
1,1,10,39,1,9,2,49,0,13 brutally honest e-cards anyone love birth control
1,3,7,25,0,6,0,32,0,science behind make u laugh
1,1,8,24,0,8,2,32,0,12 chili recipe curl fall
1,1,8,35,1,7,2,43,0,15 next-level buffalo snack superbowl party
1,1,10,46,0,9,0,56,0,people outraged mannequin impossibly thin leg
1,1,10,42,0,10,2,52,0,15 crucial holiday storage hack make life easier
1,3,11,47,1,10,0,58,0,would rather smother food chocolate peanutbutter?
1,3,13,39,2,12,0,52,0,'la la land' clearly would better ellen starred
1,3,2,65,1,16,0,67,0,man tried rob petrol station using drawn on-beard disguise list
1,1,11,32,2,10,0,43,0,"need talk lex luthor ""batman v superman"""
1,1,11,31,0,8,0,42,0,wtf freakishly realistic cat bag
1,1,10,37,2,10,2,47,0,"21 thing ""harry potter"" video game taught u life"
1,1,8,38,2,8,2,46,0,17 thing understand addicted snacking
1,1,10,41,1,9,0,51,0,literally can't tell difference nolte busey
1,2,1,27,0,5,0,28,0,real problem behind fake news
1,1,11,38,1,10,0,49,0,aziz ansari's instagram post dad make cry
1,3,3,59,4,12,2,62,0,theyve redskin ticket 50 years. theyve finally enough.
1,2,9,49,3,12,0,58,0,brokaw: democrat lot reconstruction party
1,1,8,22,0,5,0,30,0,thanksgiving amas red carpet
1,1,13,47,0,12,0,60,0,photo shoot pregnant woman model absolutely stunning
1,1,9,37,0,9,2,46,0,15 stunning gift wrapping idea minimalist
1,1,9,39,2,8,0,48,0,find style buzzfeed's health beauty newsletter
1,1,9,45,1,8,0,54,0,everyone's favourite childhood anthem got epic makeover
1,1,6,33,1,6,2,39,0,45 thanksgiving dessert pumpkin pie
1,1,13,48,0,12,0,61,0,picture sum wedding guest put damn phone
1,2,8,29,1,7,0,37,0,percent messy tidy actually?
1,1,7,31,0,7,2,38,0,18 time britain got seriously burned tumblr
1,1,10,37,0,10,2,47,0,18 time khloe kardashian coolest aunt world
1,1,11,40,0,11,2,51,0,30 online shop based northeast shopping
1,1,12,40,0,11,0,52,0,actually best way make turkey thanksgiving
1,1,7,22,0,8,6,29,0,17 away message every emo kid used 2007
1,1,7,38,1,6,2,45,0,16 real-life achievement people procrastinate
1,3,16,57,3,16,0,73,0,save dates. mad decent block party coming india major lazer dilion francis!
1,1,11,55,1,9,0,66,0,movie trailer perfectly capture post-grad struggle unemployment
1,2,4,70,2,12,0,74,0,charles barkley ripping warrior playing 'girl basketball' misinformed
1,1,6,22,2,5,0,28,0,what's worst gift gotten
1,1,11,49,4,10,0,60,0,"natalia tena sort ""harry potter"" character ""game thrones"" house"
1,3,3,38,2,8,0,41,0,rbss past sin still shaping bank future
1,1,6,22,2,6,2,28,0,tried san francisco's new $15 coffee
1,1,12,30,2,12,4,42,0,"""clueless"" would like set 2015"
1,1,9,37,0,9,2,46,0,22 halloween treat much festive candy
1,2,7,28,1,6,0,35,0,actually grosser mostpeople?
1,1,8,28,0,8,2,36,0,27 stunning reason get tim burton tattoo
1,1,10,29,1,9,0,39,0,cat best selfie game ever see
1,1,6,26,0,6,2,32,0,21 candid photo old hollywood celebs
1,1,10,48,1,9,0,58,0,writer learned cope stepbrother's schizophrenia
1,1,12,55,0,11,0,67,0,jessica williams phoebe robinson asking hollywood shift default
1,3,8,42,2,6,0,50,0,reports: democrat anthony weiner facing child-porn charge
1,2,13,63,0,12,0,76,0,three tsa agent arrested drug smuggling ring san francisco international airport
1,2,2,50,2,9,2,52,0,meet romanian high school basketball freshman 7-foot-7
1,1,7,28,0,6,0,35,0,obsessed kitchen gadget
1,1,7,33,0,7,1,40,0,7 healthy eating trick actually doable
1,1,10,38,0,10,2,48,0,19 thing people love going bed early understand
1,1,11,26,0,10,0,37,0,tell u think wore best emmy
1,1,7,38,0,7,2,45,0,27 insanely delicious salad need thanksgiving
1,1,7,31,1,6,2,38,0,12 must-haves extremely classy christmas
1,2,1,59,1,9,1,60,0,9 artist reportedly turned performing trump's inauguration
1,1,5,15,0,5,1,20,0,9 perk big hair
1,1,10,33,0,9,0,43,0,many classic chick flick seen
1,1,13,52,1,13,2,65,0,21 time tumblr user perfectly explained like fight brain
1,2,4,37,0,8,0,41,0,end nigh world health organisation
1,1,7,37,0,7,2,44,0,59 terrifyingly real nightmare new yorkers share
1,1,7,16,0,6,0,23,0,adopt pet year
1,1,9,30,0,9,2,39,0,21 picture make die little inside
1,1,5,18,0,4,0,23,0,nancy drew instagram
1,2,9,58,3,10,0,67,0,"buzzy, newly accessible destinations, canadian arctic chengdu, china"
1,2,6,67,5,15,0,73,0,teacher: dont want assign shakespeare anymore (even though he common core)
1,1,9,32,0,8,0,41,0,know number missing movie
1,1,11,47,1,10,0,58,0,recreated sexiest photo instagram here's happened
1,2,11,35,2,9,0,46,0,caution: ai big data reach kids' christmas toy
1,1,9,27,2,8,4,36,0,many 2015's top-selling single hum
1,3,2,32,0,8,5,34,0,bill gate reveals 5 favorite book 2016
1,1,8,27,2,8,2,35,0,"17 ""princess bride"" gift need life"
1,1,12,24,1,11,3,36,0,bet can't name 30 nhl team 5 minute
1,1,9,28,0,8,0,37,0,sassy tree based zodiac
1,1,9,32,0,9,2,41,0,18 miyazaki nail art design blow away
1,1,11,46,0,11,4,57,0,poster 2016 oscar nominated movie white actor removed
1,3,11,37,1,10,0,48,0,united became world's hated airline one day
1,2,4,28,1,4,0,32,0,george osborne's mansion house speech
1,1,9,41,1,8,0,50,0,justin bieber's mystery instagram girl crush found
1,1,11,35,0,10,0,46,0,amy poehler based taste waffle
1,1,11,39,2,11,2,50,0,19 photo make sense anyone wear makeup
1,1,10,38,0,10,2,48,0,15 time michael scott u graduating college
1,1,12,48,1,10,0,60,0,get best buzzfeed's reporting sunday story newsletter
1,3,1,29,0,7,4,30,0,woman running 40 marathon 40 day
1,1,7,8,0,4,2,15,0,17 dog know
1,3,7,21,1,6,0,28,0,coding skill anyone learn?
1,2,13,46,2,11,0,59,0,lebron james skipped college football 'they hit hard'
1,3,1,64,1,12,0,65,0,learning celebrate failure young age led billionaire's success
1,1,8,46,0,8,2,54,0,18 trigger people zero patience immediately recognize
1,1,11,28,1,13,9,39,0,18 ad 1915 prove we've come long way 100 year
1,2,9,42,0,11,0,51,0,meet woman claim tinder match ever
1,1,14,53,0,12,0,67,0,leonardo dicaprio told ellen almost died two separate occasion
1,3,17,58,4,16,0,75,0,"'war terror' china order muslim men trim beards, ban women's veil public"
1,1,11,39,0,10,0,50,0,one emoji question decide job
1,3,4,42,4,10,0,46,0,return east timor: 'i've brought back dead'
1,2,9,40,1,7,0,49,0,one middle school adopted gender-neutral uniform
1,1,8,30,0,8,2,38,0,11 stress text send final week
1,1,9,27,1,8,0,36,0,here's one american car
1,1,10,37,0,10,2,47,0,make 10 round random question
1,1,10,34,0,9,0,44,0,know zodiac sign based favorite food
1,1,5,24,1,3,0,29,0,cinderella cuban-american
1,1,12,44,2,11,0,56,0,"kid turned bratz doll rey ""the force awakens"""
1,2,19,47,5,9,0,66,0,delingpole: environmentalist arent wrong. theyre loathsome evil too.
1,1,11,49,2,10,0,60,0,"character ""arrested development"" based zodiac"
1,3,6,32,2,4,0,38,0,demi lovatos breast-contouring makeup trick
1,1,9,29,3,8,0,38,0,"kesha new band called ""yeast infection,"""
1,1,11,48,0,11,2,59,0,34 time tumblr taught everything need know bisexuality
1,1,6,15,0,5,0,21,0,mario link
1,1,15,69,0,14,0,84,0,artist made heartbreaking poster tribute child victim peshawar school attack
1,3,2,44,2,8,0,46,0,here would happen earth stopped rotating
1,2,11,42,4,12,0,53,0,tom selleck clear 'three men baby' ghost rumor [video]
1,1,7,28,0,6,0,35,0,event untimely disappearance
1,3,4,31,2,6,0,35,0,here's jpmorgan's pitch top young talent
1,1,7,22,0,7,2,29,0,23 sport fan made huge mistake
1,1,14,39,2,12,0,53,0,cooked easy-bake oven week here's happened
1,3,7,36,0,9,2,43,0,14 gift support cause closest heart
1,3,9,40,2,9,0,49,0,"womens lacrosse player lost college, team"
1,1,11,48,0,10,0,59,0,hilarious new twitter account make ad actually honest
1,3,11,51,2,10,0,62,0,mlb commish want transition away controversial chief wahoo logo
1,1,6,28,0,6,2,34,0,22 time pedro pascal human perfection
1,1,8,45,4,8,2,53,0,"17 shocking similarity ""mean girls"" ""angela anaconda"""
1,3,3,41,3,8,2,44,0,"russian military plane crash black sea, 'killing 92'"
1,3,9,48,4,8,0,57,0,"tourist flee nightmare paris amidst rising theft, assaults, terror"
1,1,10,41,0,9,0,51,0,impression sketch get real quick breakup
1,1,8,38,2,7,0,46,0,"meet five new playable character ""battleborn"""
1,3,5,69,1,18,4,74,0,here's happens stick galaxy s8 unicorn frappuccino drop 100 foot
1,1,7,31,0,6,0,38,0,movie helped depression
1,1,10,43,3,10,2,53,0,"13 movie iconic mermaid ""the little mermaid"""
1,3,1,49,3,8,0,50,0,"ancient, bag-like sea creature earliest ancestor?"
1,1,8,37,2,8,2,45,0,"another round, episode 39: betrayer patriarchy"
1,3,13,48,2,11,0,61,0,nba power rankings: warrior cavs reclaim top spot playoffs?
1,2,3,63,2,9,0,66,0,'desperate' australian couple unable leave cambodia surrogate baby
1,3,11,33,0,11,1,44,0,6 easy way shorten resume make stand
1,1,11,38,0,10,0,49,0,disney princess would look like real life
1,3,1,28,2,3,0,29,0,"shamrocks, snake stereotypes!"
1,3,3,86,5,18,0,89,0,trump said want replace obamacare something 'better' here's could learn british
1,1,18,65,0,17,0,83,0,couple stunning photo shoot baby learning inoperable brain tumor
1,2,10,58,0,12,0,68,0,happened french billionaire built free coding school california
1,1,9,48,2,9,2,57,0,"24 hauntingly beautiful tattoo featuring face ""spirited away"""
1,1,7,24,0,6,0,31,0,super dramatic super chill
1,1,8,38,0,8,2,46,0,12 horrifyingly cute zombie treat actually make
1,1,15,69,4,14,0,84,0,"reminder daniel radcliffe's ""harry potter"" audition literally cutest thing ever see"
1,1,14,47,0,13,0,61,0,movie taught generation misfit let freak flag fly
1,1,6,27,0,6,2,33,0,15 life changing beauty product need
1,2,2,51,4,9,0,53,0,'power rangers' fan hyped credit scenehere's
1,1,11,35,0,12,6,46,0,26 time old people best people internet 2015
1,2,23,54,3,12,0,77,0,unicef usavoice: ten-year-old syrian refugee hiba tell survived harrowing journey
1,3,8,32,3,7,0,40,0,"millennials, fear snakes, shark credit?"
1,1,8,34,1,8,2,42,0,17 incredibly cool gift kid gotten yet
1,3,3,41,0,9,1,44,0,5 way gop bill could change health insurance
1,1,6,27,0,6,2,33,0,29 gift anyone major wanderlust
1,1,14,56,0,13,0,70,0,watch deepika padukone make fun ranbir kapoor terrible internet
1,1,12,28,2,10,2,40,0,"27 random hell photo make miss ""trl"""
1,1,8,42,0,8,2,50,0,21 gorgeous drinking accessory get elegantly wasted
1,2,11,67,3,13,0,78,0,"swedish library ban factual book immigration, say content contrary human right"
1,1,12,30,2,10,0,42,0,"ok, need talk amazing usher's bulge"
1,1,10,28,0,11,6,38,0,31 british men wanted love 2015
1,1,8,37,0,8,2,45,0,15 photo everyone grew catholic understand
1,1,9,34,0,8,0,43,0,american try hong kong dessert first time
1,1,10,38,3,9,0,48,0,"here's new ""filled cupcake"" oreo flavor taste like"
1,1,8,20,0,7,0,28,0,guess big boob
1,1,5,26,0,4,0,31,0,scotch expert review cheap whiskey
1,1,14,51,1,14,1,65,0,9 totally awesome thing realize could cool new phone
1,1,9,40,0,8,0,49,0,bake perfect cooky maintaining sanity
1,1,12,36,2,11,0,48,0,"actual place mar ""the martian"" set"
1,1,9,34,0,8,0,43,0,find badass harry potter roller derby name
1,1,14,56,2,13,0,70,0,"people thailand singing ""happy birthday"" ganesha cutest thing ever"
1,3,2,50,0,10,4,52,0,initial jobless claim fall lowest level since march 1973
1,2,23,62,4,22,2,85,0,"time workout? problem, switch brown rice effect 30-minute brisk walk!"
1,1,10,40,2,9,0,50,0,"""shameless"" character based zodiac sign"
1,3,4,26,0,5,0,30,0,friendship divide nba
1,2,0,44,0,10,1,44,0,4 change shopper see buy phone
1,2,9,53,0,12,0,62,0,everything need know executive order sanctuary city
1,1,6,33,0,6,2,39,0,17 paleo breakfast actually delicious
1,3,13,48,3,13,3,61,0,$1.25 golf ball flew costco's shelf growing popularity
1,2,12,60,2,12,0,72,0,"richard matt david sweat, convicted murderer escaped prison, grisly past"
1,3,12,34,2,7,0,46,0,darpa humanoid robot take slow-motion leap forward
1,3,13,37,0,12,0,50,0,know art major based colortest
1,3,1,61,0,11,2,62,0,flight attendant share 25 thing wish passenger would stop
1,1,7,20,0,7,4,27,0,2016 year stop single
1,1,7,32,1,6,2,39,0,'90s tv show reimagined nickelodeon cartoon
1,2,2,46,3,10,0,48,0,delia smith recipe creme caramel could go wrong?
1,1,7,26,1,6,0,33,0,here's actually bruise easily
1,1,9,44,0,9,2,53,0,19 celebrity open dealing eating disorder
1,1,4,21,0,3,0,25,0,couple photoshop
1,1,10,35,1,8,2,45,0,17 glitch wtf they'll make laugh uncontrollably
1,1,11,40,0,10,0,51,0,new infographic show exactly need get tested
1,1,7,31,1,4,2,38,0,26 funniest #urbanoutfittersbelike tweet
1,3,0,28,1,7,6,28,0,17 thing we're looking forward 2017
1,1,20,59,0,15,0,79,0,beautiful video explores lighter side member indian lgbtq community
1,1,10,48,0,9,0,58,0,sometimes jessica chastain pretend bryce dallas howard
1,1,7,38,0,7,2,45,0,31 ridiculously delightful gift make
1,3,2,39,2,8,0,41,0,"father son review poignant, poetic memoir"
1,1,3,24,0,3,2,27,0,16 weird relationship milestone
1,3,9,53,1,10,4,62,0,republican may positioned win filibuster-proof senate majority 2018
1,1,8,36,1,7,0,44,0,let's talk important gaming opinion
1,1,10,26,3,9,0,36,0,"well know lyric ""stacy's mom"""
1,1,7,32,0,7,2,39,0,22 mesmerizing picture dusk around world
1,1,14,28,1,10,2,42,0,18 text mom idea they're
1,1,10,32,0,10,2,42,0,13 thing never say latina dating
1,1,15,59,0,14,0,74,0,viola davis jimmy kimmel want understand danger texting walking
1,2,4,42,1,7,0,46,0,facebook live attack: four chicago accused denied bail
1,2,13,38,3,10,0,51,0,"naacps barber: russian hack, racist hack"
1,3,8,44,3,8,0,52,0,halperin: russian troop kept hillary going wisconsin
1,2,9,24,1,8,0,33,0,deal week: akzo nobel fends ppg
1,1,9,38,2,8,0,47,0,"""friends"" character guest star linked"
1,1,12,31,2,10,2,43,0,"19 time ""lizzie mcguire"" realest teen show tv"
1,1,12,42,1,12,2,54,0,24 thing sympathise ever broke london
1,3,2,70,2,16,0,72,0,sleazy rider! semi-naked couple caught sex back moving motorcycle
1,1,15,60,0,14,0,75,0,mark zuckerberg answered question every facebook user wanted ask
1,1,11,40,0,10,0,51,0,britney spear googled picture corn post instagram
1,1,7,26,0,6,0,33,0,harry potter book title honest
1,3,16,60,3,16,1,76,0,jaime lannister revealed important detail got season 7 major spoiler!
1,1,13,40,3,12,0,53,0,"superman lois lane get ""batman v. superman"" trailer"
1,1,11,34,0,10,0,45,0,guess age based color choose
1,1,13,40,0,11,0,53,0,identify tv show based screencaps drink
1,1,14,33,1,12,1,47,0,hot guy holding bb-8 thing need see today
1,2,8,49,2,8,0,57,0,globalist le pen rival promise emancipate migrant community
1,1,9,40,1,8,0,49,0,here's everything need know renter insurance
1,1,12,26,0,9,0,38,0,celeb bff based birth month
1,1,8,23,0,8,2,31,0,21 dad clearly meant dad
1,1,8,29,0,7,2,37,0,13 tv show political junky watch
1,1,8,37,3,9,6,45,0,"17 people thought bryan adam covered taylor swift's ""1989"""
1,2,2,10,0,6,6,12,0,52 place go 2017
1,1,13,34,2,12,0,47,0,"""firefly"" cast spent lot time bed together set"
1,2,14,59,2,14,0,73,0,"wwe wrestler glenn jacobs, aka kane, run republican county mayor tennessee"
1,1,10,39,3,9,0,49,0,"someone made elsa villain ""frozen"" everything"
1,3,10,35,0,9,0,45,0,new favorite song chosen algorithm
1,2,1,29,2,5,0,30,0,ind. town's entire police force quits
1,3,12,24,2,11,9,36,0,b/r presents: nfl1000 guide day 2 2017 nfl draft
1,1,9,41,2,8,0,50,0,stingray photobombed couple's proposal adorable
1,1,12,47,1,11,0,59,0,rihanna released new song internet can't understand word
1,1,11,32,0,10,0,43,0,know food bae one question
1,2,1,67,4,15,4,68,0,"ambitious, irritating, hopeful overrated book 2016 best one,"
1,3,3,24,4,5,0,27,0,'jurassic world': see it?
1,1,8,32,2,7,0,40,0,here's ariana grande's new song really mean
1,1,7,25,1,7,2,32,0,13 art history hotties want fuck
1,3,4,43,3,7,0,47,0,"advertiser fleeing bill oreilly, viewer arent"
1,1,8,27,2,7,0,35,0,what's strangest way lost tooth
1,3,8,36,1,7,0,44,0,trump shadow looming special election
1,1,6,26,0,6,2,32,0,25 adorable animal brighten day
1,2,2,52,1,9,0,54,0,christmas: weird wonderful way world celebrating
1,3,2,85,2,16,3,87,0,24-year-old latvian rookie fantastic reaction becoming first spur player ejected 4 year
1,2,10,57,1,12,0,67,0,"naked people slaughter sheep auschwitz death camp, chain gate"
1,3,8,32,4,9,0,40,0,best (and worst) state raise family [video]
1,2,13,45,1,11,0,58,0,xx factor: inside fight reinvent financial advice woman
1,1,15,42,3,12,0,57,0,drake steph curry invite u in-n-out burger last night
1,1,11,31,1,9,0,42,0,want see buzzfeed's snapchat story
1,1,8,31,0,7,0,39,0,confident yearbook photo time
1,1,8,26,1,7,2,34,0,12 secret plus-size model want know
1,1,8,42,2,8,2,50,0,"19 confession people ""defining relationship"""
1,1,13,56,5,12,0,69,0,"bollywood cheering priyanka chopra's ""quantico"", cutest thing ever"
1,1,11,33,0,10,0,44,0,quiz answer give lent
1,2,2,70,2,10,0,72,0,'vertical forests' could transform brussels wasteland luxury apartment
1,3,5,21,1,6,0,26,0,superhero look like?
1,1,7,25,0,6,0,32,0,disney castle live
1,2,16,39,3,12,0,55,0,kendrick lamar revealed title new album 'damn.' week ago
1,1,11,40,2,11,2,51,0,"29 quote lady ""the office"" still hilarious"
1,1,7,30,0,7,2,37,0,47 thing everybody twitter
1,3,1,14,0,4,2,15,0,week 29 photo
1,1,13,47,0,13,1,60,0,guess celebrity spirit guide based 3 question
1,1,9,32,0,8,0,41,0,winter undoubtedly best season
1,1,11,37,2,10,0,48,0,"well remember second season ""the simpsons"""
1,1,9,23,0,9,1,32,0,7 way life one big game tetri
1,1,14,63,0,13,0,77,0,video perfectly capture struggle indian woman face finding public toilet
1,2,9,48,3,11,0,57,0,"chief dentsu, japanese ad agency, resign employee suicide"
1,3,9,29,0,9,0,38,0,five chart say well market
1,3,17,51,8,11,0,68,0,"celebrity trash neil gorsuch: suggest us gay sex app, anti-lgbtq, terrifying"
1,1,6,22,0,5,0,28,0,new improved eva longoria
1,2,3,44,2,11,0,47,0,gay putin's moscow: city pinker think
1,1,14,43,1,13,0,57,0,cara delevigne's dog glamorous day u ever
1,1,7,21,0,7,2,28,0,14 text ride die friend send
1,1,9,29,0,9,2,38,0,25 gift ultimate wine lover life
1,3,4,24,0,5,0,28,0,revenge lunch lady credit
1,3,3,62,3,14,0,65,0,"cat marnell lost job almost overdosed heroin. then, wrote memoir."
1,1,13,38,3,13,2,51,0,"spent 45 minute ""bigg boss"" house here's learned"
1,1,6,24,1,5,0,30,0,men answer: sex exclusivity first
1,1,9,33,3,8,0,42,0,"hardest ""divergent"" quiz ever take"
1,1,8,25,2,8,2,33,0,"23 funny tweet ""the sims"" fan get"
1,2,7,46,0,8,0,53,0,immigrant accused child rape disappears posting bond
1,1,9,28,1,8,0,37,0,guess buy secret santa
1,1,10,48,0,10,2,58,0,10 insanely delicious veggie noodle recipe better pasta
1,1,10,40,0,10,2,50,0,23 sin everyone grew drinking britain committed
1,1,7,35,4,6,0,42,0,"drop everything: demi lovato covered adele's ""hello"""
1,1,9,33,1,9,2,42,0,28 makeup chart make life much easier
1,1,9,45,1,8,0,54,0,surprising video show depression always obvious
1,1,15,45,1,15,2,60,0,could entitled $25 bought starkist tuna past six year
1,3,7,76,4,20,0,83,0,really happens brush teeth (and it'll put skipping ever again)
1,1,12,46,3,11,0,58,0,"stop listen hilarious ""golden girls"" remix"
1,1,11,51,3,11,2,62,0,"16 tweets, memes, reaction capture modi's surprise visit pakistan"
1,1,7,38,1,6,0,45,0,going home thanksgiving expectation vs. reality
1,1,9,33,1,8,0,42,0,here's actually get depressed winter
1,1,10,38,1,10,2,48,0,"15 manga series read, based favorite book"
1,3,9,43,0,9,1,52,0,5 biggest mistake millennials making money
1,2,0,34,0,7,1,34,0,5 thing may know retirement
1,1,9,31,1,8,0,40,0,what's best healthy recipe made year
1,1,15,51,2,14,0,66,0,"emma watson told use word ""feminism"" speech equality"
1,1,10,50,0,9,0,60,0,disney princess singing native language pretty magical
1,3,8,46,0,8,0,54,0,french presidential candidate macron forced deny gay affair
1,1,11,50,0,11,2,61,0,15 beautiful story people met soulmates black college
1,3,3,53,0,10,1,56,0,google home update allows assistant access 5 million new recipe
1,1,13,29,3,8,0,42,0,"here's josh radnor feel ""himym"" finale"
1,2,1,68,4,15,0,69,0,"car crash death rise, expert say ""we're right things"" prevent"
1,1,7,25,0,6,0,32,0,solve new year crossword
1,1,13,57,0,12,0,70,0,hilarious photo series highlight much cricket changed year
1,1,6,26,0,6,2,32,0,21 grandma zero fucking filter
1,2,8,42,0,10,0,50,0,american interested hunt alien life
1,2,6,44,1,9,0,50,0,one three conservative mp join anti-eu campaign group
1,1,8,30,1,7,0,38,0,what's word disney fan understand
1,1,9,29,1,8,0,38,0,here's eat dinner week
1,3,10,51,0,10,0,61,0,pilot removed flight bizarre rant divorce politics
1,1,11,48,0,11,2,59,0,19 thing american teen british girl insanely jealous
1,3,1,45,0,8,0,46,0,cardboard baby box could allow safe sleep baby
1,1,6,24,0,6,1,30,0,horoscope week december 7
1,3,11,40,2,9,0,51,0,amazon's echo may difficult time-consuming many
1,2,4,40,0,9,0,44,0,dvla website struggle new rule hiring car
1,2,2,40,1,10,2,42,0,cheese porn alert! 10 best thing cheese
1,1,6,36,1,6,2,42,0,22 reason costco america's greatest achievement
1,1,8,27,0,8,4,35,0,big winner 2016 grammy award
1,1,11,41,3,10,0,52,0,"ryan reynolds really mind nude ""deadpool"" set"
1,3,9,31,2,8,0,40,0,guess long youll keep resolution?
1,1,9,40,0,9,2,49,0,13 body positive instagram account need following
1,1,10,32,1,10,2,42,0,26 picture can't make smile
1,1,14,56,0,13,0,70,0,facebook going wild organist paying emotional tribute david bowie
1,1,9,33,0,9,2,42,0,14 woman pushed boob potential limit
1,3,1,35,0,9,2,36,0,father gave terrifying lesson 10
1,1,5,19,0,4,0,24,0,psychic actually
1,1,9,21,2,8,0,30,0,can't tell he's gay metro
1,2,12,40,1,14,0,52,0,odd lots: know stock market bubble
1,1,6,28,0,6,2,34,0,21 picture literally every girl taken
1,2,7,36,1,10,4,43,0,travel hacker's guide elite status 2017 beyond
1,1,8,24,4,7,0,32,0,"""in heights"" ""hamilton"""
1,2,6,66,1,16,0,72,0,picture moonlight's jaden piner sum feel oscar list
1,1,8,32,2,7,0,40,0,"character ""the flash"" marry"
1,1,6,14,0,5,0,20,0,pet right cat
1,3,9,42,2,8,0,51,0,jennifer aniston give 'tanning intervention'
1,1,11,34,2,10,0,45,0,say someone who's grieving vs. hear
1,3,2,40,2,6,0,42,0,half-billion-dollar statue dividing india
1,2,2,27,0,7,6,29,0,25 funniest tweet 2016 list
1,1,9,23,2,8,0,32,0,"well know season one ""buffy"""
1,2,10,48,1,8,0,58,0,ingenious hack turn amazon dash button trump-fighting machine
1,1,8,24,0,8,2,32,0,12 reason moxie best soda earth
1,1,6,26,0,6,2,32,0,26 gorgeous new cover classic book
1,1,10,33,1,9,0,43,0,make new year's eve actually bearable
1,1,15,47,4,13,0,62,0,"jon snow danced tv drake's ""hotline bling"" made people's christmas"
1,1,11,37,2,10,0,48,0,babysitter's porn dead hamsters: fuck
1,2,9,34,1,10,0,43,0,"marketers, tv set invaluable pair eye"
1,3,5,57,0,13,0,62,0,exactly long donald trump longer president list
1,1,10,28,0,9,0,38,0,gender flipped way talk food
1,3,9,35,3,8,0,44,0,susan sarandon: sexual orientation grab
1,1,9,37,0,9,2,46,0,21 thing mildly thrill everyone work retail
1,3,10,29,1,9,2,39,0,33 annoying rom-com moment time
1,3,10,62,2,9,0,72,0,"unsurprisingly, celebrity impressed donald trump's press conference"
1,1,11,49,1,10,0,60,0,everyone's freaking morrison pizza look rude
1,2,6,41,0,6,0,47,0,indestructible coffee machine extreme caffeine
1,1,7,18,1,6,0,25,0,could u playin'
1,3,2,81,0,17,0,83,0,men released shampoo claim permanently turn gray hair back original color
1,2,6,35,0,5,0,41,0,big government republican rebuke trump budget
1,1,11,43,1,11,2,54,0,22 picture prove there's place earth like planet fitness
1,3,10,57,1,11,0,67,0,pulse massacre jihadis wife arrested charge aiding foreign terror group
1,1,8,41,1,8,2,49,0,guy get '90s boyband makeover significant others
1,3,11,38,1,7,0,49,0,ligo already discovered evidence quantum gravity?
1,3,11,55,5,11,0,66,0,obamas advice precious snowflakes: dont go around looking insult
1,1,9,34,0,9,2,43,0,17 thing girl much hair understand
1,1,10,28,1,10,2,38,0,19 thing say sex emo
1,2,10,39,0,10,0,49,0,consumer want logo gift season
1,1,14,36,0,14,2,50,0,real forever 21 tee slogan fucking
1,3,2,62,0,12,2,64,0,destination 17 image ireland make want visit immediately
1,2,13,41,2,15,4,54,0,"chol marial, 14, stand 7 foot 3 basketball court"
1,1,10,42,1,9,0,52,0,struggle real buying concert ticket online
1,3,14,67,3,12,0,81,0,"deepika padukone find comparison pc bizarre, say 'worlds' completely different"
1,1,9,27,0,9,4,36,0,2015 meme based zodiac sign
1,1,8,31,0,8,2,39,0,across universe john lennon 39 picture
1,1,8,39,0,7,0,47,0,interfaith family celebrate holiday
1,1,6,23,0,5,0,29,0,adele album actually
1,1,10,39,2,9,0,49,0,"liam payne bought flying ford anglia ""harry potter"""
1,1,15,48,3,14,0,63,0,panic! disco's new music video creepiest thing see week
1,2,1,60,0,11,4,61,0,baku 2015 organiser investigate alcohol claim athlete hit bus
1,3,8,45,0,8,0,53,0,top alabama democrat back jeff session attorney general
1,1,4,23,0,4,2,27,0,21 truth group friendship
1,2,10,40,0,11,0,50,0,trust record show trump still closely tied empire
1,3,1,46,1,6,0,47,0,"giraffe facing extinction, warn conservationist"
1,1,8,44,0,7,0,52,0,facebook life achievement book lover understand
1,1,9,30,0,8,0,39,0,belong anakin skywalker kylo ren
1,1,8,29,0,7,0,37,0,troye sivan song anthem
1,2,11,41,4,10,0,52,0,"biden: watched trump rally, realized may lose election"
1,1,9,31,0,9,2,40,0,15 people definitely drake train
1,1,11,29,1,10,0,40,0,here's right kind lube every kind sex
1,1,15,38,2,14,0,53,0,used alcoholic. i'm stoner drink sometimes
1,3,2,56,3,9,4,58,0,"flight compensation: delta offer nearly 8,000 overbooked passenger"
1,2,7,24,2,8,0,31,0,blue state real tea party
1,3,2,59,2,14,1,61,0,6-year-old boy saved man massive heart attack list
1,1,5,20,0,6,6,25,0,16 imaginative art vine 2015
1,1,8,30,0,7,0,38,0,one thing never noticed aladdin
1,1,9,29,0,8,0,38,0,roommate built cat castle fit royalty
1,1,7,36,0,7,2,43,0,21 thing brutally honest woman understand
1,1,10,41,1,9,0,51,0,"bill hader fred armisen gave weird, wonderful interview"
1,3,3,47,1,10,0,50,0,here's electric car mercedes building take tesla
1,3,6,79,1,13,0,85,0,critic turkey's president recep tayyip erdogan tell intimidation ahead crucial referendum
1,1,11,47,4,10,0,58,0,"here's original ""ghostbusters"" concept art, stay puft slimer"
1,1,14,47,0,13,0,61,0,woman taking stand people say mental illness fake
1,1,10,35,3,9,0,45,0,"guess ""friends"" season based joey's fridge"
1,3,8,55,5,12,0,63,0,high-tech e.l.f. guiding confused shopper help ibm's watson
1,1,10,32,0,9,0,42,0,taylor swift missed note cried grammys
1,3,1,81,0,16,0,82,0,horrifying moment daredevil plunge four floor climbing window block flat
1,1,9,33,2,9,2,42,0,"17 time ""chavo del ocho"" perfectly summed life"
1,1,10,31,0,9,0,41,0,snapchat ran ad booze hajj story
1,1,14,50,0,13,0,64,0,made andrew garfield build ikea chair talking new movie
1,2,6,28,1,5,0,34,0,trouble disney remakemachine
1,1,10,40,0,9,0,50,0,guess personality based favorite thing
1,1,9,37,0,9,2,46,0,13 holiday drinking game get drunk christmas
1,3,10,32,0,10,2,42,0,10 book read see movie summer
1,1,6,23,0,5,0,29,0,horror movie villain
1,3,12,37,3,9,2,49,0,cosmetic crook steal $4.5m eye shadow warehouse: lapd
1,1,13,34,2,13,2,47,0,"29 thing learn hang cast ""con man"""
1,3,17,51,7,16,3,68,0,"that's future: solar power rate drop r 3.15/unit, going get cheaper!"
1,1,14,51,0,13,0,65,0,video show happens single people end awkward blind date
1,2,15,56,0,14,0,71,0,homeless guy went viral getting makeover whole lifechanged
1,2,4,24,3,4,1,28,0,community episode 1: ladder [video]
1,3,15,62,1,15,2,77,0,girl scout sell 15k cookie box writing brutally honest cookie review yahoo
1,1,12,31,0,11,0,43,0,happens guy take shower work
1,1,11,35,0,10,0,46,0,know disney film based three word
1,1,6,20,1,6,2,26,0,11 sign filipino party
1,1,9,24,0,10,6,33,0,32 time lady gaga best damn year 2015
1,1,12,45,0,11,0,57,0,super bowl commercial people talking
1,1,9,23,0,9,2,32,0,taylor swift wrote novel age 14
1,1,7,34,0,7,2,41,0,26 quote parenthood painfully true
1,3,2,54,0,8,4,56,0,stunning 1900 image record norwegian villager amid epic landscape
1,3,6,35,0,5,0,41,0,hollywood mourns screen legend debbie reynolds
1,1,7,33,0,7,2,40,0,15 hanukkah dessert make verklempt
1,3,3,46,0,8,0,49,0,feather fly pillow war overtakes downtown los angeles
1,2,9,32,6,9,0,41,0,rick ross kanye west 'wigging out': 'he played ya'll'
1,1,10,28,1,9,0,38,0,video every girl can't makeup
1,1,11,34,3,11,2,45,0,"23 ""archer"" joke funny they'll put danger zone"
1,2,12,63,3,13,1,75,0,florida taxpayer paid pitbull $1 million promote tourism sexy beach music video
1,3,11,40,0,11,2,51,0,19 tweet prove great carrie fisher attwitter
1,1,7,31,1,7,2,38,0,12 disney inspired candle wish real
1,1,12,46,0,11,0,58,0,video bros dancing justin bieber hoverboards perfect
1,1,10,33,1,10,2,43,0,19 song listen patriarchy's got
1,3,11,38,0,11,2,49,0,everything need know 38 best diet health
1,1,14,59,1,13,0,73,0,taraji p. henson responded perfectly golden globe speech almost cut short
1,3,7,33,1,7,3,40,0,100 picture thatll make pee yourselflaughing
1,1,9,27,1,7,0,36,0,most-used emoji say
1,2,2,62,1,11,0,64,0,wall street changing trade world's hottest investment product
1,1,8,44,1,7,0,52,0,anyone truly appreciates rihanna's remarkable beauty
1,3,2,30,2,5,0,32,0,here's snapchat's stock plunging
1,3,4,63,0,17,0,67,0,look like u fire missile use nuke list
1,2,7,36,1,10,1,43,0,kelly promise build trump wall 2 year less
1,2,7,38,3,7,0,45,0,google next project: fixing congested city digit
1,2,16,54,0,15,0,70,0,old fight geeta phogat sakshi malik give feel dangal
1,1,16,55,5,15,0,71,0,"alex trebek got tricked saying ""turd ferguson"" ""jeopardy,"" work done"
1,1,13,45,2,12,0,58,0,"remember first word video ""total request live"""
1,2,5,41,2,9,2,46,0,'13 reason why' different ya adaptation
1,1,7,30,2,7,2,37,0,"17 thought watching ""making murderer"""
1,2,8,29,1,8,2,37,0,fact truly upsetting '90s girl
1,3,2,36,4,8,0,38,0,"poor sleeping, energy, low libido: aging?"
1,3,6,30,4,6,0,36,0,weekend mar-a-lago: reporter notebook
1,1,12,31,0,10,2,43,0,41 wtf cat picture make laugh every time
1,1,11,41,1,10,0,52,0,today's day chandler bing supposed call julia robert
1,3,11,33,4,7,0,44,0,centurylinkvoice: new year. new you. better network.
1,1,8,30,1,7,2,38,0,24 heat-activated mug never knew needed
1,2,9,46,0,9,0,55,0,migrant stab bouncer gay nightclub refused entry
1,3,4,36,1,6,0,40,0,president donald trump first monday office
1,3,13,45,0,11,0,58,0,chris evans go full captain america former kkk leader david duke
1,3,12,46,0,12,2,58,0,11 awesome kickstarter project need invest right
1,3,19,65,4,16,0,84,0,"kareena-taimur's adorable pic go viral, kapil sharma introduces gf world ent!"
1,1,14,32,0,13,0,46,0,taylor swift loss fire alarm
1,1,11,49,2,11,2,60,0,20 thing understand slightly obsessed meal prep
1,1,7,32,0,7,2,39,0,17 reason definitely bring sweater
1,3,3,62,1,12,0,65,0,ryan gosling finally explains giggled way oscar mix-up
1,1,11,35,2,10,0,46,0,"buy mansion ""four wedding funeral"""
1,1,10,35,0,9,0,45,0,comic kylo ren chewbacca wreck
1,1,8,26,0,7,0,34,0,new book read winter
1,1,10,46,0,10,2,56,0,11 photo beatles one direction presented without comment
1,2,9,60,4,10,1,69,0,7 revelation shattered: new book detailing hillary clinton failed campaign
1,1,8,35,0,7,0,43,0,thing brazilian everyone
1,1,5,28,0,5,2,33,0,19 surprising confession anal sex
1,1,6,16,0,4,0,22,0,delivery digiorno
1,1,10,42,2,9,0,52,0,here's emma watson felt hermione granger's bushy hair
1,1,11,32,3,10,0,43,0,"well know lyric ""frosty snowman?"""
1,2,5,20,1,4,0,25,0,actually taylorswift?
1,1,10,39,0,8,0,49,0,raise kitchen game buzzfeed food newsletter
1,1,10,44,0,9,0,54,0,anyone whose face permanently frozen one expression
1,3,5,29,1,5,0,34,0,world reacts trump inauguration
1,1,14,50,3,14,1,64,0,"7 essay read: sex scene actually sexy, confident black men, debt"
1,1,10,27,3,9,2,37,0,"19 time lindsay ""you're worst"" af"
1,1,7,27,1,6,0,34,0,easiest horcrux quiz ever take
1,3,1,67,0,16,0,68,0,precise time go bed want wake feeling refreshed tomorrow
1,1,9,32,1,8,0,41,0,said it: nicki minaj elizabeth cady stanton
1,1,7,32,1,6,2,39,0,21 stellar idea astronomy-themed wedding
1,2,1,39,2,6,0,40,0,women: experienced workplace problem?
1,2,15,67,4,16,0,82,0,dem rep cleaver: ive getting kind hate phone call deciding attend inauguration
1,3,12,63,3,13,0,75,0,"megyn kelly hint dissatisfaction fox news, talk great option wapo interview"
1,2,15,58,3,12,0,73,0,"tanmay bhat's honest apology sachin,farhan-adhuna granted divorce ent"
1,3,10,36,9,11,0,46,0,abc black-ish: vote trump vote racism (video)
1,1,15,47,4,13,0,62,0,"paul rudd dancing ""ant-man"" costume cutest thing see today"
1,1,11,34,0,12,6,45,0,13 new way style hair 2016 actually pretty
1,1,12,39,0,12,1,51,0,9 woman movie somehow brought money year
1,1,9,36,0,9,2,45,0,21 time larry david spoke everyone hate people
1,2,8,43,3,7,0,51,0,ann coulter: immigrant privilege drive child rape epidemic
1,1,8,33,1,8,1,41,0,9 confession make glad single
1,3,12,55,3,12,0,67,0,adele explains went wrong george michael tribute: devastated
1,1,16,61,3,15,0,77,0,"reporter claim harassed called ""prostitute"" march show india's tolerance"
1,1,10,36,0,9,0,46,0,inkblot test determine hate
1,1,10,47,1,10,0,57,0,tyra bank chrissy teigen got really candid fertility issue
1,1,6,37,0,5,0,43,0,chocolate dessert completely mesmerizing
1,2,3,58,0,12,0,61,0,president obama used eulogy explain vision public service
1,1,6,23,0,5,0,29,0,truth shaving pubes
1,3,12,29,4,10,0,41,0,apple ceo tim cook: weve got filter fake news
1,3,1,23,0,3,0,24,0,need horticulturist
1,3,0,44,0,8,2,44,0,12 gift modern gentleman actually want year
1,2,12,34,2,10,1,46,0,superbug list: enemy no. 1 bug plague soldier
1,1,9,34,0,9,2,43,0,49 italian village bucket list
1,1,5,19,0,4,0,24,0,knowles sister
1,1,13,38,0,12,0,51,0,dog baby react exact way daddy coming home
1,3,8,35,0,8,2,43,0,15 thing anyone endometriosis need toknow
1,1,8,34,0,7,0,42,0,rapper fetty wap injured motorcycle accident
1,1,12,40,2,10,0,52,0,"uk's slow response ebola cost thousand lives, say report"
1,1,10,39,1,10,2,49,0,42 thing understand life literally sitcom
1,3,5,55,6,15,0,60,0,tried watch much fox friend president. here learned.
1,1,10,39,0,10,2,49,0,46 taylor swift lyric need instagram caption
1,3,6,34,1,6,0,40,0,iceland's fishing industry starting stink
1,1,10,23,0,9,0,33,0,actually meme bob meme snob
1,3,2,35,1,6,0,37,0,pen power: china closer ballpoint success
1,1,14,46,0,13,0,60,0,able handle new real housewife atlanta trailer
1,1,15,43,1,14,0,58,0,person care watch new star war movie
1,1,10,39,0,9,0,49,0,newbie know hitting gym
1,1,10,27,0,9,0,37,0,buy candle baby raptor inside
1,1,7,37,2,7,2,44,0,"19 thought everyone watching ""house hunters"""
1,2,11,37,0,11,2,48,0,49 bizarre also real fear every woman relateto
1,3,8,44,4,7,0,52,0,majority hungarian back orbans anti-soros university law
1,1,6,24,0,5,0,30,0,obsessed surviving
1,2,12,63,1,11,1,75,0,mitsubishi heavy industriesvoice: 3 japanese business practice age disruption
1,3,1,57,0,10,0,58,0,heartbreaking photo father dying cancer cradling young son
1,1,10,33,0,10,2,43,0,32 tweet sleep make laugh loud
1,1,10,39,0,9,0,49,0,cream cheese banana bread blow fucking mind
1,1,7,19,0,6,0,26,0,gay tribe belong
1,3,0,45,1,9,5,45,0,"5 habit worth cultivating 2017, according dietitian"
1,1,6,30,0,6,2,36,0,19 unbelivably rude text hangover
1,3,6,47,2,8,0,53,0,campus wary offering sanctuary undocumented student
1,1,10,25,1,8,0,35,0,make egg mcdonald's
1,2,9,29,4,9,0,38,0,cuban trump: dont think last four year
1,1,8,28,4,7,0,36,0,"well know one direction's ""perfect?"""
1,1,8,37,0,7,0,45,0,portrait celebrate joy freckle
1,1,13,35,1,13,2,48,0,27 time happened gay bar stay gay bar
1,1,11,45,2,10,0,56,0,"woman flushed ring toilet, lived everyone's nightmare"
1,1,13,34,2,12,2,47,0,"34 reason ""how met mother"" cleverest show tv"
1,3,6,63,1,14,2,69,0,"richmond park, 10 seat remainers may hope take tory brexiteers"
1,3,13,49,2,13,6,62,0,"high school sweetheart saving nearly $100,000 year retire early"
1,3,1,48,0,10,0,49,0,pointing phone critical document bad idea
1,1,15,42,0,12,0,57,0,went irl derek zoolander center ridiculously cool
1,2,6,20,0,6,1,26,0,7 way eat healthier thisweek
1,1,10,41,3,10,2,51,0,"18 question watching ""star wars: force awakens"""
1,1,15,43,3,14,0,58,0,"well remember lyric ""gettin' jiggy wit it"" smith"
1,1,10,36,0,9,0,46,0,starbucks drink based zodiac sign
1,1,14,55,0,15,6,69,0,16 thing martha stewart tweeted 2015 make laugh absolutely reason
1,2,2,27,4,8,4,29,0,"yes, really: '1984' sold amazon"
1,1,17,38,2,14,0,55,0,"wonder woman ""magic mike xxl"" still sex swing"
1,1,9,39,0,8,0,48,0,football club could segregate black fan white fan
1,1,6,33,1,6,2,39,0,adorable animal advent calendar: december 15
1,1,14,48,1,13,2,62,0,21 time tumblr user perfectly explained feel not-quite adult
1,1,11,38,1,11,1,49,0,"9 text send best friend, actually mean"
1,1,9,42,2,9,2,51,0,26 thing understand sightly obsessed wine
1,1,11,40,1,10,0,51,0,many song justin bieber's album selena gomez
1,2,2,74,5,18,3,76,0,509-year-old map contains first known use word 'america' may think
1,1,8,29,0,8,2,37,0,15 time justin trudeau thirst went far
1,1,11,42,0,10,0,53,0,doug pug try sexy halloween costume wow everyone
1,1,8,34,1,8,2,42,0,19 product change every booze lover's life
1,1,6,25,0,5,0,31,0,gabourey sidibe refuse back
1,1,8,35,2,8,2,43,0,"20 ""doctor who"" question impossible answer"
1,1,10,46,1,10,2,56,0,19 picture people shopped aritzia understand
1,2,10,55,2,10,0,65,0,donald trump signal big fat beautiful negotiation house healthcare bill
1,2,2,39,1,7,0,41,0,journeyman boxer: fighting losing side
1,1,7,30,2,5,2,37,0,28 jaw-dropping close-up photograph nature
1,1,5,12,0,5,4,17,0,2015 pop hit
1,3,11,54,0,10,0,65,0,watch dad read inspiring affirmation wrote daughter
1,1,8,25,0,7,0,33,0,unknowingly gender bias
1,1,10,34,0,10,2,44,0,19 people never allowed use microwave
1,1,14,35,8,8,0,49,0,"""agents s.h.i.e.l.d."" organization affiliate"
1,1,11,35,0,10,0,46,0,urinal may taken greatest leak time
1,1,10,38,1,9,2,48,0,18 pop-punk holiday song true emo kid appreciate
1,3,7,34,0,10,2,41,0,12 best place see sunset around world
1,2,3,62,3,12,0,65,0,women's march: drove people join protest around world weekend?
1,1,14,62,0,13,0,76,0,artist reimagined disney princess current age result gorgeous
1,1,9,34,0,9,2,43,0,18 reason dad basically ron swanson disguise
1,1,11,37,1,11,2,48,0,27 thing gloriously awkward able look away
1,2,4,37,0,9,0,41,0,popular tv show made amazon
1,3,2,46,0,12,0,48,0,happens penis get older list
1,1,10,34,0,10,4,44,0,moving personal essay needed read 2015
1,1,12,44,0,11,0,56,0,tumblr user discovered pun work many language
1,1,12,29,0,12,2,41,0,14 pair cat sock kick mew year style
1,1,12,42,2,11,0,54,0,"mini ""harry potter"" reunion florida weekend"
1,1,15,41,2,14,0,56,0,"yes, deep fry pumpkin spice latte way easy"
1,1,10,40,2,8,0,50,0,guess suffering post-christmas sadness
1,1,14,57,0,13,0,71,0,people bullying woman facebook picture eyebrow went viral
1,2,1,27,1,4,0,28,0,northern soul: fashion showcase
1,2,11,46,1,10,4,57,0,ncaa tournament 2017: ranking top performer first round
1,1,12,47,2,11,0,59,0,"know fave ""harry potter"" character based favorite kitten"
1,3,15,69,4,16,6,84,0,"sri sri ravishankars art living destroyed yamuna floodplains; r 42.02 cr, 10 year needed restoration"
1,3,9,35,0,10,0,44,0,watch super bowl li commercial one spot
1,3,19,43,3,17,4,62,0,best deal crossover suvs: rebate $6k lease low $169 month
1,3,4,29,4,8,0,33,0,"stonehenge, mystery, amazon"
1,1,9,30,0,9,2,39,0,21 tiny fashionable hat make cat
1,1,7,33,0,7,2,40,0,17 power snack every college student know
1,1,16,60,0,16,2,76,0,canadian mailman found woman wrote heartbreaking letter santa 22 year ago
1,1,5,10,0,5,4,15,0,hip 2015
1,1,7,30,1,7,2,37,0,13 thing know extreme poverty
1,1,10,41,0,10,2,51,0,15 thing people grew young parent understand
1,1,8,25,1,8,2,33,0,12 bouquet bride give fuck
1,1,9,34,1,9,2,43,0,22 time internet proved we're together
1,2,2,49,1,9,4,51,0,zimbabwe paying people $5 175 quadrillion zimbabwe dollar
1,1,9,36,1,9,1,45,0,9 couple costume make glad single
1,3,3,73,2,12,0,76,0,my-king johnson first active openly gay scholarship player major-college football
1,1,7,35,0,7,2,42,0,23 reason never watch american football
1,1,9,32,1,8,0,41,0,"thanksgiving, caring cared u"
1,1,11,40,1,10,0,51,0,decided deep fry christmas dinner life changing
1,1,5,23,0,5,2,28,0,21 honest secret virgin
1,1,8,40,0,8,2,48,0,17 honest confession moving boyfriend
1,1,10,39,1,9,0,49,0,what's quote lyric best describes depression
1,2,7,26,0,7,0,33,0,best dry shampoo every hair type
1,1,13,66,0,12,0,79,0,jennifer lawrence best britney spear impression endearingly awkward video
1,2,10,50,1,12,0,60,0,"preacher locked up, charged hate crime quoting bible gay teen"
1,1,8,39,2,7,0,47,0,"""friday night lights"" quarterback soulmate"
1,1,9,33,2,9,2,42,0,"19 time ""adventure time"" really wanted make cry"
1,1,6,23,0,6,2,29,0,19 time haggis fucking worst
1,1,10,43,0,9,0,53,0,cereal cocktail give breakfast deserve
1,2,2,59,0,14,0,61,0,symptom may anxiety disorder list
1,2,15,66,1,14,0,81,0,"minute sasikala sentenced four year imprisonment, twitter hosted epic roast party"
1,2,6,34,1,6,4,40,0,world's international university 2017
1,2,8,43,0,9,0,51,0,half german woman feel unsafe neighbourhood
1,3,7,17,1,6,0,24,0,game xbox one
1,1,3,15,0,4,2,18,0,1 dress 5 holiday style
1,1,9,36,0,9,2,45,0,21 gift people completely obsessed tea
1,2,14,56,3,12,0,70,0,"watch sourav ganguly play gully cricket street kolkata, right-handed!"
1,1,12,45,1,12,2,57,0,13 terrifying urban legend make wish read
1,1,9,27,2,8,0,36,0,"know castle ""game thrones"""
1,1,6,34,0,6,2,40,0,21 people made pretty questionable decision
1,3,10,29,4,7,0,39,0,"nasa, mosul, kim jong-nam: thursday briefing"
1,1,8,30,0,7,0,38,0,everyone think text drive
1,1,7,19,0,6,0,26,0,pop diva alter ego
1,3,3,57,8,11,0,60,0,"'don't eat kebabs' tupac, kurt, best musician-to-musician letter"
1,2,17,55,2,16,0,72,0,"dark matter exist, gravity wrong? answer lie billion year past"
1,1,7,28,2,7,2,35,0,"20 time ""civilization v"" made act uncivil"
1,1,15,64,1,7,0,79,0,people hashtagging #iwillnotapologizeforbeingdarkskin celebrate complexion
1,1,10,42,0,9,0,52,0,quote literature helped depression
1,1,10,42,1,9,0,52,0,raccoon polite passenger toronto's subway
1,1,7,31,1,6,2,38,0,23 crucial item every die-hard tailgater need
1,1,10,36,3,9,0,46,0,"course paul reuben play penguin's dad ""gotham"""
1,2,5,45,2,11,1,50,0,forgot dray? green warriors' game 1 triumph
1,3,4,37,3,9,0,41,0,"theresa may 'right' sack me, say michael gove"
1,1,9,34,2,7,0,43,0,what's funniest youtube comment ever seen
1,1,13,40,1,12,0,53,0,"drama, selena gomez pop princess need deserve"
1,1,10,40,0,10,2,50,0,25 thing everyone studied australia guilty
1,1,10,43,0,9,0,53,0,take makeup picture test determine dominant trait
1,3,10,52,2,10,0,62,0,medium claim trump hate crime muslim airline employee unravels
1,1,12,45,2,11,0,57,0,"smith appeared ""good morning america"" talk oscar"
1,1,13,42,0,12,0,55,0,gordon ramsay offered chef epilepsy job fired
1,2,6,50,3,11,0,56,0,korean man's instructional video u.s. v uk accent glorious
1,1,9,31,0,9,1,40,0,8 thing one tell guy body image anxiety
1,1,10,42,0,9,0,52,0,helen mirren slaughtered faves one iconic pose
1,2,15,66,1,14,0,81,0,"liquor shop along highway shut, indian student assaulted poland must read story"
1,2,2,50,2,10,0,52,0,here's pilot look they're passenger list
1,3,8,33,1,7,0,41,0,man behind warren buffetts big insurance bet
1,1,6,33,1,6,1,39,0,adorable animal advent calendar: december 1
1,2,16,41,2,15,0,57,0,"uh, spider could eat u year, case wondering"
1,1,11,37,2,11,2,48,0,"15 sexy winter drink next time ""netflix chill"""
1,1,7,27,0,7,2,34,0,21 healthier eats people hate salad
1,1,7,28,0,6,0,35,0,horror novel accurate title
1,1,8,24,0,8,2,32,0,11 way totally nail sex woman
1,1,8,24,2,7,0,32,0,"would ""game thrones"" name"
1,1,8,25,0,7,0,33,0,sign need get shit together
1,1,6,20,0,7,6,26,0,25 fab celebrity look 2015
1,1,9,28,2,8,0,37,0,"arjun kapoor ""neerja"" one noticed"
1,1,8,29,0,8,2,37,0,23 thing single girl tired hearing
1,1,7,29,0,6,0,36,0,taylor swift single favorite
1,2,3,49,2,11,0,52,0,'game thrones' statue stuff nightmare made
1,1,11,33,0,9,2,44,0,23 super cute contact paper diys transform home
1,1,14,48,1,14,4,62,0,here's moment justin bieber hailey baldwin met first time 2009
1,2,3,61,3,10,0,64,0,everything destroyed: deadly surge violence strike eastern ukraine
1,3,14,40,3,13,0,54,0,"ready file taxes, here's get extension"
1,1,5,25,1,3,0,30,0,bacon-wrapped sriracha onion ring
1,3,2,53,2,9,0,55,0,"ted cruz revealed disturbing, yet poetic, feeling queso"
1,1,2,15,0,1,0,17,0,mormon confession
1,1,8,30,0,7,0,38,0,colour test reveal orgasm face
1,1,5,29,0,5,2,34,0,11 celebrity quote depressed
1,1,9,38,0,9,4,47,0,clydesdale horse already best photobomb 2016
1,2,2,81,1,17,0,83,0,every new employee billion-dollar glass brand get kerouac pretzel welcome gift
1,1,7,29,0,8,4,36,0,17 thing actually helped lose 85 pound
1,1,11,34,0,11,2,45,0,12 chart way real people hate people
1,1,12,47,0,11,0,59,0,student makeup artist london take halloween whole level
1,1,10,32,2,10,2,42,0,"17 ""home alone"" tweet make laugh loud"
1,3,13,46,2,13,0,59,0,yemen: trump strike al-qaeda one month obama year
1,1,9,40,0,9,2,49,0,19 thing couple two year understand
1,1,12,31,4,12,0,43,0,s.o. jack sally morticia gomez
1,1,11,46,1,10,0,57,0,test determine actually western balkan
1,1,10,48,1,8,0,58,0,stop-motion music video starring cereal totally mesmerizing
1,1,9,35,0,9,2,44,0,12 aussie reveal love hate britain
1,2,3,34,1,7,6,37,0,final 2016-17 power ranking settle debate
1,1,9,32,0,8,0,41,0,puzzle everyone know booze
1,1,6,22,0,6,1,28,0,5 great book read december
1,1,8,40,0,8,2,48,0,17 reason every gryffindor need hufflepuff best friend
1,1,12,42,2,10,3,54,0,meet woman still managing stock portfolio 100-years-old
1,1,10,43,2,10,2,53,0,"18 cringeworthy moment first new episode ""first dates"""
1,1,6,21,0,7,6,27,0,12 time zendaya schooled u 2015
1,3,3,47,0,9,0,50,0,gop rep stand controversial health care comment mom
1,3,16,54,3,14,0,70,0,"shahid share misha's adorable pic, shaktimaan return tv ent world!"
1,2,13,47,3,12,1,60,0,ascap radio group's 5-year pact address elephant room
1,1,19,50,2,18,0,69,0,"took u serious minute figure famous person cover ""elle"""
1,3,9,44,0,9,2,53,0,21 gloriously perfect tweet make everything feel good
1,1,10,31,1,10,2,41,0,48 thing woman hear lifetime men
1,1,11,29,0,7,0,40,0,favorite lgbt essay published year
1,1,11,44,1,10,0,55,0,what's best story traveling internet
1,1,6,25,0,6,2,31,0,22 kid winning thanksgiving
1,1,12,41,4,11,0,53,0,"toughest game ""would rather"": hot guy vs. grilled cheese"
1,1,10,31,2,7,1,41,0,5 must-have quality usc's next football coach
1,3,3,21,0,4,0,24,0,business photo month
1,1,8,28,2,8,4,36,0,"""twelve day christmas"" written 2015"
1,3,16,45,0,14,2,61,0,10 youth punjab death row uae murder pakistani national
1,1,10,37,3,9,0,47,0,"hardest ""walking dead"" video game quiz ever take"
1,1,10,35,0,9,0,45,0,ready sync vagina smartphone
1,1,7,25,1,7,2,32,0,25 autumn tattoo fall love
1,1,7,35,1,6,2,42,0,19 thing science-geek parent understand
1,1,14,48,1,13,0,62,0,aubrey plaza tried play robert de niro's nipple succeed
1,1,9,37,0,8,0,46,0,name christmas movie poster
1,1,10,38,1,9,0,48,0,anna faris think chris pratt's ball sexy perfect
1,1,7,21,0,6,0,28,0,know fact fiction
1,3,8,43,2,9,0,51,0,kim kardashians robber reveal location ring?
1,1,12,39,2,12,2,51,0,"11 time helena ""orphan black"" cute psychopath"
1,1,10,37,0,9,0,47,0,donald trump dumpling everything need life
1,1,6,38,0,6,2,44,0,18 insanely clever beautifully decorated cooky
1,1,10,41,0,10,2,51,0,27 fictional couple restore faith black love
1,2,13,55,1,11,0,68,0,"drunk man confronts former mma fighter outside walmart, unexpected result"
1,3,2,25,0,6,0,27,0,trump get groove back
1,2,9,41,1,8,0,50,0,"society could collapse decade, predicts math historian"
1,1,9,34,0,8,0,43,0,guideline using household object sex toy
1,3,18,57,0,17,0,75,0,makeup youtuber best response teen said wished looked like
1,1,5,27,0,4,0,32,0,definitive ranking breakfast
1,1,10,29,2,10,2,39,0,"23 reason ""the office"" worst show time"
1,2,2,40,1,8,0,42,0,happen naked tourist malaysia?
1,1,18,59,0,17,0,77,0,group people tried journaling every day month got little introspective
1,1,7,23,0,6,0,30,0,guess secret sexy talent
1,1,16,38,3,16,2,54,0,"moved back parent's house 29, end world"
1,1,7,26,0,7,2,33,0,13 thing everyone germany agree
1,1,10,33,1,9,0,43,0,show u funniest picture taken dog
1,1,12,30,0,10,0,42,0,match song lyric disney tv movie
1,1,10,38,0,9,0,48,0,video beautifully show many face kerala
1,3,9,32,1,7,0,41,0,chocolate peanut butter cup recipe nyt cooking
1,1,11,43,0,10,0,54,0,one question show career actually
1,1,6,30,2,6,4,36,0,21 ridiculously cool last-minute gift $50
1,1,11,49,0,11,2,60,0,21 hilarious tweet prove tyra relatable supermodel ever
1,1,8,40,1,9,6,48,0,17 underrated everyday product change life 2016
1,1,13,38,4,11,0,51,0,"read new gender-swapped ""twilight"" book"
1,3,12,38,3,10,0,50,0,here's dave chappelle never rick james sketch 'snl'
1,3,12,42,2,10,0,54,0,wish scored invite state fair-themed wedding
1,1,6,27,0,6,2,33,0,17 reason love eddie redmayne
1,1,5,21,2,5,4,26,0,week history: 14-19 september
1,1,7,17,0,6,0,24,0,know bathroom
1,3,3,36,3,7,0,39,0,"lesson hansonism? economy, stupid"
1,2,11,47,1,11,1,58,0,yankees' mason williams hit monster hr 1st career major league hit
1,1,16,58,0,15,0,74,0,people facebook taking stand meteorologist bullied baby bump
1,1,7,25,2,6,0,32,0,"pas ""christmas shoes"" test"
1,1,8,30,0,8,2,38,0,19 coming home outfit need newborn
1,1,7,25,3,6,0,32,0,"fuck, marry, kill: dude name edition"
1,2,14,32,7,11,0,46,0,annie lennox: 'aids over...we still long way go'
1,3,10,40,3,10,0,50,0,"six months, interview -- started breaking rule"
1,2,7,33,2,8,0,40,0,"rent chickens, sell eggs: eye chinese medium"
1,1,8,36,1,7,0,44,0,everyone obsessed nev schulman's chest hair
1,1,7,34,0,7,1,41,0,7 adorable crossbreed dog never knew existed
1,3,2,39,3,7,0,41,0,polar vortex returns: here itll coldest
1,3,1,24,1,6,2,25,0,10 best holdall picture
1,3,14,50,2,11,0,64,0,juicero united: two real-time case study crisis pr entrepreneur
1,1,18,51,0,17,0,69,0,guy ran marathon shirtless name back got lot attention
1,1,11,42,0,11,2,53,0,25 tweet real people collected pokemon card
1,1,13,34,0,10,2,47,0,15 thing hear date someone obsessed imdb
1,3,9,45,2,7,0,54,0,"post-election, music exec ramping philanthropic effort"
1,2,7,36,2,8,0,43,0,france presidential vote sunday: matter
1,3,22,66,1,21,6,88,0,"kashmiri college student accused planting bomb dtc bus 2005, acquitted 12 year"
1,1,10,31,2,9,2,41,0,12 chart people live l.a. understand
1,1,12,49,1,11,0,61,0,katy perry's pan flute performance cry tear laughter
1,1,4,14,0,3,0,18,0,average
1,1,9,34,0,9,2,43,0,27 thing would never see kardashians today
1,2,3,42,0,11,0,45,0,new poll kind bad news donald trump
1,3,19,56,0,17,2,75,0,potentially abandoned test match resulted first ever odi day 46 year ago
1,1,13,43,2,11,0,56,0,here's story half-naked drunk dude flooded rogers centre
1,3,7,34,0,8,0,41,0,era email overload may never arrive myanmar
1,2,2,59,0,13,0,61,0,let stranger choose profile picture list
1,1,13,38,0,14,6,51,0,17 thing cared 2005 would never today
1,1,13,56,2,11,0,69,0,ellen degeneres made victoria's secret angel absolutely amazing
1,1,9,39,0,8,0,48,0,cheesy mashed cauliflower heaven look like
1,1,4,11,0,5,6,15,0,19 best movie 2015
1,3,5,35,1,6,0,40,0,confession weather-beaten helicopter mom
1,1,8,31,0,8,2,39,0,18 celebrity instagrams need see week
1,2,9,44,1,9,0,53,0,mall owner find relief unlikely source: online retailer
1,1,5,27,0,4,0,32,0,people try activated charcoal drink
1,1,14,59,2,12,0,73,0,eight-months pregnant bridesmaid went labor morning friend's wedding
1,3,8,35,0,8,2,43,0,29 old school black actor absolutestunners
1,1,9,36,1,9,2,45,0,27 face anyone who's tried eat healthy recognize
1,1,15,27,0,11,2,42,0,21 men suit making u thirsty hell baftas
1,2,2,43,1,9,3,45,0,trump administration push first 100 days?
1,3,9,36,3,8,0,45,0,crackdown: ag session vow new era southern border
1,1,7,19,0,6,0,26,0,elf shelf watching
1,1,11,48,0,11,1,59,0,9 really important thing every black woman know edge
1,1,11,39,0,11,2,50,0,11 thing everyone vagina need know pap smear
1,2,9,36,1,7,0,45,0,seeing e-cigarettes may increase desire smoke
1,1,8,37,0,7,2,45,0,21 thing everyone bodycombat understand
1,3,11,40,4,10,0,51,0,there deadly power ranger curse didnt know
1,1,10,38,2,10,2,48,0,23 valentine's day gift idea wish thought first
1,2,8,41,1,8,1,49,0,9 surprising way wasting money without realizing
1,1,8,31,0,8,2,39,0,19 thing prove beautiful scary
1,1,13,35,2,15,4,48,0,"8 fall show excited about, 10 give chance, 6 avoid"
1,1,4,12,0,4,1,16,0,8 way live longer
1,1,6,20,0,5,0,26,0,try guy imitate
1,1,11,38,1,10,0,49,0,chart perfectly sum like teacher
1,1,10,31,0,9,2,41,0,17 youtube channel teach damn thing
1,2,9,42,0,8,0,51,0,softbank robotics plan app store humanoid pepper robot
1,2,8,42,2,7,0,50,0,"here exercise contagious, particularly among woman"
1,1,8,38,0,7,0,46,0,bellybutton say personality
1,1,6,32,0,7,6,38,0,15 inspiring grilled cheese sandwich 2015
1,3,8,48,1,10,8,56,0,30 30 2017: young innovator redefining marketing advertising
1,3,11,56,3,13,0,67,0,andrea mitchell: trump attack hillary health would worked man
1,3,8,31,0,7,0,39,0,financially prepare career change
1,1,17,57,0,16,0,74,0,toddler devastated find adam levine married finally met
1,1,11,36,1,11,2,47,0,34 workout tip anyone idea they're
1,2,12,58,2,11,0,70,0,george washington university history major longer required take u.s. history
1,1,11,54,3,10,0,65,0,"drake, election, jays: canada overwhelmed winning everything tonight"
1,1,9,46,0,8,0,55,0,priest reportedly suspended riding hoverboard mass
1,1,8,30,0,8,2,38,0,11 thing somebody dump shittily
1,1,11,37,0,10,0,48,0,guess favorite color based birth month
1,1,7,20,0,6,0,27,0,type fall sweater
1,3,9,27,3,8,0,36,0,"iris amanda ""the holiday""?"
1,1,8,34,1,8,0,42,0,fried fair food telephone feast mode hunger squad
1,1,8,36,0,8,2,44,0,22 honest comeback retail worker wish could use
1,1,9,34,1,9,2,43,0,23 time tumblr's love captain america got right
1,1,11,29,0,9,2,40,0,42 cat gifs guaranteed make laugh every time
1,2,10,30,0,9,2,40,0,12 real af sex situation make youcringe
1,1,7,20,0,6,0,27,0,rock climb without rope
1,2,4,47,2,10,0,51,0,"rudy gobert jazz: make winning plays, worry less stats"
1,1,5,9,0,4,0,14,0,pee poo
1,1,8,23,0,7,0,31,0,well know poodle mix
1,1,7,35,1,6,2,42,0,21 terrifyingly perfect gift shark-loving kid
1,1,6,25,0,5,0,31,0,fictional bromance best
1,1,7,29,1,5,0,36,0,here's sunday buzzfeed comic roundup
1,1,6,30,0,6,2,36,0,27 surprisingly funny tweet cat
1,2,13,38,1,13,2,51,0,23 thing get hate men also attracted
1,1,7,16,0,6,0,23,0,need new best friend
1,1,7,19,0,7,2,26,0,21 lie men told sex
1,3,1,43,0,7,0,44,0,frustrated child get stuck inside toy claw machine
1,1,7,26,1,7,2,33,0,21 vine think actual magic
1,1,10,42,1,9,0,52,0,"thank goodness, demi lovato selena gomez still friend"
1,1,10,26,0,10,1,36,0,9 gross thing never front man
1,1,9,38,0,9,2,47,0,11 thing people recovering anorexia want know
1,1,14,35,0,11,0,49,0,frigid winter blue summed gifs really hot guy
1,1,9,18,0,8,4,27,0,many tv show watch 2015
1,3,4,74,2,19,0,78,0,ryan gosling whispered woman's ear oscar need know said! list
1,3,3,31,0,4,0,34,0,extended interview angelina jolie
1,3,10,46,1,9,1,56,0,salesforcevoice: 3 way make company sale intelligent
1,1,7,31,0,6,0,38,0,scared olympic athlete live turkey
1,1,6,20,1,5,2,26,0,15 mind-blowing way eat apple
1,1,7,27,0,7,2,34,0,22 landlord need fucking stopped
1,2,2,63,2,15,0,65,0,"new year, old debt? cut credit balance get ahead higher rate"
1,3,12,43,5,11,0,55,0,"israeli minister un vote, kerry speech: dont need america"
1,1,13,38,2,9,2,51,0,42 heart-pounding moment non-stop bbc four sleigh ride
1,1,10,36,0,9,0,46,0,white people thought race like people color
1,3,8,40,2,11,0,48,0,trump congress solve rubiks cube tax reform?
1,3,7,36,4,8,0,43,0,"peter thiel: globalization over, feel dated"
1,1,11,37,1,10,0,48,0,"lil bub announcing first album right here, right"
1,1,10,29,0,10,4,39,0,2006 hit single based star sign
1,1,9,34,0,8,0,43,0,selena gomez album listening
1,1,12,41,3,11,0,53,0,"yahoo india named ""cow"" india's top personality year"
1,3,6,41,2,7,0,47,0,"trump nuclear weapon tweet, translated explained"
1,3,6,55,2,11,0,61,0,world's biggest youtube star pewdiepie deletes channel one
1,1,8,27,0,8,2,35,0,21 genius way eat peanut butter jelly
1,1,9,33,2,7,2,42,0,21 secret build-a-bear employee never tell
1,1,6,35,1,5,0,41,0,iman's recent instagram post heartbreaking
1,1,5,16,0,4,0,21,0,lead squad
1,1,11,54,0,10,0,65,0,make instagram caption sound profound elliott smith lyric
1,3,3,69,0,16,4,72,0,chart election since 1979 suggests tory win landslide list
1,3,7,20,0,8,6,27,0,top 20 job getting ahead 2017
1,3,13,42,0,12,0,55,0,drinking water town turned bright pink wasweird
1,1,15,43,0,14,0,58,0,dad shocked found accidentally ran son
1,1,13,52,1,11,0,65,0,kylie jenner wear shiny ass-less pant new interview magazine photo shoot
1,1,12,40,1,12,2,52,0,22 photo make miss hell school friend
1,1,8,23,0,6,0,31,0,tv sister sister
1,1,6,31,0,6,2,37,0,23 food truth mexican would understand
1,1,8,30,0,9,6,38,0,17 indian musician changed damn game 2015
1,1,9,24,0,8,0,33,0,best way netflix chill
1,1,12,36,0,11,0,48,0,dog smiling camera happy need today
1,1,7,34,0,6,0,41,0,cursing coloring book fucking brilliant
1,2,0,37,0,6,1,37,0,9 trick remembering everything read
1,1,15,49,1,14,0,64,0,exercise burn thanksgiving dinner
1,1,8,39,0,8,2,47,0,28 insanely clever halloween costume inner geek
1,1,8,29,1,9,6,37,0,31 brilliant word know needed 2015
1,1,13,55,0,12,0,68,0,kendall jenner hailey baldwin funnest shopping date beverly hill
1,3,6,47,3,10,0,53,0,american gods: wednesday? meet deity starz's drama
1,1,14,54,2,13,0,68,0,here's science say totally possible make bread vaginal yeast
1,3,1,67,5,12,0,68,0,facebook announce fourth-quarter earnings here expect
1,1,14,35,1,11,0,49,0,"famous, katy perry backup singer pod"
1,1,10,41,1,9,0,51,0,watch mariah carey internally scream asked sing
1,1,10,43,2,9,0,53,0,"hogwarts house ""doctor who"" character belong"
1,1,9,41,2,9,2,50,0,"13 reason tatiana maslany deserves emmy ""orphan black"""
1,1,13,46,2,12,0,59,0,"would leave ""bachelor paradise"" based zodiac sign"
1,1,10,29,0,10,2,39,0,18 dog stuck thing fine
1,1,12,44,0,12,2,56,0,22 time cate blanchett proved glamorous woman earth
1,3,2,63,1,12,0,65,0,anxious british parents' baby among greatest crier world
1,1,11,32,0,11,2,43,0,18 tweet anyone fear pooping public
1,3,2,48,1,11,1,50,0,"net sit 6 bulls, make playoff victory"
1,1,7,21,1,7,2,28,0,well remember '00s rom coms
1,2,8,42,0,9,0,50,0,airliner future may sport unusual design
1,2,8,29,0,8,0,37,0,eating make live longer
1,1,9,29,2,8,0,38,0,"turn one know word ""waterfalls"""
1,1,7,36,0,6,0,43,0,justin timberlake lyric match zodiac
1,2,12,44,3,14,0,56,0,maher clintons: never want see either one ever
1,3,3,41,1,9,0,44,0,trudie styler puff piece doesnt quite add
1,2,11,56,1,13,2,67,0,rubio: 16 republican ran president would nominated gorsuch
1,1,12,43,3,11,0,55,0,"here's best look yet harry potter ""fantastic beasts"" movie"
1,1,14,46,5,11,0,60,0,"watch trailer j. cole's ""forest hill drive: homecoming"" hbo special"
1,1,9,37,0,8,0,46,0,david beckham got romeo best birthday present
1,2,17,45,0,16,0,62,0,parent dressed cat bra top show daughter small itwas
1,1,8,26,0,8,2,34,0,29 gorgeous way forget ex
1,1,8,43,0,8,2,51,0,13 unbelievably weird way people actually eat chocolate bar
1,1,10,52,0,10,2,62,0,18 perfect tweet relative annoying thanksgiving
1,1,6,25,1,5,0,31,0,friend who's back traveling
1,1,9,27,1,9,6,36,0,21 new year's resolution tv consider 2016
1,1,9,27,0,9,4,36,0,tumblr 2011 like
1,1,4,17,0,3,0,21,0,meet pumpkin raccoon
1,1,7,23,1,6,0,30,0,what's sexiest book ever read
1,1,4,15,0,2,0,19,0,buzzfeed openlab blog
1,2,4,42,4,11,0,46,0,"drake life: mixtape, album playlist?"
1,1,8,27,0,8,2,35,0,27 thing need know andy grammer
1,1,9,49,1,8,0,58,0,kylie jenner's wheelchair mag cover blasted disability advocate
1,1,12,40,0,11,0,52,0,guess ross geller freaking screenshot
1,2,8,55,2,7,0,63,0,facebook suspends youtuber disliking transgender mother commercial
1,1,15,40,1,14,0,55,0,used ashamed fear. started training acrobat
1,1,12,47,0,12,2,59,0,22 thing inevitably happen live best friend
1,2,3,24,0,2,0,27,0,frightening celebrity statue
1,1,9,41,0,8,0,50,0,people spoon professional cuddlers first time
1,1,5,12,0,4,0,17,0,text ex
1,2,2,60,2,13,0,62,0,car promise fully electric drive itself. enough?
1,1,8,23,3,8,1,31,0,pacey vs. dawson: hotter dec. 9
1,1,6,33,0,6,2,39,0,16 beautifully touching tattoo honor mom
1,2,11,46,1,10,0,57,0,church sign list patriots' super bowl win among best comeback ever
1,1,10,41,0,10,2,51,0,16 cosplayers share kindest thing someone done
1,1,6,23,0,5,0,29,0,case queer superhero film
1,1,7,29,0,7,2,36,0,10 celebrity might know muslim
1,1,9,32,1,9,2,41,0,37 thing cat think leave
1,1,8,35,0,8,2,43,0,15 smart dollar store idea declutter kitchen
1,1,5,22,0,5,2,27,0,11 way knitting actually drug
1,3,1,52,2,13,0,53,0,"cyclist told driver f*ck off, promptly fell bike"
1,2,8,27,1,6,0,35,0,baked chicken tender recipe nyt cooking
1,1,9,34,0,8,0,43,0,hardest pixar character quiz ever take
1,1,10,37,0,10,2,47,0,21 insane thing actually said people color
1,2,1,28,0,5,0,29,0,warning label light bulb
1,1,10,38,2,9,0,48,0,"""friends"" character based birth month"
1,1,7,37,0,7,2,44,0,11 scary movie would actually horrify musician
1,1,12,33,1,12,2,45,0,14 thing look cool teen cool
1,2,11,40,0,11,2,51,0,25 amazingly cool gadget gift may want keep foryourself
1,1,8,46,0,7,0,54,0,hairstylist reinterprets famous painting hair color
1,2,2,63,2,12,1,65,0,new hampshire family plan bucket list 9-year-old terminal brain tumor
1,1,7,25,1,6,0,32,0,taylor swift's grammys
1,1,6,25,0,5,0,31,0,rachel green hairstyle
1,2,12,48,2,11,0,60,0,'real people' car commercial either actor terribly bright
1,1,10,41,0,9,0,51,0,comic show true struggle adulting awkward
1,1,9,37,2,8,0,46,0,"""harry potter"" sweet eat halloween"
1,3,10,38,3,9,0,48,0,la raza wapo: trump immigration order like slave trade
1,1,13,37,0,12,0,50,0,tall girl wore heel week decided kinda cool
1,1,6,24,2,6,2,30,0,"13 text ""star wars"" character"
1,1,6,15,0,5,0,21,0,pick right dog
1,2,4,68,4,16,2,72,0,22-year-old already engineer nasa. done life? list
1,1,8,35,1,7,0,43,0,hardest football stadium quiz take today
1,1,8,27,0,7,0,35,0,actually coffee make shit
1,1,9,33,0,8,0,42,0,verbal nonverbal communicator
1,1,11,27,1,9,2,38,0,12 celebrity #tbt photo need see week
1,1,11,49,1,10,0,60,0,company may created comfortable men's underwear
1,2,11,73,5,13,0,84,0,atlantic vp: democratization news via internet left people overwhelmed information
1,3,2,59,2,12,0,61,0,speech debate review tech-savvy kid battle phoney adult world
1,1,4,21,2,5,4,25,0,"11 alternative ""25"" album art cover"
1,1,11,36,1,10,0,47,0,happens garbage adult
1,1,9,28,0,8,0,37,0,celebrity ex based zodiac
1,1,6,18,0,5,0,24,0,posh food habit
1,1,7,23,0,6,0,30,0,pas basic algebra quiz
1,1,6,32,0,5,0,38,0,beatles scientifically accurate
1,2,12,58,2,12,0,70,0,new york de blasio retreat claim donald trump caused anti-semitic threat
1,3,7,20,2,7,3,27,0,fund best 401(k)
1,1,10,38,0,9,0,48,0,american listen japanese pop music first time
1,3,12,60,4,12,0,72,0,"watch: fox news sunday panel discussion erupts shouting, accusation fake news"
1,1,14,53,2,14,2,67,0,"22 time creed bratton ""the office"" something raised lot question"
1,1,8,31,3,8,1,39,0,"here's play ""fallout 4"" imperator furiosa"
1,1,9,24,0,8,0,33,0,introvert high
1,1,11,46,1,10,0,57,0,"dear guys, please immediately stop using cell phone urinal"
1,1,7,29,0,6,0,36,0,people drink hurricane first time
1,3,2,73,3,13,0,75,0,"taking pill trigger mood swing make woman miserable, 'alarming' research show"
1,1,10,38,1,9,2,48,0,23 totally amazing bodycon look wanna rock fall
1,1,9,54,0,9,2,63,0,19 heartbreakingly honest confession dating transgender person
1,1,10,41,1,10,2,51,0,21 comment prove nicki minaj's instagram fan lost
1,2,3,26,2,6,0,29,0,big show: giant six-pack
1,2,11,32,1,9,0,43,0,shia labeouf james franco crazything?
1,1,12,46,0,11,0,58,0,know age relationship status based chinese zodiac
1,3,3,64,0,13,1,67,0,samsung confirm next week everyone knew galaxy note7 month ago
1,1,13,44,0,12,0,57,0,flirt queer girl without making total fool
1,1,15,59,0,14,0,74,0,stunning video perfectly capture high low breaking dahi handi
1,3,12,53,0,12,0,65,0,left bash lady gaga attacking trump super bowl halftime show
1,1,14,43,2,13,0,57,0,"here's go doctor every year, according doctor"
1,2,6,34,0,6,2,40,0,53 picture introvert truly appreciate
1,1,11,44,1,10,0,55,0,bryan cranston revealed marvel villain he's dying play
1,1,8,19,2,5,0,27,0,real-life meet-cute
1,1,13,44,2,12,0,57,0,"""star wars"" cast recorded cappella version famous theme"
1,2,2,70,0,16,0,72,0,man invented ridiculous way woman deal period list
1,1,13,46,1,11,0,59,0,man made eye-opening video getting interviewed younger self
1,3,3,46,1,6,0,49,0,gulp! water increasingly unaffordable many american
1,2,15,52,1,13,0,67,0,ten trans people got first id colombia new genderrules
1,2,4,20,0,4,0,24,0,fight net neutrality
1,1,9,27,0,9,2,36,0,23 time shah rukh khan cutest dad ever
1,3,2,21,1,6,4,23,0,grammys 2017: need know
1,1,15,60,3,14,0,75,0,"disney released first two teaser tim burton's ""alice looking glass"""
1,1,9,44,0,8,0,53,0,daniel radcliffe keep forgetting played harry potter
1,1,16,56,1,14,0,72,0,guy married third-grade crush tagging class picture facebook
1,1,6,24,2,6,2,30,0,"another round, episode 24: ida bae well"
1,3,2,73,1,13,0,75,0,cytomegalovirus: common infectious disease baby may never heard
1,1,4,12,1,3,0,16,0,"hey ed westwick,"
1,1,6,35,0,5,0,41,0,american try unusual japanese food invention
1,2,8,36,0,8,0,44,0,rock post unique leg workout video instagram
1,3,1,51,1,7,0,52,0,"man make impressively bizarre hotel request, hotel delivers"
1,1,12,46,0,11,0,58,0,bachelor bachelorette true love based zodiac
1,3,6,46,5,10,0,52,0,steve kerr: think lavar ball's remark 'helping' kid
1,1,15,42,0,14,0,57,0,world like last time mets went world series
1,1,10,38,1,9,2,48,0,26 seriously fucked-up thing people done sims
1,1,13,51,2,12,0,64,0,"according ""the tonight show"" sandra bullock work food service"
1,1,7,38,1,6,2,45,0,17 mind-blowing vagina confession everyone see
1,3,3,51,1,10,0,54,0,thing banned trump's inauguration list
1,1,17,66,0,16,0,83,0,father surprised daughter standing without wheelchair walked aisle
1,1,9,35,2,9,2,44,0,26 thing get ever heartbroken
1,1,12,41,0,11,0,53,0,american think justin trudeau guy canoe
1,3,8,33,0,8,2,41,0,10 time male celebrity got real body image
1,1,11,35,3,11,2,46,0,"hardest ""10 thing hate you"" quiz ever take"
1,1,8,26,1,7,0,34,0,hear taste zayn malik's solo material
1,1,12,42,2,11,3,54,0,"31 deep, wise, hilarious thing overheard nh7 weekender pune"
1,2,4,81,1,17,2,85,0,transcript donald trump's victory rally terrify anyone reading age 12 list
1,1,5,21,0,4,0,26,0,glamorous actually
1,3,3,40,1,9,2,43,0,christmas tv: 50 show watch festive season
1,2,2,28,2,3,0,30,0,hillary clinton's gut-wrenching day
1,2,10,53,3,9,0,63,0,hillary clinton staffer considered campaign slogan turn
1,2,10,34,1,11,3,44,0,new sheriff town: first 100 day session doj
1,1,5,31,0,4,0,36,0,american santa try international sweet
1,1,13,45,2,13,2,58,0,"19 awesome gift every ""game thrones"" fan wish list"
1,1,9,33,0,8,0,42,0,cajun pasta dish ultimate comfort food
1,3,15,62,1,14,0,77,0,"akshay kumar share another heartfelt video, pitch way help martyr republic day"
1,1,13,52,0,12,0,65,0,jennifer lawrence confessed made liam hemsworth real life
1,3,2,53,1,7,0,55,0,secret teacher: counselling course revolutionised teaching
1,3,2,61,0,14,0,63,0,rumor new screen next iphone could actually mean
1,1,7,33,0,7,2,40,0,19 hilarious joke book nerd appreciate
1,3,3,62,3,9,0,65,0,destination revealed: cheapest place last-minute half-term holiday
1,1,4,14,1,3,0,18,0,what's mom sharing
1,3,5,49,3,11,3,54,0,"selena gomez reacts huge '13 reason why' reception, tease season 2"
1,1,10,32,0,10,2,42,0,10 thing less white oscar
1,1,11,37,2,11,2,48,0,"29 time ""hocus pocus"" best halloween movie time"
1,1,4,20,0,4,2,24,0,32 hilarious tweet cat
1,1,9,42,0,9,2,51,0,15 photo prove reese witherspoon winning breakfast
1,2,16,52,0,13,1,68,0,2 hdfc bank official booked gurgaon illegally swappiing old note new
1,1,12,40,1,12,2,52,0,29 thing actually need hear trying lose weight
1,1,9,29,2,9,0,38,0,know lesbian hipster
1,1,11,43,3,10,0,54,0,"here's first press shot new ""absolutely fabulous"" movie"
1,3,10,34,1,9,0,44,0,trump early day tell u path forward
1,3,1,50,4,12,3,51,0,perfect body men changed last 150 year
1,2,13,39,0,13,2,52,0,32 picture take back life damnsimple
1,1,7,22,0,7,4,29,0,monday thing happen 2015
1,3,10,26,3,8,6,36,0,"lockheed ceo pledge 1,800 new jobs, lower f-35 cost"
1,1,8,19,1,6,1,27,0,pigskin blanket: nfl week 2 pick
1,1,7,38,0,7,2,45,0,16 picture instantly destroy friendship
1,1,6,21,0,6,2,27,0,23 time tumblr blew damn mind
1,1,7,37,0,6,0,44,0,celebrity naturally blonde brunette
1,1,7,27,2,7,2,34,0,"31 tattoo make scream ""nooooo"""
1,3,10,54,4,11,1,64,0,michael moore share 5-step plan fight 'mindf*ck' trump presidency
1,3,14,67,5,12,0,81,0,michael moore: democrat must declare national emergency fbi discovers truth trump
1,1,8,28,0,7,0,36,0,barry white luther vandross
1,1,6,24,0,5,0,30,0,american react old racial slur
1,1,9,28,0,9,1,37,0,7 thing know travel back time
1,1,7,41,2,7,2,48,0,16 underrated lingerie brand victoria's secret
1,1,7,27,0,7,1,34,0,7 excellent deal get weekend
1,2,10,56,1,10,0,66,0,counter-terror police site several injured french school shooting
1,1,11,40,0,10,0,51,0,know relationship status based taste shoe
1,2,2,42,3,7,5,44,0,"faulty appliance cause 12,000 fires, which? research find"
1,1,13,49,0,12,0,62,0,student body president sent home school wearing outfit
1,3,1,59,0,13,0,60,0,guy get nailed throat pigeon riding roller coaster
1,1,8,30,0,7,0,38,0,naughty disney fantasy belong
1,2,3,34,0,7,0,37,0,china may cost clinton election
1,3,13,42,5,13,2,55,0,"23 friend joke make say ugh, really love internet"
1,1,8,39,0,8,2,47,0,18 people probably regret becoming stock photo model
1,1,10,42,0,10,2,52,0,18 apple honey recipe impress jewish grandma
1,1,16,58,2,15,0,74,0,"time india called alan rickman villain ""harry potter"" series obituary"
1,2,4,66,4,15,0,70,0,diana quick: 'for first time life non-sexual relationship men'
1,1,5,17,3,4,0,22,0,"i've ""learned"" porn"
1,1,6,38,3,5,0,44,0,"every ""the office"" relationship, definitively ranked"
1,3,7,28,3,6,0,35,0,mccain: rand working vladimir putin
1,2,11,27,0,10,0,38,0,meat key ingredient lot food
1,1,12,53,2,11,0,65,0,"know favorite christmas song based favorite ""frozen"" character"
1,1,8,23,0,7,0,31,0,puppy give pep talk
1,1,14,42,1,12,0,56,0,rock wore crushed-velvet suit nothing ever
1,1,9,33,0,7,0,42,0,matthew mcconaughey reached peak hot dad mode
1,1,13,48,1,12,2,61,0,10-second clip make embarrassing moment seem like gift
1,3,5,33,0,6,0,38,0,fruit vegetable dirtiest
1,1,10,32,1,11,6,42,0,18 outfit alia bhatt wore 2015 want steal
1,3,2,37,2,7,0,39,0,ten thousand marched science. what?
1,1,11,43,1,10,0,54,0,rode hoverboards around new york city here's happened
1,1,15,57,0,14,0,72,0,girlfriend lived morning life boyfriend learned many thing
1,1,8,30,1,8,2,38,0,what's horoscope week december 14
1,1,12,34,3,11,0,46,0,"rey finn ""star wars: force awakens"""
1,1,14,46,0,14,1,60,0,9 house look normal outside anything inside
1,1,5,23,0,5,2,28,0,27 emotion every actor know
1,1,12,38,2,11,0,50,0,"remember lyric ""last friday night"" katy perry"
1,1,14,51,1,12,0,65,0,ellen degeneres north west brushing little pony's hair adorable
1,1,13,45,0,11,0,58,0,dad accidentally held gopro wrong way whole vacation
1,1,7,24,1,5,0,31,0,pop artist/producer duo
1,1,12,41,3,11,0,53,0,"mad men mash perfectly ""parks rec"" hilarious"
1,3,8,36,2,8,0,44,0,quantiacs -- quant hedge fund built freelancer
1,1,13,42,3,12,0,55,0,"new ""little mermaid"" going blonde people happy"
1,1,11,40,1,11,2,51,0,23 tweet sum san francisco's thought blue angel
1,2,7,29,3,6,0,36,0,remember character zootopia?
1,1,5,25,1,4,0,30,0,everybody hate mark match.com
1,1,10,33,0,9,0,43,0,keep panic attack ruining life
1,2,1,52,1,11,0,53,0,"talk first date, according research"
1,1,11,47,1,10,0,58,0,survivors' memory rana plaza building collapse
1,1,9,42,0,9,2,51,0,22 picture people good student never understand
1,1,7,22,0,8,6,29,0,17 time social medium saved day 2015
1,1,9,28,0,8,0,37,0,different type mom meet
1,1,9,36,1,8,2,45,0,13 meet-cute story actually happened real life
1,1,12,40,1,10,0,52,0,two-question quiz tell scary movie watch
1,2,8,34,3,7,0,42,0,"watch joey badass freestyle future's ""mask off"""
1,2,11,46,2,9,0,57,0,watch jet-powered exosuit turn inventor real-life iron man
1,1,12,41,0,11,0,53,0,supreme tight maybe hoodies hentai
1,1,10,42,2,10,2,52,0,"18 line ""the princess bride"" definitely still quote"
1,3,6,26,2,6,4,32,0,longest-leading billboard hot 100 no. 1
1,3,8,55,2,14,0,63,0,"much protein really need? less think, dietitian explains"
1,1,7,24,0,7,2,31,0,27 awesome easy lunch bring work
1,1,10,33,0,10,3,43,0,see 100 year japanese beauty one minute
1,1,10,35,0,10,2,45,0,19 struggle taking kid bathroom public
1,1,8,29,1,7,4,37,0,21 alarmingly wtf celebrity outfit '90s
1,1,9,38,0,9,2,47,0,23 terrifying thing justin bieber fan done
1,1,8,31,1,8,2,39,0,15 thing really say trans people
1,3,5,13,1,4,0,18,0,could abarista?
1,1,9,40,0,8,0,49,0,people try bizarre food combination oddly work
1,1,8,37,0,8,2,45,0,15 deliciously awesome item anyone love taco
1,2,4,49,4,9,0,53,0,sun deny russell westbrook triple-double mark: 'not versus us'
1,1,10,40,0,10,2,50,0,23 satisfying thing happen driving
1,1,13,36,6,10,2,49,0,"19 -of-this-world ""star wars"" craft keep die-hard fan busy"
1,2,14,46,1,13,0,60,0,here's banana coming rescue tribal economy india
1,1,5,22,0,6,6,27,0,27 important snapchats 2015
1,1,11,42,0,11,2,53,0,24 perfectly normal thing horror movie ruined u
1,2,4,20,1,5,2,24,0,climate 25 weather channel
1,1,7,32,0,6,0,39,0,tell u embarrassing onstage moment
1,1,6,31,0,5,0,37,0,disney movie blaxploitation film
1,1,8,31,0,7,0,39,0,noise brit make awkward situation
1,1,11,33,2,11,2,44,0,"27 joke ""the big bang theory"" never get old"
1,2,13,59,6,14,0,72,0,"hillary clinton's hard choice: first instagram post first draft. political news, now."
1,2,12,50,3,11,0,62,0,"mayor sadiq khan say london safest global city, slam donald trump junior"
1,2,1,35,0,4,0,36,0,initial jobless claim unexpectedly fall
1,1,8,39,0,8,2,47,0,14 halloween movie actually take place halloween
1,2,6,44,4,10,0,50,0,'gilligan's island' star dawn well talk mary ann's sex appeal
1,1,9,39,1,8,0,48,0,drop everything: psy released two insane new music video
1,1,10,35,1,9,0,45,0,tell u funniest thing done high
1,2,19,64,0,16,0,83,0,indian basketball star satnam singh look move prowrestling seen training wwe
1,1,8,40,0,7,0,48,0,hijab barbie instagram account beyond inspiring
1,3,3,61,1,12,0,64,0,map graphic revealed: country quaff wine per caput
1,1,5,20,0,4,0,25,0,percent teenager
1,2,3,31,1,8,2,34,0,bill gates: pathogen could kill 30m year
1,1,6,18,0,5,0,24,0,taylor swift becky
1,1,9,45,0,9,1,54,0,7 perfectly appropriate response someone asking smile
1,1,7,37,1,8,4,44,0,24 picture people 5'8 simply never understand
1,1,13,31,2,9,0,44,0,"make post without saying ""nope"""
1,1,8,39,1,8,2,47,0,actress insanely beautiful $31 million wedding
1,1,9,21,0,9,6,30,0,36 time tv blessed u man candy 2015
1,1,7,17,1,6,0,24,0,"hey guys, ted mosby india"
1,1,9,37,0,9,2,46,0,15 delicious way make favorite candy even better
1,2,3,85,4,18,0,88,0,he going home christmas. people prestigious college idea he facing there.
1,1,8,27,2,7,0,35,0,"well remember ""coming america"""
1,2,4,30,1,6,0,34,0,donald trump christmas?
1,1,10,26,0,10,2,36,0,13 gift hated kid totally want
1,3,9,31,5,6,0,40,0,"first read: trump's early good-cop, bad-cop routine"
1,1,8,21,0,7,0,29,0,really match shirt tie
1,1,13,41,0,11,2,54,0,17 reason older leo dicaprio better young leo dicaprio
1,1,13,59,0,12,0,72,0,watch heartbreaking moment raccoon accidentally drop candy puddle
1,1,7,34,0,7,2,41,0,15 winter breakfast guaranteed sooth soul
1,1,10,39,1,9,0,49,0,here's world champion runner actually eats train
1,1,11,36,0,10,0,47,0,behind one shocking movie ending year
1,3,3,32,0,7,0,35,0,shopping river island
1,2,16,52,1,15,0,68,0,"nflpa us muslim ban hash tag, address question muslim ban real thing"
1,1,10,29,0,9,0,39,0,oreo rice either best worst thing ever
1,1,9,29,0,10,6,38,0,25 music video watched 2015
1,3,3,35,2,8,4,38,0,mother day 2017: best fashion beauty gift
1,1,13,45,0,12,0,58,0,original wiggle might reunite winter drill
1,2,7,39,5,8,0,46,0,analysis: trump's dodd-frank rollback 'little guy'
1,1,9,35,1,8,0,44,0,"people fought best breakfast, side"
1,2,14,44,1,13,5,58,0,"rumoured nokia d1c android phone priced r 9999, spec revealed"
1,2,2,58,2,11,0,60,0,cheap train tickets: here's beat illogical pricing system
1,1,14,51,2,15,4,65,0,"20 thing always wanted know 12th doctor, told peter capaldi"
1,3,1,34,0,8,3,35,0,possible new dino family tree 130 year later
1,2,8,33,1,8,2,41,0,15 mistake making trying lose weight
1,1,8,34,0,7,0,42,0,garrett hedlund become even perfect
1,1,5,16,0,4,0,21,0,people really see
1,3,11,38,0,11,0,49,0,north korea got people back kim jong nam standoff
1,1,6,15,0,7,6,21,0,13 lyric made u cry 2015
1,1,8,28,0,8,4,36,0,biggest winner loser movie 2015
1,1,13,43,0,13,2,56,0,18 photo bring back memory people grew miami
1,1,15,45,0,14,0,60,0,member order phoenix based zodiac sign
1,1,10,41,0,10,2,51,0,58 thing mildly annoy anyone life someone messy
1,1,8,44,2,6,0,52,0,"youtuber tyler oakley's big, incredibly profitable adventure"
1,1,11,43,2,11,2,54,0,"24 essential life lesson ""the perk wallflower"" taught u"
1,1,13,34,2,12,0,47,0,"let twitter run life day, here's happened"
1,1,13,49,1,13,1,62,0,drake shared sweet instagram post thanking rihanna no. 1 song
1,1,8,22,1,7,0,30,0,poll: think rey actually
1,1,12,42,1,12,2,54,0,$99 flight everyone freaking come major catch
1,3,1,39,0,7,0,40,0,sleep doctor call later school start time
1,1,8,48,0,7,0,56,0,charity transforming hospitalized kid superheroes
1,3,8,33,2,6,0,41,0,u.s. supreme court take racial gerrymandering
1,3,11,64,1,10,0,75,0,kim kardashian's horrifying police statement following paris robbery released
1,3,6,20,0,7,6,26,0,34 wholesome tweet of2016
1,1,7,30,0,7,2,37,0,11 amazing chicken wing around world
1,1,7,34,0,6,0,41,0,people tell u weirdest groupon purchase
1,1,9,32,0,9,2,41,0,13 thing minnesotan born knowing
1,3,11,56,7,12,0,67,0,"pat buchanan: bitter obama despair, leaving let wreck place attitude"
1,2,10,55,2,12,2,65,0,70 percent japan approve shinzo abes trump visit; communist party outraged
1,1,12,44,0,11,0,56,0,many defunct english football ground
1,1,10,37,0,10,2,47,0,16 luscious italian word phrase need life
1,1,11,42,0,11,2,53,0,17 hilarious tweet flying make laugh loud
1,3,1,77,1,16,0,78,0,record number poor kid eating breakfast thanks program many conservative hate
1,1,10,44,0,9,0,54,0,identify christmas movie netflix description
1,3,9,56,1,10,1,65,0,"gay schoolteacher, partner accused sexually abusing 8 boy kill"
1,1,12,61,1,12,2,73,0,here's happened american given 10 minute describe everything british
1,1,10,27,0,10,2,37,0,24 cat idea world
1,2,13,49,0,12,0,62,0,entrepreneur started travel company help quit job
1,3,13,61,7,12,0,74,0,"asked caste certificate, auto driver writes 'love', get called 'illegal' authorities!"
1,2,9,47,2,11,0,56,0,complete list broker approach fiduciary rule
1,3,7,43,0,7,0,50,0,grayson allen receives technical tripping elon player
1,1,9,31,1,8,2,40,0,19 lol-worthy tumblr post dating
1,1,12,46,0,11,0,58,0,little girl confidently give woman advice text crush
1,1,9,31,0,9,2,40,0,21 undeniable reason fall best time year
1,1,7,27,0,6,0,34,0,weasley best friend
1,1,10,36,2,9,0,46,0,"one thing never noticed ""parks recreation"""
1,2,3,18,1,3,3,21,0,america 100 richest place
1,1,6,25,0,7,6,31,0,18 cringeworthy lyric 2015
1,3,1,65,0,14,0,66,0,meal parent made calorific modern lifestyle
1,1,9,28,0,8,0,37,0,truly ugliest moment life
1,3,10,46,1,9,2,56,0,24 horrifying fascinating true-crime podcasts must listento
1,1,9,42,1,8,0,51,0,here's top professional model look like without makeup
1,1,6,20,0,6,1,26,0,7 lesbian meet tinder
1,2,10,40,3,9,0,50,0,watch kacey musgraves biscuit video life begravy
1,1,12,48,0,11,0,60,0,identify janet jackson music video single screengrab
1,1,8,25,0,8,2,33,0,39 song need life january
1,1,5,27,0,5,2,32,0,25 funniest thing ever snapchatted
1,1,11,42,0,11,2,53,0,38 time james blunt trolliest troll twitter troll
1,1,8,24,0,7,0,32,0,many james bond film seen
1,1,4,17,0,5,6,21,0,21 greatest raccoon 2015
1,1,17,31,2,14,2,48,0,"39 thought every time watch ""love list it"" hgtv"
1,1,13,47,0,13,1,60,0,9 slightly gross reason might want leave pubes fuck alone
1,1,8,17,0,7,0,25,0,way ask tampon
1,1,14,44,1,13,0,58,0,hung jeremy bentham's severed head learned
1,1,8,40,1,6,0,48,0,oscar-nominated movie poster white actor removed
1,3,1,34,5,10,6,35,0,"120,000: that's much good night's sleep worth"
1,1,10,37,0,9,0,47,0,well remember pixar character look like
1,1,8,24,0,8,2,32,0,15 boozy cake pop dessert game
1,1,11,21,1,7,2,32,0,terrifying fact: nsync 20 year old
1,3,7,31,0,7,1,38,0,4 habit every millennial bring work
1,3,10,38,0,9,0,48,0,new treatment could make cell look young
1,1,6,20,0,5,0,26,0,stark lannister
1,1,15,48,3,15,1,63,0,"first look ""lip sync battle"" season 2 prof going get even better"
1,1,16,46,1,15,0,62,0,kevin hart tried go run canada handle icy street
1,2,9,41,5,9,2,50,0,"18 wikipedia page thatll make say ""fuck, thats interesting"""
1,3,3,51,2,11,0,54,0,welcome jazzy 'bad boujee' remix internet needed
1,1,10,36,0,10,2,46,0,15 really funny tumblr post dog person
1,1,12,36,0,12,2,48,0,21 thing make sense colicky baby
1,1,7,28,0,7,2,35,0,13 apps might make dating less horrible
1,3,18,35,3,9,0,53,0,full text: merry milo christmas minnesota state university
1,1,8,28,0,7,0,36,0,olivia benson olivia benson
1,3,7,39,3,9,0,46,0,secret law making european union all-time high
1,3,3,74,5,20,4,77,0,"meet first woman run boston marathon (illegally) 50 year ago 70,"
1,1,8,29,0,8,2,37,0,18 time google translate failed hard
1,1,12,46,1,11,0,58,0,rescued piglet kitten best friend totally adorable
1,1,7,27,0,7,2,34,0,23 time ed sheeran really fucking nice
1,1,11,38,2,11,2,49,0,"18 ""star wars"" cast photo awaken force within"
1,1,9,28,0,9,2,37,0,21 puppy naughty list year
1,2,13,69,1,14,0,82,0,"one facebook post, three misleading statement president trump immigration order"
1,1,8,29,1,8,2,37,0,what's horoscope week october 12
1,1,8,34,2,8,2,42,0,"another round, episode 25: stop telling woman smile"
1,1,6,24,0,6,2,30,0,classic nintendo 64 game
1,1,7,37,0,7,2,44,0,26 photo every perfectionist find pleasing
1,1,8,34,0,8,2,42,0,26 misconception bi people want set straight
1,3,2,35,1,6,0,37,0,australia handling charity wrong way?
1,1,13,60,3,11,0,73,0,let's take minute appreciate lin-manuel miranda's surprise wedding performance
1,1,11,50,3,10,0,61,0,"""star wars: force awakens"" poster hold tantalizing question"
1,1,9,31,2,8,0,40,0,"remember first episode ""full house"""
1,2,6,52,3,10,0,58,0,"top nato general echo trump, calling aspect alliance obsolete"
1,1,10,46,0,9,0,56,0,favorite musical symbol say personality
1,1,9,23,2,8,0,32,0,"lying say ""love"" kale"
1,2,14,45,2,13,0,59,0,"marketers, creative ad exec adjust video ad sound cmo today"
1,3,1,34,2,6,2,35,0,$1.1 million wager placed underdog falcon
1,1,7,36,0,6,0,43,0,depressing christmas ad enraging everyone
1,3,2,55,4,11,0,57,0,'we're going silent': scientist marching weekend
1,1,13,39,5,11,0,52,0,"first trailer ""x-men: apocalypse"" damn good"
1,1,9,37,0,9,2,46,0,17 beauty skincare product steal bae
1,1,15,36,0,10,0,51,0,rebel wilson unashamedly hit idris elba baftas
1,1,16,31,1,11,0,47,0,kate winslet time life year's baftas
1,3,13,47,1,14,0,60,0,ronda rousey broken ready roar back? past may offer clue
1,1,8,31,1,8,2,39,0,21 people give fuck christmas
1,3,6,24,1,5,0,30,0,celebrity spent new year eve
1,1,11,30,1,11,6,41,0,"25 hottest tv sex scene 2015, ranked worst best"
1,3,2,37,1,8,0,39,0,beat brexit effect holiday?
1,1,7,37,0,6,0,44,0,ballerina bride photoshoot simply stunning
1,2,11,43,0,12,0,54,0,best city getting great job year may surprise
1,1,7,24,0,7,2,31,0,19 gift naughtiest mom know
1,1,9,40,1,8,0,49,0,like explaining depression asian parent
1,1,8,44,1,7,2,52,0,51 clothing organization tip downright life-changing
1,3,3,39,0,10,0,42,0,secret code word queen dy
1,2,9,50,1,9,0,59,0,here's really happens professional athlete retire
1,3,1,49,0,11,0,50,0,raising interest rate week may bad idea
1,3,9,39,1,8,0,48,0,student think betsy devos appointment?
1,1,7,24,0,7,4,31,0,best tumblr post dating 2015
1,3,4,11,1,6,6,15,0,2016 17 word cnn video
1,1,14,43,0,13,0,57,0,dog saved owner posted wanted shot facebook
1,2,12,49,8,9,0,61,0,"nyts alcindor: democrat sound somewhat confused, dont clear leader"
1,3,5,18,2,4,0,23,0,what's dream home style?
1,3,9,48,4,8,0,57,0,zsa zsa gabor: prototype famous-for-being-famous celebrity
1,1,7,30,0,7,2,37,0,18 truth everyone without squad know
1,1,11,37,0,10,0,48,0,favorite thing fall say
1,3,10,47,1,11,8,57,0,"finland launch experiment give 2,000 people free money 2019"
1,1,8,28,1,7,0,36,0,"tiny, kind act perform today"
1,3,11,56,3,10,0,67,0,political risk analysis: investor know guyana's oil industry?
1,1,7,25,0,7,1,32,0,9 reason rey totally skywalker
1,1,11,49,1,10,0,60,0,french artist covering india's wall amazing graffiti
1,1,8,32,0,8,2,40,0,22 shopper made hard important decision
1,1,8,28,0,7,0,36,0,everything need know riz ahmed
1,1,16,45,5,15,0,61,0,"so, uh... there's gonna bollywood movie guy whose dick turn gold"
1,2,11,45,2,10,0,56,0,sears admits 'substantial doubt' ability survive
1,1,8,40,2,7,0,48,0,"""fantastic beasts"" teaser trailer finally arrived"
1,3,15,55,2,15,2,70,0,"son auto driver, pacer mohammed siraj land r 2.6 cr deal sunrisers hyderabad"
1,1,12,51,1,11,0,63,0,serious question: many pair basketball short adam sandler
1,2,3,37,2,8,0,40,0,'santa' robs u bank handing candy cane
1,1,9,22,0,9,2,31,0,22 time elf shelf went way far
1,1,11,34,2,8,0,45,0,"hogwarts house ""pll"" character belong"
1,1,9,30,0,8,0,39,0,seriously guess old maggie smith
1,1,13,44,0,12,0,57,0,tell whether sex morning one simple question
1,1,12,50,1,11,0,62,0,string quartet performed traffic jam calmed everyone's rage
1,3,5,62,1,14,0,67,0,big sport performance: thank wife girlfriend
1,2,13,43,1,12,0,56,0,ever wondered people tiny extra hole ear?
1,1,6,23,3,5,0,29,0,tell u yourself(ie): erica ash
1,1,12,37,0,8,0,49,0,make holiday simple buzzfeed diy newsletter
1,3,8,36,1,7,0,44,0,facebook's fake news solution three big problem
1,1,10,23,1,9,0,33,0,take #girlboss
1,1,11,47,1,10,0,58,0,"people glittering armpits, even though glitter worst"
1,1,12,43,2,11,0,55,0,"know ""pitch perfect"" character based zodiac"
1,1,11,39,1,11,4,50,0,31 thing anyone owned playstation '90s remember
1,1,8,32,2,7,0,40,0,"actually worst ""gilmore girls"" suitor"
1,1,10,41,0,10,2,51,0,21 celebrity kid killing u cuteness instagram
1,1,11,51,1,11,2,62,0,bunch '90s supermodel totally destroyed new fashion campaign
1,2,1,33,2,7,4,34,0,"cook favourite books, kit gadget 2016"
1,1,9,39,0,9,2,48,0,21 totally delicious thing leftover turkey
1,1,11,39,2,9,0,50,0,julia louis-dreyfus' best emmy look year
1,1,10,34,2,9,0,44,0,"anyone watched ""master none"" denise"
1,2,4,23,0,4,2,27,0,23 infamous mugshot fromhistory
1,3,1,57,0,14,0,58,0,adorable little girl u trying remember old
1,2,3,56,3,10,0,59,0,chemical weapon used syria? here investigator know.
1,3,7,35,0,8,0,42,0,get free pancake national pancake day
1,1,4,16,0,4,2,20,0,17 great looking dog
1,3,9,45,3,8,0,54,0,"vanness: linda sarsour, womens march organizer fake feminist"
1,1,9,29,0,8,0,38,0,period human history belong
1,2,14,56,7,11,0,70,0,"former obama speechwriter rip cnn stupid, bullst factory pro-trump pundit"
1,1,12,50,1,8,0,62,0,indian protesting child marriage hashtag #strengthtosayno
1,3,6,58,5,15,0,64,0,lin-manuel miranda hosting oscars: 'it's thing would ever want do'
1,1,9,32,2,8,0,41,0,"still remember robot ""robot wars"""
1,1,8,25,0,8,2,33,0,18 fact make indian feel old
1,3,9,30,0,9,2,39,0,50 thing one tell becoming aparent
1,1,8,33,0,8,2,41,0,24 totally wild fast food item need immediately
1,1,7,36,2,6,0,43,0,"secondary ""vampire diaries"" character"
1,1,14,67,2,15,0,81,0,"friendly reminder ""last christmas"" jimmy eat world best christmas song existence"
1,1,8,30,1,8,2,38,0,17 thing kanye west could've named new album
1,2,1,17,1,4,0,18,0,quiz week's news
1,1,13,54,1,13,2,67,0,11 reason probably let santa break home christmas
1,1,7,19,0,6,0,26,0,six girl date tinder
1,2,10,33,0,9,0,43,0,netflix cheating actual thing love isdead
1,1,12,52,0,11,0,64,0,get post without becoming sexually attracted cheese
1,3,10,54,4,9,0,64,0,seattle pronto bike-share program crash despite million tax dollar
1,3,9,33,4,8,0,42,0,"hot mugshot guy super-rich, living mansion"
1,1,14,48,0,13,0,62,0,bunch millennials lay coffin talked ideal funeral
1,1,13,42,1,12,0,55,0,jennifer lawrence hate new year's eve reason
1,3,6,57,1,11,4,63,0,golden globe 2017: emma stone tolerates ryan seacrest question dress
1,1,12,33,3,11,0,45,0,"here's much fun ""harry potter"" studio tour"
1,2,11,39,1,10,2,50,0,21 thought-provoking book stay mind fordays
1,1,12,37,2,9,0,49,0,many classic coming-of-age movie seen
1,1,8,34,2,8,2,42,0,"identify minor character ""30 rock"""
1,1,9,32,0,8,0,41,0,taylor swift chopped hair grammys
1,1,13,49,1,13,2,62,0,19 thing anyone who's best friend mum adult understand
1,1,10,35,0,10,2,45,0,18 gift definitely make cat love
1,2,7,63,2,12,0,70,0,cringe-worthy quote ceo travis kalanick uber's sexist work culture
1,3,10,42,0,10,0,52,0,four sign investor may warming turkish stock
1,1,10,24,2,10,2,34,0,"17 image make say ""i idea"""
1,1,11,38,2,11,2,49,0,"27 iconic ""american horror story"" quote time"
1,1,10,40,3,9,0,50,0,"what's favorite ""american horror story"" quote time"
1,1,7,29,1,7,2,36,0,many '00s british singer remember
1,3,1,48,2,12,0,49,0,lab notes: throw hand air like care
1,1,14,54,2,13,0,68,0,woman perfectly explains ask people kid
1,1,6,26,0,6,1,32,0,9 scariest cable horror story
1,3,2,41,0,8,0,43,0,christmas card definitely seems
1,1,6,16,0,5,0,22,0,little bit bitchy
1,1,12,40,0,11,1,52,0,3 refugee living uk cook favourite meal home
1,1,13,40,0,13,4,53,0,top trending recipe googled 2015 way eat
1,1,11,43,0,11,2,54,0,24 picture make runner laugh put sneaker
1,1,11,42,1,11,2,53,0,24 thing cool middle school definitely
1,1,12,44,0,11,0,56,0,chrissy teigen love pie much started cry eating
1,1,6,19,0,5,0,25,0,sign grew louisiana
1,1,8,29,0,8,1,37,0,5 way turn junk food classy cocktail
1,1,7,32,3,6,0,39,0,"zayn malik's ""zitties"" driving people insane"
1,1,10,39,1,10,2,49,0,17 brilliant thing keep ever share
1,1,11,42,0,10,0,53,0,identify ariana grande music video screencap
1,1,6,29,0,6,2,35,0,21 puppy absolutely cannot trusted
1,1,5,19,1,4,0,24,0,what's best drinking game
1,1,11,50,1,11,2,61,0,10 amazing candid wedding moment believe captured camera
1,1,9,25,3,7,0,34,0,"winner ""rupaul's drag race"""
1,1,8,25,0,8,4,33,0,could coolest baby name 2016
1,3,12,46,1,10,0,58,0,here's russia recruited elite hacker cyberwar u
1,1,9,32,2,8,0,41,0,"name ""great british bake off"" winner"
1,1,7,37,1,7,2,44,0,"11 question latino get around holidays, answered"
1,1,6,37,2,6,2,43,0,"22 time internet perfectly understood ""degrassi"""
1,2,6,71,1,14,2,77,0,stargazing guide: look see 10 thing april featured story additional story
1,2,3,39,0,9,2,42,0,stolen baby found alive south carolina 18 year
1,1,7,39,1,7,2,46,0,22 mouthwatering food believe contain alcohol
1,1,10,19,0,8,0,29,0,ready move
1,1,3,14,0,3,2,17,0,27 actually good idea
1,3,2,76,2,15,0,78,0,"stripper answer question really want know, pretty surprising list"
1,3,3,63,1,15,0,66,0,make injury forcing tiger wood cancel press conference?
1,2,1,47,1,8,0,48,0,language child learning getahead?
1,2,2,23,1,4,2,25,0,van morrison: 30 essential song
1,1,7,17,0,6,0,24,0,well know earth
1,3,5,38,5,9,0,43,0,u.s. australia keep safer. here how.
1,1,7,26,0,7,4,33,0,2005 hit song match zodiac sign
1,1,11,37,1,11,2,48,0,24 picture prove nothing cat sit
1,1,7,19,0,6,0,26,0,millennial gen x
1,1,13,52,0,12,0,65,0,band surprised dancer auditioning music video best way
1,1,8,19,0,7,0,27,0,much night person
1,2,2,80,2,13,0,82,0,baby remains found 'underground chambers' beneath former home unmarried mother ireland
1,1,11,36,0,10,0,47,0,people taking demise twitter fave well
1,1,4,15,0,4,2,19,0,25 deepest desire
1,1,9,38,0,8,0,47,0,couple successfully cloned dog died
1,1,7,25,0,7,2,32,0,12 time dwight schrute much
1,2,8,22,0,6,0,30,0,megyn kelly leaving fox news nbc
1,2,2,60,0,14,0,62,0,bos made think going mad suffering maternity paranoia
1,1,11,38,0,10,0,49,0,guess premier league club sock
1,1,5,18,0,4,0,23,0,holiday drink
1,1,15,57,1,13,0,72,0,group people nepal expressing plight using hashtag #madhesspeaks
1,1,5,17,0,4,0,22,0,stripper song
1,2,5,44,0,10,0,49,0,manchester sea win best picture oscar
1,1,6,23,0,6,2,29,0,33 shirt need immediately
1,3,4,44,2,7,0,48,0,john key resignation 'changes new zealand political game'
1,2,14,43,0,13,0,57,0,people relate hard raccoon got stuck trashtruck
1,1,6,24,0,6,2,30,0,17 thing basically workout
1,1,10,36,2,10,2,46,0,"27 moment ""the simpsons"" always make ugly cry"
1,3,9,42,3,7,0,51,0,mexican presidential candidate hold anti-trump rally l.a.
1,1,8,25,2,7,0,33,0,"doctor ""doctor who"" best"
1,1,4,19,0,4,2,23,0,literally 23 great joke
1,2,12,58,1,13,0,70,0,charity shop find mystery widower pinned heartfelt note wedding gown yahoo
1,2,7,34,1,7,0,41,0,"japan battle deflation, bitter legacy loom"
1,1,7,20,0,8,6,27,0,27 time men needed stopped 2015
1,2,0,37,0,8,2,37,0,13 useless thing stop wasting money
1,1,12,39,0,11,2,51,0,12 reason make want follow buzzfeed steller
1,1,14,45,1,14,1,59,0,7 thing wish someone told love bipolar
1,1,10,45,0,10,2,55,0,24 thing make slightly obsessed netherlands
1,3,8,48,0,9,0,56,0,mick mulvaney order federal agency prepare massive cut
1,1,7,24,0,7,1,31,0,9 boner hack never knew needed
1,1,7,19,0,7,4,26,0,new thing try 2016
1,1,16,52,0,15,0,68,0,justin bieber speaks nude photo leak reveals fan name penis
1,1,12,38,0,10,0,50,0,guess rihanna music video youtube comment
1,2,4,40,1,8,0,44,0,westgate park: australian lake turned pink
1,1,10,39,0,9,0,49,0,know relationship status based zodiac sign
1,3,6,67,1,15,0,73,0,"magic bird get reacquainted lakers look pacer star paul george, source say"
1,1,8,34,0,7,0,42,0,color test determine sexual fetish
1,1,10,36,1,10,2,46,0,17 people believe somehow older ted cruz
1,3,6,24,0,9,0,30,0,snap said worked drone
1,1,9,40,2,9,2,49,0,"11 breathtaking ""grand designs"" home actually stay"
1,1,18,62,0,17,0,80,0,tape contouring either new favorite thing total waste office supply
1,2,3,65,1,12,2,68,0,international day happiness: 45 joyous thing make instantly happy
1,1,10,45,0,9,0,55,0,disney show preschooler teaching kid consent
1,1,11,42,1,10,0,53,0,everyone absolutely floored ciara's look right
1,1,9,36,0,9,2,45,0,18 thing people love workout class know
1,1,7,26,2,6,0,33,0,"""the maze runner"" character"
1,1,6,18,0,5,0,24,0,veggie burger
1,1,9,38,1,9,2,47,0,16 adorable item bring inner leslie knope
1,1,14,39,2,12,0,53,0,"watch happens teen react ""back future part ii"""
1,2,5,7,1,2,0,12,0,watch live: rnc
1,3,8,43,1,8,0,51,0,here executive saying shareholder job
1,1,9,33,0,8,0,42,0,created depression anxiety
1,3,4,64,2,15,0,68,0,theresa may asked superpower wished had. end well list
1,1,7,33,0,7,2,40,0,26 painful truth running winter
1,1,12,45,0,11,0,57,0,know obscure cereal mascot based three question
1,1,7,23,0,6,0,30,0,people give blood first time
1,3,15,53,2,16,1,68,0,"india test formidable missile, agni v 5 news story need read today"
1,1,9,42,0,9,2,51,0,19 cuddly toy totally understand hangover right
1,1,18,62,2,16,0,80,0,"photographer no-show wedding, bride received surprise lifetime"
1,2,15,41,2,13,0,56,0,meek mill take back nicki minaj's huge af ring broke up?
1,1,8,40,1,8,2,48,0,23 thing learn following kylie jenner's instagram
1,1,10,38,0,9,0,48,0,bet never thought could eat cauliflower like
1,1,6,25,0,6,2,31,0,19 people reached peak fuckboy
1,3,1,79,1,12,0,80,0,cellphone carrier make life harder grandfathered unlimited-data user
1,1,8,35,1,8,2,43,0,19 tweet tinder actually make laugh
1,2,11,44,0,11,2,55,0,18 tumblr post need faith humanityrestored
1,1,13,42,0,10,0,55,0,adorable animal eating adorable animal bff
1,1,9,34,0,9,2,43,0,23 stocking filler beauty addict life
1,3,15,50,0,14,0,65,0,quick hack protect hair skin holi season
1,1,9,25,2,9,4,34,0,"""back future"" actually set 2015"
1,1,6,29,1,5,1,35,0,8 best thing chinese-american
1,1,10,47,2,10,2,57,0,"26 important lesson next generation learn ""harry potter"""
1,2,16,48,2,15,0,64,0,muffler man returns! cannot wait see take season!
1,2,13,56,2,12,0,69,0,reliance jio promise tariff pack 'exciting new offers' customer soon
1,1,9,36,1,8,0,45,0,guess someone's hogwarts house one selfie
1,1,8,29,0,7,0,37,0,tell u story sexism college
1,2,3,40,1,7,0,43,0,draymond green: ref applying double standard
1,2,1,48,1,11,0,49,0,hour day social medium affect kids' happiness
1,2,4,13,1,3,0,17,0,donald mcgahn?
1,1,13,43,2,12,0,56,0,"try keep chill, colin farrell's hair turning daddy gray"
1,1,6,24,2,5,0,30,0,"""percy jackson"" demigod"
1,3,3,52,2,12,0,55,0,"using emoji right, accidentally sext someone?"
1,2,18,66,1,15,0,84,0,srk's solution avoid incident like bangalore molestation something need think
1,1,9,37,0,9,2,46,0,17 surprisingly good place find cute clothes work
1,1,9,32,1,9,2,41,0,15 time donald trump anyone who's ever thrown
1,2,3,34,2,7,0,37,0,jabrill peppers: i'm pretty damn good safety
1,3,10,42,2,10,2,52,0,"23 time corinne best worst ""bachelor"" contestantever"
1,1,9,33,0,9,2,42,0,19 christmas shibas ready holiday
1,3,7,37,0,7,0,44,0,safely defend police brutality
1,1,5,30,1,5,2,35,0,24 shamelessly sexual valentine's day card
1,1,11,43,1,10,0,54,0,able stop watching mesmerising rangoli video
1,2,11,46,1,10,0,57,0,eu lawmaker say news publisher right proposal dropped
1,1,12,37,1,11,0,49,0,tipsy nail art tutorial one ever need
1,1,14,45,1,13,0,59,0,bunch corgi tea party celebrate queen's historic reign
1,3,4,27,0,7,0,31,0,big pharma plan fend trump
1,1,12,36,0,9,0,48,0,nhl player date based three question
1,1,6,22,0,7,6,28,0,24 best science fiction book 2015
1,1,12,54,0,11,0,66,0,brainteaser getting shared facebook driving people crazy
1,1,11,46,2,10,0,57,0,"""breaking bad"" character based favourite colour"
1,1,9,34,0,8,0,43,0,hometown friend facebook need hear
1,1,12,50,0,11,0,62,0,best picture winner watch based emoji preference
1,2,7,48,0,11,0,55,0,obamacare rope house follows senate voting repeal
1,1,11,40,2,10,0,51,0,"take look newest ""real housewife atlanta"" taglines"
1,1,8,35,0,9,6,43,0,17 trend appeared literally every wedding 2015
1,1,14,44,2,13,2,58,0,19 picture real anyone who's asked wi-fi password
1,1,14,35,0,11,0,49,0,nba superstar stephen curry open life dad
1,3,16,54,1,15,0,70,0,scott walker telling teacher's story year want stop
1,1,13,36,2,12,0,49,0,"need see gigi hadid naked cover french ""vogue"""
1,3,15,60,4,15,1,75,0,fake news: abc dowd repeat false claim joseph mary 2 immigrant nativity story
1,3,5,51,2,12,2,56,0,"email habit tim cook, bill gates, 16 successful people"
1,1,10,30,0,9,0,40,0,make chicken tender like fucking adult
1,2,2,59,2,12,0,61,0,ive lost faith men. seem incapable genuine affection loyalty
1,1,13,39,1,11,0,52,0,mattress built-in pet bed snuggle real
1,1,8,24,0,7,0,32,0,much know british food
1,1,6,29,1,6,2,35,0,"12 christmas gift americans, love canada"
1,1,11,36,3,10,0,47,0,"rey's bread ""the force awakens"" took three month make"
1,2,6,35,1,9,1,41,0,assault border patrol agent continue 3 day
1,3,16,61,2,15,0,77,0,"gurmehar kaur shuns misleading claim moving blog, writes martyr's daughter"
1,3,7,45,2,6,0,52,0,democratic lawmaker wont attend trump inauguration
1,1,14,58,0,13,0,72,0,happened teacher found student really thought
1,1,6,18,0,5,0,24,0,type swearer
1,1,1,47,0,10,0,48,0,country live based zodiac sign
1,1,12,54,0,12,2,66,0,31 recipe prove making thanksgiving brunch instead dinner
1,1,7,32,3,7,2,39,0,"23 sign hopelessly obsessed ""new girl"""
1,1,7,14,0,6,0,21,0,celeb teen
1,1,9,37,0,8,0,46,0,definitive ranking mario brother sexiness
1,1,9,34,0,9,2,43,0,22 picture prove drunk absolute worst
1,3,2,55,0,11,0,57,0,watch intense ad veteran nonprofit made sure trump would watch
1,3,11,45,2,10,0,56,0,"thanks cow slaughter ban, cricket ball might become obsolete!"
1,3,2,57,2,12,0,59,0,bon appetit tried make hand salad thing seriously backfired
1,1,7,32,0,7,2,39,0,people live solitary confinement 24 hour
1,1,10,40,0,10,2,50,0,18 time dylan sprouse absolute best person twitter
1,1,9,34,0,10,6,43,0,22 powerful image marriage equality 2015
1,2,3,18,0,4,0,21,0,twilight rock god
1,1,12,39,2,10,0,51,0,felt like watch trump's speech mexican-american
1,3,11,51,3,10,0,62,0,steve carell's explanation trolling 'office' fan peak michael scott
1,1,12,42,1,12,4,54,0,look approximately many inch harry styles' hair grew 2015
1,2,3,23,2,6,0,26,0,hail halo xboxs master game
1,1,8,26,0,7,0,34,0,worse email everyone else
1,1,15,36,0,14,0,51,0,mom went taylor swift concert pure magic
1,2,3,35,1,6,0,38,0,"let president obama cigarette, already"
1,1,11,30,0,11,2,41,0,19 thing real mom teacher
1,1,12,50,2,11,0,62,0,kendall jenner gigi hadid (aka kengi) ultimate friendship goal
1,2,5,17,0,5,1,22,0,6 smart idea retire rich
1,1,8,28,0,8,2,36,0,18 people harder donald trump
1,1,9,34,0,9,2,43,0,17 tinder profile make fall laughter
1,1,5,10,0,4,2,15,0,18 cosy af bath goal
1,3,8,32,2,8,3,40,0,soros group gave $100k illegal alien legal fee
1,2,0,42,0,10,1,42,0,5 way criminal try scam tax season
1,1,9,27,1,8,0,36,0,here's make insane deep dish cookie
1,1,6,33,1,6,2,39,0,26 confession canada's new prime minister
1,2,7,25,0,6,0,32,0,take back brain social medium
1,2,2,38,0,8,2,40,0,10 hardest oxbridge degree get accepted
1,1,10,42,0,10,2,52,0,18 reason every woman follow poet rupi kaur instagram
1,1,7,23,0,7,2,30,0,15 reason need cheese life
1,1,9,40,0,8,0,49,0,nicholas spark movie best describes love life
1,1,9,33,1,8,2,42,0,year-end mashup 98 song fucking fantastic
1,1,8,30,0,8,2,38,0,99 thought everyone swim one mile
1,2,5,27,0,6,0,32,0,risk rising consumer borrowing
1,3,3,66,2,16,0,69,0,"rabbi, priest gay atheist smoke weed together. happened list"
1,3,11,62,2,12,0,73,0,beastie boy ad-rock donating proceeds sale vegan shoe planned parenthood
1,1,13,50,2,12,0,63,0,"sarah jessica parker trouble judging ""sex city"" character"
1,1,10,44,1,10,1,54,0,9 joke make biswa kalyan rath new favourite comedian
1,1,8,37,0,8,2,45,0,21 secret american eagle employee never tell
1,1,10,35,1,9,0,45,0,p!nk wrote ellen degeneres super sweet new theme song
1,2,5,25,2,5,0,30,0,"wait, quavo karrueche dating?"
1,1,8,25,0,7,0,33,0,much america actually like
1,2,8,50,3,9,0,58,0,"kellogg besieged food product recall listeria, glass, metal"
1,3,6,25,1,6,0,31,0,cheapest way build trump wall
1,3,8,41,0,9,0,49,0,gorsuch could pull eight justice rightward
1,2,4,16,2,4,0,20,0,"eat peppers, live longer?"
1,1,8,28,1,8,1,36,0,"5 easy, healthy habit anyone take"
1,1,14,46,0,13,0,60,0,woman wore patriotic hijab fox news people freaking
1,3,8,31,0,7,0,39,0,successful people business
1,2,10,47,1,9,0,57,0,here's people really thought trump press conference
1,1,13,39,0,12,0,52,0,two test reveal one good one bad truth
1,3,1,47,0,7,0,48,0,florida senator resigns amid outcry racist remark
1,1,6,32,2,6,2,38,0,"16 snapchats ""friends"" fan understand"
1,2,3,34,0,8,2,37,0,large asteroid hurtle past earth april 19
1,1,7,25,0,7,2,32,0,13 thing know sex shop
1,1,11,35,0,11,2,46,0,61 thought everyone going poo office
1,1,13,48,0,12,0,61,0,bride took wedding photo album absolutely beautiful
1,3,10,41,0,10,2,51,0,16 comic woman woman find fucking hilarious
1,1,11,39,2,9,0,50,0,mid-october already snowstorm ontario
1,1,13,42,1,11,0,55,0,bride baked life-sized wedding cake groom
1,1,13,39,1,12,0,52,0,know object stick butt based zodiac
1,1,10,32,0,10,2,42,0,23 thing sister went school know
1,1,5,22,0,4,0,27,0,weird question gay couple get
1,1,9,41,0,9,2,50,0,17 mouthwatering way love affair strawberry
1,1,4,8,0,5,8,12,0,2015 1502
1,1,8,24,2,8,2,32,0,"27 time ""top gear"" made laugh like hell"
1,1,10,40,0,9,0,50,0,guess sexy halloween costume called
1,1,7,29,0,7,2,36,0,28 canadian crime ever committed
1,1,9,36,0,8,0,45,0,ink blot test reveal secret motivation
1,1,15,33,2,13,2,48,0,17 easy way makeup know wtf
1,1,10,43,0,9,0,53,0,stunning wedding photo actually make jaw drop
1,1,12,32,0,11,0,44,0,donald trump man bun haunt grave
1,3,8,42,1,11,0,50,0,"migrant headed north, thing carried end"
1,1,14,41,2,13,0,55,0,wrong side history say taylor swift can't sing
1,1,12,51,0,12,2,63,0,12 chart survived canadian winter understand
1,3,16,47,0,16,3,63,0,nicki minaj aretha franklin tied hot 100 song woman
1,2,5,53,3,14,0,58,0,new game like pokmon go catch cash prize instead
1,1,4,14,0,3,0,18,0,sensitive
1,3,8,47,3,8,0,55,0,transgender: toni tampon teach child men menstruate
1,3,1,44,0,7,0,45,0,science explores certain song give pleasure
1,2,4,11,2,4,0,15,0,lucky you?
1,3,1,59,0,12,0,60,0,woman sue fake news site stealing identity promote post
1,1,6,26,0,7,6,32,0,23 important movie question 2015
1,1,14,53,4,13,4,67,0,"ryan adam cover taylor swift's ""1989"" buzzfeed cover pitchfork's review"
1,3,4,48,2,14,0,52,0,played 'tag' using fake vr headset feel like idiot
1,1,11,30,0,9,0,41,0,match halloween costume tv show
1,1,8,32,2,7,0,40,0,"guess classic ""star wars"" creature"
1,1,10,47,0,10,2,57,0,19 apocalyptic photo storm supercells kansa beyond
1,1,15,50,1,14,0,65,0,future partner stare boob way smith stare jada's
1,1,10,38,2,9,2,48,0,19 body-positive book want read daughter
1,1,10,42,1,9,0,52,0,food test determine actually michigan
1,1,8,32,0,8,2,40,0,25 gift future revolutionary life
1,1,10,39,2,10,1,49,0,"jamie claire looking damn good ""outlander"" season 2"
1,2,3,28,3,4,0,31,0,trump's america: voter impressed?
1,3,2,59,2,12,0,61,0,mexico city metro installs 'penis seat' stop sexual harassment woman
1,1,13,45,0,12,0,58,0,diane keaton running get froyo diane keaton living best life
1,2,1,51,3,8,0,52,0,"waiter-less, cashier-less restaurant stuff future"
1,1,9,31,3,8,0,40,0,"well remember nicki's verse ""monster"""
1,1,11,42,0,11,2,53,0,23 awesome gift help stoner best friend get totally baked
1,1,15,53,0,14,0,68,0,anna camp skylar astin engaged everything finally right world
1,1,6,23,3,5,0,29,0,"what's funniest moment ""elf"""
1,2,5,46,1,12,0,51,0,"forget gap year get job jd sports, advises city lawyer"
1,1,7,32,0,7,2,39,0,22 book every twentysomething guy need read
1,1,11,39,0,10,0,50,0,lamborghini look like pizza hell
1,1,4,26,0,3,0,30,0,pumpkin flavored breakfast treat
1,1,12,38,3,12,2,50,0,"39 best moment history ""america's next top model"""
1,1,7,33,0,8,6,40,0,17 hilarious tweet astrology 2015
1,1,6,33,0,6,2,39,0,48 genuinely insane fact kardashians
1,2,10,63,1,10,0,73,0,animal right activist outraged micheal bloombergs daughter date trophy hunter
1,1,13,20,0,9,0,33,0,name tv show based one gif
1,2,12,56,1,11,0,68,0,engagement picture adorable pup breaking record cuteness!
1,2,9,27,0,8,0,36,0,one career lesson first job taught
1,1,12,39,2,11,0,51,0,"well remember ""one semester spanish love song"""
1,1,7,39,1,6,2,46,0,15 thing super-disciplined people understand
1,3,7,23,0,8,6,30,0,35 thing 2007 would never dotoday
1,1,9,33,0,9,1,42,0,4 borderline genius waffle need try
1,2,3,69,1,12,0,72,0,problem senator hesitating trump nominees: alternative might worse
1,1,9,31,0,9,2,40,0,20 great idea ended worst possible way
1,1,6,21,0,5,0,27,0,kylie jenner mint green hair
1,1,7,31,0,6,0,38,0,actually prefer appetizer dessert
1,1,12,38,0,12,4,50,0,definitive list badass queer woman crushed 2015
1,1,14,41,2,13,0,55,0,"match ""game thrones"" quote character said"
1,1,14,56,1,13,0,70,0,pope's security guy weirdly look like neil patrick harris alec baldwin
1,2,7,30,6,6,0,37,0,"mashable periscope: ""twitter party #sxsw"""
1,1,7,34,0,7,2,41,0,23 easy homemade chocolate treat
1,1,13,37,1,10,0,50,0,like watch shia labeouf movie shia labeouf
1,1,5,24,0,5,2,29,0,11 cat freaking cucumber
1,2,9,45,1,11,0,54,0,schumer call session resign need special prosecutor
1,2,4,42,0,8,0,46,0,monogamous male couple stay mindful hiv
1,2,2,64,2,10,1,66,0,intel's lead anthropologist: 4 question every tech entrepreneur ask
1,1,8,39,0,8,2,47,0,21 secret chinese restaurant waiter never tell
1,2,4,45,0,9,2,49,0,youtube fix brings 12 million video back restricted mode
1,3,17,56,2,17,2,73,0,terminally ill patient 18 month live get cured cancer 'wonder drug'
1,1,12,37,2,11,0,49,0,"would make final rose ceremony ""the bachelor"""
1,2,1,44,0,11,0,45,0,best way get rid germ washing hand
1,2,2,55,0,9,0,57,0,tourist detained malaysia getting naked sacred mountain
1,1,9,30,0,9,4,39,0,emoji test determine need 2016
1,3,3,54,2,8,0,57,0,tunnel sky: photographer capture italy's hidden courtyard
1,3,7,37,0,7,1,44,0,6 biggest credit mistake millennials making
1,3,2,32,3,8,1,34,0,5 myth new year 'detox' debunked
1,1,9,37,0,9,2,46,0,18 moving photo vigil paris held across canada
1,2,10,53,1,9,0,63,0,"donald trump issue new immigration order, legal challenge remain likely"
1,3,6,28,1,8,0,34,0,"kd returns, looking back okc exit"
1,1,9,33,2,9,2,42,0,25 thing get obsessed bath
1,2,13,67,1,12,0,80,0,"colin kaepernick turn historically bad performance bears, benched gabbert"
1,1,10,34,1,8,2,44,0,21 disney gifs ruin whole entire childhood
1,1,11,40,1,11,4,51,0,2016 martha stewart still fucking killing twitter
1,1,9,27,1,9,6,36,0,18 british tv show sadly return 2015
1,1,7,32,4,6,0,39,0,"jimmy kimmel blended ""scandal"" ""gossip girl"""
1,2,14,72,5,19,0,86,0,limbaugh call trump border wall cave country ready blame democrat shutdown
1,1,12,33,1,12,2,45,0,14 people share like divorced young age
1,1,8,23,2,7,0,31,0,"well remember ""a goofy movie"""
1,3,14,53,2,13,0,67,0,"already know brussels sprout grow, dont recommend reading thispost"
1,1,11,44,1,10,0,55,0,krampus terrifying holiday movie know needed
1,1,8,25,0,8,2,33,0,18 genius way eat cheese every meal
1,1,14,53,2,13,0,67,0,fools' gold: controversial hit discovery channel show went boom bust
1,2,8,29,0,8,2,37,0,24 picture make much happier person
1,1,10,45,1,9,2,55,0,18 unbelievably delicious thing store-bought cooky
1,1,11,50,0,10,0,61,0,sweet tooth changed forever homemade doughnut
1,3,1,50,2,10,4,51,0,money management business could reach 'a turning point' 2017
1,1,17,47,0,13,0,64,0,kristin cavallari posted tbt stephen make nostalgic af
1,1,12,41,1,11,0,53,0,angelina jolie brad pitt's new movie liking watch
1,1,11,44,2,10,0,55,0,"one hot canadian everyone forgets ""hot canadians"" list"
1,3,11,39,1,9,0,50,0,ryan: bloodbath gop fails pas health care legislation
1,1,11,29,1,10,0,40,0,best taco ever life
1,1,6,24,0,7,6,30,0,11 nonsensical lyric 2015
1,1,4,9,0,3,0,13,0,keen
1,1,16,58,0,15,0,74,0,author rainbow rowell chooses good evil epic game would rather
1,1,11,39,4,11,2,50,0,"15 word make sense ""america's next top model"" fan"
1,2,1,39,0,6,0,40,0,little girl photobombed huge venomous snake
1,3,13,44,0,13,2,57,0,19 picture give intense flashback sick akid
1,1,6,25,0,5,0,31,0,animal know daily struggle
1,1,7,29,0,7,2,36,0,19 fluffy puppy might actually bear
1,3,4,25,0,3,0,29,0,syrian catastrophe explained
1,1,10,28,0,9,0,38,0,red line test show honest
1,2,1,47,1,9,0,48,0,china fisherman explain think sea
1,3,13,55,4,14,0,68,0,hungary responds new york time coverage migrant crisis: dont get
1,2,6,32,2,8,1,38,0,7 simple (and cheap) way upgrade kitchen
1,1,13,38,2,12,0,51,0,"inside london's bone archive, dead dig go live"
1,3,2,63,5,14,0,65,0,"one big, happy group. two teen accused killing another."
1,1,9,45,0,9,2,54,0,23 picture make responsible adult extremely angry
1,2,4,21,1,6,0,25,0,"fear flying, good reason"
1,1,9,38,4,6,0,47,0,non-americans: celebrate u.s. thanksgiving
1,2,10,52,1,10,0,62,0,fake news: partying macedonian teen earns thousand publishing lie
1,1,6,14,0,6,2,20,0,12 dumb way drink beer
1,3,9,45,2,10,1,54,0,8 thing millennials need know debbie reynolds [video]
1,1,11,40,0,10,0,51,0,asked expert keep hearing escaped peacock
1,3,3,50,0,10,0,53,0,watch boy transform spitting image nicki minaj
1,1,8,29,1,8,2,37,0,molly 16. justin bieber bernie sander
1,1,8,31,0,8,2,39,0,26 picture way real millennials
1,1,8,23,0,7,0,31,0,know movie scare
1,3,14,38,4,12,0,52,0,mom ended e-cigging teen party extraway
1,3,7,39,4,7,0,46,0,ivanka watch: who selling first daughter fashion?
1,3,12,37,0,9,2,49,0,17 badass historical lgbt woman gave absolutely nofucks
1,3,8,32,2,9,0,40,0,"best fast food, picked world top chef"
1,1,10,38,0,10,2,48,0,19 word totally different meaning new mexico
1,1,10,39,1,9,2,49,0,17 shania twain lyric guide self-acceptance
1,1,8,38,0,8,2,46,0,17 incredibly lazy totally tasty noche buena recipe
1,1,9,30,0,7,1,39,0,9 illustrated tweet guaranteed make lol
1,1,6,29,2,6,2,35,0,"23 time ""hunger games"" fan dominated tumblr"
1,1,8,35,0,8,2,43,0,21 kitchen upgrade actually
1,1,4,23,0,4,2,27,0,12 thing cuban view differently
1,3,13,42,2,11,0,55,0,thief using imported tool open lock high-end cars!
1,1,16,42,0,15,0,58,0,guess team peeta team gale based zodiac sign
1,1,8,27,2,8,2,35,0,22 thing know massive prude
1,1,5,15,0,4,0,20,0,really mermaid
1,1,8,31,1,7,2,39,0,31 insane after-christmas sale shop right
1,1,9,50,0,9,2,59,0,18 breathtaking mexican treat make drool uncontrollably
1,3,15,50,0,14,0,65,0,picture taken exactly nine year ago reminder much changed
1,1,11,44,1,11,2,55,0,18 ghostly treat take halloween party next level
1,1,9,44,0,9,2,53,0,29 frightfully genius idea spookiest slumber party ever
1,1,6,20,0,4,2,26,0,31 totally adorable holiday diys
1,3,19,53,1,18,0,72,0,people cant stop laughing plank wood look like dog trapped init
1,1,14,55,4,12,2,69,0,"18-year-old instagram star say ""perfect life"" actually making miserable"
1,1,10,33,0,10,1,43,0,8 exercise video one day barely survived
1,2,11,58,2,12,0,69,0,"capitol: painting depicting police pig violates rules, removed insider"
1,3,6,41,3,10,0,47,0,skipping wbc helping u.s. star get super
1,1,9,32,3,8,0,41,0,"remember pilot episode ""bob's burgers"""
1,1,14,50,5,13,0,64,0,"here's clever thing never noticed ""beauty beast"" ""aladdin"""
1,3,10,62,2,10,0,72,0,"james mattis, john kelly confirmed defense secretary, homeland security secretary"
1,3,1,65,3,9,0,66,0,"california company want hover buildings, protecting earthquake"
1,2,9,53,1,10,0,62,0,black life matter attempt disruption super bowl attendee arrival
1,1,11,34,1,10,0,45,0,poorly drawn line book wonderful
1,2,0,37,1,8,2,37,0,24-hour work shift wreak havoc heart
1,1,9,47,0,8,0,56,0,native american asked sensitive question white people
1,2,6,24,4,6,2,30,0,selena gomez worth $10 million? [video]
1,1,11,39,3,10,0,50,0,"badass female ""star wars: force awakens"""
1,3,1,56,2,11,2,57,0,world's weirdest houses? 16 unusual property
1,2,10,43,0,9,0,53,0,jon jones offer ronda rousey career advice following loss
1,1,11,40,1,9,0,51,0,apple's new iphone update making everybody look thirsty af
1,3,8,36,3,9,0,44,0,patriot fan dance street video nytimes.com
1,2,11,62,1,13,0,73,0,speaker paul ryans approval rating plummet fails deliver president trump
1,1,5,15,0,4,0,20,0,try guy try therapy
1,1,8,27,0,8,2,35,0,16 time calum hood king instagram
1,1,8,28,0,8,2,36,0,19 husband failed hard almost
1,1,13,47,0,12,0,60,0,people loving twitter account match dog self
1,1,11,49,2,8,0,60,0,gluten-free blender muffin perfect make-ahead breakfast
1,1,8,34,0,7,0,42,0,people disability make fun donald trump
1,1,9,34,0,9,2,43,0,22 reason egg banished earth
1,2,5,45,3,7,0,50,0,what's latest uncommitted mcdonald's americans?
1,3,9,25,1,4,0,34,0,must-see inspirational espy moment
1,3,1,45,0,9,0,46,0,stop trying hush truth election hacking
1,1,9,43,0,8,0,52,0,watch people struggle trying guess urban dictionary term
1,2,5,23,0,6,0,28,0,effect stress body
1,1,6,31,0,6,2,37,0,10 strangest compliment ever received
1,1,13,49,0,12,0,62,0,ruby rose happy revealing photo published
1,2,2,34,0,8,0,36,0,eu split pace reform crisis bite
1,1,8,29,1,8,4,37,0,23 ya novel '00s everyone recognize
1,1,5,30,2,5,2,35,0,"24 time ""skyrim"" accidentally hilarious"
1,1,10,42,0,8,0,52,0,leonardo dicaprio bradley cooper valentine
1,3,8,35,0,7,0,43,0,trade question cast shadow geneva motor show
1,1,10,30,2,9,0,40,0,here's like visit actual paper town
1,1,9,39,1,9,2,48,0,19 struggle people drink tea understand
1,1,8,31,0,8,2,39,0,17 lohanthony tweet speak soul
1,1,6,23,0,5,0,29,0,artist pay tribute david bowie
1,1,12,63,0,11,0,75,0,exhibition france celebrating two century pioneering woman photographer
1,3,9,31,5,8,0,40,0,"j.p. morgan won, lost, indonesia business"
1,2,1,32,1,5,0,33,0,trump true ideology revealed
1,1,10,40,0,10,2,50,0,37 photo annoy actually reasonable
1,1,10,40,0,9,0,50,0,guess drugstore makeup product cost
1,1,7,34,0,7,2,41,0,12 waffle maker snack make immediately
1,1,10,39,0,10,2,49,0,25 race training tip actual runner
1,1,12,46,0,11,0,58,0,aziz ansari called whiteness late night stephen colbert
1,1,7,25,1,6,0,32,0,can't escape pumpkin spice puzzle
1,3,3,38,1,7,0,41,0,beautifying baghdad: colouring city wall
1,1,10,49,3,9,0,59,0,"jimmy fallon beautifully performed drake's ""hotline bling"" bob dylan"
1,1,9,31,2,9,2,40,0,25 face recognise ever period
1,1,7,28,0,7,2,35,0,18 secret coffee lover never tell
1,2,6,46,3,11,0,52,0,pool party organizer: use aggression cnn video
1,1,10,40,0,10,2,50,0,29 giant version favorite food make
1,1,9,33,1,8,0,42,0,here's make ultimate pinterest face mask
1,1,12,45,1,11,0,57,0,punny valentine's day card give based zodiac
1,2,10,41,1,11,0,51,0,big raise today cause problem tomorrow expert
1,3,15,47,5,14,1,62,0,"5 thing know ffc-acrush, china's hottest 'boy band' made girl"
1,1,14,50,2,13,0,64,0,"rafael michael ""jane virgin"" cutest bromance real life"
1,1,12,32,3,11,1,44,0,"""broad city"" season 3 trailer funny af"
1,1,8,39,0,8,2,47,0,17 inappropriate pumpkin make feel thing
1,1,8,27,2,9,6,35,0,"may 21, 2005, darkest day fashion history"
1,1,5,15,0,4,0,20,0,disney pet
1,1,8,32,1,7,0,40,0,said it: hillary clinton claire underwood
1,3,8,33,1,7,0,41,0,"shoveling snow kill men, canadian study find"
1,1,12,39,0,11,0,51,0,know season born based random question
1,3,2,53,2,10,0,55,0,easter egg calculator: guilty feel binge?
1,1,10,28,2,8,0,38,0,#flotusbars best thing see day
1,1,11,36,2,11,2,47,0,"well actually remember ""10 thing hate you"""
1,1,4,12,0,5,6,16,0,10 place travel 2016
1,2,2,50,0,11,0,52,0,new interior secretary rode horse work
1,1,10,27,2,10,2,37,0,"16 time pam ""true blood"" master sas"
1,1,8,37,2,7,0,45,0,"kanye west auditioned ""american idol"" weekend"
1,1,7,20,0,6,0,27,0,tinker bell belle
1,1,9,23,0,9,4,32,0,guess much water drank 2015
1,1,10,31,0,10,1,41,0,7 simple way make week little less shitty
1,1,10,42,0,10,2,52,0,29 ridiculous way people injured kid
1,2,8,34,2,7,0,42,0,viola davis finally playing sexualized' woman
1,1,10,39,0,10,2,49,0,16 relatable situation anyone nosy uncle aunty
1,3,2,43,0,6,0,45,0,trump administration could reshape internet
1,1,8,33,2,7,0,41,0,"""new girl"" character roommate"
1,2,6,40,1,8,0,46,0,paying president trump's travel security cost
1,2,0,32,0,7,1,32,0,5 thing woman hide husband
1,1,7,29,1,6,0,36,0,here's everything shape say
1,1,11,38,0,10,0,49,0,purple line test determine sex style
1,1,10,34,0,10,2,44,0,12 moment real anyone abuelita
1,1,11,59,0,10,0,70,0,tom hiddleston explained gothic literature geekiness surprisingly hot
1,1,8,36,0,7,0,44,0,hogwarts house kardashian belong
1,3,15,56,3,14,2,71,0,"gul panag express view sonu nigam, abhi-aish's 10th anniversary ent"
1,2,4,53,1,9,0,57,0,kate hudson's brother post hilarious response brad pitt rumour
1,1,11,46,0,10,0,57,0,canadian celebrity marry based zodiac sign
1,3,10,36,4,10,2,46,0,"19 funny chinese dating show quote thatll make say,me"
1,3,2,48,2,11,1,50,0,christmas like youve 1m scratchcard
1,1,8,37,0,8,2,45,0,13 awkward moment depression anxiety
1,1,9,33,0,8,0,42,0,know inspiration famous song
1,1,14,37,3,11,0,51,0,"""law order: svu"" character based zodiac"
1,3,1,24,0,4,0,25,0,technology get u hooked
1,1,10,33,0,9,0,43,0,know zodiac sign based favorite cat
1,3,8,46,3,8,0,54,0,big-hearted banker emerged collapse billionaire
1,1,22,28,3,8,0,50,0,"attention, world: india aced no-shave november"
1,2,11,43,0,10,0,54,0,online company meet fcc bid preserve net neutrality rule
1,1,10,35,2,10,2,45,0,28 vine remind life (always) terrible
1,1,9,30,0,9,2,39,0,21 unexpected thing make rice cooker
1,1,10,32,1,10,2,42,0,$10 ikea lack table look like inside
1,1,9,44,1,8,0,53,0,what's biggest misconception military spouse
1,2,2,47,1,11,0,49,0,tried six new frappuccino flavor dont
1,1,5,22,0,4,0,27,0,disney princess damn rock
1,1,8,20,1,8,2,28,0,make dinner week $25
1,1,10,35,0,10,2,45,0,15 time tina fey amy poehler ruled golden globe
1,1,8,33,0,8,2,41,0,15 dog greatest birthday ever
1,3,2,44,1,9,0,46,0,got money problems? frugal movement might
1,1,12,48,0,11,0,60,0,kate hudson jimmy fallon played perfect game dubsmash together
1,1,12,38,1,11,0,50,0,let hot guy help count day 'til christmas
1,1,6,23,0,5,0,29,0,signature dance move
1,1,13,29,4,8,0,42,0,"perfect end-of-summer mix here, dj a-trak"
1,3,6,53,0,13,0,59,0,new bbc dad latvian mayor whose cat interrupted live stream
1,3,2,55,3,10,0,57,0,school warning: parent need know 'eraser challenge'
1,2,5,30,2,5,0,35,0,meet robonauts: nasa's humanoid robot
1,3,11,50,4,13,0,61,0,sen. liz warren refuse disavow madonna wish blow white house
1,3,7,51,1,9,0,58,0,bearing witness executions: last breath lasting impression
1,1,12,42,1,11,2,54,0,model 69-ing fashion show really something
1,1,6,27,2,4,0,33,0,buzzfeed crossword: get emotional
1,2,8,43,3,8,2,51,0,"literally 18 hilarious tweet last night ""bachelor"""
1,3,9,31,0,8,0,40,0,new office sensor know leave desk
1,1,11,57,2,10,0,68,0,"eddie redmayne said filming ""fantastic beasts"" wonderful experience"
1,1,5,19,0,5,2,24,0,12 lesson learned bad sex
1,1,17,64,2,16,0,81,0,"wedding canceled, bride's family turned reception feast homeless"
1,3,9,52,4,13,8,61,0,"paris tourism fall 1.5 million 2016 terror fears, cost economy 1.3 billion"
1,1,7,22,0,6,0,29,0,people try balut first time
1,1,15,44,3,12,0,59,0,here's actually like victoria's secret angel irl
1,3,11,57,3,13,0,68,0,incoming trump press secretary sean spicer media: business usual
1,1,4,23,0,3,0,27,0,men transform superheroes
1,3,2,46,3,10,0,48,0,housing bubbles: economics say 'b' word
1,3,18,57,0,18,2,75,0,group hardworking woman mumbai providing full meal r 10 needy
1,1,10,28,0,9,0,38,0,rumor drake died got started
1,1,10,42,0,10,1,52,0,9 time michael scott knew exactly feel adulthood
1,2,13,52,1,12,0,65,0,trump's tweet chelsea manning obama interesting reason
1,1,13,57,0,12,0,70,0,make delicious dessert apple ice cream create instant happiness
1,1,6,24,3,6,2,30,0,"12 sign actually buddy ""elf"""
1,3,12,36,0,11,0,48,0,biggest wild card retirement deal
1,2,9,38,4,11,0,47,0,"review: amlie easy listen to, never really sings"
1,2,15,52,3,14,4,67,0,"5-year-old loses part finger accident school, 300 parent storm premise"
1,1,10,47,2,10,1,57,0,"9 christmas ""would rather"" question impossible answer"
1,3,9,40,2,11,1,49,0,"here lose weight 2 weeks, say fitness blogger"
1,1,8,38,1,7,2,46,0,23 time halloween satisfied baby-craving need
1,1,13,44,2,11,2,57,0,"24 ""american horror story"" gifs perfectly sum period"
1,1,11,35,0,11,2,46,0,33 sneaker make want throw heel
1,2,14,51,2,12,0,65,0,mcdonald's cashier's act kindness toward boy autism inspiration
1,3,17,43,1,14,0,60,0,nyc opened cookie dough cafe exactly need rightnow
1,2,21,54,6,16,0,75,0,watch: senior abbas aide moving u.s. embassy jerusalem declaration war muslim
1,1,14,48,1,14,2,62,0,20 picture make absolutely sense never target
1,1,11,40,1,10,0,51,0,what's something understand sister
1,1,7,25,0,6,0,32,0,navigate day depression
1,2,1,53,0,10,4,54,0,fed tantrum set biggest exodus emerging market since 2008
1,1,10,29,0,10,2,39,0,11 best red hot chili pepper song time
1,1,9,48,0,8,0,57,0,misconception antidepressant sick hearing
1,1,9,51,2,9,2,60,0,19 thing understand slightly obsessed masturbating
1,1,6,23,0,6,2,29,0,18 glorious nail art design fall
1,1,4,11,0,3,0,15,0,kill
1,3,8,28,2,7,0,36,0,medication expensive (in one map)
1,2,10,47,0,9,0,57,0,hillary clinton absolutely burn michael flynn single tweet
1,1,7,22,0,7,2,29,0,23 delicious way layer fall
1,3,1,44,0,9,2,45,0,10 trendiest hairstyle guy right
1,2,12,38,5,12,2,50,0,"23 thought watching ""yuri!!! ice"" first time"
1,1,10,28,0,9,0,38,0,get rid annoying gray hair
1,1,9,34,2,8,0,43,0,"roommate played honest game ""truth drink"""
1,2,8,24,0,7,0,32,0,best place retire without car
1,1,8,28,1,9,6,36,0,21 difficult choice make 2015
1,1,11,39,2,10,0,50,0,what's worst white elephant gift ever ended
1,1,18,62,0,17,0,80,0,man woman live streamed moment show differently woman treated online
1,1,10,33,0,10,2,43,0,22 medieval satan really bad day
1,3,4,61,1,14,0,65,0,green v mundine: two bloke outsmarted foxtel get board
1,1,10,37,2,9,0,47,0,"matthew lewis play hilarious game ""would rather"""
1,1,8,46,1,8,2,54,0,16 face anyone who's painfully single recognize immediately
1,1,7,19,0,6,0,26,0,lana del rey album
1,1,10,33,0,9,0,43,0,know kind instagram photo last posted
1,1,4,20,0,4,2,24,0,24 reality halloween
1,2,10,38,1,10,0,48,0,fbi: texan tried take kidnapped child iraq via mexico
1,2,4,58,4,13,0,62,0,"prince harry: ""i always wanted gurkha, opportunity never arose"""
1,2,17,42,3,10,0,59,0,"report: maddows trump tax scoop spark battle nbc, msnbc boss"
1,2,2,41,0,6,0,43,0,big business warns trump mass deportation
1,1,11,46,1,10,0,57,0,jimmy fallon's puppy predicted bronco win super bowl
1,3,1,50,0,8,1,51,0,2 chart give stock picker everywhere nightmare
1,1,9,31,0,8,0,40,0,morgan freeman really old fun fact
1,1,12,47,1,9,2,59,0,17 word mean something completely different long-distance bffs
1,1,11,35,0,10,0,46,0,movie loved feminism made love less
1,1,14,32,0,13,0,46,0,man u really gotta pee plane
1,1,7,33,0,7,2,40,0,13 heritage minute canadian need right
1,1,16,38,0,11,0,54,0,ruby rose justin bieber wore matching outfit mtv emas
1,3,12,32,2,10,1,44,0,scary-good google pixel xl: keep iphone 7 plus bay
1,1,9,36,0,9,2,45,0,19 thing people living depression want know
1,1,7,36,0,8,6,43,0,19 time pop culture embarrassingly offensive 2015
1,1,10,37,0,9,0,47,0,confronted humiliating thing teen diary
1,1,12,41,2,11,0,53,0,"""rocky horror picture show"" cast reunited feel good"
1,1,7,35,1,6,2,42,0,17 real-life milestone socially awkward people
1,3,11,38,1,10,0,49,0,create sampler platter we'll guess age height
1,3,14,38,0,12,2,52,0,winona ryder made 22 face speech sagawards
1,1,7,28,0,6,0,35,0,get freaky sharp concentration
1,1,14,43,1,12,0,57,0,amazing new plus-size clothing line faint heart
1,1,10,29,0,10,4,39,0,top 2015 song based zodiac sign
1,1,12,28,2,9,0,40,0,"adam driver bringing emo kylo ren vibe ""snl"""
1,1,7,30,0,7,2,37,0,15 obnoxious text glass would send
1,1,9,34,0,9,2,43,0,26 pro con living significant
1,2,3,60,2,9,0,63,0,khlo kardashian campaign finally strip empowerment meaning
1,1,6,21,0,6,1,27,0,6 dip change life
1,1,12,41,2,11,0,53,0,"first ""allegiant"" trailer still tris four making lot"
1,3,8,42,2,7,2,50,0,10 bizarre fast-food question thatll stump literallyanyone
1,1,7,30,0,8,6,37,0,30 criminally underrated pop song 2015
1,1,13,30,1,12,0,43,0,"weatherman day, learned"
1,1,11,41,0,11,2,52,0,10 brilliant piece life advice ryan reynolds fan
1,3,1,44,0,6,0,45,0,broadband subscriber helped quit slow provider
1,1,7,26,1,6,0,33,0,"diarrhea, told donald trump"
1,1,7,33,2,6,0,40,0,lived tried champurrado
1,1,7,34,4,6,0,41,0,"fuck, marry, kill: actor, different character"
1,3,14,55,3,14,0,69,0,"alison krauss talk 'windy city,' reveals artist son warned cover"
1,1,9,28,0,8,0,37,0,belong harry style zayn malik
1,1,12,31,0,11,0,43,0,real lipstick shade messing
1,1,9,43,0,9,2,52,0,21 product people completely obsessed poodle
1,1,21,47,0,15,0,68,0,easy hack let play music youtube using apps iphone
1,1,9,32,1,7,2,41,0,'90s nickelodeon character bff
1,1,14,41,3,12,0,55,0,"scully ""x-files"" outfit based star sign"
1,1,12,27,2,11,0,39,0,"would hero villain ""once upon time"""
1,1,10,31,0,10,2,41,0,17 time mom clarissa goddamn style icon
1,3,3,43,2,10,4,46,0,true story behind army's 1990 mission steal navy's goat
1,2,1,59,0,13,0,60,0,new space pic show greatest kitten toe bean universe
1,1,9,29,0,8,0,38,0,celebs try guess celebs butt
1,1,8,30,1,7,0,38,0,everyone obsessed daryl's arm
1,1,7,26,1,7,2,33,0,21 realistic plan we've got winter
1,2,1,43,0,7,0,44,0,zapping brain electricity feel like
1,3,5,41,3,8,0,46,0,christmas day? groundhog day? cant tell difference
1,1,6,27,3,6,2,33,0,"27 parents' reaction ""netflix chill"""
1,1,10,29,2,9,0,39,0,"know lyric ""hotline bling"" drake"
1,3,6,58,3,10,0,64,0,'emotional' jim harbaugh greets pope wolverines' visit vatican city
1,2,12,44,1,11,0,56,0,visual test determine youre optimist pessimist
1,1,14,40,0,13,0,54,0,spent week trying assertive woman workplace
1,1,14,45,2,13,0,59,0,"mary berry delivered one best sexual innuendo ""bake off"" far"
1,1,16,52,1,15,0,68,0,"band new, terrifying thing phone give anxiety"
1,1,9,42,2,9,2,51,0,17 picture appreciate ready christmas
1,3,2,57,5,12,2,59,0,"i'm worth $1.5 million, i'd never recommend paying mortgage early"
1,1,9,36,0,9,2,45,0,43 best drunken eats college town across america
1,3,5,29,1,6,4,34,0,31 accessory every 90 girl recognize
1,1,8,27,1,8,2,35,0,21 canadian thing ever see
1,1,9,29,0,10,6,38,0,13 young creatives london look 2016
1,2,5,31,0,8,1,36,0,chris pratt school acting 3 minute
1,1,7,31,0,6,0,38,0,signature british insult
1,1,11,36,0,11,2,47,0,17 thing know trying get bigger butt
1,2,2,36,3,7,0,38,0,'masala' bond spice indian economy?
1,1,10,33,2,9,0,43,0,what's funniest yik yak post seen year
1,1,9,28,0,9,2,37,0,world looked like 30 year ago
1,2,13,68,4,20,1,81,0,"fat good you! diet laden butter, cream cheese 'can help combat surge type 2 diabetes'"
1,1,12,21,7,6,0,33,0,"daisy take control ""agents s.h.i.e.l.d"""
1,1,10,32,1,10,2,42,0,many '90s toy christmas list
1,2,5,57,0,9,0,62,0,actor kal penn share script revealing indian stereotype hollywood
1,1,10,37,0,10,2,47,0,43 thing mildly irritate everyone go gym
1,1,9,39,0,8,0,48,0,color test determine secret sexual desire
1,2,1,41,1,10,0,42,0,"buy milk, bread toilet paper snow"
1,1,6,24,1,5,0,30,0,who's next canadian power couple
1,1,8,33,0,8,2,41,0,17 joke chelsea guaranteed make laugh
1,1,11,47,0,11,2,58,0,12 special educator told u teach child special need
1,2,6,37,0,8,0,43,0,meet baby born pennsylvania car dealership
1,1,14,44,0,13,0,58,0,real human department store mannequin come life
1,1,9,28,0,9,4,37,0,winner 2016 golden globe
1,2,10,50,2,11,4,60,0,"40 shot, 11 killed christmas weekend gun-controlled chicago"
1,1,7,35,0,7,2,42,0,18 brutally honest confession club promoter
1,1,11,38,0,10,0,49,0,smartest ingredient swap use kitchen
1,3,10,44,0,9,0,54,0,psychologist think lie santa damage kid
1,1,9,37,0,9,2,46,0,17 video prove kid basically drunk adult
1,1,12,39,0,12,2,51,0,17 know partner basically person
1,2,9,58,1,9,0,67,0,swedish minister: country need integrate returning islamic state fighter
1,1,10,35,2,10,2,45,0,"17 time ""this thirty"" hashtag pretty much nailed"
1,3,5,16,0,4,0,21,0,evaluate charity
1,1,13,43,3,12,5,56,0,"crazy genius spent 13 year archiving every episode mtv's ""120 minutes"""
1,1,11,40,0,11,2,51,0,16 wikipedia page change way see universe
1,1,16,56,0,15,0,72,0,happens french guy guess french american wine cheese
1,1,9,35,0,9,2,44,0,21 drunk conversation every girl least
1,1,12,40,0,11,0,52,0,happens ask queer woman dental dam
1,1,11,39,0,10,0,50,0,find taylor swift song hidden crossword
1,3,10,49,2,11,0,59,0,apple vowed revolutionize television. inside look hasnt
1,3,2,46,2,10,0,48,0,"honda affordable, high-tech car buy"
1,1,10,35,1,10,2,45,0,16 ridiculously pretty bra want keep day
1,3,6,28,0,8,2,34,0,16 hidden gem binge holiday
1,1,10,42,0,10,2,52,0,12 disneyland treat indulge holiday
1,3,6,44,2,7,0,50,0,here whats actually starbucks unicorn frappuccino
1,1,7,27,0,7,2,34,0,17 cat obviously planning murder
1,1,15,47,0,14,0,62,0,feel tell someone got tested overreact
1,1,11,46,4,10,0,57,0,"well remember clark griswold's rant ""christmas vacation?"""
1,1,4,23,0,3,0,27,0,transgender dating dilemma
1,1,9,36,1,6,0,45,0,pigskin blanket: nfl conference championship pick
1,3,4,54,0,12,0,58,0,time german submarine plopped middle central park
1,1,14,30,0,9,0,44,0,people got thirsty novak djokovic mtv emas
1,1,8,24,0,7,0,32,0,doctor need see penis
1,1,12,35,1,11,0,47,0,people say someone single vs. hear
1,1,6,26,0,6,2,32,0,24 beauty secret really know
1,1,10,37,0,10,2,47,0,33 studio ghibli cake guaranteed blow away
1,1,12,45,0,11,0,57,0,guy decorated entire subway car propose girlfriend
1,1,8,26,0,5,0,34,0,bffs slaying internet fashion
1,1,8,25,0,7,0,33,0,blake griffin punched dude head
1,1,8,28,0,8,2,36,0,15 hot ginger men sexually awaken
1,1,9,37,2,8,0,46,0,here's actually eat hungover
1,3,9,30,1,8,0,39,0,high-class sushi bar new secret weapon
1,1,8,32,0,8,2,40,0,16 situation people love gossip know well
1,3,16,57,1,15,0,73,0,"ratan tata say lonely, painful time amid ongoing tussle cyrus mistry"
1,1,8,23,0,8,2,31,0,19 food truck need visit india
1,1,13,40,0,12,0,53,0,see salad look like world two minute
1,2,12,47,0,11,0,59,0,dad nail problem complaining parent fly kid
1,1,5,28,0,5,2,33,0,12 oversized animal childhood
1,1,15,64,1,14,0,79,0,india's first transgender band released first song leave speechless
1,1,8,36,0,7,0,44,0,biggest mystery thanksgiving solved
1,1,9,25,0,10,6,34,0,23 little thing still time 2015
1,3,2,42,0,8,0,44,0,trump shocking conflict interest china
1,1,9,51,0,8,0,60,0,instagram makeup artist turn terrifying creature
1,3,5,37,3,6,0,42,0,'game thrones': ranking penultimate episode
1,3,10,54,1,10,0,64,0,ann coulter: obama testify oath trump campaign surveillance
1,2,4,61,2,12,0,65,0,"trump whiter, less academic cabinet say race class america"
1,1,8,37,1,7,0,45,0,here's real deal drinking activated charcoal
1,1,7,34,0,7,2,41,0,25 insanely fun kitchen tool need immediately
1,1,16,33,0,13,0,49,0,cool enough usa freedom kid trump rally
1,1,13,45,2,13,2,58,0,"18 ""sexy"" costume guy make lose faith halloween"
1,1,7,32,0,7,2,39,0,22 brutally honest confession bra fitter
1,3,1,37,1,11,6,38,0,revealed: 10 unusual home sale 2016
1,1,7,31,1,6,2,38,0,22 time science actually straight-up magic
1,1,8,27,0,8,2,35,0,18 thing gin drinker need life
1,3,2,39,2,7,0,41,0,'westworld' used famous robot pop culture
1,1,12,41,0,11,0,53,0,leaked star war art might reveal new detail film
1,2,10,32,2,8,4,42,0,2017 nba draft: best-case scenario top prospect
1,1,12,39,0,11,0,51,0,wish knew penis touched one
1,1,11,29,1,9,2,40,0,27 hotties ya novel who'll make thirsty af
1,1,10,35,0,10,2,45,0,21 picture real people hate driving
1,1,11,40,1,10,0,51,0,line studio ghibli clothing dropped magical
1,1,12,33,0,11,0,45,0,tell u creepiest thing child ever said
1,3,4,58,2,11,0,62,0,prince charles plan sterilise nation squirrel nutella
1,1,11,40,0,10,0,51,0,liam hemsworth trying destroy u instagram
1,3,10,33,2,10,2,43,0,"50 ""lord rings"" meme guaranteed make laugh"
1,3,6,22,0,6,2,28,0,81 thing yuccies like talkabout
1,1,9,20,0,9,2,29,0,11 type kid grew
1,1,13,38,1,11,2,51,0,22 time emilia clarke's instagram made wish bff
1,1,16,60,1,16,0,76,0,taylor swift's cat olivia benson chewed award belonging real life olivia benson
1,1,4,21,0,3,0,25,0,test culinary knowledge
1,1,8,32,2,8,2,40,0,"18 celebs totally forgot ""gilmore girls"""
1,3,5,32,1,7,0,37,0,share apple's live photo instagram
1,3,5,23,1,5,2,28,0,13 egg-cellent easter nail art idea
1,1,9,19,2,6,0,28,0,"inside omg scene ""creed"""
1,1,10,42,0,10,2,52,0,18 american girl book literally saved life growing
1,1,7,34,0,8,6,41,0,19 bizarre invention probably stay 2015
1,1,8,37,0,7,0,45,0,watch lesbian give gay men wardrobe makeover
1,1,13,48,0,14,6,61,0,17 really stupid thing stop saying woman natural hair 2016
1,1,8,37,0,8,2,45,0,21 picture people college never understand
1,1,4,23,1,4,0,27,0,meeting #squadgoals
1,1,4,17,0,3,0,21,0,name disney reptile
1,1,11,46,0,9,0,57,0,woman got transformed telenovela star looked dramatic af
1,2,4,58,2,12,0,62,0,britain's oldest olympian: hitler stopped getting medal bombed
1,1,9,28,0,8,0,37,0,husband try go bra shopping wife
1,2,11,53,5,11,1,64,0,"microsofts scaring window 7 users, claim highly insecure, dont worry"
1,1,10,35,0,9,0,45,0,know favorite singer based zodiac sign
1,1,7,30,0,7,2,37,0,22 mouthwatering thing cheese
1,1,9,37,1,9,2,46,0,18 parent tired children's facebook shit
1,3,11,52,1,9,0,63,0,ex-serviceman standing bank queue manhandled policeman karnataka
1,1,6,28,0,5,0,34,0,disney princess realistic hair
1,1,7,20,0,6,0,27,0,color aura right
1,1,9,26,0,8,0,35,0,would time travel past future
1,1,9,47,1,9,2,56,0,"21 completely genius way cook boneless, skinless chicken breast"
1,2,2,45,2,11,1,47,0,new 1 coin: coin could worth small fortune online
1,1,8,28,0,7,0,36,0,parent text emojis first time
1,1,9,41,0,9,2,50,0,27 product people completely obsessed book
1,2,3,56,3,13,0,59,0,pastor belief american girl boy doll trick enemy
1,1,15,51,1,14,0,66,0,answer three question we'll tell type book read
1,3,1,56,1,9,1,57,0,charity appeal raising 1m sends powerful message compassion
1,1,12,42,2,11,0,54,0,"""jane virgin"" character based zodiac sign"
1,3,22,21,3,9,0,43,0,stock hit all-time highs: here's need know
1,2,11,44,1,10,0,55,0,people pretty obsessed guy bob ross birthdayparty
1,1,11,39,0,10,0,50,0,ban shitty stock photo people playing video game
1,1,13,37,0,12,0,50,0,identify pop hit music video single screen shot
1,3,8,38,0,8,0,46,0,nike hit historic high latest teen research survey
1,3,2,55,5,11,0,57,0,"april giraffe finally, *finally* giving birth. real time."
1,1,8,42,0,8,2,50,0,16 time ralph wiggum perfectly embodied dating struggle
1,2,17,49,2,16,0,66,0,"rise shine, take quiz know whether youre morningperson"
1,3,13,44,2,12,0,57,0,"little girl ""titanic"" grown still crazyadorable"
1,1,18,61,0,17,0,79,0,please take moment day look stunning aishwarya rai bachchan photo shoot
1,1,6,17,0,6,2,23,0,27 mom troll heart
1,3,6,32,0,6,0,38,0,untold secret grand central terminal
1,3,8,36,1,10,0,44,0,"smiling, even oscar race losing marathon"
1,1,14,41,0,13,0,55,0,elle fanning say bryan cranston amazing think
1,1,6,23,0,6,4,29,0,resolution 2016
1,3,9,26,0,9,2,35,0,11 sign grit need succeed
1,2,5,12,1,2,0,17,0,live: yahoo earnings
1,3,8,34,1,9,3,42,0,tiny gulf country $335 billion global empire
1,2,2,15,0,4,4,17,0,top flickr photo 2016
1,1,13,56,1,12,0,69,0,overprotective dad made good warning daughter's homecoming date
1,1,14,39,5,11,0,53,0,"here's happened tried five ""easy"" ""cheap"" office diys"
1,1,9,31,0,9,2,40,0,21 gift give adulting hard
1,1,17,62,1,15,0,79,0,photographer tied model shark-infested water beautiful scary
1,3,1,37,0,8,2,38,0,10 job biggest annual cash bonus
1,1,13,38,1,13,2,51,0,19 text way real anyone who's little bit greedy
1,1,7,30,0,7,2,37,0,17 joke guaranteed make arsenal fan laugh
1,1,10,37,1,9,0,47,0,here's proof brining turkey stupid wrong
1,1,12,42,1,11,0,54,0,here's first look punisher daredevil going head head
1,3,1,35,0,9,0,36,0,hot new hedge fund monster month
1,1,8,30,0,7,0,38,0,tired hearing thanksgiving
1,1,14,45,0,13,0,59,0,people proving dick big dropping condom head
1,1,10,41,0,10,2,51,0,14 scrumptious fall recipe use exactly one pumpkin
1,1,6,24,0,5,0,30,0,christmas movie nemesis
1,3,8,28,0,9,4,36,0,5 easy way boost credit score 100 point
1,1,8,29,1,7,2,37,0,19 way stay gluten-free holiday season
1,2,15,59,3,16,0,74,0,robert davi cpac: trump force nature america needed break globalist era
1,1,11,40,0,11,2,51,0,19 hilarious tweet kid make laugh loud
1,1,9,29,0,8,0,38,0,celebs ate much thanksgiving
1,3,5,51,0,10,0,56,0,mobile technology take fight hiv lesotho people
1,2,12,52,0,11,0,64,0,siena coach jimmy patsos shake imaginary hand rider walk floor
1,1,6,26,1,6,2,32,0,15 thing say bostonian
1,3,13,32,3,10,0,45,0,rapper young m.a signing record deal--for
1,3,14,44,1,12,0,58,0,downfall youtubes biggest star symptom biggerillness
1,1,9,30,0,9,2,39,0,22 picture way real risk player
1,3,8,42,4,8,0,50,0,student claim objective truth white supremacist myth
1,2,8,30,1,8,0,38,0,coyote fan rip mayor weiers espn video
1,1,3,9,1,3,2,12,0,stretch $20
1,1,9,24,2,8,0,33,0,"mean ""hook up"" someone"
1,1,10,38,1,11,4,48,0,22 photo show insane '90s rave culture really
1,3,10,58,3,11,0,68,0,baltimore crisis due officer shortage month anti-police policy
1,3,4,50,3,10,0,54,0,re: happen post-nuclear wasteland capitol hill?
1,1,8,34,0,7,0,42,0,adorable polar bear cub discovered snow
1,1,8,33,1,7,0,41,0,dark side medical marijuana's miracle drug
1,1,9,34,0,9,2,43,0,18 hilarious meme tamale way real
1,3,8,41,0,7,0,49,0,watch alec baldwin deliver another brutal trump takedown
1,1,7,31,0,6,0,38,0,anyone know dreamforce actually
1,2,11,41,2,10,2,52,0,mom's 34-second video filmed pantry pretty much parenthood
1,1,9,44,1,8,2,53,0,24 low-carb spaghetti squash recipe actually delicious
1,1,14,39,0,13,0,53,0,went sephora asked make look like kylie jenner
1,2,1,50,1,9,1,51,0,bank branch use fall 6% customer embrace digital advance
1,1,11,31,1,11,2,42,0,vivica a. fox appears suggest 50 cent may gay
1,3,11,36,2,11,3,47,0,hard forget best photo obama's first 100 day
1,1,8,27,1,7,0,35,0,let's find floridian really
1,3,11,49,2,12,0,60,0,"song beyonce, justin timberlake might save life"
1,1,12,41,0,12,2,53,0,29 tweet lesbian make laugh every time
1,1,5,16,0,5,1,21,0,7 dinner make week
1,1,9,34,2,8,0,43,0,"guess ""friends"" episode title emojis"
1,1,9,39,2,8,0,48,0,"""bridesmaids"" character maid honor"
1,3,9,33,1,8,0,42,0,pizza test reveal youre stillsingle
1,3,10,58,4,10,6,68,0,"british university fined 400,000 almost killing student 'coffee experiment'"
1,1,12,53,4,12,2,65,0,"61 thing probably know ""harry potter philosopher's stone"""
1,3,0,54,0,6,1,54,0,8 ingenious innovation helping autistic child communicate
1,1,4,19,0,3,0,23,0,guy transform pinups
1,2,2,40,1,7,0,42,0,hayley williams's family theme park safety plea
1,1,10,46,1,8,0,56,0,jaw-dropping halloween costume kid wheelchair
1,1,8,19,0,8,1,27,0,3 dip need make game day
1,3,4,42,1,10,4,46,0,best riskiest move every team's 2017 nfl draft class
1,1,11,31,0,10,0,42,0,type donut based birth month
1,1,9,31,1,8,0,40,0,like live schizophrenia
1,1,5,13,0,4,0,18,0,case sleeping
1,1,7,30,0,7,2,37,0,30 thing girl always cold understand
1,1,10,28,0,9,0,38,0,need talk cute royalty brown
1,2,10,41,1,8,0,51,0,high-tech hijab literally make muslim womencooler
1,2,10,36,2,12,2,46,0,"love pets, keep 10 plant house"
1,1,12,66,0,11,0,78,0,chris hemsworth look completely unrecognisable dramatic weight loss movie role
1,3,12,28,1,8,0,40,0,tony robbins: make good first impression
1,1,9,30,0,8,0,39,0,know celebrity ex based one question
1,1,12,49,1,11,0,61,0,"chris rock promise oscar full drunk, disappointed people"
1,1,9,34,0,9,2,43,0,37 food tweet guaranteed make laugh every time
1,3,4,72,2,15,0,76,0,"susan buffett reveals surprising way found dad, warren buffett, rich"
1,1,8,35,2,7,2,43,0,15 autumn-themed cocktail totally warm
1,1,13,45,0,12,0,58,0,know actually want christmas based zodiac sign
1,3,10,45,3,12,0,55,0,impossible veggie burger: tech industry answer big mac
1,1,11,32,0,9,1,43,0,5 ridiculously simple diys need try month
1,1,10,24,0,7,0,34,0,famous bffs bestie
1,1,11,34,2,11,2,45,0,16 way teach kid david bowie (and world)
1,1,7,34,0,6,0,41,0,scientific santa fact ruin christmas
1,1,9,27,1,9,2,36,0,21 thing get wear black
1,3,12,56,6,12,2,68,0,"40 years, maxine hong kingston iconic book, woman warrior, still resonates"
1,3,8,20,1,7,0,28,0,find word sexy ornot?
1,1,6,30,1,6,2,36,0,24 awesome gift smash patriarchy
1,1,14,54,0,13,0,68,0,gay drama teacher responds perfectly mother pull kid class
1,3,6,50,5,12,3,56,0,"5 thing thursday, march 16: travel ban, yahoo hack, trump budget, syria"
1,1,9,27,0,8,0,36,0,disney quote need hear today
1,1,8,34,1,5,0,42,0,welcome new celebrity #icebucketchallenge
1,1,9,38,1,8,0,47,0,what's favorite celebrity couple moment time
1,1,12,35,2,10,0,47,0,question tell u.s. city belong
1,3,3,24,0,5,0,27,0,armour trump dilemma
1,1,11,37,3,10,0,48,0,"well know lyric wonka's ""pure imagination"""
1,1,13,31,0,12,2,44,0,19 reason one ever play video game pc
1,1,9,37,0,9,2,46,0,16 thing dermatologist want know skin
1,3,9,33,1,9,0,42,0,donald trump piss two biggest allies?
1,1,11,39,0,10,0,50,0,coloring book adult make feel young
1,3,1,71,2,12,0,72,0,touching moment five-year-old girl reuinted sailor father six month
1,3,16,66,4,16,0,82,0,"rubio: assad, putin understand could consequence nasty letter u.n."
1,1,11,48,3,11,2,59,0,"18 confession prove alone ""the bachelor"" obsession"
1,3,12,52,3,10,0,64,0,northwestern mutualvoice: leaving financial legacy: gift gift later?
1,2,3,45,2,9,0,48,0,walking dead shirt banned store racism
1,3,13,56,3,13,1,69,0,internet can't keep calm absconder vijay mallya's arrest bail within 3 hours!
1,1,11,36,2,10,0,47,0,"prince joined instagram might ""scandal"" fan"
1,1,9,33,1,10,6,42,0,"19 time india way, way gender progressive 2015"
1,1,9,41,0,8,0,50,0,danger true story becoming quirky indie dramedies
1,1,7,25,4,11,4,32,0,1 trip trader joe's $20 5 easy vegan dinner
1,1,12,48,1,11,0,60,0,everything need know kim kardashian amber rose's selfie
1,1,10,35,0,11,8,45,0,2016 movie see based favorite 2015 song
1,1,7,29,1,6,0,36,0,here's every tweet drake ever favorited
1,3,3,63,1,13,0,66,0,guy dumped girlfriend prom. got perfect revenge list
1,3,13,55,0,12,0,68,0,donald trump loved cite nonpartisan agency aide discrediting
1,1,15,51,1,14,0,66,0,bride held wedding reception alzheimer's home mom could attend
1,1,7,22,0,6,0,29,0,kind candy actually
1,1,8,34,1,6,0,42,0,name adorable instagram-famous pet
1,2,1,71,2,19,1,72,0,treasure hunter found 3 ton sunken gold cant leave jail say
1,1,11,40,0,10,0,51,0,color would lightsaber based zodiac sign
1,1,13,43,1,10,0,56,0,take buzzfeed five-day inbox cleanse stop hating email
1,2,7,19,1,4,0,26,0,wtf happened curt schilling?
1,1,8,34,1,8,2,42,0,19 struggle recognise really love food
1,1,16,55,2,12,0,71,0,everyone's confused sting performing nba all-star halftime show toronto
1,1,6,13,0,6,4,19,0,join gym 2016
1,1,13,34,1,12,0,47,0,"social medium ever get down, pop song"
1,1,10,32,0,10,2,42,0,38 cheap pair shoe look like million buck
1,1,8,23,0,7,0,31,0,well know ninja turtle
1,1,11,38,1,10,4,49,0,mash-up video cry nostalgic tear 1994
1,1,7,42,0,7,2,49,0,21 delectable subscription box foodie totally love
1,1,8,38,1,7,0,46,0,liam payne's shirtless selfie causing mass hysteria
1,1,12,26,1,10,0,38,0,guess age based taste m&ms
1,1,8,39,0,8,2,47,0,47 movie helped people cope depression
1,3,7,63,3,12,0,70,0,trump supporter boycotting new 'star wars' movie #dumpstarwars
1,1,10,36,0,10,2,46,0,21 tweet makeup make laugh every time
1,2,10,47,0,10,0,57,0,buffalo bill player asks cop shoot bizarre incident
1,1,9,27,1,8,2,36,0,18 thing every rom-com fan need life
1,3,9,36,1,9,0,45,0,"joel embiid give rihanna shoutout, say love"
1,3,2,37,1,7,0,39,0,rapid spread australia's cane toad pest
1,1,6,34,0,7,2,40,0,27 insanely delicious soup around world
1,1,10,31,0,9,0,41,0,spice girl based zodiac sign
1,2,2,58,1,12,0,60,0,dale cavese: football chant took internet world
1,1,4,13,2,3,0,17,0,"make ""butch"" hot"
1,2,10,64,2,14,0,74,0,"bizarre court case put violinist, leipzig string quartet, unflattering light"
1,1,9,35,0,9,2,44,0,18 tragic photo make makeup addict weep
1,2,1,65,1,12,0,66,0,relationship expert reveals keep spark long-term relationship
1,1,19,43,1,16,0,62,0,kfc making pizza fried chicken tried one
1,1,12,48,2,12,2,60,0,"20 time paget brewster ""criminal minds"" best person twitter"
1,3,14,55,2,11,0,69,0,snl audience cheer wildly character call donald trump little white bitch
1,1,6,25,0,5,0,31,0,sound confuse brain
1,1,14,35,4,11,0,49,0,"omg, tina fey amy poehler's movie ""sisters"" new poster"
1,1,10,36,0,9,0,46,0,find watch netflix february
1,1,9,38,0,9,2,47,0,17 hairdresser struggle every black girl know true
1,2,3,38,2,7,0,41,0,tony blair global network: ten thing learned
1,1,10,39,0,10,2,49,0,13 harry potter fan theory totally blow mind
1,3,3,42,2,8,0,45,0,posting picture kid facebook? think twice.
1,1,13,49,2,12,0,62,0,"mother shocked facebook post ""parent sex"" went viral"
1,1,10,31,1,10,3,41,0,here's woman worked past 100 year
1,1,11,42,1,10,0,53,0,know embarrass today based zodiac
1,1,9,27,0,10,6,36,0,10 bold new hair color trend try 2016
1,1,9,27,0,8,6,36,0,34 cosplayers slayed mcm london comic con 2015
1,1,9,44,0,8,0,53,0,take deep dive disgustingly adorable relationship
1,1,8,37,0,8,2,45,0,14 way actually resolve conflict friend
1,1,7,32,0,7,2,39,0,29 profession make parent proud
1,1,12,39,0,12,1,51,0,date member one direction 5 second summer
1,1,13,50,0,12,0,63,0,demi lovato destroyed first grammys performance dead
1,1,10,27,0,10,2,37,0,35 thing happen move new city
1,2,15,53,4,12,0,68,0,fix in: house committee russian hacking includes dnc-hired tech expert
1,1,6,19,0,5,0,25,0,laura carmilla
1,1,9,27,0,8,0,36,0,north west cutest closet time
1,1,8,28,2,8,2,36,0,23 food thing get chinese
1,2,2,32,0,6,0,34,0,best bauble christmas tree
1,1,8,45,0,8,2,53,0,29 face highly sensitive people immediately recognize
1,1,6,33,1,6,1,39,0,adorable animal advent calendar: december 6
1,2,4,32,2,4,0,36,0,situation vacant: running rome's colosseum
1,1,13,50,1,13,2,63,0,kylie jenner's lip kit sold 30 second people everywhere enraged
1,1,8,19,0,7,0,27,0,role would play band
1,1,9,40,0,9,2,49,0,15 thing single people tired hearing thanksgiving
1,2,18,55,3,19,0,73,0,"sonu nigam shave head off, kapil sharma sunil grover appear show ent"
1,3,12,42,1,12,2,54,0,club 33 coming disney world want join immediately
1,1,7,15,0,4,0,22,0,wtf online dating slang
1,1,6,28,0,6,2,34,0,21 reason john boyega human perfection
1,3,8,29,0,9,0,37,0,could yahoo account know
1,1,10,40,3,9,0,50,0,"first trailer ellen page's ""gaycation"" finally"
1,3,10,33,4,10,0,43,0,la la land fifty shade get wrong love
1,1,12,38,1,11,0,50,0,what's savage thing grandma ever said
1,1,10,42,1,9,0,52,0,here's jamie oliver turn healthy smoothie pancake
1,1,11,41,1,9,0,52,0,woman got tinder profile overhauled co-worker
1,3,3,46,4,10,0,49,0,news revealed: world least punctual airline
1,1,6,17,0,5,0,23,0,llama alpaca
1,1,3,24,0,3,2,27,0,11 ridiculous selfie confession
1,1,10,30,0,10,3,40,0,100 year girl scout look like
1,1,13,38,0,12,0,51,0,girl look much like taylor swift freak
1,3,13,54,4,13,0,67,0,watch sturgill simpson tear pres. trump's wall moving 'all around you' video
1,3,2,65,0,12,0,67,0,florida gator mascot made spectacular play save unsuspecting young fan
1,1,9,34,1,8,0,43,0,dwayne johnson spent valentine's day
1,1,12,29,0,10,2,41,0,31 diys help throw best slumber party ever
1,1,14,52,0,13,0,66,0,people happy justin bieber posted picture cornrows
1,2,1,34,1,8,0,35,0,spot snake hiding photo?
1,3,9,60,0,10,1,69,0,kellyanne conway burn hillary clinton tweet celebrating 9th circuit ruling
1,1,7,31,1,6,0,38,0,victoria's secret model stretch mark
1,3,10,37,0,13,2,47,0,nike air max 1 important air jordan 1
1,1,10,32,0,10,2,42,0,23 thing happen get drunk mum
1,1,4,16,0,3,0,20,0,vegetable
1,1,8,30,0,8,2,38,0,22 tweet perfectly sum growing texan
1,1,10,36,1,9,0,46,0,using rice cooker wrong entire time
1,1,9,21,2,9,4,30,0,11 way make-up much worse '00s
1,1,12,52,3,11,0,64,0,"cast ""high school musical"" reunited vanessa hudgens' halloween party"
1,1,4,19,0,3,0,23,0,thought manicure
1,1,12,44,0,12,2,56,0,17 time david beckham proved really sexiest damn man alive
1,1,7,16,0,6,0,23,0,much whovian
1,3,8,36,1,8,2,44,0,33 cute accessory thatll melt even coldestheart
1,3,12,44,2,12,2,56,0,25 celebs way excited meet eleven strangerthings
1,1,17,49,0,16,0,66,0,guy asked toronto police arrest could catch jay game jail
1,3,0,33,0,7,1,33,0,4 way lose weight minimal effort
1,1,6,23,0,5,0,29,0,recognize famous lip
1,1,9,32,0,9,2,41,0,21 adorable red panda product need life
1,3,8,46,0,10,0,54,0,republican insider push carbon tax white house meeting
1,1,12,42,0,12,2,54,0,19 time sasha malia flyest kid white house history
1,3,2,41,2,10,1,43,0,va. woman showing friend play lotto game win $1m
1,1,6,25,0,6,4,31,0,recognize 2015 chart topper
1,2,4,53,1,11,2,57,0,luxury hotel 20 countries: tony blair tout global business
1,1,6,24,0,7,6,30,0,16 word think differently 2016
1,1,4,25,0,4,2,29,0,21 extremely important trash panda
1,3,7,34,1,7,2,41,0,21 reason spanish world weirdestlanguage
1,3,0,31,0,9,1,31,0,5 thing watch new travel ban
1,1,10,42,2,9,0,52,0,"celebrity explain ""netflix chill"" emmy red carpet"
1,1,7,23,0,6,0,30,0,belong england scotland
1,1,4,18,0,3,0,22,0,disney quote pickup line
1,3,10,25,0,9,2,35,0,29 beautiful tv quote alltime
1,1,11,49,2,10,0,60,0,"sarah michelle gellar reveals mysterious new ""star war rebels"" role"
1,3,1,51,3,14,0,52,0,"way write l, t, i, reveals lot personality"
1,2,1,35,1,8,2,36,0,20 best-selling book year
1,2,4,25,0,5,0,29,0,fabulous men fabulous pledge
1,3,10,35,2,10,0,45,0,equal pay day? here everything need know
1,3,2,54,0,8,0,56,0,truck drag car along highway california highway collision
1,1,8,32,0,8,2,40,0,18 thing everyone date makeup addict know
1,1,6,24,0,5,0,30,0,male disney character
1,2,2,62,3,14,0,64,0,fashion industry really want wear pajama street. dont it!
1,2,9,37,0,8,0,46,0,zodiac sign common among world leader
1,1,4,9,0,3,0,13,0,fall
1,1,8,23,0,9,6,31,0,27 time riley curry darn cute 2015
1,1,8,29,1,7,0,37,0,let's try improv comment section
1,1,5,27,0,5,2,32,0,12 celebrity powerpuff girl eye
1,1,6,15,1,5,0,21,0,miss ex's dog
1,2,11,29,2,8,0,40,0,next facebook? wall street size snap ipo
1,1,9,22,2,7,0,31,0,many u.s. state capital know
1,1,8,30,1,7,2,38,0,23 patch tattered clothes and/or life
1,1,15,49,3,13,0,64,0,"woman ""the office"" re-created throwback photo emotion real"
1,2,12,56,3,13,0,68,0,farage: lot trump voter scratching head syria airstrikes
1,3,1,35,3,11,1,36,0,quid in: time get rid 1 coin
1,2,7,39,0,7,2,46,0,26 pose every single person immediately recognize
1,1,13,43,1,12,0,56,0,like grow looking different parent
1,1,9,32,0,9,1,41,0,new 5 second summer song favorite
1,1,14,55,0,13,0,69,0,superstitious enough turn around black cat cross path
1,1,9,30,0,9,1,39,0,find horoscope week october 5
1,2,12,75,2,13,0,87,0,police investigation woman brutally beaten anti fascist wearing national flag bracelet
1,2,6,50,1,11,4,56,0,moonlight beat la la land? final oscar 2017 award prediction
1,1,12,34,0,11,0,46,0,guy drop phone toilet worst day ever
1,1,17,54,0,14,0,71,0,video perfectly capture tragedy hate favorite tv show
1,1,12,42,3,11,0,54,0,"smiths, kardashians, mary j. blige formed epic squad"
1,2,8,36,0,7,0,44,0,hubble space telescope changed universe
1,1,13,40,0,12,0,53,0,color dye hair based taste movie
1,1,8,38,0,8,1,46,0,9 reality people delicate fucking flower
1,1,8,35,0,7,0,43,0,severus snape quote match zodiac sign
1,1,11,36,0,10,0,47,0,happens sister best friend
1,1,7,35,1,5,0,42,0,thing salvadoran-americans tired hearing
1,1,12,51,1,11,2,63,0,15 depressing meal make cry ketchup-topped spaghetti
1,1,5,17,0,4,0,22,0,name muppets
1,3,13,47,5,11,2,60,0,"groom kill 10-yo boy 'sword ritual', bride's family call marriage"
1,1,10,41,2,10,2,51,0,"21 confession biggest ""gilmore girls"" fan world"
1,2,3,48,3,12,0,51,0,make british business sound 'hip' add word brooklyn
1,3,6,21,1,5,1,27,0,7 way make hack-proof
1,1,8,34,1,7,0,42,0,"meet jill, adorable squirrel instagram"
1,1,10,53,0,10,2,63,0,21 tweet perfectly capture personal relationship kraft dinner
1,1,9,49,0,9,2,58,0,12 indian webcomics every twentysomething reading right
1,1,11,33,2,12,4,44,0,29 thing understand went uni mid '00s
1,1,16,31,0,14,4,47,0,99 game want play sony brings ps2 emulator ps4
1,1,11,52,2,11,2,63,0,"12 undeniable reason denise hemphill best character ""scream queens"""
1,1,8,32,0,7,0,40,0,american beauty told miss america winner
1,1,10,31,0,9,0,41,0,colbert break vaping hot right
1,1,6,32,0,6,2,38,0,27 underrated hair product actually work
1,1,5,27,0,5,2,32,0,35 costume guaranteed win halloween
1,2,10,44,3,11,1,54,0,5 thing hope see lorde's 'saturday night live' appearance
1,3,11,47,1,12,0,58,0,conor mcgregor could make sh*t ton money floyd mayweather fight
1,1,16,51,1,15,0,67,0,adele said mic dropped piano that's grammy performance
1,1,12,40,0,12,2,52,0,17 thing real people always drop phone
1,2,11,46,0,10,0,57,0,donald trump found something mysterious rudy giuliani
1,1,9,36,0,9,2,45,0,24 perfectly cozy delicious treat bake fall
1,1,6,31,0,6,2,37,0,19 insane platform shoe need immediately
1,2,0,30,0,5,1,30,0,5 hotel fascinating past life
1,2,12,52,3,8,0,64,0,fbi interview top u.s. gymnast intensifying sexual-abuse investigation
1,3,9,58,5,11,0,67,0,obama: sander pretty centrist politician compared republican
1,1,11,40,2,10,0,51,0,"kendrick lamar performed brand new song ""the tonight show"""
1,3,2,53,1,12,2,55,0,oral history night baseball stopped retire no. 42 forever
1,2,7,32,1,7,2,39,0,26 quirk american dont realize superweird
1,1,14,47,0,14,2,61,0,17 struggle real anyone grew strict parent
1,3,11,42,4,9,0,53,0,octavia spencer joke 'hidden fences' 'snl' monologue
1,2,9,44,3,12,2,53,0,"nixon tried spoil johnson vietnam peace talk 68, note show"
1,1,11,43,1,10,0,54,0,"damn, inside indian train change completely"
1,1,8,24,0,7,0,32,0,people eat king cake first time
1,1,10,36,1,9,2,46,0,17 thing realise leave all-girl school
1,1,7,25,0,6,0,32,0,kind roommate actually
1,1,13,61,2,11,0,74,0,harry potter real: researcher uncovers real-life professor snape welsh university
1,1,8,28,2,7,0,36,0,"dear australia, need talk macca's"
1,1,12,52,0,11,0,64,0,jennifer lawrence amy schumer together golden globe perfect
1,1,10,41,3,10,2,51,0,"23 hilarious ""toy story"" moment make laugh every time"
1,1,12,37,0,11,0,49,0,joined tinder got stupid best friend
1,1,7,39,2,8,3,46,0,"20 tweet perfectly capture ""fallout 4"" experience"
1,2,9,37,2,8,0,46,0,casual reminder: there's thing reverse racism
1,1,7,19,0,6,0,26,0,woman decide sex
1,1,9,31,0,9,2,40,0,29 gift help empower woman world
1,1,8,34,3,6,0,42,0,"old-school ""star wars"" character ranked hotness"
1,3,3,19,2,2,0,22,0,"eyewitness: rennes, france"
1,1,11,49,0,10,0,60,0,trans artist made stunning poster trans day remembrance
1,1,10,41,0,10,2,51,0,24 thing guaranteed push way beyond breaking point
1,1,15,43,0,14,0,58,0,photo real deer posing next fake reindeer adorable
1,2,13,28,4,10,0,41,0,ups tweeted -- deleted -- bizarre mlk jr message
1,2,13,60,1,12,0,73,0,"ordinance jallikattu, court observation murthal rape must read story"
1,2,11,30,1,10,1,41,0,3 type awful co-worker deal
1,1,11,32,4,11,4,43,0,21 photo make sense mid-'00s teen
1,1,9,37,0,9,2,46,0,21 thing everyone vagina know kegels
1,3,16,54,4,13,0,70,0,"fmr ufc fighter tim kennedy reenlists, credit trump: military got teeth back"
1,1,8,30,0,8,2,38,0,15 best football celebration time
1,1,11,36,0,9,0,47,0,tv character halloween year
1,1,9,24,0,8,0,33,0,excuse make going gym
1,3,8,43,0,8,0,51,0,scientist turn spinach leaf beating human heart cell
1,1,12,41,1,11,0,53,0,here's actually need know growing hair
1,2,3,39,3,7,0,42,0,elon musk's next move: merging brain computers?
1,1,8,32,0,8,2,40,0,20 super sexy maternity option knocked
1,2,8,46,1,7,0,54,0,pinball craftsman hit bumper building sought-after machine
1,3,14,47,1,13,0,61,0,people relating hard teen mom got caught taking aselfie
1,1,12,33,0,11,0,45,0,guess sex toy regular shit
1,1,11,42,2,10,0,53,0,"ricky gervais officially back david brent ""the office"""
1,1,6,20,0,6,2,26,0,18 truth people love wine
1,1,10,35,0,10,2,45,0,18 thing girl height boyfriend know
1,2,12,29,5,9,0,41,0,aspirational r.s.v.p.: saying yes mean
1,1,5,19,0,6,6,24,0,15 best accidental butt 2015
1,1,11,30,3,8,0,41,0,"well know kristen wiig's ""snl"" character"
1,1,7,30,1,6,2,37,0,22 drool-worthy instagrams follow year
1,1,8,34,2,7,0,42,0,said it: disney princess vs. kardashian edition
1,1,16,37,0,12,0,53,0,walk dark room without stepping lego brick
1,1,8,29,0,8,2,37,0,17 worst dare people actually done
1,1,14,50,3,14,2,64,0,"34 fact probably know ""harry potter order phoenix"""
1,1,15,36,1,12,0,51,0,omg middle finger emoji arrived here's get
1,1,13,57,0,12,0,70,0,ryan reynolds perfect response sexist marketing superhero movie
1,3,1,66,1,11,0,67,0,"common issue ruin relationship, according couple counsellor"
1,1,7,29,1,6,2,36,0,17 rey-inspired product actually buy
1,2,11,47,2,9,0,58,0,exclusive: sean spicer give cnn public dressing-down press gaggle
1,1,12,35,1,11,0,47,0,draw turkey that's good everyone freak
1,1,6,26,0,6,2,32,0,18 really funny tumblr makeup post
1,2,12,52,4,12,2,64,0,10 best fashion moment beyonce's 'b'day anthology video album'
1,3,9,25,4,7,0,34,0,here first look x-filesreboot
1,1,12,42,2,12,2,54,0,"20 reason stile stilinski ""teen wolf"" man dream"
1,1,9,22,0,9,6,31,0,15 beloved tv show said goodbye 2015
1,1,10,36,0,10,2,46,0,19 thing family three people know
1,1,13,36,3,10,0,49,0,"""ahs: hotel"" character based zodiac sign"
1,1,6,27,0,5,0,33,0,write autobiographical novel
1,3,10,47,2,10,0,57,0,"depp, dicaprio, clooney top list overpaid actor hollywood"
1,1,10,46,0,9,0,56,0,twentysomething stereotype based zodiac sign
1,1,7,34,0,7,2,41,0,25 present people fucking love stationery
1,2,7,32,2,7,4,39,0,must-hear music podcast: best album 2016 edition
1,1,7,30,2,7,2,37,0,14 new year's resolution we're still working
1,1,6,18,0,5,0,24,0,award show host
1,1,13,46,0,10,0,59,0,identify meryl streep movie imdb description
1,1,16,60,2,15,2,76,0,13 thing guy who's bernie sander hillary clinton looked like #demdebate
1,1,11,48,1,9,0,59,0,kate winslet officially wrote retouching l'oreal contract
1,1,10,38,0,9,0,48,0,vin diesel shut body shamers single instagram
1,3,7,30,0,6,0,37,0,weirdest record store day release ever
1,1,8,34,1,8,2,42,0,18 sweet pumpkin treat believe healthy
1,3,4,46,1,8,0,50,0,khalid masood: everything know london attacker
1,1,6,29,1,6,2,35,0,23 sign obsessed cat collecting
1,1,9,30,0,8,0,39,0,recipe fruit sushi blow mind
1,3,22,43,2,14,0,65,0,ex-undercover dea agent: drug dealer asked try product
1,3,1,43,2,7,0,44,0,homeless people 'exploited sex' online advert
1,1,15,61,0,14,0,76,0,ballet troupe performed impromptu routine flight delay slayed u
1,1,11,47,0,10,0,58,0,footballer marry based favorite action star
1,3,9,39,2,9,1,48,0,9 reason politifact unqualified label fake news
1,1,4,16,1,3,0,20,0,what's weird phobia
1,1,8,24,0,9,6,32,0,22 best peanut butter baby vine 2015
1,1,7,19,0,6,0,26,0,much chocoholic
1,1,12,40,2,11,0,52,0,"""harry potter"" moment wish could happen real life"
1,1,9,46,0,9,2,55,0,15 campaign sign actually winning canadian election
1,1,9,37,5,9,1,46,0,"character ""fallout 3"" ""fallout: new vegas"""
1,1,8,33,0,8,2,41,0,26 people got shittier christmas gift
1,1,7,46,0,7,2,53,0,19 struggle naturally disorganised people understand
1,1,4,15,0,4,2,19,0,12 grim reality life
1,1,12,46,0,11,0,58,0,stevie wonder took james corden best carpool karaoke ride ever
1,1,10,34,0,9,0,44,0,guess beatles song opening lyric
1,1,12,45,1,11,0,57,0,famous magical treehouse canada know
1,3,2,30,3,5,0,32,0,melania give husband anthem 'nudge'?
1,3,6,45,4,12,0,51,0,"oh, loved you, johnny depp. see purple-tinted truth"
1,1,11,31,0,10,0,42,0,get drunk wine kathie lee hoda
1,1,11,42,2,11,2,53,0,"15 thing make cast ""scream queens"" scream bloody murder"
1,1,8,19,0,8,2,27,0,16 boozy way ring new year
1,2,18,59,2,14,3,77,0,"sc hears nirbhaya's rapist death penalty appeal, isro launch 104 rocket must read"
1,1,10,41,1,9,0,51,0,romance's hottest writing duo turned fanfic career
1,3,3,53,2,12,0,56,0,everything wanted know 'rogue one' afraid ask
1,2,11,37,4,11,0,48,0,"face a.l.s., simon fitzmaurice find fire inside"
1,3,17,49,5,13,5,66,0,28-year-old got fired built $500k-a-month business traveling world
1,1,7,38,0,6,0,45,0,anyone experience regret ejaculating
1,2,2,66,1,10,4,68,0,"philly fed manufacturing demolishes expectations, hit highest level since 1984"
1,1,2,18,0,1,0,20,0,parseltongue problem
1,1,6,30,0,5,0,36,0,jessica chastain communed ghost
1,1,12,37,1,12,2,49,0,24 first date rule straight men want die alone
1,1,10,43,1,8,0,53,0,happens everyday people re-create iconic fashion ad
1,1,5,27,0,5,2,32,0,16 slightly incorrect name animal
1,1,8,27,0,7,0,35,0,true new jerseyans ace quiz
1,1,12,30,0,11,0,42,0,might one vivid sex ed book ever
1,3,3,28,1,8,1,31,0,4 thing irs want know
1,1,6,25,1,7,6,31,0,14 tattoo make sense 2015
1,3,5,61,1,12,0,66,0,lawyer claim link ex-ny police chief unsolved long island murder
1,1,9,43,1,9,2,52,0,18 quick workout help exercise pretty much anywhere
1,1,8,33,0,8,2,41,0,18 time internet told truth grandma
1,1,9,40,1,9,2,49,0,17 thing people need glass never understand
1,3,8,30,1,9,6,38,0,17 badass woman probably didnt hear in2016
1,2,7,61,5,11,0,68,0,alice's 'resident evil' homecoming change everything (paid content sony)
1,1,5,26,1,4,2,31,0,32 jaw-dropping halloween makeup idea
1,1,14,56,1,13,0,70,0,want best friend justin bieber watching carpool karaoke
1,1,13,39,4,11,0,52,0,where's best place ever celebrated new year's u.s
1,2,4,16,0,4,0,20,0,superior chicken soup
1,1,17,52,0,14,0,69,0,meghan trainor charlie puth made uncomfortably long time amas
1,1,7,23,1,7,2,30,0,11 thing let get
1,1,8,26,0,8,2,34,0,21 cooky need make holiday
1,3,11,56,2,13,1,67,0,breast cancer trends: woman 5 state opt unneeded mastectomies?
1,1,10,38,0,9,0,48,0,sleeping position say love life
1,3,9,47,1,10,4,56,0,red carpet highlight 2017 billboard latin music awards: watch
1,2,1,34,0,10,0,35,0,worst time buy new laptop
1,1,10,35,1,10,6,45,0,25 funniest tweet 2015 grown-ass adult
1,1,11,41,0,11,2,52,0,27 picture make way much sense college student
1,3,11,40,1,9,0,51,0,footage show ufo hovering near mexican border?
1,1,11,31,0,10,0,42,0,bobby flay cat magical duo ever
1,1,5,26,0,4,0,31,0,motivational poster tweet
1,1,5,17,0,5,2,22,0,14 way transform potato
1,3,11,54,0,11,0,65,0,new york newspaper mock giant boat party following playoff loss packer
1,1,15,37,0,10,0,52,0,guy nsync react adele shattering sale record
1,1,12,51,1,11,0,63,0,india's first queer graphic anthology look freaking amazing
1,1,10,42,0,9,0,52,0,cutest treat halloween mummy nutter butter
1,3,7,32,2,8,0,39,0,trudeau (kind of) legalizing pot canada
1,2,5,63,2,12,0,68,0,lady gaga post photo new metallica 'tattoo' ahead grammy award performance
1,1,12,31,0,9,2,43,0,19 insanely unique thrift shop need visit asap
1,3,13,51,1,13,2,64,0,19 picture tweet way funny youre slightly obsessed withmakeup
1,1,7,26,0,6,0,33,0,pamela anderson cured hepatitis c
1,1,5,20,0,4,0,25,0,famous teenager
1,2,1,42,1,7,1,43,0,7 way completely killing iphone battery
1,2,7,32,2,8,1,39,0,5 dad awesomely bad dance move [video]
1,1,19,57,1,18,0,76,0,tell u feel picture we'll tell big perfectionist
1,2,10,46,0,11,0,56,0,koran verse denying jesus son god sung scottish cathedral
1,1,7,26,1,7,2,33,0,29 way design kid's dream bathroom
1,1,12,48,1,12,2,60,0,friendly reminder victoria beckham used dress like '00s
1,1,7,24,2,6,0,31,0,"well remember ""jersey shore"""
1,1,8,29,0,8,2,37,0,28 adorable animal thing need life
1,1,15,50,0,15,1,65,0,million people obsessed video mom getting 4 kid ready
1,1,10,41,4,8,2,51,0,"17-year-old created insanely detailed ""map stereotypes"""
1,1,5,14,0,4,0,19,0,mean really
1,1,5,19,1,4,0,24,0,can't remember name
1,1,7,34,0,7,2,41,0,15 gift coolest friend truly appreciate
1,2,2,34,2,7,0,36,0,beijing: city can't escape smog
1,1,9,23,1,8,0,32,0,can't fall asleep
1,3,9,41,5,9,0,50,0,'the astronaut wife club' sneak peek: cue spotlight [video]
1,1,10,39,3,9,0,49,0,"clueless american's guide ""the great british bake off"""
1,3,1,40,2,8,0,41,0,"serious yoga injuries, though rare, rise"
1,1,7,34,0,7,2,41,0,28 challenging puzzle anything basic
1,1,6,19,0,5,0,25,0,guess favorite pie
1,1,10,36,1,10,1,46,0,7 thing happen child alcoholic
1,3,9,37,1,10,0,46,0,pigeon pose: master stretch tight hip
1,2,2,41,1,9,0,43,0,angry red panda japan's new working woman
1,1,10,40,1,10,2,50,0,21 tweet getting old funny they're true
1,2,3,63,0,14,0,66,0,nbn website update allows find network available area
1,1,7,23,0,8,6,30,0,14 men made 2015 maddeningly hot year
1,1,10,30,0,9,0,40,0,guess barista writes cup
1,1,5,24,0,4,0,29,0,woman discus crushing friend
1,2,11,57,0,12,0,68,0,kevin durant finally settle longstanding debate height really
1,1,12,39,0,10,2,51,0,19 super cute dollar store diys complete bedroom
1,1,9,27,2,8,0,36,0,"much really know ""doctor who"""
1,1,10,36,2,9,0,46,0,"six merry murderess ""chicago"""
1,3,12,41,5,11,0,53,0,ann coulter: maniac running foreign policy! (its trump)
1,1,14,34,2,9,2,48,0,"12 reason kendrick sampson ""htgawm"" ultimate bae"
1,1,8,27,1,6,0,35,0,angry pop-punk christmas song
1,1,9,36,0,9,2,45,0,59 rihanna lyric need instagram caption
1,1,11,48,0,10,0,59,0,reese witherspoon think elle wood supreme court justice
1,1,7,46,0,7,2,53,0,13 weird italian expression translated literally english
1,2,7,32,2,7,0,39,0,"kodak black team yo gotti ""weatherman"""
1,1,11,33,3,8,0,44,0,na receives w.e.b. du bois medal harvard university
1,1,7,18,0,6,1,25,0,7 easy dinner tasty af
1,1,13,45,2,12,0,58,0,"watched ""home alone"" first time actually horrifying"
1,1,7,23,2,6,0,30,0,"finish quote ""elf"""
1,1,11,43,0,10,0,54,0,thing people hate talking phone understand
1,1,9,25,0,8,0,34,0,ramen never looked good
1,1,8,28,1,6,0,36,0,first celebrity ex-husband
1,1,3,10,1,2,0,13,0,lovely
1,3,9,29,0,11,4,38,0,eqt going adidas sneaker 2017
1,3,2,36,1,7,0,38,0,damian lewis webchat post question
1,1,14,45,1,13,0,59,0,asked bunch married lesbian couples: pop question
1,3,11,37,1,11,2,48,0,22 picture prove there's good world bad
1,2,15,51,0,14,0,66,0,george takei half twitter make joke russia oscar night
1,1,15,54,3,13,0,69,0,guy lost ring right proposed...and still insanely adorable
1,1,12,46,0,12,2,58,0,24 thing miley cyrus hannah montana would never done
1,3,6,41,4,5,0,47,0,comedian-in-chief: obamas funniest moment president
1,2,8,38,0,7,0,46,0,see moment conjoined twin reunite surgery
1,2,5,41,0,10,0,46,0,mccain make secret trip syria meet u troop
1,2,3,41,2,7,0,44,0,african american become organ donors?
1,1,9,35,0,9,4,44,0,watch weather people made fool 2015
1,1,11,30,1,10,0,41,0,vet saved dog's life helped see
1,3,6,22,3,7,3,28,0,huffpost headline quiz: dec. 30 jan. 5
1,1,10,36,0,9,0,46,0,picture proof people worst
1,2,1,46,3,10,1,47,0,after-care prof challenge 8-year-old med
1,1,10,37,0,10,2,47,0,19 cringiest facebook post history cringe
1,3,9,41,2,8,3,50,0,"skier accidentally fly 152-foot cliff, somehow survives"
1,1,13,44,4,12,0,57,0,"cast ""gilmore girls"" first episode, last episode,"
1,3,11,46,3,10,1,57,0,david tennant list 6 key thing (hopefully) make everything ok
1,1,7,32,0,7,2,39,0,19 honest confession ann summer worker
1,3,1,53,0,8,0,54,0,nutritionist explains food buy organically
1,1,10,31,0,9,0,41,0,rap artist based zodiac sign
1,1,8,28,0,7,0,36,0,house stark house targaryen
1,1,9,32,1,10,6,41,0,23 thing cool 2005 definitely
1,1,9,23,1,5,0,32,0,diy pore-cleansing egg white face mask
1,1,10,31,5,10,2,41,0,"18 gorgeous santa make wanna say ""ho, ho, ho"""
1,1,7,32,0,6,0,39,0,deadpool antidote superhero fatigue
1,3,2,37,2,9,0,39,0,tech treasure attic? here's quick guide
1,1,5,18,1,3,0,23,0,talking self-esteem
1,3,12,57,8,15,0,69,0,bob beckel: trump shouldnt control nuclear code he starting lose
1,1,9,26,0,8,0,35,0,much really know vance joy
1,1,6,28,1,5,0,34,0,what's favorite boozy holiday drink
1,3,1,31,0,7,0,32,0,next face poverty could
1,1,13,55,0,12,0,68,0,girl shut complicated math homework hilarious response
1,1,10,24,0,9,0,34,0,men never find damn thing
1,1,11,50,0,11,2,61,0,24 struggle people gone final week understand
1,3,6,27,1,6,4,33,0,world's reputable company 2017
1,1,13,41,0,12,0,54,0,know trump rally dance move based one question
1,1,17,64,3,16,0,81,0,"people trying make britney spear playable character ""super smash bros."""
1,1,15,59,1,14,0,74,0,martha stewart shaded wendy williams bringing fact seventy
1,1,7,24,2,7,2,31,0,15 appetizer rockin' new year's eve
1,3,8,63,2,9,0,71,0,"china tightens censorship, ban livestreaming coverage trump inauguration"
1,1,8,39,2,8,2,47,0,"19 time ""freaks geeks"" perfectly portrayed high school"
1,1,8,29,3,7,4,37,0,"48 lesson younger, 21-year-old sister taught"
1,3,3,70,2,15,0,73,0,google activity show everything company know user there lot
1,2,8,81,3,18,0,89,0,selfish work: helping others lead 'generosity burnout' damage career
1,1,15,58,3,14,0,73,0,"answer question we'll tell ""bring on"" cheerleader audition"
1,2,3,39,2,9,0,42,0,quiz: well know disney sport movies?
1,1,12,47,1,11,2,59,0,18 simple time-saving idea help prepare thanksgiving meal
1,1,7,33,2,6,0,40,0,what's weirdest question ever googled
1,1,7,22,0,7,2,29,0,20 worst time make eye contact
1,2,3,40,2,9,1,43,0,5 u.s. bank draw customer complaint
1,1,9,48,2,9,2,57,0,"27 time ""hannah montana"" accurately described college student"
1,1,7,25,0,6,0,32,0,one direction member son
1,3,11,62,4,9,0,73,0,"exclusiverep. dana rohrabacher: general flynn treated unfairly, perhaps illegally"
1,1,8,33,1,7,0,41,0,serious question: nicolas cage scrooge
1,1,8,32,0,7,0,40,0,bailee madison hailee steinfeld
1,1,9,42,0,9,2,51,0,20 christmas dachshund totally ready holiday
1,1,10,40,2,9,0,50,0,"saddest storyline ""love actually"" got even sadder"
1,2,1,24,0,6,2,25,0,two child 15 year apart
1,3,9,47,2,9,0,56,0,"golden globe awards, fort lauderdale: monday evening briefing"
1,1,11,44,0,10,0,55,0,marijuana strain smoke based zodiac sign
1,1,7,25,0,6,0,32,0,game throne made emmy history
1,1,13,62,2,12,0,75,0,"gabrielle union jimmy fallon hilariously parodied popular song ""the tonight show"""
1,1,11,34,2,10,6,45,0,15 behind-the-scenes pic vance joy 1989 world tour
1,2,12,48,2,13,0,60,0,rescued pit bull's smile cutest thing see today insider
1,1,13,49,0,12,0,62,0,disney hero villians look like face swapped
1,2,4,49,0,10,1,53,0,7 picture paul nuttall looking slightly miffed list
1,1,9,38,0,8,0,47,0,asked american react canadian election thing
1,1,10,33,0,9,0,43,0,pop princess based birth month
1,2,18,49,2,15,0,67,0,"justin trudeau host ama quora, post picture prove really"
1,1,14,43,2,14,2,57,0,"24 time ""how get away murder"" cast gave u serious squad goal"
1,1,15,56,2,14,0,71,0,"full breakdown long feud involving amber rose, kanye west, kardashians"
1,1,11,31,0,11,2,42,0,22 thing anyone ever cell phone get
1,1,8,29,1,7,0,37,0,hear clip good charlotte's comeback song
1,1,13,39,3,10,0,52,0,"cheap, pre-fab hobbit house thing they're whimsical af"
1,1,9,31,0,7,0,40,0,tv family spend christmas
1,3,13,62,2,16,4,75,0,forbes mag: iran cool travel destination 2017 visitor must adapt sharia law custom
1,1,11,41,0,10,0,52,0,illustration show feel like migraine
1,1,9,32,2,8,0,41,0,what's best thing seen veterinarian
1,3,2,42,0,10,0,44,0,common birthday world list
1,2,1,20,0,3,0,21,0,president visuals
1,1,8,34,0,8,2,42,0,29 photo make developer laugh every time
1,2,9,57,3,9,0,66,0,new parchment declaration independence surfaces. head-scratching ensues.
1,1,8,21,0,7,0,29,0,much really love dog
1,1,8,18,0,5,0,26,0,youtube youporn
1,2,3,58,2,13,0,61,0,man's commentary ny train giving zero f*cks people comedy gold
1,1,10,38,2,10,2,48,0,here's biggest halloween costume year '90s
1,1,10,44,0,9,0,54,0,identify architectural landmark one small detail
1,1,6,32,0,6,2,38,0,19 thing bridal stylist understand
1,1,4,13,0,3,0,17,0,deadpool
1,1,9,36,2,9,2,45,0,27 tweet speak every britney spear fan's soul
1,3,1,56,1,12,0,57,0,id never heard condition terrible joint pain set
1,2,1,49,0,12,0,50,0,airline making harder u buy cheap ticket
1,3,1,38,1,8,6,39,0,21 hottest women-founded startup watch 2017
1,1,12,44,0,12,2,56,0,27 hilarious tweet med school make laugh cry
1,1,8,36,0,8,2,44,0,18 difference snow day canada america
1,1,10,45,0,10,2,55,0,17 thing people crazy low blood pressure understand
1,1,7,28,0,7,2,35,0,15 travel tip every introvert need know
1,1,9,35,0,9,2,44,0,23 recipe prove meal complete without fluff
1,2,9,35,0,9,2,44,0,19 cleaning tip neglected corner home
1,1,9,33,1,8,0,42,0,time realize britney spear actually god
1,3,7,35,2,7,0,42,0,man make 'crying jordan' uniform softball team
1,1,15,50,1,14,0,65,0,look like taylor swift calvin harris maybe broken
1,1,15,44,3,11,0,59,0,"joseph gordon-levitt made diy yoda costume ""star wars"" premiere"
1,2,4,22,1,3,0,26,0,adventurous father day gift
1,1,12,41,0,11,0,53,0,guy calculated much money spent saving matt damon
1,1,7,29,0,7,2,36,0,32 parent totally nailed halloween
1,3,2,36,8,10,0,38,0,we're recession. that's good news ... it?
1,1,11,38,0,11,2,49,0,54 lady gaga lyric need fire instagram caption
1,1,8,34,2,7,0,42,0,sonakshi sinha's knee look like satish shah's face
1,1,11,46,1,9,0,57,0,bear/dog creature stumped internet identified
1,1,9,32,0,8,0,41,0,marvel movie looking forward
1,1,11,33,1,10,0,44,0,like kiss another woman first time
1,1,13,37,0,14,6,50,0,21 thing scotland rest world need get 2016
1,1,9,43,0,8,0,52,0,scientist sharing unusual bucket list twitter
1,1,12,68,1,11,0,80,0,police started woman's stabbing investigation farhan akhtar intervened
1,3,8,42,3,8,0,50,0,angelina jolie slam refugee order: trump playing fire
1,2,1,38,0,9,0,39,0,company want bring dog work
1,1,15,44,2,14,0,59,0,"guess many time gigi hadid touched hair ""how deep love"""
1,1,9,28,0,9,2,37,0,13 woman show shoe feel sexiest
1,1,15,46,0,14,0,61,0,know member friend group based zodiac sign
1,1,10,28,1,9,0,38,0,"people always cold, stay warm"
1,1,11,40,3,11,2,51,0,"18 time pam beesly proved best character ""the office"""
1,1,7,27,1,6,0,34,0,ode yolanda foster's malibu mansion
1,1,10,43,1,10,2,53,0,17 picture perfect obsessed fried chicken
1,1,9,23,0,8,2,32,0,17 subtle way make home creepy af
1,3,4,66,0,12,0,70,0,mysterious discovery water china awaken inner indiana jones
1,3,4,78,3,12,1,82,0,february recap: 5 trending topic spark watercooler conversation (sponsored content belvita)
1,2,15,60,6,14,0,75,0,"shahid-mira's cute banter, dangal's national anthem leaf twitterati fix ent!"
1,1,11,28,0,10,0,39,0,guy wore heel day felt pain
1,1,11,35,1,11,2,46,0,18 thing understand live lazy house
1,1,16,50,2,15,0,66,0,"choose path see survive fire swamp ""the princess bride"""
1,2,2,74,3,15,0,76,0,u.s. city using crazy device block drivers' vision pay fine
1,1,8,35,0,7,0,43,0,identify celebrity smile
1,2,10,48,3,10,2,58,0,10 can't miss tax deduction small business self-employed person
1,1,5,12,3,4,0,17,0,"i'm adopted, i'm"
1,3,3,41,0,7,0,44,0,trump abortion funding cut could affect africa
1,1,11,45,1,10,0,56,0,bring office's white elephant gift exchange
1,1,6,26,0,5,0,32,0,netflix original series
1,1,8,37,0,8,2,45,0,40 thought everyone start raining outside
1,1,10,33,0,9,0,43,0,remember theme andy milonakis show
1,1,6,27,0,6,2,33,0,14 couple definitely breaking
1,1,7,39,0,6,0,46,0,magical world underground night personality
1,3,2,42,1,10,0,44,0,map: find common cause death county
1,1,8,38,1,7,4,46,0,hair-raising photo world beard championship 2015
1,1,5,10,0,4,0,15,0,dad dad
1,3,2,45,2,12,0,47,0,"one thing today, click video list"
1,1,10,40,2,10,2,50,0,"29 perfect comeback ever happened ""friends"""
1,3,5,54,3,8,0,59,0,"football transfer rumours: koscielny, giroud sissoko marseille?"
1,1,14,46,0,13,0,60,0,enya heard stressed released soothing new song help
1,1,11,43,0,10,0,54,0,thing wish someone told emotionally abused
1,3,10,55,0,13,0,65,0,nasa study reveals much radiation really hit travel plane
1,2,4,59,2,13,0,63,0,'the big bang theory' continue haunt television year come
1,1,14,51,2,13,0,65,0,"katniss tell johanna snow die exclusive ""hunger games"" clip"
1,3,1,30,0,7,4,31,0,ombre biggest design trend 2016
1,1,9,30,0,8,0,39,0,netflix chilling
1,1,7,36,0,7,1,43,0,3 minute christmas hallmark movie hilarious
1,2,2,54,2,6,0,56,0,building future: singapore's stunning architectural project
1,1,9,30,0,8,0,39,0,look amazing cat go adventure
1,1,7,34,2,6,0,41,0,"""neon genesis evangelion"" character"
1,1,6,25,0,5,0,31,0,animal match birth month
1,2,7,20,1,7,0,27,0,really work bad diet?
1,1,10,27,2,10,1,37,0,"first trailer ""i cait"" season 2"
1,1,6,21,1,5,0,27,0,hogwarts xavier's
1,1,6,22,0,5,0,28,0,solve logic riddle
1,2,8,35,1,8,4,43,0,here's millennials preparing success 2017
1,1,6,29,0,6,2,35,0,17 unusual beautiful russian baby name
1,1,12,47,4,11,0,59,0,"kendall jenner told kim kardashian ""pregnant,"" kim gave fuck"
1,3,7,33,0,7,2,40,0,29 gift true makeup addict appreciate
1,3,1,20,3,4,0,21,0,'i'm allergic husband'
1,1,7,29,3,6,0,36,0,"dead ""grey's anatomy"" character"
1,1,12,41,0,11,0,53,0,top gear seven presenter people taking piss
1,2,12,43,4,13,0,55,0,watch: spicer asked feel work fascist? apple store
1,1,12,48,0,11,0,60,0,guess music video featuring nicki minaj screenshot
1,2,1,70,1,12,2,71,0,15-minute quiz give scientifically accurate assessment personality
1,1,10,52,1,10,2,62,0,15 sickeningly adorable celebrity couple tweet honor valentine's day
1,1,10,31,3,7,0,41,0,"""ahs: hotel"" character match star sign"
1,2,2,9,1,4,8,11,0,30 30 2017: sport
1,2,2,35,0,7,0,37,0,uruguayan jail inmate set shop
1,1,10,45,2,9,2,55,0,13 apps make iphone-android relationship much better
1,1,10,33,4,10,2,43,0,"katie holmes say ""dawson's creek"" '90s reboot"
1,1,10,47,2,10,2,57,0,"14 reason ""the muppet christmas carol"" ultimate christmas movie"
1,1,9,33,2,8,0,42,0,"""family guy"" moment make laugh every time"
1,2,3,38,2,8,4,41,0,'detroit' trailer sends john boyega back 1960s
1,3,14,43,3,12,0,57,0,"people keep making joke ""house hunters"" funny af"
1,2,11,65,2,10,0,76,0,"unlike house colleagues, senate democrat attending trump inauguration"
1,1,12,39,0,12,2,51,0,21 picture way real people always tired
1,2,9,40,4,10,0,49,0,nobel-winning sexism lab room debate nytimes.com
1,1,12,48,1,13,3,60,0,harry potter fan turned platform 9 3/4 memorial alan rickman
1,2,1,52,0,9,0,53,0,teen surprised giant graffiti penis lurking senior photo
1,1,12,39,0,11,0,51,0,pastry chef match treat outfit work
1,1,7,36,2,7,2,43,0,"13 time ""sesame street"" parody completely nailed"
1,1,13,46,0,12,0,59,0,portrait cat shaking clean need see today
1,3,0,39,1,7,1,39,0,7 mega-billionaires made fortune last year
1,1,11,39,2,11,4,50,0,17 gift food-obsessed people $25 amazon
1,3,16,46,2,15,0,62,0,"meet happiest dog world, maru husky also look like panda!"
1,1,11,45,0,10,0,56,0,identify chocolate smashed
1,1,10,38,0,10,2,48,0,15 thing anyone alcohol allergy tired hearing
1,1,8,36,0,8,2,44,0,25 vanity basically porn makeup addict
1,1,7,29,1,4,0,36,0,#freethenipple investigated naked mike
1,1,9,29,0,9,2,38,0,37 best meme canada internet
1,3,7,23,0,6,0,30,0,retailer beat amazon
1,3,7,35,0,7,2,42,0,15 tweet anyone student loan understand
1,1,11,51,2,11,2,62,0,"32 artist across globe created insane snapchat trailer ""deadpool"""
1,1,5,21,0,4,0,26,0,confident actually
1,1,8,34,0,8,2,42,0,29 amazing literary magazine need reading
1,1,9,26,0,8,0,35,0,tried hot new street drug zank
1,1,7,32,0,7,2,39,0,14 text socially anxious people send party
1,3,6,25,0,7,0,31,0,going run could extend life
1,2,10,44,3,9,0,54,0,left wing vegan denied swiss passport shes annoying
1,2,11,37,2,12,6,48,0,need new year's resolution? 10 idea stronger career 2017
1,1,7,31,0,7,4,38,0,early 2000s disney show match zodiac
1,1,13,25,0,10,0,38,0,know funny cat gif need see today
1,1,9,34,3,9,0,43,0,black ever crack? -- guess black celebs age
1,1,10,27,0,9,0,37,0,learned drink goddamn gin
1,3,1,35,0,9,0,36,0,man wire smart home comfy life
1,3,9,35,2,9,0,44,0,"nivea pull ""white purity"" ad one obvious reason"
1,1,12,36,2,11,0,48,0,"dear world, word advice india: butt dirty"
1,2,18,62,0,14,0,80,0,man beaten cricket bail criticising pm modi demonetisation long atm queue
1,2,11,40,1,11,2,51,0,21 thing youll understand love people also hatethem
1,3,8,34,3,9,2,42,0,fast food cheat-sheet: here order 10 chain
1,1,9,34,0,8,0,43,0,fooled basic science question
1,1,8,35,0,8,2,43,0,13 confession big butt surprise
1,3,2,65,3,13,0,67,0,"pre-suasion: influence people give job, according psychologist"
1,1,10,31,0,10,2,41,0,19 gift every booze lover need ask year
1,1,9,38,0,10,6,47,0,22 little thing teenage girl obsessed 2004
1,3,5,37,5,8,0,42,0,anna soubry: 'i'll never forgive boris johnson' video
1,1,11,36,1,9,2,47,0,15 nyc restaurant try obsessed instagram
1,2,13,58,2,11,0,71,0,miss carrie fisher even watching ellen degeneres' touching tribute
1,1,7,27,1,6,0,34,0,hilary duff's new purple hair gorgeous
1,1,8,29,0,8,2,37,0,23 gift make makeup lover swoon
1,1,10,33,0,10,2,43,0,20 thing make breakup hurt much less
1,1,15,71,4,13,0,86,0,"adele's classroom-instruments rendition ""hello"" jimmy fallon root obviously amazing"
1,1,8,31,0,7,0,39,0,cher destroys donald trump one little tweet
1,2,11,39,1,9,0,50,0,non-traditional wedding hit right thefeels
1,1,13,44,1,12,0,57,0,"guess what, british people taking piss donald trump"
1,2,5,31,0,6,0,36,0,printable super bowl li prop bet scorecard
1,1,12,48,2,10,0,60,0,here's favourite british heart-throbs looked like decade ago
1,1,11,34,0,11,2,45,0,22 home decor piece make wish dead
1,3,11,32,1,11,1,43,0,9 question determine youre type typeb
1,1,9,50,0,8,0,59,0,people touching reaction confronted homophobia
1,1,7,26,0,7,2,33,0,11 shibas keep getting stuck thing
1,1,11,31,0,11,2,42,0,18 picture way real brother
1,3,6,28,2,7,0,34,0,"trump policy reversals, word"
1,1,9,39,0,9,2,48,0,27 thing always happen office christmas
1,2,7,31,4,5,3,38,0,gun-controlled chicago: 400 shot year-to-date
1,1,11,43,0,10,0,54,0,dessert valentine based zodiac sign
1,2,2,30,3,4,0,32,0,"news quiz: location, location, location"
1,2,3,36,1,7,0,39,0,learned sean spicer's first briefing
1,1,7,22,0,6,0,29,0,disney home live
1,1,9,48,0,9,2,57,0,18 insanely delicious vegan christmas cooky santa would approve
1,1,9,26,0,9,2,35,0,17 reason natural hair good look
1,1,9,32,0,9,2,41,0,17 face paleta payaso made could relate
1,3,19,71,2,21,6,90,0,story umerkot pakistani town 80% hindu population till 1965 war undid social fabric
1,1,10,44,2,9,0,54,0,"tyler ford answer question identity, style,"
1,1,7,44,0,7,2,51,0,17 incredibly helpful chart cooking thanksgiving dinner
1,1,7,31,0,6,0,38,0,breastfeeding really look like
1,1,14,51,2,13,0,65,0,"must watch cast ""downton abbey"" reenact scene american accent"
1,1,9,37,1,8,2,46,0,26 kid halloween gender-bent costume
1,3,14,61,4,13,0,75,0,sanya celebrated fatima's birthday epic 'dangal' cake picture adorable!
1,1,9,36,0,9,2,45,0,17 time internet perfectly summed cancer
1,1,11,54,0,10,0,65,0,twitter skewered steve harvey announcing wrong miss universe winner
1,3,9,36,3,7,0,45,0,dhs remove obamas handcuff border patrol agent
1,1,9,28,0,8,0,37,0,choice color say
1,1,14,48,2,13,0,62,0,"""how get away murder"" character partner crime"
1,2,3,52,1,8,0,55,0,free online resource improve productivity business insider
1,3,15,43,0,15,2,58,0,99 thing improve life life aroundyou
1,3,10,35,1,9,0,45,0,"tried quit sugar, failed without realizing"
1,2,2,33,2,6,0,35,0,virus lottery: could next epidemic?
1,1,11,37,1,10,0,48,0,emma stone music video queen we've always dreamed
1,1,12,26,1,8,0,38,0,rihanna dyed hair blue pretty zomg
1,3,1,61,3,11,4,62,0,"2,000 year later, scientist finally know what's charred roman scroll"
1,1,12,40,0,12,2,52,0,spike lee look back 19 movie defined career
1,1,5,21,0,4,0,26,0,intensely michigan
1,1,10,32,0,10,2,42,0,18 people forgot already word
1,2,10,47,4,11,0,57,0,jane fonda pitch trumpers adult diaper help leak
1,2,1,44,1,8,0,45,0,"dating apps making people less picky, study claim"
1,1,12,31,0,11,0,43,0,tried kylie jenner lip kit great time
1,3,2,35,1,6,2,37,0,beach holiday world's 20 greatest beach
1,1,7,18,1,8,4,25,0,17 way look like '90s dream babe
1,3,7,25,6,10,4,32,0,"politico scoop: donald trump may 6 2, 6 3"
1,1,13,45,1,12,0,58,0,here's accidentally made old avril lavigne death hoax go viral
1,1,8,25,0,8,2,33,0,26 powerful photo week
1,3,2,34,0,6,0,36,0,swedish class reacted migrant visit
1,1,8,31,1,8,2,39,0,18 picture understand weird hell
1,3,9,27,0,6,0,36,0,espn loses half million subscriber
1,1,15,48,0,11,0,63,0,nasa released breathtaking photo southern india taken space
1,1,9,27,0,8,0,36,0,animal allowed round
1,1,9,33,2,7,2,42,0,19-year-old girl look exactly like kylie jenner
1,2,2,28,1,6,0,30,0,could thing get worse trump?
1,1,8,39,1,8,2,47,0,19 surprising thing probably know herpes
1,1,6,25,2,5,0,31,0,"character ""awkward"""
1,1,15,61,1,12,0,76,0,#missuniverseintro hashtag prof filipino take beauty pageant whole new level
1,2,3,48,1,11,0,51,0,travel truth really like travel blind person
1,1,11,32,4,8,0,43,0,gfs shaved bfs' faces... blood everywhere
1,1,13,45,0,12,0,58,0,runner getting noticed inspiring people run size
1,3,8,33,3,11,4,41,0,2017 year smart home: whats stopping you?
1,2,1,41,1,8,0,42,0,snowy hill prof every car's worst nightmare
1,2,1,88,4,23,4,89,0,"every mammal (including humans), take 12 second poop word man spends 15 minute loo"
1,3,6,20,0,6,1,26,0,5 great book read indecember
1,1,9,32,0,9,4,41,0,ryan curry definitely cutest baby born 2015
1,2,4,48,2,6,0,52,0,berlin attack: so-called islamic state claim responsibility
1,3,16,21,2,9,1,37,0,know all: thursday top 7 story nbc news
1,2,8,42,2,8,0,50,0,"donald trump, fort lauderdale: friday evening briefing"
1,1,11,45,2,11,2,56,0,23 thing relate slightly obsessed makeup
1,2,3,38,1,8,0,41,0,catalonia try secede spain year?
1,1,14,47,1,13,0,61,0,went lauren conrad's fashion show lived high school fantasy
1,3,4,45,1,10,0,49,0,there's huge problem donald trump tweet list
1,1,12,43,1,11,0,55,0,three question tell disney movie star
1,3,10,34,1,8,0,44,0,beat year-end rush three financial move
1,1,4,15,0,3,0,19,0,lumbersexual
1,1,15,45,0,12,0,60,0,jake gyllenhaal wrote letter kfc bring back chicken little
1,1,12,43,0,11,0,55,0,mother finally opened depression anxiety
1,1,7,20,0,6,0,27,0,friend coffee snob
1,1,8,32,0,8,2,40,0,27 adorable giraffe product need life
1,1,10,38,1,8,0,48,0,dude tinder profile overhauled co-worker
1,1,8,45,0,8,2,53,0,24 spectacular coincidence make question reality
1,1,5,27,0,4,0,32,0,problem book lover understand
1,1,7,28,0,6,0,35,0,pop anthem match birth month
1,1,8,23,0,7,2,31,0,20 reason marty mcfly flyest guy
1,3,6,38,3,5,0,44,0,nancy pelosi: obamacare bipartisan legislation
1,1,6,24,1,5,0,30,0,cheap vs. expensive vodka taste test
1,1,9,37,1,8,0,46,0,tried perverted men's halloween costume
1,1,9,26,1,6,0,35,0,psa: leg shaving season officially
1,2,1,56,0,10,1,57,0,moment 2 quiz show contestant gloriously awkward
1,1,8,36,0,7,0,44,0,illustration capture joy living alone
1,1,8,29,2,7,0,37,0,"""house hunters"" spinoff"
1,2,6,57,2,12,2,63,0,anti-trump movement calling boycott 36 dapl-linked bank
1,1,6,30,0,5,0,36,0,weird thing sibling believed growing
1,3,12,37,1,11,0,49,0,pretend buy jewellery we'll guess old
1,2,12,48,3,11,0,60,0,"look closely, lady gagas halftime show seemed very, political"
1,2,14,47,4,12,1,61,0,remember lionel messi's 5-year-old afghan fan? finally got meet idol
1,1,3,25,0,3,2,28,0,14 scandalous teacher confession
1,3,12,43,2,11,0,55,0,like transgender teacher donald trump's america
1,1,9,41,1,8,0,50,0,couple craziest wedding crasher: president
1,1,9,28,2,8,0,37,0,"really know word ""breaking free"""
1,1,8,30,0,8,2,38,0,23 gift every unicorn lover need life
1,2,14,41,2,11,0,55,0,"imo, early december best time start new year resolution"
1,1,8,35,3,8,2,43,0,"50 thing probably know ""love actually"""
1,1,8,33,0,9,6,41,0,18 thing differently dating 2016
1,2,2,50,3,9,0,52,0,'broadchurch' best british crime show watching
1,3,9,36,1,9,0,45,0,job protect internet trolls?
1,1,8,33,0,8,2,41,0,21 apps make christmas shopping easy
1,2,14,41,0,13,0,55,0,word test reveal think head heart
1,3,3,49,1,8,0,52,0,seven surprising moment past super bowl half-time show
1,1,11,35,0,9,0,46,0,youtube beauty guru based one question
1,1,9,31,0,10,6,40,0,21 thing everyone wear uggs 2016 relate
1,2,4,37,0,11,2,41,0,top 20 party city u canada
1,1,12,41,0,11,0,53,0,someone india bakchod office lost damn mind
1,1,10,46,2,9,0,56,0,"miley cyrus sent britney spear ""britney"" balloon birthday"
1,1,11,44,0,10,0,55,0,holiday shopping looked like way black friday
1,3,11,41,0,11,2,52,0,14 thing woman advert honestly make fuckingsense
1,3,8,37,3,7,0,45,0,"hurrah, dollar flowing (almost) normally"
1,1,12,44,0,11,0,56,0,canadian nightclub put crazy donald trump mural bathroom
1,3,12,48,2,11,2,60,0,sephora's top 10 best-selling lipstick mix obvious unexpected
1,2,2,45,0,8,0,47,0,japanese people wrapping cloth
1,2,7,42,0,7,0,49,0,suspected car bomb explodes swedish capital stockholm
1,1,11,41,0,10,0,52,0,canadian cop best response underage booze party
1,1,11,38,0,10,0,49,0,karaoke song sing based zodiac sign
1,3,2,29,1,7,4,31,0,2017 oscar party picture
1,1,9,35,1,8,2,44,0,14 mind-blowing shaadi outfit idea every lazy girl
1,2,8,42,2,8,2,50,0,"literally 34 hilarious tweet ""the bachelor"" finale"
1,1,11,38,0,10,0,49,0,know best worst quality based one question
1,2,15,46,2,14,0,61,0,google flight guy purchase flight 'the best time buy now'
1,3,1,45,3,8,0,46,0,know president's 'designated survivor'
1,1,11,50,1,9,0,61,0,friendly reminder joseph gordon-levitt adorable child
1,1,8,31,0,8,2,39,0,19 homemade food gift actually make
1,1,9,44,1,8,0,53,0,animal control investigated kylie jenner dogs' weight
1,2,12,68,4,15,0,80,0,"nod gender inclusivity, university minnesota drop king queen homecoming title"
1,3,4,70,0,15,0,74,0,someone pointed exactly theresa may scared election list
1,1,11,41,2,10,0,52,0,"steven moffat took ""which doctor companion you"" quiz"
1,2,1,65,3,13,0,66,0,"kid headed college, doesnt mean theyll graduate"
1,1,10,42,0,9,0,52,0,everything need know new favorite supermodel
1,3,13,58,5,13,0,71,0,glenn thrush: inbox flooded democrat saying ossoff terrible candidate
1,3,12,53,0,12,2,65,0,absurd forever 21 choker people hilariously done chokertrend
1,3,3,62,1,13,6,65,0,"250,000 patient forced change surgery record number gp practice close"
1,1,9,34,0,8,0,43,0,much actually know vegetarian food
1,2,17,54,1,14,1,71,0,ibmvoice: 6 thing know mobile wallet use holiday season
1,1,10,31,2,9,2,41,0,23 fast-food item never see life
1,1,5,15,0,6,6,20,0,19 best horror film 2015
1,1,10,26,0,9,0,36,0,far would make hunger game
1,1,8,25,0,5,0,33,0,misconception ocd
1,1,10,43,1,9,0,53,0,here's iconic movie poster look like without word
1,1,11,36,3,8,0,47,0,"chance rapper's ""snl"" performance give chill"
1,1,7,17,0,6,2,24,0,26 time taylor swift af
1,3,1,18,0,6,6,19,0,12 best video game 2016
1,1,9,31,1,10,6,40,0,15 indian stop winning life 2015
1,3,12,42,1,12,0,54,0,greatest super bowl win leaf doubt: tom brady best ever
1,3,4,67,0,16,0,71,0,great grandmother praying lord ring figurine year list
1,2,1,50,0,10,0,51,0,place child unlucky name
1,3,8,50,0,8,0,58,0,chinese component found north korean rocket despite sanction
1,1,11,41,4,9,1,52,0,"9 wtf question ""double, double, toil trouble"" left unanswered"
1,1,7,25,1,7,1,32,0,7 way totally ignore man's ball
1,1,8,27,0,8,1,35,0,5 stage getting first grey hair
1,1,12,46,2,11,0,58,0,"""the vampire diaries"" character based zodiac sign"
1,1,10,34,0,9,0,44,0,coast united state actually best
1,3,9,42,1,9,6,51,0,ap college basketball poll 2017: complete week 17 ranking released
1,2,2,54,0,12,1,56,0,2 hidden iphone feature change way get text
1,2,4,61,3,11,0,65,0,mark cuban explains twitter experiment: 'just knew would drive people crazy'
1,1,7,23,1,6,0,30,0,"dear dixie chicks, really need"
1,2,12,48,0,12,1,60,0,6 country must visit since currency got cheap last year
1,1,11,36,0,10,0,47,0,finally bought amazon echo happened
1,1,16,64,0,15,0,80,0,anne hathaway shared empowering photo paparazzo tried take picture baby bump
1,2,7,30,0,6,0,37,0,pornhub crowdfunds first porn shot space
1,3,2,47,3,11,0,49,0,"control planet earth, control"
1,1,12,34,1,11,0,46,0,favorite part man's body say
1,1,7,27,0,7,2,34,0,21 uncle thing ever happened
1,1,9,41,0,9,2,50,0,18 reason single winter actually amazing
1,1,8,38,0,8,2,46,0,22 time russell brand actually really fucking funny
1,2,9,51,1,9,0,60,0,report: malia obama attends dakota access pipeline protest sundance
1,2,4,44,1,10,0,48,0,truth behind world's reliable iq test list
1,2,10,30,1,8,1,40,0,silicon valley nervous h-1b reform
1,3,3,46,0,11,0,49,0,people regret voting trump list
1,3,10,37,2,12,5,47,0,cloud container news made headline 2016 -- part 1
1,1,10,40,0,9,0,50,0,tell difference shawn aaron ashmore
1,1,9,32,1,8,0,41,0,lady gaga's new disco cover make weekend
1,1,10,42,0,9,0,52,0,one question determine favorite type climax
1,1,9,34,0,9,2,43,0,19 thing happen sunday scaries
1,1,9,23,3,8,2,32,0,"23 ""x-files"" gift world"
1,1,15,50,3,14,0,65,0,"""growing name"" hashtag capture like unique name"
1,1,9,34,0,9,2,43,0,21 dessert delicious colorful
1,2,1,48,1,8,0,49,0,america's hottest investment product go global
1,1,15,48,2,14,0,63,0,"justin bieber dropped ""hotline bling"" remix give much life"
1,2,9,39,1,9,2,48,0,22 joke probably shouldnt laugh definitelywill
1,1,12,44,0,11,0,56,0,one feature apple watch actually helped quit smoking
1,3,11,24,0,8,2,35,0,23 recent book woman read asap
1,1,6,29,0,6,2,35,0,19 internet hack every student know
1,1,10,35,0,9,0,45,0,guess popular music video view
1,1,12,41,0,11,0,53,0,people really pissed taylor swift album year
1,1,11,46,4,8,0,57,0,"here's body-positive reason modcloth ditched ""plus"" section"
1,3,10,51,0,11,2,61,0,top 10 holdover obama bureaucrat president trump fire remove today
1,1,11,40,0,11,2,51,0,18 thing everyone intense fear height relate
1,3,11,37,1,11,4,48,0,here favorite emo dude 2000s look likenow
1,1,19,52,1,17,0,71,0,groom put every guy shame creating mash-up song wedding vow
1,1,8,31,2,8,2,39,0,here's favorite '90s toy look like today
1,1,8,47,0,8,2,55,0,32 impossibly delicate engagement ring utter perfection
1,1,6,25,0,6,2,31,0,15 amazing woman know better
1,3,5,44,2,10,0,49,0,quiz: know brand chose famous colors?
1,1,13,45,1,12,0,58,0,guy surprised girlfriend corgi best thing ever
1,1,9,27,0,8,0,36,0,keep romance alive kid
1,1,6,27,0,5,0,33,0,made people try unusual toothpaste
1,1,6,29,0,6,2,35,0,19 food truth texan would understand
1,2,13,52,3,12,1,65,0,china rising downloads falling: 5 takeaway ifpi's global music report
1,2,2,62,3,12,5,64,0,"average british woman spends 70,000 appearance lifetime, research find"
1,1,9,32,0,9,2,41,0,19 hideaway clear head london
1,2,11,43,2,10,0,54,0,"""cash ousside"" teen defies expectation whitegirls"
1,1,11,44,2,10,0,55,0,missy elliott's new video everything ever wanted
1,1,8,30,0,7,0,38,0,people get tattoo regret covered
1,1,11,35,1,10,0,46,0,"best jim pam moments, ranked order cuteness"
1,3,2,32,2,6,0,34,0,vet 'euthanised' taiwan
1,3,3,65,4,12,2,68,0,"without tip 19-year-old, tom brady's stolen jersey might recovered"
1,3,10,48,2,10,2,58,0,18 picture youll understand youre permanently tattooed apencil
1,3,16,60,3,16,0,76,0,"kapil admits arguing sunil, jacqueline justin bieber's tour guide ent"
1,1,6,26,0,5,0,32,0,hangover cure internet swears
1,1,6,18,0,5,0,24,0,suck canadian
1,2,9,23,1,8,2,32,0,17 giant mug need thirsty af
1,1,8,30,0,7,0,38,0,much british history actually know
1,1,13,49,1,12,0,62,0,what's favorite story time black fraternity sorority
1,1,12,40,2,11,0,52,0,"one thing never noticed ""arthur"" rock world"
1,1,13,53,1,12,0,66,0,justin bieber stormed offstage fan let wipe floor
1,1,13,42,1,13,4,55,0,know 2016 movie excited see based one question
1,1,9,32,0,9,2,41,0,19 snapchats every girl shop target sent
1,3,3,79,3,17,0,82,0,immigrant shadow austin: know right plan someone care child
1,3,1,27,0,6,1,28,0,5 largest airport world
1,3,1,39,0,10,5,40,0,9 iphone trick make life easier 2017
1,1,8,42,0,8,2,50,0,26 delectable chocolate treat seduce valentine
1,3,12,51,3,13,0,63,0,sanders: way democratic party run decade worked
1,3,4,52,0,10,0,56,0,teen pranking facebook news feed random event
1,1,4,13,0,3,0,17,0,life number
1,2,2,83,0,15,0,85,0,german supermarket known creating amazing viral ad new commercial losing weight
1,1,9,26,0,8,2,35,0,17 song make workout merry af
1,3,1,41,2,6,0,42,0,'jeopardy' contestant dy episode air
1,1,14,42,2,13,0,56,0,"hey indians, one question tell monster"
1,1,5,19,0,6,6,24,0,21 craziest fan theory 2015
1,1,5,12,0,4,0,17,0,fart work
1,2,11,62,0,12,0,73,0,rapper burned donald trump mask arrested connection violent home invasion
1,1,6,21,0,8,10,27,0,13 reason 2015 basically repeat 1995
1,1,13,49,0,12,0,62,0,cancer survivor became meme people compared stephen curry
1,1,12,58,3,11,0,70,0,"daniel radcliffe got nostalgic ""harry potter"" completely adorable"
1,1,13,44,0,12,0,57,0,gina rodriguez cutest brought dad golden globe
1,1,9,45,1,9,2,54,0,23 picture people worked retail never understand
1,2,16,54,7,13,0,70,0,"stop pitting other, all's well 'raees' srk 'kaabil' hrithik!"
1,3,0,36,0,7,2,36,0,41 incredible museum visit die
1,1,9,31,2,8,0,40,0,"funniest cold open ""the office"""
1,1,14,43,3,14,2,57,0,"taylor swift sued $42 million lyric ""shake off"""
1,1,10,29,1,9,0,39,0,here's wrap present like actual adult
1,3,9,34,0,9,1,43,0,5 way empower engage employee lead change
1,1,4,12,0,3,0,16,0,snake
1,2,8,48,1,8,0,56,0,newsweek: donald trump channel steve bannon inaugural address
1,3,6,20,1,5,0,26,0,people look like names?
1,1,14,52,0,14,2,66,0,13 beautiful reason go adventure partner year
1,2,9,42,2,10,0,51,0,"strategic eating guide expo milan, foodie world fair"
1,1,13,43,0,12,0,56,0,people mind read mentalist batshit insane
1,1,7,34,0,6,0,41,0,british adult try sweet childhood
1,1,15,39,2,15,2,54,0,"24 time daisy ridley badass real life ""star wars"""
1,1,12,37,0,11,0,49,0,easiest way egg toast breakfast
1,1,12,40,1,11,0,52,0,movie that's going emotionally wreck
1,1,10,52,0,9,0,62,0,britney spear continues perform wardrobe malfunction
1,3,2,46,0,9,4,48,0,biggest surprise snub 2017 oscar nomination
1,1,12,38,0,12,1,50,0,8 way style hair gym actually awesome
1,3,4,51,4,10,0,55,0,actually make kickstarter successful (hint: $)
1,1,15,45,2,14,0,60,0,"one question, tell worst humanity"
1,1,5,17,0,7,8,22,0,16 thing turning 16 2016
1,2,8,32,0,8,2,40,0,20 hit song literally sound exactly thesame
1,1,9,28,0,8,0,37,0,mario based zodiac sign
1,1,8,23,0,7,0,31,0,could speak mental disorder
1,1,10,39,1,10,1,49,0,fallout 4 may caused dramatic dip pornhub's traffic
1,1,9,30,2,8,0,39,0,"guess ""friends"" episode food"
1,1,9,40,0,9,2,49,0,18 apple dessert totally change life forever
1,1,15,57,1,13,0,72,0,video teenage kendall kylie jenner lip-synching taylor swift amazing
1,1,11,42,0,10,0,53,0,person might robbed graf tumblr going insane
1,1,12,31,0,11,0,43,0,guess hate based swear
1,3,13,40,3,11,0,53,0,new trump-obama phone chat 'conan' kind hilarious
1,3,11,47,2,8,0,58,0,"gop representative pull anti-cop painting, return democrat"
1,1,9,20,0,8,6,29,0,15 absolute best wwe match 2015
1,1,12,40,2,9,0,52,0,"mikaelson sibling ""the originals"" bff"
1,1,13,47,3,13,5,60,0,"50,000 people visited uber parody website let ""hire hitman"""
1,1,5,26,0,6,6,31,0,15 time priyanka chopra goddamn owned 2015
1,2,0,65,2,12,2,65,0,90-year-old man writes tip combat loneliness losing wife sister
1,3,3,58,2,13,0,61,0,chinese saying 'the ugly wife treasure home' actually mean
1,3,16,70,3,15,0,86,0,meet 'cyanide mallika' india's first woman serial killer neighbour sasikala bengaluru jail
1,2,4,57,2,10,0,61,0,celebrity conspiracy theory: marisa tomei supposed win oscar
1,1,9,32,2,8,0,41,0,"know name ""scandal"" character"
1,1,10,34,0,9,0,44,0,guess number come next sequence
1,3,11,38,1,10,2,49,0,24 porta-potty horror story shake core
1,1,9,39,2,8,0,48,0,"everything jessica jones drink ""jessica jones"""
1,2,9,47,0,9,2,56,0,26 hilarious conversation obama biden definitely thisyear
1,3,8,33,2,6,0,41,0,katharine hepburn brownie recipe nyt cooking
1,1,6,22,0,7,6,28,0,27 exciting book coming 2016
1,1,8,31,0,8,2,39,0,21 face anyone work weekend know well
1,3,4,43,2,9,6,47,0,"2017 nfl schedule: record predictions, analysis 32 team"
1,1,13,43,2,13,2,56,0,"17 ""the west wing"" trivia question true fan able answer"
1,1,10,41,2,10,2,51,0,18 thing probably know working santa's grotto
1,1,6,23,0,6,2,29,0,21 reason date canadian
1,1,4,22,1,3,0,26,0,what's secret personality
1,2,1,29,0,10,5,30,0,5 way apple get back game 2017
1,2,21,61,2,21,1,82,0,7 fatty food add grocery list cut back body fat reduce risk heart disease
1,3,10,40,6,8,0,50,0,"republican party, c.i.a., syria: thursday evening briefing"
1,3,15,61,3,13,0,76,0,"'postmortem' business going digital wake demonetisation, say pm narendra modi"
1,1,15,38,2,14,0,53,0,"ronda rousey beat crap guy ""ellen"" awesome"
1,1,8,29,0,7,0,37,0,making cheese microwave
1,1,13,52,0,12,0,65,0,way making sweet potato thanksgiving dinner
1,1,13,49,0,12,1,62,0,penelope cruz javier bardem ultimate fangirls stage u2
1,2,0,36,1,7,1,36,0,7 high-paying job people hate people
1,3,9,29,0,8,2,38,0,21 time aubrey plaza weird relatable af
1,1,3,21,0,3,2,24,0,12 pregnancy test confession
1,1,14,45,1,14,3,59,0,here's 100 year east african beauty look like minute
1,1,11,45,0,11,2,56,0,11 vegan thanksgiving side healthy delicious
1,2,12,63,3,13,0,75,0,fmr obama official farkas: disturbing rice story leaked distracted u russia
1,1,16,57,4,15,0,73,0,"demi lovato revealed disney asked ""fix"" gap teeth filming ""camp rock"""
1,1,12,43,0,11,0,55,0,top model jourdan dunn look fabulous cover vogue brasil
1,2,12,46,2,12,2,58,0,19 hilarious joke intellectual make sayme
1,1,12,26,0,9,2,38,0,10 hairstyle curly hair need try asap
1,1,4,21,0,3,0,25,0,wrapping perfect present
1,1,11,43,0,11,2,54,0,16 excellent movie watch netflix directed woman
1,1,6,16,1,4,0,22,0,wifi connect
1,1,10,41,4,9,2,51,0,"17 fact ""robot chicken"" seth green's stop-motion studio"
1,1,7,33,0,7,2,40,0,29 thing improve day immeasurably
1,3,15,53,2,15,0,68,0,"ram gopal varma lash pawan kalyan, bella thorne go topless ent"
1,1,6,29,1,7,5,35,0,32 thing karl pilkington 100% actually said
1,1,9,38,0,8,0,47,0,ghost movie required watching horror fan
1,1,14,40,0,13,0,54,0,guess marvel movie based first last line
1,1,14,46,0,13,0,60,0,watch gay marine ask singer steve grand marine corp ball
1,1,17,44,0,16,0,61,0,bride eating burger hockey game wedding dress u
1,1,6,29,1,6,2,35,0,27 way celebrate international men's day
1,1,8,19,0,9,6,27,0,24 time toast dog u 2015
1,1,8,37,0,8,2,45,0,15 bottomless boozy brunch change life
1,2,8,38,0,7,0,46,0,warren buffett explains conquered stage fright
1,1,7,25,0,7,4,32,0,healthy recipe 2015
1,1,10,40,1,9,0,50,0,caribbean people tried other's dessert blast
1,1,10,27,0,9,0,37,0,people smiling baby laptop
1,1,9,34,0,8,0,43,0,know best quality based random question
1,1,11,46,1,11,2,57,0,21 completely engrossing fan fiction able stop reading
1,3,10,45,0,9,0,55,0,people amazing vision correctly match thesecolors
1,1,7,21,1,6,0,28,0,like micropenis
1,1,7,28,0,6,0,35,0,first celebrity hookup
1,1,10,36,0,10,2,46,0,19 tweet hanukkah make laugh loud
1,1,11,32,0,11,2,43,0,week september 14 store
1,1,10,24,1,8,0,34,0,try guy watch k-pop first time
1,3,10,55,3,13,0,65,0,tulsi gabbard: need learn iraq libya intervening syria
1,2,1,14,0,2,0,15,0,crystal meth haul
1,2,6,49,1,11,2,55,0,celebrate uk coffee week one britain's 30 buzziest coffee shop
1,2,14,50,3,12,0,64,0,"yes, birth-control pill really might making feel awful, study say"
1,1,8,26,2,9,3,34,0,"10 reason ""gotham"" season 2 brand new show"
1,1,8,36,0,7,0,44,0,answer basic question michigan
1,1,5,33,0,5,2,38,0,32 strikingly beautiful wedding dress detail
1,2,10,47,4,10,0,57,0,"obama: corrosive nature talk radio, fake news ruined democracy"
1,1,9,38,1,9,2,47,0,26 thing know slightly obsessed candle
1,3,13,59,0,13,1,72,0,rujuta diwekar share 5 essential tip stay hydrated cool throughout summer
1,1,10,33,0,10,2,43,0,17 horrible pair tube sock need stopped
1,1,7,25,0,7,2,32,0,23 soccer player forgot human
1,1,6,30,0,6,2,36,0,18 unbelievably rude text anxiety
1,3,2,28,0,8,4,30,0,look africa 2017
1,2,13,37,2,13,5,50,0,"delta air line paid $11,000 fly florida weekend"
1,3,2,25,2,6,0,27,0,airbnb 'growing like weed'
1,1,13,36,0,13,2,49,0,21 worst thing say someone unique name
1,2,4,29,4,7,2,33,0,paul pierce draymond green: '3-1 lead oops'
1,1,8,35,3,6,2,43,0,19 jack-o'-lantern really understand struggle
1,1,20,65,3,17,2,85,0,22-year-old whose husband baby killed drunk driver posted gut-wrenching facebook plea
1,2,1,41,0,10,0,42,0,way could lose seat airplane
1,1,7,31,0,7,1,38,0,6 question seriously need ask
1,1,7,23,0,8,6,30,0,31 celebrity baby said hello 2015
1,1,8,34,1,7,2,42,0,18 mcdonald's hack definitely worth trying
1,2,1,25,0,5,0,26,0,people food snob
1,3,4,41,0,7,0,45,0,ivanka trump joining trump administration
1,1,13,43,3,11,0,56,0,"""the martian"" went best-selling novel blockbuster film"
1,1,9,30,0,9,2,39,0,28 way add extra flavor everything cook
1,2,0,34,1,6,2,34,0,15 fantastic non-toy gift holiday
1,1,9,31,0,9,2,40,0,21 animal vine make smile every time
1,1,12,52,1,10,0,64,0,ellen degeneres adele record voicemail greeting perfection
1,3,9,37,1,8,0,46,0,there airline people dislike even united
1,1,11,44,0,11,2,55,0,21 amazing gift people totally obsessed hair
1,1,12,37,0,11,0,49,0,eerie photo show hooked phone
1,3,3,57,3,12,0,60,0,blueprint resistance trump emerged. here look like.
1,1,8,45,0,8,2,53,0,17 winter struggle canadian parent truly understand
1,2,4,47,2,11,0,51,0,google's valentine's day game lot darker think
1,1,10,39,0,9,0,49,0,whatever happening anne hathaway good
1,1,9,28,0,8,0,37,0,life look like quiet people
1,1,7,19,0,6,0,26,0,pas cookie tin test
1,1,8,31,2,8,2,39,0,here's evolution barbie's face 56 year
1,1,13,36,2,11,0,49,0,"would happen ""goosebumps"" book set la"
1,1,10,28,1,8,0,38,0,here's taylor swift cover gq magazine
1,1,9,31,0,9,4,40,0,2015 year taylor lautner still really hot
1,1,9,38,0,8,0,47,0,hogwarts house disney prince belong
1,3,9,56,8,9,0,65,0,"trump: madonna womens march comment disgusting, disgraceful country"
1,1,9,42,1,8,2,51,0,19 life-changing way eat mashed potato thanksgiving
1,1,9,37,0,8,0,46,0,get take part menstruation conversation
1,1,6,32,0,6,2,38,0,19 time tumblr hilariously perfect timing
1,1,5,18,0,6,6,23,0,26 time trans people ruled 2015
1,1,11,42,0,10,0,53,0,jack white patrick carney allegedly almost got fight
1,1,8,42,0,7,0,50,0,artist turn pantone color delicious smoothy
1,1,8,21,2,7,0,29,0,"well know ""the maze runner"""
1,3,17,43,7,11,0,60,0,tbs-owned super deluxe game punch-a-nazi make player beat milo pulp
1,2,19,49,1,16,4,68,0,ibmvoice: top five trend watch internet thing 2017
1,1,7,30,1,6,0,37,0,here's actually start lifting weight
1,1,9,37,2,9,2,46,0,"31 important moment ""friends"" reunion"
1,1,7,30,0,7,2,37,0,19 actually stylish men follow instagram
1,1,11,41,1,11,2,52,0,17 product prove raising kid damn future
1,1,13,42,1,11,0,55,0,iphone feature shortcut most-used setting
1,3,2,44,0,7,0,46,0,angry protest gaza crippling power shortage
1,2,10,35,1,9,0,45,0,woman unsolved death freak fuckout
1,3,3,52,2,9,0,55,0,u.s. government grows seriously garbage weed research
1,1,13,40,1,10,2,53,0,12 christmas present someone never ever ever bone
1,1,7,29,0,7,2,36,0,21 minimalist product might turn
1,1,5,19,0,4,0,24,0,festive actually
1,1,8,35,0,8,2,43,0,17 gorgeous teal pumpkin anything scary
1,1,6,22,0,5,0,28,0,men talk crush friend
1,1,9,34,0,8,0,43,0,find genitalia hidden crossword
1,3,13,58,4,11,1,71,0,morgan stanleyvoice: startup reach billion-plus valuation 2 year [video]
1,3,2,59,1,10,0,61,0,news long-haul destination flight never cheaper
1,3,1,51,1,10,0,52,0,"penis subway seat, making people uncomfortable"
1,1,7,26,0,7,2,33,0,22 dog found forever home
1,3,12,63,4,11,0,75,0,report: iran violating nuclear deal secret development near off-limits parchin site
1,1,11,46,1,10,0,57,0,latinas search #latina hashtag happened
1,1,10,29,1,9,0,39,0,"taylor swift want meet you, meet"
1,1,18,68,3,17,0,86,0,"john boyega completely lost shit watched ""star wars: force awakens"" trailer"
1,1,10,40,2,10,2,50,0,"34 reason cersei badass ""game thrones"" character"
1,1,11,59,0,10,0,70,0,young trans filmmaker sundance want revolutionize trans storytelling
1,2,3,13,0,5,0,16,0,beat bot
1,1,11,44,2,10,0,55,0,pantone chose two color year represent ~gender fluidity~
1,2,8,44,1,9,3,52,0,"previously deported alien, brother busted 200 pound meth"
1,1,10,37,0,10,2,47,0,13 time headphone mission destroy beauty
1,3,20,60,3,15,0,80,0,high-intensity interval training (hiit) might instant health fix thought
1,1,4,22,1,3,0,26,0,instafamous: eyebrow queen
1,1,12,43,0,11,0,55,0,know favorite pop star based favorite disney movie
1,1,5,16,0,4,0,21,0,meet hottest cop ever
1,1,8,31,0,7,0,39,0,john krasinski hotter got ripped
1,1,11,47,0,11,2,58,0,18 face people received dick pic immediately recognise
1,1,14,43,3,12,0,57,0,"remember solve puzzle ""putt-putt save zoo"""
1,3,9,34,0,9,2,43,0,61 cringe thought getting bikiniwax
1,1,9,38,0,9,2,47,0,top 21 hillary clinton face benghazi committee
1,3,7,22,0,4,0,29,0,mtv spring break throwback photo
1,1,5,22,0,5,2,27,0,14 time silently judge people
1,2,17,53,0,15,3,70,0,6 social impact business idea could change world 30 summit emea
1,3,2,65,3,11,0,67,0,"psychics, witch pagans: people get alternative spirituality?"
1,1,6,21,1,5,0,27,0,damn! percent daniel
1,1,9,41,0,9,2,50,0,16 delicious plantain recipe make life better
1,3,14,77,7,20,0,91,0,"ryan: sanctuary city violation rule law, youve got enforce law get federal assistance"
1,1,4,19,0,4,2,23,0,13 accurate album title
1,1,7,31,2,6,0,38,0,"character ""the incredibles"""
1,3,1,44,0,10,0,45,0,child select right college
1,1,6,20,1,5,0,26,0,salted coffee: less bitter
1,1,5,14,1,5,2,19,0,lose 50+ pound
1,1,11,43,2,10,0,54,0,"""pretty little liars"" movie might actually coming theater"
1,1,12,37,2,12,2,49,0,"17 round ""never ever"" ed sheeran jamie lawson"
1,3,16,59,2,15,0,75,0,"forget three khans, irrfan khan witnessed stardom got mobbed gangtok!"
1,3,2,45,1,10,0,47,0,"pepsi, wrote next great commercial free"
1,2,5,36,0,7,4,41,0,biggest medium advertising question 2017
1,1,6,25,0,5,0,31,0,official emo band name generator
1,1,8,36,1,8,2,44,0,19 thing people drink coffee understand
1,2,7,39,0,8,0,46,0,google training ad placement computer offended
1,1,15,52,3,13,0,67,0,"trans-themed episode ""how get away murder"" actually really great"
1,1,9,37,0,8,2,46,0,29 dog looking depressed af halloween costume
1,1,13,40,0,12,0,53,0,best hair makeup look emmy red carpet
1,3,3,46,1,9,0,49,0,nine thing weve learnt one month facebook messenger
1,1,15,64,4,14,0,79,0,"know favorite ""game thrones"" character based favorite ""harry potter"" character"
1,1,8,42,1,7,0,50,0,food test determine boyfriend's personality
1,2,11,44,0,11,0,55,0,texas man dog found dead becoming trapped inside car
1,2,2,27,3,5,0,29,0,whats method trump madness?
1,1,10,43,0,9,2,53,0,34 disturbing photo santacon ruin christmas
1,3,8,26,0,8,2,34,0,24 tweet speak pettysoul
1,2,10,19,4,7,1,29,0,future's 'hndrxx' pace no. 1 debut
1,3,4,44,5,9,0,48,0,russia's 'humpty dumpty' hackers: trying do?
1,1,6,30,0,6,2,36,0,17 picture hot people never understand
1,2,15,50,1,14,0,65,0,career change staying put: make lateral move within company
1,1,10,42,1,10,2,52,0,19 thanksgiving food make started planning yet
1,3,0,29,0,7,1,29,0,5 weird trick mind play
1,1,9,32,2,8,0,41,0,"mindy kaling really like troll ""star wars"" fan"
1,2,4,43,0,9,0,47,0,trump voter texas oppose mexico border wall
1,3,12,64,4,11,0,76,0,"police: four woman arrested spraying anti-trump, anti-police graffiti north carolina"
1,3,6,27,0,7,6,33,0,21 people drastically changed in2016
1,3,7,31,2,6,0,38,0,asos's foreign flair can't mask british bother
1,3,5,62,3,11,0,67,0,anna wintour 'meets donald trump' slating president-elect train
1,2,4,46,1,11,4,50,0,2016 good bad? may johnson differ christmas message
1,1,11,52,1,10,0,63,0,surprise snowstorm turned couple's wedding winter wonderland
1,1,9,42,0,8,0,51,0,hunger game star honor paris victim mockingjay pin
1,3,4,39,0,7,0,43,0,campaign impeach donald trump launched list
1,1,9,35,4,9,2,44,0,"14 ""game thrones"" moment improved ""star wars"" quote"
1,1,14,42,0,13,0,56,0,saturday night live proved adele one unite u
1,1,9,43,0,10,6,52,0,12 time badass woman fought ridiculously sexist dress code 2015
1,1,10,31,0,9,0,41,0,kid explain boy girl act third grade
1,1,9,36,2,7,2,45,0,17 time people fell head-over-heels musical theater
1,1,6,20,0,6,1,26,0,5 great book read november
1,1,9,36,2,9,2,45,0,18 time @nenshi proved canada's first internet dad
1,1,3,19,1,1,0,22,0,bacon-wrapped appetizer
1,1,7,29,0,7,2,36,0,23 perfect gift movie religion
1,2,1,57,3,10,0,58,0,white woman 'posed black civil right leader' years-long deception
1,1,9,27,0,7,2,36,0,16 snapchats long distance bffs sent
1,3,11,41,4,10,0,52,0,andys friend toy story share face terrifying
1,1,9,37,0,9,2,46,0,19 quick healthy salmon dinner anybody make
1,3,8,39,0,8,2,47,0,19 picture prove drunk people actually genius
1,1,9,32,1,9,2,41,0,16 fact sound right actually true
1,1,5,20,0,4,0,25,0,guess personality
1,1,5,15,1,5,2,20,0,11 time can't even
1,1,9,31,0,8,0,40,0,famous trio friend would belong
1,1,8,18,0,7,0,26,0,like zoe joe sugg
1,3,11,50,0,10,0,61,0,two word make instantly irresistible according dave kerpen
1,2,10,43,0,10,2,53,0,21 piece advice anyone relationship could definitely use
1,2,10,41,0,10,1,51,0,8 brilliant philosopher taught u great deal life
1,1,10,29,1,10,2,39,0,18 way know mom friend group
1,1,8,40,1,8,2,48,0,12 chart everyone who's ever drank alcohol understand
1,1,13,40,4,12,0,53,0,"played ""never ever"" tamar adrienne ""the real"""
1,1,16,35,0,14,0,51,0,taught grandma nae nae cute af
1,2,1,58,2,11,0,59,0,bizarre moment snake 'thief' stuff python trouser pet shop
1,2,2,48,1,9,0,50,0,lucky location white christmas year?
1,2,3,58,4,12,0,61,0,curious world north korea's export badger fur 'strength pills'
1,2,12,42,1,11,0,54,0,"france made every citizen organ donor, unless opt"
1,3,2,34,1,9,3,36,0,triple j hottest 100: play mate quiz
1,1,13,45,2,12,0,58,0,taraji p. henson best reaction viola davis' historic emmy win
1,1,13,41,0,12,0,54,0,know addicted social medium based one question
1,3,8,31,2,9,1,39,0,5 live prince clip worth watching (while can)
1,2,14,49,3,12,0,63,0,apprehensive putin say 'diplomatic dog' gifted japan's pm shinzo abe
1,1,7,28,0,7,2,35,0,18 thing caribbean latino agree
1,2,17,56,2,16,2,73,0,42-bogey good train run indian woman survives incident like boss!
1,1,3,9,0,2,0,12,0,deserve
1,1,12,37,0,10,0,49,0,ellen degeneres member one direction perfect
1,2,7,45,1,7,0,52,0,kremlin disinformation machine targeting europe
1,1,14,40,0,14,2,54,0,23 thing every black person grew south know true
1,3,2,62,5,13,0,64,0,"italy voted constitutional reform. why, happen next."
1,1,6,28,0,5,0,34,0,dinosaur match zodiac sign
1,2,14,59,3,13,0,73,0,"'better die face court martial,' wrote sting video soldier killing"
1,1,8,34,1,7,2,42,0,41 dollar-store hack every parent know
1,1,9,26,0,8,0,35,0,tell phone screen cracked
1,3,12,61,3,14,0,73,0,brooks: trump siding foreign leader u president israel russia
1,2,8,37,0,9,0,45,0,new ferguson video add wrinkle michael brown case
1,1,8,38,3,6,0,46,0,"memoriam: shia labeouf's beautiful, gorgeous rattail"
1,1,11,38,0,11,2,49,0,21 wicked way trick people eating best candy ever
1,3,16,66,2,15,0,82,0,cnns henderson: might view flynn resignation press scored point wh
1,1,7,31,1,6,2,38,0,20 time conan o'brien completely owned twitter
1,1,14,43,1,13,0,57,0,know worst mistake ever made based taste ball
1,1,5,20,0,5,2,25,0,23 easy peasy packed lunch idea
1,3,13,70,3,13,0,83,0,national immigration law center exec director: session clear white supremacist agenda
1,2,7,33,0,6,0,40,0,one quality set successful parent apart
1,1,8,39,0,7,0,47,0,random question determine sexual vibe
1,2,12,35,1,11,0,47,0,"best place get pie every state, according toyelp"
1,1,9,29,0,10,6,38,0,22 nature photo taken 2015 blow away
1,2,3,27,1,8,0,30,0,got bumped flight. sued
1,3,6,27,2,7,3,33,0,600 underage migrant turn adult
1,1,10,38,2,8,0,48,0,life-changing product wish owned earlier
1,1,6,25,0,6,2,31,0,20 kid definitely going place
1,2,1,23,1,6,4,24,0,budget 2017: key point glance
1,1,8,35,1,8,2,43,0,24 time internet handle apple pencil
1,3,10,45,4,10,0,55,0,mark krikorian: puzder champion job american wont myth
1,2,6,25,0,6,2,31,0,26 picture ruin weekend
1,1,7,32,0,7,2,39,0,26 student killed homecoming style game
1,1,8,36,0,8,2,44,0,22 character childhood forgot hated
1,1,6,21,0,5,0,27,0,ferrell movie
1,2,16,65,1,15,0,81,0,virat kohli's fluent hundred keep india afloat even england make dent batting order
1,3,12,67,3,14,0,79,0,golf commentator caught mic saying player fiance wear shortest skirt country
1,1,6,16,0,5,0,22,0,food yum yuck
1,1,10,34,2,9,4,44,0,15 star war character name according 12-year-old boy
1,1,7,37,0,7,2,44,0,41 romantic idea elevate engagement picture
1,1,13,48,3,12,0,61,0,"watch trailer ""the purge: election year"" want nightmare"
1,3,7,39,0,8,1,46,0,7 terror attack plot foiled christmas season
1,1,13,45,0,12,0,58,0,one direction singing one direction car james corden
1,1,12,34,0,11,0,46,0,guess last thing googled based age
1,2,11,31,0,10,0,42,0,make harry potterfeast
1,1,8,17,0,4,0,25,0,share hbcu family photo
1,2,14,56,1,14,2,70,0,23 golden retriever puppy wholl remind still good thing thisworld
1,1,11,43,4,10,0,54,0,"definitive proof ""titanic"" ""peter pan"" almost movie"
1,1,8,29,2,7,2,37,0,day 2 buzzfeed's 7-day clean eating challenge
1,1,9,40,3,8,0,49,0,"britney spear dance ""hello,"" make adele relevant"
1,1,17,52,0,12,0,69,0,carrie fisher domhnall gleeson totally stole show backstage baftas
1,1,13,34,0,12,0,47,0,dog ready share human gross baby
1,1,7,23,4,6,0,30,0,"said it: ""bob's burgers"" edition"
1,1,11,41,1,10,0,52,0,well really know champion league clubs' logo
1,1,5,14,0,4,0,19,0,fake orgasm
1,1,13,42,1,9,0,55,0,gifs joseph-gordon levitt definitely make smile
1,1,8,27,1,7,0,35,0,like hypochondria
1,3,7,17,1,6,0,24,0,much asshole areyou?
1,1,7,26,0,7,4,33,0,beat 2015 taylor swift challenge
1,1,5,27,0,5,2,32,0,61 impossibly tiny tasteful tattoo
1,1,4,15,0,4,3,19,0,100 year family dinner
1,1,12,47,1,12,2,59,0,18 chart speak anyone who's nailing whole healthy thing
1,1,17,44,2,16,0,61,0,see guy's sweet reaction finding he's going dad
1,1,14,47,0,13,0,61,0,tell date four question biryani
1,3,11,29,3,8,0,40,0,milo: america problem fake hate crime
1,2,9,28,0,10,6,37,0,17 people determined even gayer in2017
1,1,11,35,1,10,0,46,0,clearest blue chvrches one year's best song
1,1,9,32,0,8,0,41,0,kahlua fudge brownie want loved
1,1,10,43,1,9,0,53,0,halsey opened like living endometriosis
1,3,7,46,2,7,0,53,0,california declare legal war trump administration
1,2,6,35,3,6,0,41,0,secret 'something rotten's' biggest number
1,1,7,29,1,7,2,36,0,32 year's amazing science picture
1,1,10,29,1,9,0,39,0,here's actually mean work wife
1,1,7,25,0,7,2,32,0,23 adorable pin give someone love
1,1,12,40,3,10,2,52,0,87-year-old granny give zero fuck everyone's idol
1,1,11,35,1,10,0,46,0,"know date, based favorite color"
1,3,8,33,1,8,2,41,0,22 picture prove dont deserveanimals
1,3,2,50,2,11,4,52,0,"coca-cola cut 1,200 job consumer turn away sugary drink"
1,1,6,25,0,5,0,31,0,woman discus kissing first date
1,2,3,46,1,9,0,49,0,lagos slum producing nigeria's top football talent
1,1,12,42,0,11,0,54,0,name disney villain looking hand
1,1,10,33,1,7,0,43,0,double-face halloween makeup look trippy af
1,1,7,34,0,7,2,41,0,18 hilarious tweet perfectly sum laziness
1,2,2,74,1,11,0,76,0,animal right activist attack peruvian men threw cat crocodile-infested lagoon
1,1,8,38,0,7,0,46,0,woman discus define relationship
1,1,8,23,0,8,2,31,0,21 big dog trying best brave
1,1,9,33,3,8,0,42,0,"well remember ""sabrina, teenage witch"""
1,3,18,52,3,11,0,70,0,bokhari: bill nye destroyed scientific credibility single netflix episode
1,3,4,39,1,12,0,43,0,here's part uk sex list
1,1,11,36,0,10,0,47,0,many food network star would sleep
1,1,5,15,0,6,2,20,0,player 1 player 2
1,1,11,39,0,10,0,50,0,fictional queer lady based zodiac sign
1,1,14,56,1,13,0,70,0,"bollywood music video without music funniest thing online, need"
1,1,11,48,2,10,0,59,0,"chelsea handler share experience drug ""chelsea does"""
1,1,14,34,7,11,0,48,0,"mindy kaling think ""badass"" live p.e.i. we're like"
1,1,8,29,0,7,0,37,0,gordon ramsay nigella lawson
1,3,3,88,2,22,3,91,0,model ate 500 calorie day working. shared look like giving list
1,1,7,17,0,6,0,24,0,one way ask someone
1,1,12,31,1,11,0,43,0,learned there's one way gay sex
1,2,1,29,0,2,0,30,0,surprising celebrity friendship
1,1,7,26,2,6,2,33,0,"25 hilarious ""spongebob"" quote"
1,1,11,20,0,7,0,31,0,tv bromance bff
1,2,14,40,1,9,0,54,0,cbrevoice: turn workplace desired destination
1,1,13,58,1,11,0,71,0,dutch organization providing free abortion woman zika-affected region
1,1,4,14,0,5,6,18,0,14 best beatbox vine 2015
1,3,4,72,1,14,0,76,0,arab teacher catchy attempt teach hebrew become online sensation israel
1,2,5,33,0,6,0,38,0,sean spicer went full melissa mccarthy today
1,1,11,46,4,10,0,57,0,"season ""american horror story"" binge ""hotel"""
1,1,7,28,0,6,0,35,0,gwyneth paltrow shit paaaaants
1,1,13,45,4,12,0,58,0,"first trailer netflix's ""the get down"" incredible"
1,2,1,50,0,13,6,51,0,20 tweet cher help remember 2016 better light
1,1,9,52,1,8,0,61,0,daniel radcliffe's tribute alan rickman completely heartbreaking
1,3,9,37,3,10,0,46,0,merkel say weak euro problem stand trump
1,2,13,35,1,12,0,48,0,"buy fail building bicycle ikea,too"
1,1,9,43,0,9,2,52,0,17 infuriatingly unrealistic cliche used movie
1,1,8,39,3,7,0,47,0,"evolution jennifer lawrence's ""hunger games"" style"
1,1,10,38,2,10,2,48,0,20 thing world black people exist
1,1,14,30,0,11,0,44,0,know cute baby panda gif need see today
1,3,2,50,1,7,0,52,0,lab extend purebred dog popularity record; rottweiler rise
1,3,1,46,2,13,0,47,0,stick head sand prepare old age
1,1,13,44,4,12,0,57,0,"donald trump slug ""monsters, inc."" ease tired heart"
1,1,6,20,2,6,1,26,0,"well remember ""scream 2"""
1,1,9,28,0,7,2,37,0,27 diy jewelry project actually easy
1,1,11,39,0,10,0,50,0,watch skeptic try remain calm haunted asylum
1,1,9,26,2,9,2,35,0,"17 cat craigslist make go ""me"""
1,2,6,25,0,7,0,31,0,wave new work gerhard richter
1,1,8,37,0,8,2,45,0,28 photo give serious relationship goal
1,1,8,43,0,8,2,51,0,16 delightful family holiday tradition around world
1,1,13,35,0,13,1,48,0,tried 5 ikea hack see cheap easy really
1,1,7,31,0,7,2,38,0,20 miranda sings tweet brighten monday
1,2,7,35,0,9,2,42,0,boost social security check 85 percent
1,1,6,25,3,5,0,31,0,tell u yourself(ie): rob delaney
1,1,10,28,0,10,2,38,0,26 apps help get shit done year
1,2,8,40,2,9,0,48,0,eaglet hatch camera: chance survival?
1,1,9,34,0,8,0,43,0,remember disney star sang lyric
1,1,8,19,0,7,0,27,0,hole best new emoji
1,1,4,11,0,3,0,15,0,hate camping
1,1,9,33,0,9,2,42,0,24 situation make cringe cry
1,1,15,46,0,14,0,61,0,dad finding wife pregnant make uterus skip beat
1,1,11,42,0,10,0,53,0,guess chipotle burrito order single question
1,1,9,43,1,8,0,52,0,everyone eating cereal wrong incredibly upsetting
1,1,10,65,1,9,0,75,0,rose mcgowan defends comment criticizing caitlyn jenner's understanding womanhood
1,3,12,55,1,11,0,67,0,female employee kerala found dead inside infosys' hinjewadi office pune
1,1,10,41,0,10,2,51,0,18 thing people depression anxiety relate
1,1,7,24,0,6,2,31,0,17 gift every shondaland fan love
1,1,8,29,0,7,0,37,0,solve crossword puzzle good cause
1,1,6,25,0,5,0,31,0,canadian honest snapchat
1,1,8,39,0,8,2,47,0,21 precious moment every close mother daughter share
1,1,11,47,2,10,0,58,0,"entire original cast signed ""trainspotting"" sequel"
1,3,2,54,1,10,0,56,0,"harrowing moment cop shot oklahoma caught audio, video"
1,1,12,53,3,11,0,65,0,"disgustingly real, viral ""scrotum backpack"" officially going sale"
1,1,8,21,2,7,0,29,0,"waffles, that's"
1,1,14,42,0,12,2,56,0,17 impressive diy gift make thing around house
1,1,13,40,0,12,4,53,0,identify 2016 movie comment youtube trailer
1,3,2,60,0,10,0,62,0,syrian photographer rescued child aleppo bus bombing speaks
1,1,12,43,0,11,0,55,0,snapchat story would looked like ten year ago
1,1,11,35,0,11,2,46,0,23 tweet way funny people wear makeup
1,2,2,50,2,7,0,52,0,mystery crown-like structure venus' surface revealed
1,1,8,20,1,7,0,28,0,girl dirty mind
1,2,12,43,1,12,4,55,0,people show 2016 changed year's depressing meme
1,1,8,27,0,7,0,35,0,adele song sob tonight
1,1,13,40,0,12,0,53,0,ate spiciest ramen shop tokyo actually turned red
1,2,3,17,1,4,4,20,0,pessimist guide 2017
1,1,13,43,1,12,0,56,0,men learned braid hair they're looking back
1,1,10,60,0,10,1,70,0,9 way avoid uncomfortable conversation relative thanksgiving
1,1,9,44,0,9,2,53,0,15 word mean something completely different tim hortons
1,1,11,38,0,10,0,49,0,know celebrity marry based sign
1,1,9,47,1,9,2,56,0,15 snapchats people california's central valley would send
1,1,7,27,0,5,0,34,0,buzzfeed violet character
1,1,11,39,0,10,0,50,0,posh spice nicki minaj praised adele epic cover
1,2,2,78,3,13,0,80,0,scientist want create red team challenge climate research. congress listening
1,1,13,46,1,12,0,59,0,"year dutiful service, shiba ran tobacco shop retires"
1,3,3,26,3,5,0,29,0,many u.s. adult transgender?
1,3,3,66,1,12,1,69,0,4 lesson millennials spend money mtv's new reality competition show
1,2,1,36,0,6,0,37,0,certain noise really drive people nut
1,3,2,51,1,11,0,53,0,social media: think post pic kid
1,1,14,63,2,13,0,77,0,"according taylor swift's twitter faves, calvin harris probably still together"
1,1,9,47,0,9,2,56,0,80 katy perry lyric make seriously perfect instagram caption
1,1,10,50,0,10,2,60,0,24 disappointing white elephant gift people actually ended
1,1,12,40,0,11,0,52,0,donald trump coloring book adult look like
1,2,5,63,2,18,1,68,0,made exact replica donald trump 'the sims 3' lot wild thing happened
1,1,10,48,0,10,2,58,0,17 thing republican candidate actually looked like debate
1,2,2,23,2,5,0,25,0,achieve 'oscars look'
1,1,16,66,0,15,0,82,0,know favorite unexpected disney pixar villain based favorite taylor swift song
1,1,7,28,0,7,2,35,0,21 people slayed african ankara print
1,1,10,36,0,10,2,46,0,23 thing anybody ever dated boy understand
1,3,2,35,1,7,0,37,0,sniper green tea helmand's front line
1,1,13,52,2,13,2,65,0,"12 perfect vacation take india detox, disconnect, get refreshed"
1,1,10,43,0,10,4,53,0,winner loser asian representation hollywood 2015
1,1,16,51,0,15,0,67,0,ed westwick showed emmy party looking like chuck bass dream
1,1,12,48,0,11,0,60,0,guess relationship status based favorite board game
1,1,11,45,0,10,0,56,0,test determine type sex match personality
1,1,5,11,0,4,0,16,0,bart lisa
1,1,8,36,0,8,2,44,0,11 epic slap incredibly therapeutic watch
1,1,6,23,1,4,0,29,0,stimulating fact g-spot
1,3,4,52,1,9,0,56,0,"derogatory internal nickname trump white house, ranked"
1,1,12,48,0,11,0,60,0,chris hemsworth grappling longer sexiest man alive
1,3,7,51,3,11,0,58,0,george michael thank james corden's 'carpool karaoke'
1,1,12,51,2,12,2,63,0,17 thing understand slightly obsessed singing car
1,3,9,61,0,8,0,70,0,jackie evancho album sale skyrocket announcing inauguration performance
1,1,8,32,0,9,4,40,0,25 indie album still amazing 10 year later
1,1,7,18,0,7,2,25,0,24 time dog good u
1,1,7,23,0,7,4,30,0,florida continued worst 2015
1,1,12,38,2,11,0,50,0,"ferrell exotic animal expert ""the late show"""
1,2,6,29,0,5,0,35,0,bank teller draw scrutiny security
1,2,4,73,3,15,5,77,0,"here's southern rail passenger saying strike twitter 30,000 tweet analysed"
1,1,8,33,0,8,2,41,0,27 position every single person
1,1,5,17,3,3,0,22,0,like...sexually
1,1,13,48,2,11,0,61,0,here's kendall jenner looking flawless new balmain x h&m commercial
1,2,3,54,1,10,0,57,0,new obama/biden meme help survive inauguration week
1,2,11,76,4,22,2,87,0,meet sexbots: contender 20 billion race create ai sex doll chat 'never say no'
1,1,8,25,0,7,0,33,0,name previous life
1,1,8,36,0,8,2,44,0,22 reason zellers actually better target
1,1,8,21,0,8,2,29,0,13 sexist ad made india
1,2,6,30,1,8,3,36,0,humble taco inspired $750 mexican meal
1,1,10,39,0,10,2,49,0,19 thing everyone military fitness know true
1,1,6,23,0,6,2,29,0,15 reason december best month
1,1,9,34,0,9,2,43,0,21 cozy velvet thing make life fancier
1,1,8,46,0,8,2,54,0,wendy williams attempt guess 16 terrible celebrity painting
1,2,11,34,1,9,0,45,0,warrior tough beat fivethirtyeight
1,1,6,26,1,4,0,32,0,terminated much-wanted pregnancy
1,1,10,35,0,9,0,45,0,kendall jenner shared photo boob instagram
1,1,9,31,2,9,2,40,0,"21 reason felicity smoak real hero ""arrow"""
1,2,16,62,1,15,0,78,0,cat named hugh jackman recovering fire faster wolverine
1,1,11,32,1,11,2,43,0,"25 picture way, way real cat owner"
1,3,14,57,5,15,0,71,0,air force troop warned use word boy girlmight deemed offensive
1,1,10,33,0,9,0,43,0,pretty little liar based style
1,1,12,50,0,11,0,62,0,american shocked facebook post england went viral
1,3,11,58,3,13,2,69,0,"dem rep. chaka fattah get 10 year prison fraud, racketeering, money laundering"
1,1,11,40,1,10,2,51,0,28-day challenge get actually start working
1,3,0,35,0,7,1,35,0,4 tax break every parent know
1,1,6,27,0,5,0,33,0,booze leftover halloween candy
1,2,6,21,3,7,6,27,0,20 best k-pop song 2016: critic's pick
1,1,12,40,3,11,0,52,0,"there's new ""potter puppet pals"" time halloween"
1,3,13,41,0,13,2,54,0,23 reason great british bake best show onnetflix
1,1,8,40,0,8,2,48,0,19 people prove rainbow eyebrow insanely gorgeous
1,1,11,36,1,11,4,47,0,2015 word added dictionary
1,3,3,64,3,11,0,67,0,trump's travel ban leaf resident feeling like 'prisoners' united state
1,1,10,38,0,9,0,48,0,many halloween movie actually seen
1,1,14,56,0,13,0,70,0,watch footage two sikh men unraveling turban rescue four drowning boy
1,1,9,36,1,9,4,45,0,celebrity wearing 2016's golden globe
1,1,9,28,0,9,2,37,0,19 tweet tea speak soul
1,1,10,39,0,10,1,49,0,9 insanely smart shopping hack help win black friday
1,2,6,27,0,8,4,33,0,best 2016 sometimes well
1,1,12,34,0,12,2,46,0,19 tweet death way funny laugh
1,3,11,33,2,9,0,44,0,ten thing co-worker need know
1,1,6,31,0,6,2,37,0,23 people failed spectacularly cooking
1,1,12,46,2,11,0,58,0,"meet diane warren, whose song ruining karaoke year"
1,1,9,41,0,8,0,50,0,hogwarts house would sort politician
1,2,1,55,3,7,0,56,0,"""dead snap"" revolutionizing quarterback-center exchange"
1,2,10,44,2,10,0,54,0,stephen curry free throw teach investor expert
1,1,9,36,0,8,0,45,0,word association test reveal true self
1,1,6,18,0,5,0,24,0,actually give fuck
1,3,11,40,1,10,0,51,0,silicon valley cure diabetes low carbs high tech?
1,1,5,19,0,4,0,24,0,king bach dominated vine
1,2,13,52,3,12,0,65,0,everything need know gilmore girl character weve neverseen
1,2,9,45,0,10,2,54,0,16 best movie television show high school football
1,1,11,38,1,10,0,49,0,asking help system speak language
1,3,4,63,1,13,2,67,0,adidas offer island nfl prospect break record fastest 40-yard dash
1,1,15,49,1,14,0,64,0,little girl reacting reveal luke skywalker's father u
1,1,11,47,0,10,0,58,0,benedict cumberbatch imitated otter punched teddy bear
1,1,10,40,1,11,4,50,0,23 album definitely owned christian teenager '90s
1,1,8,22,0,7,0,30,0,pizza hut look like
1,1,14,55,4,13,0,69,0,indians: let's take second acknowledge priyanka chopra f*cking killin'
1,1,12,27,3,9,0,39,0,"issa rae's ""insecure"" coming hbo long last"
1,3,9,39,3,9,0,48,0,john legend: trump already done enough impeached
1,1,13,39,0,12,0,52,0,see jamie fraser life never
1,1,11,31,3,10,1,42,0,"new queen ""rupaul's drag race"" season 8"
1,1,11,40,0,10,0,51,0,naomi campbell posed nude magazine everything
1,1,9,22,0,9,4,31,0,guess much money made 2015
1,1,11,44,0,11,2,55,0,19 shameless thing happen become obsessed band
1,2,3,49,0,9,0,52,0,hidden twitter setting free iphone storage space
1,3,11,51,1,9,0,62,0,cargillvoice: millennials driving change protein industry
1,1,10,41,0,9,0,51,0,hannah hart volunteered kitten adorable
1,1,10,27,0,9,0,37,0,tell u keep healthy diet college
1,1,6,9,0,5,2,15,0,17 dad dad af
1,2,11,35,3,8,0,46,0,should-be-bigger bracket: see artist
1,2,1,62,0,9,0,63,0,reporter instantly regret attempting broadcast beside large puddle
1,2,7,21,3,7,2,28,0,"22 best ""rain drop, drop top""tweets"
1,2,3,52,2,10,0,55,0,un's sudden tweak whistleblower policy fend defunding?
1,2,11,44,0,11,2,55,0,literally 19 photo dev patel sunny pawar beingadorable
1,1,14,45,0,13,0,59,0,guess kind snapchatter based single question
1,1,8,30,0,8,2,38,0,19 thing every eyeliner addict know true
1,1,11,39,0,11,2,50,0,24 reason netflix important thing life
1,2,6,26,1,6,2,32,0,10 new year's resolution wallet
1,1,12,45,1,11,0,57,0,here's one tell depression anxiety
1,1,10,40,0,10,2,50,0,10 mouthwatering dish healthy simple
1,1,16,42,0,15,4,58,0,old favorite tv movie character 2016
1,3,8,51,5,7,0,59,0,college professor organize national teach-in challenge trumpism
1,1,6,24,1,7,6,30,0,rated 16 2015's celebrity thirst trap
1,1,11,40,0,11,2,51,0,19 thing everyone love harry potter booze need
1,1,11,48,2,10,0,59,0,"drop everything watch super empowering trailer ""parched"""
1,2,5,39,4,11,0,44,0,"dividend stock great used (ko, mo)"
1,1,9,39,3,8,0,48,0,"teachers, what's best halloween costume ever"
1,1,10,34,1,8,0,44,0,here's youtubers say mental health
1,2,5,22,0,5,0,27,0,eat food better sleep
1,2,9,36,1,8,0,45,0,"employer ask salary history, say"
1,1,9,41,1,9,1,50,0,7 insanely easy organizing trick actually want try
1,3,2,35,2,6,0,37,0,im really thinking: failed novelist
1,1,8,32,0,7,0,40,0,comedy series binge watch next
1,1,7,35,0,7,2,42,0,12 thing salvadoran american tired hearing
1,1,13,38,2,12,0,51,0,"ed sheeran going acting new ""bridget jones"" movie"
1,3,8,51,2,8,0,59,0,twitter test censoring entire user account sensitive content
1,2,3,32,1,6,0,35,0,slovenia v england: player fared
1,1,8,28,0,8,2,36,0,31 time puppy made world better place
1,3,11,57,3,10,0,68,0,maher: unreasonable concerned safety transgender bathroom
1,1,8,31,1,9,4,39,0,23 thing '90s kid christmas list
1,3,11,40,3,12,0,51,0,know much cost protect trump family? [video]
1,1,9,30,0,9,2,39,0,19 delicious way eat candy corn fall
1,1,12,40,2,11,0,52,0,"reminder ""gilmore girls"" autumn show time"
1,2,3,67,1,12,0,70,0,green lantern still recover become multi-movie franchise deserve
1,2,5,62,0,15,0,67,0,nation world spending prepare world war three list
1,1,10,33,3,11,4,43,0,"16 time ""this england '90"" made feel feeling"
1,1,12,36,0,10,2,48,0,19 thing happen bff basically sister
1,1,9,39,3,8,0,48,0,"kanye west perfectly responded drake's ""nice pool"" lyric"
1,1,11,46,2,10,0,57,0,"hogwarts house ""game thrones"" character belong"
1,1,10,31,0,9,0,41,0,many gamer term actually know
1,1,3,8,0,3,1,11,0,9 time cried
1,3,2,52,3,11,0,54,0,'hairy blob' globster found philippine shore?
1,3,1,56,0,12,0,57,0,app say measure many time woman interrupted men
1,1,11,34,1,11,1,45,0,$4 street food look like around world
1,1,13,58,0,13,2,71,0,11 art craft project prove mason penelope disick creative genius
1,2,15,63,1,14,0,78,0,border adjustable tax can't shrink trade deficit produce trillion new revenue
1,1,9,27,0,9,2,36,0,13 stage getting one got away
1,1,12,39,0,11,2,51,0,21 hilarious tweet tv make laugh every time
1,1,7,42,0,7,2,49,0,22 picture people without roommate never understand
1,1,8,27,0,7,0,35,0,many logan lerman movie seen
1,1,10,38,0,10,2,48,0,21 funny tweet perfectly sum hatred people
1,1,13,46,1,12,0,59,0,ferrell mark wahlberg realize know
1,3,5,44,2,12,0,49,0,blac chyna dragging tyga snapchat. tale old time!
1,1,10,45,0,9,0,55,0,everything need know floating iceberg hot chocolate
1,1,9,36,4,8,0,45,0,"what's best ""yahoo answers"" question ever seen"
1,1,7,29,0,7,2,36,0,23 thing pregnant woman find funny
1,1,9,31,0,8,0,40,0,try tasty treat super bowl party
1,1,12,29,5,10,0,41,0,"there's new doctor ""grey's anatomy"" he's hot af"
1,1,12,32,0,12,2,44,0,18 way help loved one going hard time
1,1,9,35,0,9,2,44,0,21 insanely hot dish guaranteed spice life
1,2,7,57,5,10,2,64,0,19-year-old dunkin' donut worker behind ashley judd's viral #nastywoman poem
1,3,3,52,6,9,0,55,0,i'm ditching amazon walmart's e-commerce competitor here's
1,3,14,42,3,11,0,56,0,former nfl te tony gonzalez: skipping white house visit silly
1,1,11,58,1,10,0,69,0,engineering student eloquently pointed female classmate equal
1,1,9,29,0,8,0,38,0,know play private session
1,1,9,31,1,9,2,40,0,17 easy step wow lover valentine's day
1,1,8,37,2,8,2,45,0,"14 ""hunger games"" question impossible answer"
1,1,11,44,0,10,0,55,0,jennifer lawrence never looked better last night
1,1,12,53,1,10,0,65,0,extreme phone pinching possibly nerve-racking internet craze yet
1,1,10,39,1,9,0,49,0,here's watch netflix blizzard
1,1,6,29,0,5,0,35,0,test determine personality
1,3,9,47,3,9,0,56,0,take mettleand wireto build world tallest christmas tree
1,3,3,39,2,8,0,42,0,valve kill steam greenlight here's matter
1,2,1,61,2,10,0,62,0,non-verbal boy's special bond deaf dog captured heartwarming photo
1,1,10,33,0,10,2,43,0,17 thing never say female football fan
1,1,7,19,4,6,0,26,0,"~have~ ""like"" picture"
1,1,16,38,2,12,0,54,0,"kris jenner swim around pool ""trap queen"" love magazine"
1,2,1,47,0,9,1,48,0,6 google product service never even knew existed
1,3,9,16,0,7,0,25,0,bath bomb sent girl er
1,1,17,52,4,16,0,69,0,"well remember lyric panic! disco's ""i write sin tragedies"""
1,3,13,40,3,12,0,53,0,"bad relationship new year's eve, alone"
1,1,13,50,0,12,0,63,0,one dude pentatonix look like howie backstreet boy
1,1,8,35,2,8,4,43,0,(probably) biggest parenting trend 2016
1,1,8,23,2,8,2,31,0,"21 gift ""sims"" addict life"
1,1,8,45,0,8,2,53,0,23 thing american honestly never understand britain
1,1,8,35,0,7,0,43,0,malala yousafzai pretty much good everything
1,1,8,30,0,7,0,38,0,music video starring gigi hadid
1,3,5,70,2,14,5,75,0,"lucy barnard's bid walk 30,000km argentina alaska includes collecting poo harvard"
1,1,13,45,0,12,0,58,0,george takei still waiting donald trump come see musical
1,3,10,26,1,8,1,36,0,6 myth ira can't afford believe
1,1,11,41,0,11,2,52,0,29 pair impossibly gorgeous heel wear wedding day
1,1,9,34,0,9,1,43,0,9 hand sign make everyday life easier
1,1,8,42,0,7,0,50,0,everyone personally devastated tabitha goat
1,1,14,51,1,13,0,65,0,super fast trick getting faux locs changed every lazy human's life
1,1,9,38,0,9,2,47,0,21 vine make question entire existence
1,1,6,22,0,5,0,28,0,video game princess
1,3,1,38,0,8,0,39,0,pretty penny could cost pretty penny
1,3,13,48,3,11,0,61,0,"mark ruffalo, michael moore, alec baldwin lead anti-trump protest nyc"
1,1,11,50,1,10,0,61,0,watch teenager's emotional reaction waking heart surgery
1,1,16,53,3,14,0,69,0,invaded three queer lady couple's apartment see like u-haul
1,1,11,52,2,10,0,63,0,"hogwarts house ""american horror story"" character belong"
1,2,9,43,4,9,0,52,0,new yorker: white house press corp livid trump trolling
1,1,11,37,1,10,0,48,0,asked mom marriage advice here's happened
1,2,9,34,1,9,1,43,0,actually know 4 middle easternfoods?
1,1,12,37,0,11,0,49,0,guess month born single question
1,1,11,35,0,10,0,46,0,name movie commonly used word
1,1,7,28,2,6,0,35,0,"""waiting exhale"" character"
1,1,11,38,1,11,2,49,0,12 chart explain like date every zodiac sign
1,1,5,32,0,4,0,37,0,disney princess breastfeeding public
1,1,5,21,1,4,0,26,0,comedy's next great leading man
1,3,8,53,2,14,0,61,0,cia hack iphone? need know wikileaks dump.
1,1,7,31,0,6,0,38,0,first celebrity boyfriend
1,1,13,38,1,12,0,51,0,food test tell true los angeles foodie
1,2,14,77,3,14,0,91,0,secret service taking appropriate action agent suggested wouldnt defend trump bullet
1,2,2,78,4,19,0,80,0,'my mum angle': hilarious tattoo fails show thing go badly wrong inker can't spell
1,3,3,65,0,16,0,68,0,middle manager retired reply email tirade show quit job
1,1,14,44,1,13,0,58,0,answer one question we'll tell adele song need hear
1,1,11,41,0,10,0,52,0,christmas carol sing based zodiac sign
1,1,11,49,3,9,0,60,0,"self care routine include buzzfeed's ""another round"" podcast"
1,1,4,15,0,3,0,19,0,bros give money advice
1,2,7,32,0,8,0,39,0,uber give restless employee way cash
1,2,8,38,2,12,0,46,0,american tech icon bet nuclear -- lost way
1,3,2,48,2,7,0,50,0,red sox prospect baseball's strangest pre-pitch routine
1,3,4,64,3,12,1,68,0,henry cavill announces role 'mission: impossible 6' cheekiest possible way
1,1,7,24,0,6,0,31,0,well know carrie underwood
1,1,10,42,0,9,0,52,0,newly revealed wizard school study abroad
1,1,6,23,0,5,0,29,0,gangster movie bride
1,1,11,38,0,10,0,49,0,saul williams politics race poetry america
1,2,13,47,2,12,3,60,0,salary chronicles: $200k job offer showed potential limitless
1,1,10,29,0,10,2,39,0,60 thought try knit present
1,1,6,28,1,7,5,34,0,33 thing kim kardashian 100% actually said
1,1,11,41,0,10,0,52,0,famous vampire date based zodiac sign
1,3,9,48,0,9,0,57,0,john hopkins fool navy perfectly executed hidden ball trick
1,1,5,12,0,3,0,17,0,britney spear b
1,2,1,38,0,7,0,39,0,help u map street harassment around world
1,3,15,46,2,16,1,61,0,pak hit india's water war 5 story need read sunday
1,1,9,39,0,9,2,48,0,19 beautiful way use sampaguita flower wedding
1,3,7,36,2,7,0,43,0,favorite brazilian carnival queen? vote!
1,1,10,31,0,9,0,41,0,need talk nut brownie cooky
1,2,14,68,0,13,0,82,0,dude followed girlfriend around world photographed wedding perfectly
1,1,5,14,0,5,4,19,0,getting phone call 2016
1,2,2,66,6,12,0,68,0,"'they're sold like shoes': cambodia's building boom built slave labour, report say"
1,2,8,43,1,9,0,51,0,brief history humankind desperate attempt stay fit
1,3,14,40,4,10,0,54,0,sapvoice: customer's experience broken: here's fix
1,3,4,59,3,14,0,63,0,golden globe predictions: win win tv category
1,1,7,31,0,7,2,38,0,22 honest confession burger king server
1,1,11,40,2,10,0,51,0,"know ""love actually"" character hook"
1,1,7,31,0,7,2,38,0,33 question white people white people
1,1,10,40,0,10,2,50,0,21 fucking great gift best friend love swearing
1,3,11,21,1,9,0,32,0,"ipo heat up, texas bank want"
1,1,14,45,2,13,0,59,0,"nicki minaj would like medium know yes, actually, smile"
1,1,7,36,1,6,0,43,0,couple review other's credit card statement
1,1,8,34,0,8,2,42,0,10 delicious recipe made coconut milk
1,3,13,39,3,13,3,52,0,myanmar travel company went $0 $1.5m revenue year
1,1,12,50,0,11,0,62,0,demi lovato gave best worst possible answer interview
1,1,8,33,0,9,6,41,0,17 celebrity opened mental health 2015
1,1,7,28,1,6,0,35,0,today's good nice horoscope human
1,2,10,58,1,9,0,68,0,"oregon school district ban santa claus decorations, seek religious tolerance"
1,1,11,32,0,10,0,43,0,colour test tell old really
1,1,11,39,0,10,2,50,0,23 important thing ever happened yikyak
1,1,11,40,2,11,2,51,0,"19 reason lily ""modern family"" would best friend ever"
1,1,11,46,0,10,0,57,0,guess bollywood celebrity childhood picture
1,1,10,38,2,8,2,48,0,"21 time ""hocus pocus"" perfectly described single bffs"
1,1,16,52,3,15,0,68,0,"raven chelsea reunited slayed hell ""that's raven"" theme song"
1,2,3,20,0,4,4,23,0,biggest celebrity feud 2016
1,3,8,58,6,8,0,66,0,"krauthammer: timing russia sanction ridiculous, obama action adolescent"
1,1,9,24,1,7,0,33,0,medically possible lick g-spot
1,1,9,24,2,8,0,33,0,"far would make ""the bachelor"""
1,1,9,40,0,9,1,49,0,8 stage every driver go morning commute
1,3,21,58,2,19,0,79,0,"yes, virat kohli skipper, m dhoni still around guide england"
1,1,13,44,1,12,0,57,0,weeknd say taylor swift stop petting hair party
1,1,9,39,0,8,0,48,0,texture test reveal hidden personality trait
1,1,8,27,0,8,2,35,0,19 face everyone make cold
1,1,8,23,0,8,2,31,0,19 thing cat owner know true
1,1,9,32,0,8,0,41,0,squad halloween year
1,1,14,65,0,13,0,79,0,man syndrome totally transformed compete bodybuilding contest
1,1,15,42,0,12,2,57,0,19 illustration sum relationship adhd
1,1,13,49,0,12,0,62,0,mountain lion climbed utility pole california stayed
1,1,9,49,0,9,2,58,0,21 hilarious tweet perfectly capture feeling dating
1,1,10,39,0,10,2,49,0,29 halloween costume make three thing fewer
1,3,9,43,3,9,3,52,0,"statistic professor win $100k lottery, share lottery tip yahoo"
1,1,6,28,2,5,0,34,0,"everyone secretly hate ""friends"""
1,2,13,61,3,12,0,74,0,"tahir shah leaf pakistan, kareena-saif officially introduce baby taimur ent"
1,1,9,32,3,10,2,41,0,"11 time ""$ave dat money"" song generation"
1,1,8,26,0,8,2,34,0,17 way keep kid safe halloween
1,3,5,30,0,6,0,35,0,year conquering negative thinking
1,1,15,57,0,14,0,72,0,celebrity got festive fuck stopped jingle ball photo booth
1,1,10,45,2,9,0,55,0,"catalina wine mixer ""step brothers"" actually happening"
1,1,7,26,0,7,2,33,0,horoscope week november 30
1,1,5,31,0,5,2,36,0,20 problem cosplayers understand
1,1,12,51,0,11,0,63,0,zodiac sign date based favourite disney character
1,3,1,37,1,9,0,38,0,here body would say could talk
1,1,11,40,0,11,2,51,0,32 online shop based southwest shopping
1,1,9,25,2,8,0,34,0,"hey india, talk mom like"
1,3,8,37,3,10,0,45,0,"set, keep, personal-finance resolution"
1,1,8,19,0,7,0,27,0,actor singer
1,3,15,51,2,14,0,66,0,looking ideal calcium rich recipe keep bone healthy? go!
1,1,11,36,3,9,0,47,0,"""x-files"" character based zodiac sign"
1,1,7,36,0,7,2,43,0,28 thing scotland surprise everyone
1,1,7,25,1,8,4,32,0,19 '00s teen movie summed one sentence
1,1,8,24,1,7,0,32,0,said it: leslie knope amy poehler
1,2,10,37,0,10,0,47,0,man fight cougar outside tim hortons save dog
1,1,11,43,0,10,0,54,0,cheap fancy faux brass hanger upgrade space
1,1,10,38,0,10,2,48,0,29 song remind high school sweetheart
1,1,12,43,0,12,2,55,0,21 super calming space make want meditate right
1,1,8,41,2,8,2,49,0,"judah friedlander ""30 rock"" defines popular dating term"
1,1,9,38,0,8,0,47,0,one thing never noticed disney character
1,1,8,36,0,8,2,44,0,14 picture make indian incredibly angry
1,1,10,44,1,8,0,54,0,struggle discover first same-sex relationship
1,1,16,56,0,15,0,72,0,twitter losing mind really sexist poll conducted time india
1,1,11,35,4,10,0,46,0,"cast ""it's always sunny philadelphia"", v"
1,1,9,30,0,9,4,39,0,selena gomez kendall jenner 2015
1,1,7,25,0,7,4,32,0,2015 thing halloween
1,1,15,49,1,14,0,64,0,tom fletcher announced he's dad awesomely amazing way
1,1,10,43,3,9,0,53,0,"one thing definitely never noticed ""love actually"""
1,1,10,44,2,9,2,54,0,10 scrumptious gluten-free treat feel like compromise
1,1,6,25,0,7,6,31,0,15 time indian newspaper messed 2015
1,1,18,53,1,17,0,71,0,"world watched marlene pinnock get beaten cop, still street"
1,1,9,44,0,9,1,53,0,9 fanfiction pairing ship even harder around valentine day
1,1,13,39,3,12,2,52,0,"46 thing would different ""friends"" set l.a"
1,3,6,42,0,8,0,48,0,peace afghanistan taliban foundered
1,2,18,58,2,17,0,76,0,"indian rat catcher get job florida, story south india's last rat catcher"
1,1,14,39,3,11,0,53,0,woman give haircut bffs... woman
1,3,1,65,0,11,0,66,0,behind scene largest annual meeting global warming contrarian
1,1,14,35,1,13,0,49,0,here's kid motivate make gym today
1,3,6,53,2,11,0,59,0,news bali greatest destination earth (so say tripadvisor)
1,2,2,50,0,10,0,52,0,corruption tour shine light murky world graft mexico
1,3,12,48,4,13,0,60,0,"march job report: yeah, yeah. blame weather. check chart"
1,1,7,25,0,7,2,32,0,61 best teacher meme internet
1,3,9,51,2,8,2,60,0,target retailer hit $15 billion loss since pro-transgender announcement
1,1,8,37,3,8,2,45,0,"25 time ""it's always sunny"" made laugh uncontrollably"
1,2,2,34,3,9,2,36,0,here's real cost '12 day christmas'
1,1,12,53,0,11,0,65,0,graphic novel perfectly capture struggle indian woman
1,1,9,34,0,9,2,43,0,13 recipe people think hate slow cooker
1,1,10,34,2,9,0,44,0,what's strangest thing ever put butt
1,1,14,40,0,13,0,54,0,gave drunk girl bunch puppy lot tear
1,1,16,53,2,14,0,69,0,man feed mcdonald's employee awesome thing
1,2,2,55,2,12,2,57,0,"""wire tapping"" 11 word phrase trump tweeted quote"
1,1,11,27,0,9,2,38,0,25 vintage photo wild nye party past
1,1,7,17,2,6,0,24,0,"weird way guy say ""i love you"""
1,1,7,30,1,8,6,37,0,29 childhood snack sadly return 2015
1,1,6,29,0,7,6,35,0,30 question ask 2016
1,1,9,37,0,9,2,46,0,28 limited item feeling nostalgic
1,2,11,33,0,11,0,44,0,never ask slice lemon drink
1,1,6,28,0,6,2,34,0,19 song actually fuckboy anthem
1,1,11,43,0,10,0,54,0,everyone think hermione ended harry
1,3,7,38,0,14,1,45,0,fcc gave reason hold buying 4k tv
1,2,9,47,2,9,2,56,0,donald trump float boeing proposal counter lockheed martin f-35
1,1,9,24,0,8,0,33,0,well know fast food menu item
1,1,9,37,2,9,2,46,0,here's try black tap milkshake without spending $15
1,1,10,47,0,9,0,57,0,david beckham immortalized daughter drawing new tattoo
1,1,8,32,0,7,0,40,0,behold terrifying mascot ever exist
1,1,8,37,1,7,0,45,0,here's actually happened hogwarts letter
1,1,13,44,0,12,0,57,0,know piss thanksgiving based zodiac
1,1,7,21,1,6,0,28,0,"could straight, would"
1,1,16,47,3,15,0,63,0,"actor siddharth want u call hero, he's leaving u choice"
1,1,9,32,3,6,0,41,0,best anti-romantic rom-com watching
1,1,9,28,0,7,2,37,0,21 thing mac lover truly appreciate
1,1,7,33,0,6,0,40,0,good luck charm match personality
1,1,9,34,2,8,0,43,0,"""harry potter"" movie watch right"
1,1,15,46,0,14,0,61,0,people pretending faint front dog see react
1,1,13,43,2,13,4,56,0,"oprah interviewed cast ""friends"" 1995 melt heart"
1,1,12,50,0,11,0,62,0,rob thomas apologizes trying make joke black australian
1,1,11,35,0,10,0,46,0,lady gaga slaying old hollywood look emmy
1,1,11,43,0,9,0,54,0,find next healthy recipe buzzfeed food newsletter
1,1,12,46,1,10,0,58,0,eva longoria took buzzfeed spelling test here's happened
1,1,7,28,0,7,2,35,0,19 time realized dating target
1,1,10,35,1,10,2,45,0,16 face recognize hate talking phone
1,2,13,49,5,14,0,62,0,"buchanan syria: mccain, graham, rubio going get war want"
1,3,11,39,3,10,0,50,0,here's migos make sure valentine's day flop
1,1,7,27,0,7,2,34,0,18 perfect cake people hate people
1,3,1,59,0,14,0,60,0,judge reveals easy way protect loan friend money
1,1,8,40,0,8,2,48,0,miss america apologized vanessa williams 32 year
1,1,11,37,0,9,0,48,0,try cocktail watch favorite cw show
1,1,12,41,0,12,1,53,0,8 slightly gross fact make aware mouth
1,3,6,14,3,3,1,20,0,8 down-to-the-wire tax tip
1,1,10,41,1,9,0,51,0,"baby eats bacon first time, reach peak satisfaction"
1,3,15,45,3,14,2,60,0,14 people hating new whatsapp 'stories' feature much are!
1,3,1,31,2,6,3,32,0,everyone's laughing $400 juicer
1,1,8,27,1,8,2,35,0,"20 way live forever, according news"
1,1,7,15,4,6,0,22,0,f*&%s give
1,1,8,35,1,7,0,43,0,guess celebrities' godparent
1,3,3,36,1,7,2,39,0,15 most-wanted type employee linkedin
1,3,15,56,6,14,0,71,0,"self-proclaimed singer's cover 'closer' bad, actually landed jail!"
1,3,15,38,0,14,0,53,0,listen guy say sleep try laugh
1,1,10,46,0,9,0,56,0,matt damon hilariously reacts sexual tweet ponytail
1,1,11,33,0,10,0,44,0,know zodiac sign based cat choose
1,2,16,45,1,12,0,61,0,"family fight ban usda wildlife trap killed dog, injured son"
1,1,13,32,3,11,0,45,0,what's best pizza place ever eaten u.s
1,2,11,33,2,9,2,44,0,fbi capture 'top 10 wanted' fugitive los angeles
1,1,9,29,2,8,0,38,0,"know correct plural form ""octopus"""
1,3,10,37,0,10,2,47,0,22 joke motivation make laugh thencry
1,2,5,22,1,4,0,27,0,china's great balance sheet play
1,1,10,34,0,9,0,44,0,kim noble art turning suicide theatre
1,1,10,31,1,10,2,41,0,11 people fucking wrong even funny
1,1,10,45,2,10,2,55,0,"31 time ""scream queens"" perfectly described night friend"
1,1,9,27,0,8,0,36,0,make cinnamon donut hole home like pro
1,1,10,42,0,10,2,52,0,25 time gina rodriguez adorable celeb instagram
1,2,4,43,2,12,1,47,0,"bmw's new 7 series luxury car future, today"
1,1,2,13,0,1,0,15,0,happy pugsgiving
1,1,7,33,1,8,6,40,0,22 picture give intense flashback 2006
1,1,10,37,0,10,2,47,0,19 secret people work marketing never tell
1,1,12,45,1,11,0,57,0,"black friday shopper camp entire week, fucking around"
1,2,6,19,0,7,5,25,0,8 creative hobby take in2017
1,2,2,52,2,10,4,54,0,24 mind-blowing fact warren buffett $70 billion fortune
1,1,12,44,1,11,0,56,0,baby's reaction hearing created amazing
1,1,12,38,2,10,2,50,0,"12 reason pete davidson relatable ""snl"" cast member"
1,1,12,71,1,10,0,83,0,best-selling author dismissed postpartum depression screening pharmaceutical conspiracy
1,1,11,40,0,10,0,51,0,people mash various fast food create ultimate food
1,1,5,21,0,6,6,26,0,24 best television moment 2015
1,1,11,37,2,9,2,48,0,27 behind-the-scenes comment hear puppy bowl
1,3,9,47,3,11,0,56,0,latest establishment talking point: trump may guilty treason
1,1,9,37,0,9,2,46,0,27 animal hilariously embodied mean human
1,2,11,43,0,10,0,54,0,beaver somehow ended herding cattle saskatchewan ranch
1,1,14,54,2,13,0,68,0,motorcyclist grabbed unsuspecting girl's foot freeway best
1,3,12,49,2,13,0,61,0,new york times; left alarmed donald trump reach union voter
1,1,7,23,0,6,0,30,0,food grossest
1,1,5,17,0,4,0,22,0,harry style
1,1,7,25,0,8,6,32,0,23 celebrity couple loved lost 2015
1,2,11,39,0,11,2,50,0,17 fitness tip actually make psyched workout
1,1,7,32,2,6,0,39,0,"identify character ""recess"""
1,1,9,27,2,8,0,36,0,"think ""scream queens"" killer"
1,1,4,20,0,5,6,24,0,literally 24 tweet 2015
1,2,8,35,0,7,0,43,0,next netflix murder mystery obsession
1,1,8,36,1,8,2,44,0,21 reason michael b. jordan everything instagram
1,2,13,41,3,11,0,54,0,mulder scully might kissing first 'x-files' set photo
1,3,11,66,0,14,0,77,0,woman foolishly try take selfie uncooperative crocodile pay price
1,3,9,46,3,7,1,55,0,hb2 repeal: north carolina overturn controversial bathroom bill
1,1,9,33,0,9,2,42,0,31 beautiful poster teach damn thing
1,2,11,39,1,11,6,50,0,ncaa tournament 2017: everything need know sweet 16
1,1,6,25,1,6,2,31,0,window 3.0 solitaire deck
1,3,11,54,1,11,0,65,0,azealia bank post rihannas phone number feud trump executive order
1,1,12,34,2,13,4,46,0,"25 time ""10 thing hate you"" made fall madly love"
1,3,6,67,0,15,0,73,0,black life matter protester jumped barrier take confederate flag list
1,3,11,40,1,10,0,51,0,"watch priest, rabbi atheist smoke weed talk religion"
1,1,6,28,4,5,0,34,0,"please, everyone, stop saying ""squad goals"""
1,2,2,18,3,5,7,20,0,africa's top shots: 8-13 april 2017
1,1,3,21,0,3,2,24,0,11 startling boob confession
1,1,14,47,3,13,0,61,0,"know ""game thrones"" character like based zodiac"
1,3,12,67,6,15,0,79,0,clinton trump: cannot speak protecting syrian baby close america door
1,3,8,30,1,9,0,38,0,iphone android yoga app best me?
1,1,6,26,0,6,2,32,0,24 people simply stopped caring
1,1,11,44,1,10,0,55,0,"growing female audience, marvel hope invite everyone"
1,1,9,33,1,8,2,42,0,13 glorious made-up word literature
1,2,2,38,1,8,0,40,0,happy places: vacation spot call home
1,1,10,33,2,10,2,43,0,"27 moment ""how met mother"" fan never forget"
1,1,12,38,3,11,2,50,0,"27 time ""fresh prince bel-air"" funniest show ever made"
1,1,14,40,2,13,0,54,0,"drop everything google ""a long time ago galaxy far far away"""
1,1,8,29,0,7,0,37,0,cara delevingne taylor swift
1,1,10,36,3,8,0,46,0,what's funniest pop-punk tumblr post ever seen
1,2,3,41,2,12,0,44,0,'saved bell' diner coming city near
1,1,9,28,1,8,0,37,0,groom saved guest's life wedding
1,1,7,40,0,7,2,47,0,33 everyday word hilariously punny double meaning
1,2,12,74,4,12,2,86,0,shattered revelation: clinton campaign hatched russian hacking narrative 24 hour hillary loss
1,2,9,52,2,11,0,61,0,"russian hacked democrat plan cheat general election,"
1,1,10,42,2,10,2,52,0,"28 reason ross geller actually best character ""friends"""
1,3,9,38,2,10,0,47,0,corkscrew? problem. better way open winebottle
1,1,8,25,0,8,2,33,0,33 healthy thing eat work
1,1,8,25,0,7,0,33,0,one real yankee candle name
1,1,10,29,0,10,2,39,0,19 picture way real night
1,2,3,50,1,10,0,53,0,make dorie greenspans cheese bacon apro quick bread
1,2,3,37,3,7,0,40,0,vote: finalist win year's heisman?
1,1,5,24,0,5,2,29,0,19 thing michigander know true
1,3,14,45,1,13,0,59,0,plan day disneyland we'll tell disney princess
1,3,2,67,0,11,0,69,0,three best documentary oscar nominee capture history racial division
1,3,3,57,3,13,0,60,0,"woman slashed trump sign florida 'ruined chill,' cop say"
1,1,10,29,0,10,4,39,0,movie made u love hate sequel 2015
1,1,6,21,0,5,0,27,0,umbrella worst
1,3,9,35,2,11,0,44,0,"warp speed wont get u stars, might"
1,3,1,44,0,11,0,45,0,brave men wrangle giant snake car engine
1,1,11,23,0,9,0,34,0,would tv show life like
1,3,3,45,2,9,0,48,0,"walking jesus walk, modern twist easter season"
1,1,14,48,2,13,0,62,0,valentine's day story prove maybe worst day year
1,2,11,55,6,14,0,66,0,"tapper: lot medium think lot trump supporter deplorable, racist"
1,1,9,33,0,8,0,42,0,hogwarts house pop diva belong
1,2,2,55,3,9,0,57,0,nicotine: honest account emotional complexity quitting
1,1,8,27,0,7,0,35,0,everyone look hella drunk pic
1,1,14,68,1,13,0,82,0,here's happened twentysomethings tried cooking family recipe first time
1,1,5,37,0,7,2,42,0,12 recipe celebrate chocolate chip cookie
1,2,12,52,0,12,2,64,0,49 people tell u realised open sexualitymattered
1,1,13,36,0,13,3,49,0,photo 500 sheep snowy field mess mind
1,1,12,43,1,11,0,55,0,there's weed menstrual cramp stick vagina
1,1,6,22,0,5,0,28,0,song help get motivated
1,1,8,26,1,7,0,34,0,need talk justin bieber's hair
1,3,2,41,0,10,1,43,0,5 vr safety tip stop destroying home
1,1,13,38,1,12,0,51,0,"hold up, know channing tatum sing like angel"
1,1,6,22,0,5,0,28,0,cheap american beer
1,1,14,51,0,13,0,65,0,man giving software away free help people disability
1,1,6,21,2,7,5,27,0,"19 life lesson ""500 day summer"""
1,2,18,58,2,16,2,76,0,"security caught napping 65-yo woman sneak axe metro train, attack passenger"
1,1,10,33,0,10,2,43,0,17 creepy video send chill spine
1,2,8,33,0,7,0,41,0,inkblot test reveal actualissues
1,1,12,37,3,11,0,49,0,"here's ""toy story"" voice actor look like real life"
1,1,12,43,1,9,0,55,0,amber rose opened slut-shaming slutwalk event
1,1,7,25,0,7,2,32,0,23 wonderful way eat cake winter
1,1,14,27,3,7,0,41,0,"dear world, ruining indian food, please stop"
1,3,11,47,2,12,0,58,0,analysis: learned rex tillerson's debut world stage
1,1,7,33,0,7,2,40,0,11 time one direction literally dragged
1,1,11,36,0,10,0,47,0,thing sikh community want know
1,3,2,71,3,13,0,73,0,"finland basic universal income solution automation, fewer job lower wages?"
1,1,7,18,2,4,0,25,0,"abc according ""friends"""
1,1,10,36,0,9,0,46,0,nutella dessert based birth month
1,1,11,47,1,11,1,58,0,insane $6 bathing suit amazon actually look good everyone
1,1,11,34,1,10,0,45,0,katy perry's new song get holiday spirit
1,1,14,59,1,14,2,73,0,17 hilarious tweet india's censor board cutting kissing scene new bond film
1,1,8,44,0,7,0,52,0,someone please buy caffeinated bracelet immediately
1,1,7,28,3,9,6,35,0,29 unmistakable sign '90s '00s kid
1,2,2,42,0,9,0,44,0,life gay israeli military got easier
1,1,8,32,0,7,0,40,0,kid talk parent got divorced
1,3,10,38,0,10,2,48,0,12 gripe people problem thing alone
1,1,6,19,0,6,2,25,0,19 time drake last laugh
1,1,4,10,0,3,0,14,0,carb
1,1,9,34,2,6,2,43,0,18 time leonardo dicaprio out-leo dicaprio'd
1,3,17,54,3,14,0,71,0,"soldier's wife seek cbi probe, anil vij's comment gandhi must read story"
1,1,6,27,0,5,0,33,0,men admit feeling loneliness
1,1,7,24,0,7,2,31,0,21 greeting card need calm
1,1,8,33,0,7,0,41,0,resolve conflict friendship
1,1,14,44,3,13,0,58,0,"hey lazy people, here's new super easy, delicious prawn dish try"
1,1,13,40,0,12,0,53,0,cat box bed solution literally problem
1,2,1,54,0,9,0,55,0,republican divided help people buy health insurance
1,3,2,36,6,8,0,38,0,"'it's crazy, sure': meet star musical.ly"
1,1,16,56,2,16,4,72,0,"taylor swift haim danced flawlessly nelly sang ""hot herre"" 1989 world tour"
1,1,11,44,0,10,0,55,0,identify disney channel movie celebrity
1,2,6,30,2,6,1,36,0,'bachelor paradise' season 2 cast revealed
1,1,7,36,0,7,2,43,0,24 makeup milestone anyone obsessed beauty
1,2,3,67,0,12,2,70,0,destination 19 photograph prove alaska beautiful place america
1,1,7,23,1,6,0,30,0,here's bad boy always sexier
1,1,5,28,0,4,0,33,0,military suicide prevention fails
1,2,12,66,3,11,0,78,0,"'ugliness handicap' reason behind higher dowry, teach maharashtra school textbook"
1,2,1,28,0,6,2,29,0,10 best tennis moment culture
1,1,10,42,0,9,0,52,0,gay men gave lesbian makeover result disastrous
1,1,9,25,0,9,4,34,0,guess many people kissed 2015
1,1,5,29,0,4,0,34,0,pigeon love wearing bagel apparently
1,1,12,40,1,13,4,52,0,16 thing tear cried listening adele's 25
1,2,3,66,1,11,0,69,0,happens extremely unlikely scenario electoral college go rogue?
1,1,7,34,0,7,2,41,0,19 thing probably never knew nightmare
1,1,7,36,1,7,2,43,0,23 delicate moonstone necklace never take
1,2,9,38,1,8,1,47,0,7 quick easy money-saving idea young millennials
1,3,7,21,0,6,0,28,0,best deal amazon today
1,1,9,32,0,9,2,41,0,21 chill gift get holiday season
1,3,1,53,1,9,0,54,0,woman battling cancer stunned diner's amazing act kindness
1,1,11,45,2,10,0,56,0,"""harry potter"" character marry based zodiac"
1,1,9,12,0,7,6,21,0,29 wtf tv moment 2015
1,1,8,30,2,7,0,38,0,tweeted it? donald trump vs. kim kardashian
1,1,18,56,0,18,1,74,0,world like last time someone sold 2 million album one week
1,2,16,60,0,15,0,76,0,twinkle khanna best reaction seeing vendor sell pirated copy book
1,1,8,31,0,9,6,39,0,69 excellent indie record may missed 2015
1,1,4,27,0,3,0,31,0,journey trans masculinity
1,3,8,32,1,7,0,40,0,let talk fucking repulsive eggnogis
1,1,9,29,1,8,0,38,0,"whoa, jimmy kimmel look super hot beard"
1,3,12,37,2,14,7,49,0,11 great movie 2016 stream netflix (and 1 hulu)
1,1,10,38,1,9,0,48,0,"dude, actually rent entire island airbnb"
1,3,12,60,3,11,0,72,0,megyn kelly-roger ailes sexual harassment allegation film set big short writer
1,2,7,29,1,7,2,36,0,26 little thing ruin every teachersday
1,3,1,63,1,9,0,64,0,hundred people protest-rolling hill delightfully mesmerizing
1,1,17,59,1,16,0,76,0,model perfect response reporter asked she'd eat fashion show
1,1,11,47,0,10,0,58,0,test determine people find attractive
1,1,12,52,1,12,2,64,0,"17 young adult novel read, based favorite literary classic"
1,1,9,41,3,9,4,50,0,"kylie jenner's resolution 2016 literally ""realize stuff"""
1,1,9,44,0,9,2,53,0,25 year great missouri earthquake never happened
1,2,10,46,1,9,0,56,0,news anchor learns husband's death live broadcast
1,1,7,24,0,6,0,31,0,well know katniss everdeen
1,2,4,46,1,11,1,50,0,"say someone cancer, according 6 patient"
1,1,5,21,0,4,0,26,0,emoji keyboard arrived
1,2,8,37,2,9,0,45,0,sign time career change ashford university
1,1,5,18,0,4,0,23,0,gay ask lesbian sex
1,3,7,22,1,6,2,29,0,"20 year ago, tv looked different"
1,3,11,48,2,11,1,59,0,carrie fisher's singing voice: 5 time shared hidden musical side
1,1,12,41,1,11,0,53,0,people tried figure max ruby's parent
1,3,8,45,3,8,0,53,0,"republican party, megyn kelly, titanic: wednesday briefing"
1,1,6,26,0,6,2,32,0,18 thought everyone hookup
1,1,12,33,1,10,2,45,0,18 confession reveal like live ocd
1,3,7,28,1,7,1,35,0,get back work! 6 clever productivity apps
1,1,9,26,1,8,0,35,0,want call frisco? ask hell angel
1,1,7,21,0,6,0,28,0,well know regina george
1,1,10,46,1,9,0,56,0,food test determine actually pennsylvania
1,3,8,41,4,13,1,49,0,blac chyna drag tyga snapchat 4 morning: 'ur b*tch'
1,1,10,34,0,10,2,44,0,37 insane picture ever taken burning man
1,1,14,58,0,13,0,72,0,american kid tried dinner around world reaction next level
1,2,6,22,1,5,0,28,0,popular emo opinions?
1,1,7,35,1,7,2,42,0,19 stealthy product protect thing
1,1,12,43,1,11,0,55,0,taylor swift's family took halloween whole new level year
1,1,13,38,0,12,0,51,0,solve puzzle get little pop culture
1,1,10,38,2,10,2,48,0,"26 tumblr post ""star wars"" guaranteed make laugh"
1,1,10,47,1,10,2,57,0,40 suggestion posh spice's replacement spice girl reunion
1,2,9,30,0,8,2,39,0,ice round 44 criminal alien texas capital
1,1,9,34,3,9,2,43,0,"18 thing know ""while sleeping"""
1,1,7,19,0,7,2,26,0,17 secret want tell ex
1,1,12,53,2,11,0,65,0,"natalie dormer auditioned completely different role ""game thrones"""
1,1,12,49,0,11,0,61,0,new glitter root hair trend woman dumping sparkle onto head
1,2,6,41,0,11,2,47,0,difference uk u 14 picture list
1,2,3,27,0,6,3,30,0,family take lead mh370 mystery
1,1,9,33,0,8,0,42,0,taco bell menu item match zodiac sign
1,1,10,35,0,10,2,45,0,17 struggle parent hate way dress
1,1,11,54,2,10,0,65,0,"lane ""gilmore girls"" maybe definitely confirmed revival happening"
1,2,11,48,0,12,0,59,0,unlikely south american capital need put bucket list
1,1,9,39,0,9,2,48,0,23 people look drop dead amazing wearing brown lipstick
1,1,15,50,1,14,0,65,0,couple want show traveling partner always fairy tale
1,3,1,34,0,7,0,35,0,gender identity term need know
1,1,7,45,0,7,2,52,0,17 reaction everyone recognize engagement season
1,1,8,42,1,9,2,50,0,20 cereal recipe stress-eat new episode serial
1,1,11,26,0,9,2,37,0,20 iconic aim away message time
1,3,6,17,0,6,0,23,0,lose airpods
1,1,7,24,0,7,2,31,0,42 urgent question cat
1,1,10,42,4,7,0,52,0,what's weirdest thing gotten trick-or-treating
1,1,13,45,0,13,2,58,0,11 thing really need know annoying bump arm
1,3,1,47,0,7,0,48,0,spring breaker save people devastating house fire
1,1,13,34,3,10,0,47,0,"fka twig radiates power cover ""paper,"" love cake"
1,1,12,43,0,12,1,55,0,8 thing need know gabriel iglesias weight loss
1,3,0,43,0,8,6,43,0,21 incredible innovation improved world 2016
1,1,8,24,0,7,0,32,0,well know zodiac symbol
1,1,6,26,0,6,2,32,0,17 question twin sick answering
1,1,7,32,0,7,2,39,0,10 badass hairstyle need try immediately
1,2,2,48,0,9,0,50,0,family holiday parent holiday better u
1,2,2,57,4,11,6,59,0,"unknown 25-year-old election spending $1,300 facebook promotion"
1,2,9,27,0,9,2,36,0,18 joke send friend love drama
1,2,10,47,0,10,0,57,0,eleven way stop winter weather delay ruining travel
1,1,8,27,1,8,2,35,0,13 pet understand cute
1,1,6,20,2,6,5,26,0,14 drive-thru worker 100% done
1,3,13,69,0,13,0,82,0,russell westbrook give great response reporter asked stats following playoff loss
1,1,8,27,0,8,2,35,0,17 photo woman small foot relate
1,2,14,33,0,10,0,47,0,brody jenner trying say nsfw cartoon
1,3,1,29,1,6,0,30,0,say hello body's newest organ
1,1,10,39,1,10,2,49,0,19 thing understand refuse answer phone
1,1,17,53,0,15,0,70,0,one black college survived leap division ii division back
1,1,6,23,0,5,0,29,0,hug hater get surprise group hug
1,1,11,46,1,10,0,57,0,what's weirdest sexual question parent ever asked
1,3,7,23,0,7,2,30,0,19 lie actually believed ateen
1,1,13,41,0,11,0,54,0,buffalo chicken potstickers dope af easy make
1,1,7,37,2,6,0,44,0,"someone created scariest ""simpsons"" opening ever"
1,1,10,35,0,9,0,45,0,many kind french fry actually eaten
1,2,10,59,2,12,0,69,0,intelligence agency concluded russian attack u.s. election
1,1,7,21,0,7,4,28,0,2016 good luck symbol
1,1,9,29,0,9,2,38,0,31 tumblr post straight fuck
1,2,14,56,1,13,0,70,0,family spends freezing night car gps direction leave stranded yahoo
1,2,18,55,2,17,1,73,0,"ahead poll 5 states, sc say politician can't seek vote name caste religion"
1,1,5,27,1,4,2,32,0,19 super-interesting disney music fact
1,1,10,32,1,7,0,42,0,here's people lol differently around world
1,1,6,24,0,7,6,30,0,32 dumbest thing happened 2015
1,1,12,43,0,11,0,55,0,product trending amazon week
1,1,8,38,0,8,2,46,0,39 accessory look exactly like favorite food
1,1,8,32,1,8,2,40,0,31 time frankie boyle's twitter control
1,3,8,43,3,8,0,51,0,china's enrichment spawn mature problem -- middle class angst
1,3,10,49,1,9,0,59,0,politician planning skip donald trump inauguration
1,3,5,54,6,12,0,59,0,miner bo copley: trump executive order climate good start [video]
1,3,1,48,2,7,0,49,0,'pussyhat' knitter join long tradition crafty activism
1,1,7,27,0,7,2,34,0,34 amazing way use halloween candy
1,1,9,29,0,8,0,38,0,best place get underwear
1,1,8,21,0,7,6,29,0,22 reason samoyed animal 2016
1,1,8,40,0,8,2,48,0,18 moment incredible humanity chennai rain
1,3,6,32,1,6,2,38,0,43 impossibly cute product youll actuallyuse
1,2,11,29,1,10,2,40,0,tv pet peeves: 10 thing really make u nut
1,1,9,30,0,9,2,39,0,23 online store still time order
1,3,6,47,1,6,0,53,0,report: pornography use tied relationship dissatisfaction
1,3,12,37,1,12,2,49,0,19 tweet find funny kind hate health food
1,1,10,36,1,9,0,46,0,here's actually detox eating thing
1,3,19,49,2,15,0,68,0,"srk meet mn chief raj thackeray, aamir khan shed serious image ent"
1,2,15,49,4,13,2,64,0,"16-year-old girl saved pimps, thanks uber driver's alertness"
1,1,11,34,2,10,0,45,0,"well know ""pretty little liars"" theme song"
1,1,12,38,2,12,2,50,0,"21 truth dev rachel taught love ""master none"""
1,1,10,47,0,9,0,57,0,accidental instagram ariana grande uploaded
1,1,9,36,1,8,2,45,0,21 food-inspired dog name actually really cute
1,1,15,45,0,14,0,60,0,people stuck arm hole blindly let tattoo artist ink
1,3,13,37,0,13,2,50,0,24 song literally sing top yourlungs
1,1,12,38,2,11,0,50,0,"dakota johnson say proud ""fifty shade grey"""
1,1,10,40,2,8,0,50,0,mary-kate olsen's wedding decor bowl cigarette
1,3,13,47,4,12,0,60,0,teradatavoice: what's virtual unicorn do? verizon knows!
1,1,11,34,3,10,2,45,0,mid-'00s chris pratt best chris pratt here's
1,2,7,44,2,9,0,51,0,best- worst-performing airline world
1,3,2,49,2,11,0,51,0,armour made costly mistake take 'years' fix
1,1,10,38,1,9,0,48,0,show u simple halloween costume ever worn
1,2,1,25,0,8,6,26,0,10 best video game 2016
1,2,1,77,5,17,5,78,0,"luxury music festival ticket cost $12,000 turned nightmare here's happened"
1,2,5,22,1,4,0,27,0,employable actually?
1,1,8,25,2,7,0,33,0,here's like live anxiety
1,3,1,45,0,10,0,46,0,curious case hidden abbot besieged temple
1,3,12,58,3,13,0,70,0,"man hid ex-girlfriends corpse cupboard year, still invited friend"
1,3,13,48,2,12,0,61,0,"true ""friends"" fan answer question first season"
1,3,6,29,1,8,0,35,0,real winner grammys?
1,3,15,54,2,16,3,69,0,4 men caught airport trying smuggle 1.2 kilo gold hidden underwear!
1,3,2,45,1,8,0,47,0,trump say china wont labeled currency manipulator
1,1,7,18,0,8,4,25,0,48 book need read 30
1,1,9,33,0,8,0,42,0,eastern european city made word
1,2,7,35,1,8,0,42,0,secret happy marriage? two master bedroom
1,2,14,57,2,12,0,71,0,bbc presenter given warning saying transgender people never real woman
1,2,14,51,2,14,2,65,0,"woman make obscene video man gunpoint, blackmail r 20 lakh!"
1,2,7,29,0,8,6,36,0,12 moment prove queer teen totally won2016
1,1,12,37,2,11,0,49,0,"kanye west revealed album title ""the life pablo"""
1,1,11,34,1,10,0,45,0,here's actually crush
1,1,7,36,0,7,1,43,0,7 healthy eating trick actually realistic
1,1,14,48,4,13,0,62,0,"well really know lyric ""beauty school dropout"" ""grease"""
1,2,1,55,1,10,0,56,0,walmart reportedly buy hottest men's clothing brand
1,1,9,29,1,11,8,38,0,12 '90s cartoon two decade old 2016
1,1,4,15,2,4,1,19,0,let's talk chanel #3
1,3,2,35,2,8,0,37,0,trump aide draw line lies?
1,1,14,53,4,11,0,67,0,here's look disney-pixar's new short film featuring indian-american family
1,1,13,40,0,12,0,53,0,cute animal would kill chance
1,1,12,39,4,11,0,51,0,"stop listen remix adele's ""hello"""
1,3,9,49,3,9,0,58,0,model candice huffines inspiring advice perfect body
1,1,11,39,1,10,2,50,0,16 super-helpful chart teach actually work
1,1,9,40,1,9,2,49,0,16 christmas pinterest fails almost nailed
1,3,12,28,1,10,2,40,0,goldman sachs: 17 stock long way fall
1,1,6,15,0,5,0,21,0,handle food thief
1,1,10,53,2,8,0,63,0,gina rodriguez tackle hollywood's problem latino diversity head-on
1,1,9,34,2,9,2,43,0,"31 post prove ""harry potter"" funniest fan"
1,3,8,41,6,9,0,49,0,"wonder woman, spider-man trailer push familiar"
1,1,16,53,0,15,0,69,0,male actor get christmas based first letter name
1,1,10,37,1,9,0,47,0,mitch albom wish reading phone
1,3,17,43,1,9,0,60,0,jpmorgan chasevoice: leadership lesson ceo jpmorgan chase
1,1,6,32,0,5,0,38,0,people try making pinterest hanukkah craft
1,1,13,44,3,12,0,57,0,"terrain taylor swift's ""out woods"" music video"
1,2,11,51,3,12,0,62,0,believe trump dressed 'superhero' costume party insider
1,3,6,30,1,5,0,36,0,psychology explains always late
1,3,7,79,5,19,0,86,0,revealed: monthly salary expect earn according age (and lower think!)
1,2,11,48,1,10,0,59,0,here therapist want know politicallyactive
1,1,10,35,0,9,0,45,0,couple lost two ring within two day marriage
1,1,12,38,1,11,0,50,0,here's six amazing trick get wardrobe
1,1,10,31,2,10,2,41,0,"30 thing need know mike ""the miz"" mizanin"
1,1,9,36,0,9,2,45,0,70 classic black film everyone see least
1,1,6,20,0,5,0,26,0,halsey music video
1,1,10,34,0,10,2,44,0,24 academic tweet make laugh cry
1,1,7,23,2,7,2,30,0,"18 way ""fallout"" ruined life"
1,1,11,32,0,10,0,43,0,see drawing way people
1,3,15,61,2,14,0,76,0,syrian refugee hala kamil made powerful red carpet statement here's important
1,1,15,50,0,14,0,65,0,black friday brawl video woman stealing little kid probably fake
1,1,15,38,1,13,0,53,0,expert teach u makeup like grown-ass woman
1,1,8,22,1,6,0,30,0,drake low-key one direction stan
1,3,12,59,2,14,5,71,0,"credit suisse say plan hire 10,000 muslim refugee hurting starbucks brand sale"
1,1,10,37,0,10,1,47,0,9 photo oscar isaac proudly gazing golden globe
1,1,17,49,2,16,0,66,0,new round celebs reading mean tweet great expect
1,1,8,31,0,8,2,39,0,17 celebrity instagrams need see week
1,1,10,29,2,9,0,39,0,"well know lyric ""hakuna matata"""
1,1,8,25,0,8,4,33,0,many british movie watch 2015
1,1,8,20,3,6,0,28,0,fall l.a. vs. fall everywhere else
1,1,9,26,1,9,1,35,0,find horoscope week nov. 2
1,1,10,36,0,10,2,46,0,12 chart everyone lived dorm understand
1,1,8,28,1,8,2,36,0,18 thing happen gay fresher
1,3,1,32,0,9,2,33,0,ranking top 10 hoop shoe ad time
1,3,6,25,2,8,0,31,0,lie me: fiction post-truth era
1,1,18,63,0,17,0,81,0,guy proposed girlfriend roller coaster caught whole thing camera
1,3,13,46,2,11,0,59,0,modernizing u.s. army could make nuclear war russia less likely
1,1,9,40,3,9,2,49,0,"13 ""hamilton"" horoscope tumblr know needed"
1,1,6,32,1,7,4,38,0,29 book every '90s kid immediately recognize
1,3,13,51,2,12,0,64,0,"brazilian football referee breaking internet, here's going"
1,3,13,42,0,11,0,55,0,elliot fletcher break boundary one trans actor tv
1,3,12,66,2,14,0,78,0,"shock videos: meet ray buckley, might actually become chairman democratic party"
1,3,10,46,2,10,0,56,0,donald trump: medium doesnt cover large crowd march life
1,1,9,37,0,8,0,46,0,know relationship status based one question
1,3,11,40,4,13,1,51,0,"one cookie, 2 versions: girl scout smores wont"
1,2,14,57,4,10,0,71,0,msnbcs reid: voice america broadcast network could become essentially breitbart
1,2,8,36,2,8,2,44,0,10 embarrassing would rather question
1,3,7,25,1,6,1,32,0,9 little thing long-term couplesdo
1,1,10,41,1,8,0,51,0,artist re-imagined super mario famous cultural icon
1,1,7,23,2,6,2,30,0,25 one-dish meal idea pasta
1,3,10,52,0,11,0,62,0,heartbreaking photo vet neglected va spark outrage insider
1,2,3,18,0,3,4,21,0,celebrity holiday card 2016
1,2,3,68,1,11,0,71,0,"worst mistake everybody make cooking steak, according anthony bourdain"
1,1,8,25,0,8,2,33,0,21 powerful photo week
1,1,11,33,2,9,0,44,0,re-created photo kid cry santa's lap
1,1,10,39,1,9,2,49,0,21 insanely easy single-dish meal change life
1,1,10,36,2,9,0,46,0,"need see ""dirty thunderstorm"" mount etna"
1,3,3,43,1,8,0,46,0,scientist studying whale new york's coast
1,1,10,37,1,9,0,47,0,penguin couple better valentine's day
1,1,10,35,2,9,0,45,0,here's proof cat know they're bos everyone
1,1,14,47,0,14,2,61,0,23 time fashion week finally kept real put natural hair runway
1,1,10,48,1,8,0,58,0,guess celebrity tweeted holiday-themed tweet
1,1,8,32,0,8,2,40,0,30 chilling photo attack pearl harbor
1,1,11,52,2,10,0,63,0,"several indian came together send message called ""dear terrorists"""
1,2,6,17,0,6,1,23,0,4 great book read inmarch
1,1,9,38,0,9,2,47,0,17 cute halloween makeup tutorial got way creepy
1,3,6,27,0,6,0,33,0,sex therapist really thinking
1,3,4,49,2,8,0,53,0,washington state sock recalled 'go dawgs' printed inside
1,1,12,40,3,10,2,52,0,"87-year-old may best, canadian neighbour canada"
1,1,7,15,0,7,2,22,0,17 cat could use day
1,1,10,37,1,9,0,47,0,"football aside, tom brady take really cute dad pic"
1,1,12,28,0,11,0,40,0,like man eating disorder
1,1,6,26,1,5,2,32,0,18 easy delicious one-pan breakfast
1,1,25,49,1,15,0,74,0,here's unbearably cute footage ranveer deepika remind alone
1,1,10,29,4,8,0,39,0,"guys, ""america's next top model"" returning tv"
1,1,9,25,2,7,0,34,0,"character ""the crowd"""
1,3,5,58,2,14,2,63,0,took 10 minute explain trump north korea 'complicated' list
1,1,14,52,0,13,0,66,0,deformed mountain lion fascinating also might make gag little
1,1,14,54,2,14,1,68,0,"selena gomez chloe grace moretz new supremes trailer ""neighbors 2"""
1,1,10,23,1,9,0,33,0,"herb, would name"
1,2,1,60,1,10,0,61,0,"want children, husband struggle climax intercourse"
1,1,8,29,0,8,2,37,0,17 amazing emma watson gift need right
1,1,11,30,2,11,2,41,0,"23 adorable way say ""i love you"" best friend"
1,1,10,44,3,12,4,54,0,21 wardrobe staple every '00's girl swore abercrombie fitch
1,3,10,39,1,9,6,49,0,"jpmorgan software second took lawyer 360,000 hour"
1,3,1,47,1,7,0,48,0,much normalizing abnormal president deserve?
1,2,1,30,1,9,0,31,0,like live next prison?
1,1,8,41,1,6,0,49,0,first-generation american talk american dream
1,1,15,43,0,14,0,58,0,one tip help guy dress better rest life
1,1,15,44,0,12,0,59,0,celebrity bffs best friend based one question
1,2,14,45,2,12,0,59,0,tucker carlson take bill o'reilly's time slot way one
1,1,11,44,0,11,2,55,0,20 hilarious tweet make think twice kid
1,2,6,29,1,5,0,35,0,america's favorite vinyl record state
1,1,8,23,0,7,0,31,0,let tarot help crush
1,2,8,56,1,8,0,64,0,"illegal immigrant accused repeatedly raping, kidnapping autistic woman"
1,1,8,45,0,8,2,53,0,23 time tumblr cleverly explained genderqueer mean
1,1,19,49,1,18,0,68,0,video man pushing bin icy path funniest thing see today
1,1,13,42,1,12,0,55,0,know excited right based one question
1,3,2,48,2,12,6,50,0,year flood: nation 10 extreme weather event 2016
1,1,9,32,3,9,2,41,0,"10 time lost sh*t watching ""hamilton"" musical"
1,1,9,32,0,9,2,41,0,26 thing make sense ungirly girl
1,1,5,25,0,4,0,30,0,stereotypically single
1,3,12,56,4,13,0,68,0,pantsuit nation: hillary facebook group get book deal member livid
1,3,8,34,2,6,0,42,0,huge fire hit france grande-synthe migrant camp
1,2,5,86,1,15,0,91,0,"white house social medium director misused official position going gop lawmaker, ethic expert say"
1,1,8,39,0,8,2,47,0,16 time unnecessary censorship made sport dirty heck
1,2,3,17,0,5,6,20,0,22 breakout movie star 2016
1,1,5,12,1,4,2,17,0,22 jojo's best tweet
1,1,9,34,0,8,0,43,0,costume halloween year
1,1,10,31,0,9,0,41,0,many iconic teen movie seen
1,1,12,50,1,12,2,62,0,21 embarrassing liz lemon moment make feel better
1,3,1,44,1,8,0,45,0,here much tipping hairdresser
1,1,9,37,0,8,0,46,0,every tourist know coming london
1,1,10,41,2,8,0,51,0,people disappointed kanye's slut-shaming amber rose
1,3,5,33,0,6,2,38,0,12 tip gracefully returning holiday gift
1,1,10,21,2,8,0,31,0,found l.a. food ever
1,3,10,49,2,11,0,59,0,"crosby, stills, nash young could reunite shared hatred trump"
1,1,10,43,0,9,0,53,0,one direction played final show thing got emotional
1,1,10,42,0,10,2,52,0,43 overlooked place travel lover list
1,1,10,42,2,9,0,52,0,"i, person horrible eyeliner, tried pinterest eyeliner tip"
1,1,6,33,1,6,2,39,0,adorable animal advent calendar: december 18
1,2,15,60,5,18,0,75,0,"gorsuch: scalia lion law judge look law demands, prefer"
1,3,2,30,1,5,0,32,0,shattering all-american town
1,1,11,34,2,10,0,45,0,"baker dance turkish version ""bake off"""
1,1,12,53,2,11,0,65,0,"mumbai sending powerful message love, support, solidarity paris"
1,1,9,39,0,9,2,48,0,21 unbelievably delicious thing cookie dough
1,1,20,65,3,18,1,85,0,9-year-old boy cerebral palsy everton's goal month contest whole thing amazing
1,1,10,34,2,9,0,44,0,"season ""buffy vampire slayer"" soul"
1,1,18,66,4,16,0,84,0,"billy street talk pizza rat gay, donald trump's anus-mouth, hilarious hot topic"
1,3,1,41,0,10,0,42,0,alligator seems go little ride manatee
1,1,11,40,0,10,0,51,0,amazing thing happened wedding
1,1,7,17,3,5,2,24,0,17 life-changing way eat m&m's
1,2,14,55,3,15,1,69,0,"govt care cash crunch, raise fuel price 5 major read today"
1,2,1,43,0,8,2,44,0,10 incredible photo defiance history list
1,3,4,55,2,9,0,59,0,kremlin leader bragged tipping u.s. presidential election
1,1,11,37,0,11,2,48,0,86 lana del rey lyric need instagram caption
1,1,12,39,3,11,0,51,0,"nadiya's speech end ""bake off"" incredibly moving"
1,3,6,35,1,7,0,41,0,watson make stunning horseshoe putt espn video
1,1,8,22,0,7,0,30,0,would one sims trait
1,1,9,37,0,8,0,46,0,watch one man transform five woman makeup
1,1,8,38,1,7,2,46,0,18 unforgettable way pizza-tize superbowl party
1,1,11,23,1,9,2,34,0,well remember wwf early '90s
1,1,9,45,0,9,2,54,0,21 time tumblr user perfectly summed relationship goal
1,1,12,44,0,10,2,56,0,56 thought watching shia labeouf watching shia labeouf movie
1,1,10,38,1,8,0,48,0,need beer-battered chicken tikka popcorn life
1,2,6,23,0,6,2,29,0,22 product world never askedfor
1,1,6,42,0,6,2,48,0,24 perfectly romantic wedding song twentysomethings
1,2,2,29,0,4,0,31,0,world landmark recreated lego
1,1,7,19,0,6,0,26,0,assassin templar
1,2,9,52,4,9,4,61,0,"scarlett johansson lead superhero-filled list 2016's ""top grossing actors"""
1,2,7,22,1,7,0,29,0,shox fox get smoked espn video
1,1,11,33,1,13,8,44,0,21 thing 2015 look fucking weird 10 year
1,1,8,27,0,7,0,35,0,like general princess leia
1,1,9,42,2,9,2,51,0,"21 time ""catastrophe"" perfectly summed life thirty"
1,3,8,35,1,7,0,43,0,biggest money mistake makedecade decade
1,1,8,30,0,7,0,38,0,pas really tricky spelling test
1,1,10,33,1,9,1,43,0,8-picture test reveal deep truth
1,1,8,34,3,8,2,42,0,"79 thought we've watching ""the bachelor"""
1,1,9,33,0,10,6,42,0,40 country song defined life early 2000s
1,1,6,34,2,6,2,40,0,"15 ""geordie shore"" quote inspirational poster"
1,1,10,38,0,9,0,48,0,inkblot test know job actually
1,1,8,31,0,8,2,39,0,23 thing could happen san francisco
1,2,8,35,3,9,0,43,0,schumer: trump far president little impact
1,1,9,36,0,7,2,45,0,23 academy award gifs perfect everyday situation
1,3,1,50,1,9,0,51,0,man's attempt fiery shot end predictable disaster
1,3,9,29,2,8,0,38,0,here really like anabortion
1,3,2,33,3,7,0,35,0,workout: netball give massive buzz
1,2,7,35,3,7,0,42,0,paul ryan: devin nunes source whistleblower type
1,1,8,34,0,9,6,42,0,25 ridiculously romantic moment made u cry 2015
1,1,6,20,0,5,0,26,0,liquid candy bar taste test
1,1,12,44,0,11,0,56,0,actress chopped hair inspiring reason
1,1,4,29,0,3,0,33,0,american review australian currency
1,3,13,68,4,15,0,81,0,"anthony michael hall, madonna, celebs reputation bad neighbor [video]"
1,1,9,23,0,8,0,32,0,role would play bank heist
1,1,11,38,0,10,0,49,0,guess celeb person think look like
1,1,9,32,2,8,0,41,0,"jessica chastain best part ""crimson peak"""
1,1,12,33,1,11,0,45,0,here's actually get rid acne body
1,1,13,40,0,12,0,53,0,profane message need hear based star sign
1,1,11,31,2,10,0,42,0,"busy ramone amanda zimm ""ready not"""
1,1,10,47,0,10,2,57,0,19 intimate confession couple feel pressure get married
1,1,11,42,0,10,0,53,0,know favorite celeb based least favorite celebs
1,1,9,44,0,9,2,53,0,19 creepiest weirdest thing child actually said
1,1,15,55,1,14,0,70,0,someone likely stop talk stranger they're dressed attractively
1,1,10,36,2,10,2,46,0,"16 question really hard ""skins"" fan answer"
1,1,6,26,1,7,6,32,0,18 resolution regret making 2016
1,1,7,38,0,7,2,45,0,21 british christmas tradition america need adopt
1,1,10,29,0,9,0,39,0,people fear dog meet pit bull puppy
1,1,9,30,0,8,0,39,0,actually sex wedding night
1,1,12,43,2,10,2,55,0,22-year-old college student became world champ beer mile
1,3,12,38,1,10,0,50,0,air india offer free wi-fi domestic flight july
1,2,2,34,3,5,0,36,0,kashmir violence: online video 'show abuse'
1,1,11,23,0,9,1,34,0,need 5 diy hair mask life
1,2,13,50,3,12,0,63,0,susan rice: donald trump stone cold crazy appointing steve bannon nsc
1,1,10,36,0,10,2,46,0,18 sweet savory dinner combo blow mind
1,1,14,55,2,13,0,69,0,"get christmas based favorite ""big bang theory"" character"
1,2,1,32,0,7,0,33,0,cocaine body brain
1,3,10,40,0,10,4,50,0,try passing tricky grammar test eighth grader took in1912
1,1,7,23,0,7,1,30,0,6 unique way drink coffee
1,1,10,39,0,9,0,49,0,font test reveal something deeply true
1,1,9,37,3,8,0,46,0,"there's crazy dessert trend year called ""piecaken"""
1,1,10,32,0,9,0,42,0,ice cream satan intends destroy world
1,3,9,29,1,9,2,38,0,21 tweet trader joes damntrue
1,1,8,42,0,8,2,50,0,19 extremely satisfying moment every woman look forward
1,1,7,26,0,7,2,33,0,18 thing every beer drinker need know
1,3,9,24,0,9,4,33,0,know many people slept in2016
1,1,9,41,1,8,2,50,0,27 life-changing product really helped people acne
1,3,10,36,5,10,2,46,0,see ivanka trump jared kushners new $5.5 million d.c. home
1,1,12,44,0,11,0,56,0,groom surprised grandma hospital wedding day
1,2,10,41,0,9,0,51,0,tv producer ken ehrlich memorable grammy moment
1,1,9,29,0,9,2,38,0,19 picture prove man bun gone far
1,3,7,35,2,7,0,42,0,jerry brown seek common ground donald trump
1,1,3,10,0,2,0,13,0,goy try latke
1,3,3,39,1,6,0,42,0,nigeria uyo church collapse: footage aftermath
1,1,9,37,0,9,2,46,0,17 thing canadian tried smuggle border
1,3,4,53,3,12,0,57,0,love harrison ford even he causing real life havoc. here
1,3,5,81,3,17,0,86,0,"unsure theresa may actually meant brexit speech, i've deconstructed line line"
1,1,8,46,0,8,2,54,0,15 embarrassing situation every lightweight drinker
1,1,10,34,0,9,0,44,0,identify kesha music video screencap
1,1,8,40,0,8,2,48,0,22 time ariana grande actually pretty damn surprising
1,1,7,32,0,7,2,39,0,17 people hilarious language brain fart
1,1,11,40,0,11,2,51,0,21 way optimist could explain one worst habit
1,1,7,27,4,7,2,34,0,"what's absolute best song adele's ""25"""
1,2,1,35,0,7,0,36,0,get ready another year global tumult
1,1,7,27,1,8,0,34,0,said it: alice cooper dalai lama
1,1,6,28,2,5,0,34,0,"""steven universe"" character"
1,1,10,34,0,10,2,44,0,13 perfect holiday gift horror fan life
1,1,7,26,1,7,2,33,0,'00s hit best describes love life
1,1,10,43,2,9,0,53,0,"evan peter character ""american horror story"""
1,1,10,41,3,8,0,51,0,"scales, measuring cups: learning cook caribbean-style"
1,1,10,36,0,10,2,46,0,10 world landmark could look like epic drought
1,1,15,38,0,10,0,53,0,everybody watching gop debate made cnn plane joke
1,1,10,39,0,10,2,49,0,11 chart speak everyone fucking love sleep
1,2,5,33,0,7,0,38,0,former miss usa charged boyfriend assault
1,1,3,19,0,2,0,22,0,delectable vegan dinner
1,2,10,80,2,17,0,90,0,daily show's trevor noah compare donald trump's america apartheid home country south africa
1,1,5,26,0,4,0,31,0,people revisit old instagrams
1,1,7,33,0,6,0,40,0,christmas movie match zodiac sign
1,2,14,61,4,14,3,75,0,"there's rush white money, pune industrialist convert r 200 crore black. really!"
1,1,7,25,3,6,0,32,0,"fuck, marry, kill: girl name edition"
1,3,7,33,1,9,1,40,0,role models? parent glued screen 9 hour day
1,1,9,32,0,7,0,41,0,tv family eat thanksgiving
1,3,2,73,3,17,0,75,0,blizzard expected slam northeast here's potential snow
1,2,1,49,0,9,0,50,0,really know every major hacking story
1,3,0,57,1,12,4,57,0,"50 hospital charge uninsured 10 time cost care, study find"
1,1,5,18,0,4,0,23,0,feminist quote
1,3,9,34,4,11,0,43,0,russia u.s. election: know dont know
1,1,9,30,0,9,2,39,0,watch tiny puppy get massage 30 minute
1,2,11,50,1,10,0,61,0,build ideal boyfriend we'll guess favorite starbucks drink
1,3,1,47,0,10,0,48,0,state take money paycheck
1,1,11,41,0,10,0,52,0,genius iphone trick help clear entire inbox
1,1,6,19,0,5,0,25,0,love scar
1,1,8,26,0,7,0,34,0,well actually know prince eric
1,2,2,53,0,10,0,55,0,catholic high school could make million snap public offering
1,1,12,43,2,12,2,55,0,23 thing understand mum friend group
1,1,12,51,1,12,2,63,0,19 confession people excited see high school friend
1,1,10,38,1,9,2,48,0,21 quote ya heroine make feel unstoppable
1,1,15,36,1,14,0,51,0,hedgehog fat can't even roll ball
1,2,4,43,1,10,0,47,0,love witch witchcraft's appeal era trump
1,1,10,38,0,10,2,48,0,17 time britain confused hell everyone tumblr
1,2,2,33,1,9,0,35,0,blue: healing power sea
1,1,11,53,1,9,1,64,0,3d-printed permanent hairpiece making wave cancer survivor
1,1,9,35,0,9,2,44,0,21 thing friend group chat understand
1,1,11,46,2,11,2,57,0,"17 ""nude"" beauty product actually look amazing brown skin tone"
1,3,4,41,1,9,1,45,0,chance rapper donating $1m chicago school
1,1,13,50,3,12,0,63,0,"rihanna gave right amount shade asked taylor swift's ""squad"""
1,1,12,37,1,11,0,49,0,adele wrote lovely letter away long
1,1,6,27,0,5,0,33,0,disney princess florida
1,2,1,51,0,10,0,52,0,pizza dipped milk disrespectful pizza crime yet
1,1,12,52,1,12,2,64,0,11 best moment john oliver's hilarious guide canadian election
1,3,8,44,2,7,0,52,0,twitter rank most-tweeted-about holiday song movie
1,1,8,40,2,8,2,48,0,"22 female friendship lesson phoebe, monica, rachel"
1,1,6,28,1,6,2,34,0,14 weird wonderful antique girls' book
1,1,11,23,0,10,0,34,0,dog dog
1,2,2,46,2,7,0,48,0,viewpoint: inequality get unimaginably worse?
1,1,13,43,2,13,2,56,0,"17 tweet ""the force awakens"" make laugh as"
1,1,4,10,3,3,4,14,0,mcdonald's: 1955 vs.
1,1,12,40,4,11,0,52,0,"tom hiddleston singing ""i saw light,"" welcome"
1,1,11,38,3,10,0,49,0,"let's see well remember first episode ""misfits"""
1,1,10,35,1,10,2,45,0,11 way definitely look like got sh!t together
1,1,21,60,3,19,0,81,0,"woman owns t-shirt entire script ""bee movie"" people losing mind"
1,1,10,40,2,10,2,50,0,"14 time ""ginger snaps"" perfectly summed teen girl angst"
1,2,7,42,1,7,0,49,0,report: laura ingraham considering senate run virginia
1,1,13,60,2,12,0,73,0,"kendall jenner, gigi, bella hadid transforming supermodel eye"
1,2,16,57,0,16,2,73,0,brace bank queue limit cash withdrawal may end december 30
1,1,6,32,0,6,2,38,0,11 halloween costume deeply single people
1,2,12,64,2,10,0,76,0,kellogg foundation support group headed cop-killer-loving black life matter founder
1,3,12,25,3,10,0,37,0,"i'm first-time dog owner, wish knew"
1,1,7,20,0,6,0,27,0,jack finn harries
1,2,6,36,2,5,0,42,0,"obama, kerry, proposes dividing jerusalem"
1,3,7,16,0,7,4,23,0,best job apply 2017
1,3,8,36,0,9,0,44,0,commuter barbie internet losing
1,2,2,43,1,6,0,45,0,australia burning rubbish electricity?
1,1,11,48,2,10,0,59,0,"alan rickman narrates new ""alice looking glass"" trailer"
1,1,12,37,0,11,0,49,0,know designed eye bag based birth month
1,2,1,64,0,17,0,65,0,poor woman got hand stuck toilet badly call police
1,3,0,46,1,9,2,46,0,15 quality look hiring front-end developer
1,2,17,55,2,16,0,72,0,'save boy child' campaign every grain truth society need learn
1,3,2,56,3,11,0,58,0,"ideal hair beard (length) ratio, according top london stylist"
1,1,13,43,0,13,2,56,0,22 way make easier get married parent divorced
1,1,15,41,0,12,0,56,0,super bowl halftime show gif based birth month
1,2,8,30,0,8,2,38,0,19 reason morning people need bestopped
1,1,9,39,0,8,0,48,0,people try novelty astronaut dessert first time
1,3,11,54,0,11,2,65,0,photographer traveled 20 country highlight beauty redhead
1,2,2,65,2,9,0,67,0,"turkey general election deal blow erdogan, creates political uncertainty"
1,2,4,69,3,16,0,73,0,"teen fired facebook live highway. moment later, everyone car dead."
1,1,9,28,0,7,0,37,0,ellen degeneres jimmy fallon
1,1,11,45,0,10,0,56,0,well actually know world junior hockey championship
1,2,9,52,4,12,0,61,0,lebron's nba final performance best ever? quite. rank eighth.
1,1,13,54,0,13,2,67,0,man body photoshopped 18 country examine global beauty standard
1,3,7,46,1,11,2,53,0,ceelo green joy villa: 10 strangest grammy award outfit
1,1,8,44,0,7,0,52,0,annoying misconception people make extrovert
1,2,5,51,0,10,0,56,0,secretary education devos asks question twitter go nut
1,2,18,57,1,17,1,75,0,mother's struggle bring back kidnapped 2 yo daughter mumbai coming end
1,1,11,42,0,10,0,53,0,couple refused call wedding despite blizzard
1,3,4,46,2,7,0,50,0,international women's day: witty comeback sexist banter
1,3,13,44,1,12,0,57,0,create pizza we'll reveal best friend get married
1,1,12,41,0,11,0,53,0,happens blizzard strike wedding day
1,1,6,33,1,6,3,39,0,27 5-ingredient dinner actually healthy
1,1,7,20,0,7,2,27,0,19 people much going
1,1,12,50,1,11,0,62,0,grandma played recent college grad flip cup everything
1,1,10,36,2,8,0,46,0,here's veggie-filled snack even picky eater love
1,3,13,46,0,12,0,59,0,switch free advice paid one negotiating tactic
1,1,11,39,1,10,0,50,0,here's step selfie game thinking creatively
1,1,11,53,0,11,2,64,0,25 thing every college student know dealing social anxiety
1,1,11,35,3,8,0,46,0,"abc family's ""hocus pocus"" schedule halloween"
1,3,3,50,1,8,0,53,0,supreme court controversial ruling executive order
1,1,11,43,0,11,2,54,0,24 picture way real people resting bitchface
1,1,10,35,1,11,4,45,0,21 awesome '80s girl toy worth small fortune
1,2,8,36,0,8,0,44,0,greatest late night snack around world
1,1,8,28,0,7,0,36,0,new pop singer obsess
1,1,9,34,1,9,2,43,0,17 cat can't hide christmas cheer longer
1,1,12,47,1,12,2,59,0,21 thing understand best friend massive troll
1,3,3,50,5,11,0,53,0,russell westbrook: 'i get ref'd same' player
1,1,9,33,0,8,0,42,0,member olivia pope associate
1,3,24,40,2,13,0,64,0,war speech: chicago review book boycott simon schuster milo deal
1,2,12,53,1,12,3,65,0,drunk canadian pilot almost endangered 100 life fainted cockpit!
1,1,11,56,2,10,0,67,0,jennifer aniston justin theroux everyone's dream valentine's day plan
1,1,8,47,0,7,0,55,0,privileged crossword say everything patriarchy
1,1,4,19,0,4,2,23,0,11 thing every canadian
1,2,3,25,1,2,0,28,0,australia dinosaur laboratory
1,1,11,47,1,10,0,58,0,drake's mom extra adorable birthday celebration last night
1,3,3,31,1,6,0,34,0,"rock, schumer chappelle hit stage"
1,1,7,15,1,5,0,22,0,decade j.lo
1,1,14,40,0,14,1,54,0,6 theory zayn malik gigi hadid car together
1,1,6,27,0,6,2,33,0,15 time paris geller brutally honest
1,1,6,18,5,5,0,24,0,"hey, guys, what's ""cheese stick"""
1,1,11,34,2,10,0,45,0,"spot real ""star wars"" character fake"
1,1,10,39,0,9,0,49,0,tweet twitter user found funniest year
1,1,9,30,0,8,0,39,0,minute kendall jenner wax figure
1,1,12,41,0,11,0,53,0,microscopic video make skin crawl good way
1,2,10,63,2,13,0,73,0,"blinked apple's wwdc keynote, missed healthkit homekit update"
1,1,10,37,0,9,0,47,0,reminder taylor swift holiday album exists
1,1,7,26,1,6,2,33,0,10 life-changing thing try november
1,2,10,40,0,9,0,50,0,nikki haley lead walkout un nuclear weapon ban meeting
1,1,8,13,0,4,0,21,0,blonde hbic
1,1,7,33,0,7,2,40,0,26 picture prove cat actually asshole
1,2,12,38,2,11,0,50,0,time square live stream need new year's eve
1,1,8,36,0,7,0,44,0,kylie jenner reportedly dumped tyga birthday
1,3,5,30,0,5,0,35,0,smartphones unexpected new rival
1,1,12,41,1,11,0,53,0,people lot feeling tom daley's insane frying pan
1,1,8,34,0,8,2,42,0,32 product every elephant lover need home
1,1,13,42,1,14,4,55,0,21 product sale $25 totally buy love color
1,1,8,27,2,7,0,35,0,what's weirdest sex toy ever seen
1,2,7,29,1,6,0,36,0,flight attendant jet lag survival guide
1,1,12,42,0,11,0,54,0,canadian lot money took adorable photo
1,1,8,38,1,7,2,46,0,37 life-changingly useful website know
1,1,11,35,0,11,2,46,0,man sending letter ocean 12 year
1,1,7,34,0,8,6,41,0,11 best celebrity interaction instagram 2015
1,3,8,29,1,6,0,37,0,greek zucchini fritter recipe nyt cooking
1,3,4,52,2,15,1,56,0,big deal lauren alaina no. 1 song country radio
1,2,4,59,0,12,0,63,0,happens donald trump attack private citizen twitter
1,2,16,60,3,16,0,76,0,"sonu nigam remains firm stand, tweet he's use loudspeaker religion"
1,1,15,59,0,14,0,74,0,making sure everyone world know deepika padukone flawless goddess
1,1,7,29,0,7,2,36,0,31 delicious thing eat january
1,2,5,44,1,5,0,49,0,hilarious reaction beyonce's pregnancy announcement
1,1,10,32,1,11,0,42,0,here's break friend like damn adult
1,1,10,45,2,9,0,55,0,"happens straight people try ""conversion therapy"""
1,3,4,76,4,15,0,80,0,"bruce springsteen invite young fan perform 'growin' up' onstage, brings house"
1,1,10,37,4,9,0,47,0,"cover drake's ""hotline bling"" really, really good"
1,1,7,27,0,7,2,34,0,16 celebrity idea british
1,1,8,45,1,8,2,53,0,17 insane christmas decoration believe actually exist
1,1,10,36,3,8,0,46,0,"body-shame ariel winter, clap back"
1,3,13,39,3,12,0,52,0,here's drake calling 'more life' playlist album
1,2,0,65,2,12,2,65,0,16-year-old devise system save heart attack victim work experience
1,1,7,31,0,6,0,38,0,learned neuroatypical partner
1,1,13,52,0,12,0,65,0,insane sandcastle hotel really exist actually stay
1,3,2,19,0,4,0,21,0,leave planet earth
1,2,3,77,4,18,0,80,0,donald trump say follow 'two simple rules' everyone's making joke list
1,1,11,43,3,10,0,54,0,"well remember important date ""harry potter?"""
1,1,9,40,0,9,2,49,0,22 stylish product every reindeer lover need life
1,1,8,35,0,8,2,43,0,16 extraordinary black trans leader need know
1,3,10,42,2,10,0,52,0,vin diesel rock reportedly settle candy as feud
1,3,6,31,1,8,0,37,0,"jail, pad tampon bargaining chip"
1,2,3,52,0,11,0,55,0,timeline event surrounding suspicious death ny judge
1,1,10,44,0,10,2,54,0,11 thing one tell woman relationship twenty
1,1,7,20,0,6,0,27,0,like high school
1,1,9,33,0,8,0,42,0,make post without drooling
1,3,11,52,2,13,0,63,0,queen elizabeth us purse send secret signal staff [video]
1,1,16,41,3,12,0,57,0,"tiny detail might've missed ""ddlj"" make movie tragedy"
1,1,9,45,0,9,2,54,0,21 struggle everyone done dissertation understand
1,1,14,50,0,13,0,64,0,mystery glitch facebook led two stranger meeting falling love
1,2,5,51,0,8,0,56,0,pewdiepie claim youtube contacted deleting account
1,1,12,27,4,10,0,39,0,what's best pb&j la? feast mode hunger squad
1,1,13,40,1,12,0,53,0,determine good driver three question
1,1,10,34,0,9,0,44,0,discontinued fast food item miss
1,1,8,24,1,7,0,32,0,here's best irish bar every state
1,2,8,46,2,9,0,54,0,pope francis urge immigrant respect local law custom
1,1,9,29,0,9,2,38,0,24 problem live scotland
1,1,10,54,3,10,1,64,0,"7 essay read: preventing suicide, crowdfunding adoptions, single"
1,1,7,30,3,5,0,37,0,"""crazy ex-girlfriend"" character"
1,1,8,27,0,8,2,35,0,24 picture straight fuck
1,1,8,41,1,8,2,49,0,13 men's right activist share message feminist
1,1,9,21,0,8,6,30,0,10 diy project totally failed 2015
1,2,5,29,0,5,2,34,0,27 time tumblr beautifully wholesome
1,3,2,35,1,6,1,37,0,1 killed capitol hill tree-branch accident
1,1,9,39,1,8,0,48,0,member jennifer lawrence's growing squad
1,1,10,25,0,7,0,35,0,bff give best dating advice
1,3,1,28,1,7,0,29,0,really die broken heart?
1,1,7,27,0,8,6,34,0,19 meme totally made parent laugh 2015
1,1,13,51,0,12,0,64,0,broadway star called audience shaming special need child
1,2,7,28,1,7,0,35,0,navigate new airline carry-on rule
1,3,5,48,5,12,0,53,0,ian mcshane think 'game thrones' fan need 'get f*cking life'
1,1,10,48,3,10,2,58,0,"37 thought listening ""serial's"" surprise second season premiere"
1,1,12,54,0,11,0,66,0,daniel craig brutally honest regarding feeling james bond
1,1,8,23,0,8,4,31,0,taylor swift best 2016 far
1,1,13,45,2,13,2,58,0,"deaf couple open discussion love, sex, 46 year together"
1,3,9,30,1,7,1,39,0,suntrustvoice: 3 country business
1,1,13,50,1,12,0,63,0,everyone internet freaking amber rose's response kanye
1,3,4,35,2,6,0,39,0,marcellus wiley go one-on-one lonzo ball
1,1,11,33,1,10,6,44,0,29 time #blackgirlmagic hashtag 2015
1,1,13,39,2,12,0,52,0,"remember lyric ""you belong me"" taylor swift"
1,1,8,28,0,8,2,36,0,21 adorable fox product need life
1,1,8,35,0,7,0,43,0,make easy chicken fajita quesadilla home
1,2,13,60,1,12,0,73,0,afghanistan's first female fighter pilot getting death threat taliban
1,3,9,45,3,11,0,54,0,"finally, politician good idea: paid f*ck break worker"
1,3,4,36,0,6,0,40,0,sarah palin criticizes trump carrier deal
1,1,11,38,0,11,2,49,0,17 reason tina belcher best role model young girl
1,1,6,17,1,4,0,23,0,buzzfeed crossword: son
1,1,9,41,0,9,2,50,0,31 insanely adorable product make life easier
1,1,5,18,0,5,2,23,0,10 recipe save sanity
1,1,13,45,1,12,0,58,0,sorting hat quiz tell house definitely
1,1,9,40,0,9,2,49,0,17 red velvet recipe guaranteed satisfy sweet tooth
1,1,13,48,1,12,0,61,0,people thought kid faked perfect pitch he's proving wrong
1,1,8,36,0,7,0,44,0,american watch russian cartoon first time
1,1,10,51,2,10,2,61,0,24 thing understand slightly obsessed traveling
1,2,4,31,0,9,0,35,0,best tv film easter egg year
1,1,16,54,4,14,0,70,0,"j.k. rowling used ""harry potter"" explain opposes cultural boycott israel"
1,1,9,30,0,9,2,39,0,21 people making gift called life
1,2,1,16,1,3,0,17,0,week's happy news
1,1,10,43,2,9,0,53,0,"damn straight sigourney weaver new ""ghostbusters"""
1,2,10,42,3,10,0,52,0,funny: saturday night live viewer trump joke
1,1,9,26,0,9,1,35,0,6 type people meet holiday party
1,2,1,45,0,6,0,46,0,wife refuse conventional cancer treatment
1,1,12,32,2,11,0,44,0,who's worst person ever sat next plane
1,1,6,19,0,5,0,25,0,whatsapp viber
1,1,12,50,0,11,0,62,0,someone calculated rich harry potter answer surprising
1,2,6,52,0,8,0,58,0,louisville player confuses cbs reporter jacksonville state spy
1,1,8,29,2,7,0,37,0,"""friends"" quote life motto"
1,2,1,27,2,5,0,28,0,'i believe husband poisoned'
1,1,8,32,0,8,2,40,0,11 reason bindi irwin incredible role model
1,3,8,41,2,7,0,49,0,"ear infections, shorter antibiotic course isnt better"
1,1,15,44,1,14,0,59,0,cute baby kangaroo excited treat can't handle
1,1,13,51,3,11,0,64,0,"macklemore released track called ""white privilege ii"" something"
1,1,8,23,0,8,2,31,0,19 best food truck los angeles
1,2,10,47,4,11,0,57,0,dad touching reaction daughter wet pant make hero [video]
1,1,13,42,0,12,0,55,0,zayn malik grey hair people losing damn mind
1,1,13,55,1,12,0,68,0,people mourning david bowie twitter moving heartbreaking
1,2,4,34,3,7,2,38,0,politics live readers' edition: tuesday 11 april
1,1,6,23,0,5,0,29,0,actually move canada
1,3,11,32,0,11,1,43,0,1 simple trick use totally slash food waste
1,1,7,37,0,7,2,44,0,17 painful mascara moment every woman recognize
1,3,11,31,1,9,0,42,0,guess tv show crappy photoshop?
1,1,8,24,1,9,4,32,0,31 love song listened late '90s
1,3,6,22,0,7,6,28,0,50 funniest tweet woman 2016
1,2,11,33,0,11,2,44,0,39 british men want rip clothes rightnow
1,1,7,18,0,7,2,25,0,97 best thing world
1,3,8,49,0,9,0,57,0,radical besiege feinstein home urge rejection trump cabinet
1,2,1,41,0,9,0,42,0,story five young woman killed fun
1,3,3,52,0,11,0,55,0,keep belief santa alive well chrome extension
1,2,4,19,1,6,0,23,0,meditate well guide
1,2,3,65,1,11,0,68,0,"everything want know trump cabinet confirmation hearings, vote"
1,3,2,78,1,13,0,80,0,body positive instagram star share post explaining feel bad indulging
1,1,16,52,0,15,0,68,0,brave guy going viral taking selfie wife giving birth
1,1,4,23,0,3,0,27,0,sign overthink everything
1,1,8,41,0,8,2,49,0,23 cleverly creative way decorate rented apartment
1,1,9,36,0,9,2,45,0,17 cheesy soup equal part gooey delicious
1,1,6,31,2,5,0,37,0,adult review popular kids' toys: cleverkeet
1,1,8,44,0,7,0,52,0,perpetually miserable disney character really
1,1,11,42,2,10,0,53,0,"guess ""harry potter"" character would send text"
1,1,12,39,3,12,2,51,0,"79 thought watching ""star wars: episode v"" first time"
1,3,3,52,1,11,0,55,0,small alabama town rebounding trump could change
1,2,3,61,5,8,0,64,0,"'counter-strike' semifinal highlights: near misses, killing spree chaos"
1,1,6,28,0,6,2,34,0,22 perfect response wrong number text
1,2,6,36,1,7,0,42,0,"alexander melamid begin artenol, art magazine"
1,1,7,26,0,7,2,33,0,16 truth people fucking love nap
1,3,2,29,0,5,0,31,0,extreme adventure earth
1,1,15,60,2,14,0,75,0,"gu kenworthy's instagram photo good, might second career photographer"
1,3,1,61,0,9,0,62,0,touching moment conjoined twin see separation surgery
1,1,9,39,2,8,0,48,0,"julia, sesame street's first character autism"
1,2,12,34,4,11,0,46,0,"good cop dead cop, say alleged pa cop-killer"
1,2,12,33,2,10,0,45,0,betsy devos asked twitter question. go well.
1,2,4,61,1,14,0,65,0,heart girl: eight photo question know woman
1,3,9,37,7,6,0,46,0,"cnns chalian: trump going mainstream, establishment"
1,3,10,45,2,8,0,55,0,"column-the fact social security, medicare may surprise"
1,1,14,54,1,13,0,68,0,"aziz ansari vacationing india dad, instagrams hilarious"
1,3,7,39,1,10,0,46,0,"fleeing boko haram, thousand cling road nowhere"
1,3,12,30,1,10,4,42,0,2017 nfl free agency: best move every team still make
1,3,19,54,1,19,1,73,0,"muslim could marry 4 times, guy chose marry wife four different way"
1,2,2,45,0,11,0,47,0,learned filing tax first time
1,1,5,20,0,6,6,25,0,19 greatest animal hug 2015
1,3,5,19,1,5,1,24,0,9 sign ambivert
1,1,7,23,0,6,0,30,0,introvert wintrovert
1,1,10,39,3,9,0,49,0,"everything wanted know ""the heroes: reborn"" cast"
1,1,6,23,0,5,0,29,0,stressing people
1,1,7,20,0,6,0,27,0,need talk mandy moore
1,1,10,36,2,10,2,46,0,"19 fact guaranteed make ""harry potter"" fan feel old"
1,3,4,18,1,6,4,22,0,time critic top book 2016
1,3,9,49,1,10,0,58,0,"fort lauderdale shooting, rumor second gunman created chaos"
1,1,9,39,2,9,2,48,0,"21 reason follow ""dogs taking dumps"" instagram"
1,1,10,41,0,10,2,51,0,29 question couple share social medium account
1,1,9,36,0,9,2,45,0,24 motivational celebrity tweet time
1,1,10,44,0,10,2,54,0,14 ridiculously awesome toaster snack get cold
1,1,8,34,0,7,0,42,0,stranger gave dying groom dream wedding
1,1,13,32,0,12,0,45,0,many goat tree one know
1,3,2,47,4,13,4,49,0,"wanted: someone travel luxury around world 8,000 month"
1,1,17,41,0,14,0,58,0,regular guy trained like fbi agent day actually nailed
1,1,9,37,2,9,3,46,0,here's complete list david bowie's 100 favorite book
1,2,10,30,1,9,0,40,0,refuse remove hijab trump america
1,1,15,44,1,14,0,59,0,man built kayak dog it'll give serious squad goal
1,1,8,32,0,9,6,40,0,29 time tom hardy goddamn human perfection 2015
1,1,9,35,0,9,2,44,0,21 moment anyone day drunk recognize
1,1,9,34,1,9,2,43,0,69 fact probably know spice girl
1,1,17,58,0,16,0,75,0,story cancer survivor getting first haircut go zero feel real fast
1,3,8,32,1,7,0,40,0,warren buffett: america fine trump
1,1,7,28,0,7,1,35,0,returned get even creepier season 2
1,1,13,42,0,12,0,55,0,romance film ice cream combo based zodiac
1,1,8,35,1,8,2,43,0,17 beer fests around world oktoberfest
1,3,8,43,1,7,0,51,0,america need small apartment buildings. nobody build
1,2,13,58,3,12,0,71,0,white house object drudge criticism: gop need time replace mammoth obamacare
1,1,6,21,0,5,0,27,0,hate speech come campus
1,1,9,32,0,8,0,41,0,make ultimate spaghetti red sauce
1,1,9,31,0,8,0,40,0,tell u whether thing food drink
1,1,12,36,1,10,0,48,0,golden globe afterparty moment see tv
1,2,11,50,1,10,0,61,0,quadruplet dad get incredible gift steve harvey wife death
1,1,6,24,0,5,0,30,0,stereotypically dad dad
1,1,7,36,0,7,2,43,0,18 hilarious reaction netflix launching india
1,3,17,55,2,17,4,72,0,"rakhi likely get arrested, pc becomes second beautiful woman 2017 ent"
1,1,13,50,2,11,0,63,0,samantha bee perfect reaction vanity fair's all-male comedy cover
1,1,9,23,1,8,0,32,0,"god close door, open window"
1,1,11,55,1,9,0,66,0,instagram account hilariously capture real life situation post-it
1,1,10,50,0,9,0,60,0,girl halloween transforming cinderella costume
1,1,12,41,1,11,0,53,0,"first semester college, told bar mitzvah picture"
1,2,7,17,3,5,2,24,0,50 best notorious b.i.g. song
1,3,12,48,2,12,2,60,0,"17 tweet anyone love jughead kinda hate archie ""riverdale"""
1,2,3,46,1,7,0,49,0,legendary astronaut john glenn's inspiring life photo
1,1,9,35,2,9,1,44,0,well remember ted mosby's girlfriends? part 1
1,1,5,15,0,4,0,20,0,ellen page lead way
1,3,0,27,0,6,1,27,0,4 way keep password safe
1,1,11,34,0,10,0,45,0,lesbian woman ask gay men question want know
1,1,8,22,0,8,2,30,0,31 dog thing ever happen
1,1,13,47,0,13,2,60,0,12 picture water body india could become new happy place
1,1,15,53,3,14,0,68,0,"man returned wife's ""woman year"" award caitlyn jenner received one"
1,2,6,42,2,12,0,48,0,star wars: fan make trailer last jedi?
1,3,2,54,4,9,0,56,0,politician love left-behind cliche. mask failure
1,1,7,33,2,6,0,40,0,"character ""national treasure"""
1,1,11,36,0,10,0,47,0,disney villain would look like real life
1,1,11,37,0,11,2,48,0,22 harry potter tumblr post give many feel
1,1,6,28,0,5,0,34,0,people try existential haunted house
1,1,11,35,0,10,0,46,0,hot guy holding puppy make feel thing
1,3,13,39,1,12,0,52,0,samantha bee's show tell trump knew knew
1,1,13,51,2,12,0,64,0,"barbara walter told bradley cooper face find ""screwable"""
1,1,10,35,2,10,4,45,0,2015's best news blooper they're control
1,1,3,12,0,2,0,15,0,fresh fruit sushi
1,2,3,59,3,12,0,62,0,inside largest earth science event: 'the time never urgent'
1,1,8,33,0,8,2,41,0,35 meatless monday recipe people hate tofu
1,1,7,26,2,7,2,33,0,"23 time tinder actually made say ""awww"""
1,1,7,30,0,6,0,37,0,secret service nickname
1,1,7,34,0,7,2,41,0,11 cute little poem accurately describe love
1,2,2,49,0,10,0,51,0,literature map world simply brilliant list
1,1,10,37,0,10,2,47,0,19 reason making dessert slow cooker
1,1,9,35,0,8,0,44,0,need talk guy wearing basketball short
1,1,8,31,0,8,2,39,0,13 insanely clever oatmeal trick need try
1,3,4,26,2,6,0,30,0,might post-brexit eu look like?
1,2,15,75,3,14,0,90,0,"sonu nigam tweet morning azaan loudspeakers, face backlash calling forced religiousness"
1,1,12,44,1,10,0,56,0,tell u life-changing product helped adult acne
1,1,17,63,0,16,0,80,0,muslim professor offering treat people pork meal stand intolerance
1,1,11,39,0,10,3,50,0,15 invisible thing definitely missed 2nd gop debate
1,2,1,50,1,9,6,51,0,18 biggest breakthrough self-driving car expected 2030
1,1,7,32,0,6,0,39,0,tell u embarrassing teenage moment
1,2,0,34,0,7,1,34,0,5 survival myth could get killed
1,3,10,47,1,10,2,57,0,41 fact anna faris chris pratts adorable relationship
1,1,12,42,2,12,2,54,0,"24 thing would happen ""inside out"" set philippine"
1,1,5,21,0,5,2,26,0,10 truth eurasian know well
1,1,8,30,0,8,1,38,0,8 way deal dumb question canada
1,2,14,63,4,13,0,77,0,"okeefe: dems, left, medium asked disavow violent inauguration protester"
1,3,2,47,1,7,0,49,0,arizona governor welcome uber fleet self-driving car
1,1,6,30,1,7,5,36,0,37 thing kardashians 100% actually said
1,1,15,47,1,11,0,62,0,hgtv show watch filled existential dread
1,3,6,53,3,11,0,59,0,here's latest super bowl champion visit trump's white house
1,1,9,38,1,8,2,47,0,21 budget-friendly adventure worth taking new year
1,1,13,48,0,12,0,61,0,sound like taylor swift responded kanye west grammys speech
1,2,9,22,1,9,1,31,0,"4 soft skill need work on,"
1,1,11,47,4,10,0,58,0,"perrie edward recreated britney's ""baby one time"" perfect"
1,2,1,59,4,11,2,60,0,"holiday cookie bakers, here secret weapon: 1 dough, 5 fabulous result"
1,1,10,39,1,9,0,49,0,watch evolution men's eyewear three minute
1,1,12,43,0,11,0,55,0,guess favorite avril lavigne song based zodiac
1,1,14,42,1,12,0,56,0,one-eyed cat conquered fear ocean learned surf
1,2,2,52,3,11,0,54,0,"timeline obama's best jokes, red-hot zinger corny pun"
1,1,7,18,0,7,6,25,0,24 word overused af 2015
1,1,9,33,2,8,0,42,0,protomartyr's joe casey old indie rock
1,1,10,27,0,9,0,37,0,would disney movie life like
1,2,9,48,1,10,0,57,0,"catholic group fly syrian italy, marking contrast trump ban"
1,1,7,29,0,7,2,36,0,15 way make cheap wine insanely drinkable
1,1,11,37,2,10,0,48,0,here's actually get fit college student
1,1,5,25,0,5,2,30,0,11 sign actually senioritis
1,3,3,47,1,10,0,50,0,trump handshakes? getting awkward
1,1,7,31,5,6,0,38,0,"better: ""hocus pocus"" ""halloweentown"""
1,1,8,37,0,8,2,45,0,15 halloween snack guaranteed gross guest
1,1,8,41,0,8,2,49,0,19 surprising confession people married money
1,1,10,33,0,9,0,43,0,get post without relating
1,3,4,32,0,10,2,36,0,13 best place eat ramen new york city
1,1,8,26,2,7,0,34,0,"""force awakens"" fan art draw"
1,3,14,73,5,12,0,87,0,hamilton producer lin-manuel miranda sobbing obama free domestic terrorist oscar lopez rivera
1,1,9,42,0,9,2,51,0,17 facebook life event actually worth bragging
1,1,7,22,0,7,2,29,0,21 song grinded five year ago
1,2,9,32,0,9,2,41,0,23 picture make squirm laugh
1,1,12,50,2,11,0,62,0,"know favorite ""harry potter"" character based favorite puppy"
1,1,10,47,2,10,2,57,0,"21 real, frustrating, neverending struggle tidy student"
1,2,1,60,2,15,0,61,0,valentine's busy time private eye reason think
1,3,10,46,3,10,3,56,0,america's expensive home: $250m los angeles mansion hit market
1,1,12,47,3,9,2,59,0,"33 badass ""scream queens"" gifs every possible scream-worthy situation"
1,1,11,39,0,10,0,50,0,reminder keira knightley used dress like
1,1,17,57,0,16,0,74,0,way horse brings girlfriend hay eat together melt heart
1,1,10,48,0,9,0,58,0,prince william give emotional rare speech princess diana
1,1,13,40,2,12,0,53,0,"dad joke han solo might best ""star wars"" twitter account yet"
1,3,0,46,0,8,1,46,0,7 transcendental festival middle nowhere
1,3,7,43,0,10,0,50,0,repeal online privacy protection mean
1,1,8,18,2,5,0,26,0,could pas potion o.w.l
1,1,7,35,0,7,2,42,0,55 delicious dessert people hate chocolate
1,1,10,45,1,9,0,55,0,emma watson's new haircut literally definition flawless
1,3,6,33,0,9,0,39,0,end year positive financial note
1,1,10,30,0,9,0,40,0,every girl lot hair struggle
1,1,8,49,0,8,2,57,0,18 euphoric moment twentysomethings basically grandma
1,3,4,29,0,6,4,33,0,captivating animal picture 2016 photo
1,3,2,9,1,2,1,11,0,3. wonder woman
1,1,13,49,2,12,0,62,0,"zodiac date based favourite ""game thrones"" house"
1,1,6,19,0,5,0,25,0,show u white ink tattoo
1,1,9,34,2,8,0,43,0,"justin bieber awkwardly scold fan ""clap beat"""
1,1,9,37,1,8,0,46,0,worst netflix chill experienced
1,3,13,39,0,13,2,52,0,22 meme goddamn pure send yourgrandma
1,1,10,33,0,10,2,43,0,25 feminist song always make feel like bos
1,3,10,35,2,11,1,45,0,8 world's stylish hotel mexico paris
1,3,7,32,3,9,0,39,0,need watching hbo's 'big little lies'
1,1,7,33,0,7,2,40,0,15 great piece relationship advice book
1,1,6,27,0,5,0,33,0,thing nobody told depression
1,1,10,31,0,10,2,41,0,19 tweet friend zone way real
1,1,11,25,0,9,2,36,0,17 people want gop debate chill
1,1,10,40,2,10,2,50,0,18 awesome gift best friend who's valentine's day
1,1,12,39,4,9,0,51,0,"psa: there's chrome extension block ""star wars"" spoiler"
1,1,9,38,0,9,2,47,0,12 everyday activity might actually good
1,1,6,38,1,6,2,44,0,'90s kid recreate childhood halloween costume
1,3,8,29,0,8,2,37,0,17 picture dog living bestlife
1,2,7,29,0,7,2,36,0,16 embarrassing story aboutsex
1,3,9,42,0,8,0,51,0,migrant stab christian woman reading bible
1,1,6,22,0,6,2,28,0,18 baby rhino learning rhino
1,2,13,27,3,10,1,40,0,espn's nfl mvp poll: ryan unseats brady no. 1 spot
1,1,14,49,4,13,0,63,0,"identify ""love hip hop: atlanta"" season based joseline's hair"
1,2,1,41,0,5,0,42,0,face transplant recipient overwhelmed result
1,1,6,31,0,6,1,37,0,7 weeknight dinner everybody love
1,1,15,64,0,14,0,79,0,thierry henry reacted brilliantly brendan rodgers getting sacked became huge meme
1,1,9,30,0,8,0,39,0,size mattress partner need
1,3,1,47,0,9,0,48,0,woman find strength camaraderie rowing age
1,1,7,22,0,6,0,29,0,fall boy soulmate
1,1,9,35,0,9,2,44,0,51 modern black film everyone see least
1,1,10,29,0,9,0,39,0,woman try put lipstick selfie stick
1,2,3,47,1,9,0,50,0,minimalism more! discovered joy recluttering
1,3,8,42,1,8,0,50,0,u launch nafta renegotiation process coming weeks: ross
1,3,1,58,1,7,0,59,0,property tycoon denies threatening business partner pregnant wife
1,1,8,32,0,8,2,40,0,24 reason cara delevigne bos instagram
1,3,8,29,1,7,0,37,0,well actually know starbucks?
1,2,9,24,1,9,2,33,0,17 sign adult also still kid
1,3,8,25,0,8,2,33,0,24 powerful photo thisweek
1,1,8,25,1,7,0,33,0,said it: donald trump jack donaghy
1,1,8,28,0,8,2,36,0,30 thing need know rob schneider
1,1,8,26,0,7,0,34,0,know social network older
1,3,11,27,3,9,2,38,0,"bitcoin dropped 10%, likely etf now?"
1,1,10,42,0,10,2,52,0,23 free health fitness apps need download immediately
1,1,10,40,1,10,2,50,0,21 magical place south believe actually exist
1,1,5,24,0,5,2,29,0,22 reason giraffe greatest
1,1,5,22,1,6,5,27,0,9 thing definitely lose 2016
1,3,9,39,2,9,0,48,0,virgil: beltway assures u deep state doesnt exist
1,1,10,35,1,10,2,45,0,17 way amazing valentine's day
1,1,11,46,1,10,0,57,0,take quiz it'll reveal something actually factual
1,2,2,44,0,9,0,46,0,great white shark attack boat real life jaw moment
1,1,11,41,0,10,0,52,0,thing hair look amazing right haircut
1,1,10,33,0,10,4,43,0,2016 movie see based zodiac sign
1,2,1,58,0,10,0,59,0,bullied teen creates magnificent prom dress perfect payback
1,1,10,38,3,8,2,48,0,gigi hadid's 16-year-old brother got modeling contract
1,1,12,42,2,11,0,54,0,"""orange new black"" inmate would prison nemesis"
1,3,8,32,2,7,4,40,0,"morgan stanleyvoice: 2017, software eats world"
1,1,10,35,4,9,0,45,0,"""what's up?"" awkward question existence"
1,1,15,55,3,14,0,70,0,"sound like milo ventimiglia good ""gilmore girls"" news team jess fan"
1,1,10,41,0,10,2,51,0,13 bollywood moment changed face swimwear india
1,1,10,29,0,9,0,39,0,pop star based zodiac sign
1,1,11,41,0,10,0,52,0,taylor swift opened grammys fan lost damn mind
1,3,2,50,2,9,0,52,0,vintage (time) travel poster beautiful list
1,1,7,26,0,7,2,33,0,19 people know definitely dead
1,2,8,40,3,8,0,48,0,miller: provided enormous evidence voter fraud
1,2,2,55,3,10,0,57,0,'i lost fingers': asylum seeker make dangerous border crossing
1,1,12,53,1,11,0,65,0,two picture perfectly sum what's wrong indian beauty standard
1,3,9,50,0,9,0,59,0,best twitter reaction joseph fiennes playing michael jackson
1,3,11,43,2,11,0,54,0,watch madonna drop f-bomb live tv women's march washington
1,1,9,37,1,8,0,46,0,"long, exhausting summer street harassment"
1,1,9,39,0,9,2,48,0,26 picture show different america britain
1,1,10,41,1,9,2,51,0,21 bite-size dessert satisfying boyfriend
1,1,7,35,1,7,2,42,0,16 thing people raynaud's understand
1,1,12,47,0,11,0,59,0,male celebrity compatible based zodiac
1,1,5,11,3,4,0,16,0,"i'm native, i'm"
1,1,12,40,1,11,0,52,0,bet can't name horror movie scream queen scream
1,1,10,34,0,10,4,44,0,well remember popular wedding 2015
1,1,9,26,0,10,6,35,0,17 thing maybe going kill 2015
1,1,9,37,0,9,2,46,0,13 struggle pet live canada understand
1,1,12,35,0,12,2,47,0,27 gift people care food
1,1,12,54,0,11,0,66,0,really tell difference elena gilbert katherine pierce
1,1,7,25,0,7,2,32,0,14 type people every college party
1,1,10,35,0,10,2,45,0,15 thing might common helga pataki
1,1,15,48,3,14,0,63,0,"samuel l. jackson put flare iconic film quote ""the late show"""
1,1,12,50,3,11,0,62,0,"remember opening charlie chaplin's ""the great dictator"" speech"
1,3,19,69,0,15,0,88,0,slaughterhouse owned bsp leader offered cash reward beheading danish cartoonist sealed
1,2,10,36,1,12,4,46,0,best worst 2017 april fools' day prank far
1,1,14,44,2,12,2,58,0,"16 ""spongebob squarepants"" moment went right head kid"
1,1,11,41,0,11,4,52,0,instagram filter use first picture 2016
1,1,9,33,0,9,2,42,0,23 time kelly rowland gorgeous almost hurt
1,1,16,61,0,15,0,77,0,heartwarming photo capture moment elderly couple helped young man tie tie
1,1,13,46,3,12,0,59,0,"carrie fisher's daughter new ""star wars"" movie rocking leia bun"
1,1,9,23,2,8,0,32,0,"know lyric ""hello"" adele"
1,1,10,38,0,10,2,48,0,35 important question need yoshi answer right
1,1,8,21,0,6,2,29,0,16 gifs ruin childhood
1,2,14,43,1,14,2,57,0,10 artist wont believe never grammy album theyear
1,3,9,39,0,9,1,48,0,5 question determine many child youhave
1,1,10,45,0,9,0,55,0,favorite comedian say personality type
1,1,10,14,2,6,0,24,0,"""friends"" set ussr"
1,2,1,22,1,5,0,23,0,here's cat sleep much
1,3,7,73,2,18,0,80,0,proof beer mars? nasa rover discovers large green bottle red planet's surface
1,3,5,68,4,14,0,73,0,everything need know corinne olympios newest villain 'the bachelor'
1,1,7,30,2,7,2,37,0,36 thing probably know nando's
1,2,10,39,4,9,0,49,0,"conway: clinton camp past anger, grief denial stage"
1,1,6,29,0,6,2,35,0,30 gorgeous tattoo inspired great book
1,1,5,26,0,5,2,31,0,31 question gynecologist
1,3,12,48,0,11,0,60,0,guy best passive aggressive response dirty roommate
1,1,11,36,3,10,1,47,0,"7 reason listen buzzfeed's new podcast ""the tell show"""
1,1,7,31,0,7,2,38,0,21 baby look remarkably like people
1,2,8,38,0,8,2,46,0,17 fucking infuriating thing happen every porno
1,1,8,33,0,7,0,41,0,type thanksgiving turkey make
1,2,1,49,0,7,0,50,0,online treatment reduces chronic knee pain arthritis
1,3,8,42,1,7,0,50,0,oprah rethinking presidential run donald trump win
1,1,9,35,0,8,0,44,0,actually prefer ryan gosling ryan reynolds
1,1,8,33,0,8,2,41,0,19 time tumblr totally nailed texting like
1,1,10,36,0,11,6,46,0,21 time victoria david beckham proved love real 2015
1,1,7,39,0,7,1,46,0,9 celebrity discover inner princess puzzle
1,1,8,16,6,10,6,24,0,"know '80s, '90s, '00s kid"
1,1,10,51,1,9,0,61,0,nicki minaj's latest selfie come amazing inspirational message
1,1,11,31,0,12,6,42,0,23 spicy way bring hot sauce life 2016
1,2,1,48,1,10,0,49,0,dominatrix reveals like run sex dungeon hotel
1,1,11,35,1,10,0,46,0,tracked guy one canada's greatest meme
1,1,9,22,0,8,0,31,0,iconic diva time
1,2,3,18,1,3,0,21,0,milo yiannopoulos?
1,1,12,47,1,12,2,59,0,25 embarrassing thing people done doctor's office
1,3,2,48,0,10,0,50,0,happiness gay people around world mapped list
1,1,12,38,0,11,0,50,0,three question tell big city live
1,3,12,51,0,12,0,63,0,helpful study reveals country men lie dick size
1,2,9,46,4,9,0,55,0,trump america's billionaire politician -- meet others
1,2,7,34,0,9,1,41,0,7 food moisturize skin inside
1,1,10,41,2,9,0,51,0,"identify ""the simpsons"" character foot"
1,2,11,48,2,11,0,59,0,dilbert creator scott adam stop donating alma mater uc berkeley
1,1,8,24,0,8,2,32,0,36 happy dog sad people
1,3,10,27,3,12,5,37,0,"here's get paid $16,000 lie bed day"
1,2,7,38,2,8,2,45,0,flash crash trader $50 million fortune vanished
1,1,14,39,4,13,0,53,0,"sam hunt's ""break small town"" video hot problematic"
1,1,7,35,1,6,0,42,0,woman's lonely christmas card hilarious
1,2,8,45,4,8,3,53,0,someone mashed-up 100 classic christmas track (and terrifying)
1,3,16,56,2,15,0,72,0,blind gamer 'street fighter v' tournament game thanks super sensitive ear
1,1,7,25,0,6,0,32,0,well remember basic science
1,3,2,44,7,6,0,46,0,"lady gaga's halftime show messages: 'inclusion,' 'equality'"
1,3,9,43,2,8,2,52,0,31 gorgeous non-diamond engagement ring youll totally fallfor
1,3,2,52,1,9,0,54,0,nightclub responds brilliantly woman's racist rant list
1,1,6,20,2,5,2,26,0,21 mind-blowing way eat s'mores
1,1,7,28,0,6,0,35,0,current disney channel show
1,2,4,47,3,10,0,51,0,"nasa launch flying saucer test flight, suffers chute snafu"
1,3,2,58,2,12,0,60,0,"london commuter tracked, learned list"
1,1,4,23,0,3,0,27,0,couple discus mental illness
1,1,8,23,0,8,4,31,0,popular bar every state 2015
1,1,13,41,1,12,0,54,0,need watch capella mashup lady gaga's biggest hit
1,1,13,43,0,12,0,56,0,daylight saving literal worst one talking
1,1,12,42,0,11,0,54,0,goldfish tea bag friend never knew needed
1,1,11,39,1,11,2,50,0,"17 female friendship truths, told amy poehler tina fey"
1,2,8,30,1,8,6,38,0,2016 election split 22 year-long marriage
1,2,3,31,1,6,0,34,0,food inspires name india's parsi
1,2,10,49,1,11,2,59,0,saudi prince cop 80 plane ticket fleet well-traveled falcon
1,1,9,31,0,9,2,40,0,15 weird thing never knew word
1,1,15,48,2,14,0,63,0,"doug keep whole murder thing new ""house cards"" trailer"
1,1,12,37,1,12,4,49,0,know new year's eve plan based favorite 2015 song
1,1,10,34,0,9,0,44,0,guess eye color three question
1,1,10,48,1,10,2,58,0,15 vampire recipe make halloween party instant success
1,1,6,26,2,7,6,32,0,20 weirdest couple early(ish) 2000s
1,2,6,30,0,6,0,36,0,brawl break high school graduation
1,1,11,42,0,10,0,53,0,know favorite halloween movie based zodiac sign
1,3,2,35,0,7,0,37,0,nordstrom broke curse trump tweet
1,1,12,45,2,11,0,57,0,"""true blood"" character date based zodiac sign"
1,1,5,19,1,5,2,24,0,27 sign we've reached peak kale
1,1,12,19,0,8,4,31,0,winner 2016 baftas
1,1,6,32,0,5,0,38,0,sailor senshi imagined disney princess
1,2,4,44,0,11,5,48,0,9 coolest tech product saw mobile world congress 2017
1,2,12,38,0,11,0,50,0,quantum physic tell u fate written star
1,1,11,45,1,9,0,56,0,virat kohli spoken sexism gender-based violence
1,1,9,29,0,8,0,38,0,know birth month based one question
1,1,12,37,3,10,0,49,0,know s.o.'s zodiac sign based favourite thing
1,3,16,64,3,14,0,80,0,ex-state staffer advocated spying trump boasted getting wink inside obama admin
1,1,13,46,0,13,2,59,0,mom shared body looked like 24 hour giving birth
1,2,20,65,2,17,0,85,0,espns jemele hill: trump denounce racist act done name instead bashing snl twitter
1,3,3,49,0,7,0,52,0,billionaire steve schwarzman warns next financial crisis
1,1,9,35,0,8,0,44,0,people think gigi hadid kinda look like fergie
1,2,5,43,0,6,2,48,0,14 chilling picture incredible underwater sculpture
1,1,8,29,0,8,2,37,0,19 picture way real final
1,1,10,37,1,9,0,47,0,here's people celebrate new year around world
1,3,9,31,1,9,0,40,0,tee time trump? pro golfer say absolutely
1,1,8,27,0,8,2,35,0,12 thing woman ever feel bad
1,1,8,30,0,8,2,38,0,19 question brit visiting america
1,1,7,30,0,7,2,37,0,travel around world 46 cookie recipe
1,1,7,34,0,7,2,41,0,19 thing anyone shitty nail understand
1,3,10,33,3,11,0,43,0,"go ahead, write check coffee, ive got day"
1,1,9,34,0,9,2,43,0,26 chart actually make happier person
1,1,8,28,0,7,0,36,0,well know spanglish spanish
1,1,13,36,0,12,0,49,0,photo demi lovato become huge meme called poot
1,1,7,33,0,7,2,40,0,14 time blair waldorf right everything
1,3,28,35,2,9,3,63,0,isro successfully launch resourcesat-2a pslv-c36 rocket morning
1,2,6,26,2,5,0,32,0,top-selling holiday songs?
1,1,13,47,2,13,2,60,0,"14 ""game thrones"" trivia question every true fan able answer"
1,1,12,53,1,11,0,65,0,inside natural history museum's wonderfully creepy room thing jar
1,2,1,55,0,12,1,56,0,9 state taxpayer get tax dollar
1,1,9,39,0,9,4,48,0,storm unveiled shipwreck 1930s california
1,1,7,37,0,7,2,44,0,18 confession men call feminist
1,3,11,38,1,11,2,49,0,18 photo thatll make feel small littlenervous
1,2,1,38,2,8,0,39,0,fasten up: readers' photo theme attach
1,2,8,34,1,7,0,42,0,beyond hennessy: get fancy five cognac
1,1,15,45,1,14,0,60,0,here's happens go different meetup every day month
1,1,7,35,2,6,0,42,0,"""american me"" quote inspirational poster"
1,1,14,39,0,13,0,53,0,disney cover band got people kiss new york city singing
1,1,12,36,0,11,0,48,0,jaden smith look amazing dress new vogue korea
1,1,11,46,3,11,1,57,0,"7 essay read: smoking get sober, asian pseudonyms, loneliness"
1,1,11,45,0,11,2,56,0,17 word different meaning really love halloween
1,3,1,50,0,10,0,51,0,mourner gather funeral black victim sword slaying
1,1,6,34,0,6,2,40,0,23 word everyone stop saying immediately
1,1,13,32,0,12,0,45,0,sleep next someone warm
1,3,1,40,0,8,0,41,0,stop rating flight attendant hot
1,2,3,62,0,13,0,65,0,evidence one bizarre theory trump mounting list
1,3,14,65,5,14,0,79,0,'rogue one' sound editor reveal found princess leia's 'hope' production secret
1,3,2,53,1,10,0,55,0,haunting story one best young spanish-language writer
1,3,10,27,1,11,0,37,0,cant pay tax bill full
1,1,5,19,1,5,2,24,0,29 sign actually witch
1,3,1,22,1,3,0,23,0,pot's thriving black market
1,2,11,36,0,10,0,47,0,kelly ripa dye hair pink like half hollywood
1,1,14,48,2,11,0,62,0,former binge-eater taking stand fat-shamers yoga
1,1,9,34,2,8,0,43,0,"raisin fucking worst, let's ban forever"
1,1,14,46,2,13,0,60,0,"puppy version ""fresh prince"" theme one matter"
1,1,8,28,0,7,0,36,0,well know christmas movie title
1,3,9,37,0,8,0,46,0,james corden real problem zach galifianakis
1,1,9,21,0,9,4,30,0,guess much pizza ate 2015
1,1,6,27,0,6,2,33,0,16 thing londoner want tourist know
1,2,16,67,6,16,0,83,0,cnns sanders: make america great take u back slavery internment camp chinese
1,1,8,32,1,9,6,40,0,17 people definitely meet celebrity 2015
1,2,3,50,3,12,0,53,0,syria: here's need know trump's strike air base
1,3,8,39,3,8,0,47,0,"michael flynn, kim jong-un: tuesday evening briefing"
1,1,8,32,0,8,2,40,0,21 tweet thanksgiving way real
1,1,9,27,0,8,0,36,0,talk selena gomez right
1,1,7,24,0,7,2,31,0,17 picture ben fold glass
1,1,15,51,0,14,0,66,0,took people terrified snake face biggest fear
1,1,14,52,0,13,0,66,0,woman tried boudoir photography first time loved every second
1,1,13,62,2,12,0,75,0,"everyone lost mind new ""gilmore girls"" episode officially coming netflix"
1,1,8,37,4,8,1,45,0,"""hunger games: mockingjay, part 2"" character"
1,2,10,48,4,10,0,58,0,'avengers: infinity war' marvel favorite peter dinklage could play
1,2,2,52,1,8,0,54,0,super-secret division charge russia investigation
1,2,11,44,1,14,0,55,0,president use order memo stop yahoo
1,2,1,48,0,10,0,49,0,astronaut see look window
1,1,8,32,1,8,2,40,0,15 animal restore faith world
1,1,11,40,0,11,2,51,0,34 online shop based southeast shopping
1,2,2,28,0,6,0,30,0,get free refill starbucks
1,1,15,59,2,14,0,74,0,"know favorite ""game thrones"" character based favorite taylor swift look"
1,1,11,41,1,11,2,52,0,22 question asked always stay late
1,1,15,47,0,14,0,62,0,bearded woman kiss boyfriend show men feel kiss beard
1,1,8,35,0,8,2,43,0,29 incredibly delicious recipe start
1,1,9,31,2,8,0,40,0,"here's actually heal dry, chapped lip"
1,1,10,43,1,9,0,53,0,here's actually happens stop taking birth control
1,1,12,52,0,11,0,64,0,color blot test determine subconscious obsessed
1,1,8,23,0,7,0,31,0,talked people like pet
1,1,13,51,1,12,0,64,0,"pizza lover rejoice, someone invented necklace hold pizza slice"
1,1,4,24,0,4,2,28,0,27 totally hilarious family photo
1,1,9,42,0,9,2,51,0,18 awesome holiday tradition family try year
1,1,6,19,0,5,0,25,0,adele release new song
1,1,8,41,1,8,2,49,0,25 face everyone who's home thanksgiving recognize
1,1,12,38,0,10,0,50,0,neil degrasse tyson talk beauty life death
1,3,8,28,0,7,0,36,0,know sailor scout actuallyare
1,1,9,32,0,9,1,41,0,8 super romantic way tell someone love
1,3,7,45,3,6,0,52,0,schweizer: hillary lost corruption consequence
1,1,8,34,0,7,0,42,0,zayn malik look exactly like young joseph stalin
1,1,11,44,0,10,0,55,0,lucky charm marshmallow actually real thing
1,1,15,50,3,14,0,65,0,"internet can't stop sharing insane tabla cover ""how deep love"""
1,3,21,51,1,19,0,72,0,"ed sheeran play cameo got, salman make film akshay ent world"
1,1,9,32,0,8,0,41,0,well know iphone battery indicator
1,1,8,34,0,8,2,42,0,14 retro advert would never published today
1,3,8,50,7,7,0,58,0,"jeopardy contestant mispronounces tupac, internet go crazy [video]"
1,3,1,44,0,9,0,45,0,parent created drug save daughter
1,1,9,34,0,8,0,43,0,guess celebrity tweet belongs
1,3,1,87,6,17,5,88,0,"supermodel-backed music festival ticket cost $12,000 turned nightmare here's happened"
1,1,8,35,0,8,2,43,0,15 time onion proved humanity predictable
1,3,3,44,0,7,0,47,0,know collecting social security
1,1,11,39,2,10,0,50,0,"""the lord rings"" character wingman"
1,1,8,28,1,8,2,36,0,"27 time urban outfitter went way, way far"
1,1,18,51,2,16,2,69,0,video grandpa singing 93-year-old dying wife give feel
1,2,1,35,0,8,0,36,0,never really get first love
1,1,10,34,2,9,0,44,0,"well remember first ""harry potter"" movie"
1,1,4,18,0,3,0,22,0,kid play tamagotchi
1,1,15,46,1,14,0,61,0,little guy got tooth pulled drone totally awesome
1,2,3,43,1,10,0,46,0,"winchester best place live uk, study reveals"
1,1,9,31,0,8,0,40,0,inspired seek help mental health
1,3,16,49,3,13,0,65,0,alec baldwin playing donald trump 'snl' regularly much longer
1,1,10,36,1,9,0,46,0,bet can't solve really hard geometry problem
1,2,13,35,1,9,0,48,0,bafta block award film arent diverse enough
1,1,9,33,0,9,2,42,0,58 french village bucket list
1,1,9,37,0,10,4,46,0,21 thing everyone obsessed forever 21 know true
1,2,3,56,2,14,0,59,0,nobody believed man got run deer april fools'; video prof
1,3,13,53,1,12,0,66,0,leopard caught alive delhi first time yamuna biodiversity park!
1,1,12,38,2,11,0,50,0,"well actually know belle ""beauty beast"""
1,3,7,72,4,13,0,79,0,donald trump think convince rand paul republican obamacare replacement. here how.
1,2,2,39,0,8,0,41,0,southeast asian walking fish life name
1,1,11,44,2,11,2,55,0,"17 question impossible ""harry potter"" fan answer"
1,3,4,22,0,5,0,26,0,suv need winter tire
1,1,9,34,0,8,0,43,0,might ultimate newborn photo shoot
1,1,10,35,0,9,0,45,0,disney villain based zodiac sign
1,3,1,25,1,2,0,26,0,tillersons troublesome start
1,1,13,39,0,12,0,52,0,website tell favorite band emo
1,1,14,43,0,13,0,57,0,cat lover get surprised box tiny kitten lose mind
1,1,6,25,0,6,2,31,0,12 wedding tip bride anxiety
1,3,6,31,0,6,4,37,0,billionaire sport team owner almanac 2017
1,1,10,25,2,9,0,35,0,"guess often say word ""fuck"""
1,1,6,41,0,6,2,47,0,22 piece beautifully minimalist geometric jewellery
1,1,9,36,0,9,2,45,0,22 word totally different meaning austin
1,2,9,42,0,9,2,51,0,17 truth people adore wine could possibly understand
1,1,9,26,0,8,0,35,0,much actually know gay sex
1,1,10,46,0,9,0,56,0,demi lovato signed modeling contract wilhemina model
1,1,8,31,1,7,0,39,0,we're launching first ever series itunes
1,1,6,29,1,5,0,35,0,here's real vegetarian actually eat
1,2,10,49,5,11,0,59,0,watch: first trailer al gore inconvenient sequel: truth power
1,3,10,43,0,9,0,53,0,buying selling mlb player turning head spring training
1,1,12,43,1,11,0,55,0,guy's comic hilariously sum truth parent
1,3,1,85,2,17,0,86,0,"trump latest comment stoke talk new nuclear arm race, press secretary try explain"
1,1,14,51,2,12,0,65,0,meet body-positive artist who's giving troll taste medicine
1,3,5,20,1,5,2,25,0,17 kid arent playingaround
1,1,5,25,1,4,0,30,0,magician play magic: gathering
1,1,9,34,0,9,2,43,0,17 time fragility masculinity went way far
1,1,12,35,0,11,0,47,0,take care training race
1,3,1,46,1,10,0,47,0,dip back in: beat hummus crisis quick recipe
1,1,10,27,0,9,0,37,0,cute cat make hard leave house
1,3,2,38,0,7,0,40,0,computer game minecraft help autism
1,1,15,46,1,14,0,61,0,kind animal niall's shirt new one direction music video
1,1,7,21,0,7,2,28,0,12 sign grew san francisco
1,1,6,27,0,6,2,33,0,15 scented candle could actually use
1,1,8,29,1,7,0,37,0,here's eat dinner tonight
1,1,4,29,0,4,2,33,0,17 beautifully designed mermaid tattoo
1,1,12,33,0,12,2,45,0,18 thing way real people stay late
1,1,9,26,0,9,1,35,0,7 easy thing improve life
1,1,10,43,0,10,2,53,0,11 slightly horrifying fact stop biting nail
1,1,6,34,0,6,2,40,0,14 time canada completely ruined halloween
1,1,9,47,1,9,2,56,0,hogwarts house '90s nickelodeon character belong
1,1,12,65,0,12,1,77,0,7 incredible thing learned jennifer lawrence glamour magazine interview
1,1,12,41,1,12,2,53,0,"18 time cory topanga set relationship bar way, way high"
1,1,11,31,1,9,2,42,0,13 celebrity #tbt photo may missed week
1,1,9,36,0,9,2,45,0,25 thing happen best friend get married
1,2,3,13,0,5,6,16,0,10 best music meme 2016
1,1,8,22,2,9,6,30,0,"15 time ""broad city"" best part 2015"
1,3,10,43,2,12,0,53,0,"trump ally congress warns state, california, make nice"
1,1,10,36,0,10,2,46,0,14 green smoothy people still taste kale
1,1,11,47,0,10,0,58,0,amazing origin cotton candy raccoon finally revealed
1,1,8,42,1,8,2,50,0,21 hilariously weird phobia believe people
1,1,9,30,0,8,0,39,0,well actually know modern text speak
1,3,12,41,1,14,8,53,0,30 30 europe: star shaping world finance 2017
1,1,6,16,0,5,0,22,0,need talk snoke
1,1,12,44,2,12,2,56,0,22 picture make sense people eldest sibling
1,1,5,34,2,5,2,39,0,"another round, episode 30: frimfram fittlesworth"
1,3,2,43,1,10,0,45,0,trump win name came first key states?
1,2,10,30,4,9,2,40,0,"18 face-swaps make say today,satan"
1,1,12,47,2,11,0,59,0,answer one question we'll determine really texas
1,1,7,37,3,6,0,44,0,"favorite ""grey's anatomy"" relationship"
1,1,8,36,1,8,2,44,0,11 moment everyone who's met fuckboy understand
1,2,12,44,0,11,0,56,0,frank ocean released another new song people losing
1,1,7,24,0,8,6,31,0,23 people tweeted 2015
1,1,4,26,0,5,2,30,0,13 bread thanksgiving table
1,3,11,44,1,10,1,55,0,8 tip anyone want learn calligraphy hand-lettering
1,1,7,20,0,8,6,27,0,24 song sweatily made 2005
1,1,6,26,4,5,0,32,0,"""cinderella"" ""maleficent"""
1,2,6,38,0,8,2,44,0,27 stunning photo world beautiful place
1,1,9,26,0,9,2,35,0,18 map change see world
1,3,9,45,3,9,0,54,0,"donald trump, aleppo, golden globes: monday evening briefing"
1,1,7,28,1,5,0,35,0,would pas fourth-grade science today
1,1,13,52,1,12,0,65,0,watch lifelike portrait emma watson come alive artist's timelapse
1,1,15,46,1,14,0,61,0,canadians: tell photo taken afternoon night
1,1,6,33,0,5,0,39,0,surprising beauty hack using coffee ground
1,2,8,42,1,8,0,50,0,dog-related bill flood albany major legislation stall
1,3,3,86,5,17,0,89,0,"google's business chief show 'very, very, very' tricky position ad offensive youtube video"
1,1,6,24,0,5,0,30,0,james franco got bar mitzvahed
1,1,11,38,2,10,0,49,0,"actually remember first episode ""the west wing"""
1,1,7,27,0,7,2,34,0,36 absolute best curvy costume idea
1,3,13,51,2,12,0,64,0,three girl dressed hidden figure character give youlife
1,3,17,54,3,15,0,71,0,"srk plan quit smoking drinking, kapil's physical brawl sunil ent"
1,1,12,55,0,11,0,67,0,bhopal government official caught watching porn council meeting
1,1,5,19,0,4,0,24,0,scott give eastwood
1,1,15,45,3,13,0,60,0,"lot people think gray-haired reporter ""making murderer"" hot"
1,2,7,48,3,15,6,55,0,citi: '12 chart christmas' tell u lot expect 2017
1,1,9,39,0,8,0,48,0,figure card humanity crossword
1,1,7,20,1,6,2,27,0,17 life-changing way eat oreo
1,3,7,34,1,7,1,41,0,samsung refurbishing disastrous note 7?
1,1,7,35,0,7,2,42,0,24 dessert guaranteed make caramel lover drool
1,1,4,12,0,3,0,16,0,woman love wine
1,1,2,15,0,1,0,17,0,kimchi quesadilla
1,1,7,29,0,7,2,36,0,19 thing sensible people relate
1,3,6,66,1,11,0,72,0,real mediterranean diet: expect featured story additional story
1,1,12,38,0,12,2,50,0,22 photo prove black girl magic long time
1,1,10,40,1,10,2,50,0,10 christmas movie drinking game want play year
1,2,13,38,2,12,3,51,0,people 100% ok teen roommate open hisbread
1,1,7,33,0,7,2,40,0,17 genius tip dealing impostor syndrome
1,3,1,29,4,8,0,30,0,"news fake, trust?"
1,3,7,43,1,7,0,50,0,"isaiah thomas tweet emoji, everyone obsesses meaning"
1,1,20,47,2,19,0,67,0,"designer store told woman ""go gym"" asked ghagra size"
1,3,5,44,1,12,1,49,0,high cholesterol? 5 food eat avoid
1,1,12,35,0,11,0,47,0,know favorite dog breed based taste men
1,2,7,31,2,7,0,38,0,star wars: last jedi rehabilitate yoda?
1,3,11,55,3,12,3,66,0,"$207 phone case beyonce, kendall jenner, celebrity obsessed"
1,1,12,32,1,9,0,44,0,many award-winning tv show seen
1,1,10,38,0,10,2,48,0,23 sibling photo shoot make want another baby
1,1,10,33,0,9,0,43,0,crazy smart trick save money
1,1,13,30,0,12,0,43,0,pigeon ate rat like rat ate pizza
1,1,15,32,1,13,2,47,0,22 thing give bff show they're one
1,1,7,24,0,7,2,31,0,17 thing lazy couple get
1,2,6,42,0,12,0,48,0,theaster gate took ax painting nga
1,1,6,25,0,6,2,31,0,19 contact everyone phone
1,2,1,24,0,2,0,25,0,tropical cyclone explained
1,1,10,35,0,10,1,45,0,4 question determine get cat
1,2,10,28,0,10,0,38,0,find far drive car empty
1,1,12,37,0,11,0,49,0,drake song would titled honest
1,1,9,36,1,8,0,45,0,here's teenage emo heartthrob look like
1,1,8,39,0,8,2,47,0,29 truly horrible vegetable recipe exist
1,1,15,39,0,13,0,54,0,stephen colbert cooked meal indian mom cute af
1,1,5,22,0,6,6,27,0,25 funniest sport tweet 2015
1,1,11,43,1,11,2,54,0,18 important new year's resolution stated five word
1,1,14,50,0,13,0,64,0,taylor swift music video stud date based birth month
1,2,8,37,5,13,8,45,0,maduro diet: 3 4 venezuelan lost least 19 pound 2016
1,1,10,51,0,9,0,61,0,kim kardashian accidentally shared retouched selfie original
1,1,11,42,0,10,0,53,0,random hogwarts student based zodiac sign
1,3,4,18,1,3,0,22,0,farmer fear trump?
1,3,10,29,2,9,0,39,0,moving ad 'rogue one' people tear
1,1,9,34,0,10,6,43,0,30 early 2000s country song make day better
1,1,9,34,1,9,2,43,0,26 incredibly cozy dorm actually want live
1,2,9,45,3,9,0,54,0,"donald trump, quebec city, patriots: monday evening briefing"
1,3,4,43,3,9,1,47,0,'twin peaks' season 3: showtime revival get premiere date
1,1,9,31,0,9,2,40,0,16 rude text chronic pain would send
1,3,0,27,0,6,2,27,0,13 unexpected cost kid
1,3,12,41,1,11,0,53,0,"jimmy kimmel montage prof donald trump mover, shaker"
1,3,12,36,0,11,0,48,0,trivia genius pas timed true falsequiz
1,1,9,41,0,9,2,50,0,27 way decorate home actually inspirational
1,1,10,30,0,10,2,40,0,need talk gigi hadid like 10 second
1,3,6,32,3,5,0,38,0,claim: syrian mafia control stockholm suburb
1,3,1,32,3,4,0,33,0,car-stealing 'mystery device' uncovered
1,1,9,17,0,8,6,26,0,25 wtf photo made news 2015
1,3,11,63,4,12,0,74,0,drexel university professor christmas wish: want christmas white genocide
1,1,10,31,4,11,2,41,0,"well remember missy elliot's rap ""1, 2 step"""
1,2,14,27,1,10,0,41,0,like adhd yourtwenties
1,1,11,38,0,10,0,49,0,know taylor swift hairstyle would look best
1,3,5,30,1,7,1,35,0,iphone io 9 new feature business insider
1,1,14,47,2,12,0,61,0,here's happened made three-course meal using microwave
1,1,7,22,0,7,4,29,0,well remember 2015 oscar
1,1,14,34,1,10,0,48,0,j.lo slayed amas stage insane dance medley
1,1,7,33,0,7,2,40,0,19 feminist costume idea badass little girl
1,1,13,50,0,12,0,63,0,internet trying find rockstar masquerading fruit seller
1,3,6,27,1,9,0,33,0,get doctor visit
1,2,2,39,1,7,0,41,0,world's drunkest country list
1,1,12,35,0,10,0,47,0,know ya couple significant
1,1,7,35,0,7,2,42,0,22 time tumblr accurately summed lesbian dating
1,1,10,41,2,9,0,51,0,"smith really sad ""independence day"" character died"
1,1,9,37,0,8,0,46,0,disney princess look like without face
1,1,10,38,2,9,2,48,0,21 question every single person l.a. asked
1,1,10,39,0,10,2,49,0,15 halloween candy apple make apple look bad
1,3,6,35,0,9,0,41,0,remake famous airport world
1,1,7,27,0,7,2,34,0,13 haiku single people relate
1,1,6,19,0,5,0,25,0,kind introvert
1,3,5,43,3,12,0,48,0,"we've fun, let's leave bbc dad family alone"
1,3,1,57,0,12,2,58,0,incredible journey missing dog trekked 60 mile find owner
1,1,7,23,0,5,0,30,0,pretzel bite dippable af
1,2,16,53,0,15,0,69,0,strange case russian diplomat got head smashed electionday
1,3,16,64,0,15,0,80,0,scientist formulated equation show much damage human causing earth
1,2,4,55,4,8,0,59,0,world's biggest dinosaur footprint found 'australia's jurassic park'
1,1,11,46,1,10,0,57,0,assumption someone made feminist
1,1,9,30,1,8,0,39,0,brief history lori petty's red carpet style
1,2,14,34,4,13,4,48,0,here peek all-new powerpuff girl set air in2016
1,3,8,37,1,7,2,45,0,16 parchment-wrapped dinner people hate dish
1,1,8,40,1,7,2,48,0,19 problem teenager over-straightened hair
1,3,2,77,2,21,1,79,0,treasure hunter found 3 ton sunken gold cant leave jail say list
1,1,8,25,0,7,0,33,0,much really know emojis
1,1,13,43,1,12,0,56,0,here's happens woman try buy female condom india
1,2,11,53,3,14,2,64,0,10 reason peter gabriel's 'solsbury hill' one greatest song time
1,1,10,35,1,9,0,45,0,everyone found denzel's son really hot
1,3,4,25,0,5,6,29,0,10 company hunting freelancer 2017
1,1,9,40,1,9,2,49,0,15 vagina horror story send shiver spine
1,3,2,37,0,7,0,39,0,dancing officer spread joy school texas
1,1,8,28,0,5,2,36,0,17 adorably spoooooooky knit halloween
1,3,15,52,1,15,4,67,0,rajat kapoor feel movie made 1950s best indian cinema ever seen!
1,2,13,32,2,12,0,45,0,ask raise: do don'ts
1,1,4,17,0,3,0,21,0,cuffing season coming
1,1,8,30,1,7,0,38,0,happens girl other's makeup
1,1,10,38,0,10,2,48,0,23 hilarious meme explain greek life black school
1,1,13,58,0,12,0,71,0,story anyone reservation bringing syrian refugee canada
1,2,11,56,0,11,0,67,0,injectable filler reportedly left woman blind one eye disfigured face
1,1,11,40,0,11,1,51,0,8 fact sheree kenya might want remember
1,1,6,19,0,6,2,25,0,17 cat really loving cat nip
1,2,10,44,1,12,0,54,0,here's trump could make mexico pay border wall insider
1,1,9,31,0,9,2,40,0,29 tried true tip every brand new parent need
1,1,7,27,0,7,1,34,0,8 moment butch lesbian know well
1,1,11,34,0,10,0,45,0,post supposed make feel better right
1,3,5,42,4,10,0,47,0,stormzy: gang sign prayer review london new grime lord
1,1,10,42,0,10,2,52,0,21 way use chocolate strawberry outside bedroom
1,1,17,59,1,16,0,76,0,gay man wrote heartbreaking letter parent come wedding
1,3,2,63,2,14,2,65,0,uber lyft driver share 14 thing they'd love tell passenger can't
1,2,10,49,0,9,0,59,0,scientist find surprising link birth month disease risk
1,2,12,56,0,11,0,68,0,green veggie like celery broccoli help improve breast cancer treatment
1,3,10,41,0,12,0,51,0,keep office holiday party going rail
1,3,13,43,5,11,6,56,0,"32 behind-the-scenes look tv shows, movies, theater, fandom from2016"
1,2,3,47,0,9,0,50,0,indian politician reputation bond villain
1,1,9,31,0,9,2,40,0,25 foolproof way impress lady club
1,3,2,44,0,11,0,46,0,long average person last bed list
1,3,12,63,5,12,0,75,0,westworld star jeffrey wright: trump overtly vulgar misogynist man ever elected
1,1,10,43,1,8,0,53,0,insane amethyst-inspired wedding cake blow mind
1,1,7,30,3,6,0,37,0,"what's favorite moment ""hocus pocus"""
1,2,8,35,2,8,4,43,0,(probably) hottest parenting trend of2017
1,1,8,28,0,7,0,36,0,well actually know cher horowitz
1,1,10,23,0,10,4,33,0,guess many time sex 2015
1,1,8,31,1,7,0,39,0,finally! crossword filled star war pun
1,1,14,52,0,14,2,66,0,18 time hannah hart ingrid nilsen set bar high couple everywhere
1,1,14,45,0,13,0,59,0,know zodiac sign based picture zayn malik choose
1,1,13,39,0,12,0,52,0,go nut trying find poop emoji cupcake
1,1,13,40,3,11,0,53,0,"well know lyric ""rudolph red-nosed reindeer"""
1,2,6,31,0,6,0,37,0,expert take performing pressure
1,2,13,49,4,10,0,62,0,"dhs kelly slam obamas policies, proclaims sacred duty protect america"
1,1,10,45,2,10,2,55,0,17 thing understand slightly obsessed bed
1,2,10,31,3,7,0,41,0,"donald trump, nato, boeing: thursday briefing"
1,1,9,29,0,9,2,38,0,30 halloween costume put u shame
1,1,8,14,1,4,0,22,0,what's hbcu love story
1,1,3,10,0,2,0,13,0,guy try tinder
1,1,9,33,1,8,0,42,0,what's favorite comedy movie black cast
1,1,10,34,0,10,2,44,0,20 thing make total sense lift weight
1,2,4,70,4,15,0,74,0,cub theo epstein home run response getting named world greatest leader
1,1,5,24,1,4,0,29,0,what's horoscope december
1,2,10,31,4,10,2,41,0,believe hype: bling $70 water vs. nyc tap water
1,1,6,17,1,4,0,23,0,stage all-nighter
1,2,15,52,0,12,2,67,0,11 heartwarming hilarious story lgbt parent coming theirkids
1,2,10,34,0,9,0,44,0,inside navy seal raid yemen targeting al qaeda
1,1,7,29,0,8,6,36,0,33 time celebrity stood feminism 2015
1,1,15,40,0,13,0,55,0,know tv couple based favorite lush bath bar
1,1,13,46,1,12,0,59,0,one thing probably notice gaga golden globe
1,1,12,53,1,11,0,65,0,"twentysomethings, make post without getting turned"
1,2,5,31,3,8,8,36,0,"30 30 asia 2017: industry, manufacturing energy"
1,1,8,25,0,6,2,33,0,19 dutch word wtf translation
1,2,13,37,0,13,1,50,0,truly kinky person get 8 correct thisquiz
1,1,8,28,0,7,0,36,0,meredith grey meredith grey
1,3,12,59,0,12,0,71,0,staffer helped broker iran nuclear deal still working trump state department
1,2,8,20,0,4,0,28,0,milo announces new medium venture
1,1,3,16,0,3,2,19,0,21 geekiest pickup line
1,2,5,60,1,11,0,65,0,"share pearson, premier food mitie plunge profit warning strike"
1,1,17,57,0,18,4,74,0,watch guy age 12 20 year old two minute incredible selfie time lapse
1,1,13,36,2,8,0,49,0,"hogwarts house ""himym"" character belong"
1,1,4,16,0,3,0,20,0,marry kocoum
1,1,15,29,0,9,2,44,0,26 photo prove nothing hotter rugby
1,1,7,31,0,6,0,38,0,pornhub hilarious christmas advert
1,1,7,20,0,8,6,27,0,23 way get shit together 2016
1,2,3,69,2,13,0,72,0,hidden gem serve west african dish youd hard-pressed find anywhere else
1,1,13,45,2,12,0,58,0,"wookiee cooky perfect snack ""star wars"" fan"
1,1,10,36,1,9,0,46,0,"college kids, gift really want christmas"
1,1,6,26,1,5,0,32,0,woman answer: sex exclusivity first
1,1,11,50,0,10,0,61,0,important member beckham household joined instagram
1,1,9,33,0,9,4,42,0,vote 2024 presidential election
1,1,8,37,1,7,0,45,0,"heather graham ride garbage truck, remains perfect"
1,1,11,34,2,11,5,45,0,"need talk truly iconic naomi clark ""90210"""
1,1,11,43,3,10,0,54,0,"duet cover adele's ""hello"" give intense goosebump"
1,2,3,69,1,12,0,72,0,katie piper: model left burned acid attack share tip rebuilding confidence
1,2,4,8,3,2,0,12,0,come cpi...
1,1,9,35,1,9,2,44,0,"19 thing warm even coldest, deadest heart"
1,2,3,43,2,8,0,46,0,meryl streep hit star-struck trump big weakness
1,3,11,51,1,10,0,62,0,supermodel gigi bella hadid protest trump immigration order nyc
1,1,10,35,2,9,0,45,0,"many ""harry potter"" character name"
1,1,9,28,0,8,2,37,0,12 time tumblr got weird af zodiac sign
1,2,10,37,0,10,1,47,0,7 famous people share wisdom art happiness
1,1,8,39,0,8,2,47,0,21 wonderful coat completely perfect spring
1,3,12,59,6,13,3,71,0,exclusiverep. massie trump first 100 days: neil gorsuch worth entire election
1,1,7,31,0,6,0,38,0,quentin tarantino leading lady
1,3,2,49,0,9,0,51,0,culture around trump troubling message police
1,1,8,33,0,8,2,41,0,19 thing every vegetarian must eat die
1,1,10,32,3,8,0,42,0,go-to beverage say ~thirst~
1,3,11,44,2,10,0,55,0,captain america actor give tom brady pas supporting trump
1,3,6,69,2,17,0,75,0,five food need eat every day flatter stomach (including miso soup bread)
1,1,9,26,0,9,2,35,0,15 mug video gamer life love
1,1,12,44,1,11,0,56,0,reminder: donald trump stunned stone cold steve austin wwe
1,3,8,41,1,9,1,49,0,dont leave job interview without asking 3 question
1,1,9,39,0,9,2,48,0,20 sign definitely hilarious story behind
1,3,14,71,2,13,0,85,0,mess arnold schwarzenegger! troll mocking special olympics get destroyed social medium
1,1,6,18,2,5,0,24,0,"well remember ""hook"""
1,1,11,41,0,10,0,52,0,video make rethink first world problem
1,1,7,23,0,8,6,30,0,27 awesome trans moment 2015
1,1,16,34,0,13,0,50,0,know funny dog gif need see based zodiac
1,3,8,43,0,11,0,51,0,carl icahn adviser carl icahn investor meet
1,3,9,48,1,9,2,57,0,17 mindblowing celebrity fact never believe actually true
1,1,13,42,0,13,2,55,0,24 picture make want live planet anymore
1,1,8,9,0,5,0,17,0,bff big baby
1,2,9,41,1,12,1,50,0,people bothered colorful photo 5 black women?
1,1,7,32,1,7,1,39,0,"8 worst questions, answered science"
1,3,15,43,1,15,1,58,0,quit job live abroad: 8 place cheap might need work
1,3,2,58,4,13,0,60,0,'split' pulled incredible twist ending go next
1,1,11,35,1,11,2,46,0,18 little thing explain kid one day
1,1,11,49,0,10,0,60,0,evan rachel wood made amazing comment bisexuality
1,1,16,48,3,12,0,64,0,"black widow hulk adorable ""lego marvel's avengers"" cutscene"
1,3,2,56,1,11,0,58,0,"mother get cropped family photo, furious response list"
1,3,8,34,0,8,2,42,0,32 gorgeous beauty product people color swearby
1,1,7,29,0,7,2,36,0,34 eye opening photo great depression
1,1,10,48,2,9,0,58,0,"stop everything ""friday night lights"" musical happening"
1,1,5,11,0,4,0,16,0,dope nope
1,1,11,35,0,10,0,46,0,actually hand foot always cold
1,1,11,36,0,10,0,47,0,secret dark side would surprise people
1,1,13,44,1,13,2,57,0,forever 21 accused stealing artist's design crop top
1,2,10,44,1,9,0,54,0,dessert test reveal many grandchild youllhave
1,1,17,18,1,8,2,35,0,31 way know definitely dc native
1,3,5,53,3,10,0,58,0,soundcloud stage: soulful r&b singer's major festival debut
1,3,6,23,1,6,4,29,0,world's expensive car 2017
1,3,1,54,0,8,0,55,0,study link better patient outcome doctor trained overseas
1,1,11,31,0,9,0,42,0,woman shaved head look fly af
1,1,9,47,0,9,2,56,0,11 scientific prediction future seriously crazy
1,1,7,32,0,7,2,39,0,24 confession topshop staff never tell
1,3,10,46,2,12,0,56,0,whitewashing ghost shell even worse thought
1,2,2,44,1,9,0,46,0,here sadness make physically sick list
1,2,4,54,6,9,4,58,0,black mirror's 'san junipero': 2016's life-affirming piece television
1,1,10,43,0,9,0,53,0,fucking weird erotic novel best describes love life
1,2,10,49,2,10,0,59,0,nailed half-court shot almost missed boyfriend proposal
1,3,11,55,3,12,0,66,0,sean penn former producer steve bannon: conniving hateful bloated punk
1,1,7,23,0,6,0,30,0,mumford son album
1,2,14,48,3,13,0,62,0,girl fish pulled finding nemo move everyone screaming
1,1,10,27,0,9,0,37,0,guess much owe student loan
1,1,11,33,1,10,2,44,0,take back '90s nostalgic af pancake
1,1,6,22,2,6,2,28,0,"22 people keeping ""yolo"" alive"
1,1,10,42,2,9,0,52,0,"hogwarts house character ""hamilton"" belong"
1,3,22,47,1,20,4,69,0,"hope 2017, aib video show next year going bomb"
1,2,6,28,1,5,0,34,0,prison phone rates: ripoff continues
1,3,2,24,1,7,7,26,0,100 woman 2016: fighting good death
1,1,14,41,1,12,0,55,0,actually die mind-blowing new circle k logo
1,3,1,72,3,14,0,73,0,"career likely whether oldest, middle youngest child"
1,2,3,55,2,8,0,58,0,paedophile hunter scrap facebook live sting police warning
1,3,2,42,1,8,0,44,0,nasty nice? study link personality brain shape
1,1,13,57,2,12,0,70,0,"everyone freak spice girl ""potentially"" planning reunion tour"
1,1,9,31,4,8,0,40,0,"listen ariana grande's new ep ""christmas chill"""
1,1,11,49,0,10,0,60,0,associated press accidentally linked amazing sassy cat video
1,1,12,44,1,11,0,56,0,people fucking hate dressing halloween: alone
1,3,13,39,2,12,0,52,0,"nintendo switch review: buy buy, question"
1,2,6,43,0,8,2,49,0,muslim outnumber christian 30 church school
1,1,8,37,1,8,2,45,0,19 tweet chipotle actually make laugh
1,3,1,46,2,11,0,47,0,poke hole jacket itll repair
1,1,7,16,0,6,0,23,0,think hit
1,1,10,41,1,9,0,51,0,kendall jenner's ponytail ponytail dream made
1,2,1,39,2,7,0,40,0,dopamine dressing dress happy?
1,1,10,33,2,9,0,43,0,"well know lyric ""bohemian rhapsody"""
1,1,8,29,1,8,2,37,0,teen watch '00s music video first time
1,1,7,32,0,7,2,39,0,11 cookie lyon greeting card every occasion
1,1,14,53,0,13,0,67,0,ursula would look like lived different ocean environment
1,3,2,57,0,12,0,59,0,thing always suspected dog actually true list
1,3,3,43,1,8,1,46,0,5 way trump's supreme court pick may influence business
1,1,15,41,4,14,0,56,0,"tina fey would like know see ""star wars"" ""sisters"""
1,2,2,61,1,16,0,63,0,summer movie preview: watch want see best best
1,1,11,42,0,11,2,53,0,31 halloween costume scare shit friend
1,1,7,34,0,7,2,41,0,14 surprising confession people deaf
1,1,9,34,0,8,0,43,0,shout people eat noodle thanksgiving
1,1,9,38,1,8,0,47,0,dog care less canadian rockies
1,1,12,50,0,12,2,62,0,12 thing sunny leone said past working adult entertainment
1,1,10,39,0,10,2,49,0,16 reason black friday garbage compared boxing day
1,1,6,33,1,6,1,39,0,adorable animal advent calendar: december 9
1,1,10,43,4,10,2,53,0,"15 time lady gaga's outfit slayed ""american horror story: hotel"""
1,1,17,56,0,16,0,73,0,girl cried tried pepsi first time life much sometimes
1,1,7,39,0,7,2,46,0,17 relationship goal actually worth achieving
1,1,8,32,1,8,2,40,0,17 hilarious way people found santa real
1,2,18,61,6,17,0,79,0,"'nbc's new year's eve' host carson daly share new year's resolution, stay warm time square"
1,1,8,34,2,8,2,42,0,"13 ""teen wolf"" question impossible answer"
1,1,9,31,1,8,0,40,0,what's actual name based birth month
1,1,10,26,3,9,2,36,0,"23 best line fox mulder ""the x-files"""
1,1,12,46,0,12,2,58,0,33 thing french people confuse fuck everyone else
1,2,9,36,0,9,1,45,0,6 morning ritual make productive day
1,1,9,45,2,9,2,54,0,15 cringeworthy romance story make glad single
1,2,9,43,4,8,0,52,0,"paris, bill oreilly, venezuela: thursday evening briefing"
1,3,10,45,1,12,0,55,0,"cooking got barbara lynch south boston, brought back"
1,1,8,39,3,8,2,47,0,"31 fact probably know ""edward scissorhands"""
1,1,7,32,0,7,2,39,0,43 thing bernie sander probably today
1,2,11,50,0,10,0,61,0,feisty little dancer channeling aretha franklin give youlife
1,1,9,29,0,8,0,38,0,makeup test reveal truth
1,3,2,53,3,14,4,55,0,"chicago's first baby 2017 named honor of, guessed it, cub"
1,1,13,30,2,13,4,43,0,"""mean girls"" would like set 2015"
1,3,7,32,2,7,0,39,0,real benefit apple cider vinegar [video]
1,1,8,31,4,7,0,39,0,"jennifer lopez perfect jimmy fallon's ""ew!"""
1,1,6,33,1,6,2,39,0,27 batshit line mike tyson's autobiography
1,1,10,42,2,9,0,52,0,"hogwarts house ""star wars"" character belong"
1,1,10,33,0,10,2,43,0,22 time animal trying live life
1,1,14,54,0,13,0,68,0,new yorkers dealt stalled subway train starting drake singalong
1,1,9,37,1,8,0,46,0,here's real healthy people actually eat brunch
1,1,10,46,0,9,0,56,0,color swirl test determine actual personality type
1,2,7,25,1,8,0,32,0,im breaking apple watch
1,1,13,38,1,12,0,51,0,peanut butter jelly bourbon exists gift u
1,2,13,43,1,12,0,56,0,iphone really frying brain? five thing need know
1,2,7,28,0,6,0,35,0,anyone invest like warren buffett
1,3,8,25,0,8,2,33,0,22 powerful photo thisweek
1,1,9,42,1,9,1,51,0,everyone who's sexually attracted deacon fallout 4
1,1,9,30,4,7,0,39,0,"so, ""american horror story: hotel"" look creepy af"
1,2,14,68,3,12,0,82,0,seven 'green' building around world prove architecture environment-friendly
1,1,8,32,0,8,2,40,0,28 onion headline basically sum life
1,2,11,40,0,10,0,51,0,successful people sunday productive week
1,1,4,17,0,5,6,21,0,45 funniest tweet 2015
1,2,3,34,2,7,0,37,0,barack obama legacy: regret?
1,1,12,35,2,11,0,47,0,"cast ""a cinderella story"" look like"
1,1,15,48,2,14,2,63,0,here's epic road trip let spend whole year 70-degree weather
1,1,11,34,0,10,0,45,0,mega man boss bizarre name try guess
1,3,2,48,2,14,0,50,0,"watch, watch, watch say march"
1,1,12,41,1,12,2,53,0,21 cute dog picture help put whatever putting
1,1,10,34,0,10,1,44,0,9 rescue dog sleeping bed first time
1,3,8,40,0,8,2,48,0,18 picture prove dog actually beautiful weirdo
1,3,6,14,0,7,6,20,0,19 teen in2016
1,3,13,50,3,13,0,63,0,"brady campaign donald trump: dont need prayers, need gun control"
1,1,9,31,0,9,2,40,0,27 tweet make tall people laugh loud
1,1,12,38,0,11,0,50,0,hairstylist gave bride cancer hair dream
1,3,3,62,2,15,0,65,0,"girl get oxford, rejection letter list"
1,2,2,19,1,3,0,21,0,grammys: winner list
1,1,11,43,1,10,0,54,0,world know jake gyllenhaal's real height thanks conan
1,1,14,25,0,8,0,39,0,guess really want christmas
1,1,5,19,0,5,2,24,0,29 gift actually really want
1,3,2,48,0,10,1,50,0,blood orange release stunning new music video 3 track
1,1,15,49,0,14,0,64,0,actor color nominated oscar year people pissed
1,1,15,40,0,14,0,55,0,guess age live based taste music
1,1,10,44,0,10,2,54,0,13 thing happen best friend start getting married
1,1,15,65,3,14,0,80,0,"week's ""showstopper"" bake one nervewracking television moment year"
1,1,6,23,0,5,0,29,0,name everyday thing
1,1,8,39,0,8,2,47,0,18 indian dessert guaranteed satisfy sweet tooth
1,1,14,50,2,13,0,64,0,"look like paris doyle still together ""gilmore girls"" revival"
1,1,8,31,0,8,2,39,0,22 object people actually lost as
1,1,8,38,1,8,2,46,0,21 call center horror story give nightmare
1,1,10,45,1,9,0,55,0,watch lady gaga's heartbreaking new music video campus rape
1,1,16,46,0,13,0,62,0,jason derulo performed hoverboard emas glorious
1,1,14,42,4,10,0,56,0,"black body trial: conviction hiv-positive ""tiger mandingo"""
1,1,13,50,1,13,2,63,0,'90s horrible decade nostalgia clouding judgment
1,1,10,32,0,10,2,42,0,33 leslie knope quote help live best life
1,3,15,66,6,16,0,81,0,cnns tapper: fair critique medium running early trump rally start finish
1,2,1,48,0,11,0,49,0,one three victim domestic abuse men
1,1,7,26,0,8,6,33,0,19 people contoured better 2015
1,1,15,57,3,14,0,72,0,"star ""million dollar listing: los angeles"" guess much luxury home cost"
1,1,8,46,0,7,0,54,0,trans woman complicated relationship halloween
1,1,12,36,0,11,0,48,0,figure headline say first try
1,1,5,21,0,4,0,26,0,people try bizarre candy cane
1,2,5,55,2,15,0,60,0,turn cpr bring drowned lizard back life. couple times.
1,1,15,32,0,13,2,47,0,look like skateboard road 70 mph
1,1,8,25,0,7,0,33,0,moment becomes hookup
1,2,8,35,0,7,0,43,0,apple move might strike fear advertiser
1,1,15,53,2,14,0,68,0,reason wrong think ariana grande everything
1,1,10,45,0,10,2,55,0,15 gorgeous people disability winning style game
1,3,15,68,3,13,1,83,0,northwestern mutualvoice: sweet smell success: 5 tip starting post-retirement business
1,1,8,33,2,7,2,41,0,21 secret mcdonald's employee tell
1,1,10,40,0,10,2,50,0,19 beautiful place scotland give people feel
1,1,9,35,2,9,2,44,0,"16 reason ""cat owner appreciation"" day"
1,1,8,25,0,8,2,33,0,16 exciting creative way eat egg
1,1,8,35,2,7,0,43,0,"molly ringwald think great too, claire dane"
1,1,14,49,2,11,0,63,0,watch golden retriever experience true joy ride merry-go-round
1,1,12,50,0,11,0,62,0,comedian talked abused raped previous relationship
1,1,12,34,4,11,0,46,0,"we're ""columbus day"" we're going rename"
1,3,1,52,0,10,0,53,0,date definitely judging crappy old phone
1,1,11,40,3,10,0,51,0,"here's happened white actor told ""act whiter"""
1,1,11,42,2,10,0,53,0,"kristen stewart advice ""star wars"" star daisy ridley"
1,3,9,44,1,9,0,53,0,trump ecstatic brazilian partner see big deal future
1,1,16,46,3,15,0,62,0,"hate ""the big bang theory"", tweet make stand applaud"
1,3,6,24,1,5,0,30,0,london libor trader next
1,1,10,37,0,9,0,47,0,group badass woman killed menswear game
1,1,16,53,0,15,0,69,0,watch people get mind blown possibility winnie pooh girl
1,1,9,43,0,8,0,52,0,stunning new clothing line bridge fashion feminism
1,1,11,39,0,10,0,50,0,need talk gigantic stuffed bear costco
1,2,12,55,2,16,3,67,0,college student top 1 percent bottom 60. find yours.
1,1,10,38,3,9,0,48,0,"aziz ansari's parent simply amazing ""master none"""
1,1,10,37,1,9,0,47,0,helen mirren looked best ever looked last night
1,3,15,46,6,13,5,61,0,"crazy sumit's kiss-and-run video one lakh hits, earned around r 70,000!"
1,3,8,24,1,6,0,32,0,bill o'reilly running friend
1,3,11,35,4,11,3,46,0,"""get out"" wont 100% rating rotten tomato everagain"
1,1,6,31,0,6,2,37,0,19 stunningly weird piece anatomy jewelry
1,1,9,29,0,8,0,38,0,sam smith recorded new james bond song
1,1,7,37,0,6,0,44,0,chanel oberlin quote motivational poster
1,1,11,44,6,10,0,55,0,"behind scene casting secret ""gossip girl,"" ""arrow,"""
1,1,17,72,3,15,0,89,0,"weekly gossip roundup: shia labeouf get arrested, pippa middleton split boyfriend,"
1,1,10,39,1,9,0,49,0,question determine ready settle
1,3,9,19,0,7,0,28,0,test tax iq pop quiz
1,1,9,41,2,9,2,50,0,21 word really understand unless florida
1,1,7,17,0,6,0,24,0,guess voted
1,1,13,51,1,13,6,64,0,11 gender-progressive thing already happened india 2015
1,1,11,37,2,10,0,48,0,"spot real ""harry potter"" character fake"
1,1,7,33,0,6,0,40,0,grown woman discus feminism hello barbie
1,1,12,44,1,11,0,56,0,believe many shark swimming florida right
1,1,11,48,1,10,0,59,0,thief kept stealing crashing poor canadian guy's truck
1,1,7,22,0,7,2,29,0,19 reason thankful dog
1,2,2,26,1,6,0,28,0,willing let trump evolve?
1,1,9,28,0,8,0,37,0,belong john boyega oscar isaac
1,3,9,34,0,8,0,43,0,camping stove also recharge gadget
1,3,8,35,1,7,0,43,0,alexander rossi american racing next big thing
1,1,8,28,0,8,2,36,0,15 expensive picture world
1,1,12,40,2,11,2,52,0,23 plus-size gym clothes sacrifice style
1,1,12,44,1,12,2,56,0,19 sex horror story make feel better love life
1,2,1,34,1,8,2,35,0,27 thing know iphone could
1,1,10,37,2,9,0,47,0,"""gotham"" character based zodiac sign"
1,3,4,51,3,10,0,55,0,google throw shade trump's 'muslim ban' historical doodle
1,1,9,39,0,9,2,48,0,22 struggle every small girl big foot understand
1,2,3,45,2,10,0,48,0,will's story: opioid abuse dark web intersect
1,2,4,59,1,12,0,63,0,supreme court nominee neil gorsuch tripped horse-sized duck
1,1,7,40,0,7,2,47,0,21 unconventional septum ring need immediately
1,1,8,32,1,7,0,40,0,watch adult review bizarre kids' toy
1,1,11,46,0,10,0,57,0,news channel green screened reporter chennai flood
1,1,9,33,0,8,0,42,0,nicolas cage greatest actor universe
1,1,9,33,1,9,2,42,0,19 thing understand suck makeup
1,3,2,64,1,10,0,66,0,kim kardashian shared beauty tip first post-robbery public appearance
1,1,11,68,4,10,0,79,0,"benedict cumberbatch tell theatre audience ""fuck politicians"" ""hamlet"" performance"
1,1,9,26,2,8,1,35,0,"""pretty little liars"" season 1 iq"
1,1,10,34,0,10,2,44,0,19 reason fall love turkish person
1,3,3,83,1,14,0,86,0,"man accused violent carjacking involving woman, two child lockyer valley remanded custody"
1,1,15,46,0,13,0,61,0,know ya hottie boyfriend based zodiac sign
1,1,8,23,0,7,0,31,0,matt damon ben affleck
1,1,8,35,0,8,1,43,0,9 sweet story roommate became best friend
1,1,12,57,6,10,0,69,0,"someone switched gordon ramsay's line ""masterchef junior"" ""hell's kitchen"""
1,1,9,30,0,9,2,39,0,asked 20 people went black college
1,3,5,65,1,14,0,70,0,"david cameron brexit, donald trump regret calling referendum"
1,2,8,43,1,10,0,51,0,trump plan keep job america: pressure promise
1,1,10,41,0,10,2,51,0,21 thing every second semester college senior know true
1,1,10,20,0,9,0,30,0,poot want see
1,3,8,35,0,8,2,43,0,19 time feminist funniest people ontumblr
1,3,1,77,1,14,0,78,0,facebooks creepy new feature encourages friend stranger based plan
1,3,1,69,1,15,0,70,0,"scent body wash, chicken stock canned drink come one company"
1,2,5,43,2,10,1,48,0,warren sapp think myles garrett deserving no. 1
1,1,10,32,1,7,0,42,0,tv show featured full-frontal male nudity
1,1,5,26,0,6,6,31,0,29 celebrity wedding happened 2015
1,1,8,26,0,8,2,34,0,14 crazy creepy place canada
1,1,10,39,0,10,2,49,0,17 disney nutella meme guaranteed make laugh loud
1,1,8,38,1,8,1,46,0,"percentage kardashian you, based 3 question"
1,1,11,44,2,10,0,55,0,"guess hogwarts house ""harry potter"" character"
1,2,11,52,2,12,0,63,0,watch gorillaz debut new 'humanz' album entirety secret london show
1,1,8,29,2,7,2,37,0,day 7 buzzfeed's 7-day clean eating challenge
1,3,5,30,0,6,2,35,0,hollywood legend debbie reynolds dy 84
1,1,5,17,0,4,0,22,0,italian really
1,1,12,38,0,11,0,50,0,know want christmas based zodiac sign
1,2,1,46,3,8,0,47,0,designer clothing line stylish ... bulletproof
1,3,2,41,2,8,0,43,0,firefighter cancer: risky job even riskier?
1,1,9,40,0,9,1,49,0,7 insanely cool halloween treat actually make
1,1,10,61,1,9,0,71,0,here's justin bieber looking gorgeous skateboarding playing instrument
1,3,18,73,7,16,0,91,0,"unicorn nursery: outside u.s., india iit produce billion-dollar startup founder india real time"
1,1,14,26,2,9,0,40,0,"""himym"" episode title reference"
1,1,9,31,1,10,4,40,0,27 party anthem early '00s still go hard
1,1,13,38,1,12,0,51,0,there's something called racoon dog guy japan one
1,1,8,40,1,7,0,48,0,guy's beautiful portrait leave speechless
1,1,9,37,2,8,0,46,0,"cast ""the office"" reimagined disney character"
1,2,2,33,1,6,0,35,0,trump started new deportation drive?
1,1,12,35,1,11,0,47,0,know teenage girl based single question
1,3,8,38,1,9,3,46,0,trump penny keeping pro-life promise first 100 day
1,1,11,41,2,10,0,52,0,"hogwarts house character ""the hunger games"""
1,1,10,37,0,9,0,47,0,adorable red panda cub make public debut chicago zoo
1,1,11,37,1,11,2,48,0,18 thing always happen people hate new year's eve
1,1,10,35,0,11,6,45,0,15 amazing product change way sleep 2016
1,3,1,60,0,9,0,61,0,london marathoner help struggling fellow runner cross finish line
1,1,12,49,0,11,0,61,0,couple canceled wedding gave money syrian refugee
1,1,13,44,3,11,0,57,0,"binge-watch ""making murderer"" think solve crime"
1,1,10,42,0,10,2,52,0,24 subtly spooky halloween decoration leave year
1,3,7,26,0,7,0,33,0,star got start soap opera
1,2,3,59,0,10,0,62,0,academic group censure university illinois rescinded job offer
1,1,11,41,0,10,0,52,0,oreo chocolate chip brownie basically work art
1,3,2,54,1,11,0,56,0,chinese people given enormous amount food parent
1,3,12,42,2,9,0,54,0,super-bowl-watching nun back entertaining ever
1,1,13,51,2,12,0,64,0,"costume competition prof ""simpsons"" fan best world"
1,1,9,25,0,8,0,34,0,name stuff solar system
1,3,1,37,0,7,0,38,0,cool teen build soda machine empty locker
1,3,11,34,0,8,0,45,0,net neutrality critic ajit pai named new fcc chairman
1,1,12,34,1,11,0,46,0,guess based soda drink
1,1,9,49,0,9,2,58,0,19 controversial topic tear family apart thanksgiving
1,1,13,52,0,13,2,65,0,20 incredibly honest confession really like stepparent
1,1,13,49,2,12,0,62,0,"set photo prove ""gilmore girls"" revival really happening"
1,3,14,40,1,14,0,54,0,man helped build trump meme army want reformit
1,1,9,30,0,8,0,39,0,know alter ego superheroes
1,1,11,35,0,10,0,46,0,go holiday based zodiac sign
1,1,9,40,0,9,2,49,0,19 wildly adorable product definitely need life
1,2,5,43,5,15,0,48,0,"want land great job? go 'gap yah', work jd sport"
1,1,11,35,0,10,0,46,0,many lesbian movie name single frame
1,3,13,44,3,13,4,57,0,"score 10/12 great lake quiz, youre probably themidwest"
1,1,11,35,0,11,2,46,0,19 best thing ever happened grocery store
1,1,7,27,0,6,0,34,0,know favorite one direction song
1,1,10,37,0,10,2,47,0,16 tweet spaghetti make laugh loud
1,1,11,34,1,10,4,45,0,in-demand new york library book 2015
1,1,7,23,0,6,0,30,0,bad flirting actually
1,1,9,26,0,9,2,35,0,16 scary movie need see die
1,1,9,45,2,9,2,54,0,"28 shot ""breaking bad"" character beautifully composed"
1,2,1,53,1,10,0,54,0,"risky behavior decline age, gray matter may explain"
1,1,5,22,2,4,0,27,0,"goodbye, america's next top model"
1,3,5,29,3,9,0,34,0,kim jong-nam row: n korea come top?
1,2,6,42,4,8,0,48,0,see reaction chris brown's appearance 'black-ish'
1,1,11,49,0,10,0,60,0,guide dog puppy trained adorable mini harness
1,1,14,40,0,13,0,54,0,pranked bunch people dropping iphone front
1,3,2,47,0,11,0,49,0,game throne fan ultra geeky deep dive death
1,1,11,42,0,10,0,53,0,crossword everyone kinky sex rihanna song
1,2,9,44,1,9,2,53,0,10 horror movie question thatll stump even biggestfanatics
1,1,9,30,1,9,4,39,0,here's top ten liked instagram post 2015
1,1,10,32,2,10,2,42,0,"18 reason need watching ""billy street"""
1,1,7,36,1,8,4,43,0,19 thing '90s student newcastle remember
1,1,12,48,0,11,0,60,0,happens couple reveals sexual fantasy
1,1,7,24,0,7,2,31,0,18 hangover text real
1,2,3,73,3,16,0,76,0,almost killed afghanistan. he painted president sent there.
1,1,10,29,2,10,1,39,0,"name character ""big hero 6"""
1,1,7,24,1,6,0,31,0,said it: disney insult edition
1,2,7,34,2,5,0,41,0,model fashion secret social-media weapon
1,1,10,40,0,9,0,50,0,someone remixed line holiday movie epic song
1,1,10,42,0,9,0,52,0,two cartoonist doodle page madness happens
1,1,7,23,0,7,2,30,0,16 time tumblr made think hard
1,1,7,25,1,8,4,32,0,26 thing cared 11 year
1,2,13,59,3,15,0,72,0,ridiculously easy recipe lost hour sleep recipe nyt cooking
1,1,8,21,0,7,0,29,0,guess movie bed
1,1,12,39,1,10,0,51,0,lived according dj khaled's incredible snapchat day
1,3,7,37,0,9,0,44,0,pope francis became leader global left
1,3,10,50,6,9,4,60,0,"smurfs-obsessed woman 7,000 smurf items: world largest collection [video]"
1,1,6,21,1,7,5,27,0,$500k student loan debt 37 second
1,1,14,47,0,13,0,61,0,high school boy wore dress school protest dress code
1,2,5,50,0,8,0,55,0,state celebrating confederate memorial day monday
1,1,7,32,0,7,2,39,0,15 perfectly reasonable way deal stress
1,2,13,37,2,14,2,50,0,ghosted 3 time last year. 6 thing learned.
1,1,10,29,0,10,2,39,0,16 adorable corgi sploots get rut
1,3,14,37,1,13,2,51,0,13 thing bulk-buy amazon make feel like adult
1,3,9,32,1,10,0,41,0,hard america kick sugar habit
1,1,11,44,1,10,2,55,0,25 delicious bite-size treat made wonton egg roll wrapper
1,1,9,39,0,9,2,48,0,18 confession married sex break heart
1,1,8,28,0,8,2,36,0,21 hot guy agree week totally sucked
1,1,17,66,1,16,0,83,0,toddler headbanging air drumming favourite band cutest thing see today
1,1,19,65,0,18,0,84,0,woman hid positive pregnancy test apple watch box surprise husband birthday
1,1,5,26,2,4,0,31,0,"""transparent"" character"
1,1,12,58,1,12,2,70,0,"39 heartfelt, relatable comforting quote lyric depression"
1,1,12,39,0,11,0,51,0,match letter word phonetic alphabet
1,2,17,45,4,16,0,62,0,two bleeding people left die one week. india need 'duty help' law?
1,1,10,29,0,9,0,39,0,real parent get kid sleep
1,2,5,27,1,6,2,32,0,world's 50 best restaurant
1,1,13,46,4,12,0,59,0,"elle wood ""legally blonde"" sandy olsson ""grease"""
1,1,9,37,0,9,2,46,0,24 book perfectly match new york fashion week look
1,1,8,30,1,8,2,38,0,44 insane president's day sale shop right
1,1,10,34,1,9,2,44,0,17 spot-on gift friend hate wearing pant
1,1,10,41,0,9,0,51,0,know favorite color based favorite celebrity
1,2,14,68,3,16,4,82,0,"bizarre! female cricketer score 160, teammate 0 lopsided batting scorecard you' ever see"
1,1,13,33,0,12,0,46,0,know type wine like drink day
1,1,10,35,0,9,0,45,0,tell u take medication mental health
1,1,10,39,1,10,2,49,0,17 brilliant artist follow creative slump
1,3,10,37,0,10,2,47,0,24 picture make feel better thefuture
1,1,5,18,0,4,0,23,0,sexiness score
1,1,8,31,2,8,2,39,0,"25 question ""one tree hill"" fan need answered"
1,1,11,29,0,10,0,40,0,call thing hold hair
1,1,7,32,0,6,0,39,0,people talk first therapy session
1,1,9,36,3,9,2,45,0,"25 tweet ""friends"" make laugh every time"
1,3,11,62,0,12,0,73,0,former google vice president start company promising clean safe nuclear energy
1,1,10,36,1,10,2,46,0,17 photo offer rare look north korea's interior
1,3,1,54,0,11,0,55,0,inspiring teen went right back work car accident
1,1,10,39,0,10,2,49,0,13 indian copywriter owe u explanation ad
1,1,5,18,0,4,0,23,0,path trans motherhood
1,2,5,33,0,9,0,38,0,trump say happy new year trump way
1,1,7,31,1,7,6,38,0,26 mom officially out-mommed 2015
1,3,9,42,2,8,0,51,0,desirable passport earth dont include america
1,1,10,41,0,10,2,51,0,27 slightly terrible thing happen whenever go ikea
1,1,9,36,0,9,2,45,0,19 reason eating lipstick absolute worst
1,3,2,34,1,5,0,36,0,dabbing sneezing congress photocall?
1,1,6,15,0,3,0,21,0,easy diy halloween nail
1,1,10,45,1,9,0,55,0,here's happens tater tot cheeseburger join force
1,1,10,37,0,10,2,47,0,15 bowl soup make feel better immediately
1,2,1,60,1,9,0,61,0,super talented dad transforms sons' drawing beautiful artwork
1,1,12,39,2,11,0,51,0,"many book mentioned ""gilmore girls"" read"
1,1,8,33,0,7,0,41,0,color test reveal primary emotion
1,1,8,27,0,8,2,35,0,10 thing look forward winter
1,2,9,42,2,11,3,51,0,three way protect 401(k) trump kill fiduciary rule
1,1,13,45,2,12,0,58,0,what's incredible response given ex texted
1,2,9,51,4,10,0,60,0,mccain: obamas lack leadership causing unraveling world order
1,1,10,36,0,9,0,46,0,sarah michelle gellar ready fight next battle
1,3,2,58,1,11,0,60,0,oscar screw-up could avoided one design change
1,1,6,38,1,6,2,44,0,18 moment absolutely everyone's experienced class
1,3,11,55,4,13,0,66,0,vin diesel dwayne johnson's 'the fate furious' feud: complete timeline
1,2,8,48,1,8,0,56,0,watch: police journalist attacked swedish school riot
1,3,4,50,2,10,3,54,0,"oldest living dodger fan, 108, always excited see jackie robinson"
1,1,11,49,2,11,1,60,0,"6 awkward holiday conversation dreading, deal"
1,2,15,63,1,14,0,78,0,warren buffett's dealmaking ketchup giant kraft heinz head abroad age donald trump
1,3,9,39,4,10,0,48,0,"whats ivanka trump art collection, worth?"
1,3,3,65,2,17,0,68,0,appalled what's going aleppo six way help list
1,3,9,32,0,11,10,41,0,21 trend 2007 really make comeback in2017
1,1,6,27,0,6,2,33,0,19 struggle growing eyebrow
1,3,4,56,1,11,0,60,0,zsa zsa gabor knew femininity performance. played perfectly
1,1,6,23,0,6,2,29,0,73 thought every woman tinder
1,1,12,39,2,11,0,51,0,"think mariah carey actually bride ""kill bill"""
1,1,10,37,0,10,1,47,0,9 woman share harsh reality living severe acne
1,2,2,66,2,13,0,68,0,know russia's interference presidential election
1,1,17,49,0,16,0,66,0,know old feel old actually based chinese zodiac
1,1,13,45,1,12,0,58,0,here's ultimate playlist get stage breakup
1,1,8,39,1,8,2,47,0,15 startling confession people who've wet dream
1,1,4,10,0,3,0,14,0,cathy
1,1,12,36,3,11,0,48,0,"""bridge spies"" going dad's favorite movie"
1,1,8,37,0,8,2,45,0,15 thing people talk understand
1,3,3,62,0,11,0,65,0,phillies surprise fan daughter ticket autism awareness game
1,1,10,50,0,9,0,60,0,one makeup question determine dominant character trait
1,2,10,29,2,9,0,39,0,"earth's sky violet, see blue"
1,1,9,32,1,8,2,41,0,17 practical item soothe type-a soul
1,1,10,48,1,9,0,58,0,here's actually happens eat horrifying vintage recipe
1,1,12,39,2,10,0,51,0,someone found giant dick-shaped icicle cool ball
1,3,8,50,3,13,1,58,0,chuck e. cheese go wall street: $1 billion ipo reportedly work
1,1,11,36,2,10,0,47,0,"slow cooker pork rice bowl quick, easy, filling"
1,1,5,31,0,6,6,36,0,17 dramatic celebrity eyebrow evolution 2015
1,1,12,40,0,12,4,52,0,cocaine ad 1970s prove past different world
1,1,11,22,3,8,0,33,0,"use n-word, told black-ish"
1,1,9,34,0,8,0,43,0,delicious foolproof way cook salmon
1,1,8,28,0,7,2,36,0,19 insane pizza mashups delicious af
1,1,6,26,0,6,2,32,0,18 pug forgot important thing
1,1,6,26,1,5,0,32,0,cheap vs. expensive tequila taste test
1,2,5,52,3,13,0,57,0,chris sale great addition red sox. there one problem.
1,1,9,31,2,10,10,40,0,36 song remember college 2007-2011
1,1,6,21,0,6,2,27,0,13 guy contour better
1,1,13,51,0,12,0,64,0,nick cannon kind predicted mariah carey would leave billionaire
1,3,0,35,0,8,5,35,0,5 digital marketing trend die 2017
1,1,10,37,0,10,2,47,0,26 penis fact people wish knew younger
1,1,11,39,2,10,0,50,0,cam newton's pant even worst thing picture
1,2,3,86,4,18,0,89,0,"divorced, married took gay lover? love actually: happened next, according fan fiction"
1,2,8,35,2,7,0,43,0,design melania trump inaugural ball gown?
1,1,8,36,1,8,2,44,0,32 tweet alcohol actually make laugh
1,1,9,35,0,9,2,44,0,17 actual worst avocado ever happened
1,1,7,22,0,5,0,29,0,ya heroine quote inspires
1,3,1,62,0,13,0,63,0,incredible story one doctor saved life million soldier
1,1,10,26,2,9,0,36,0,"cast new ""jungle book"" movie"
1,1,7,31,0,8,6,38,0,15 surprising baby announcement 2015
1,1,9,30,0,8,0,39,0,match adele song album
1,1,9,27,0,9,2,36,0,23 thing work best friend know true
1,1,9,40,2,9,2,49,0,"18 time internet perfectly summed playing ""mario kart"""
1,1,11,30,1,10,0,41,0,ci people say trans people vs. hear
1,2,18,43,1,13,0,61,0,watch: people ignore woman head stuck nyc subway door insider
1,1,8,29,1,8,2,37,0,16 muslim emojis know needed
1,3,5,27,0,5,1,32,0,5 sign high emotional intelligence
1,1,7,31,0,6,0,38,0,identify united state leader
1,2,13,49,4,11,0,62,0,"guillermo 'jimmy kimmel live!' return nba finals, lebron ignores"
1,1,16,37,1,12,0,53,0,know k-pop girl group belong based one question
1,3,13,44,1,12,0,57,0,economy getting better? answer depends votedfor
1,1,10,33,1,9,0,43,0,here's people nine country like get drunk
1,1,3,18,1,2,2,21,0,11 fat-shaming confession
1,1,11,51,2,11,2,62,0,"12 documentary definitely watch liked ""making murderer"""
1,3,8,36,0,8,2,44,0,30 time classroom extra educational
1,3,3,29,0,7,4,32,0,science news top five science book 2016
1,1,7,19,0,6,0,26,0,great lake
1,1,9,38,0,8,0,47,0,identify christmas movie cover
1,2,2,30,1,7,0,32,0,two age happiest list
1,1,8,30,0,7,0,38,0,would disney animal look like human
1,1,10,32,0,10,2,42,0,23 tweet way funny anyone boob
1,1,11,40,0,10,0,51,0,matt damon taking picture daughter every dad ever
1,1,9,34,0,8,0,43,0,shortcut hogwarts spotted montreal
1,3,1,50,2,10,0,51,0,two airline boss quit 'drunk' pilot caught camera
1,1,6,33,0,5,0,39,0,people try making pinterest christmas craft
1,1,11,35,0,10,4,46,0,identify 2015 music video youtube comment
1,2,5,65,1,13,0,70,0,donald trump tweeted st patrick's day colossally missed irony list
1,1,15,52,0,14,0,67,0,woman taking picture reese witherspoon background u
1,1,5,19,0,6,6,24,0,40 important corgi 2015
1,1,10,44,0,9,0,54,0,physicist shot underwater see would happen
1,2,1,58,1,8,0,59,0,footballer score world's sneakiest penalty truly stylish fashion
1,1,9,39,0,8,0,48,0,good knowledge classic football rivalry
1,1,9,28,1,7,0,37,0,pas gross-ass bodily fluid quiz
1,1,9,29,0,8,0,38,0,delete photo ex instagram
1,1,11,34,0,11,2,45,0,23 gift people love pizza love
1,3,5,17,3,2,0,22,0,hyphen-nation nytimes.com
1,2,7,21,0,4,0,28,0,milo resigns breitbart news
1,1,11,36,0,9,0,47,0,popular american tv show set philippine
1,1,8,25,2,7,0,33,0,"well remember ""the parent trap"""
1,1,8,24,0,6,2,32,0,21 truth drama bffs understand
1,1,10,31,0,10,2,41,0,38 way clean thing kitchen
1,1,10,15,0,6,0,25,0,feel like ptsd
1,1,8,30,0,8,4,38,0,naked rower back 2016 calendar
1,1,7,29,2,8,4,36,0,"23 time ""30 rock"" perfectly summed final week"
1,1,9,25,0,8,0,34,0,much pasta lover actually
1,1,7,30,0,7,2,37,0,19 insanely popular crock pot recipe
1,1,12,45,2,12,2,57,0,"19 time val ""dancing stars"" proved husband material"
1,1,5,30,0,5,2,35,0,53 insanely creative matching tattoo idea
1,1,10,34,0,10,4,44,0,people tried candy early 1900s loved
1,2,11,63,1,13,0,74,0,ar technica: white house fails make case russian hacking tampered election
1,3,15,49,4,13,2,64,0,"meet 10-yo sahana khatun, first female diagnosed 'tree man syndrome'"
1,1,12,34,2,8,2,46,0,"23 ""spongebob squarepants"" gifs perfectly sum life"
1,1,9,32,0,9,2,41,0,21 awesome way bring outdoors home
1,1,12,47,3,11,0,59,0,"wiz khalifa sang adele's ""hello"" create perfect stoner anthem"
1,3,3,40,3,11,5,43,0,apple replaces ipad air new 9.7-inch model $329
1,1,8,44,1,6,0,52,0,classic christmas movie reimagined low-budget knockoff
1,1,8,28,0,8,2,36,0,17 time richard ayoade hero needed
1,1,8,38,0,8,1,46,0,8 amazing people make appreciate refugee
1,1,7,21,0,6,0,28,0,pick best secret santa
1,1,10,30,2,9,0,40,0,~have~ invite person wedding
1,3,9,43,3,9,0,52,0,jinger duggar getting backlash wearing pants? [video]
1,2,2,28,0,6,2,30,0,10 least stressful job america
1,1,11,47,2,10,0,58,0,"anyone harbouring secret lust kristian bruun ""orphan black"""
1,2,0,39,1,9,1,39,0,5 thing wrong moment wake
1,2,2,34,1,7,0,36,0,apple help get people addicted news?
1,1,11,29,0,10,0,40,0,know hair color need rock fall
1,3,14,45,1,13,0,59,0,"great news, john mayer finally found manly heart emoji men use"
1,1,11,25,0,9,0,36,0,men wore makeup week looked glam af
1,1,5,23,2,4,0,28,0,"""hamilton"" character"
1,1,7,38,0,6,0,45,0,hannibal lecter quote motivational poster
1,1,13,53,2,12,0,66,0,"hilarious woman inserting ""the bachelor"" glorious"
1,3,5,42,2,10,0,47,0,could escaped killer heading now? cnn video
1,1,6,28,0,5,0,34,0,celebs play blind kissing challenge
1,1,5,18,0,4,0,23,0,netflix chill
1,3,3,76,3,14,0,79,0,brit spent month trying identify lost alzheimers patient. answer broke hearts.
1,1,8,21,0,8,2,29,0,19 tip make bed even cozy
1,1,10,34,0,9,0,44,0,skydiver got caught plane jumping
1,2,3,36,4,8,0,39,0,blind date: definitely think im witty guy
1,1,5,23,0,5,2,28,0,21 truth woman understand
1,3,7,34,0,9,3,41,0,country want everyone 100 gram gold
1,2,3,38,1,7,4,41,0,here's nostradamus predicted 2017 list
1,1,14,53,0,13,0,67,0,hand horrifying couple costume wear halloween
1,2,2,21,0,6,4,23,0,plan make america 1953
1,3,8,46,1,10,0,54,0,brand advance career ashford university
1,3,9,37,2,9,1,46,0,"hey, remember 6 democrat voted confirm ben carson?"
1,1,11,46,1,10,0,57,0,driving quiz determine actually los angeles
1,1,5,25,0,5,2,30,0,15 way actually express
1,1,6,26,0,5,0,32,0,slick rise vintage masculinity
1,1,9,30,2,9,1,39,0,"well remember season 1 ""the simpsons"""
1,3,5,42,3,11,2,47,0,sad story behind lyric east 17 stay another day
1,1,4,15,1,6,2,19,0,6 woman 1 spooky lip color
1,2,20,68,2,21,6,88,0,"began digging graf feed four daughters. 13 year 5,000 body later made peace dead"
1,1,10,49,1,9,2,59,0,29 ridiculously delicious chinese recipe better take-out
1,1,6,19,0,5,0,25,0,unicorn dragon
1,1,14,60,2,13,0,74,0,"rory williams pretty much graduated companion doctor ""legends tomorrow"""
1,2,12,49,4,10,0,61,0,"whitehouse.gov take climate page, put america first energy plan"
1,3,14,49,0,13,0,63,0,people going nut weird meme crazy local news interview
1,3,12,27,1,10,3,39,0,bmws c 650 gt scooter beat motorcycle day
1,1,11,38,0,10,0,49,0,george takei took internet troll perfect
1,1,7,17,0,6,0,24,0,good enough son
1,1,9,35,0,9,2,44,0,23 picture way real flight attendant
1,1,6,13,0,4,0,19,0,dessert iq
1,2,13,62,2,12,0,75,0,"visually impaired malayalam singer chooses career marriage, set new world record!"
1,3,13,47,3,9,0,60,0,oscar-winner casey afflecks next role: animatronic bear peta protest
1,3,11,31,4,10,0,42,0,"plan wedding, well give day, month, andyear"
1,1,9,24,2,8,0,33,0,"i'm antisocial, want alone"
1,1,17,29,0,10,0,46,0,jon hamm finally emmy tonight glorious
1,2,9,46,1,11,3,55,0,"gummy bear maker haribo build plant wisconsin, creating 400 job"
1,1,13,55,0,13,2,68,0,21 insanely cute simple dollar store halloween costume gift god
1,1,10,44,0,9,0,54,0,video hilariously make fun people stage instagrams
1,3,5,30,2,7,1,35,0,isi offered kill 4-year-old girl
1,3,5,37,1,5,0,42,0,study: millennials delaying entry adulthood
1,1,12,47,3,11,0,59,0,"here's first look kerry washington anita hill ""confirmation"""
1,3,1,53,0,9,0,54,0,political view help determine science book buy
1,1,4,15,0,3,0,19,0,futuristic
1,2,1,68,0,11,0,69,0,man surprise high school sweetheart proposal last chemo session
1,1,10,41,0,10,2,51,0,18 picture prove office grossest place earth
1,1,6,16,0,5,0,22,0,mature age
1,1,10,43,0,9,0,53,0,freestyle crossword everyone love pop culture
1,1,7,31,0,7,2,38,0,17 stunning men eyeliner better
1,1,8,43,1,7,0,51,0,people read people's heartbreaking coming letter
1,1,10,38,2,9,0,48,0,"mashup ""hotline bling"" wii music everything"
1,1,9,21,1,9,6,30,0,15 hit 1996 make feel old af
1,2,8,38,0,7,0,46,0,wealthiest woman celebrity go vacation
1,1,11,40,1,12,6,51,0,68 new year's resolution help twenty 2016
1,1,10,46,1,9,0,56,0,vanessa hudgens shared heartbreaking photo father's grave
1,3,1,33,2,7,2,34,0,10 best high-necked blouse picture
1,2,9,44,2,10,0,53,0,clemson tiger 'get back' coach put work offseason
1,1,10,43,1,9,0,53,0,definitive ranking dude deserve tina belcher's love
1,1,10,31,1,9,2,41,0,female '90s tv character total role model
1,1,7,28,2,8,6,35,0,"17 funniest tweet ""harry potter"" 2015"
1,2,2,33,0,5,0,35,0,migrant take public transport calais
1,1,11,42,1,10,0,53,0,solve puzzle ready intimate challenge
1,1,17,45,4,15,0,62,0,"j.j. abrams broke back trying save harrison ford set ""star wars"""
1,1,8,20,0,8,2,28,0,21 woman teach slay
1,3,1,56,0,9,1,57,0,7 incredible christmas family reunion guaranteed make smile
1,1,10,31,4,9,0,41,0,"cast ""friends"" ""game thrones"" house"
1,1,11,36,0,11,2,47,0,24 photo make wish went mermaid school
1,1,12,41,0,11,0,53,0,guy dressed aladdin rode magic carpet new york
1,3,5,86,4,20,0,91,0,money-making secret rich people swear (and they're simple follow know are)
1,1,8,41,1,8,2,49,0,22 life hack incredibly stupid they're borderline genius
1,1,9,33,3,8,0,42,0,"dear ""walking dead"": killed wrong person"
1,1,14,43,4,13,0,57,0,"student best ""hello"" cover ever encore ""ellen"""
1,3,6,26,1,7,0,32,0,clean person's guide messy desk
1,1,10,49,2,10,1,59,0,"9 fucking ugly tattoo transformed something new ""tattoo fixers"""
1,1,9,33,0,8,0,42,0,guess celebrity eyeliner
1,3,3,28,1,5,0,31,0,kenya's rising ballet star joel kioko
1,3,12,39,3,12,0,51,0,here dont know pan am golden era air travel
1,1,8,28,0,7,0,36,0,disney prince better rest
1,3,8,57,5,15,0,65,0,"ever choked food? revealed, diy guide saving life..."
1,1,17,50,1,15,0,67,0,vanity fair photo late-night tv host getting quite response people
1,1,8,32,0,8,2,40,0,22 important celebrity tweet time
1,1,10,46,2,8,2,56,0,people tweeting hilarious made-up muslim fact #1in5muslims
1,1,10,42,1,11,4,52,0,21 polly pocket set give every '90s kid intense nostalgia
1,3,7,40,0,8,0,47,0,four confirmation fight shaped supreme court
1,3,7,30,3,9,2,37,0,baby jessica 30 year later: life miracle
1,1,15,49,1,14,0,64,0,woman puppy lost eye other's kindred spirit
1,3,9,55,5,9,0,64,0,feinstein: trump splitting america apart blizzard executive order
1,1,2,13,0,2,1,15,0,6 little victory
1,3,13,37,0,12,0,50,0,lady six kid one funniest mom twitter
1,2,5,86,2,19,1,91,0,humans: everything know channel 4's new series far cast creepy persona synthetic ad
1,1,9,46,0,9,2,55,0,20 time urban dictionary straight ruined favorite animal
1,1,8,35,0,8,2,43,0,19 happy french bulldog guaranteed make smile
1,1,7,32,0,7,2,39,0,13 reason life would better halloweentown
1,1,12,28,1,11,0,40,0,guess dog's name single try
1,1,7,23,0,6,0,30,0,smith lyric real fake
1,3,1,57,5,15,8,58,0,"1,500 people, 2 elevator 500 ton luggage -- here's saudi king travel"
1,1,9,37,0,9,2,46,0,22 amazing apps revitalize love reading
1,3,9,42,1,8,0,51,0,couple's creepy selfie seriously freaking people
1,2,9,31,1,8,0,40,0,reason can't put smartphones
1,2,16,58,4,15,0,74,0,'dangal' girl fatima sanya's dancing video give glimpse crazy side!
1,1,19,47,2,16,0,66,0,taylor swift maid honor bff's wedding it'll give feel
1,3,9,30,3,8,0,39,0,here's helpful tool resist trump agenda
1,1,7,28,0,7,2,35,0,27 perfect gift anyone love whale
1,2,2,11,0,3,4,13,0,grammy winner 2017
1,1,8,29,0,7,0,37,0,hilarious name give dog
1,2,4,80,4,17,0,84,0,syria chemical attack: sarin gas likely weapon used idlib expert say russian claim 'don't add up'
1,3,10,54,0,9,0,64,0,hackathon hustler make living corporate coding contest
1,1,12,33,2,13,6,45,0,"guy made $4,000 suit scratch took 10 month"
1,1,10,38,2,9,0,48,0,here's body jerk awake falling asleep
1,1,10,45,1,9,2,55,0,13 idea budget-friendly beach weekend getaway new yorkers
1,1,12,48,0,12,2,60,0,15 delectable overnight oat totally worth getting bed
1,1,8,35,0,9,6,43,0,22 painfully awkward thing happened 2015
1,1,6,19,0,5,0,25,0,conform majority
1,3,3,68,1,16,0,71,0,it: pennywise scare frenzy trailer break record view single day
1,3,10,46,1,10,2,56,0,15 product thatll make actually look forward secondsemester
1,3,9,38,2,9,0,47,0,venice jeweler star also best-kept secret
1,3,7,28,0,8,6,35,0,51 rock album early 2000s teen listened
1,1,11,37,2,11,2,48,0,"30 thing need know ""baby daddy"" star chelsea kane"
1,1,10,40,0,9,0,50,0,woman discus whether men woman actually friend
1,1,10,36,0,10,2,46,0,15 word totally different meaning mom
1,1,8,28,0,8,2,36,0,21 dog make believe happiness
1,3,1,20,0,4,0,21,0,goat weird eye
1,3,7,18,0,8,5,25,0,3 way better investor 2017
1,1,7,31,0,7,2,38,0,21 cheap easy decorating trick renter
1,1,9,45,0,8,0,54,0,everyone freaking downright magical airbnbs
1,2,4,44,1,9,3,48,0,100 women: south korea stopped parent aborting girl
1,1,10,39,0,10,1,49,0,9 people want second chance talking crush
1,1,5,26,0,5,2,31,0,17 meatball identity crisis
1,1,8,33,1,7,0,41,0,blake lively's lifestyle brand going heaven
1,1,14,43,2,13,0,57,0,"need choose black white, neither hair"
1,2,9,51,3,12,0,60,0,waters: investigation find evidence impeach trump
1,1,9,44,0,9,2,53,0,18 easy decadent dessert people obsessed chocolate
1,2,10,34,4,8,0,44,0,imdb add special f rating system feminist film
1,1,6,32,0,6,2,38,0,21 thing former baby lesbian understand
1,1,8,34,2,8,2,42,0,23 word understand indiana
1,1,9,34,0,8,0,43,0,body language trick people liking
1,1,12,38,2,11,4,50,0,45-year-old blind man climbed machu picchu 13 hour
1,1,13,48,1,12,0,61,0,everything need know taco bell's new fried chicken taco shell
1,1,6,26,1,6,2,32,0,21 secret infertile woman tell
1,1,11,47,2,11,2,58,0,21 thing understand ever cheesecake factory
1,1,11,29,2,10,0,40,0,"need talk music ""a goofy movie"""
1,1,6,24,0,6,1,30,0,3 way make spaghetti squash pasta
1,1,11,49,1,10,0,60,0,snapchats morning person non-morning person would exchange
1,1,13,66,1,11,0,79,0,vogue's december cover feature bollywood diva across generation looking glorious af
1,1,10,42,1,8,0,52,0,kardashian-jenner sister fave new singing group
1,1,6,20,2,5,0,26,0,"look ""burping"" black hole"
1,1,7,25,1,7,1,32,0,6 type lesbian broken
1,1,12,33,0,11,0,45,0,ultimate reason living city best
1,1,11,39,0,10,0,50,0,internet decided jeremy corbyn massive lad
1,1,14,17,0,9,6,31,0,29 wtf moment 2015 mtv emas
1,2,5,13,0,4,0,18,0,lavar ball genius
1,1,13,43,2,12,0,56,0,"crazy story ""clue"" went forgotten flop cult triumph"
1,1,7,34,0,7,2,41,0,19 extravagant gift totally deserve year
1,1,7,22,3,5,0,29,0,tell u yourself(ie): dj qualls
1,1,3,10,1,2,0,13,0,tampon vs. pad
1,3,14,40,3,14,7,54,0,28-year-old retired $2 million net worth investing 2017
1,1,8,27,1,9,2,35,0,18 pic make miss best friend
1,1,6,31,0,6,2,37,0,16 perfect response indian patriarchy
1,1,9,35,0,8,0,44,0,otter relaxing enjoying snack
1,1,7,22,0,6,0,29,0,hand model explains take
1,1,6,24,0,6,2,30,0,27 picture gamers find funny
1,1,9,37,0,9,2,46,0,asked 12 scientist faith affect work
1,3,6,64,6,14,0,70,0,japanese ceo resigned employee death overwork. wont enough.
1,1,11,41,2,10,2,52,0,"13 plus-size woman loving themselves, matter hater say"
1,3,11,49,2,10,0,60,0,alec baldwin revive donald trump role snl following inauguration
1,3,12,60,6,15,0,72,0,krauthammer: syria strike sends message sheriff town america back
1,1,7,34,0,7,1,41,0,7 delicious dinner great weeknight
1,2,11,63,3,13,0,74,0,"student denounced racist wearing red, white blue clothing basketball game"
1,2,4,50,3,13,2,54,0,'47 meter down' mandy moore shark movie know wanted
1,1,8,25,1,7,0,33,0,newest thing
1,1,7,27,0,6,0,34,0,woman cut vagina trimming
1,3,4,60,1,15,0,64,0,"donald trump went twitter rant bizarre, even list"
1,1,10,35,0,10,2,45,0,27 tweet anxiety make laugh cry
1,1,7,23,4,6,0,30,0,"here's ""joy"" went very, wrong"
1,1,10,31,2,10,2,41,0,"27 reason need make kid watch ""friends"""
1,3,14,41,6,11,0,55,0,"watch: whoopi, behar attack 'new guy' trump 'puppet' spicer insider"
1,2,12,43,1,8,0,55,0,sapvoice: facebook uber reveal secret digital disruption
1,1,4,13,1,3,0,17,0,what's teen name
1,1,6,36,0,6,2,42,0,17 celebrity couple costume ruled halloween
1,3,10,61,1,11,0,71,0,meadows: freedom caucus intrigued healthcare offer hill meeting penny
1,1,9,28,1,10,6,37,0,19 moment 2015 make proud indian
1,1,17,52,0,14,0,69,0,story david bowie blasting mtv playing black artist going viral
1,1,9,37,1,8,0,46,0,i'm armless archer paralympic silver medalist
1,1,13,44,0,12,0,57,0,kate mara jamie bell probably dating adorable
1,1,14,49,0,13,0,63,0,bride literally put spell new husband first dance
1,2,9,26,2,9,0,35,0,miss president wont go away?
1,1,10,43,0,9,0,53,0,little trick save tights total destruction
1,1,6,18,0,5,0,24,0,kind ambivert
1,2,4,60,0,12,0,64,0,natanyahu issue stern warning iran exclusive interview fox news
1,2,11,27,6,12,4,38,0,-- least -- educated state u.s. 2017
1,2,12,42,2,12,0,54,0,financial spring cleaning: keep toss tax day
1,3,1,37,0,10,0,38,0,dude wake really mean skunk tent
1,2,7,42,4,8,0,49,0,brzezinski: trump admin trying create dictatorship?
1,1,9,36,0,9,2,45,0,17 reason port authority literally hell earth
1,1,8,32,1,8,3,40,0,watch 100 year women's lingerie three minute
1,1,9,38,0,9,2,47,0,45 thing wish someone told antidepressant
1,2,4,52,0,9,0,56,0,google home spread bizarre conspiracy theory barack obama
1,1,8,21,2,7,0,29,0,"""the voice"" team would"
1,1,9,33,3,8,0,42,0,"here's ""goosebumps"" would look like musical"
1,1,15,44,4,12,0,59,0,"fka twig cover sia's ""elastic heart"" perfect thing ever"
1,3,15,61,3,14,0,76,0,video anushka sharmas conversation journalist mother make go awww!
1,1,8,33,1,8,2,41,0,31 fall wedding idea want try immediately
1,1,11,32,1,8,0,43,0,hilary clinton's response gop debate
1,1,7,28,1,6,0,35,0,hardest science quiz take today
1,3,14,35,0,11,0,49,0,fake vpns trying cash online privacy fear
1,1,8,24,0,7,0,32,0,taylor swift kanye west
1,2,5,50,2,9,0,55,0,u.s. soccer start answering tough question hope solo
1,1,8,26,0,8,2,34,0,25 fan genius player
1,1,10,40,0,9,0,50,0,badass couple raised bar engagement photo
1,3,2,52,0,9,0,54,0,mediterranean diet could help fight depression
1,1,4,15,0,5,6,19,0,37 punniest tweet 2015
1,1,7,32,0,7,2,39,0,27 epic adventure worth taking twenty
1,1,11,37,1,11,2,48,0,34 photo prove we're actually living video game
1,2,26,0,2,6,4,26,0,future retail 2016 [slide deck]
1,2,1,68,1,12,0,69,0,"despite negative stigma, payday loan much different credit card"
1,2,5,38,2,8,3,43,0,rolls-royce ghost come $100k worth goody
1,2,9,40,1,10,0,49,0,sam club bet drone fly shelf christmas
1,3,12,40,1,12,1,52,0,"8 way get spouse open more, according therapist"
1,2,1,27,0,6,0,28,0,marrying man saved life
1,3,17,54,4,16,0,71,0,winner world whisky award bet tried half
1,1,4,14,0,3,0,18,0,go camping
1,3,9,36,1,8,2,45,0,18 real-life optical illusion leave youshook
1,1,10,45,0,11,6,55,0,71 highly anticipated movie 2016 sundance film festival
1,1,9,38,0,7,0,47,0,ellen degeneres celebrity scare favorite
1,1,12,40,2,12,1,52,0,"5 reason ""the last witch hunter"" vin diesel movie ever"
1,2,13,48,1,12,0,61,0,"parent abandon kid railway station, policeman give new life"
1,3,6,48,0,8,0,54,0,u president obama surprise spokesman white house briefing
1,1,13,44,2,12,0,57,0,aziz ansari's new show first trailer pretty damn great
1,1,9,31,3,10,2,40,0,"19 time leslie knope shut sexism ""parks rec"""
1,1,12,36,0,9,0,48,0,tinder added sti testing locator website
1,1,13,31,0,10,0,44,0,name element periodic table
1,1,7,28,1,6,0,35,0,what's profound quote death
1,1,16,44,0,15,0,60,0,guy made fake fact go viral prove believe everything read
1,2,5,48,1,9,0,53,0,earl hay press: hollywood get fake money newspaper
1,3,1,45,0,9,2,46,0,parent successful kid 12 thing common
1,1,7,29,0,6,0,36,0,new pentatonix original song
1,3,6,42,0,8,0,48,0,lebron james issue warning shot outspoken lavar ball
1,1,10,36,1,10,2,46,0,27 sex question afraid ask anyone google
1,1,8,27,0,8,2,35,0,21 gift people really love pug
1,3,11,35,3,10,0,46,0,"maxine waters: impeach trump, cant build wall"
1,1,9,26,0,8,0,35,0,soulmate jedi knight sith lord
1,1,8,31,0,8,1,39,0,5 men talk struggle body image
1,1,5,25,0,4,0,30,0,cake match personality
1,1,16,26,0,11,3,42,0,woman 110 year old today enough
1,2,3,83,4,14,0,86,0,trump new national security adviser may undo early change white house's foreign-policy team
1,1,16,55,3,15,0,71,0,"try control yourself, ""sexiest doctor alive"" giving away date charity"
1,2,10,46,1,9,0,56,0,strategic investment always good strategy startup
1,2,15,43,2,15,6,58,0,bar kerala made 250m-long maze wall beat supreme court's 500m rule
1,2,2,58,3,10,0,60,0,gay marriage opponent suddenly state rights. wonder why.
1,1,12,48,0,11,0,60,0,celebrity kiss mistletoe based zodiac
1,1,8,41,0,8,2,49,0,21 thing goddamn disappointing every fucking time
1,1,9,29,0,8,0,38,0,match cat celebrity owner
1,3,13,45,3,11,0,58,0,fact-checked seven season shark tank deals. results.
1,3,3,44,4,7,0,47,0,eastenders: every christmas knees-up punch-up ranked
1,2,3,42,2,7,0,45,0,letter africa: nigeria's art flowery language
1,2,3,54,0,11,0,57,0,harvard law school making major change admission policy
1,1,8,30,2,8,3,38,0,here's 100 year american men women's beauty
1,1,12,47,2,12,2,59,0,21 thing understand tallest friend group
1,1,5,25,2,5,4,30,0,celeb *actually* halloween 2015
1,1,16,48,1,14,0,64,0,guess buzzfeed employee's screen name looking photo
1,1,9,33,0,9,2,42,0,17 gift people whose best friend pomeranian
1,2,2,35,5,9,0,37,0,trump: 'i'm worried he's gonna give kiss'
1,1,10,28,0,11,6,38,0,17 best bar buenos aire must visit 2016
1,1,6,23,0,5,0,29,0,pie match zodiac sign
1,2,10,43,0,10,2,53,0,21 people trolled gordon ramsay shitty foodtweets
1,3,4,16,1,2,0,20,0,tax-smart bond swapping
1,1,7,29,0,7,2,36,0,17 incredible lesbian pinays need know
1,1,7,29,0,6,0,36,0,know celebrity fantasize
1,1,13,12,0,6,0,25,0,suffer fomo jomo
1,1,12,41,4,11,0,53,0,"well remember ""filthy animal"" scene ""home alone"""
1,1,7,26,2,6,2,33,0,17 thing plus-size woman can't possibly
1,2,6,37,1,6,2,43,0,19 fucking infuriating thing women's clothing
1,3,5,47,1,8,0,52,0,facebook messenger debut thirsty new year's eve filter
1,3,4,59,1,10,0,63,0,sweden official twitter account debunks donald trump claim line line
1,1,7,19,0,7,2,26,0,21 time tumblr drug
1,1,5,19,2,4,0,24,0,"long journey ""freeheld"""
1,3,2,47,1,7,0,49,0,skeletal rickshaw commemorates india's deadly riot
1,1,4,18,0,3,0,22,0,liam hemsworth went vegan
1,1,8,33,1,8,1,41,0,7 easy organizing idea actually want try
1,1,9,40,0,8,0,49,0,vogue china photoshopped gigi hadid people pissed
1,3,5,59,0,9,0,64,0,johnny manziel offer donald trump advice deleting twitter account
1,2,3,45,1,8,2,48,0,donald trump's 10 weirdest ever facial expression list
1,1,9,30,0,8,0,39,0,make quiz without dying
1,1,11,42,2,10,0,53,0,"really remember halloween episode ""boy meet world"""
1,1,8,35,0,8,2,43,0,17 time kourtney kardashian shut family
1,1,5,23,0,4,0,28,0,black people learn kwanzaa
1,1,11,36,0,12,6,47,0,17 outfit sonam kapoor wore 2015 could pull
1,1,6,23,1,5,0,29,0,smartphone
1,1,13,52,3,13,1,65,0,"justin bieber dy like really, really pretty death ""zoolander 2"" trailer"
1,3,12,45,0,11,0,57,0,donald trump think endure controversy pain
1,3,3,46,2,11,0,49,0,"may forgive dylann roof, want dead"
1,1,11,54,1,10,0,65,0,serena williams named sport illustrated's sportsperson year
1,1,13,60,0,12,0,73,0,recovering anorexic share bikini pic promote body positivity
1,1,8,36,0,7,0,44,0,google calendar trick get organized
1,2,9,33,1,11,2,42,0,40 celebrity pixie cut good want go
1,3,4,54,1,8,0,58,0,donald trump hillary clinton's final campaign spending revealed
1,1,10,43,1,9,0,53,0,crossword everyone who's obsessed taylor swift
1,1,10,33,2,9,0,43,0,"get ready another crazy season ""house cards"""
1,1,11,34,0,10,0,45,0,ed sheeran song based zodiac sign
1,2,7,35,1,9,2,42,0,show money: 13 athlete deserve raise
1,1,12,39,0,12,2,51,0,21 hilarious tweet way real hate stuff
1,1,9,36,1,9,2,45,0,17 thing picky eater want hear thanksgiving
1,3,8,43,0,8,0,51,0,ivanka trump push white house agenda human trafficking
1,1,11,43,0,10,0,54,0,know favorite food based favorite chrissy teigen
1,3,10,28,4,8,0,38,0,govt launch 'anti-troll' app woman soon!
1,1,6,37,0,6,2,43,0,21 beautiful unexpected bridesmaid dress color
1,1,5,30,0,5,2,35,0,19 incredibly rare endangered baby animal
1,1,11,37,0,11,2,48,0,23 dad joke guaranteed make shake head smile
1,2,1,34,2,6,0,35,0,nigeria 'gay wedding' bust lead charge
1,1,7,27,0,6,0,34,0,male oscar winner soulmate
1,1,7,22,0,6,0,29,0,would hook ghost
1,1,7,28,0,8,6,35,0,21 animal following 2015
1,1,11,35,2,11,2,46,0,"27 type drunk definitely been, told sims"
1,1,8,33,0,8,2,41,0,17 underrated national park america
1,1,11,30,2,10,6,41,0,12 remarkable picture nyc's fifth ave 1911 vs. today
1,1,13,57,3,12,0,70,0,"grab earphone listen gorgeous instrumental cover adele's ""hello"""
1,1,8,36,0,8,2,44,0,15 christmas emojis could definitely use right
1,1,7,25,0,8,6,32,0,24 picture prove 2015 damn future
1,1,7,27,0,7,2,34,0,21 photo perfectly sum grad school
1,2,6,29,1,5,1,35,0,report: trump deporting 4k somali migrant
1,1,9,29,1,6,0,38,0,pigskin blanket: nfl divisional round pick
1,1,8,39,1,9,4,47,0,20 commercial jingle '90s kid still remember every lyric
1,3,13,62,4,13,0,75,0,zayn malik speaks revealing billboard cover story: 'i'm censoring anymore'
1,2,7,27,0,7,2,34,0,tear gas attack hamburg metro affect 50
1,1,11,33,0,10,0,44,0,ruby rose tried dance like drake perfect
1,1,9,51,0,8,0,60,0,twentysomethings solved problem like video game character
1,1,12,40,0,12,2,52,0,11 roald dahl quote inject little magic day
1,1,10,41,0,10,2,51,0,13 terrible photo people took eclipse phone
1,3,15,44,2,14,0,59,0,matter penny dinner woman wife
1,1,8,29,0,8,2,37,0,19 painful photo every short guy relate
1,1,11,46,0,10,0,57,0,facebook user going nut fake jennifer aniston story
1,3,1,36,0,6,0,37,0,seven bit advice aspiring comedian
1,1,11,32,2,10,0,43,0,"bond girl age gap ""james bond"" reversed"
1,1,11,47,2,11,1,58,0,"6 music video ""would rather"" question impossible answer"
1,1,10,34,3,9,0,44,0,"hardest ""true false"" space quiz take today"
1,2,9,40,1,10,6,49,0,2017 ncaa tournament bracket: latest projection field 68
1,1,5,15,0,6,6,20,0,16 best poetry book 2015
1,1,5,14,0,4,0,19,0,kill cockroach
1,3,1,29,2,6,0,30,0,tailor ticking time bomb
1,1,14,46,3,13,0,60,0,"remember iconic shabooya scene ""bring on: nothing"""
1,3,13,47,0,12,0,60,0,debate toughest cartoon cat tearing people apart
1,1,7,28,0,6,0,35,0,cat musical returning broadway
1,1,8,28,1,7,0,36,0,said it: cory matthew riley matthew
1,3,1,43,0,9,0,44,0,pizza come plastic table center
1,1,14,48,2,13,0,62,0,"jimmy fallon getting ride universal based ""tonight show"""
1,1,12,38,0,11,0,50,0,know zodiac sign based tissue box choose
1,3,14,57,0,14,2,71,0,23 extremely thirsty tweet chris pratt get graphic scroll
1,3,2,43,0,8,0,45,0,modern witch gathering online stop trump
1,1,10,34,3,9,0,44,0,"what's worst thing michael scott ""the office"""
1,1,13,61,0,12,0,74,0,photoshoots canadian black student group give serious squad goal
1,1,11,34,0,11,2,45,0,20 time emma watson shut sexism best damn way
1,1,11,32,0,10,0,43,0,using huge ipad pro actually like
1,1,15,49,4,14,0,64,0,"sarah jessica parker talk carrie, ""hocus pocus,"" love new york"
1,1,13,49,3,12,0,62,0,"game throne drawn ""bob's burgers"" character crossover need"
1,3,18,62,1,16,0,80,0,internet going crazy harry potter-themed christmas tree tote see
1,3,8,41,3,8,0,49,0,"obama, aleppo, vladimir putin: friday evening briefing"
1,3,11,44,0,11,0,55,0,one group using soap making help fight human trafficking
1,3,0,69,1,16,1,69,0,"5 tip decorate home like rich person, bank account anything"
1,1,5,26,0,5,2,31,0,10 comic server understand
1,1,11,38,0,11,2,49,0,14 time olly neil milan cutest couple twitter
1,1,9,29,0,9,2,38,0,23 disney fact make feel hella old
1,1,6,19,0,5,0,25,0,yuppie hipster
1,2,7,30,0,7,0,37,0,circle give fruit fly direction
1,3,6,32,3,8,4,38,0,7 thing wildly successful people 7:30 a.m.
1,1,13,41,1,10,1,54,0,5sos performance beautiful thing ever hear
1,1,8,25,1,7,0,33,0,one zayn malik's tattoo
1,1,14,42,2,10,0,56,0,thierry henry say we're thinking sport's lgbt issue
1,1,12,40,1,11,0,52,0,"wait, fuck going water pouring illusion"
1,1,7,37,0,7,2,44,0,17 reason people regret open relationship
1,1,5,27,0,5,2,32,0,19 people confess college regret
1,2,9,60,1,16,6,69,0,big winner 2017 grammyawards find winner 84 category here.
1,3,6,18,0,5,0,24,0,get ready bond meltdown
1,1,9,36,0,9,2,45,0,24 adorable product every cat lover need home
1,1,7,34,1,6,2,41,0,19 non-princess disney costume idea halloween
1,1,14,58,1,13,0,72,0,went sylvester stallone memorabilia preview asked smell rocky's glove
1,1,12,46,0,12,4,58,0,kim kardashian instagrammed might 2000s photo time
1,3,4,34,1,7,0,38,0,cia think anti-virus program
1,1,13,42,0,12,0,55,0,people going nut trying find hidden panda photo
1,1,9,32,0,10,6,41,0,32 greatest thing happened tumblr 2015
1,1,16,40,1,15,2,56,0,guy want charge $11k tiny view pope window
1,1,13,35,1,12,6,48,0,26 movie we're excited see 2015 bfi london film festival
1,1,9,31,0,8,0,40,0,guess celebrity first tweet
1,1,9,23,1,8,0,32,0,tried wedgie jean
1,3,9,35,2,11,0,44,0,espn picks: expert like unc gonzaga win all?
1,1,8,29,0,8,2,37,0,21 sign need taken immediately
1,1,11,32,2,8,0,43,0,"first trailer ""the bfg"" positively magical"
1,3,1,43,1,8,0,44,0,exercise scientist reveals get six-pack ab
1,3,7,44,0,9,0,51,0,option gamma trump trade peril volatility fund
1,1,10,35,0,9,0,45,0,question pretty little liar
1,3,8,56,2,12,0,64,0,"jeff bagwell, tim raines ivan rodriguez elected baseball's hall fame"
1,1,8,35,0,8,1,43,0,9 christmas movie cuffing season
1,1,7,25,0,7,2,32,0,23 time north carolina damn chill
1,3,3,11,0,3,0,14,0,year inmoney
1,1,8,34,0,8,2,42,0,18 time saw something hilarious internet
1,1,11,40,0,11,2,51,0,25 place canada basically look like bob ross painting
1,3,9,33,0,9,1,42,0,6 easy trick make way productive
1,1,7,30,0,7,2,37,0,14 text perpetually cold people sent
1,1,10,43,0,9,0,53,0,watch hedgehog get massage instantly become tickled
1,1,11,30,0,10,0,41,0,guess taste men based makeup
1,3,11,35,0,11,2,46,0,22 thing make feel like adult infebruary
1,1,10,28,0,9,0,38,0,many zac efron film seen
1,3,5,24,0,4,0,29,0,trade pact face growing pushback
1,1,9,37,0,9,2,46,0,18 dreamy gift anyone obsessed traveling
1,1,4,11,0,3,0,15,0,pickle
1,1,7,33,1,7,2,40,0,55 new year's resolution actually doable
1,1,8,32,0,8,2,40,0,16 incredibly rude text boob would send
1,3,8,50,4,8,0,58,0,krauthammer: obama torched democrat entire minor league system
1,3,2,67,1,16,0,69,0,melania trump popular husband quote show
1,3,4,42,3,6,0,46,0,viewpoint: 'delicious spectacle' president trump
1,1,10,36,1,10,2,46,0,21 time michael ian black's tweet made laugh loud
1,3,14,60,1,13,1,74,0,rbi official caught exchanging note illegally 5 interesting read today
1,2,2,38,1,9,0,40,0,spot problem photo? list
1,1,11,42,0,10,0,53,0,celebrity ramen instagram never knew needed
1,1,11,38,0,11,2,49,0,19 phil dunphy dad joke guaranteed make laugh
1,2,6,19,3,5,0,25,0,"youre busy, youre rude"
1,1,6,23,3,5,0,29,0,tell u yourself(ie): tia mowry
1,1,15,46,0,14,0,61,0,duke disabled dwarf bull us wheelchair walk need new home
1,3,6,28,0,7,0,34,0,mysterious flash faraway galaxy
1,3,2,44,0,9,1,46,0,5 whatsapp hack need master immediately list
1,2,4,36,1,7,0,40,0,cub dominate mlb's list popular jersey
1,3,6,79,6,14,0,85,0,people wheelchair couldnt see yayoi kusamas infinity mirrors. museum found innovative fix.
1,2,11,25,0,9,4,36,0,2017 mlb rookie hyped early
1,1,9,29,0,8,2,38,0,14 adorable animal giving kind ok advice
1,1,14,48,1,14,2,62,0,16 meme need show parent they're pressuring get married
1,1,10,30,0,10,2,40,0,21 reason woman never ever pit bull
1,1,10,36,1,10,1,46,0,7 bizarre fact know week history
1,1,17,58,3,16,0,75,0,"child taught nyle ""america's next top model"" hottest man ever"
1,1,10,32,0,10,2,42,0,13 tumblr post marauder need true
1,1,12,47,0,11,0,59,0,emma watson given brutally honest interview child stardom
1,1,11,39,3,11,2,50,0,"25 reason need sookie st. james ""gilmore girls"" revival"
1,3,6,33,0,7,0,39,0,best nontoxic beauty gift kid tweens
1,3,8,43,5,8,0,51,0,"rand: rice committed crime, something thats devastating"
1,1,11,53,0,10,0,64,0,kanye west threw kim kardashian pregnancy themed surprise birthday party
1,2,7,50,1,9,0,57,0,secret disney world performer revealed longtime goofy's ama
1,3,7,36,2,7,2,43,0,iran sanction 15 u.s. company supporting israel
1,1,14,47,1,13,0,61,0,dad halted daughter's wedding stepdad could help give away
1,3,9,30,3,10,3,39,0,tested $1 vs. $55 lipstick whathappened
1,1,14,47,0,13,0,61,0,tyra bank announced birth first child adorable way
1,3,17,64,4,16,4,81,0,amy jackson's sizzling dance ziva dhoni's guest appearance: a-z indian premier league 2017
1,1,12,47,1,12,2,59,0,19 hilarious tweet sit kids' table thanksgiving
1,2,6,48,0,6,0,54,0,sarah silverman mistake construction marking swastika
1,1,10,24,0,9,0,34,0,kind animal past life
1,1,7,24,2,6,0,31,0,"""no name"" product actually"
1,1,6,21,0,5,0,27,0,forgotten game app
1,1,6,41,4,9,2,47,0,1 indian 1 indian unrelatable: television's race equation
1,1,11,43,0,11,2,54,0,20 absurdly chic dog mastered art winter dressing
1,1,7,23,0,7,2,30,0,19 game day recipe make sunday
1,3,1,49,1,9,0,50,0,would wash hand leftover old cocktails?
1,1,8,35,0,8,2,43,0,17 fall breakfast satisfy sweet tooth
1,1,9,39,1,8,2,48,0,23 super stylish product every elephant-lover need
1,2,6,28,3,8,4,34,0,2016 best year animation ever? [video]
1,1,6,21,2,5,0,27,0,"history ""frisco"" headline"
1,1,9,39,0,9,2,48,0,40 life hack disney movie borderline genius
1,2,10,39,0,10,2,49,0,20 gift people live internet appreciate
1,2,6,57,0,11,0,63,0,prince george steal show royal family leaf christmas day service
1,1,7,33,1,7,2,40,0,28 gooey brownie change life forever
1,3,6,38,6,7,0,44,0,"sander ryancare: absolute disaster, disgrace"
1,1,11,40,0,10,0,51,0,avenger looked like originally comic
1,1,10,37,0,9,0,47,0,gigi hadid silencing body shamers give life
1,3,4,74,1,15,0,78,0,jake gyllenhaal make clear want talk taylor swift awkward interview
1,2,5,40,1,12,4,45,0,8 best new feature apple added iphone io 10.3
1,1,7,19,0,6,0,26,0,know left key
1,1,14,64,1,14,2,78,0,19 time kendall jenner cara delevingne's friendship perfect actually painful
1,3,7,46,2,11,2,53,0,toast christmas past: 27 nba's best christmas day moment
1,3,5,52,3,10,0,57,0,lonzo ball say 'i'm better than' fellow draft prospect markelle fultz
1,1,8,29,0,8,2,37,0,21 sign took high school way seriously
1,1,9,32,0,8,0,41,0,guess san francisco burrito
1,2,9,54,2,11,5,63,0,"least 13,000 hanged mass execution syrian prison: amnesty international"
1,1,3,12,0,2,0,15,0,tennis racket
1,1,9,35,3,8,0,44,0,"dancer justin bieber's ""sorry"" video"
1,2,16,40,0,13,3,56,0,boy best reaction adopted 832 day foster care
1,3,1,52,0,7,0,53,0,scientist find link cat ownership schizophrenia
1,1,8,31,0,7,0,39,0,zodiac sign compatible
1,1,9,28,0,7,0,37,0,buzzfeed new york halloween
1,3,18,55,3,17,0,73,0,'the rock' reduced roomful people tear reunited military family show!
1,3,8,75,3,16,0,83,0,trump's america dodd-frank act: donald trump plan banking regulation matter
1,1,9,28,0,9,2,37,0,18 way mom tortured called love
1,1,13,45,0,12,0,58,0,yeah taco bell drive sign look like giant penis
1,1,9,45,2,8,0,54,0,"charlotte rampling call oscar boycott ""racist white people"""
1,1,9,36,0,8,0,45,0,thing happen thanksgiving love food
1,1,9,33,0,8,0,42,0,halloween look like around world
1,1,12,46,5,11,0,58,0,"sleep seeing ""today"" show cast ""peanuts"" character"
1,1,7,22,0,6,0,29,0,show u tiny subtle tattoo
1,2,3,47,2,11,0,50,0,participate women's strike can't skip work
1,3,1,57,0,10,0,58,0,tennessee cowboy lasso runaway calf police car viral video
1,1,8,36,0,7,0,44,0,color test determine guilty pleasure
1,2,16,55,2,14,0,71,0,nostalgic! tv's iconic bahus parvati tulsi pose epic selfie ekta kapoor
1,3,2,42,0,11,0,44,0,tom hank reply fan mail help woman win bet
1,1,8,37,0,9,6,45,0,34 important instagrams britney spear 2015
1,1,11,39,3,10,0,50,0,"derek shepherd mark sloan ""grey's anatomy"""
1,2,6,15,0,6,4,21,0,world look in2035
1,1,10,30,3,7,0,40,0,"shaggy return ultimate dis track, ""gfy"""
1,3,12,66,2,13,0,78,0,gwyneth paltrow sends birthday wish ex-husband chris martin boyfriend brad falchuk
1,3,11,43,1,10,0,54,0,here's trump could try stop company offshoring job
1,1,6,32,0,6,2,38,0,26 pregnant woman totally slayed halloween
1,1,12,45,1,11,0,57,0,taylor swift reference one direction's new album
1,2,14,37,2,13,0,51,0,build startup day? tried here's happened
1,1,11,36,3,10,0,47,0,"here's cast ""high school musical"" look like"
1,1,7,45,0,7,2,52,0,31 thing every person western massachusetts understands
1,1,16,39,4,10,0,55,0,"""himym"" couple halloween costume s.o. wear"
1,1,10,39,1,8,0,49,0,paris hilton's instagram account right hilarious af
1,1,10,39,0,10,2,49,0,21 picture make sense people sibling
1,3,1,66,3,17,0,67,0,"sorry, refunds: men think get money back bad date?"
1,1,14,43,3,13,0,57,0,"new ""star wars: force awakens"" trailer give chill"
1,2,3,45,2,8,6,48,0,qualcomm announces 802.11ax wi-fi solution 4x capacity
1,1,6,25,2,6,2,31,0,"18 thing really, really"
1,1,9,42,0,9,2,51,0,11 underrated grammy nominee add playlist
1,2,2,59,4,11,0,61,0,smell death everywhere: inside world dangerous mine
1,3,1,42,0,8,0,43,0,lie right debase civilised society
1,1,12,36,0,10,0,48,0,reminder demi lovato look fierce af right
1,1,13,46,0,13,2,59,0,20 embarrassing thing happened people gym
1,1,14,42,1,10,0,56,0,"omfg, backstreet boy spice girl might touring together"
1,1,14,37,0,12,0,51,0,feel like favorite tv show ending
1,1,6,30,0,5,0,36,0,thought everyone public bathroom
1,3,11,34,2,10,0,45,0,"every line helen mirren say ""the fate furious"""
1,1,9,32,3,8,0,41,0,"remember essay ""the breakfast club?"""
1,1,7,24,0,8,6,31,0,40 powerful obama moment 2015
1,1,8,31,0,9,6,39,0,17 best thing matt bellassai whined 2015
1,2,9,28,0,8,0,37,0,akzo nobel running reason snub ppg
1,1,6,29,0,5,0,35,0,disney princess fall activity
1,1,13,54,0,13,1,67,0,9 slightly disturbing fact stop cleaning ear ever
1,1,9,26,0,9,2,35,0,16 exit song walkout last final
1,1,15,54,3,13,0,69,0,"dc comic called pakistan's language ""pakistanian"" twitter field day"
1,1,8,25,1,7,0,33,0,pair damn daniel's shoe
1,1,9,34,2,11,4,43,0,17 product every bath body work addict owned '90s
1,1,11,33,1,10,0,44,0,gave sugar two month here's happened
1,1,8,23,0,7,0,31,0,people love
1,3,11,22,0,8,0,33,0,ira mistake fix tax day
1,1,11,29,2,11,2,40,0,"13 adam hill rant ""the last leg"" nailed"
1,3,10,45,0,9,0,55,0,terrifying way sleeping enough actually change gut
1,1,12,49,0,12,2,61,0,15 confession people literally think sex best workout
1,1,8,23,0,8,1,31,0,8 fandom ship war end
1,2,3,56,4,13,3,59,0,"week apps: instagram hit 700 million, apple's new music deal,"
1,1,18,62,1,17,0,80,0,meet alia bhatt superfan who's going hilarious length reply twitter
1,2,10,35,0,10,2,45,0,19 people got worst secret santa gift inhistory
1,1,7,30,0,5,0,37,0,lea delaria revisits career highlight
1,1,11,44,0,11,2,55,0,23 hilarious tumblr post show strange canada truly
1,1,9,36,0,9,2,45,0,27 people prove humanity evolutionary dead end
1,1,12,43,3,11,0,55,0,"""star wars: force awakens"" actor best friend"
1,1,11,25,0,9,2,36,0,27 time bbc news failed hard failed
1,1,8,41,1,8,2,49,0,15 delicious cocktail actually horrible
1,1,6,26,3,5,0,32,0,tell u yourself(ie): eric balfour
1,1,11,39,0,10,0,50,0,guess pixar character based image eye
1,1,8,25,0,7,0,33,0,need talk pussycat doll
1,1,4,29,1,4,4,33,0,celebrity halloween costumes: 2015 edition
1,2,7,20,2,7,2,27,0,21 theory jack isus
1,1,4,36,0,4,2,40,0,32 unbelievable confession masturbation
1,3,9,28,1,8,0,37,0,turbotax want what? share tax data
1,3,1,18,3,3,0,19,0,come retail sales...
1,1,7,19,0,6,2,26,0,23 time marilyn manson af
1,1,7,28,1,6,0,35,0,easiest patronus quiz ever take
1,1,10,34,0,10,2,44,0,24 time ryan reynolds proved king twitter
1,1,10,40,0,10,2,50,0,15 holiday treat basically reason season
1,3,2,49,0,12,0,51,0,look mundane job would suck pokemon world
1,1,7,27,0,8,6,34,0,22 hipster thing happened 2015
1,2,4,19,0,5,6,23,0,2016 nfl week 14 playoff scenario
1,1,13,41,1,12,0,54,0,"guy shot entire wedding iphone, look stunning"
1,1,8,32,2,7,0,40,0,"remember famous ""love actually"" scene"
1,2,18,57,3,16,0,75,0,"odisha cm naveen patnaik's aircraft got stuck runway police push it, really!"
1,3,4,44,3,10,4,48,0,"thor, atlas, zelda: popular new baby name 2017 revealed"
1,1,9,42,3,10,3,51,0,"42 thing thought ""american horror story: hotel"" episode 7"
1,2,3,41,2,10,0,44,0,sa power: load shedding happening?
1,1,10,42,2,9,0,52,0,"rise, fall, improbable comeback morris brown college"
1,1,17,62,1,16,0,79,0,here's need know new harry potter theme park universal studio hollywood
1,1,12,33,2,13,6,45,0,"21 time ""why always lying"" meme best meme 2015"
1,3,7,25,0,7,1,32,0,9 thing climate change
1,1,13,47,3,12,0,60,0,"""star wars: force awakens"" character based zodiac"
1,1,10,32,1,9,0,42,0,here's half century love really look like
1,1,8,20,2,7,0,28,0,said it: taylor swift dr. phil
1,3,2,40,3,7,0,42,0,trump's executive order: travel ban affect?
1,1,10,21,2,5,0,31,0,omg winnie-the-pooh actually girl
1,1,9,37,0,9,1,46,0,6 thing make slow cooker immediately
1,1,10,32,0,10,2,42,0,12 karaoke song perfect partner
1,2,3,43,2,9,1,46,0,game throne reveals season 7 summer release date
1,1,10,31,0,10,2,41,0,15 chart anyone taken shower relate
1,1,6,21,0,5,0,27,0,addicted facebook
1,1,10,40,2,9,0,50,0,style game buzzfeed's health beauty newsletter
1,1,6,33,1,6,1,39,0,adorable animal advent calendar: december 2
1,3,13,44,6,12,0,57,0,michael moore: u.s. sh*ts people country
1,1,6,17,0,5,0,23,0,brain coffee
1,3,8,40,0,8,0,48,0,rogue east cleveland cop framed dozen drug suspect
1,1,11,40,0,11,2,51,0,22 tumblr post make former emo kid cry laughter
1,1,8,36,0,9,6,44,0,13 dog look like 2016 presidential candidate
1,1,11,54,1,10,0,65,0,kylie jenner's bodyguard apparently pushed jessica alba sent flower
1,1,8,22,3,7,0,30,0,would rather?: hot guy vs.
1,3,2,68,2,15,0,70,0,man wore suit meet new nephew first impression matter list
1,1,11,35,1,10,0,46,0,tried sex ghost here's happened
1,3,3,48,1,8,0,51,0,latest: capitol architect say pig painting break rule
1,3,9,39,0,9,2,48,0,36 incredibly petty thing sibling done
1,3,2,44,2,8,0,46,0,africa's naming traditions: nine way name child
1,2,14,40,8,13,0,54,0,sean spicer abc jon karl: calm press briefing
1,1,9,34,2,7,0,43,0,here's dj khaled's inspirational advice jeb bush
1,1,10,46,2,9,2,56,0,25 super last-minute halloween costume blow people's mind
1,1,5,19,0,4,0,24,0,survived suicide attempt
1,3,1,38,0,9,2,39,0,12 city tree around world
1,1,7,34,0,7,2,41,0,15 situation every dog owner understand
1,1,7,28,0,6,0,35,0,porn star teach couple secret sex move
1,2,9,24,0,8,0,33,0,fun workout people hate gym
1,3,13,37,1,13,2,50,0,17 tumblr post youll get never good atmath
1,1,10,37,1,10,2,47,0,15 vine proving harry style chill he's onstage
1,3,2,23,2,4,0,25,0,trump know he president?
1,1,7,28,0,9,2,35,0,23 cheap easy hack best bath ever
1,1,6,22,1,7,6,28,0,14 trend we're hoping happen 2016
1,1,12,39,0,11,0,51,0,identify pop artist anagram name
1,2,7,50,2,7,0,57,0,two significant arrest westminster terror investigation
1,1,19,56,1,16,0,75,0,hell going harry style gigi hadid's awkward interaction amas
1,1,8,41,0,8,2,49,0,11 thing twentysomethings know job
1,1,10,43,0,11,6,53,0,20 vintage photo capture black college student life 1940s
1,1,6,23,0,5,0,29,0,therapist wrote breakup text
1,1,5,27,0,4,0,32,0,grandma play card humanity
1,1,12,42,1,11,0,54,0,guy's insane beatboxing skill seen believed
1,1,7,27,2,7,2,34,0,"33 time ""spongebob"" fan killed tumblr"
1,1,7,40,0,7,2,47,0,22 type hangover beautifully illustrated boglins
1,1,10,26,0,9,0,36,0,talk creepy hug emoji
1,3,7,37,1,6,0,44,0,"beheaded, castrated man found outside walmart store"
1,1,9,52,0,9,2,61,0,19 painfully honest confession people experience panic attack
1,1,8,28,0,7,0,36,0,chill would freaky situation
1,1,12,29,3,9,0,41,0,"npr's podcast ""the hidden brain"""
1,1,6,25,0,8,6,31,0,28 hilarious people gave fuck 2015
1,1,7,22,0,7,2,29,0,39 picture anyone sad
1,3,2,83,1,19,0,85,0,healthy student finances! humble serving bean toast tackle pain gout
1,1,7,35,0,7,2,42,0,15 absolutely brutal text social anxiety
1,1,6,26,0,6,2,32,0,18 slogan perfectly sum twitter
1,3,24,55,2,16,0,79,0,fake news day one: spicer scold press time reporter false martin luther king bust story
1,1,9,42,2,8,0,51,0,"see well know ""arrested development"" character"
1,2,1,48,2,11,0,49,0,there dark side losing weight one talk
1,1,7,22,0,7,2,29,0,24 woman plus size mean
1,3,2,62,3,14,1,64,0,7 news story week thought april fool's actually
1,2,8,35,0,8,0,43,0,le pen maintains first round lead latest polling
1,2,2,56,0,11,4,58,0,brutally honest ad 2002 oldsmobile brings internet infinite joy
1,3,0,26,0,6,1,26,0,5 weird way mind trick
1,2,11,53,4,12,0,64,0,rand paul: there lot obamacare lite house obamacare replacement bill
1,2,5,27,0,5,0,32,0,amazon begin accepting food stamp
1,2,10,48,0,10,2,58,0,11 iconic george michael recording absolutely must listento
1,2,10,44,0,10,0,54,0,dollar regains reflation mojo hedge fund bet get flushed
1,1,7,25,0,7,2,32,0,10 boozy drink people love candy
1,1,8,33,2,7,0,41,0,"corrupted gem ""steven universe"""
1,1,10,35,2,9,0,45,0,"""glee"" character based zodiac sign"
1,2,17,72,3,15,0,89,0,"huffpost what's working honor roll: case teaching student emotional skills, academic one"
1,3,13,52,0,12,0,65,0,arizona gubernatorial candidate want know sexlife
1,1,6,25,0,5,0,31,0,rihanna album actually
1,1,10,35,2,10,1,45,0,"9 ""game thrones"" fan theory make show better"
1,1,5,19,0,4,0,24,0,proof human body weird
1,1,9,31,0,8,0,40,0,type disney movie character would
1,2,11,22,0,8,2,33,0,33 new beauty product need try asap
1,1,11,30,0,10,0,41,0,pick heart get positive message
1,1,13,53,1,12,0,66,0,behind scene footage ted cruz's campaign brilliantly awkward
1,2,2,32,0,6,0,34,0,fashion courting muslim pound
1,1,9,21,1,8,1,30,0,8 struggle new yorker l.a
1,2,4,56,0,10,0,60,0,kim kardashian chrissy teigen officially launched book club
1,3,3,9,0,2,0,12,0,big border tax
1,1,9,34,1,8,0,43,0,bet can't solve basic geometry problem
1,1,9,20,1,8,2,29,0,19 time ok hit panic button
1,2,18,63,9,17,0,81,0,"'this america' 'f*** wall' underwear, ny fashion week made bold political statement"
1,2,21,45,2,16,0,66,0,"visa debit, credit card hacked seconds, find research uk"
1,1,6,21,0,5,0,27,0,thought exam
1,1,9,36,1,7,0,45,0,learned friendship pro-anorexia site
1,1,10,49,0,10,1,59,0,9 way kim kardashian pregnancy totally differently time
1,1,8,26,0,8,2,34,0,17 llama think better
1,3,6,57,0,13,0,63,0,chrissy teigen chrissy teigen response super bowl nip slip
1,1,10,40,1,9,0,50,0,stop worship matt bomer picture
1,1,12,36,0,12,1,48,0,9 demon dog want haunt dream eat soul
1,1,10,37,2,9,0,47,0,"remember name ""full house"" character"
1,2,2,56,0,9,0,58,0,state american incorrectly declared dead every year
1,1,9,29,0,9,2,38,0,18 tip bring colouring next level
1,1,6,26,0,5,0,32,0,female disney character
1,1,11,47,0,11,2,58,0,21 endearingly dorky old facebook post justin trudeau
1,3,3,43,2,10,2,46,0,wizard $35m coach show worth investment
1,3,2,41,0,9,0,43,0,airbnb offer free housing hit trump ban
1,1,10,37,2,9,0,47,0,"kid reenact first black friday ""jimmy kimmel live"""
1,2,10,46,1,11,3,56,0,zimbabwean pay 35 quadrillion local dollar $1 currency dy
1,2,1,31,2,7,0,32,0,reason hope (almost) every team
1,3,2,44,2,9,0,46,0,afghan civilian casualties: hit new high?
1,2,3,59,1,12,0,62,0,cyclone debbie: meet storm chaser get thrill severe weather
1,3,1,58,2,12,0,59,0,"bangkok city guide: plus best hotels, restaurant bar"
1,1,11,34,1,10,2,45,0,26 thing french people find kind strange u.s
1,1,11,43,0,11,1,54,0,bride spent 8 month creating dream wedding dress hand
1,3,7,37,0,8,0,44,0,germany tap migrant phone tackle asylum fraud
1,2,1,56,1,10,0,57,0,heal thyself: meet doctor living condition treat
1,1,5,16,0,4,0,21,0,pikachu meowth
1,1,9,31,0,9,2,40,0,24 tweet make every nurse laugh loud
1,1,12,41,1,11,0,53,0,here's everyone wore glamour woman year award
1,1,9,35,3,8,0,44,0,"doctor ""grey's anatomy"" would save life"
1,1,13,45,2,12,0,58,0,"got drunk listened adele's new album, thing got emotional"
1,2,9,46,1,9,0,55,0,report: former jeb bush staffer considered top education post
1,3,6,61,0,11,0,67,0,emotional advice kid kept jimmy fallon stitch interview
1,1,9,30,0,8,0,39,0,actually happy halloween
1,1,13,59,1,12,0,72,0,thousand sharing inspirational story amputee who's national athlete
1,1,8,28,0,8,2,36,0,17 secret hair stylist want know
1,1,8,23,0,7,0,31,0,niall horan ed sheeran
1,1,10,27,0,9,0,37,0,day life trans cabaret performer
1,1,3,10,1,3,4,13,0,what's 2015 name
1,3,2,70,1,13,0,72,0,fed conducted series test determine credibility new aviation threat yahoo
1,1,10,47,0,10,2,57,0,18 perfect couple halloween costume idea girlfriend
1,1,12,42,0,11,0,54,0,need talk absolute perfection tim riggins
1,2,0,44,0,11,2,44,0,10 simple strategy help pay kind debt
1,1,10,35,0,9,0,45,0,vancouver cutest yoga class ever exist
1,1,14,45,2,13,0,59,0,"kelly ripa thanking watching ""live"" bring tear"
1,1,11,44,0,10,0,55,0,honey boo boo dropped cringeworthy music video ever
1,2,8,47,1,8,0,55,0,president trump delivers first address congress: celebs react
1,1,9,36,0,9,2,45,0,30 hella easy way seriously transform old jean
1,2,15,58,0,15,1,73,0,8 iconic bollywood movie prove vinod khanna charming actor time
1,1,8,37,0,8,2,45,0,19 beautiful gift people obsessed frida kahlo
1,3,3,53,0,12,0,56,0,data firm helped trump win probed brexit
1,2,1,36,1,8,0,37,0,winning freelance life: happy
1,1,7,33,1,6,0,40,0,amanda seyfried's dog actually regina george
1,2,1,49,0,14,0,50,0,snow chance next week need keep eye
1,1,13,57,1,11,0,70,0,beautiful comic pay tribute two-spirit indigenous people lost violence
1,1,10,42,1,9,0,52,0,people hand makeup actually mesmerizing
1,1,11,45,0,11,2,56,0,19 hilarious thing muslim internet blessed u
1,3,11,41,0,11,1,52,0,9 people pose nude show body diversity really lookslike
1,1,10,44,0,9,0,54,0,selena gomez shuts body shamers criticizing weight
1,2,1,47,1,8,0,48,0,russian man undergo world's first full head transplant
1,1,5,24,1,5,2,29,0,13 thing probably wrong
1,1,15,62,1,13,0,77,0,bride treated mcdonald's groom went paintballing wedding
1,1,14,65,0,13,0,79,0,woman posting heartbreaking story mental health instagram fight stigma
1,1,10,31,0,9,0,41,0,london pigeon actually day
1,1,7,43,1,7,2,50,0,video perfectly parody '50s propaganda lesbian
1,2,1,41,2,9,0,42,0,beauty: hair regime doesnt hard work
1,1,12,46,1,10,0,58,0,woman given self-love beauty routine changed everything
1,1,10,42,3,9,0,52,0,"proof ""futurama"" funniest, cleverest show history"
1,1,12,36,1,11,0,48,0,"year visiting dad prison, friend"
1,1,8,45,0,8,2,53,0,18 stunning christmas cooky guaranteed impress family
1,1,15,58,0,15,2,73,0,optimistic man tried sneak 14 bottle liquor saudi arabia underwear
1,1,13,34,0,12,0,47,0,tried cook eat monstrosity emu egg
1,1,5,19,0,5,2,24,0,23 sign cannot trusted
1,2,6,40,1,6,0,46,0,washington officer shot identified; remains critical
1,1,9,24,0,9,2,33,0,11 shibas would please like go
1,3,4,66,5,10,0,70,0,allegedly happens inside scientology's notorious 'prison camp' called 'the hole'
1,1,9,19,0,7,2,28,0,24 gorgeous diys go gold
1,1,10,16,0,7,2,26,0,29 way manage adhd work
1,1,9,39,0,9,2,48,0,23 holiday cocktail guaranteed get merry bright
1,1,11,33,0,11,2,44,0,many 15 weird boob habit actually
1,2,6,56,2,13,4,62,0,popular tinder? dating app reveals right-swiped name 2016
1,1,15,35,0,14,0,50,0,guy lost road rage incident gigantic meme
1,1,12,39,1,11,0,51,0,desi girl early twenty vs. late twenty
1,1,10,46,0,10,2,56,0,13 insanely delicious reason light firework diwali
1,1,11,37,0,11,2,48,0,26 delicious thing make tube biscuit dough
1,1,6,18,1,5,0,24,0,what's ex right
1,1,8,36,0,7,0,44,0,favorite thanksgiving food say
1,1,5,21,0,4,0,26,0,slytherin hybrid
1,1,7,28,0,6,0,35,0,year celebrity headline
1,2,2,44,0,7,0,46,0,facebook track internet outage around world
1,1,10,38,2,9,0,48,0,"iconic ""clueless"" outfit based zodiac"
1,1,12,32,1,11,0,44,0,tell bukowski poem actually porno
1,1,9,38,0,9,2,47,0,10 ridiculously hot doctor guaranteed give fever
1,3,2,53,2,10,0,55,0,inside logo: wolves' new look represents franchise ready win
1,1,9,39,0,9,2,48,0,23 tweet prove never cross cara delevingne
1,1,8,34,2,8,2,42,0,"16 time tumblr hilarious ""the hunger games"""
1,1,9,37,0,9,2,46,0,29 gorgeous way make winter decor look expensive
1,1,7,28,0,7,2,35,0,21 tiny thing really annoy tidy people
1,3,2,40,1,9,2,42,0,premier league: 10 thing look weekend
1,1,8,23,0,9,6,31,0,16 model gonna blow mind 2016
1,1,10,41,0,9,0,51,0,watch flower girl absolutely school dad wedding
1,1,9,30,1,8,0,39,0,"ladies, question still ask mom"
1,1,12,27,0,11,0,39,0,part corgi need know
1,1,10,49,1,10,2,59,0,13 reason twinkle khanna akshay kumar bollywood's cutest couple
1,1,8,29,2,7,0,37,0,"minor ""parks recs"" character"
1,1,13,27,2,9,0,40,0,"""anti"" song based zodiac sign"
1,1,8,28,0,8,4,36,0,cutest dog 2016 westminster dog show
1,2,10,50,1,9,0,60,0,internet going wild college student crazy wraparound haircut
1,1,12,34,2,10,0,46,0,u.s. president would look like man bun
1,2,1,50,1,13,0,51,0,man learns try take selfie sea lion
1,1,13,54,0,12,0,67,0,totally awesome clothing line target come straight plus size
1,1,7,31,0,7,2,38,0,11 reason actually matt bellassai
1,3,1,37,0,9,0,38,0,memorable person room
1,3,17,56,1,17,1,73,0,someone literally paid public toilet madurai r 5 cheque even funny
1,1,7,24,0,7,2,31,0,21 video egg actually porn
1,2,1,64,4,12,0,65,0,"'students mark other's test improve grades', say top school head"
1,1,10,39,2,9,0,49,0,"well remember first episode ""supernatural"""
1,1,11,52,2,10,0,63,0,"watch actor hilariously impersonate cher ""clueless"""
1,1,7,24,1,7,4,31,0,hardest 2015 quiz take year
1,1,5,15,0,5,2,20,0,22 time cat made sense
1,3,3,71,1,11,0,74,0,fort lauderdale shooting: australian man reveals survived deadly airport attack
1,3,4,14,1,4,0,18,0,fat cell forever?
1,1,9,38,2,9,2,47,0,"23 insanely adorable jamie scott quote ""one tree hill"""
1,1,13,51,2,13,2,64,0,"14 thing never noticed opening number ""beauty beast"""
1,3,8,43,2,8,0,51,0,james franco spiraled depression trump victory
1,1,8,21,0,7,0,29,0,pill grey red blue
1,1,6,36,0,5,0,42,0,fortune cooky existed thirtysomethings
1,1,6,26,0,6,2,32,0,14 problem overly nice people
1,2,1,64,2,13,0,65,0,'we making science' say man doctor reveals plan head transplant
1,1,8,26,0,9,6,34,0,28 time yahoo answer lost damn mind 2015
1,1,8,39,0,8,2,47,0,11 everyday problem solved power perspective
1,2,4,82,2,20,1,86,0,utah law shaking $4 billion contact lens industry price drop business insider
1,1,9,36,1,8,0,45,0,what's best place buy affordable jewelry online
1,1,10,39,0,9,0,49,0,definitely sign daily dog newsletter
1,2,9,38,3,10,0,47,0,patient saved. thats family suing.
1,1,14,48,3,12,0,62,0,"someone youtube made ""hotline bling"" version obama amazing"
1,2,8,21,1,7,0,29,0,name dog breeds?
1,3,0,50,0,11,2,50,0,13 essential item never thought donate need
1,1,11,44,0,11,2,55,0,17 strikingly beautiful irish baby name take
1,1,11,32,0,11,2,43,0,16 people took love hockey little far
1,3,6,85,3,15,0,91,0,never get flat stomach eating surprising food (including healthy broccoli watermelon)
1,1,10,35,0,9,0,45,0,dog heroically escape vet take vet
1,3,14,46,2,9,0,60,0,two kerala youth arrested goa distributing anti-isis pamphlets!
1,1,4,22,0,3,0,26,0,grandparent give love advice
1,3,9,57,1,9,0,66,0,illinois legislature decides making obamas birthday state holiday
1,1,13,48,2,12,0,61,0,harry styles' hand jimmy kimmel's butt new favorite celeb couple
1,1,13,41,1,11,0,54,0,new movie tragic love story no-labels generation
1,2,3,61,3,14,0,64,0,"madonna's carpool karaoke and, well, need see"
1,1,6,14,0,5,0,20,0,type thot
1,1,13,48,1,12,0,61,0,"meet blindy, inspirational blind penguin looking new home"
1,2,16,46,0,11,0,62,0,naacp leader rachel dolezal allegedly faked black woman year
1,3,10,35,1,9,0,45,0,taxpayer willing avoid paying taxes?
1,3,1,42,3,6,0,43,0,opera-loving sister 'stumbled' heroism
1,3,7,36,3,7,0,43,0,brooks: trump admin high level incompetence
1,1,4,11,0,3,0,15,0,speed read
1,1,6,23,0,6,2,29,0,16 text fetus wish could send
1,1,7,28,2,6,0,35,0,chicago vs. new york: ultimate showdown
1,1,10,36,0,9,0,46,0,magic harry potter would benefit
1,3,15,54,3,14,0,69,0,"mariah carey's ""all want christmas you"" top modern holiday classic list"
1,1,11,40,1,10,0,51,0,guess get married based random question
1,1,8,27,0,7,0,35,0,darth vader luke skywalker
1,1,12,45,2,12,2,57,0,"24 reason best bit ""friends"" actually monica chandler"
1,1,8,23,0,7,0,31,0,well know viral vine
1,1,9,37,1,9,2,46,0,12 stunning american hotel want live forever
1,1,9,33,0,9,2,42,0,22 super annoying thing every woman deal
1,1,11,39,1,9,0,50,0,solve crossword remember pre-iphone era
1,1,13,47,1,12,0,60,0,know bailee madison movie star based three question
1,1,14,34,3,12,2,48,0,"14 time ""the fresh prince bel-air"" realest show tv"
1,1,15,37,0,14,4,52,0,know happen 2016 based favorite tv show
1,1,15,47,2,14,0,62,0,"sansa stark finally catch break next season ""game thrones"""
1,1,13,43,0,12,0,56,0,tina fey gave perfect answer question woman comedy
1,1,11,36,0,11,3,47,0,watch 100 year brazilian beauty little minute
1,3,1,41,1,8,0,42,0,could young blood revive memory aging brain?
1,2,8,28,2,7,0,36,0,here know trump mexico wall
1,2,15,43,3,11,1,58,0,ibmvoice: 3 sign time evolve start-up thinking support growth
1,1,17,62,2,15,0,79,0,rugby fan's super-excited reaction meeting shane williams make grin like fool
1,1,7,34,0,7,2,41,0,19 ridiculous lie literally everyone told kid
1,3,8,70,4,16,0,78,0,el chapo: secure mexican drug lord joaquin guzman's new home u maximum-security jail?
1,3,8,33,1,7,0,41,0,ten sign interviewing bad employer
1,1,11,38,3,10,0,49,0,"identify car ""grand theft auto: vice city"""
1,1,5,21,0,4,0,26,0,actually sapiosexual
1,2,4,45,1,10,0,49,0,south africa: manenberg school top class
1,2,4,17,0,4,2,21,0,30 holiday gift guide
1,3,13,52,5,11,0,65,0,"karnataka cm confuses china's 'sichuan' india's siachen, almost start war"
1,1,10,39,2,8,0,49,0,t.j. miller reacting super bowl commercial hilarious
1,1,9,30,0,8,0,39,0,movie much better second time
1,3,3,52,1,11,0,55,0,"heard warplanes, never thought hospital target"
1,1,9,35,0,9,3,44,0,159 disney quote need instagram caption
1,1,10,39,0,9,0,49,0,watch trainer get ass kicked aerial yoga
1,1,12,57,3,10,1,69,0,watch favourite comedian perform toughest audience yet: 8-year-olds
1,1,14,51,0,13,0,65,0,jamie dornan golfing desktop background rest life
1,1,10,42,2,10,2,52,0,"30 thing might know ""galavant"" star luke youngblood"
1,1,9,34,1,9,2,43,0,20 tweet outfit make laugh loud
1,1,12,37,0,11,0,49,0,tom hank reveals movie meant
1,3,4,67,1,11,0,71,0,u band slightly stoopid produce world's first smokeable vinyl record using hashish
1,1,8,27,0,7,0,35,0,cookie monster cookie lyon
1,3,12,34,4,9,2,46,0,19 thing youll get youre high- low-maintenance
1,1,13,46,3,11,0,59,0,"queen tyra bank reprising role upcoming ""life-size"" sequel"
1,1,10,36,3,9,0,46,0,"""star wars: force awakens"" hunk soulmate"
1,1,9,37,3,8,0,46,0,"game throne character drawn ""bob's burgers"" style"
1,1,9,24,0,9,2,33,0,23 scone shake tea time
1,1,8,34,0,8,2,42,0,23 tumblr post hilariously sum boob
1,1,7,22,0,6,0,29,0,need talk pumpkin spice
1,1,9,19,0,9,2,28,0,21 thing new york fall
1,1,8,33,0,9,3,41,0,18 iconic kim kardashian tweet 4 word
1,2,8,39,0,7,0,47,0,nyt call transgender education emergency room
1,1,12,38,0,11,0,50,0,channing tatum emo guy golden globe award
1,1,7,31,2,6,0,38,0,christmas vs. jewish christmas: win
1,1,9,31,1,9,2,40,0,guess '90s toy deserve christmas
1,1,9,37,1,8,2,46,0,17 tweet every left-handed person totally relate
1,1,11,39,0,10,0,50,0,percent blair waldorf based zodiac sign
1,1,8,45,1,7,0,53,0,men evidently rediscovered headband horrifying
1,3,13,48,0,12,0,61,0,terrible thing happened one holiest week year
1,1,13,39,3,11,0,52,0,"cast ""maze runner"" imitated dylan o'brien red carpet"
1,3,18,56,2,14,0,74,0,former nfl running back warns slave labor doj signal return private prison
1,1,8,33,1,9,6,41,0,22 reason still ready hoverboards 2015
1,1,12,29,3,11,0,41,0,"well know word eminem's ""my name is"""
1,3,2,56,2,11,0,58,0,"ghost becomes zombie: dating phenomenon, one screenshot"
1,1,9,37,0,9,2,46,0,17 insanely brilliant way hide alcohol outfit
1,2,9,35,1,9,3,44,0,100 genius hack guaranteed make parent jobeasier
1,2,2,24,1,4,0,26,0,taking america's worst fear
1,2,8,48,1,9,0,56,0,"trump ordered syria attack, ate dinner chinese president"
1,1,9,47,4,6,0,56,0,"lupita nyong'o discusses #oscarssowhite, inclusivity, progress"
1,1,11,36,0,11,2,47,0,21 tweet prove brain real dick sometimes
1,3,3,48,2,11,2,51,0,"time 50-ton whale drove along street portland, maine"
1,3,11,68,3,12,0,79,0,trump: intelligence briefing show absolutely effect cyber attack election result
1,2,11,41,6,10,0,52,0,"rogue one: star war story, sing dominate christmas box office"
1,1,9,34,1,9,2,43,0,23 people even get fucking acronym right
1,1,9,27,0,8,0,36,0,former model told u stay healthy
1,1,10,35,0,9,0,45,0,match taylor swift song album
1,1,7,29,1,7,2,36,0,see james bond's style evolution 60 year
1,1,4,19,0,3,0,23,0,santa taste test reindeer
1,1,12,41,0,11,0,53,0,drake performed bat mitzvah made tweens happy
1,1,7,30,2,7,2,37,0,"24 reason start watching ""vicious"" right"
1,1,10,44,1,9,0,54,0,here's bunch woman honestly discussing sexting habit
1,1,12,40,3,11,0,52,0,"kid covered gaga's ""paparazzi"" look like"
1,1,6,6,0,3,0,12,0,esp
1,1,7,27,0,6,0,34,0,make friend according science
1,1,11,35,0,11,2,46,0,47 important cher tweet last five year
1,1,6,29,0,6,2,35,0,literally 22 really funny tumblr post
1,1,4,21,0,4,2,25,0,14 honest instagrams fall
1,2,12,37,2,11,0,49,0,firefly reboot could happen one person board
1,2,1,51,2,8,0,52,0,"corset training, celebrity weight loss trend, largely busted"
1,1,11,42,0,10,0,53,0,taste emojis reveal truth personality
1,1,12,52,2,11,0,64,0,"""hunger games"" interpretation change way see mockingjay"
1,1,8,35,0,7,0,43,0,need discus global treasure alicia vikander
1,2,10,60,1,10,0,70,0,"rachel maddow air headline linking venezuelan protest trump, retracts online"
1,2,15,51,4,13,0,66,0,"annoyed flight delay, man tweet 'hijack' pm modi, get deplaned arrested"
1,3,8,31,2,8,2,39,0,17 joke youll understand youre wellread
1,1,8,20,0,7,0,28,0,black woman walk gun show
1,1,8,35,0,8,2,43,0,11 insanely sexy move literally every man love
1,3,11,39,1,11,2,50,0,14 moment pure bliss youll recognize livealone
1,1,8,32,0,8,2,40,0,23 adorable penguin product need life
1,1,11,32,0,10,0,43,0,pan dulce delicious thing need try
1,1,11,32,0,11,2,43,0,13 time lady gaga needed move fuck outta way
1,1,10,36,0,9,0,46,0,bald eagle attacked donald trump photo shoot
1,3,8,37,3,6,0,45,0,salesforcevoice: death (traditional) salesman
1,1,7,24,0,7,2,31,0,24 badass moment history
1,3,1,25,1,7,5,26,0,50p coin could worth 100
1,2,2,27,1,5,0,29,0,syrian ceasefire deal: know
1,2,12,58,1,13,1,70,0,modi sarkar announces lottery scheme digital payment 5 story today
1,1,16,53,0,15,0,69,0,know iphone android based favorite fast food restaurant
1,1,4,13,0,3,0,17,0,name disney cat
1,1,13,36,2,12,0,49,0,"donald trump want muslim ""watch list"" made one"
1,2,7,26,2,6,0,33,0,olsen twin stylish senior? decide.
1,1,10,28,3,10,2,38,0,"44 place possible sex ""the sims"""
1,1,10,30,0,9,0,40,0,might sexist real estate ad ever
1,1,7,11,0,3,0,18,0,relative
1,3,10,49,3,10,0,59,0,dem sen gillibrand: ultimately gorsuch confirmed senate
1,3,7,29,2,7,0,36,0,everything need know 'iron fist'
1,2,10,41,0,10,1,51,0,7 fact blurt awkward silence thisweekend
1,2,1,37,1,7,0,38,0,civil right activist lying race?
1,1,11,47,0,11,2,58,0,17 chilling confession people stalked ex
1,1,8,31,0,7,0,39,0,name say personality
1,3,3,71,3,14,3,74,0,"uk parliament terror attack: 4 people killed, including cop alleged assailant; 20 injured"
1,2,1,66,0,14,2,67,0,take biggest step toward building wealth 10 minute computer
1,3,0,47,0,9,1,47,0,5 crafty way keep thief stealing package
1,1,8,31,0,8,2,39,0,21 important kitten picture need see
1,1,8,14,0,5,0,22,0,member exo
1,1,16,60,0,15,0,76,0,get picture zac efron wearing tiny short without gasping air
1,1,9,38,1,9,2,47,0,15 award anyone definitely what's going around
1,2,15,48,1,15,2,63,0,14 photo thatll make laugh sense humor stuck middleschool
1,1,7,48,1,7,2,55,0,20 heartbreaking confession people asperger's syndrome
1,1,7,25,2,6,0,32,0,"""league legends"" yordle"
1,1,8,21,0,7,0,29,0,mouthgasm taco bell
1,1,9,34,0,8,0,43,0,kris jenner declared scott disick true love
1,2,10,34,2,7,0,44,0,alec baldwin denies snl impression helped trump win
1,2,9,14,4,6,0,23,0,make us: 'syd' espn video
1,1,12,42,1,11,0,54,0,here's happens order large pizza
1,2,8,32,1,8,0,40,0,happening trump cabinet week
1,3,10,32,1,10,1,42,0,cash $1 billion gift card aftermarket
1,3,11,40,1,10,0,51,0,"make india car crash tested again, result pretty"
1,2,3,68,4,17,1,71,0,5-year-old boy left heartbreaking note woman. trying find list
1,2,0,33,0,7,1,33,0,3 thing could making unhappy
1,1,9,31,0,10,6,40,0,21 little thing 2006 gratifying
1,3,10,48,2,10,2,58,0,10 reason average student successful graduation
1,3,7,45,0,7,0,52,0,chinese social medium rage united airline controversy
1,1,4,28,0,3,0,32,0,shocking police officer confession
1,1,8,32,0,7,0,40,0,little thing give biggest anxiety
1,1,7,26,0,7,2,33,0,17 reason woman long hair
1,1,10,36,0,10,4,46,0,crazy thing people used believe woman 1800s
1,1,8,18,0,6,2,26,0,19 time cv receipt chill
1,3,7,37,1,7,0,44,0,here separate casey affleck nateparker
1,1,7,24,0,7,2,31,0,22 easy brunch recipe make fall
1,1,12,39,1,11,0,51,0,thing kim kardashian said that'd weird said
1,3,2,35,0,9,4,37,0,eight year way worse 2016 list
1,1,14,49,0,13,0,63,0,guy greeted stranger airport make feel thing
1,1,13,48,4,13,2,61,0,"11 quote prove ""star wars"" ""the princess bride"" basically"
1,2,12,44,3,12,1,56,0,3-year-old kid roller coaster backyard! insider
1,1,8,28,0,8,2,36,0,11 thing hit everyone right feel
1,1,14,59,0,13,0,73,0,surprising thing happened kid asked choose happiness money
1,1,19,64,2,16,0,83,0,today's dose wtf: four topless woman bollywood dancing time square wearing body paint
1,1,7,27,4,5,0,34,0,tell u yourself(ie): ta'rhonda jones
1,2,10,37,0,9,0,47,0,child reacted photo caitlynjenner
1,1,13,45,0,13,2,58,0,22 thing people bad expressing feeling know true
1,1,9,39,1,8,2,48,0,17 hilarious honest definition sci-fi fantasy term
1,3,17,62,3,16,0,79,0,making dough home sharing: small pie company became part 'airbnb business cycle'
1,3,2,69,2,12,0,71,0,'painful' sunscreen burn case ignite call review product testing australia
1,1,11,41,2,10,0,52,0,tell u best valentine's day gift ever received
1,3,12,59,3,10,0,71,0,nyt op-ed claim internet threatens democracy bypassing establishment class
1,1,10,34,1,10,2,44,0,18 struggle everyone cat's name go
1,2,7,49,0,8,0,56,0,black student university michigan demand segregated space
1,1,8,34,2,8,2,42,0,"11 internet cartoon make feel ""popeful"""
1,2,9,44,2,9,2,53,0,23 mexican breakfast make every morning freakin' fiesta
1,1,5,12,0,5,4,17,0,2009 pop hit
1,1,16,52,0,15,0,68,0,know old favorite pop star released first album
1,3,7,35,0,6,0,42,0,transgender texas boy get new birth certificate
1,1,12,41,1,10,0,53,0,meet sikh rapper looking change world hip-hop
1,1,11,36,0,8,0,47,0,lady gaga casually slayed jfk airport terminal
1,2,7,49,4,13,1,56,0,"orange new black: slow day litchfield, season 3 mark time"
1,1,12,28,0,11,0,40,0,amy schumer held cup new york great
1,1,13,51,2,13,4,64,0,need stop rewatch victoria beckham's 2007 reality show
1,2,7,38,2,8,4,45,0,beauty brand broke diversity barrier 2016 [video]
1,3,5,63,0,14,0,68,0,people think new nike advert sportswoman middle east list
1,1,5,25,0,4,0,30,0,potterheads try fan created sweet
1,1,10,30,0,8,2,40,0,40 easy diys instantly upgrade home
1,1,11,35,2,10,0,46,0,"powerline ""a goofy movie"" look like"
1,3,9,27,0,10,6,36,0,18 hot dude proved 2016 year ofthirst
1,3,3,46,1,8,0,49,0,here's lacroix sparkling water gained cult following
1,1,12,31,1,11,1,43,0,9 thing still ok love tennis ruined
1,1,9,32,0,7,0,41,0,well remember playstation game
1,3,11,48,0,11,2,59,0,21 joke hilariously accurate anyone love food network
1,1,8,25,0,8,2,33,0,22 powerful photo week
1,2,6,27,1,6,2,33,0,samira wileys opinion 21 randomthings
1,1,9,34,1,8,0,43,0,here's healthy people actually eat time
1,1,6,26,1,6,2,32,0,29 piece birmingham's best street art
1,1,14,42,1,13,0,56,0,"learned stop cheating, needed stop cynical"
1,1,10,42,2,10,2,52,0,18 halloween struggle recognize hot place
1,2,6,64,2,10,0,70,0,gop member house intelligence committee claim 'unmasked' report detailed
1,1,17,43,2,13,0,60,0,gifs chris evans pretending can't push-up important
1,2,8,32,1,9,4,40,0,social medium news need know: march 2017 roundup
1,1,7,31,0,6,0,38,0,ethan embry staged unlikely comeback
1,2,2,42,0,7,0,44,0,turn child narcissist list
1,1,8,23,0,8,2,31,0,27 time glitch matrix
1,1,9,27,0,9,2,36,0,11 chart feel bad body
1,2,6,36,4,7,1,42,0,'game thrones': 9 especially gut-wrenching moment
1,2,15,63,2,12,0,78,0,manmohan singh's office knew changing requirement fit agustawestland's bid say sp tyagi
1,1,12,48,1,11,0,60,0,kylie jenner's favorite instagram poet wrote special poem
1,2,0,34,0,10,5,34,0,7 little way love body 2017
1,2,8,41,1,12,1,49,0,ex-nfl rb montee ball reveals would get drunk 4 time week
1,3,11,49,1,12,0,60,0,hear sean lennon willow smith sing song co-written carrie fisher
1,1,14,47,1,13,0,61,0,marco antonio solis jesus christ look freaking
1,1,12,48,2,11,0,60,0,"match ""series unfortunate events"" illustration book"
1,1,8,24,0,7,0,32,0,call drake cell phone
1,1,9,43,0,9,2,52,0,33 thing russia differently everywhere else earth
1,1,7,33,0,7,2,40,0,19 text twentysomethings sent dad
1,3,1,50,0,9,0,51,0,best photograph wall barrier around world
1,1,7,29,0,7,2,36,0,10 scary movie viewed complete coward
1,1,10,39,2,9,0,49,0,"would receive final rose ""bachelor"" ben higgins"
1,1,9,43,1,9,2,52,0,22 struggle people wear glass never understand
1,1,11,31,2,10,0,42,0,"well remember ""sex city"" finale"
1,1,8,34,0,8,2,42,0,18 decadent cupcake recipe better sex
1,1,7,25,0,6,0,32,0,quiz determine drive
1,1,11,50,2,10,0,61,0,here's happened one dude tried six different women's hairstyle
1,3,7,36,0,7,0,43,0,tim kaine accuses donald trump holocaust denial
1,2,8,23,0,7,0,31,0,five sign work weak manager
1,1,6,28,0,6,2,34,0,26 adorable product every dog owner need
1,3,14,47,0,14,1,61,0,6 reason penning thought blog always good decision
1,3,10,38,1,10,2,48,0,15 literary baby name thatll make want havechildren
1,1,10,30,0,10,2,40,0,17 people said wrong thing wrong time
1,3,11,40,3,12,0,51,0,patriot love head coin toss; super bowl bettor bank
1,2,5,36,4,10,1,41,0,'halt catch fire' episode 2: mutiny man's world
1,1,7,28,0,6,0,35,0,handle evening menstruation
1,3,1,55,1,10,0,56,0,buzzfeed got listicle-trolled guy suing court filing
1,1,12,44,0,12,2,56,0,13 reason frozen food aisle depressing place earth
1,3,9,35,2,9,2,44,0,21 beautiful reason woman joined 'a day without woman'
1,2,2,69,2,9,0,71,0,"high-ranking fed official resigns, reveals role leaked confidential information"
1,1,10,40,1,9,0,50,0,medieval europe's epic moment looked like
1,1,12,51,0,12,2,63,0,18 horror novel every true fan read watching movie version
1,1,9,26,0,8,0,35,0,send person give bad gift
1,1,6,23,0,7,6,29,0,19 creepiest news story 2015
1,3,3,38,2,7,6,41,0,11 super-smart technology 2017 mercedes e-class
1,1,7,20,1,6,0,27,0,"kangaroo kind hot, yeah"
1,1,12,41,0,11,0,53,0,go adventure ron weasley samwise gamgee
1,2,1,52,1,8,0,53,0,"forget graphing calculator hacks, real cheater use tortoise"
1,1,13,41,0,13,2,54,0,71 thought get stupid excited seeing cool dog
1,3,15,53,2,15,2,68,0,new definition blindness bring number blind country 40 lakh
1,1,8,35,0,7,0,43,0,daniel radcliffe ditched hairy potter look
1,3,1,47,3,10,0,48,0,"silly human, may take cat's hard-earned money"
1,3,4,35,1,5,0,39,0,cameroon's indomitable lion roared
1,1,10,35,0,10,2,45,0,57 thing happen morning one night stand
1,1,10,54,0,10,2,64,0,19 time tumblr depressingly accurate relationship money
1,1,8,23,0,7,0,31,0,much welsh stereotype
1,1,12,54,1,11,0,66,0,time discussed dumbledore totally screwed slytherin house
1,1,9,39,0,9,2,48,0,18 presentation would make pay attention class
1,1,9,32,0,9,2,41,0,13 hashtags real anyone grew catholic
1,3,10,31,0,11,6,41,0,29 powerful piece writing woman 2016
1,1,9,30,0,9,2,39,0,27 tweet latino way real
1,3,11,31,1,11,6,42,0,10 in-love couple 2017 oscar redcarpet
1,3,2,50,0,10,0,52,0,dentist became one richest people washington
1,2,7,34,4,9,0,41,0,donald trump peter thiel: he ahead curve
1,3,2,46,4,8,0,48,0,old-fashioned way belgrade's artisan survive?
1,1,10,44,0,10,2,54,0,22 emergency item need huge fucking blizzard hit
1,1,14,44,1,13,0,58,0,toronto finally cat cafe even cuter imagine
1,1,10,32,0,8,0,42,0,u music festival attend year
1,1,3,26,0,3,2,29,0,11 tragic everyday disappointment
1,1,7,24,0,7,2,31,0,27 clever way remember shit
1,2,3,28,2,6,4,31,0,'chewbacca mom' winning facebook 2016
1,1,12,46,2,14,6,58,0,29 picture give severe flashback late '90s early '00s
1,1,5,15,0,4,0,20,0,get laid tonight
1,3,15,48,7,12,0,63,0,"caitlyn jenner warns trump: mess lgbt community, im coming"
1,2,6,27,1,8,2,33,0,12 artist can't wait see coachella
1,2,3,86,1,17,0,89,0,work aliens? drone capture aerial footage mysterious crop circle russian wheat field
1,1,8,22,2,9,4,30,0,"21 time angie best part ""30 rock"""
1,1,10,49,0,10,2,59,0,11 iconic bollywood magazine cover would broken internet
1,1,7,31,0,7,2,38,0,24 thing theme park lover understand
1,3,13,53,2,12,0,66,0,living space make u younger? astronaut experienced age reversing!
1,3,8,45,0,8,0,53,0,eight creative people recommend favorite classic book
1,1,7,26,0,7,2,33,0,18 thing funny musician
1,1,6,30,0,6,2,36,0,23 thing weave addict understand
1,1,9,35,0,9,2,44,0,24 thing stop saying breakup
1,3,8,36,3,6,0,44,0,"six false accusation john lewis, hero-turned-hack"
1,2,5,28,0,6,0,33,0,worst airport america
1,3,1,58,0,12,1,59,0,3 reason half american worker using vacation time
1,1,12,50,3,12,2,62,0,"20 time frank reynolds hilarious character ""it's always sunny"""
1,3,2,70,1,14,0,72,0,get ultimate home-cooked meal restaurant run grandma list
1,3,9,36,3,12,0,45,0,"booze kill, putin deemed good czar"
1,1,6,19,0,5,0,25,0,know exactly live
1,1,13,40,1,12,0,53,0,know country going die based one question
1,1,9,26,0,9,2,35,0,32 video game play die
1,1,11,52,2,10,0,63,0,"recognize ""steven universe"" character based silhouette"
1,3,1,62,1,11,0,63,0,tipping point: revealing city exercise harm good
1,1,13,49,0,12,0,62,0,watch josh hutcherson try trip jennifer lawrence fell
1,2,8,47,0,9,0,55,0,campaign asks woman grow body hair antiviolence awareness
1,2,6,21,2,6,0,27,0,seventy spotify cnn.com
1,1,11,38,2,10,0,49,0,"guess age ""would rather"" question"
1,1,7,19,3,6,0,26,0,"earliest i've said ""i love you"""
1,1,7,33,0,7,2,40,0,34 wonderful product people hate clutter
1,1,9,33,1,8,0,42,0,what's best part christmas midwest
1,2,13,50,5,14,11,63,0,"2015-2016 revealed strict side censor board, 135 hindi film given 'a' certificate!"
1,1,10,40,0,9,0,50,0,donald trump famous horror movie scene petrify
1,2,10,46,0,12,0,56,0,one man dead shooting near filming boosie badazz music video
1,1,14,56,0,13,0,70,0,guy beatboxed siri create amazing indian classical jam ever
1,3,7,17,0,7,2,24,0,17 meme send trash ex
1,1,7,30,0,7,2,37,0,18 time miranda hart spoke absolute truth
1,1,9,36,2,8,0,45,0,here's ditching apple's iphone cord changed life
1,3,10,35,4,10,0,45,0,chris evans trump presidency: feel rage. feel fury
1,3,6,61,1,13,0,67,0,chrissy teigen decided protest casey afflecks oscar perfect way list
1,1,7,37,1,7,2,44,0,22 chemical romance's unforgettable moment
1,1,14,61,0,13,0,75,0,woman wrote beautiful facebook post cancelling wedding dowry
1,1,16,29,0,12,0,45,0,horchata cold brew thing need try asap
1,1,10,45,3,9,0,55,0,"what's favorite leslie knope quote ""parks recreation"""
1,1,17,45,9,15,0,62,0,"scott disick said he'd ""for sure"" kill kim kardashian game ""f#@k, marry, kill"""
1,1,9,31,3,9,2,40,0,"well remember ""the walking dead"" season 1-3"
1,1,9,43,2,9,2,52,0,22 thing understand slightly obsessed lush
1,1,15,55,0,14,0,70,0,new york taxi driver nailed sexiest pose charity pin calendar
1,3,3,71,3,19,0,74,0,woman worry ex kill leaf prison. law wont let taser.
1,1,8,38,1,8,2,46,0,15 totally breathtaking place believe real
1,2,0,63,0,11,2,63,0,23 fascinating diagram reveal negotiate people around world
1,3,7,41,1,8,0,48,0,want avoid munching unhealthy foods? serve
1,1,8,35,1,8,2,43,0,27 studio ghibli tattoo make heart croon
1,1,11,34,0,10,0,45,0,fan theory jar jar binks blow mind
1,1,16,42,0,13,0,58,0,know raccoon gif make happy based zodiac sign
1,3,6,42,2,11,0,48,0,hell happened bbc news studio?! list
1,1,13,47,0,13,2,60,0,19 gorgeous lingerie set make never want wear pant
1,1,9,40,0,10,6,49,0,42 genius tweet made british people piss 2015
1,3,5,49,1,12,1,54,0,line duty season 4: bbc series returning sooner think
1,1,7,25,0,7,2,32,0,13 thing trans woman sick hearing
1,1,8,32,0,8,2,40,0,19 hilarious tweet ryan gosling
1,1,8,35,0,8,2,43,0,75 thought every runner running marathon
1,1,12,41,0,10,0,53,0,finally found tv character whose depression look like mine
1,3,5,15,1,4,0,20,0,"trump bump, canada"
1,1,7,25,2,6,0,32,0,"lea michele finding life ""glee"""
1,1,9,28,0,9,2,37,0,25 best response super blood moon
1,1,9,34,0,8,0,43,0,know favorite social medium platform
1,1,6,24,1,5,0,30,0,here's real vegan actually eat
1,1,15,44,2,12,0,59,0,broke bff's house dressed like santa here's happened
1,1,10,52,2,9,2,62,0,13 eye-opening fact reveal india's massive obsession engineering
1,1,10,34,1,10,1,44,0,9 image minnie mouse never seen
1,1,8,31,0,7,0,39,0,disney prince hotter aladdin
1,1,10,30,0,9,0,40,0,male singer ex based birth month
1,1,5,22,0,4,0,27,0,fan try harry potter lipstick
1,1,8,21,1,7,0,29,0,know find love tinder
1,1,11,38,0,11,2,49,0,19 sign best friend becoming person
1,1,12,30,0,11,0,42,0,much crap drawer full crap
1,1,11,28,0,10,0,39,0,would life like lame super hero
1,2,4,32,1,7,0,36,0,watch women's march washington
1,2,5,18,0,6,6,23,0,16 men dominated makeup in2016
1,1,9,38,1,8,0,47,0,neville longbottom grown big ol' moustache
1,1,10,36,2,9,0,46,0,"well know relationship ""love actually"""
1,1,6,35,0,6,2,41,0,24 confession scottish people american
1,1,8,25,0,9,6,33,0,39 amazing pop song may missed 2015
1,1,5,16,1,4,0,21,0,social medium vs. real life
1,1,8,32,1,7,2,40,0,13 must-have high street product natural hair
1,1,9,27,0,9,2,36,0,19 tweet funny love beauty
1,1,13,50,0,12,0,63,0,try die watching channing tatum whisper sweet nothing stranger
1,1,10,44,2,10,2,54,0,here's proof everyone peak attractiveness they're 41
1,1,9,39,1,7,0,48,0,plus-size model absolutely slayed fashion week
1,1,8,24,0,7,0,32,0,many wes craven film seen
1,1,7,24,0,7,2,31,0,22 people give flirting
1,3,1,29,0,6,0,30,0,never touch anyone ever
1,1,9,38,2,9,2,47,0,33 weird thing find every british person's garage
1,1,9,27,0,9,2,36,0,23 moment make feel like real adult
1,1,7,35,0,7,2,42,0,23 brilliant ingredient swap really try
1,1,10,47,1,9,0,57,0,mariah carey's insane engagement ring belongs history textbook
1,3,4,22,1,3,0,26,0,america hated company
1,1,11,46,3,10,0,57,0,"john legend beautifully performed ""all me"" couple's wedding"
1,1,10,41,1,9,0,51,0,adele's album cover giving entire world eyeliner goal
1,1,8,30,0,8,2,38,0,15 thing sex therapist really want know
1,1,7,29,1,6,2,36,0,23 life-changing apps downloaded year
1,1,8,31,1,8,2,39,0,21 thing understand brace
1,1,10,43,3,10,1,53,0,"well remember ""the princess diary 2: royal engagement"""
1,1,10,35,0,10,1,45,0,6 easy holiday gift give everyone squad
1,2,10,38,1,10,0,48,0,training brain dont need reading glass
1,1,6,26,0,6,2,32,0,21 piece advice aspiring writer
1,1,7,30,0,6,0,37,0,complete pop culture crossword
1,2,9,38,2,8,0,47,0,buzzfeed scoop: sebastian gorka nazi anti-semite
1,3,2,26,1,8,3,28,0,silver sirens: top 8 model 40
1,1,11,34,1,11,3,45,0,here's look 100 year wedding gown three minute
1,1,11,41,0,11,4,52,0,lip challenge fails awful actually 2015
1,2,12,51,1,12,2,63,0,"11 thing people motion sickness sick, tired nauseated hearing"
1,1,7,32,0,6,0,39,0,postpartum depression feel like
1,3,16,54,2,15,2,70,0,unlucky owner's laferrari supercar worth r 6.5 crore crushed cube
1,1,11,31,0,10,0,42,0,would remove pot head leopard
1,2,10,50,3,12,0,60,0,seahawks running back marshawn lynch star 'call duty: black ops iii'
1,1,9,28,1,8,0,37,0,poll: actually work first order
1,3,12,49,1,10,0,61,0,oraclevoice: concrete manufacturer changing face finance
1,3,16,61,1,15,0,77,0,girl's legit rant bollywood song something discussed point
1,1,16,38,0,12,0,54,0,jacob tremblay cut line meet leo dicaprio sag award
1,3,9,46,1,10,0,55,0,here chelsea clinton responding awkward joke mom
1,1,18,50,0,17,0,68,0,got bunch people drunk try drunk food around world
1,2,6,31,0,7,3,37,0,assault border patrol agent 143 percent
1,1,10,46,1,8,0,56,0,incredible lingerie shoot come body-positive message
1,1,9,40,2,9,2,49,0,"19 gift people slightly obsessed ""minecraft"""
1,1,11,43,0,10,0,54,0,apparently selena gomez niall horan made weekend
1,1,17,50,0,16,0,67,0,trans guy took selfie every day three year show face changed
1,2,3,51,0,10,0,54,0,slovenia honoring beloved melania trump wine
1,2,5,41,2,7,0,46,0,real-life horror kong: skull island vietnam premiere
1,1,8,31,0,8,2,39,0,33 badass picture golden age tattoo
1,1,7,24,3,6,0,31,0,tell u self(ie): kym whitley
1,3,7,40,0,8,0,47,0,donald trump attack bring team obama retirement
1,1,12,57,0,11,0,69,0,group friend changed halloween game coordinated costume
1,3,12,43,3,12,1,55,0,"samsung galaxy s8 review: great phone, thats matter"
1,3,17,46,4,18,8,63,0,2016's worst password bad 2015's (so please tell list)
1,1,9,41,1,9,2,50,0,21 delicious dip believe three ingredient
1,1,10,30,0,9,0,40,0,burrito los angeles new york city
1,2,3,59,3,10,0,62,0,israel palestinians: alternative two-state solution?
1,1,8,34,2,7,0,42,0,"guess celebrity ""the simpsons"" cameo"
1,2,1,53,1,11,0,54,0,one kitty's cuddly nature prof cat total jerk
1,3,2,50,1,8,0,52,0,"farewell, introduction two vastly different america"
1,1,12,42,2,11,0,54,0,"well remember first episode ""friday night lights"""
1,2,1,51,0,6,0,52,0,selfridges invents coffee spread containing espresso shot
1,1,10,34,0,9,0,44,0,mac cheeseburger friend need
1,1,12,38,1,11,0,50,0,feel really dumb see simple bagged milk
1,1,8,41,0,7,0,49,0,disney princess dressed halloween
1,1,9,29,0,9,2,38,0,15 text student loan dying send
1,1,15,60,0,14,2,75,0,43 important picture watching livestream shia labeouf watching movie
1,2,1,82,0,16,0,83,0,vigilante attack burglar cut one hand catching breaking house
1,3,12,73,2,12,0,85,0,ivy league student claim classroom trauma professor refuse acknowledge white privilege
1,2,6,19,2,6,0,25,0,"fliers, know rights?"
1,1,7,32,2,7,1,39,0,"5 lit ""empire"" cocktail viewing party"
1,1,8,30,0,7,0,38,0,miranda lambert miranda sings
1,1,12,49,1,11,0,61,0,"real, heartbreaking story behind viral dog bathing video"
1,1,8,33,0,7,0,41,0,justin bieber admits still love selena gomez
1,1,4,15,0,3,0,19,0,mayo hater taste test
1,2,11,79,5,11,0,90,0,kurtz: establishment medium hyperventilation trump selection press conference questioner whiny
1,1,10,31,1,9,0,41,0,wendy's burger king got fight twitter
1,1,10,39,0,10,4,49,0,thing people actually said muslim 2015
1,1,13,53,1,11,0,66,0,pop-up dinner empowering woman restaurant industry
1,1,8,28,0,9,6,36,0,23 tweet 2006 make feel ancient
1,1,12,52,4,10,0,64,0,doggy-style vs. missionary: guess partner's favorite sex position
1,1,6,19,0,5,0,25,0,percent night owl
1,1,3,23,0,3,2,26,0,12 awkward foreplay confession
1,3,10,55,3,11,0,65,0,survivor cbs prepared outrage transgender contestant outing
1,3,1,68,3,15,0,69,0,"one year, publishing house release book written woman here's"
1,2,7,21,2,5,0,28,0,donald trump winning war cnn
1,3,7,28,2,6,0,35,0,report: fox news parting bill oreilly
1,1,10,39,1,10,6,49,0,21 life-changing health beauty product try 2016
1,1,18,52,3,17,0,70,0,"teen ended ""ugliest girls"" poll school, best response"
1,1,9,36,3,8,2,45,0,"50 hauntingly beautiful photo ""the x-files"""
1,1,10,44,0,10,3,54,0,106 unexpectedly awesome song every moment wedding day
1,1,8,27,0,7,0,35,0,student legal right safe space
1,1,8,35,0,9,6,43,0,21 greatest example fragile masculinity 2015
1,1,8,28,1,8,3,36,0,here's look 100 year halloween costume
1,2,14,70,1,14,0,84,0,ag sessions: sanctuary city fail comply immigration law risk losing federal dollar
1,1,9,24,2,8,0,33,0,"well know ""when harry met sally"""
1,1,7,24,0,7,2,31,0,21 best server meme internet
1,1,9,33,1,8,0,42,0,hipster santa coolest santa ever meet
1,2,2,55,1,12,0,57,0,confession disappointing dad five thing regret
1,1,6,26,1,6,2,32,0,18 animal weird they're probably fake
1,3,4,47,2,11,0,51,0,chicken mcnuggets come four shape here's list
1,1,10,40,0,10,2,50,0,27 little thing people obsessed makeup guilty
1,1,9,31,0,8,0,40,0,know favorite comedian based age
1,2,2,58,2,11,0,60,0,award-winning photo show planet earth way never seen
1,1,15,42,1,14,0,57,0,photo drake hot go emergency room
1,1,8,20,0,9,6,28,0,10 biggest lie told 2015
1,3,13,41,2,11,0,54,0,here happens take morning-after pill thetime
1,2,7,31,0,6,0,38,0,mads mikkelsen fucking amazing atdancing
1,1,8,34,0,9,6,42,0,27 utterly terrible way food actually served 2015
1,1,10,36,2,9,0,46,0,"""harry potter"" villain based zodiac"
1,3,2,42,2,7,0,44,0,saudi king visit indonesia 'cars entourage'
1,1,7,30,0,7,2,37,0,17 saddest gingerbread house year
1,1,15,51,1,13,0,66,0,short film old arranged-married couple make cry smile
1,2,1,56,1,12,0,57,0,one little drop blood may someday predict long youll live
1,1,12,50,2,11,0,62,0,"musical film watch based favorite ""glee"" character"
1,1,7,35,0,7,2,42,0,19 confession muslim paris attack
1,3,6,28,0,6,0,34,0,enviros file lawsuit stop border wall
1,2,1,69,2,12,0,70,0,widow claim husband died 'emotional distress' forced clean toilet
1,3,9,39,2,9,5,48,0,"long dow jones industrial average reach 21,000?"
1,1,16,56,3,16,0,72,0,"reminder ""pinky brain"" christmas special make cry every time"
1,2,2,47,2,9,0,49,0,awe-inspiring photo earth remind u what's stake
1,1,13,39,0,11,0,52,0,know personality age based favorite tv show
1,2,10,41,4,9,0,51,0,worried political risk? (hint: insurer are)
1,1,9,27,2,8,0,36,0,here's actually like fitbit
1,3,6,27,1,7,0,33,0,best snack bedtime?
1,1,11,34,0,12,6,45,0,25 time chris pratt anna faris proved love real 2015
1,1,10,29,0,10,4,39,0,exact replica titanic set sail 2018
1,1,6,22,2,6,2,28,0,"37 thing cut ""the force awakens"""
1,3,9,26,1,10,6,35,0,33 science fact didnt know start of2016
1,1,11,36,0,10,0,47,0,everyone would rather date cookie person
1,3,9,59,2,8,0,68,0,"hollywood, medium mercilessly mock kellyanne conways trump inauguration outfit"
1,1,6,32,0,6,2,38,0,19 food truth chicagoans understand
1,3,18,48,4,12,0,66,0,watch: fatah song palestinian authority tv call slice open israel chest
1,1,11,45,0,10,0,56,0,need talk overwhelmingly perfect julianne moore
1,1,9,26,0,8,0,35,0,high heel foot
1,1,8,26,2,7,0,34,0,"obsessed ""game thrones"""
1,3,2,50,1,9,0,52,0,take teenage child mediterranean cruise?
1,1,7,19,2,5,2,26,0,13 all-too-real text bra
1,1,7,19,0,7,4,26,0,much love minion 2015
1,1,9,34,3,8,0,43,0,"name monica's boyfriend ""friends"""
1,1,8,29,0,8,2,37,0,18 way bring sandwich life
1,1,12,58,1,11,0,70,0,chris hemsworth think funny paparazzo thought michael fassbender
1,1,9,26,1,9,2,35,0,13 part body know name
1,2,3,60,3,11,0,63,0,extinct: 'jurassic pork' report flag project survived earmark ban
1,2,9,43,1,9,1,52,0,9 wonderfully weird ornament people tradition
1,1,9,22,0,8,0,31,0,guess kind porn like
1,1,4,23,0,4,2,27,0,10 awkward first kiss confession
1,3,1,51,0,10,4,52,0,curious case unsolved mystery perplexed u 2016
1,2,2,45,2,12,1,47,0,"new year start jan. 1, terrible time renewal"
1,1,14,55,2,13,0,69,0,"creator ""master none"" thanked straight white guy acceptance speech"
1,2,9,37,0,8,0,46,0,woman survived one deadliest snake attack
1,1,8,31,3,8,2,39,0,"23 monica geller's iconic line ""friends"""
1,2,8,28,0,8,3,36,0,100 important puppy photo alltime
1,3,8,33,3,8,0,41,0,rush limbaugh: offense donald trump
1,1,9,42,0,9,2,51,0,13 inspiring roald dahl quote guaranteed brighten day
1,1,10,40,0,10,2,50,0,25 small thing actually huge people anxiety
1,1,13,41,0,12,0,54,0,baby elf shelf cutest thing holiday season
1,1,11,29,0,10,0,40,0,sit right watch rock hit quan
1,1,11,41,1,10,0,52,0,pop diva's scent wear based birthstone
1,1,12,42,0,11,0,54,0,wiz khalifa showed golden globe looking classy hell
1,1,7,21,2,7,2,28,0,"11 thing need know ""room"""
1,1,11,52,3,10,0,63,0,"here's trailer ""trolls"" starring anna kendrick justin timberlake"
1,1,7,29,0,8,6,36,0,17 red carpet look 2015 breathtaking
1,1,7,13,0,3,2,20,0,15 unbearable animal pun
1,2,5,71,5,17,0,76,0,"okay, fine fine, google's april fool's day prank pretty great year,"
1,1,5,16,0,5,2,21,0,25 thing might dead
1,1,7,36,0,6,0,43,0,ventriloquist dummy scariest thing ever
1,1,9,28,0,9,1,37,0,9 sex tip anyone vagina try
1,1,11,39,0,10,2,50,0,19 creepy af halloween makeup idea scar forever
1,2,4,53,1,12,2,57,0,walking dead season 7 finale episode: 5 character might die
1,3,1,34,1,8,3,35,0,100 best nonfiction books: story far
1,1,11,36,0,10,0,47,0,emo trinity album based zodiac sign
1,3,8,25,0,6,0,33,0,ipo market take baton tech insanity
1,1,9,54,1,7,0,63,0,watch transgender teacher comfort gender-nonconforming student
1,3,7,40,3,7,0,47,0,california professor call trump win act terrorism
1,1,13,49,0,13,2,62,0,17 photo world need see understand beautiful mumbai really
1,3,5,43,0,9,0,48,0,dumbo remake see tim burton michael keaton reunite
1,1,7,23,0,8,6,30,0,31 beautiful movie shot 2015
1,2,3,41,0,8,0,44,0,learn north korean military parade
1,1,8,39,0,8,2,47,0,15 thing introvert know planning wedding
1,1,7,46,2,6,2,53,0,"17 hilarious american-canadian differences, according tumblr"
1,1,9,49,1,7,0,58,0,canadian hilariously confessing un-canadian trait
1,3,9,32,2,9,0,41,0,"pressed duck rich, old trend thats new"
1,1,11,50,0,10,0,61,0,zoo animal around world opening christmas present early
1,1,13,53,3,11,0,66,0,"carrie fisher considered play sandy ""grease"" olivia newton-john"
1,1,12,51,1,11,0,63,0,internet can't stop memeing randeep hooda massive weight loss
1,1,11,41,0,10,0,52,0,pick pumpkin determine halloween night
1,3,7,25,4,8,2,32,0,daily: 47-day fall michael flynn
1,1,12,50,2,11,0,62,0,"know favorite ""harry potter"" character based favorite color"
1,1,9,28,0,10,6,37,0,21 yik yak 2015 really damn funny
1,1,8,39,0,8,2,47,0,23 couple costume give relationship goal
1,1,10,30,0,9,0,40,0,dog breed based zodiac sign
1,2,15,51,2,11,0,66,0,fix in: comey praised dnc-hired cybersecurity firm even botched report
1,2,4,41,1,8,0,45,0,trump's big epa website change make furious
1,3,15,64,1,14,0,79,0,goofy ending! presenter mistakenly announce la la land best picture instead moonlight
1,2,18,62,3,16,0,80,0,five trait separate job seeker get hired (with real-life examples)
1,1,9,32,2,6,0,41,0,jean-ralphio mona-lisa saperstein
1,2,5,25,2,7,0,30,0,put energy drink! cnn video
1,1,8,31,1,8,2,39,0,35 people failed hard actually perfect
1,1,9,26,1,8,0,35,0,adult sit santa's lap first time
1,1,10,40,0,10,4,50,0,mark wahlberg beach cause 2016 sexual awakening
1,1,11,44,2,10,0,55,0,"pussycat panty give whole new meaning ""cute underwear"""
1,1,7,22,0,6,0,29,0,initial say
1,2,13,54,4,11,0,67,0,"teradatavoice: help retirement planners, try, can't help"
1,3,12,48,0,11,0,60,0,sparkly silicone beauty blender change makeupgame
1,1,13,36,1,12,0,49,0,lived without phone one week here's learned
1,1,10,28,0,9,0,38,0,tell chris liam hemsworth
1,3,7,40,0,8,0,47,0,aleppo evacuation halted rebel open fire convoy
1,1,13,55,0,13,2,68,0,survive 30 second looking really hot shirtless hairy chested guy
1,1,11,36,0,10,0,47,0,pope francis met obama family dog white house
1,1,12,42,2,9,0,54,0,take sriracha everywhere on-the-go packet
1,3,6,20,0,6,0,26,0,teen say social medium
1,1,9,24,0,9,2,33,0,19 kid grow change world
1,2,3,12,1,3,0,15,0,we're reading
1,2,5,56,1,11,0,61,0,here's white house staff pranked president obama holiday
1,3,9,50,1,7,0,59,0,awesome teacher prank student gibberish-filled spelling test
1,1,8,32,1,6,0,40,0,inception-like image blow mind
1,1,9,34,0,9,2,43,0,15 fab little gift reddit secret santa love
1,1,7,15,0,6,0,22,0,pizza
1,3,12,38,0,11,0,50,0,woman gifted karaoke mic absolute
1,1,12,59,3,11,0,71,0,"without alan rickman ""love actually"" scene heartbreaking"
1,3,15,60,6,15,0,75,0,exclusiverep. steve king: optimistic ever felt swearing-in day
1,1,11,36,2,11,4,47,0,sexy pizza rat halloween costume cost $89.95
1,1,7,27,0,8,6,34,0,31 christmas gift totally asked 2005
1,1,11,32,1,9,0,43,0,know feel-good song based zodiac sign
1,1,11,35,0,11,2,46,0,22 picture real people hate job
1,1,10,43,2,11,4,53,0,23 thing understand 10 year older sibling
1,1,13,41,0,11,0,54,0,guess mariah carey music video youtube comment
1,2,11,47,5,10,0,58,0,exclusive: jenna jameson denies role anti-trump porn film: fake news
1,1,15,52,0,14,0,67,0,veterinarian ate neglected dog cage make feel comfortable
1,2,11,35,2,12,4,46,0,edited (but long) list thing kanye west said 2016
1,1,13,45,1,12,0,58,0,kylie jenner prof wear butt pad showing spanx
1,1,11,42,1,11,2,53,0,"24 great movie likely missed year, totally see"
1,1,9,28,2,8,2,37,0,"24 middle-class crisp went way, way far"
1,3,2,55,1,11,2,57,0,anti-trump movement calling boycott 33 retailer
1,1,11,45,0,11,2,56,0,42 question still logistics wizarding world
1,1,10,37,0,9,0,47,0,famous movie sidekick based zodiac
1,3,2,46,2,5,0,48,0,trump: five political minefield facing president-elect
1,1,9,41,4,8,0,50,0,"what's favorite professor snape moment ""harry potter?"""
1,3,7,42,2,9,0,49,0,samsung heir denies charge 'trial century' begin
1,1,7,24,0,4,0,31,0,diy halloween porcelain doll makeup
1,1,8,37,1,6,0,45,0,christmas-themed horror movie watch
1,3,4,48,0,11,0,52,0,indian state banned pepsi coke revoked
1,1,18,60,0,17,0,78,0,indian soldier taking time share lunch squirrel cutest thing ever
1,1,11,30,2,10,2,41,0,name '90s r&b track single screencap
1,1,9,33,1,8,2,42,0,17 thing confident plus-size woman deal
1,2,13,57,4,10,0,70,0,"wtf, look like twitter account predicted beyoncs pregnancy announcement"
1,3,7,38,1,7,0,45,0,pro-trump rally across america stand violence
1,1,7,33,0,6,0,40,0,shondaland hunk valentine
1,1,7,30,0,7,4,37,0,coolest parenting product 2015
1,3,2,47,0,9,0,49,0,young aussie surfer photo bombed shark shared wave
1,1,8,26,1,8,2,34,0,19 struggle person can't burp
1,1,5,19,0,6,6,24,0,23 best tinder response 2015
1,3,1,48,2,8,0,49,0,could planting tree save world's largest river island?
1,1,8,32,0,8,2,40,0,17 photo prove saskatoon gorgeous heck
1,2,11,46,0,10,0,57,0,teen brought stepdad tear surprise christmas gift
1,2,11,73,2,14,0,84,0,facebook want read thoughts? secretive division may developing mind-reading device
1,2,8,39,0,8,1,47,0,7 thing american love invented immigrant
1,1,10,40,0,10,2,50,0,63 thing mildly irritate british people daily basis
1,2,4,56,3,8,0,60,0,steven spielberg's 'jurassic park' decision changed movie forever
1,1,9,32,0,9,2,41,0,18 photo makeup make every girl cringe
1,1,8,41,0,8,2,49,0,16 word mean something completely different target
1,1,10,34,0,10,2,44,0,21 thing happen really massive dog
1,1,14,40,2,11,0,54,0,psa: get japan visit world's biggest fucking fish market
1,1,7,35,0,7,2,42,0,19 picture dog embarrassing situation
1,1,9,34,0,8,0,43,0,indian billionaire trying save world
1,1,13,37,2,10,0,50,0,lot people upset youtuber's fat-shaming video
1,2,1,65,1,10,0,66,0,global warming conference skeptic think they're winning debate
1,1,9,27,0,9,2,36,0,22 dude tell u last time cried
1,3,10,78,3,18,5,88,0,"jump 2017 line-up confirmed channel 4: sir bradley wiggins, lydia bright louis smith hitting slope"
1,3,11,32,1,11,3,43,0,see get 8/10 celebrity siblingsquiz
1,1,10,29,1,8,0,39,0,k-pop girl group actually
1,1,8,33,0,7,0,41,0,renaissance artist hook
1,1,6,18,0,5,0,24,0,cheese love life
1,1,9,32,5,7,0,41,0,"cast ""dr. horrible's sing-along blog"" reunited"
1,1,8,23,0,9,6,31,0,17 song older class 2019
1,1,9,40,2,8,0,49,0,"""breaking bad"" character said famous last word"
1,3,3,69,5,15,0,72,0,"stop, daddy: lawmaker beat wife child pleaded him, official say"
1,3,7,27,1,6,0,34,0,here's one sign abenomics working
1,1,11,35,2,10,0,46,0,"choice ""candy crush"" candy say"
1,1,7,25,0,6,0,32,0,identify lush bath bomb
1,1,11,38,1,10,0,49,0,solve crossword way craft beer
1,1,4,9,2,3,0,13,0,~deep~
1,1,5,14,0,4,0,19,0,would fuck alien
1,1,9,27,3,9,2,36,0,"""20 minute in, give look"" puzzle"
1,2,2,41,1,7,0,43,0,"mother, daughter die grisly czech sauna accident"
1,2,4,31,3,5,0,35,0,what's made canada's slims river disappear?
1,2,17,55,3,16,1,72,0,"dad jailed mom remarried, 5yo taking care grandmothers!"
1,1,14,56,0,13,0,70,0,grandma best reaction taylor swift bringing mick jagger onstage
1,3,2,38,0,7,0,40,0,queen made history milestone
1,3,7,31,2,7,3,38,0,"literally 100 really funny ""game thrones"" meme"
1,1,6,26,1,5,0,32,0,what's best family halloween movie
1,1,7,27,0,7,2,34,0,18 gentleman cat best manner
1,1,7,25,1,6,0,32,0,hardest emoji quiz ever take
1,3,7,36,0,9,0,43,0,recognize sign holiday stress dog
1,1,15,40,1,13,2,55,0,jimmy kimmel asked people ready 5.5 equinox aka fall
1,1,15,34,1,12,0,49,0,guy us sword fire cut hair totally wtf
1,1,8,30,0,8,2,38,0,23 slice pizza sexually awaken
1,1,12,45,2,12,2,57,0,"15 ""gossip girl"" trivia question every true fan able answer"
1,1,11,44,1,10,4,55,0,kylie jenner liked kardashian-jenner instagram 2015
1,1,9,28,1,7,0,37,0,co-worker facebook need hear
1,1,13,44,2,12,0,57,0,"lot people sharing powerful ""doctor who"" speech war"
1,1,10,43,0,9,0,53,0,guess many follower instafamous people
1,1,12,22,0,9,0,34,0,know u tv show set
1,1,8,27,1,6,0,35,0,star war fan try covergirl's makeup line
1,1,13,41,2,13,2,54,0,"25 best moment ""elf"" get excited christmas"
1,1,8,34,1,8,2,42,0,76 thing know three year university
1,1,11,30,0,10,0,41,0,know pet based random question
1,1,7,21,0,7,2,28,0,27 mario myth happen true
1,3,9,36,0,8,0,45,0,running business taught investing
1,1,6,43,1,5,0,49,0,boyfriend choose girlfriends' halloween costume
1,1,15,49,0,14,0,64,0,blake lively ryan reynolds fell love double date people
1,1,7,25,0,7,2,32,0,17 picture dog job
1,1,8,29,1,8,1,37,0,2 chainz pay veteran's rent entire year
1,3,10,38,0,10,2,48,0,42 amazing makeup palette almost pretty use
1,1,17,52,3,15,2,69,0,70-year-old woman's reason single give whole new level goal
1,1,10,42,2,9,0,52,0,"lamar odom love kanye's new album, according kim kardashian"
1,1,10,37,1,10,2,47,0,22 photo make sense people perfect nail
1,3,10,43,4,9,0,53,0,chris pratt 'officially' weighs jurassic world theory
1,2,2,77,9,13,0,79,0,'racist' primary school headmistress called staff 'f*****g muslims' banned teaching life
1,1,8,27,1,8,2,35,0,"27 time netherlands went way, way far"
1,1,8,41,0,7,0,49,0,underrated baby product everyone know
1,1,7,28,0,7,2,35,0,17 thing girl tell best friend
1,1,6,16,3,4,0,22,0,"""x-men"" heroine"
1,3,12,44,1,11,0,56,0,create perfect mate find exactly get married
1,2,13,36,11,11,0,49,0,"oscar mix-up: moonlight, la la land video nytimes.com"
1,3,7,33,1,7,3,40,0,woman share honest photo 180-pound weight loss
1,2,9,35,2,8,0,44,0,kendrick lamars next studio album take us?
1,1,16,26,0,8,0,42,0,nyle dimarco make thought nsfw nyfw
1,1,7,17,0,6,0,24,0,stay fit college
1,1,14,35,0,13,0,49,0,wait day debate faith public square
1,1,11,50,2,10,0,61,0,"hybrid hogwarts house ""harry potter"" character belong"
1,2,10,43,2,9,0,53,0,"hillary clinton join instagram, post funny pic, people get mad"
1,1,8,28,3,7,0,36,0,married vs. single: what's best first date
1,1,11,37,0,11,2,48,0,19 epic cake fails make laugh every single time
1,1,13,43,0,12,0,56,0,miss piggy open split century life kermit
1,1,10,39,0,10,2,49,0,17 confession real people hate partying
1,1,8,33,0,9,6,41,0,16 time taylor swift right everything 2015
1,3,5,36,4,8,0,41,0,reality check: malmo 'rape capital' europe?
1,1,11,36,1,11,2,47,0,24 amazing product let world know burger fan
1,2,5,20,0,5,2,25,0,25x rule early retirement
1,1,14,52,1,13,0,66,0,beautiful poem resonate anyone living place
1,1,7,23,1,7,2,30,0,31 thing still young
1,1,9,32,0,8,0,41,0,well know iconic wedding dress
1,1,9,36,1,9,2,45,0,remember year '90s movie released
1,1,13,46,1,12,0,59,0,"henry cavill hot, make think turtleneck attractive"
1,1,17,57,4,16,0,74,0,"starbucks worker fiercely dropped like hot weeknd's ""can't feel face"""
1,1,7,21,0,6,0,28,0,well know airport code
1,1,13,38,1,11,0,51,0,k-pop song listen based birth month
1,3,12,40,1,14,0,52,0,marine le pen may get lift unlikely source: far left
1,1,8,42,1,8,2,50,0,15 genius iphone accessory help declutter life
1,1,8,19,0,7,0,27,0,know much like job
1,1,8,31,0,7,0,39,0,keep motivated writing novel
1,1,9,34,0,9,2,43,0,25 beautiful college campus world
1,2,10,48,2,12,2,58,0,"cyclone vardah strike chennai, kill 2 5 major story today"
1,1,8,29,1,7,0,37,0,know spend powerball jackpot
1,3,7,25,1,8,4,32,0,21 song every 90 girl still know byheart
1,3,3,56,2,11,0,59,0,alleged ft. lauderdale airport shooter get gun back police?
1,3,5,64,1,12,0,69,0,storm stella: thousand u flight delayed cancelled due winter snowstorm
1,1,6,28,0,5,0,34,0,american try new canadian lay flavor
1,2,13,60,2,13,0,73,0,"yangtze ship tragedy, deleted report drive speculation china real time report"
1,3,5,64,1,18,0,69,0,fake irs scam tried dupe police officer got best revenge list
1,1,13,43,1,12,0,56,0,woman look almost identical megan fox crazy hell
1,1,8,31,0,8,2,39,0,21 photo jake gyllenhaal really hit home
1,1,9,39,1,9,2,48,0,29 fairytale place visit finland helsinki
1,1,12,42,1,11,0,54,0,here's happens turn pumpkin spice latte pizza
1,1,9,34,0,6,0,43,0,one gif perfectly explains gender inequality
1,3,13,48,1,12,0,61,0,frank ocean memorable grammys moment wasnt even
1,2,10,36,5,9,0,46,0,"young thug's video ""wyclef jean"" expect"
1,1,8,34,0,8,2,42,0,21 picture smiling dog life terrible
1,2,3,41,1,9,2,44,0,"walking dead continue 20 years, say producer"
1,1,10,31,1,9,0,41,0,know santa claus based one question
1,1,5,37,0,5,2,42,0,18 breathtakingly photographic location wale
1,1,10,34,0,10,2,44,0,13 cute way add india everyday wardrobe
1,1,8,25,0,7,0,33,0,like nelly kelly rowland
1,3,17,57,2,15,0,74,0,u man charged hate crime thrashing indian origin man 'mistaking muslim'
1,1,8,38,3,7,2,46,0,"15 funny, shocking, truly weird real-life coincidence"
1,3,16,58,2,13,0,74,0,four friend stumble upon ancient italian 'stonehenge' looking ww ii bunker
1,1,6,19,0,5,0,25,0,please look baby zebra
1,1,9,29,4,9,1,38,0,"quote ""home alone"" ""home alone 2"""
1,1,7,30,3,7,2,37,0,"10 sign totally obsessed ""star trek"""
1,1,4,15,0,3,0,19,0,cenobite
1,1,11,39,0,10,0,50,0,interpret drawing way people
1,3,10,47,0,9,0,57,0,guy record heartwarming moment surprised mom christmas
1,1,14,44,0,14,2,58,0,13 picture convince get maa tattoo hindi right
1,1,9,34,0,9,2,43,0,19 amazing bowl soup guaranteed rock world
1,3,13,50,3,10,0,63,0,nyt executive editor: washington post slogan sound like next batman movie
1,1,9,41,0,9,2,50,0,26 thing people relationship never ever understand
1,1,8,38,0,7,0,46,0,number test determine personality type
1,1,10,41,1,10,2,51,0,"12 hack make netflix, hulu amazon prime streaming better"
1,1,10,32,0,9,0,42,0,many michael cera movie seen
1,1,9,37,2,8,0,46,0,"know secondary ""game thrones"" character"
1,1,13,45,0,12,0,58,0,justin bieber song life anthem based zodiac sign
1,1,8,35,0,9,6,43,0,23 unforgivable thing internet minion 2015
1,3,5,74,2,17,0,79,0,donald trump justin trudeau asked question answer said all. list
1,1,6,19,0,7,6,25,0,17 trend men avoid 2016
1,2,2,80,1,18,0,82,0,"teenager used walk mile work take care mother, everything changed list"
1,3,2,68,3,15,0,70,0,wear computer glass every day even though perfect vision here's
1,1,12,43,0,11,0,55,0,golden globe reaction face based zodiac sign
1,1,14,37,1,9,0,51,0,michael fassbender's awkward kiss cam cut baftas
1,1,15,50,2,14,0,65,0,"groom fulfilled childhood dream wedding ""back future"" day"
1,3,6,30,0,7,0,36,0,davos brings global elite together
1,1,11,34,0,10,0,45,0,love life need based zodiac sign
1,1,11,37,1,11,2,48,0,22 thing get love animal people
1,3,1,60,0,9,0,61,0,dying author pen heartbreaking dating profile beloved husband
1,2,14,64,1,13,0,78,0,rahul raj feel kamya punjabi releasing pratyusha banerjee's short film publicity stunt
1,2,6,24,1,5,0,30,0,could planet like coruscant exist?
1,1,6,29,0,5,0,35,0,confession halloween costume model
1,2,3,43,0,7,2,46,0,10 playstation experience reveals might missed
1,1,10,39,1,9,0,49,0,toronto zoo's baby panda actually look like panda
1,1,9,32,3,8,0,41,0,"hardest ""degrassi"" quiz ever take"
1,3,5,56,1,10,0,61,0,mitt romney give brutal powerpoint critique obamas foreign policy
1,1,15,63,0,14,0,78,0,someone keep accidentally texting guy awesome beard reply hilarious
1,3,1,50,0,12,0,51,0,losing dog harder losing relative orfriend
1,3,10,47,2,8,5,57,0,"14,474 people contract hiv blood transfusions, government denies"
1,3,4,50,0,10,0,54,0,strange noise sweden thought caused northern light
1,1,12,33,0,11,0,45,0,guy slumber party first time loved
1,1,9,31,1,10,5,40,0,27 motorcycle jacket $100 cozy fall
1,3,3,55,0,9,2,58,0,14 successful ceo entrepreneur share best business advice
1,1,8,31,1,7,0,39,0,"dear men, stop wearing boxer board short"
1,3,14,52,2,13,4,66,0,"sasikala's cm dream crumbles, inflation lowest since 2012 must read"
1,1,11,34,2,10,0,45,0,"guess ""harry potter"" film title credit"
1,2,22,50,1,16,5,72,0,now? 6 quarterback drafted tom brady infamous 2000 nfl draft
1,1,11,40,2,10,0,51,0,"chris pratt, anna faris, adorable son named penguin"
1,3,2,49,2,11,1,51,0,9 bizarre thing still canon 'star wars' universe
1,3,8,22,0,6,0,30,0,new nike kobe ad releasing next week
1,2,7,33,1,6,0,40,0,apple rank warren buffett's portfolio
1,3,13,57,1,13,4,70,0,"canada plan legalise marijuana 2018, accept recreational use pot nationwide"
1,2,9,31,3,10,0,40,0,bank error favor? keep cash?
1,1,8,24,0,7,0,32,0,taylor swift ed sheeran
1,3,10,42,1,10,2,52,0,15 green tea-infused beauty product skin thank
1,1,8,34,1,8,2,42,0,"23 favorite comfort foods, without gluten"
1,2,1,41,0,7,0,42,0,smart knob prevent kitchen disaster
1,3,2,52,2,11,0,54,0,trying lose weight? colder month might perfect time.
1,1,5,25,0,4,0,30,0,worst kind misunderstanding
1,1,10,48,0,10,2,58,0,15 chart graph anyone longterm relationship understand
1,1,7,27,2,8,6,34,0,"27 important moment ""bake off"" 2015"
1,2,2,54,2,15,0,56,0,ko pop bilderberg: could year let hang out?
1,1,10,38,0,10,2,48,0,17 knockoff game system failed hard almost
1,1,11,31,2,10,2,42,0,"21 post watching tv make say ""same"""
1,2,16,55,2,12,0,71,0,vmwarevoice: cloud helped school district handle texas-sized growth spurt
1,1,10,30,2,10,2,40,0,"""10 thing hate you"" guy date"
1,1,11,37,0,10,0,48,0,tom daley dustin lance black engaged married
1,1,13,43,2,12,0,56,0,"guess ""harry potter"" character anagram name"
1,1,13,42,1,10,2,55,0,13 insanely delicious mashed potato recipe want make asap
1,1,11,32,1,11,4,43,0,"need watch 5,000 duckling run pond right"
1,1,9,36,1,9,2,45,0,well remember '00s disney holiday special
1,2,10,39,3,12,0,49,0,watch hardwell honk horn hit road 'om telolet om' meme
1,2,6,49,1,10,0,55,0,england call somerset craig overton cover chris jordan
1,1,9,38,0,9,2,47,0,27 thing everyone gone therapy understand
1,3,7,23,1,6,2,30,0,10 best-paying city tech job
1,3,2,41,1,10,0,43,0,bumped flight? know right fly
1,1,6,30,1,6,2,36,0,24 trip actually changed people's life
1,3,7,29,0,7,1,36,0,9 thing every woman secretly inwinter
1,1,9,36,3,8,0,45,0,"here's cast ""halloweentown"" look like today"
1,3,4,23,1,5,2,27,0,15 well-kept secret master
1,1,7,38,0,7,2,45,0,16 honest confession people wearing purity ring
1,2,3,45,1,8,0,48,0,there's finally something awesome google glass
1,1,10,43,0,9,0,53,0,ice cube kevin hart react perfectly everyday situation
1,1,7,24,0,6,0,31,0,memory david bowie
1,1,9,31,1,9,6,40,0,24 classic hip-hop song transport 1996
1,2,1,51,1,10,0,52,0,woman's rare genetic disorder could hold key weight loss
1,1,14,35,0,13,0,49,0,girl texted adele lyric ex go well
1,3,12,59,0,14,0,71,0,lily allen lost twitter row tommy robinson threatening legal action
1,1,8,44,0,8,2,52,0,12 glorious bailey cocktail delight tastebud
1,1,9,27,1,9,2,36,0,43 book able stop talking
1,1,12,32,0,11,0,44,0,one girl saved trash week thing piled
1,1,17,42,1,14,0,59,0,here's preview new mac makeup designed bunch badass woman
1,2,3,41,1,8,0,44,0,here's make perfect old fashioned cocktail
1,1,9,29,0,8,0,38,0,many jamie lee curtis movie seen
1,1,11,42,2,10,0,53,0,what's funniest thing heard someone say sleep
1,1,16,49,4,15,0,65,0,"parent irate children's book called ""do want play balls?"""
1,1,11,43,0,11,2,54,0,19 time canada mercilessly trolled rest world tumblr
1,1,8,18,0,7,0,26,0,guy explain win date
1,1,8,38,0,8,2,46,0,19 small change actually helped people lose weight
1,1,11,42,1,10,0,53,0,cancer survivor talk really like cancer
1,1,13,41,1,12,0,54,0,asked people street okay talk depression
1,2,5,56,4,12,0,61,0,new celebrity apprentice missing something isnt trump
1,1,11,41,0,10,0,52,0,please help u figure carrie fisher tweet mean
1,1,8,32,0,8,2,40,0,44 weird celebrity tweet make laugh
1,2,6,36,1,8,0,42,0,catcher elbow runner trying score espn video
1,2,2,50,1,10,0,52,0,watch slow-motion pile unfold icy montreal street
1,1,5,32,0,4,0,37,0,disney villain reimagined without makeup
1,1,8,38,1,8,2,46,0,31 tweet halloween actually make laugh
1,1,12,45,1,11,0,57,0,rob kardashian posted photo blac chyna yeah they're dating
1,1,6,26,2,7,4,32,0,23 thing understand 23
1,1,10,45,0,9,0,55,0,people angry kim kardashian photoshopped nude shoot
1,1,9,34,1,8,0,43,0,what's favorite month based zodiac sign
1,3,9,43,2,9,0,52,0,tough trade weakens hand u.k. retailer refinancing loom
1,1,18,58,3,17,0,76,0,"little girl singing ""i'm gonna love it"" sick mom shatter heart"
1,1,7,36,0,7,2,43,0,31 meal prep photo ridiculously satisfying
1,1,10,33,3,9,0,43,0,"nadiya best contestant year's ""bake off"""
1,1,16,52,1,15,0,68,0,"know, jose bautista got home slaying texas ranger"
1,3,1,53,1,10,0,54,0,shopper's random act kindness woman delight internet
1,2,8,37,1,7,0,45,0,five-star hotel incredibly cheap portugal
1,1,12,47,3,12,2,59,0,"23 moment ""keeping kardashians"" prove actually art"
1,1,10,39,0,10,2,49,0,21 masterfully punny tweet make laugh loud
1,2,2,68,4,13,0,70,0,mistletoe actually tree-killing parasite here's became christmas icon
1,1,10,41,0,10,2,51,0,21 thing every college kid tired hearing thanksgiving
1,2,2,31,2,8,0,33,0,ive hit sleep wall im seeing double
1,2,1,42,0,8,0,43,0,red wine ingredient may improve health obese men
1,1,8,36,1,7,1,44,0,8-picture test reveal greatest quality
1,1,8,29,0,8,4,37,0,2016 look like favorite celebs
1,1,7,29,1,6,0,36,0,justin bieber's hairstyle
1,1,9,30,0,8,0,39,0,people tried ikea food first time
1,1,13,29,2,11,2,42,0,19 nancy down gifs feel like real ~witch~
1,3,10,40,1,10,0,50,0,justin bieber's cutest moment fan
1,1,6,25,3,5,0,31,0,tell u yourself(ie): ron funches
1,1,11,38,0,11,2,49,0,31 childhood photo amy schumer damn cute
1,1,8,32,0,7,0,40,0,picture prove burning man actual magic
1,1,13,39,1,11,0,52,0,anti-gay preacher got shut boy playing bagpipe
1,2,1,35,0,7,0,36,0,village aiming create white utopia
1,1,10,31,0,10,2,41,0,19 reality woman big boob know true
1,1,6,21,4,4,0,27,0,tell u yourself(ie): steve-o
1,1,14,39,1,13,0,53,0,guy figured way beatbox along siri fire
1,1,6,28,0,6,2,34,0,17 powerful quote racism america
1,2,10,28,1,9,0,38,0,plan funeral we'll tell die
1,1,6,18,0,5,0,24,0,dark art bradford cox
1,1,7,30,1,7,2,37,0,17 valentine's day card long term couple need
1,1,13,38,0,12,0,51,0,thing dick dick pic might actually want see
1,1,14,48,0,13,0,62,0,four question decide tell crush feel
1,1,13,38,1,12,0,51,0,here's use new naked palette suck eyeshadow
1,1,7,25,0,7,2,32,0,24 reason add tattoo wedding
1,1,9,44,0,9,2,53,0,17 delicious winter smoothy jump start morning
1,3,10,52,1,9,0,62,0,vibrator maker secretly tracking customer sexualactivity
1,1,6,24,1,5,2,30,0,18 lol-worthy tumblr post book
1,1,7,19,0,6,0,26,0,need talk james reid
1,3,3,40,0,9,4,43,0,damning 2004 report well fargo chose ignore
1,1,5,25,1,2,0,30,0,buzzfeed crossword: celebribabies
1,1,9,31,0,8,0,40,0,well actually know famous brand logo
1,1,13,47,0,11,0,60,0,maisie williams youtube channel brought sophie turner
1,1,7,28,0,6,0,35,0,chuckled way laughter yoga
1,2,4,32,1,7,0,36,0,city london grapple new eu shake-up
1,3,30,58,3,14,0,88,0,ncaa tournament championship: here's expert picking gonzaga north carolina's showdown
1,1,9,31,1,9,2,40,0,19 perfect gift anyone who's fresh fuck
1,1,8,30,0,7,0,38,0,famous chris leading man
1,3,1,44,2,9,5,45,0,"maryland church ordered evict homeless pay $12,000 fine"
1,3,1,51,1,8,0,52,0,court settle debate thats divided grammar nerd decade
1,2,10,31,4,7,0,41,0,"adl poll: antisemitism low u.s., despite concern"
1,1,14,39,0,10,0,53,0,black lgbt people reveal happened came
1,1,13,42,1,12,0,55,0,choose ugly sweater we'll guess first letter name
1,1,6,25,1,7,2,31,0,7 gorgeous gift card holder cost $0
1,1,9,29,0,8,0,38,0,solve puzzle love board game
1,2,10,33,0,10,2,43,0,woman 20 job title happiest work
1,1,8,28,0,8,2,36,0,18 thing nerdy couple get
1,1,7,29,0,6,0,36,0,beauty product ad actually honest
1,1,9,24,1,8,0,33,0,steak dinner two
1,1,8,41,0,8,2,49,0,17 hilarious confession people attempted twerk
1,1,13,38,4,10,0,51,0,"america finally got episode ""bern enthusiasm"" ""snl"""
1,1,18,68,1,17,0,86,0,watch nerdy daredevil solve rubik's cube skydiving stomach fall as
1,1,12,54,0,12,2,66,0,15 sweet salty dessert infinitely satisfying boyfriend
1,1,10,50,0,10,2,60,0,12 disney channel original movie question impossible answer
1,1,7,32,0,7,2,39,0,12 moment neko atsume fan understand
1,3,2,42,0,7,0,44,0,north korean set celebrate leader amid tension
1,3,8,24,0,9,6,32,0,27 time chris pratt ruined men in2016
1,3,10,49,1,9,0,59,0,"obama order five last minute monuments, presidential history"
1,3,3,44,1,11,4,47,0,"best tv show every year since 2000, according critic"
1,3,8,38,1,8,0,46,0,best college football player never heard
1,1,10,34,0,8,0,44,0,leonardo dicaprio ryan gosling
1,1,10,36,0,10,2,46,0,18 gift perfect anyone love outer space
1,1,11,46,1,11,2,57,0,"15 year ago today, britney justin wore iconic matching denim"
1,1,9,34,1,8,0,43,0,show u best christmas ornament ever made
1,2,11,36,0,10,0,47,0,chris pratt santa claus exactly needtoday
1,2,10,48,6,10,0,58,0,apple's big developer conference today. here's expect. [video]
1,3,6,42,1,8,0,48,0,toronto's peel district school board muslim prayer row
1,1,12,41,2,11,0,53,0,"game play ""the tonight show jimmy fallon"""
1,3,8,41,3,12,2,49,0,"economics new york city blizzard, $1.8 million inch"
1,1,13,37,0,12,0,50,0,fox hound tragic disney film ever made
1,1,12,43,0,12,2,55,0,24 hilarious tweet kid way real every parent
1,1,11,48,2,11,2,59,0,"23 sexy male ""survivor"" contestant guaranteed get hot bothered"
1,1,11,38,0,11,2,49,0,26 office accessory make happier work
1,1,9,27,1,8,0,36,0,here's get haircut actually like
1,1,11,55,3,10,2,66,0,29-year-old's graphic surgery photo show crippling effect arthritis
1,1,14,40,0,13,0,54,0,know song get dance floor based one question
1,3,4,35,0,9,1,39,0,6 wacky ce gadget tell u future
1,2,4,46,2,12,6,50,0,pay what? ato name large company paid zero tax 2014-15
1,2,7,17,1,7,5,24,0,25 best job pay $100k
1,1,10,37,0,9,0,47,0,know name obscure disney character
1,2,9,44,2,11,0,53,0,uc berkeley offer class fake language game throne
1,1,10,35,0,9,0,45,0,guess muppet movie single screencap
1,1,6,23,1,6,2,29,0,pigskin blanket: super bowl 50 pick
1,3,10,42,2,8,1,52,0,camera catch 2-year-old twin epic party bedtime
1,3,6,26,0,5,0,32,0,ten habit incredibly happy people
1,1,8,24,0,8,2,32,0,17 solution good true
1,1,9,31,1,8,0,40,0,here's map canadian see canadian
1,1,13,48,1,12,0,61,0,serious question: katie holmes right best new york
1,3,13,42,1,10,0,55,0,watch: man us catlike reflex catch falling toddler insider
1,1,10,36,2,8,0,46,0,comedian's stand-up special speak soul
1,1,7,31,1,7,2,38,0,11 turkey get eaten thanksgiving
1,3,3,77,0,13,0,80,0,historian predicted donald trump would win presidency forecast impeached
1,2,2,72,0,17,0,74,0,guy went holiday group total stranger greatest reason list
1,1,6,31,1,7,4,37,0,13 amazingly fun halloween costume '90s kid
1,1,8,25,0,7,0,33,0,identify drake kanye
1,2,3,50,5,12,0,53,0,"""spy wild"": animal know we're watching"
1,1,11,49,1,10,0,60,0,bengalis: get post without craving maach instantly
1,1,5,28,2,4,0,33,0,"""halloweentown"" character"
1,2,12,47,2,11,0,59,0,wedding dress would never know made toilet paper [video]
1,1,12,30,2,11,0,42,0,"well know lyric ""colors wind"""
1,3,4,30,2,8,5,34,0,6 wildest celebrity quote 2016 [video]
1,1,9,35,1,8,0,44,0,solange knowles's wedding ring got lost mardi gras
1,1,5,20,0,6,6,25,0,21 thing white people ruined 2015
1,3,3,53,3,9,1,56,0,fast furious 8 early screening reactions: 'another winning entry'
1,1,9,44,0,9,2,53,0,29 beard undercut combination awaken sexually
1,1,12,45,0,11,0,57,0,ed sheeran revealed good reason becoming musician
1,3,13,44,1,13,0,57,0,"teen set fire man sleeping nyc subway, brag friend"
1,1,7,31,2,6,0,38,0,"creed ""rocky"" without racial insecurity"
1,3,16,57,3,18,1,73,0,mega democrat donor tom steyer: world play november 8 way expected
1,1,13,39,0,11,0,52,0,know zodiac sign based wikihow page choose
1,1,12,52,0,12,2,64,0,11 incredibly cool place totally star war staycation
1,3,9,64,5,10,0,73,0,wasserman schultz: hillary using overwhelming popularity advance dialogue
1,3,16,59,2,16,2,75,0,there's beauty pageant camel saudi arabia winner win 31 million dollars!
1,1,9,30,0,9,4,39,0,2016 book reader pumped
1,1,9,37,0,8,0,46,0,color test determine ideal sex position
1,1,11,40,1,10,0,51,0,"running helped cope depression, got injured"
1,1,7,21,0,7,2,28,0,16 sign stubborn live
1,1,5,20,1,5,2,25,0,"43 tweet grapes, fruit"
1,1,13,48,0,13,2,61,0,21 time taylor swift totally understood cat lady life best life
1,1,12,49,3,10,1,61,0,"tried 4 lazy-girl shirt-gapping solutions, got surprisingly lucky"
1,1,9,36,0,9,2,45,0,31 important mental health tip try right
1,2,16,59,3,15,0,75,0,ever wondered people snore don't? here's answer cause snoring
1,1,11,46,1,11,2,57,0,16 immigrant anonymously confess like live away home
1,1,10,32,0,11,6,42,0,25 best guest taylor swift brought stage 2015
1,1,12,47,5,10,0,59,0,"king ""hamilton"" gender-swapped version ""schuyler sisters"""
1,1,14,47,3,13,0,61,0,future gave drake really big ring ('cause need really nice things)
1,1,10,21,1,8,0,31,0,match phone r&b video
1,1,12,54,0,11,0,66,0,mark ruffalo posted shirtless pic promoting breast cancer awareness men
1,1,16,55,0,15,0,71,0,hindu ate beef protest ban challenged extremist kill
1,2,13,59,1,17,1,72,0,"want find best steals, need know 7 secret craigslist success"
1,1,17,44,0,15,3,61,0,grandma went ride life lamborghini speed 165 mph
1,1,8,27,2,9,6,35,0,"35 funniest ""game thrones"" joke 2015"
1,1,11,35,0,10,0,46,0,meghan trainor ariana grande teamed new song
1,1,4,11,0,3,0,15,0,adulty
1,1,8,33,2,7,0,41,0,"season ""american horror story"" connect"
1,1,11,42,1,10,0,53,0,natalie dormer possibly dropped new hint jon snow's fate
1,1,10,36,0,9,0,46,0,need talk khloe kardashian hitting peak
1,1,14,46,0,13,0,60,0,madonna helped couple get engaged middle concert last night
1,1,6,28,1,7,4,34,0,18 crime makeup committed '00s
1,3,3,76,6,17,4,79,0,here u music listener voted 2016 favorite radio song year state-by-state
1,1,7,31,0,7,2,38,0,12 fact candle probably know
1,1,6,17,0,5,0,23,0,moon move
1,1,10,39,0,10,2,49,0,literally 21 mr burn quote picture donald trump
1,1,5,15,0,4,0,20,0,bad selfies
1,1,7,34,0,7,2,41,0,23 people completely get makeup struggle
1,2,1,57,0,12,0,58,0,man sinking car desperately throw infant stranger dry land
1,1,6,31,1,5,0,37,0,what's greatest video game achievement
1,3,9,39,0,9,0,48,0,oscar dress really powerful message behind
1,1,13,48,2,11,2,61,0,14 insanely easy diy valentine's day treat spread serious love
1,1,16,39,0,15,0,55,0,get free car oprah free tub vaseline tyra
1,3,12,24,3,12,0,36,0,took wrong job -- long stay?
1,3,3,46,1,8,0,49,0,malta's azure window rock formation collapse sea
1,1,11,34,1,11,2,45,0,23 people firm grasp what's important life
1,3,7,40,3,10,0,47,0,jeb bush: trump become distraction
1,1,10,26,2,9,0,36,0,"well know game ""life strange"""
1,3,22,15,7,10,1,37,0,"nba awards, part 1: mvp, roy, coy, dpoy, sixth man, mip"
1,2,11,57,2,15,2,68,0,sri lanka sell 80% stake strategically placed harbor chinese india real time
1,3,2,65,3,9,0,67,0,child-sharing: meet straight female friend who've legally adopted together
1,2,7,34,0,7,4,41,0,watch newly unearthed 2013 kanye west interview
1,3,6,18,0,6,1,24,0,5 yoga move tone ab
1,1,13,31,0,12,0,44,0,baby kitten best friend wake nap
1,1,9,37,0,8,0,46,0,favourite pixar character say
1,1,14,47,0,13,0,61,0,badass woman taking selfies show harvest like bos
1,1,9,34,1,10,4,43,0,22 stupid easy tip make window 10 much better
1,1,7,23,0,6,0,30,0,state actually belong
1,1,8,30,1,7,2,38,0,20 incredible tv show kiss never forget
1,1,9,35,0,9,2,44,0,13 picture perfectly sum black drunk
1,1,10,37,0,9,0,47,0,sign date based favourite metal
1,1,12,39,0,12,4,51,0,know favorite song 2000s based zodiac sign
1,3,16,71,1,15,0,87,0,espns stephen smith call respect trump black community following steve harvey backlash
1,3,9,39,1,9,4,48,0,nfl free agency: predicting biggest bust 2017 signing
1,2,9,42,2,8,0,51,0,actor t.j. miller arrested allegedly slapping uber driver
1,3,10,37,1,9,0,47,0,electric car startup missing one thing: cash
1,1,11,28,2,10,0,39,0,"know food ""facts"" true false"
1,1,9,37,0,9,2,46,0,21 tweet depression might make laugh
1,1,12,31,3,11,0,43,0,"remember word ""you're one want"""
1,2,2,59,2,15,0,61,0,"yahoo hack: know account breached, next"
1,1,13,56,0,12,0,69,0,grab earphone listen instrumental taylor swift medley right
1,1,9,30,0,8,0,39,0,make tasty kimchi queso slay life
1,1,8,28,5,8,2,36,0,"21 ""miley, what's good?"" item actually"
1,1,11,36,0,11,4,47,0,2016 world tour see based birth month
1,1,5,13,0,4,0,18,0,pet human
1,1,10,36,2,9,0,46,0,what's favorite lana del rey song exist
1,1,10,31,1,10,1,41,0,9 way save money shopping kids' section
1,1,12,44,0,11,0,56,0,woman extreme knitting giant blanket look cosy
1,2,3,55,1,10,0,58,0,olympics washington didnt win could still transform city
1,3,8,45,0,7,0,53,0,top bartender reveal favorite winter cocktail recipe
1,1,11,29,2,9,1,40,0,carrie fisher's dog gary went crazy met bb-8
1,1,13,35,0,12,0,48,0,wore bellabeat leaf week happened
1,1,11,33,0,11,2,44,0,21 thing girl hate bra shopping know true
1,1,7,18,0,6,0,25,0,true harry potter fan
1,1,15,52,2,13,2,67,0,92-year-old killing bharatanatyam make feel like unfit potato
1,1,7,32,0,7,1,39,0,7 stage carving thanksgiving turkey
1,1,12,55,0,12,2,67,0,27 scared men sacrificing girlfriend fright save
1,2,3,60,4,13,2,63,0,"houston, problem: amazing history iconic apollo 13 misquote"
1,1,8,25,2,8,2,33,0,"19 life lesson learned ""bring on"""
1,1,10,33,0,10,2,43,0,23 nerdy kid restore faith future
1,3,11,56,0,11,0,67,0,alabama governor appoints luther strange replace ag jeff session senate
1,1,9,27,0,8,0,36,0,emojis need illuminati
1,1,12,36,1,11,0,48,0,"shut down, finest moment human history"
1,3,1,33,1,5,0,34,0,"please get along, people tell president"
1,1,10,32,1,9,0,42,0,talk prince harry's beard right
1,1,5,14,0,4,0,19,0,dating merman
1,1,8,14,2,6,0,22,0,"tv show ""g"""
1,1,10,31,0,9,0,41,0,quiz tell naked palette get
1,1,7,16,1,5,0,23,0,go-to happy song
1,1,9,28,0,8,6,37,0,32 strangely beautiful picture nyc 1970s
1,1,12,50,2,12,2,62,0,"29 ""harry potter chamber secrets"" title actually accurate"
1,2,8,41,1,7,0,49,0,change investment president trump?
1,2,2,55,1,15,0,57,0,man created sex doll weird think list
1,1,9,37,0,9,2,46,0,21 awesome holiday thing actually find target
1,2,2,77,2,17,0,79,0,"woman's story lesson always, always listen girlfriend list"
1,1,13,29,3,10,0,42,0,"cast ""bob's burgers"" look like irl"
1,1,12,51,1,11,0,63,0,ariana grande perfect response accusation skinny
1,1,9,34,0,8,0,43,0,thread count make difference bed sheet
1,1,11,39,1,10,0,50,0,gay men asked straight men they've always wanted know
1,1,9,29,2,8,0,38,0,"north, south, central new jersey"
1,1,11,36,0,10,0,47,0,weekend based zodiac sign
1,3,2,50,2,9,0,52,0,carrier's owner cave fear losing federal contracts?
1,1,10,48,0,9,0,58,0,take picture test determine dominant personality trait
1,1,5,23,0,5,2,28,0,31 real san francisco problem
1,1,7,23,0,6,0,30,0,brave thing today
1,1,12,38,1,10,0,50,0,know movie one-time oscar winner
1,1,14,45,1,13,0,59,0,here's use toothpick make brownie look like spiderweb
1,3,11,50,3,11,0,61,0,"accumulate ""soft skills"" complement mba ashford university"
1,2,12,46,2,10,0,58,0,want boycott trump-friendly companies? apps aim assist
1,1,7,29,0,7,1,36,0,7 essential packing hack next trip
1,3,3,36,0,6,0,39,0,unpredictability play north korea
1,1,12,48,1,11,0,60,0,know whether extrovert introvert based instagram
1,1,12,41,0,12,1,53,0,7 weeknight dump dinner make slow cooker
1,2,17,67,0,17,3,84,0,eman lost 120 kilo surgery suffering failure heart frequent epileptic fit
1,1,8,22,0,8,1,30,0,3 easy breakfast make mug
1,1,10,30,0,10,2,40,0,18 thing change way look adele
1,1,12,53,1,11,0,65,0,stop go stalk incredibly beautiful makeup artist
1,2,2,60,1,11,0,62,0,one tokyo restaurant's success failure decided panda sex
1,3,6,39,0,5,0,45,0,maybelline introduces first male makeup ambassador
1,1,11,34,2,10,0,45,0,"whitney port ""the hills"" still shocked ever"
1,2,16,57,3,17,2,73,0,pak's passport officer think 31 day feb internet fun expense!
1,1,9,32,0,9,2,41,0,22 tweet neat freak totally relate
1,1,8,30,0,7,0,38,0,veteran play call duty pro gamers
1,2,8,24,0,8,2,32,0,26 sex toy actually get jobdone
1,3,11,31,5,10,2,42,0,"27 creepy af santa photo thatll make say ""why?!"""
1,2,15,76,3,14,0,91,0,abc nightline issue correction misrepresenting fleischer make seem critical spicer
1,1,14,49,2,13,0,63,0,"first ""finding dory"" trailer suggests dory went missing"
1,1,15,31,0,10,0,46,0,feel like someone call bff bff
1,3,11,44,3,12,0,55,0,fake news: judge neil gorsuch found fascist club school
1,3,6,28,0,6,1,34,0,9 thing people impostor syndrome
1,1,7,27,0,6,0,34,0,sign grew southern california
1,1,7,28,2,7,0,35,0,reliable memory? street tested
1,1,12,42,0,12,0,54,0,let puppy proposal help forget world going shit
1,1,9,31,1,8,0,40,0,here's make pumpkin spice mini cookie pie
1,1,7,39,0,7,2,46,0,21 really funny relatable tweet thanksgiving
1,1,11,35,1,11,2,46,0,17 thing single valentine's day
1,1,10,35,2,9,0,45,0,"world reacted adele releasing ""hello"""
1,1,6,28,2,5,0,34,0,"""grease"" character soulmate"
1,3,2,78,2,16,0,80,0,"great cough syrup con: medicine buy chemist virtually effect, say scientist"
1,3,2,76,3,14,0,78,0,doom gloom: funeral director reveals jaw-dropping moment career
1,1,7,30,0,7,2,37,0,22 photo guaranteed annoy anyone bakes
1,2,2,70,4,15,0,72,0,'it's common think': need know abortion according expert
1,1,11,60,0,10,0,71,0,everyone losing mind amazing toasted marshmallow milkshake
1,3,14,37,3,11,5,51,0,"nasa planning land asteroid worth $10,000 million billion!"
1,1,11,38,1,10,2,49,0,15 time kate winslet give af anyone thought
1,3,9,41,1,7,0,50,0,five cringe-worthy move make look unprofessional
1,2,4,35,4,8,2,39,0,"'orphan black' season 3, episode 9 recap: family tie"
1,2,12,67,4,13,0,79,0,"mike morell, cited russia hacking stories, work longtime clinton aide phillippe reines"
1,1,5,17,0,4,0,22,0,try something new
1,2,3,44,1,7,0,47,0,unmistakable anatomy president trump flip-flop
1,1,11,39,0,10,0,50,0,disney villain enemy based zodiac sign
1,1,8,24,0,7,0,32,0,guy feel fake boob first time
1,1,14,55,1,13,0,69,0,little girl dressed fairy crush skateboarding trick adorable
1,3,1,25,0,4,0,26,0,austrian town seek new hermit
1,3,2,47,0,11,0,49,0,man went missing found inside python list
1,3,9,52,1,10,0,61,0,shock berkeley poll: california voter want democrat work trump
1,1,8,31,4,8,2,39,0,"well remember ""grey's anatomy"" season 1-5"
1,1,9,38,0,8,0,47,0,color inkblot test reveal sexual fantasy
1,1,8,29,0,8,1,37,0,7 yule log cake literally look like shit
1,1,10,28,2,10,4,38,0,17 thing never say girl 5-foot-9
1,1,7,32,0,7,2,39,0,23 word disney fan really understand
1,2,14,47,0,14,0,61,0,clown show could lead government shutdown month
1,1,11,51,0,10,0,62,0,target customer confused porn played loudly intercom
1,3,12,34,0,11,0,46,0,say millennials want save world
1,3,10,28,1,10,7,38,0,ncaa tournament 2017: 1 prop bet every sweet 16 game
1,1,13,43,3,13,2,56,0,"21 reason ""it's wonderful life"" best christmas movie time"
1,1,8,28,0,7,0,36,0,color test reveal sex secret
1,1,14,31,1,10,2,45,0,18 punk grunge-themed shop need check asap
1,1,16,51,0,16,2,67,0,zac efron hugged random girl 30 second romantic thing ever
1,3,11,69,6,11,0,80,0,"twitter announces censoring search results, low-quality tweet combat abuse harassment"
1,1,9,33,2,8,0,42,0,actor who's everywhere want famous
1,1,11,32,3,9,0,43,0,"get first look horror-comedy ""the final girls"""
1,1,7,23,1,6,0,30,0,lady gaga's old apartment rent
1,3,6,17,0,6,2,23,0,17 dog made hugemistake
1,1,12,37,2,12,2,49,0,"31 thing ""harry potter"" could nickname dick"
1,1,13,49,0,13,2,62,0,21 hilarious tweet ghost make laugh loud every time
1,1,13,52,0,12,0,65,0,know favorite disney channel original movie based zodiac sign
1,1,7,35,1,6,0,42,0,russia's nomadic reindeer herder face future
1,2,7,31,0,7,0,38,0,director joss whedon call ivanka trump dog
1,1,9,31,1,8,0,40,0,tried magic wand here's happened
1,2,10,46,2,9,0,56,0,"john podesta violate federal financial disclosure laws, nah?"
1,1,7,45,0,6,0,52,0,photographer gregory crewdson release haunting new series
1,2,1,60,1,13,0,61,0,"longer life, researcher say eat many fruit veggie per day"
1,1,6,31,0,6,2,37,0,12 chart woman instantly understand
1,1,10,39,0,10,2,49,0,26 totally awesome product make life fun
1,1,11,42,0,11,2,53,0,21 funny tweet dating guaranteed make laugh
1,1,9,35,0,8,0,44,0,would thank oscar acceptance speech
1,3,5,32,2,8,9,37,0,"report: 90,000 christian killed faith 2016"
1,2,11,47,3,10,0,58,0,police: suspect killed attacking az trooper u illegally
1,1,10,37,0,10,2,47,0,15 adorable item everyone grew eating pan dulce
1,1,13,45,1,11,0,58,0,baby failing christmas make laugh/cry desk
1,1,6,20,2,5,0,26,0,"well know ""portlandia"""
1,1,6,23,0,5,0,29,0,know actual favorite movie
1,3,12,54,2,11,0,66,0,student mob shuts blue life matter lecture claremont mckenna college
1,1,7,38,0,7,2,45,0,19 euphoric experience people love stationery
1,1,6,15,0,5,0,21,0,adele going call
1,1,10,41,0,9,0,51,0,shopping clothes make question entire life
1,3,5,58,1,12,0,63,0,lindsay lohan starting hijab fashion line? star post clue instagram
1,1,11,37,3,9,0,48,0,"star war carbonite ""pop-tarts"" cool word"
1,1,12,45,0,12,2,57,0,17 hilarious tweet final week make laugh loud
1,2,11,34,1,7,0,45,0,red alert politics: milo outsell hillary clinton
1,1,14,53,1,13,0,67,0,lupita nyong'o perfect response lack racial diversity oscar
1,2,2,45,2,9,0,47,0,ultimate moscow quiz paying attention?
1,1,9,30,0,8,0,39,0,lil mama managed become hilarious meme
1,2,11,44,3,10,0,55,0,"new ""beauty beast"" feature disney first gay character"
1,2,6,36,0,6,0,42,0,president obama hit twitter celebrate legacy
1,3,10,49,1,10,2,59,0,13 weird christmas tradition around world thatll surpriseyou
1,3,11,46,3,11,0,57,0,dem rep cohen: hopefully mother earth survive next four year
1,1,11,47,0,10,0,58,0,jessica lange showed emmy rocking transition lens glass
1,1,13,55,1,12,0,68,0,indian tweeting advice younger self damn heartwarming
1,2,14,60,0,14,2,74,0,child young 13 attending smartphone rehab centre cure addiction
1,1,12,50,3,11,0,62,0,"here's mindblowing ""harry potter"" fan theory avada kedavra curse"
1,2,3,35,2,9,4,38,0,wale v belgium: euro 2016 qualifier happened
1,3,6,36,0,6,0,42,0,firebrand wilder lead ahead dutch election
1,2,2,58,4,10,2,60,0,18 sticks...and sign neighbourhood hit peak gentrification
1,1,10,41,0,9,0,51,0,free health fitness apps everyone know
1,1,7,17,0,5,0,24,0,classic tv show
1,1,7,23,0,7,2,30,0,10 celebs look hotter man bun
1,1,11,39,1,11,2,50,0,27 time celebs care looked like grammys
1,1,14,56,3,13,0,70,0,"thousand people sharing diplo's facebook post filming ""lean on"" india"
1,1,10,35,0,8,0,45,0,well remember classic gamecube game
1,1,8,36,1,8,2,44,0,15 reason canadian actually happy fall
1,3,13,49,1,13,0,62,0,"adele katy perry, hollywood obsessed crystal"
1,1,6,25,0,5,0,31,0,new burrito emoji problematic
1,3,11,32,0,12,6,43,0,10 promising job 2017 skill need get
1,1,12,48,0,12,2,60,0,24 productive thing successful people first hour day
1,3,13,56,1,16,1,69,0,"7 big revision republican made health care bill, made"
1,1,10,34,0,9,0,44,0,tell used make masterpiece
1,1,7,20,0,6,0,27,0,yoga pilate
1,1,11,41,1,10,0,52,0,"hey america, need talk terrible ketchup habit"
1,3,12,50,2,10,4,62,0,trump suggests gop need 2018 craft 'wonderful' obamacare replacement
1,1,6,25,0,5,0,31,0,find horoscope november
1,1,8,31,3,7,0,39,0,"drake's video ""hotline bling"" finally"
1,3,0,67,1,11,2,67,0,19 cocktail probably never heard start drinking immediately
1,2,1,84,0,15,0,85,0,new safety advice issued combined oral contraceptive review pill blood clot risk
1,1,7,29,0,6,0,36,0,name fictional language
1,1,11,43,0,10,0,54,0,know favorite christmas movie based single question
1,1,7,24,0,8,6,31,0,top 10 google search 2015
1,3,4,35,2,7,1,39,0,"master round 3 grades: spieth, garcia make wave"
1,1,14,60,0,13,0,74,0,heartwarming photo captured moment woman bought food homeless stranger
1,1,3,11,0,2,0,14,0,history santa
1,1,8,31,1,8,2,39,0,23 reason follow @polls twitter
1,1,10,42,0,10,2,52,0,17 situation real naturally unlucky people
1,1,6,19,0,5,0,25,0,donald trump popular
1,1,11,41,0,11,2,52,0,13 chart perfectly sum reality planning wedding
1,1,8,28,0,8,2,36,0,25 brilliant way eat apple fall
1,1,13,36,0,12,0,49,0,name flag every country rugby world cup
1,1,14,47,2,13,0,61,0,"watch leah remini get scared shitless clown ""dancing stars"""
1,1,5,18,2,6,4,23,0,coming out: 1st time vs. 101st time
1,1,13,44,2,12,0,57,0,"identify ""the lord rings"" character eye"
1,3,6,37,1,7,0,43,0,major element trump new immigration policy
1,1,7,35,1,6,0,42,0,celebrity react snapchat's new selfie filter
1,2,5,85,3,17,0,90,0,could imagination making fat? vivid thought 'trigger food craving encourage eat more'
1,3,13,43,3,11,0,56,0,recent u.s. terror plot hear donald trump talking
1,3,5,64,2,14,4,69,0,odds 2020 presidential election (from elizabeth warren kanye west)
1,3,5,38,3,9,0,43,0,word day: cory booker explains 'freedom' bert
1,1,10,32,0,9,0,42,0,tried patti labelle pie lost damn mind
1,1,9,42,0,9,2,51,0,26 priceyish thing definitely buy twenty
1,1,11,43,3,11,2,54,0,"thing got rather awkward '90s kid danced ""macarena"" solo"
1,1,7,25,0,8,6,32,0,15 proposal proved love alive 2015
1,3,15,49,1,13,0,64,0,shia labeouf anti-trump art project shut fourth time move uk
1,3,1,65,0,8,0,66,0,biodegradable paper airplane could revolutionize humanitarian aid
1,1,11,42,0,11,2,53,0,22 thing everyone love oscar isaac understand
1,1,8,31,0,7,2,39,0,32 time spongebob perfectly summed life
1,1,9,37,0,9,2,46,0,30 time people took passive aggression next level
1,3,11,37,3,11,4,48,0,"""office"" scholar get 15/15 michael scott quiz"
1,1,8,39,1,8,2,47,0,28 delightful free phone wallpaper make smile
1,1,14,51,1,12,0,65,0,ariel winter breast reduction scar body-shaming
1,1,10,31,1,8,0,41,0,zendaya rocking full-on mullet grammys
1,1,4,24,0,4,2,28,0,16 nerdily perfect christmas tree
1,3,4,56,3,12,1,60,0,8 tip staying productive youre never office (hp australia)
1,1,10,36,1,9,0,46,0,wendy williams spill tea summer's hot gossip
1,1,11,40,2,11,2,51,0,"21 reason ""harry potter"" actually worst series time"
1,1,6,23,0,5,0,29,0,thing christian want know
1,2,2,38,4,8,2,40,0,"womadelaide turn 25, count 'world music'?"
1,1,4,23,0,4,2,27,0,19 truly awkward lube confession
1,1,5,20,0,5,2,25,0,17 tattoo makeup lover
1,3,9,46,0,12,0,55,0,check last time someone read wrong winner oscar
1,2,16,52,5,15,0,68,0,stephen a. smith joke women's world cup player want 'mess hair up'
1,1,14,47,2,13,0,61,0,"ed sheeran quit social medium stop ""seeing world screen"""
1,1,10,38,1,10,2,48,0,17 thing secretly satisfying old heart
1,1,11,43,2,11,2,54,0,"10 ""friends"" trivia question every true fan able answer"
1,1,12,36,2,10,0,48,0,"tv channel done perfect joke ""groundhog day"""
1,2,9,49,1,11,0,58,0,trump call world leader upsetting decade diplomacy
1,1,11,36,1,10,0,47,0,what's best life advice ever got grandma
1,1,11,40,0,11,2,51,0,22 thing scottish people trying tell year
1,1,11,39,0,10,0,50,0,guy animated class doodle epic dance video
1,3,10,60,3,12,0,70,0,"unity: bill hillary clinton, george laura bush attend trump inauguration"
1,3,8,36,1,8,2,44,0,18 true crime conspiracy theory thatll creep youout
1,1,9,42,0,9,2,51,0,11 halloween costume destroy faith humanity
1,1,12,32,0,11,0,44,0,close eggnog handful mayonnaise
1,1,12,57,3,11,0,69,0,"here's kelly bishop said filming ""gilmore girls"" without edward herrmann"
1,2,13,44,4,12,0,57,0,"cop break car free 'frozen' elderly woman, find mannequin"
1,2,11,44,0,10,0,55,0,amber tamblyn sum messiness breastfeeding one photo
1,2,9,37,1,10,0,46,0,"trump dig wiretap, matter say differently"
1,1,8,30,0,8,2,38,0,23 insanely cozy robe spend weekend
1,3,4,32,0,7,0,36,0,ultimate app guide super bowl sunday
1,2,4,43,1,7,0,47,0,dick costolo tweet resignation business insider
1,1,16,42,0,15,0,58,0,help people find kid give real messi shirt
1,2,3,47,1,8,0,50,0,syria conflict: british surgeon cannot forget girl
1,2,1,69,4,14,0,70,0,russian teenager 'set fire' trying take 'ultimate selfie' train roof
1,1,14,36,0,13,0,50,0,adele cover vogue looking like damn piece art
1,3,2,29,0,7,0,31,0,sun helped spark life earth
1,3,9,37,1,9,1,46,0,president obamas 3 tip get politically active
1,2,3,73,0,13,0,76,0,interview ukip candidate get terrifying every paragraph read list
1,1,11,41,0,11,2,52,0,21 amazing side dish make forget turkey
1,2,17,64,2,18,1,81,0,"whining social medium get punished, army chief tell staff 5 major read today"
1,1,11,39,0,10,0,50,0,need see incredible graphic bond girl outfit
1,1,10,38,1,10,2,48,0,"17 emotion every canadian knows, told carly rae jepsen"
1,3,8,24,1,8,1,32,0,guess 5 questions?
1,1,10,32,0,10,2,42,0,23 insanely cool thing baby food jar
1,1,9,41,1,8,0,50,0,favorite fandom's technology powerful
1,1,7,20,0,7,2,27,0,24 best design fails time
1,1,11,30,1,10,0,41,0,played bizarre sex toy
1,1,12,45,2,11,0,57,0,"hedley give u exclusive stripped cover song ""hello"""
1,1,6,16,1,5,0,22,0,ex
1,1,15,66,1,14,0,81,0,"game throne map magically materializes coffee shop bench, white walker apocalypse nigh"
1,1,16,55,0,15,0,71,0,royal world series could watch paul rudd get sprayed champagne
1,1,11,31,0,11,2,42,0,13 cute easy way style natural hair party
1,3,2,58,1,12,0,60,0,nintendos weird wonderful switch console may hard sell
1,1,13,38,0,12,0,51,0,sale urban outfitter fucking
1,2,2,44,0,13,0,46,0,safest place sit plane list
1,2,9,34,0,8,0,43,0,watch big sean spit freestyle funkmaster flex
1,2,9,34,1,8,0,43,0,solve anagram classic book titles?
1,1,11,37,1,10,0,48,0,sex beginning relationship vs. one year
1,1,12,44,3,9,0,56,0,here's day-after-thanksgiving workout barely move
1,3,9,53,4,7,0,62,0,whistle-blower: global warming data manipulated paris conference
1,1,6,21,0,5,0,27,0,ghost name actually
1,1,6,21,1,5,2,27,0,12 mind-blowing way eat polenta
1,2,2,47,4,13,0,49,0,now? woman tipped make 'a man's world'
1,1,9,40,1,7,0,49,0,song sexy halloween costume scary-accurate
1,1,13,55,4,11,0,68,0,"two plus-size model year's ""sports illustrated"" swimsuit edition"
1,3,12,30,1,7,0,42,0,three american car make iihs safest-car list
1,1,10,48,0,9,0,58,0,woman turned mermaid fulfilled childhood dream
1,1,8,31,1,8,1,39,0,7 healthy food trick actually want try
1,2,1,46,1,7,2,47,0,uber driver threaten rebellion $40bn company
1,1,11,37,0,10,0,48,0,dating site disney fan exists magic real
1,1,5,22,0,4,0,27,0,drawing anxiety feel like
1,3,2,69,1,16,2,71,0,"liam neeson 22 actor gained lost weight film roles, picture"
1,1,6,33,0,6,2,39,0,25 healthier version favorite dessert
1,1,6,20,0,5,0,26,0,stevie nick song
1,1,8,35,0,8,2,43,0,20 solo cappella video truly masterpiece
1,1,10,27,3,7,0,37,0,"stephanie mill destroyed u nbc's ""the wiz"""
1,1,6,24,2,5,0,30,0,"""the fosters"" character"
1,1,8,33,0,8,1,41,0,7 easy way eat healthier without even noticing
1,1,9,38,0,8,0,47,0,jim halpert costume wear halloween
1,1,9,37,1,9,0,46,0,student tell reason teacher annoying
1,1,13,55,1,11,0,68,0,artist make extremely detailed portrait using fire impressive af
1,1,14,49,4,12,0,63,0,"j.k. rowling responded perfectly critic ""harry potter"" play cast"
1,1,8,38,2,8,1,46,0,"7 ""scream queens"" question impossible answer"
1,3,17,61,8,14,0,78,0,"fncs cavuto: trump saint, press consistent inconsistency hardly without sin"
1,2,4,45,0,8,0,49,0,donald trump announces abrupt change u foreign policy
1,3,12,46,1,11,0,58,0,choose squiggle i'll tell everybody love
1,1,12,51,2,11,0,63,0,"someone made amazing mashup video mariah carey ""shading"" ariana grande"
1,1,12,56,2,11,0,68,0,there's weird geographical quirk sweden's match denmark week
1,3,18,72,2,17,0,90,0,canine truly virat kohli's best friend! team india skipper bond sniffer dog prince pune stadium
1,1,8,39,0,8,1,47,0,8 hilarious comic book lover understand
1,3,16,64,3,15,0,80,0,twinkle khanna wonder she'll feel patriotic paying watch ranveer undies!
1,3,1,56,1,10,0,57,0,"injecting natural oil muscle gain could deadly, doctor warn"
1,1,7,18,0,6,0,25,0,pinky brain
1,1,7,29,0,6,0,36,0,eat healthier without even noticing
1,1,14,56,1,13,0,70,0,video perfectly describes like single home holiday
1,3,8,46,1,8,0,54,0,"commodity rally slows, currency investor get creative"
1,1,11,41,3,10,0,52,0,"people meltdown kid's cover ""trap queen"""
1,1,9,37,2,8,0,46,0,"women, drinking water wrong whole life"
1,1,11,35,1,11,2,46,0,23 weird thing see display science museum
1,3,1,45,2,9,6,46,0,"someone stole $100,000 worth blueberry need answer"
1,1,6,20,0,6,1,26,0,6 girl meet halloween
1,1,14,45,2,13,0,59,0,"""find panda"" pic people losing shit"
1,1,6,18,0,6,4,24,0,best frank ocean song 2015
1,2,23,50,4,16,2,73,0,here discovery 7 wonder trappist-1 solar system important far
1,2,14,41,1,13,0,55,0,lower back giving hard time? yoga could solution
1,1,11,45,1,11,2,56,0,62 thought we've shopping target holiday
1,1,6,28,0,5,0,34,0,scariest halloween candy taste test
1,2,10,31,0,8,0,41,0,look like jpmorgan building robo adviser
1,1,11,29,1,10,0,40,0,well know word adele's new album
1,1,9,36,0,8,0,45,0,boyfriend peeta mellark peter griffin
1,1,12,35,1,10,0,47,0,best friend's wedding might getting tv show sequel
1,1,6,24,0,6,2,30,0,33 canadian sentence ever
1,1,12,39,4,11,0,51,0,"remember lyric ""naked mole rap"" ""kim possible"""
1,2,5,46,2,11,0,51,0,'beauty beast' vr delivers disney magic touch
1,1,7,21,0,6,0,28,0,mom wrong year
1,1,5,12,3,4,0,17,0,"i'm bipolar, i'm"
1,1,8,28,0,7,0,36,0,evil star war faction would join
1,1,6,24,0,5,0,30,0,thanksgiving side dish
1,3,11,60,0,11,0,71,0,cleveland cavalier cavalier fan traveled memphis night lebron james rested
1,2,4,65,4,14,0,69,0,"yes, lavar ball ridiculous ... college basketball could use people like"
1,1,13,43,2,12,0,56,0,"would ""harry potter"" best friend based zodiac sign"
1,2,12,63,2,13,0,75,0,tech startup woo investor unconventional financial metric number add up?
1,3,8,30,1,7,0,38,0,cynical compared everyoneelse?
1,1,9,28,4,8,0,37,0,"liked ""uptown funk,"" love song"
1,1,12,45,2,11,0,57,0,"ice cube, kevin hart, conan might worst driving instructor"
1,1,11,41,1,10,0,52,0,michael b. jordan gorgeous perfect golden globe
1,3,3,50,1,10,0,53,0,brad pitt didnt attend oscar busy sculpting
1,1,7,23,0,7,2,30,0,17 tiger giant cat
1,1,7,37,0,7,2,44,0,17 medieval snail perfectly summarise life
1,3,11,40,1,9,0,51,0,bar exchange show eu brexit negotiator get deal done
1,2,2,49,1,10,0,51,0,hack vote: cyber expert say ballot machine easy target
1,1,7,22,0,6,0,29,0,date weeknd drake
1,1,10,47,1,8,0,57,0,martian prof science totally action-adventure worthy
1,2,9,26,2,9,2,35,0,24 joke wont get dont wearglasses
1,1,9,45,0,8,0,54,0,color test determine dominant personality trait
1,1,9,35,0,9,2,44,0,16 text might actually get birth control
1,1,5,16,0,5,2,21,0,11 awesome sale shop
1,2,18,57,1,15,0,75,0,cop madhya pradesh get thrashed brutally issuing fine bjp leader's relative
1,2,13,63,3,14,0,76,0,washpost: never trump republican complain never getting job new white house
1,1,11,33,0,10,0,44,0,feel like everyone making art
1,3,18,62,1,15,0,80,0,commuter left shocked someone played porn led screen delhi's rajiv chowk metro station
1,3,5,68,2,15,0,73,0,angela merkel pick hanging obama hanging trump. blame her?
1,1,15,52,0,14,0,67,0,watch mom surprise trans daughter news name change legal
1,1,5,19,0,4,0,24,0,doritos flavor
1,3,2,22,0,3,0,24,0,stubhub finally get social
1,1,8,29,2,7,0,37,0,"well actually remember ""hey arnold"""
1,3,4,38,3,10,3,42,0,apple fan saved $300 (apple book included)
1,1,8,24,0,7,0,32,0,love bed people
1,1,8,37,1,8,1,45,0,9 bollywood couple we're awkwardly still
1,2,6,26,2,5,4,32,0,l.a. film festival 2015 showcase diversity
1,1,11,40,3,10,0,51,0,here's like physically can't pierce ear
1,3,7,34,0,8,0,41,0,steve ballmer serf fascinating data trove
1,3,2,28,1,7,0,30,0,fed's rate hike mean
1,1,8,24,2,7,2,32,0,"27 time tiffany ""daria"" iconic af"
1,3,12,43,1,12,3,55,0,best photo president trump's first 100 day
1,1,14,65,2,13,0,79,0,"physicist tweeted gravitational wave ""may discovered"" people excited"
1,3,13,62,0,13,0,75,0,swedish police chief shut interior minister call deport terror suspect
1,1,7,28,0,6,0,35,0,anxious people actually hear
1,3,4,50,1,8,0,54,0,amber tamblyn reveals baby name via hillary clinton humble-brag
1,1,10,45,0,9,0,55,0,stephen colbert nail social medium support paris matter
1,1,8,28,3,7,0,36,0,turtleneck battle: drake vs. nick jonas
1,1,7,31,0,7,2,38,0,19 thoughtful gift office best friend
1,1,12,37,0,11,0,49,0,tried find perfect nude lipstick high street
1,3,13,70,1,14,0,83,0,john legend's twitter account hacked threaten donald trump thirst hillary clinton
1,1,15,49,3,14,0,64,0,"people upset rey missing ""star wars: force awakens"" toy set"
1,3,6,34,2,8,4,40,0,ce 2017: tech preview la vegas's biggest launch
1,3,1,13,1,2,0,14,0,golf exercise?
1,3,2,49,2,9,0,51,0,e-cigarettes safer tobacco? new study fire debate
1,2,1,51,1,17,0,52,0,lose memory age stop
1,3,5,52,0,9,0,57,0,kid brilliantly recreated viral bbc interview list
1,1,11,55,0,10,0,66,0,incredible makeup artist transform anyone anything
1,3,3,46,2,6,0,49,0,ex-trump university student want president's apology
1,2,10,34,0,9,0,44,0,food craving reveal pop diva youare
1,3,14,55,1,13,0,69,0,"michelle barack obama proving yes, retirement really bestthing"
1,1,11,46,0,10,0,57,0,tried beauty subscription service catering woman colour
1,1,15,63,3,14,0,78,0,"acrobatic hoverboard choreography justin bieber's ""sorry"" may best thing see"
1,1,9,28,0,9,2,37,0,21 movie old enough drink year
1,1,10,41,0,10,2,51,0,24 thing people slightly obsessed reading know true
1,1,15,24,2,11,0,39,0,time make snap decision: nyc la
1,1,9,30,1,8,0,39,0,here's make delicious whiskey pecan pie
1,3,13,46,1,12,0,59,0,"entrepreneur build better power network, one dinner time"
1,1,10,45,0,9,0,55,0,artist illustrated popular witch result spooky
1,3,1,32,3,8,0,33,0,'you never know make back'
1,3,5,46,3,13,1,51,0,bos baby no. 1 movie north america second weekend
1,1,7,48,1,7,2,55,0,20 mouthwatering breakfast sandwich nurse hangover
1,1,6,26,0,5,0,32,0,cringingly british abroad
1,1,13,64,0,12,0,77,0,government officer caught playing candy crush meeting farmer grievance
1,2,7,48,4,11,0,55,0,"super bowl cheat sheet: brady, curry, gaga falcons' best chance"
1,1,11,36,0,10,0,47,0,watch two men jetpacks fly alongside jumbo jet
1,1,13,59,0,13,2,72,0,18 woman endometriosis reveal want everyone know struggle
1,1,10,34,1,10,2,44,0,"21 hilarious tweet life way, way real"
1,3,5,67,1,11,0,72,0,"australia consider shorter working week, green leader richard di natale say"
1,2,2,27,2,6,3,29,0,"donald trump's first 100 days, tweet"
1,3,14,48,1,14,1,62,0,7 fact potato didnt know want telleveryone
1,3,2,36,0,8,0,38,0,mystery giant metal die solved idaho
1,1,4,11,0,4,2,15,0,12 day khaled
1,1,10,47,1,9,0,57,0,here's native american say christopher columbus
1,3,3,35,0,8,0,38,0,apple unveils way find lost airpods
1,1,15,52,0,14,0,67,0,hayao miyazaki making magical nature park child visit
1,1,10,38,0,9,0,48,0,tonsil stone thing probably learn
1,1,12,47,0,11,0,59,0,try guess halloween candy smashed
1,3,8,39,2,7,0,47,0,bizarre topshop mom jean shopper confused
1,3,7,26,0,7,2,33,0,20 forced rhyme pop music history
1,3,9,34,0,8,0,43,0,quit job another
1,2,11,60,3,13,0,71,0,escaped chibok girl anniversary abduction boko haram:bring girl back
1,1,10,39,0,9,0,49,0,know favorite animal based favorite color
1,1,9,40,1,9,2,49,0,25 hysterical tweet lottery make laugh
1,2,8,25,0,9,6,33,0,17 time sex almost went fucking far in2016
1,1,8,29,0,7,0,37,0,pursuing happiness trans woman color
1,1,11,41,1,10,0,52,0,here's famous face attended london fashion week
1,1,6,24,0,5,0,30,0,hailee steinfeld song
1,1,8,30,1,8,2,38,0,24 drink order drinking
1,1,9,40,0,8,0,49,0,watch tiny hamster throw adorable halloween party
1,1,8,26,0,8,2,34,0,11 sex toy story make cringe
1,1,6,29,0,5,0,35,0,would pas environmental science
1,1,5,13,0,4,2,18,0,21 cosy af bedroom goal
1,2,11,64,1,14,1,75,0,$1 accessory michelle williams sienna miller rocked golden globe red carpet
1,1,9,34,2,9,2,43,0,19 thing get obsessed hummus
1,1,11,32,0,10,0,43,0,know zodiac sign based taste music
1,1,15,26,0,9,2,41,0,13 question bsb nkotb fan tired hearing
1,1,10,35,0,10,2,45,0,85 thought canadian shopping america
1,1,9,23,0,7,2,32,0,14 curly hair tip actually work irl
1,1,13,43,0,11,0,56,0,tv hunk marry based favorite social medium
1,3,11,36,5,11,2,47,0,"19 tweet ikea thatll make say, yup, every damntime"
1,1,12,44,0,12,2,56,0,17 image make sense people obsessed high heel
1,1,6,20,2,5,0,26,0,"""star wars"" villain"
1,1,9,38,0,9,4,47,0,hogwarts house 2016 oscar nominee belong
1,2,12,43,1,10,0,55,0,wall street bank enough prevent shoddy chinese ipos?
1,1,7,31,0,7,2,38,0,27 adorable harry potter thing baby need
1,2,2,39,0,5,0,41,0,gallery weird wonderful religious relic
1,2,1,51,0,10,0,52,0,horrifying way drug addict getting fix
1,1,10,38,0,9,0,48,0,accessory get based favorite food
1,1,9,32,0,9,0,41,0,coolest goddamn owl see today
1,3,4,40,2,11,0,44,0,"getting on, getting it: life oap hotspot"
1,3,6,62,4,10,0,68,0,watch celebrity raise money social justice inauguration day 'love-a-thon'
1,1,7,25,0,8,6,32,0,24 vintage picture paris life 1920s
1,2,10,56,5,11,0,66,0,frozen ever after: exclusive look disney upcoming attraction speakeasy
1,1,13,45,1,11,0,58,0,marc anthony delivered powerful speech latino u.s
1,1,6,12,0,5,2,18,0,29 sock cool af
1,1,8,45,0,8,2,53,0,19 time canadian condescending american winter
1,3,4,86,3,18,0,90,0,donald trump cabinet prof belief government like running business. he get shock
1,1,12,35,3,11,2,47,0,size-14 model star david's bridal's new ad campaign
1,1,8,29,0,7,0,37,0,quiz determine datable
1,2,8,38,2,8,0,46,0,wikileaks explained: vulnerable hackers?
1,1,6,16,0,6,2,22,0,27 sign may meninist
1,1,5,19,0,4,0,24,0,moaning myrtle
1,1,11,50,0,10,0,61,0,ryan reynolds think superhero movie sex violence
1,1,16,54,2,15,0,70,0,quiz determine relationship like jim pam's leslie ben's
1,1,9,35,1,8,0,44,0,eating brie cheese wrong entire life
1,2,8,52,2,14,1,60,0,"markelle fultz hope no. 1 pick, expects rivalry lonzo ball nba"
1,3,9,42,0,10,0,51,0,booming market telling u global economy
1,3,13,60,1,12,0,73,0,forget positive thinking: actually change negative thought success
1,2,9,38,0,10,0,47,0,court keep people rikers remaining tough
1,1,10,31,0,9,0,41,0,guess horror story one quote
1,1,10,34,2,9,0,44,0,"people talked like cookie ""empire"" real life"
1,3,1,31,0,7,0,32,0,design city living went wrong
1,1,15,61,0,14,0,76,0,happens ex ask intense question forehead forehead
1,1,11,35,0,11,2,46,0,13 fun activity may technically able mar
1,2,9,33,0,9,1,42,0,8 change bedroom need sleep better
1,2,8,25,0,7,0,33,0,best deal internettoday
1,1,6,27,0,6,2,33,0,11 christmas card cuban would send
1,1,8,20,0,7,0,28,0,better way fold fitted sheet
1,1,6,17,2,5,0,23,0,"well speak ""parent"""
1,1,16,40,1,14,0,56,0,took clothes audience plus-size woman ruled
1,3,1,50,1,10,0,51,0,city worst air pollution level world?
1,1,11,53,0,10,0,64,0,elephant rampaging darjeeling finally caught
1,1,12,60,4,10,0,72,0,"drop everything watch taylor swift's stripped-down performance ""wildest dreams"""
1,2,1,48,0,10,0,49,0,clean sweaty ball prevent smelly scrotum
1,1,12,48,1,11,0,60,0,here's much better idea issuing rule female college student
1,2,5,58,6,15,2,63,0,"game throne recap, season 5 episode 9: dance dragon great escape"
1,1,15,56,0,14,0,71,0,dude selling drug facebook made ridiculously easy police catch
1,1,10,35,0,9,0,45,0,know celebrity crush based birth month
1,1,8,31,3,8,4,39,0,"please, america, let's say goodbye fuckboys 2016"
1,2,11,33,4,11,3,44,0,"get 100% ""parks rec"" character quote quiz?"
1,3,10,34,0,9,0,44,0,muslim ban ripping young couple apart
1,1,7,23,0,6,0,30,0,figure music joke
1,1,7,18,0,6,0,25,0,world going end today
1,1,9,16,0,9,4,25,0,much rap fan 2015
1,1,5,16,0,4,0,21,0,tea time around world
1,1,13,43,0,13,1,56,0,got makeup done 5 different counter happened
1,1,8,28,1,8,2,36,0,23 thing woman say vs. actually mean
1,1,14,38,1,14,2,52,0,23 thing way real single year
1,1,6,27,0,6,2,33,0,21 thing vegetarian couple get
1,1,5,27,1,4,0,32,0,"so, kristin chenoweth love trisquits"
1,1,12,38,1,12,2,50,0,26 gift people who'd rather live page book
1,1,4,21,1,4,2,25,0,15 freshers' week horror story
1,1,7,25,0,6,0,32,0,christmas movie belong
1,1,10,34,0,10,2,44,0,22 fact prove world stranger think
1,1,11,38,3,10,0,49,0,"here's looked like behind scene ""fuller house"""
1,1,7,33,0,6,0,40,0,steak sandwich glorious terrifying
1,1,9,45,4,8,0,54,0,"miranda sings covered adele's ""hello"" seriously hilarious"
1,3,5,71,1,16,4,76,0,camra national pub year 2017: yorkshire pub saved closure community win top award
1,1,7,33,0,6,0,40,0,classical composer best suit taste
1,1,5,19,0,4,0,24,0,upstairs neighbor
1,1,8,33,0,8,2,41,0,22 picture definitely saved phone
1,1,8,31,0,8,2,39,0,24 gift people like art appreciate
1,1,9,18,0,9,2,27,0,19 new way give fuck
1,1,13,45,0,12,0,58,0,know celebrity dislike based zodiac sign
1,3,4,45,0,7,0,49,0,nico rosberg stuns formula one retirement bombshell
1,1,11,52,0,10,2,63,0,21 tv relationship prove different hogwarts house great together
1,1,11,43,0,10,0,54,0,president obama talk novel important life
1,1,8,32,0,7,0,40,0,favorite condiment say
1,2,7,28,1,6,0,35,0,politico scoop: eric trump killed two deer
1,1,5,22,0,4,0,27,0,definitive guide kissing
1,1,12,45,2,11,0,57,0,can't stop combining word randomly ruining goddamn life
1,1,9,25,4,7,0,34,0,"said it: ""rupaul's drag race"" edition"
1,1,11,36,2,10,0,47,0,"marry lucas nathan scott ""one tree hill"""
1,1,8,31,0,9,6,39,0,17 time chloe mini frenchie instagram 2015
1,1,12,37,0,11,0,49,0,tell welsh town harry potter spell
1,1,9,34,0,9,2,43,0,24 reason spooning fun anybody involved
1,1,6,24,3,5,0,30,0,tell u yourself(ie): jill scott
1,1,8,33,1,9,6,41,0,17 fact 2007 make feel fucking ancient
1,1,6,26,1,5,0,32,0,"one woman, three tim burton character"
1,1,8,45,1,7,2,53,0,19 mind-blowing pancake guaranteed change breakfast forever
1,1,10,33,2,10,2,43,0,23 picture make sense child
1,1,8,35,1,9,4,43,0,25 celebrity believe turning 50 year
1,3,7,30,3,7,0,37,0,obama: latte sippin democrat need show
1,2,9,31,0,8,0,40,0,lady gaga show company make comeback
1,2,18,65,0,17,0,83,0,mom shared annoying thing said daughter syndrome mom joinedin
1,2,11,26,2,9,3,37,0,indian doctor win r 17.5 crore lottery uae!
1,1,13,49,2,13,2,62,0,21 image make sense unless baby sister older brother
1,1,15,55,3,14,0,70,0,"seeing wife sexy photoshopped photos, husband said missed ""flaws"""
1,1,9,32,0,9,2,41,0,12 divine thing every tea lover need life
1,3,4,57,0,12,0,61,0,bbc news tune dancer invited channel perform credit
1,1,10,38,2,10,2,48,0,"27 time jim dwight perfect frenemies ""the office"""
1,3,4,39,2,7,0,43,0,pogues basics: iphone announce call
1,1,6,29,0,6,2,35,0,16 spanish landmark actually crap
1,3,4,46,3,9,0,50,0,jordan peele's 'get out' spark new silly internet challenge
1,1,12,36,2,13,4,48,0,"21 thing may known ""10 thing hate you"""
1,1,12,54,2,11,0,66,0,"know thanksgiving food match favorite ""parks rec"" character"
1,2,10,38,2,10,0,48,0,expect u.k. market may pull brexit trigger
1,1,11,43,2,10,0,54,0,"""street fighter"" character based zodiac sign"
1,1,13,45,2,12,0,58,0,"adam lambert play game ""would rather"" thing get hilarious"
1,1,7,30,2,7,2,37,0,"28 time ""breaking bad"" really fucking funny"
1,1,11,41,0,11,2,52,0,15 easy healthy dinner people literally time cook
1,1,8,41,0,8,2,49,0,26 super simple vegan breakfast basically dessert
1,1,8,36,1,8,2,44,0,12 motivational quote people can't bothered
1,1,7,27,0,7,2,34,0,14 basic brilliant way use sriracha
1,1,8,33,0,8,2,41,0,21 thing people party hard understand
1,1,8,37,2,8,2,45,0,"16 ""the simpsons"" question impossible answer"
1,2,11,42,1,10,0,53,0,woman turning viral meme eye makeup hilarious
1,2,1,40,2,9,0,41,0,obama ditched cargo short
1,3,3,70,4,13,0,73,0,"donald trump travel ban: time 'there surprises', administration say"
1,2,1,67,1,11,0,68,0,"teen investigative journalist oust shady principal, give u hope future"
1,1,11,36,0,10,0,47,0,guess zodiac sign based favorite gift
1,1,8,33,2,7,0,41,0,"name ""bake off"" technical challenge"
1,1,10,36,0,9,0,46,0,people pissed old navy selling baby shirt
1,2,10,49,4,12,0,59,0,"al gore: global warming principal cause syrian civil war, brexit"
1,1,8,46,0,8,2,54,0,11 honest motivational poster people living depression
1,1,10,29,0,9,0,39,0,thai chef break make good pad thai
1,3,1,26,1,5,0,27,0,here's clean mattress
1,2,3,63,1,9,0,66,0,faceapp: expert privacy concern popular face transformation app
1,3,2,50,1,13,0,52,0,food fridge posh list
1,1,13,51,0,11,0,64,0,chris hemsworth leonardo dicaprio suffer oscar new movie
1,3,3,60,2,15,3,63,0,forget iphone 7 13 reason next iphone blow everyone away
1,2,9,55,3,10,0,64,0,bangladesh family: vogue model killed refusing wear islamic garment
1,3,9,28,1,9,6,37,0,13 life-changing item add kitchen in2017
1,1,10,37,0,9,0,47,0,know favorite cocktail based zodiac sign
1,1,16,42,0,15,0,58,0,dad son dressed like one could tell apart
1,1,10,31,0,9,0,41,0,need tell u thing sandwich
1,1,10,37,0,9,0,47,0,wonderful thing ever happen avocado toast
1,1,12,40,0,12,2,52,0,21 tweet way funny anyone pregnant sister
1,1,13,43,0,12,0,56,0,know city spend christmas based zodiac
1,1,11,45,0,10,0,56,0,everything thought knew washing sheet wrong
1,3,13,70,8,13,0,83,0,"matthew coulter-berkeley controversy: free thinking, argument, debate come college"
1,3,14,42,0,11,0,56,0,aziz ansari kicked snl fire monologue donaldtrump
1,3,7,33,0,8,0,40,0,wealthiest zip code every state
1,1,10,41,2,9,2,51,0,29 life-saving tip teach college orientation
1,2,12,63,4,11,0,75,0,washington post: trump appointment military officer may turn u.s. dictatorship
1,3,12,35,1,11,0,47,0,know meant entrepreneur
1,3,2,50,1,13,0,52,0,here's life like quit porn star list
1,1,6,25,0,5,0,31,0,fruit match zodiac sign
1,1,6,19,1,5,0,25,0,like witness death
1,3,8,40,0,7,0,48,0,technology driving logistics holiday season
1,2,12,62,0,14,0,74,0,sport writer give hall fame vote avoid voting conservative curt schilling
1,1,7,20,0,6,0,27,0,lady gaga madonna
1,1,11,38,0,11,2,49,0,17 card valentine love much kanye love kanye
1,1,12,36,2,11,0,48,0,"stephen colbert give u trump need ""the late show"""
1,3,11,43,0,10,0,54,0,new manicure trend turn manicure anaquarium
1,1,13,52,0,12,0,65,0,jennifer lawrence talk ridiculous tattoo new issue vogue
1,3,7,41,1,8,0,48,0,inside look white house christmas decoration
1,1,5,16,1,4,0,21,0,drunk vs. hungover
1,1,13,51,2,11,1,64,0,2-year-old trying blow birthday candle heartbreakingly cute
1,1,9,28,0,8,0,37,0,need super cute comic life
1,1,6,25,1,5,0,31,0,"yo, wanna netflix chilaquiles"
1,2,5,33,3,9,0,38,0,u.s. import mexico? whole lot
1,3,14,64,0,14,2,78,0,mexican couple get remarried india according hindu custom 50 year wedding
1,1,18,56,1,14,0,74,0,wwii veteran's reunion wartime sweetheart make feel thing
1,1,12,42,1,11,2,54,0,19 truth non-mormons loved growing mormon community
1,1,9,30,0,8,0,39,0,dancing pumpkin guy look like
1,3,3,45,1,10,4,48,0,here's donald trump obsessed 2016 electoral map
1,3,18,59,7,16,0,77,0,msnbcs ruhle warren: guy power didnt thing improve regular americans?
1,1,11,33,1,11,2,44,0,19 soul food recipe almost good mom's
1,1,8,29,2,7,2,37,0,day 4 buzzfeed's 7-day clean eating challenge
1,1,7,25,2,6,0,32,0,"""game thrones"" direwolf"
1,1,10,46,0,9,0,56,0,nick jonas shared possibly best throwback thursday photo ever
1,2,19,60,4,18,3,79,0,"surat tea seller redefined 'black tea' us, i-t seizes r 400 crore jewellery"
1,1,7,18,1,6,0,25,0,time new religion
1,1,9,30,0,8,0,39,0,people try grass jelly drink first time
1,1,11,30,0,10,0,41,0,let michael ian black help better grown
1,1,8,29,3,8,2,37,0,"19 jess mariano's best line ""gilmore girls"""
1,1,5,20,0,4,0,25,0,tattoo artist honest
1,1,8,36,2,7,0,44,0,"underrated ""gilmore girls"" guy soulmate"
1,1,13,57,3,12,2,70,0,"10 brilliantly fashionable way low-key dress favorite ""star wars"" character"
1,3,1,25,1,6,0,26,0,home hot tub picture
1,1,8,32,0,8,2,40,0,26 delicious thing serve holiday party
1,2,11,44,1,10,0,55,0,pork tenderloin stuffed herb caper recipe nyt cooking
1,1,10,41,0,10,2,51,0,11 chart perfectly sum relationship mom
1,3,7,40,0,7,2,47,0,27 picture every twentysomething grandma relate
1,1,9,36,0,9,2,45,0,22 intensely pleasurable old word need bring back
1,1,8,19,0,7,0,27,0,empathy take u limb
1,1,11,44,0,10,0,55,0,watch couple kiss slow motion get sexually awakened
1,2,15,48,0,14,0,63,0,giant gray blobby thing become huge meme russia somereason
1,2,4,62,2,13,0,66,0,trevor noah theory trump throw nationals' opening pitch
1,1,10,41,1,10,2,51,0,15 chart mean something people love running
1,1,10,34,0,10,2,44,0,16 unwritten rule way real lazy people
1,1,12,38,0,11,0,50,0,apparently texas get pickle go movie
1,2,20,68,1,20,1,88,0,austerity big fat indian wedding? bill seek limit spending r 5 lakh introduced lok sabha
1,1,9,39,0,9,2,48,0,14 awkward photo bollywood star wax statue
1,1,10,34,0,10,2,44,0,34 tweet food make laugh every time
1,3,0,36,3,6,1,36,0,7 sign dating not-so-charming prince
1,1,11,42,2,10,2,53,0,16 non-canadians hots canada's next prime minister
1,1,11,49,0,11,2,60,0,17 amazing product actually worked people curly hair
1,1,13,32,1,13,2,45,0,28 tweet sum like grow new jersey
1,2,10,37,0,9,0,47,0,brave people changed meaning bathtime
1,3,13,34,5,8,0,47,0,"chile, mexico, u.s. highest inequality rates, oecd say"
1,1,9,41,1,8,2,50,0,17 mind-blowingly cute simple halloween costume kid
1,2,2,49,0,9,0,51,0,bird flu detected chicken breeding facility tennessee
1,1,7,27,1,6,2,34,0,17 beautiful room book-loving soul
1,1,7,24,0,7,4,31,0,year 2015 told terrible drawing
1,1,13,36,0,12,0,49,0,thing bunny yoga incredibly cute
1,2,13,57,4,13,0,70,0,michelle bernard trump presidency: cant help think slavery coming back
1,1,7,27,2,7,2,34,0,"19 perfect etsy gift ""golden girls"" fan"
1,1,12,47,0,11,0,59,0,quiz reveal family argue christmas
1,1,6,20,0,5,0,26,0,make mini nutella pizza
1,3,11,36,2,13,4,47,0,leap second: here 2016 going tiny bit longer
1,1,9,44,1,9,2,53,0,22 picture people grad student never understand
1,1,10,35,3,9,0,45,0,"match quote ""grey's anatomy"" character"
1,2,6,37,2,7,0,43,0,espn expert predictions: anyone catch cubs?
1,3,2,47,0,9,0,49,0,indian state election matter whole world
1,1,7,34,0,6,0,41,0,answer basic psychology question
1,3,3,39,4,11,0,42,0,'you may well kill us': human cost india's meat ban
1,1,11,33,0,11,2,44,0,19 thing happen song come club
1,1,9,41,2,9,2,50,0,"19 time ""absolutely fabulous"" summed twenty"
1,1,10,35,3,9,0,45,0,"michael scott's lover ""the office"""
1,2,1,51,2,10,0,52,0,"polar vortex here, competing global warming"
1,1,17,57,0,17,2,74,0,superstar dog world record holder catching 14 ball paw one minute
1,1,11,49,0,10,0,60,0,instagram model perfect response unwanted dick pic
1,3,1,60,1,12,0,61,0,federal budget launch new era social affordable housing?
1,3,4,74,2,14,0,78,0,donald trump want everything america strong. announced one big exception.
1,1,8,30,0,8,2,38,0,23 reason never set foot manitoba
1,1,10,41,1,9,0,51,0,toad controlled robot adorably terrifying
1,1,7,43,0,7,2,50,0,17 entirely unnecessary beauty product actually exist
1,3,13,47,3,13,0,60,0,nbcs chuck todd john kelly: deporting illegals best use money?
1,3,10,43,1,9,0,53,0,singapore year misbehaving moneyman put ma high alert
1,1,12,49,1,11,0,61,0,making thanksgiving turkey wrong way whole life
1,1,15,50,0,14,0,65,0,indian artist built sand sculpture drowned syrian boy beach
1,1,7,17,0,6,0,24,0,phase moon
1,3,2,11,1,4,8,13,0,30 30 2017: youngest
1,1,17,52,2,15,4,69,0,"reminder convenience store scene ""magic mike xxl"" best scene 2015"
1,2,9,49,1,9,0,58,0,shocking new detail emerge aaron hernandez's double murder trial
1,1,6,21,1,6,1,27,0,8 type girl danced
1,1,13,41,0,13,0,54,0,hold baby people nervous around baby
1,1,10,42,0,9,0,52,0,everyone weirdly jack skellington growing
1,1,7,23,1,7,2,30,0,21 thing woman wear hijab can't
1,1,12,43,2,11,0,55,0,here's eat everything ever wanted miyazaki film
1,1,9,31,0,9,2,40,0,19 white lie best friend told
1,1,8,29,1,8,2,37,0,23 trader joe's recipe family need try
1,1,9,36,0,8,0,45,0,easy trick make waffle taste like churros
1,1,9,32,0,9,2,41,0,25 thing people thick hair simply never
1,2,5,20,2,4,0,25,0,soda new enemy: san francisco
1,3,2,64,1,13,0,66,0,mcdonald's switch fresh beef bad news one biggest competitor
1,3,8,33,2,9,4,41,0,"bad blood: fastest, furious music feud 2016"
1,1,12,46,1,12,2,58,0,"12 years, girl finally decided show parent tattoo"
1,3,1,46,0,9,0,47,0,caring dying wife brought u even closer together
1,1,9,46,1,8,2,55,0,17 severely relatable moment anyone gift-opening anxiety
1,1,12,32,0,11,0,44,0,cleaned as bidet happened
1,1,4,12,0,3,0,16,0,need elvira
1,1,11,32,0,10,0,43,0,see world eye legally blind man
1,1,8,22,0,8,4,30,0,look 2016 grammy award
1,1,13,45,1,12,1,58,0,7-picture test determine type harry potter fan
1,3,1,45,0,12,0,46,0,file tax extension run time
1,1,10,43,0,9,0,53,0,jennifer lawrence aziz ansari new friendship goal
1,1,11,37,0,10,0,48,0,know age based opinion taylor swift
1,1,13,61,0,12,0,74,0,photographer celebrates diversity black hair adorable photo series
1,1,9,19,1,6,0,28,0,destiny's child tlc
1,1,11,35,0,10,0,46,0,guess concession stand food item real
1,1,14,27,0,11,0,41,0,guy pro baseball player mlb fan
1,2,10,44,1,8,0,54,0,campaign-trail marine le pen blocked entering migrant camp
1,1,16,52,0,12,0,68,0,sikh working syrian refugee say keep mistaken isi member
1,1,8,24,0,7,0,32,0,resist call doughnut
1,1,14,36,2,13,0,50,0,here's dump partner go uni
1,1,16,57,2,15,0,73,0,here's brilliant twitter account follow desi woman sick sexism
1,1,9,31,1,9,2,40,0,21 secret people hate sex tell
1,2,2,45,2,10,0,47,0,"france better britain, we're scared admit"
1,1,5,17,0,4,0,22,0,salad hurt soul
1,2,3,51,0,7,0,54,0,nigel farage blame multiculturalism london terror attack
1,3,0,83,2,21,3,83,0,"3 sign give house flipping shot, according man who's real estate 20 year"
1,1,11,44,0,11,2,55,0,16 reason kid protective parent best friend
1,1,12,39,2,12,2,51,0,18 romantic af movie show stream valentine's day
1,3,1,54,1,12,0,55,0,journal club change way doctor prescribe?
1,1,10,46,0,9,0,56,0,guess fictional character person think look like
1,1,7,18,2,6,0,25,0,"karen ivy ""smash"""
1,2,1,69,1,11,0,70,0,"female cockroach reproduce year without needing male, scientist find"
1,1,8,35,2,7,2,43,0,12 mouthwatering mini-cakes never share
1,2,8,30,1,7,0,38,0,pas challenging timed foodquiz?
1,1,11,50,0,10,0,61,0,interracial couple share appalling thing people said
1,1,9,41,0,9,1,50,0,8 outrageously cute shelter cat ready halloween
1,1,6,15,3,5,0,21,0,"i'm republican, i'm"
1,2,9,49,3,10,0,58,0,wasserman schultz: donald trump belief elected dictator
1,3,11,56,4,10,0,67,0,krauthammer: obamas deluding say race relation improved
1,2,1,42,1,9,0,43,0,"everyone brown eyes, even appear blue"
1,1,12,38,3,11,0,50,0,"poll: rory end ""gilmore girls"" revival"
1,3,6,45,1,9,0,51,0,one california high school made million snap's ipo
1,1,13,46,0,13,2,59,0,12 reason definitely need take person swimming first date
1,2,17,56,2,14,0,73,0,much-maligned minivan perfect vehicle usher era self-driving car
1,1,6,27,0,6,2,33,0,26 question asian white people
1,1,7,30,0,7,2,37,0,16 men need delete facebook immediately
1,1,5,34,0,5,2,39,0,17 mouthwatering holiday main vegetarian
1,2,6,47,2,8,0,53,0,stephen colbert touchingly eulogizes rickles 'late show'
1,3,4,49,0,12,0,53,0,watch worn powerful ceo world
1,1,8,32,1,8,2,40,0,lauren cohan's 19 step surviving horror movie
1,1,6,33,0,7,6,39,0,19 breathtaking avocado toast happened 2015
1,3,5,22,1,4,0,27,0,people find approachable?
1,1,8,34,2,7,0,42,0,what's funniest reason cried drunk
1,3,13,44,3,13,0,57,0,check dj khaled's hilarious ad 'we best glow' body lotion
1,2,9,40,1,10,0,49,0,alabama player awe nick saban's sick new mercedes
1,1,9,44,0,9,2,53,0,couple remarried 23 year getting divorced
1,1,10,33,1,9,2,43,0,43 mild thrill anyone mid-twenties
1,3,0,49,1,10,1,49,0,5 travel credit card sign-up bonus fund summer trip
1,1,17,61,0,14,0,78,0,abc apologised using photo wrong indian actress promoting priyanka chopra
1,1,7,37,0,7,2,44,0,14 photo anyone menstruates understand
1,2,13,73,2,12,0,86,0,texas a&m player kirk merritt's lawyer provides unbelievable reason indecent exposure accusation
1,1,12,54,2,10,0,66,0,woman re-creates iconic celeb instagram photo totally hilarious
1,2,1,50,0,11,0,51,0,teenager discovered new planet third day work
1,1,8,17,0,7,0,25,0,would crime show
1,1,11,41,1,10,0,52,0,solve puzzle obsessed music movie
1,1,9,30,0,9,2,39,0,13 chart way real bisexual woman
1,2,8,23,2,10,2,31,0,april 15 lost claim tax day
1,1,12,46,1,11,0,58,0,here's make delicious chicken parmesan baked penne dinner
1,3,3,60,1,9,0,63,0,seasonally stressed? outsource christmas professional
1,2,5,35,0,10,4,40,0,full guide every team 2017 ncaa tournament
1,1,11,39,0,10,0,50,0,many football club identify kit
1,1,13,48,0,12,0,61,0,mom posted incredibly raw emotional photo life birth
1,2,1,36,2,8,0,37,0,happens file tax return?
1,1,11,29,0,10,0,40,0,harry style tweet indie band name
1,1,16,56,0,16,2,72,0,29 horrible thing happen put retainer first time forever
1,1,13,58,1,12,0,71,0,bette midler tweeted interest jennifer lawrence amy schumer's movie mom
1,1,11,35,0,10,0,46,0,taylor swift show emmy epic photo shoot
1,1,11,38,0,10,0,49,0,guy make insane silhouette cut paper
1,1,12,33,2,11,0,45,0,"one thing never noticed ""how met mother"""
1,3,2,65,1,10,4,67,0,surprise candidate brings 2016 presidential dynamic virginia governor race
1,3,3,41,0,9,0,44,0,gruelling test sydney hobart yacht race
1,1,8,23,0,7,0,31,0,make carly rae jepsen pop star
1,3,8,37,6,7,0,45,0,"film-maker punched, kicked, choked migrant no-go zone"
1,1,7,21,1,6,0,28,0,"dear hairy girls, alone"
1,1,9,41,2,9,2,50,0,"23 hilarious hidden joke ""the simpsons"" probably missed"
1,1,6,22,0,6,2,28,0,19 worst superheroes time
1,1,7,30,2,7,5,37,0,25 thing girl 5-foot-10 understand
1,1,6,32,2,6,2,38,0,"another round, episode 40: blacker history month"
1,3,4,48,1,10,0,52,0,frozen mr fox: hunter display animal preserved block ice
1,1,8,31,1,6,0,39,0,identify popular fast-food item
1,1,12,39,0,11,0,51,0,happens ask adult draw jeremy corbyn
1,1,10,42,0,10,2,52,0,32 delicious recipe bring fall breakfast table
1,1,8,33,0,8,2,41,0,12 terrifying ghost movie horror fan must see
1,1,10,47,0,9,0,57,0,video perfectly capture fear relationship
1,2,1,44,0,9,2,45,0,caerphilly farmer may get full payout 24 year wait
1,1,10,35,3,10,2,45,0,"marshall eriksen's best 25 quote ""how met mother"""
1,1,9,30,0,7,0,39,0,tv show helped depression
1,1,13,33,0,9,0,46,0,literally bunch funny tweet hgtv show
1,1,10,34,2,9,2,44,0,18 post totally spot-on women's body hair
1,2,2,55,4,9,0,57,0,'spy suburbia': pensioner's secret life revealed bomb scare
1,2,9,35,0,9,1,44,0,7 failed disney storyline read tobelieve
1,1,4,14,1,3,0,18,0,what's fuck style
1,1,6,37,0,6,2,43,0,35 time kardashians unintentionally funny
1,2,3,38,1,12,1,41,0,5 thing new year's eve lower tax bill
1,1,11,20,2,9,0,31,0,"know tv show ""b"""
1,1,8,27,1,8,2,35,0,19 wedding photo want pin right
1,3,11,49,1,10,0,60,0,chelsea clinton husband shut hedge fund month hillary loss
1,1,8,39,0,8,2,47,0,25 situation serious germophobes relate
1,3,7,36,2,7,2,43,0,"21 funny, cringey, questionable teenage bandnames"
1,2,8,41,0,8,1,49,0,7 step rebound student loan refinancing rejection
1,1,13,40,0,12,0,53,0,baskin robbins flavor based day born
1,1,9,50,1,9,2,59,0,17 heartbreaking confession people love someone back
1,1,8,32,0,7,0,40,0,actually go honeymoon
1,2,4,42,2,10,3,46,0,100 women: english girls' school reborn nairobi slum
1,3,16,56,2,14,2,72,0,29-year-old attracted five former top credit suisse real estate banker firm
1,1,11,33,0,10,0,44,0,best bag packing tip every trip
1,1,12,40,2,11,0,52,0,zayn malik's hair game fucking strong here's proof
1,1,10,37,0,9,0,47,0,know subconscious fear based birth month
1,3,9,51,2,7,0,60,0,eric holder airbnb run controversial #weaccept multiculturalism ad
1,1,8,11,2,7,6,19,0,"24 best ""snl"" skit 2015"
1,2,9,40,3,9,0,49,0,bond bear look poised come hibernation...again
1,1,12,51,3,12,3,63,0,"couple's ""101 dalmatians"" engagement shoot disney dream made"
1,1,12,56,2,11,0,68,0,guy keep editing celebrities' instagrams pretty funny
1,1,13,52,0,12,0,65,0,hundred woman around india sleeping park reclaim public space
1,1,12,53,1,10,0,65,0,fan-made kylie jenner video put social medium bullying perspective
1,1,11,37,3,9,0,48,0,"""friends"" cast gave special shout-out matthew perry"
1,1,9,36,0,8,0,45,0,personality type based signature
1,1,11,38,0,10,0,49,0,tyra bank posted adorable photo newborn son
1,1,9,38,2,7,0,47,0,here's he-man look like realistic proportion
1,2,3,32,2,6,0,35,0,'hidden figures' cosplay cutest
1,3,22,67,1,18,0,89,0,"bad news yusuf pathan, bcci revoke objection ceritificate would allow play hong kong"
1,2,1,74,0,13,0,75,0,use insight consumer psychology research make spouse appreciate
1,2,1,46,0,7,0,47,0,serbian attitude harden migrant gather
1,1,11,40,0,11,2,51,0,22 gorgeous way get whole family hanukkah spirit
1,1,12,37,4,12,2,49,0,"able listen adele's ""25"" apple music spotify"
1,1,6,25,0,6,1,31,0,8 struggle tall boyfriend
1,1,8,23,0,8,4,31,0,well remember movie 2005
1,1,8,44,0,8,2,52,0,21 amazingly delicious lasagna guaranteed change life
1,3,17,59,3,18,1,76,0,"trump co try getting masood azhar banned un, china veto 5 important read today"
1,1,11,40,0,10,0,51,0,woman created every amazing food pun universe
1,3,8,37,1,8,2,45,0,13 product help start skincare routine
1,1,15,43,0,11,0,58,0,gorgeous former antm contestant change damn game
1,2,9,32,2,9,0,41,0,obama: here's miss white house
1,1,18,45,1,13,0,63,0,sacha baron cohen make dig oscars' diversity issue stage baftas
1,3,3,40,0,11,2,43,0,28 expensive home sale u right
1,1,13,58,2,12,0,71,0,"first new ""powerpuff girls"" clip buttercup beating misogynist lumberjack"
1,1,8,20,0,7,2,28,0,18 time upgrade meme real af
1,1,11,35,1,10,2,46,0,19 thing big-boobed girl love clothes know true
1,2,2,31,1,5,0,33,0,surprise! trump listening critic
1,3,4,63,4,8,0,67,0,scarlett johnsson call ivanka trump 'cowardly' following 'complicit' interview
1,3,4,31,0,6,0,35,0,strange afterlife banned tsa item
1,2,5,23,0,5,0,28,0,american airstrikes go wrong
1,1,14,49,0,13,0,63,0,five psychic tell u fortune made u question everything
1,1,9,37,1,8,0,46,0,tina fey's new action movie look intense hilarious
1,3,9,27,0,10,5,36,0,5 tip make better investor 2017
1,3,7,21,1,6,0,28,0,could dark matter ever form star?
1,2,11,49,1,11,0,60,0,"chicago murder rate spikes, many fear violence become normalized"
1,2,11,46,3,11,0,57,0,bentley flying spur rolls-royce ghost: fantasy car you?
1,1,11,41,2,11,2,52,0,17 thing happen eat meat thanksgiving
1,1,13,52,0,12,0,65,0,american failed adorably trying figure term used cricket
1,2,4,38,3,6,0,42,0,man unearths dad's never-before-seen footage jfk
1,2,1,56,0,12,0,57,0,awful sore mouth symptom something serious
1,1,12,37,0,9,0,49,0,regular people try catch pass nfl quarterback
1,1,11,29,3,8,4,40,0,best end-of-the-year mashup 2015 finally
1,2,11,41,0,11,2,52,0,17 hilarious tumblr post everyone done withschool
1,3,1,72,0,15,0,73,0,one anticipated hedge fund launch year even bigger thought
1,1,11,38,0,10,0,49,0,old actually based favourite swear word
1,2,12,58,5,13,0,70,0,fatah spokesperson: trump moving u.s. embassy jerusalem open gate hell
1,3,12,58,1,10,0,70,0,nba commissioner adam silver double league transgender activism stance
1,1,10,34,2,10,2,44,0,"49 fact might know ""harry potter"" book"
1,1,8,32,0,8,2,40,0,17 thing instantly make day better
1,2,16,63,0,15,0,79,0,kamal haasan along others tweeted unexplainable video cop setting auto fire
1,1,11,37,0,10,0,48,0,prove rich buying expensive shit ruining
1,2,11,40,0,8,0,51,0,cpac straw poll find overwhelming support donald trump
1,1,7,27,1,6,1,34,0,9 time olivia ashamed raven-symone
1,2,13,46,2,12,0,59,0,"hey, people really, really run president"
1,3,8,43,1,8,3,51,0,duggar family scandal: official called 911 visiting home
1,1,10,42,0,10,2,52,0,17 beauty advent calendar need know christmas
1,1,13,49,0,12,0,62,0,love actually heartbreaking lesbian plot got cut movie
1,1,11,48,0,10,0,59,0,bob ross painting episode streaming online people stoked
1,2,11,38,0,10,0,49,0,pizza hut hot dog bite pizza pizza america deserves
1,3,1,58,0,11,0,59,0,mother expect less partner
1,1,9,30,0,9,2,39,0,31 period tweet make laugh cry
1,1,13,48,3,12,0,61,0,"know fave ""gilmore girls"" character based food craving"
1,1,7,27,1,5,0,34,0,sign buzzfeed quinta's newsletter
1,1,9,31,0,8,0,40,0,relax watch hamster eat little carrot
1,3,2,58,0,12,1,60,0,2 startup combining fix problem wall street stock research
1,2,7,34,1,8,0,41,0,beijing grip yuan becoming tenuous
1,1,11,50,1,10,0,61,0,kesha officiated makeup artist's wedding earned eternal love
1,3,2,38,4,7,0,40,0,vegemite bought -- surprise -- australian
1,3,1,48,2,11,0,49,0,'digital wellness lady' mission make unplug
1,1,8,35,0,8,2,43,0,18 reason country ever accept refugee
1,2,13,49,0,12,0,62,0,inside view nine month campaign trail president trump
1,1,8,17,0,6,2,25,0,16 wtf animal face swap
1,1,8,36,0,8,2,44,0,15 brilliant creative way use spaghetti squash
1,2,18,58,4,16,1,76,0,"9-year-old rape survivor, living mother streets, nailed rapist court"
1,1,11,33,1,10,0,44,0,anyone who's huge fight family data
1,3,11,33,0,10,0,44,0,build monster tell deepestfear
1,1,14,44,0,13,0,58,0,six guy likely run online dating
1,3,10,40,0,10,0,50,0,new cruise ship reimagines mean outdoors
1,2,0,44,1,11,1,44,0,9 cooking project please crowd
1,1,14,57,2,13,0,71,0,investigation bracelet that's stuck kylie jenner's wrist year
1,1,10,35,0,9,0,45,0,everyone need actually get shit done today
1,1,14,29,0,11,0,43,0,know gif freak based age
1,1,9,31,0,8,0,40,0,best friend kendall kylie
1,1,11,57,0,10,0,68,0,neil patrick harris family officially outdid halloween
1,3,10,81,4,21,4,91,0,"new netflix may 2017: house cards, master none, f family returning streaming service's best month yet"
1,1,8,36,5,6,0,44,0,"here's first, action-packed trailer ""allegiant"""
1,1,9,38,1,8,0,47,0,here's trailer documentary james foley
1,1,5,17,0,4,0,22,0,pizza topping
1,1,10,32,0,9,0,42,0,one tell assaulted
1,3,3,24,0,6,0,27,0,beat uk energy price rise
1,1,11,40,1,10,0,51,0,what's craziest thing happened oral sex
1,1,9,35,0,8,0,44,0,blood type say personality
1,1,12,45,1,11,0,57,0,here's pregnant woman actually need know zika virus
1,3,11,37,2,7,0,48,0,cnns fake news get trump-hating politico reporter fired
1,1,11,38,0,10,0,49,0,know favorite disney dude based zodiac sign
1,3,2,58,2,14,2,60,0,one annoying thing entire planet turned 20 list
1,3,11,40,2,11,2,51,0,"17 tweet people love hate jughead ""riverdale"""
1,3,5,14,5,10,11,19,0,17 (or no. 17 hot 100 hit 2017
1,1,15,49,0,14,0,64,0,happened tried hot sauce made scorpion pepper
1,1,13,61,1,13,2,74,0,19 thing people already broken new year's resolution understand
1,1,7,26,2,7,2,33,0,10 ghost even know halloween
1,1,8,26,0,8,1,34,0,7 easy way eat healthier week
1,1,11,49,1,10,0,60,0,jason sudeikis' son playing lightsaber hilarious adorable
1,1,14,68,0,13,0,82,0,photographer captured candid moment life famous artist throughout history
1,1,8,28,1,8,2,36,0,23 product help actual adult
1,2,7,37,3,7,0,44,0,"north carolina, berlin, delta: thursday briefing"
1,1,21,46,0,16,0,67,0,jason derulo walked mtv emas red carpet cigar drink hand
1,1,9,34,1,8,0,43,0,"big, jiggling man butt actually deserve"
1,1,12,33,2,12,2,45,0,"22 sad, lonely people even cat life"
1,1,8,22,0,7,0,30,0,north west saint west
1,1,15,54,3,14,0,69,0,"new ""spaceballs: schwartz awakens"" trailer make feel like kid"
1,2,2,58,4,15,0,60,0,polar vortex coming. here mean cold could get.
1,1,6,29,1,6,1,35,0,7 chart explain life's mystery
1,3,4,27,1,7,6,31,0,andrew clements' top 10 classical cd 2016
1,2,5,67,3,18,0,72,0,something say betsy devos. sent senator pizza message.
1,1,7,32,1,6,0,39,0,here's one really weird thing butterfree
1,1,7,36,0,6,0,43,0,makeup struggle every girl understands
1,1,12,46,1,11,0,58,0,here's doctor say theory bra cause breast cancer
1,1,10,28,0,10,2,38,0,17 dog proud stick found
1,1,9,38,0,9,2,47,0,15 delectable way use leftover halloween candy
1,1,13,45,0,13,2,58,0,22 struggle way real everyone play orchestra
1,1,11,32,0,10,0,43,0,match quote kardashian said
1,3,15,63,3,17,0,78,0,lawyer rape case fire saying woman good lying 'because they're weaker sex'
1,1,14,24,0,9,0,38,0,exo gif based zodiac sign
1,1,11,32,0,11,2,43,0,17 moment kid moved around lot know well
1,1,13,47,2,13,3,60,0,scott pilgrim greatest movie ever disagree 100% wrong
1,3,3,25,1,6,2,28,0,10 simple prank april fools' day
1,1,9,36,1,9,2,45,0,26 men who'll make pregnant without even touching
1,1,10,39,0,9,0,49,0,hugh jackman think tom hardy next wolverine
1,1,9,31,2,8,0,40,0,"rihanna look flawless new video ""work"""
1,2,11,63,2,11,0,74,0,kellyanne conway: democratic leader put stop violent anti-trump protester
1,1,8,24,0,8,2,32,0,21 cozy thing make get cold
1,1,9,36,2,8,0,45,0,what's best group halloween costume ever
1,1,13,63,2,12,0,76,0,"mumbai police identified various potentially dangerous place ""no selfie zones"""
1,1,11,37,0,10,0,48,0,guess eye color based question color
1,1,6,22,0,5,0,28,0,black history told snapchat
1,1,13,55,0,12,0,68,0,know favorite disney princess based favorite taylor swift single
1,1,7,32,2,7,2,39,0,"27 word ""office"" fan really understand"
1,2,1,42,2,10,7,43,0,"5 historic property sale less $250,000"
1,1,9,36,0,8,0,45,0,mystery michael jackson sonic hedgehog
1,3,14,47,1,11,1,61,0,jpmorgan chasevoice: 4 tip help business flourish social medium
1,1,10,43,0,10,2,53,0,15 portrait capture natural beauty redhead color
1,1,9,30,0,9,2,39,0,21 photo really make feel super old
1,1,8,21,2,7,0,29,0,"actually fan ""trap queen"""
1,3,4,57,0,12,0,61,0,important breast cancer drug two decade get nh funding
1,2,7,30,2,6,0,37,0,"trump tweets, vowing obamacare isnt safe yet"
1,1,9,27,0,8,0,36,0,never fuck poached egg
1,2,2,65,1,12,0,67,0,one question let instantly read someone's personality list
1,1,7,26,1,6,2,33,0,10 life-changing thing try february
1,1,9,28,2,8,0,37,0,"black guy discus black guy ""star wars"""
1,1,8,37,0,8,2,45,0,19 way pink eyeshadow actually look totally badass
1,2,10,51,7,18,4,61,0,bryce cheer? harper yankee 2019 ... yankee blog- espn
1,1,11,41,2,11,2,52,0,"here's 58 smiley emojis mean, defined british people"
1,1,7,35,2,6,0,42,0,"""friends"" character actually date"
1,2,3,47,0,9,0,50,0,pope francis reshape climate discussion
1,1,11,32,0,10,0,43,0,weird thing stay warm winter
1,1,6,26,0,6,2,32,0,13 misogynistic phrase need die
1,1,11,41,0,11,2,52,0,23 picture cat destroy faith cat education
1,1,13,42,2,12,0,55,0,"may found perfect roland ""dark tower"" film"
1,1,10,30,0,9,0,40,0,feel like make crush laugh
1,1,7,36,0,7,2,43,0,17 wonderful activity alice wonderland fan
1,1,5,11,0,4,0,16,0,evil cat
1,1,6,27,0,5,0,33,0,people react uber passenger rating
1,1,10,38,0,9,0,48,0,guess favorite chocolate based zodiac
1,1,11,44,1,11,2,55,0,16 creepiest place texas forever haunt dream
1,1,11,43,0,10,0,54,0,dakota johnson leslie mann hilariously hit hot reporter
1,1,15,32,5,9,0,47,0,"omg, yes, totally make hair glow-in-the-dark"
1,3,10,52,2,11,0,62,0,united airline tried bar girl flight wearing legging [video]
1,1,7,28,2,6,0,35,0,what's best fanfiction ever read
1,1,7,26,0,8,6,33,0,12 recipe made life complete 2015
1,2,1,24,3,6,2,25,0,16 sign 'made it' america
1,1,12,34,1,11,0,46,0,thing spending new year's eve alone
1,1,12,36,2,11,0,48,0,"weirdest shit amazon ""saved later"""
1,1,13,55,5,12,0,68,0,here's everything went lilly ||superwoman|| singh went jimmy fallon
1,1,15,47,2,13,0,62,0,comedian's stand-up gay indian make new fave
1,1,9,36,1,9,2,45,0,22 philosophy joke silly they're kinda funny
1,3,8,42,1,9,0,50,0,here's lebron james recovers every nba final game
1,3,14,75,7,13,0,89,0,"fareed zakaria: obama admin largely scandal-free operated microscope, looked different"
1,3,4,36,0,8,0,40,0,rating job security every nfl head coach
1,1,11,40,0,9,0,51,0,find next great book buzzfeed book newsletter
1,1,6,23,1,7,4,29,0,29 truth '90s latina girl get
1,1,6,32,0,6,2,38,0,27 picture prove placement everything
1,1,11,40,1,9,0,51,0,non-welsh people try guess definition welsh phrase
1,1,6,26,2,5,0,32,0,what's zodiac sign's pizza topping
1,1,14,41,2,13,0,55,0,"minor ""star wars"" character name british village"
1,2,7,26,2,7,0,33,0,clock boy dad vow appeal tossed case
1,2,10,53,1,11,0,63,0,sean spicer: report show obama administration spied trump
1,1,14,52,0,13,0,66,0,two time jennifer lawrence embarrassed life
1,1,10,33,0,10,2,43,0,17 amazon review disney film way real
1,3,3,47,1,8,0,50,0,"george michael died natural causes, british coroner say"
1,3,10,49,0,8,0,59,0,celebrity boycott delta youtube hoaxster booted flight
1,1,6,33,0,6,2,39,0,14 hottest indigenous celebrity canada
1,1,9,30,0,8,0,39,0,career going according tarot
1,1,10,23,0,9,0,33,0,would better date new man
1,1,7,31,0,7,2,38,0,13 struggle waiting halloween arrive
1,2,7,30,1,8,6,37,0,16 story prove 2016 wasnt absolute worst
1,1,7,18,0,6,0,25,0,like spock kirk
1,3,0,42,0,8,1,42,0,3 thing every man avoid wearing winter
1,3,3,51,2,11,0,54,0,america's airline shameless. united set new low
1,1,11,39,0,10,0,50,0,know favorite smiley emoji based birth month
1,1,15,56,0,14,0,71,0,eva longoria america ferrera took golden globe bit hand
1,2,2,87,1,21,2,89,0,"top 10 food eat beat bloating get flat stomach, trendy apple cider vinegar korean kimchi"
1,2,14,51,1,12,0,65,0,sick dad surprised daughter making cross-country wedding
1,1,7,19,1,5,0,26,0,hate bf's mustache
1,1,6,21,0,5,0,27,0,bravo show honest title
1,1,9,34,0,9,2,43,0,16 time chris martin really excited puppy
1,1,7,25,1,6,0,32,0,crushing cat sitter
1,1,11,40,4,10,0,51,0,"movie ""man"" title actually ""mandolins"""
1,1,9,37,3,8,0,46,0,"barbie's new collection curvy, petite, tall doll"
1,1,4,17,0,4,2,21,0,15 iconic anime theme song
1,3,18,48,2,17,0,66,0,know couple hour day sun could boost immunity? here's
1,3,1,50,1,9,0,51,0,middle-aged woman vulnerable internet
1,3,8,34,2,9,0,42,0,"ohio woman rescued neighbor pit, police say"
1,1,6,18,0,5,0,24,0,male music icon
1,1,10,30,0,10,2,40,0,21 time fell head heel oscar isaac
1,3,10,59,1,13,1,69,0,report: facebook give employee permission skip work protest trump may 1st
1,1,15,51,1,14,0,66,0,"son died, family decided build park kid disability"
1,1,11,37,0,11,2,48,0,19 tweet way funny everyone love sleep
1,1,5,26,0,5,2,31,0,11 struggle woman understand well
1,2,13,55,0,12,0,68,0,woman flood twitter story first time clothes sexualized
1,3,7,30,0,7,2,37,0,13 thing every indian done studying
1,1,12,33,0,11,0,45,0,city live based taste men
1,1,9,36,0,9,2,45,0,23 gift others secretly gift
1,1,9,30,1,8,0,39,0,toughest dragon ball z quiz ever take
1,3,2,38,3,8,0,40,0,adrian peterson say 'it's money'
1,1,9,22,0,9,2,31,0,19 sign go college small town
1,1,9,42,1,10,4,51,0,21 incredibly easy weeknight meal take 20 minute less
1,3,10,50,1,12,0,60,0,detroit rapper molly brazy seen pointing gun toddler head video
1,1,9,31,2,8,0,40,0,mom vs. daughter: make best enchilada
1,1,13,53,0,12,0,66,0,miley cyrus freak phone call hilary duff throwback interview
1,1,9,50,1,9,2,59,0,18 pointlessly gendered product destroy faith humanity
1,2,9,38,0,9,2,47,0,17 time pizza disrespected worst possible way
1,1,11,48,0,10,0,59,0,difference people social anxiety without
1,1,12,55,0,11,0,67,0,two high school student created game literally break stereotype
1,1,7,25,0,6,0,32,0,people play dreidel first time
1,2,7,26,1,7,2,33,0,60 food taste better high
1,2,15,56,2,14,0,71,0,deleted scene 'dear zindagi' tell closure important life
1,1,12,42,2,12,2,54,0,18 thing understand one find funny
1,1,8,32,1,8,2,40,0,21 struggle people messy never get
1,1,6,24,2,6,2,30,0,"random ""30 rock"" character"
1,3,2,40,3,10,0,42,0,"snap, crackle, pop: case study chasing hot stock"
1,3,11,39,2,9,0,50,0,"nyt: mexico owns california texas, trade amnesty"
1,1,9,34,1,9,2,43,0,24 thing know nigerian parent
1,1,8,40,0,8,2,48,0,21 ridiculously tasty treat made bailey irish cream
1,1,9,29,0,9,2,38,0,19 truth iced coffee reason
1,1,9,38,0,9,2,47,0,14 text best friend zero boundary send
1,2,12,43,1,11,0,55,0,"first time ever, black woman headlining coachella"
1,2,6,21,2,6,4,27,0,what's ahead luxury travel 2017?
1,3,8,35,1,7,0,43,0,gitmo board approves release al-qaeda bomb maker
1,1,8,25,0,7,0,33,0,belong london san francisco
1,1,9,28,0,8,0,37,0,guy hate shopping clothes much
1,2,11,60,2,15,0,71,0,"jamie scott secret writing hit one direction, justin bieber niall horan"
1,1,7,34,1,7,2,41,0,18 insanely pretty beet recipe valentine's day
1,3,3,52,1,11,0,55,0,family night! see nominee brought relative oscar
1,1,9,28,3,8,0,37,0,"""oops, forgot matt damon"" movie"
1,1,9,30,0,9,2,39,0,11 chart graph every james bond fan get
1,1,4,22,1,4,2,26,0,17 sign actually deadpool
1,1,8,29,0,8,2,37,0,11 gift true psychopath would ever give
1,1,11,32,1,10,0,43,0,time find actually know salma hayek
1,1,9,22,1,8,2,31,0,23 thing ra want know
1,1,7,21,1,6,0,28,0,one thing guy talk
1,1,13,53,1,12,0,66,0,people wearing glitter tear eye actually catching
1,1,12,42,0,11,0,54,0,inkblot test tell really living
1,3,11,38,1,9,0,49,0,t-shirt whitewashing worth thousand word
1,1,10,27,0,9,0,37,0,guess get sex
1,2,1,45,3,5,0,46,0,middlesbrough severed penis man's death 'misadventure'
1,1,10,42,0,9,0,52,0,bean meme twitter account actually matter
1,3,17,55,2,15,0,72,0,"slb issue official statement, swami om reach bigg bos finale venue ent"
1,3,8,45,3,8,0,53,0,washpo: trump voter motivated racism november election
1,3,6,30,2,5,0,36,0,ask billboard: madonna's career album sale
1,1,12,49,0,11,0,61,0,photographer prof canada magical place winter
1,2,1,37,0,6,0,38,0,navy fighter jet depriving pilot oxygen
1,1,8,38,3,8,2,46,0,"11 ""harry potter"" name pronouncing wrong"
1,1,9,41,0,9,2,50,0,21 frustration real anyone raised catholic
1,1,10,36,0,9,2,46,0,21 thing everyone obsessed lacroix know true
1,1,10,34,0,9,0,44,0,meme prove drake always dance beat
1,2,3,23,0,5,2,26,0,10 commandment tuxedo
1,1,10,32,1,10,2,42,0,17 website visit bored mind
1,3,7,27,0,9,4,34,0,need know 2017 tax season
1,1,12,51,2,11,0,63,0,"picture ""fuller house"" set make extremely nostalgic"
1,1,10,47,0,10,2,57,0,15 nearly impossible pop culture question queer lady answer
1,1,10,34,3,9,0,44,0,"""star wars"" j. crew collection rule galaxy"
1,2,15,69,2,15,0,84,0,guy handstand push-ups stack dumbbell latest person film super-dangerous gym stunt
1,1,10,39,0,10,2,49,0,24 time boston terrier cutest dog internet
1,1,8,24,0,7,0,32,0,kim kardashian jackie
1,1,11,32,0,10,0,43,0,instead going home holiday
1,1,12,45,2,10,1,57,0,mom painted 7-year-old daughter incredible star war mural
1,1,11,40,0,11,2,51,0,15 struggle everyone celebrity crush know true
1,1,8,28,1,7,0,36,0,what's favorite book written woman
1,1,11,44,0,11,2,55,0,17 picture guaranteed make want squigglism tattoo
1,2,11,24,2,10,6,35,0,19 time j.k. rowling sassy af twitter in2016
1,2,9,30,1,8,0,39,0,many apple product youowned?
1,1,8,22,0,7,0,30,0,tell someone like
1,1,10,36,2,9,0,46,0,"""bones"" squintern based zodiac sign"
1,2,1,38,0,6,0,39,0,inside world competitive sign spinning
1,3,14,39,2,15,3,53,0,here's easy way win 2 ticket hot 97's hot holiday show
1,1,6,36,0,5,0,42,0,presidential candidate extinct animal
1,1,13,46,0,12,0,59,0,people tried urine first time disgusted
1,2,10,38,2,10,2,48,0,"18 tanning salon horror story make say ""gross"""
1,3,1,36,0,7,4,37,0,eight way technology impacted life in2016
1,1,10,33,1,9,2,43,0,13 way grinch-ify every table holiday party
1,1,7,22,0,6,0,29,0,type british person
1,1,7,34,1,7,1,41,0,7 turkey wondering everyone's acting weird
1,2,12,41,2,11,2,53,0,"rare move, supreme court allows 24-week pregnant woman abort"
1,1,8,23,0,7,0,31,0,know teen famous
1,1,9,29,3,9,2,38,0,"19 time ""she's man"" funniest movie ever"
1,3,9,46,0,7,0,55,0,division iii football player arrested murder investigation
1,1,9,22,0,8,0,31,0,guess kind drunk
1,1,8,30,0,9,6,38,0,35 text 2015 really fucking funny
1,2,1,45,0,10,0,46,0,woman flew tornado bathtub survived
1,2,4,53,1,8,0,57,0,"democrat block confirmation vote sessions, price mnuchin"
1,1,8,30,1,7,0,38,0,handy phrase people
1,1,10,37,3,10,2,47,0,"23 time internet reminded u ""friend zone"" real"
1,1,7,24,0,7,2,31,0,19 thing woman love eating get
1,1,6,28,0,6,2,34,0,21 struggle attractive person
1,1,8,30,0,7,0,38,0,soulmate derek morgan spencer reid
1,1,13,40,2,12,0,53,0,"would ""harry potter"" wand made based zodiac"
1,3,16,55,6,15,0,71,0,pc say 'chal na katrina' zac efron baywatch's hindi trailer awfully hilarious!
1,2,2,57,4,12,0,59,0,pet 'emotion trackers' intelligent jean here. want them?
1,3,11,37,2,10,0,48,0,"dog remember do, even supposed"
1,2,1,41,1,9,3,42,0,8 men richer 3.6 billion people combined
1,1,3,13,0,2,0,16,0,bad driving school
1,1,13,48,2,12,0,61,0,"""jessica jones"" cast reveals would happen leaked spoiler"
1,3,10,53,1,11,0,63,0,husband's viral post urge men everywhere respect wife mother
1,1,9,29,0,9,2,38,0,23 people tinder might make smile
1,3,10,33,3,7,0,43,0,menendez aipac: steve bannon white nationalist
1,1,7,20,0,6,0,27,0,much know cheese
1,1,5,21,1,6,3,26,0,23 movie older today's year 7
1,1,11,44,0,10,0,55,0,emma watson sharing perfect quote remember alan rickman
1,3,9,54,6,8,0,63,0,photo shoot deep purple's 'infinite': exclusive behind-the-scenes footage
1,1,9,38,0,9,2,47,0,17 thing teen cared less seeing justin bieber
1,2,1,51,4,15,3,52,0,10 thing want see 'fast 9' (or whatever end called)
1,1,13,51,2,12,0,64,0,"christian bale amazing emotional deleted scene ""the big short"""
1,1,9,30,1,9,2,39,0,15 time blake lively's hair made weep joy
1,1,7,33,1,6,2,40,0,14 trully crappy review oscar-nominated film
1,3,11,66,0,12,0,77,0,asylum seeker suspected killing child receive cash payouts swedish government
1,1,9,46,2,8,0,55,0,what's underwhelming celebrity encounter ever
1,1,9,32,0,9,1,41,0,8 thing everyone abuelita know true
1,2,1,41,3,7,0,42,0,eight billionaire 'as rich world's poorest half'
1,1,8,35,0,8,2,43,0,55 thought everyone eating olive garden
1,3,17,53,2,14,0,70,0,"kansa governor writes pm modi, sc decline ansal's plea must read stoies"
1,1,7,26,0,7,2,33,0,15 new word added dictionary today
1,1,13,53,0,12,0,66,0,disney princess would look like boyfriend answered phone call
1,1,9,30,0,9,2,39,0,15 perfect way respond unwanted dick pic
1,2,1,63,3,10,0,64,0,"stranger living ""around corner"" discover they're sister"
1,2,14,61,0,15,0,75,0,nfl prospect missed winning island wore nike cleat instead adidas
1,1,15,49,1,13,0,64,0,single people get fake boyfriend girlfriend week weird af
1,1,13,55,1,13,1,68,0,makeup artist 3 princess jasmine look halloween gorgeous
1,2,10,33,4,10,3,43,0,see two baby dancing beyoncs7/11
1,2,1,63,1,11,4,64,0,biggest 2016 fantasy football lesson shouldnt forget next draft season
1,1,5,28,0,5,2,33,0,21 tweet homebody appreciate
1,1,7,36,3,7,2,43,0,"14 perfect situation hillary clinton's badass ""no"""
1,1,7,20,0,6,0,27,0,diploma toilet paper
1,1,7,20,0,6,0,27,0,alex haley dunphy
1,1,6,19,0,5,0,25,0,sleeping naked weird nah
1,2,6,28,2,7,4,34,0,best rock/alternative song 2016?
1,2,2,42,2,13,0,44,0,want new job new year? ask expert live chat
1,1,10,44,0,10,2,54,0,17 woman confessed really think receiving oral sex
1,2,8,55,5,13,0,63,0,darth vaders rogue one pun forced? many star war fan find disturbing.
1,1,15,47,2,14,0,62,0,"nick kroll amy poehler split, love dead, hatred summer grows"
1,1,7,24,0,7,2,31,0,13 chart every black girl relate
1,1,9,24,3,8,3,33,0,"45 thought ""ahs: hotel"" episode 5"
1,1,7,24,0,8,6,31,0,24 goat upped selfie game 2015
1,1,8,22,1,7,2,30,0,clothes forever 21 h&m
1,1,12,43,2,12,2,55,0,"42 thing would happen ""mean girls"" set philippine"
1,3,12,48,3,10,0,60,0,internet gave birth 'troll politics' president-elect trump
1,2,14,38,5,13,0,52,0,"ned ryun: trump know medium hate anyway, go big?"
1,1,11,40,0,10,0,51,0,reminder relationship abuse obvious
1,1,10,27,0,8,0,37,0,tv female friend group belong
1,1,10,31,0,9,0,41,0,need talk peanut butter baby right
1,1,5,20,0,6,6,25,0,31 golden retriever 2015
1,1,11,38,3,9,0,49,0,"reminder chad ""high school musical"" grown-up"
1,1,8,26,0,7,0,34,0,andy garcia committed full beard
1,1,11,38,0,11,2,49,0,17 tweet sick make laugh cough
1,1,10,52,0,10,2,62,0,16 beautifully curated vacation rental perfect design lover
1,1,11,39,1,10,0,50,0,scientist know make latest pluto photo
1,1,10,36,0,9,0,46,0,animal test reveal truly see
1,1,7,21,1,6,0,28,0,know going retire
1,1,10,35,0,10,2,45,0,17 mouthwatering food need eat lunar new year
1,2,2,31,2,5,4,33,0,davos 2017: teens' virtual reality challenge
1,1,9,27,3,8,0,36,0,"like ""wait marriage"""
1,1,7,48,2,7,2,55,0,"21 time ""beetlejuice"" perfectly described college experience"
1,1,4,15,3,3,0,19,0,"knock, knock! who's"
1,3,3,45,3,13,0,48,0,"friend dying. doctor, tell truth."
1,2,7,47,1,12,0,54,0,"apple kicked wwdc bill hader, drone least one goat"
1,3,9,60,1,12,3,69,0,report: islamic state general flees europe 400 soldier disguised refugee
1,1,9,39,2,8,0,48,0,"marnie piper returning town ""halloweentown"""
1,1,8,25,1,6,0,33,0,helped stop self-harming
1,1,15,34,0,12,0,49,0,know bizarre gif need see based zodiac
1,1,10,40,0,10,2,50,0,15 bloody delicious afternoon tea must eat die
1,1,8,40,1,8,1,48,0,7 mental health resource feeling helpless
1,2,3,49,3,13,3,52,0,quiz: real headline satirical one trump's 100 days?
1,1,5,24,0,5,2,29,0,name 10 constellation
1,3,12,61,3,13,0,73,0,"wash post: obama administration spent billion fix failing schools, didnt work"
1,2,10,46,4,9,0,56,0,"blue state blues: thank you, president-elect trump, saving israel"
1,1,11,36,4,10,0,47,0,"there's new hairstyle called ""hun"" taking"
1,1,9,33,1,8,0,42,0,here's video game actually healthy
1,1,11,38,0,10,0,49,0,might cry watching koko gorilla new kitten
1,3,2,49,3,7,0,51,0,romania protests: 'race time' corruption fighter
1,2,2,76,2,16,0,78,0,"man's son killed himself, decided world needed little kindness list"
1,2,7,22,2,7,4,29,0,artist winning 2016 far? vote!
1,3,3,39,1,8,0,42,0,hollywood afraid march netflix?
1,2,10,32,0,11,6,42,0,21 moment 2016 reminded u love body
1,1,10,31,1,8,0,41,0,try guy learn perform iconic k-pop dance
1,1,8,34,3,8,2,42,0,"26 thing probably notice ""jessica jones"""
1,1,8,34,0,8,2,42,0,36 picture people living best onesie life
1,2,8,41,1,8,0,49,0,watchdog group trump suit hinge risky legal argument
1,1,7,36,0,6,0,43,0,celebrity actually valentine
1,1,8,34,0,7,0,42,0,one direction song match zodiac sign
1,1,7,34,0,7,2,41,0,19 brutally honest confession tesco worker
1,1,11,39,0,10,0,50,0,know name based opinion disney movie
1,3,7,44,2,11,0,51,0,super bowl li quiz: root falcon patriots?
1,1,9,35,2,9,2,44,0,"43 reason ""home alone"" worst christmas movie ever"
1,1,9,50,1,8,0,59,0,shonda rhimes' comment diversity television everything
1,1,9,35,0,8,0,44,0,gift list hack might actually save holiday
1,1,7,29,0,8,6,36,0,18 hilarious medium correction 2015
1,1,10,41,2,9,2,51,0,"20 overcrowded, anxiety-inducing place world"
1,1,16,56,3,15,0,72,0,"would look like ""friends"" written insane, malevolent computer"
1,3,5,54,1,12,1,59,0,fast furious 8 trailer: fate furious look totally banana
1,1,10,46,0,10,2,56,0,11 thing definitely happen donald trump president
1,1,16,53,0,12,0,69,0,lgbt college student letting future teacher know need
1,1,10,43,1,9,0,53,0,film pixar's tribute classic cinema brilliant
1,2,12,61,4,10,0,73,0,payback potential australian prime minister's 'dumb deal' earns trump tongue-lashing
1,1,7,17,0,7,2,24,0,26 gift emo life
1,3,10,35,0,10,2,45,0,27 drinking meme need send school friend
1,2,9,56,1,9,0,65,0,"britney spear fan prank southwest airlines, receives perfect response"
1,1,8,30,0,8,4,38,0,predict 2016 fortune one question
1,1,6,22,0,6,2,28,0,21 reason pie come guy
1,1,9,25,0,8,0,34,0,love based zodiac sign
1,2,9,23,1,8,2,32,0,top 50 ceo ranked worker
1,1,11,41,0,11,2,52,0,19 thing happen get together uni friend
1,1,12,31,1,11,0,43,0,need stop date robot
1,1,10,27,0,10,2,37,0,17 time ellen oprah u squad
1,1,7,17,0,4,2,24,0,15 australian animal dgaf
1,1,8,22,0,7,0,30,0,well know kanye west song
1,2,8,48,3,10,0,56,0,corbyn: theresa may denial nh crisis scapegoating gps
1,1,12,46,2,11,0,58,0,"hair salon offering ""quiet chairs"" people hate talking"
1,1,12,43,2,11,0,55,0,"need talk christening speech ""jane virgin"""
1,1,10,32,0,9,0,42,0,many google search trick know
1,3,10,45,2,9,0,55,0,what's special apple? handset maker ask government
1,1,11,36,3,10,0,47,0,"would specialty doctor ""grey's anatomy"""
1,1,14,44,2,13,0,58,0,"would survive one day enchanted forest ""once upon time"""
1,1,11,43,0,10,0,54,0,david schwimmer looked exactly like kylo ren younger
1,1,7,29,0,7,2,36,0,25 delicious reason eat miso
1,3,8,38,3,8,0,46,0,"donald trump, chicago, job report: friday briefing"
1,1,12,43,0,11,0,55,0,amputee performed amazing routine dance show
1,1,13,43,0,12,0,56,0,know zodiac sign based ice cream drumstick choose
1,1,10,31,3,9,0,41,0,"like blair serena ""gossip girl?"""
1,1,12,37,0,11,0,49,0,boyfriend dressed week happened
1,1,11,39,0,11,2,50,0,30 tweet science make laugh think
1,1,15,32,0,13,0,47,0,people go bar crawl find best nacho la
1,1,14,36,0,13,0,50,0,one question tell good driver
1,1,13,43,0,12,0,56,0,new horror movie make scared mom grandma
1,3,10,55,1,11,0,65,0,kylie jenner showed christina aguilera's birthday bash vintage xtina
1,1,7,25,2,6,0,32,0,"""the lego movie"" character"
1,3,9,43,2,8,0,52,0,donald trump visitor log show who shaping transition
1,1,10,38,2,10,2,48,0,"33 ""mean girls"" quote guaranteed make laugh every time"
1,1,15,47,3,14,0,62,0,"priyanka chopra's prep red carpet eat burger, amazing"
1,1,12,41,0,11,0,53,0,dude put makeup moving car finally understand
1,1,10,34,2,9,0,44,0,"like jessica trish ""jessica jones"""
1,1,12,52,5,11,0,64,0,"twitter's made clear ""parks recreation"" ""hamilton"" soulmates"
1,2,3,42,0,9,2,45,0,27 stunning image taken google street view
1,1,12,40,1,12,2,52,0,21 way life would different never met best friend
1,1,8,31,0,7,0,39,0,martha stewart fix typo like fucking bos
1,1,7,35,0,6,0,42,0,font choice determine personality
1,1,6,35,0,6,2,41,0,19 cat reaction every thanksgiving situation
1,1,8,32,3,7,0,40,0,"well remember sawyer's ""lost"" nickname"
1,1,6,26,0,6,2,32,0,17 time cat loved summer produce
1,2,2,48,1,11,0,50,0,alys fowler: give seedling best start life
1,1,10,28,2,9,0,38,0,what's worst thing ever done dare
1,1,9,29,0,9,2,38,0,13 cute animal living moment
1,1,11,45,2,10,0,56,0,"ariana grande reunited ""victorious"" cast perfect"
1,1,10,39,1,10,2,49,0,27 thing bed involve watching netflix
1,1,11,31,2,10,0,42,0,"cast ""love actually"" look like"
1,1,11,45,0,12,5,56,0,9 time ranbir kapoor katrina kaif gave u relationship goal 2015
1,1,14,53,0,13,0,67,0,jennifer lawrence amy schumer add chris pratt aziz ansari squad
1,1,11,35,0,10,0,46,0,know food based three question
1,3,9,30,0,8,0,39,0,best deal internet weekend
1,3,4,44,1,8,0,48,0,saving sally: little filipino film needed saving
1,1,8,22,0,6,0,30,0,uk artist listen
1,1,8,31,0,7,0,39,0,jewel staite best twitter account ever
1,1,6,19,0,7,6,25,0,50 best jaden smith tweet 2015
1,1,10,12,0,5,0,22,0,bmi look like irl
1,3,1,39,3,8,0,40,0,'world's original sport car' sold auction
1,1,9,39,1,9,2,48,0,13 unique side dish steal show thanksgiving
1,1,10,24,0,9,0,34,0,well see color rainbow
1,1,14,58,2,13,0,72,0,"everyone know neville longbottom best damn character ""harry potter"""
1,3,4,43,1,9,0,47,0,american think donald trump good president?
1,2,5,60,0,14,2,65,0,samsung galaxy s8 price leak suggests much cheaper apple iphone 8
1,3,8,35,0,7,0,43,0,american still feel shaky retirement
1,1,6,17,0,5,0,23,0,party mix food
1,1,13,44,0,12,0,57,0,monster sugar cooky cutest thing see day
1,3,1,53,5,10,0,54,0,antarctica's sky lit electric-blue cloud here's
1,1,7,27,0,7,2,34,0,horoscope week september 28
1,2,11,61,2,9,0,72,0,pegavoice: disruptors wanted: successful company view employee customer
1,1,5,22,1,5,2,27,0,22 sign obsessed venmo
1,1,16,59,2,15,0,75,0,"emilia clarke jason momoa cutest ""game thrones"" reunion paris fashion week"
1,1,8,27,0,8,2,35,0,18 newborn puppy ready take world
1,1,8,36,1,7,0,44,0,new year's eve underwear tradition around world
1,1,9,32,0,8,0,41,0,classic literature quote indie lyric
1,3,1,77,3,17,0,78,0,white kid taunt black student body slam made race high school main subject
1,1,8,31,1,7,0,39,0,hardest tube station quiz take today
1,3,5,25,1,3,0,30,0,celebrity meet-cute story
1,3,14,64,0,14,0,78,0,patriot owner bob kraft reveals donald trump helped difficult life crisis
1,1,12,36,0,11,0,48,0,pick doodle determine need weekend
1,1,10,27,0,9,0,37,0,soy milk go funny coffee
1,1,10,37,0,11,6,47,0,12 incredible thing imgur video game 2015
1,1,13,47,1,13,4,60,0,"amanda seyfried justin long split, proving 2015 year love died"
1,1,10,42,3,10,5,52,0,"taylor swift donated $50,000 backup dancer's nephew cancer"
1,3,10,73,3,14,0,83,0,donald trump's u treasury secretary: thing may know ex-goldman banker steven mnuchin
1,1,13,38,2,10,0,51,0,"""friends"" character bff based zodiac sign"
1,1,11,45,2,9,0,56,0,"could successfully rob mccallister family ""home alone"""
1,1,9,35,1,9,2,44,0,19 sign thirsty one friendship group
1,2,9,40,1,10,4,49,0,13 classic 00s song actually meant otherartists
1,1,8,21,0,6,0,29,0,tv drama leading lady
1,1,10,33,0,10,2,43,0,21 dad way embarrassing good
1,1,10,34,2,9,0,44,0,"well remember first episode ""scandal"""
1,2,2,76,1,17,0,78,0,non-apology year award go nobel scientist think woman cry time
1,1,14,47,1,13,0,61,0,woman made robot help apply lipstick hilariously bad
1,2,9,52,0,8,0,61,0,oblivious guy hilariously explained happens gynecologist
1,1,7,32,0,7,2,39,0,25 halloween makeup look actually easy
1,3,11,46,1,11,0,57,0,forget kobe beef: cult steak everybody want right
1,1,8,26,0,7,0,34,0,watch adorable emu try play fetch
1,3,8,36,1,7,0,44,0,toy horse's wildly detailed dick freak internet
1,1,5,30,0,5,2,35,0,12 iconic female character without makeup
1,3,4,38,0,9,0,42,0,prediction top free agent nfl team
1,1,11,36,4,8,0,47,0,"""star wars"" audition ""snl"" beyond hilarious"
1,1,9,46,0,9,2,55,0,21 insanely easy appetizer guaranteed please party guest
1,2,11,49,2,10,1,60,0,6th-grade girl purposefully broke school's sexist dress code
1,1,7,35,0,7,2,42,0,19 product every single girl buy
1,1,12,52,0,11,0,64,0,tell difference photo space movie screenshots
1,3,12,64,4,13,0,76,0,"here's miley cyrus, kylie jenner, chrissy teigen, celebrity rang christmas"
1,1,9,36,1,8,2,45,0,16 monster-themed treat need make halloween
1,1,12,41,2,12,3,53,0,here's men women's fashion evolved past 100 year
1,1,14,44,1,11,0,58,0,people posting racist comment mac's instagram black model
1,1,8,33,1,8,2,41,0,16 animal pal care resolution
1,1,13,56,1,12,0,69,0,tell u ridiculous thing bought drunk grocery shopping
1,1,9,35,1,9,2,44,0,17 reason relationship solid think
1,1,9,41,0,9,2,50,0,33 incredible real headline could happen canada
1,1,6,34,1,5,0,40,0,"remembering jenkem, greatest internet hoax"
1,1,7,20,1,7,2,27,0,19 stans stan'd little hard
1,1,8,27,0,7,0,35,0,taylor swift oprah winfrey
1,2,8,30,0,8,2,38,0,19 meme period fuckingreal
1,1,11,31,3,11,1,42,0,"kaley cuoco performed ""i'm slave 4 u"" damn snake"
1,1,13,42,0,12,0,55,0,chris moyles returning radio breakfast show radio x
1,1,10,37,3,9,0,47,0,"here's thackery binx ""hocus pocus"" look like"
1,1,11,32,0,11,4,43,0,reminder everyone wore new year 2005
1,1,11,22,0,10,0,33,0,red one blue one
1,1,14,37,1,13,0,51,0,tell pop song lyric hallmark greeting card
1,2,1,48,1,9,2,49,0,15 surprising fact tesla car probably know
1,3,6,22,3,7,0,28,0,like live mar [video]
1,1,9,25,0,9,2,34,0,27 gift people done work
1,2,3,39,1,6,0,42,0,burkina faso's new war militant islamist
1,1,14,46,5,13,0,60,0,"original jan ""the brady bunch"" shop teacher ""grease: live"""
1,2,7,23,1,6,1,30,0,7 life-changing thing try inmarch
1,1,11,44,0,11,2,55,0,19 map change see favourite fictional world
1,3,4,36,5,7,1,40,0,"7 can't-miss apps: duobook, forest, alarmmon"
1,1,13,41,3,13,2,54,0,"25 hearty soups, stews, chili fill keep warm"
1,1,7,23,1,7,2,30,0,13 film know poot starred
1,2,1,57,2,11,3,58,0,get ready watch first-ever 360-degree livestream rocket launch
1,1,10,43,2,9,0,53,0,"""finding nemo"" character based personality"
1,2,4,60,0,11,0,64,0,brother jailed trafficking people poland work sport direct
1,2,11,33,4,11,0,44,0,"super rich, probably live u.s.: chart"
1,3,8,33,0,8,2,41,0,23 insane picture trump president
1,1,10,44,6,10,2,54,0,"26 ""harry potter"" quote made hilarious replacing ""wand"" ""penis"""
1,1,16,39,0,12,4,55,0,photo make 2016 baftas look like golden age hollywood
1,1,12,36,0,10,0,48,0,asked lea delaria honest advice thing got real
1,1,7,24,2,7,2,31,0,"jenna maroney ""30 rock"""
1,1,5,13,2,4,2,18,0,29 real l.a. problem
1,1,7,27,0,8,6,34,0,18 picture 2015 guaranteed make sad
1,1,9,29,0,10,6,38,0,11 hugest meme happen 2016
1,1,9,31,0,10,6,40,0,28 paris hilton thing paris hilton 2015
1,1,4,20,0,3,0,24,0,crazy confession ex
1,2,2,47,1,7,0,49,0,twist fate save brazilian football commentator's life
1,1,10,38,1,9,0,48,0,here's need know getting popular tattoo
1,1,8,35,0,7,0,43,0,terrifying pirate queen history
1,2,3,50,2,13,0,53,0,"decorated christmas tree yet? so, want see"
1,1,11,45,0,10,1,56,0,9 actor actually oscar nomination leo dicaprio
1,1,6,21,1,4,0,27,0,ultimate kool-aid taste test
1,1,9,23,0,8,0,32,0,like emma swan dark swan
1,2,1,52,1,6,0,53,0,uber whistleblower expose breach driver-approval process
1,1,7,22,0,9,8,29,0,31 song turning 10 year old 2016
1,2,3,37,4,9,2,40,0,"crystal pepsi's back, want '90s things,"
1,1,9,37,0,8,0,46,0,getting massage shifted relationship body
1,2,3,66,6,14,0,69,0,fairytale ending: 'magic beans' grow reveal secret message telling 'it's over'
1,3,5,19,2,4,0,24,0,child-free live longer?
1,3,16,66,0,15,0,82,0,guy us facial recognition get info random stranger send one important message
1,1,8,24,0,8,2,32,0,19 sexiest book ever read
1,1,9,36,0,8,0,45,0,might best sweater breastfeeding mom
1,2,1,54,2,13,0,55,0,root review: remake brutal harrowing need
1,1,13,45,1,11,0,58,0,stunning photo captured split second hot tea froze mid-air
1,2,9,27,2,6,0,36,0,official! donald trump speaking cpac
1,1,5,27,0,4,0,32,0,someone mispronounces name
1,3,10,45,3,9,0,55,0,"character shonda rhimes regret killing ""grey's anatomy"""
1,1,10,37,0,9,0,47,0,peter dinklage debuted glorious man bun emmy
1,1,15,51,1,14,0,66,0,"based one picture, patrick stewart living life far better"
1,3,1,43,1,10,0,44,0,"former model starved death, anorexia"
1,3,15,62,3,14,0,77,0,gujarat indian state number company 'vanished' people's money
1,1,12,43,2,10,0,55,0,woman found h&m's balmain collection google leaked
1,1,13,52,1,12,0,65,0,government's official medium bureau tweeted fake photo modi chennai
1,1,8,32,0,8,2,40,0,11 emojis former emo kid would definitely use
1,1,7,30,0,7,3,37,0,woman 350 ugly christmas sweater
1,1,11,30,0,10,2,41,0,21 photo anyone drunk af relate
1,1,9,29,0,9,2,38,0,23 people clearly know thing work
1,3,9,40,5,9,0,49,0,"james baldwin archive, long hidden, come (mostly) view"
1,2,2,41,0,11,0,43,0,map country eat meat list
1,1,7,31,0,7,2,38,0,15 thought every germaphobe airplane
1,3,14,53,3,14,1,67,0,"akshay donates martyred jawans' kin, baahubali 2 trailer ent!"
1,1,8,29,0,8,2,37,0,16 craziest celebrity mug shot time
1,3,4,57,2,16,1,61,0,fined 1% profit mild irritation bt? look like
1,1,10,36,2,9,0,46,0,what's meanest thing ever done sibling
1,1,7,25,0,6,0,32,0,anyone still us nightlight
1,1,12,37,0,12,2,49,0,12 cute snake tiny hat help conquer fear
1,2,2,15,0,5,5,17,0,expect e3 2015
1,1,10,47,3,9,0,57,0,"here's happened priyanka chopra visited ""jimmy kimmel live"""
1,1,8,29,1,9,4,37,0,22 photo halloween looked like '90s
1,1,14,49,0,13,0,63,0,everyone attracted pharrell puppet new missy video
1,1,7,34,0,7,2,41,0,27 insanely clever halloween costume dog
1,1,10,39,2,9,0,49,0,"""clueless"" character based zodiac sign"
1,2,7,79,2,13,0,86,0,"sherlock series four: teaser trailer drop clue tom hiddleston, moriarty margaret thatcher"
1,3,2,50,1,8,0,52,0,trump shell game russia make everything look suspicious
1,1,12,31,3,9,0,43,0,"adele's reaction ""snl"" skit perfect"
1,1,8,25,0,7,0,33,0,take quiz make brain orgasm
1,1,10,51,2,10,2,61,0,23 thing understand slightly obsessed smoothy
1,1,8,37,0,7,0,45,0,helped eating disorder recovery
1,3,8,28,0,8,2,36,0,15 mom whose weird idea might begenius
1,1,7,26,0,7,2,33,0,24 fact lube really know
1,1,7,34,0,6,0,41,0,curvy targeting banned gmail advertiser
1,1,9,26,0,9,2,35,0,23 beautiful dog world
1,1,9,25,0,9,2,34,0,15 dog feel type way bathtime
1,1,12,35,1,11,0,47,0,take quiz find meet true love
1,1,10,38,0,9,0,48,0,dachshund determined sleep teddy bear
1,2,2,49,0,11,0,51,0,woman using tinder match scam money men
1,3,6,41,1,6,0,47,0,widow chronicle husband murder illegal immigrant
1,1,7,23,0,6,0,30,0,bollywood era belong
1,2,10,39,1,10,0,49,0,"rex tillerson, exxon mobil forged path abroad"
1,1,9,38,2,9,5,47,0,"avenger based favorite ""90210"" character"
1,1,8,41,1,7,0,49,0,matthew gray gubler's tweet motivational poster
1,3,11,36,2,10,0,47,0,here's paris street named steve job
1,1,5,14,0,4,0,19,0,actually diva
1,3,8,42,2,8,0,50,0,ashley judd: trump election victory worse raped
1,3,8,32,3,8,2,40,0,"22 lady gaga look thatll leave you, honestly,shook"
1,1,6,29,0,6,2,35,0,23 time feminist perfect comeback
1,1,12,36,2,11,0,48,0,"long would last kappa kappa tau ""scream queens"""
1,1,12,46,1,11,0,58,0,probably know real reason chinese woman bound foot
1,1,7,33,0,7,2,40,0,10 delicious recipe make eating healthy fun
1,1,6,15,0,5,0,21,0,toad yoshi
1,1,11,44,0,11,2,55,0,15 humorously honest thing liam gallagher ever said
1,1,7,30,0,7,2,37,0,16 vine people smoke understand
1,1,8,34,0,8,2,42,0,21 thing people dating hockey player get
1,1,5,20,1,5,4,25,0,2015's biggest meme emojis
1,1,14,36,0,10,0,50,0,motivational shia labeouf gif need see today
1,2,3,34,1,11,0,37,0,go brain get dj vu
1,2,7,30,0,7,2,37,0,53 best opening sentence literature
1,1,10,41,1,10,2,51,0,17 thing woman makeup understand
1,1,13,51,0,12,0,64,0,retired woman compiled memory box remind life
1,2,10,33,0,8,0,43,0,survey point challenge nato face russia
1,1,6,22,0,5,0,28,0,avoid internet argument
1,1,15,46,2,14,0,61,0,"match ""the great british bake off"" innuendo person said"
1,2,2,64,0,14,4,66,0,poster celebrity world lost 2016 heartbreaking list
1,3,2,42,1,9,0,44,0,there's key risk europe everybody missing
1,1,12,44,1,11,0,56,0,tear hearing josh groban kelly clarkson duet
1,1,9,29,1,7,0,38,0,terrible tale racist one-night stand
1,2,6,28,3,5,0,34,0,donald trump: nobody belief susan rice
1,1,12,48,0,11,0,60,0,hot bartender possibly best jeopardy contestant time
1,2,7,37,1,8,6,44,0,"economy gain 227,000 job january president trump"
1,1,6,30,1,6,2,36,0,17 nifty product declutter life
1,3,2,63,5,17,0,65,0,"call pig police personal. head, itwas personal"
1,3,10,45,0,9,0,55,0,eight secret waterfall make next vacation magic
1,2,3,68,1,13,0,71,0,conspiracy theory-spreading website seat white house briefing room
1,1,13,42,1,12,0,55,0,avril lavigne nick carter released single pop dream
1,3,13,41,1,12,0,54,0,know many oscar nominee pas bechdeltest?
1,1,12,40,0,11,0,52,0,know decade belong based five question
1,1,9,28,0,8,0,37,0,new product teach men kegels
1,2,16,55,4,14,0,71,0,"gop sen cotton: dems filibuster, republican must confirm gorsuch"
1,1,7,28,0,6,0,35,0,meet girl buttchugged cough syrup
1,1,11,54,1,10,0,65,0,organisation trying launch india's first transgender model agency
1,1,4,22,0,4,2,26,0,18 shocking big dick confession
1,1,6,32,1,6,2,38,0,"12 classic poems, rewritten depression"
1,1,9,34,1,8,0,43,0,let's spend time watching oscar isaac sing
1,3,5,67,0,14,0,72,0,dramatic difference mike penny donald trump come press
1,1,10,57,1,9,0,67,0,grandmother's reaction meeting adopted granddaughter priceless
1,1,10,37,0,12,10,47,0,12 photo reveal british class system 1970s 1980s
1,1,8,32,0,8,2,40,0,13 awkward moment happen get brace
1,3,10,40,2,10,2,50,0,26 annoying house hunter moment piss every time
1,2,7,40,0,9,0,47,0,get benefit fasting less deprivation
1,3,2,32,0,5,0,34,0,folk packing republican town hall
1,1,8,41,1,7,0,49,0,america's iconic landmark finished
1,1,13,40,0,12,0,53,0,people try smelliest fruit front live audience
1,1,10,38,2,10,2,48,0,"17 iconic ""american idol"" performance time"
1,3,4,46,0,11,0,50,0,happiest unhappiest place live uk list
1,1,9,43,0,8,0,52,0,empire confronted racism homage classic hollywood
1,1,14,46,2,13,0,60,0,"mom shut hilarious ""first day school"" picture"
1,2,1,21,0,3,0,22,0,bookish football star
1,3,8,27,0,10,4,35,0,10 good reason change job every 3 5 year
1,1,8,33,1,8,1,41,0,7 healthy eating trick actually want try
1,3,8,79,0,18,0,87,0,alien bug hitching ride earth spacecraft could attack human must never allowed escape
1,1,10,25,0,9,0,35,0,need talk lady gaga flop
1,1,4,28,0,3,0,32,0,southerner guess yorkshire phrase
1,1,10,30,0,10,2,40,0,17 way crafternoon bottle booze
1,2,1,29,2,7,0,30,0,'drugs fix room like second home'
1,1,13,43,0,13,2,56,0,21 thing woman makeup public transport know true
1,1,11,37,0,10,0,48,0,thing concert would weird anywhere else
1,3,9,38,3,9,0,47,0,robot coming job. they're already
1,2,5,21,0,5,2,26,0,literally 19 large cat
1,2,1,49,2,7,0,50,0,warring neighbour delight internet intense 'sign war'
1,1,8,33,3,8,2,41,0,"leslie knope's 33 best line ""parks recreation"""
1,2,2,71,4,18,0,73,0,"pastor wrote book better man. week later, caught naked, affair."
1,1,9,38,2,8,0,47,0,"alan rickman wrote perfect farewell ""harry potter"""
1,1,8,18,1,6,2,26,0,18 cake gifs make moist
1,1,9,28,3,8,0,37,0,"first ""hunger games"" red carpet vs. last"
1,1,8,29,0,7,0,37,0,weird food love eating together
1,1,5,16,0,6,6,21,0,18 place must travel 2016
1,3,14,59,0,14,1,73,0,chemical leak cleaning operation leaf least 7 worker dead latur oil mill
1,1,11,41,1,10,0,52,0,"great question answered, hot dog sandwich"
1,2,1,25,0,5,0,26,0,best place swim shark
1,1,7,37,0,7,2,44,0,26 picture people without kid never understand
1,1,7,31,1,7,2,38,0,42 question every girl victoria's secret
1,1,7,35,1,7,2,42,0,26 halloween costume actually keep warm
1,2,9,34,2,8,0,43,0,u.s. car maker idle plant amid oversupply concern
1,1,6,34,1,5,0,40,0,justin theroux's eyebrow wonderful actor
1,1,12,31,0,10,2,43,0,29 perfectly autumn thing must nyc fall
1,3,9,44,4,8,0,53,0,new okeefe video: leftist planning stink bomb deploraball
1,1,13,56,3,12,0,69,0,"""be like bill"" meme passive aggressively call people's social medium habit"
1,1,8,34,0,8,2,42,0,33 powerful book help depression
1,2,14,59,1,14,0,73,0,"justin bieber sport curse definitely real, claimed latest victim"
1,1,14,52,0,13,2,66,0,13 animal masturbation fact make feel better single af
1,1,16,57,3,14,0,73,0,"ashley nell tipton first ""project runway"" winner win plus-size collection"
1,2,11,44,2,10,0,55,0,biggest moment nancy pelosi's town hall almost happen
1,1,10,53,1,10,2,63,0,"15 highly important question adulthood, answered michael ian black"
1,2,9,44,0,10,4,53,0,advanced imaging reveals secret 1491 map columbus may used
1,2,4,15,0,4,4,19,0,unhappiest job 2017
1,1,8,36,0,8,2,44,0,17 drag queen transformation blow mind
1,1,5,20,0,6,6,25,0,19 best autocorrect fails 2015
1,1,11,37,0,10,0,48,0,best friend katy perry taylor swift
1,1,9,42,1,9,2,51,0,22 fucking adorable valentine's gift baes love cursing
1,1,14,41,0,14,2,55,0,last 30 second post full picture zit popped
1,2,11,50,3,11,2,61,0,18 time community snuck hilarious little joke mightvemissed
1,3,2,69,4,15,2,71,0,"really like date 30s: panic mode, emotional baggage single parents?"
1,3,8,31,1,7,0,39,0,dystopian movie universe belongin?
1,2,4,56,2,9,0,60,0,'planet earth ii' replaced human scream hilariously disturbing
1,1,10,36,2,10,2,46,0,"17 tumblr post ""harry potter"" make weep"
1,2,3,59,0,10,0,62,0,third man arrested connection alleged pamela geller beheading plot
1,2,4,58,2,12,0,62,0,first u delivery amazon drone publicly caught video
1,1,7,19,0,6,0,26,0,feel period sex
1,1,10,43,2,9,0,53,0,"thank ""unbreakable kimmy schmidt"" pizza rat boulevard"
1,2,6,27,2,5,0,33,0,instagram's new update game-changer
1,1,8,32,3,7,0,40,0,"well remember sean paul's ""temperature"""
1,1,9,25,0,8,0,34,0,role would play disney movie
1,1,5,26,0,5,2,31,0,29 beautiful men beautiful beard
1,1,7,26,0,7,2,33,0,27 insane pizza mashups need right
1,2,3,34,3,9,0,37,0,"obama middle east little, late?"
1,1,5,29,0,5,2,34,0,19 struggle every blogger recognize
1,3,4,70,2,16,4,74,0,"sat tutor charge $1,500 hour explains everyone wrong preparing test"
1,3,10,39,0,8,0,49,0,aclu back zuckerberg censorship new medium facebook
1,1,13,40,3,11,0,53,0,t.i. think woman president united state
1,3,1,66,0,14,0,67,0,secret camera hook public toilet pervert using spy people
1,1,12,46,0,11,2,58,0,13 epic gingerbread house inspired favorite movie tv show
1,1,7,21,0,6,0,28,0,much welsh food tried
1,1,7,21,0,7,2,28,0,21 life lesson big ang taught u
1,2,8,50,0,9,0,58,0,mexican couple suspected killing american green card marriage
1,2,4,60,2,11,0,64,0,'dear white people' trailer spark backlash netflix face claim racism
1,3,6,23,1,5,0,29,0,here's people believe fake news
1,1,7,30,0,7,2,37,0,30 time portland portland function
1,1,8,26,1,7,0,34,0,who's enemy based zodiac sign
1,1,10,35,0,10,2,45,0,26 picture leave asking lot question
1,3,9,47,3,9,0,56,0,watch: celebrity sing survive ahead trump inauguration
1,1,10,40,0,10,2,50,0,62 thing mildly irritate everyone work office
1,1,9,41,0,8,0,50,0,justin trudeau meet taylor swift hilarious parody
1,1,7,26,0,7,2,33,0,horoscope week november 16
1,3,2,65,0,10,0,67,0,scientist apparently discovered make perfect breast list
1,1,9,36,1,7,0,45,0,dj khaled's snapchats perfect fortune cooky
1,1,9,35,0,9,2,44,0,21 elf shelf accessory need christmas
1,2,5,60,4,14,0,65,0,'we're eye candy': meet female wwe wrestler changing game
1,1,5,14,0,4,0,19,0,mar arizona
1,1,6,35,0,6,2,41,0,17 incredibly honest confession wet dream
1,3,5,35,0,6,0,40,0,make cauliflower broccoli compelling
1,1,9,35,0,9,2,44,0,28 insanely awesome gift coolest geek know
1,1,5,14,0,4,0,19,0,winter
1,2,0,43,0,10,4,43,0,30 city everyone 30 want live right
1,1,8,45,0,7,0,53,0,muslim american tweeting amazing picture
1,1,6,30,0,6,2,36,0,19 picture cat people never understand
1,1,14,47,0,14,2,61,0,22 sentence way real people grew strict parent
1,1,9,39,0,8,0,48,0,dad read text daughter sent boyfriend
1,1,5,18,0,4,0,23,0,carb soulmate
1,1,12,40,1,10,0,52,0,push-up bra actually look like different size
1,2,4,71,3,14,0,75,0,rick perry think america need president who served military. voter agree?
1,2,8,38,1,8,0,46,0,ally fear trump eroding america moral authority
1,1,14,38,1,12,0,52,0,tried stand-up comedy first time awful
1,1,9,34,0,8,2,43,0,14 picture shia labeouf movie watching movie
1,1,11,41,0,10,0,52,0,motivational poster see dentist honest
1,1,16,62,0,16,4,78,0,group sending hand sanitisers mark zuckerberg victim 2002 gujarat riot
1,1,5,16,1,4,0,21,0,texting back
1,2,13,72,1,13,0,85,0,prosecutors: inauguration day protester arrested charged felony rioting
1,1,8,30,0,8,2,38,0,21 agonizing truth people feel much
1,3,4,24,0,4,0,28,0,child rapist deported ecuador
1,1,13,44,1,12,0,57,0,here's evidence zayn malik gigi hadid could dating
1,1,8,44,0,8,2,52,0,28 picture tweet guaranteed make absolutely everyone laugh
1,1,11,29,0,10,0,40,0,afraid deep sea outer space
1,1,10,33,2,10,2,43,0,17 photo remind world bad
1,1,5,28,0,5,2,33,0,21 confession parent teenager
1,1,12,35,0,11,0,47,0,parent explain bird bee
1,2,8,35,0,7,0,43,0,heart attack striking healthy young woman
1,3,10,40,5,11,0,50,0,steve bannon: warned ailes megyn kelly shes devil
1,1,12,39,0,11,0,51,0,kate middleton strange wave need addressed
1,3,4,39,1,8,0,43,0,kind manager president donald trump be?
1,1,9,29,0,8,0,38,0,sorry lorelai gilmore kind worst
1,3,9,31,0,9,2,40,0,25 moment laziest lazy people willget
1,1,8,41,0,7,0,49,0,tell u heartwarming celebrity encounter
1,1,7,34,3,6,0,41,0,"remember ""friends"" characters' middle name"
1,1,7,22,1,6,0,29,0,weirdo group
1,1,8,32,3,8,2,40,0,"29 fact probably know ""the holiday"""
1,1,6,15,0,5,0,21,0,ask consent
1,3,3,18,0,4,0,21,0,culture nastiness
1,3,2,37,1,7,0,39,0,tragic kingdom disney land flopped
1,2,11,40,0,11,2,51,0,19 time kris jenner savagely roasted hell herfamily
1,1,9,38,0,8,0,47,0,anyone realizes turned squidward
1,1,12,37,1,11,0,49,0,here's dog injured baby deer became best friend
1,1,14,54,0,14,2,68,0,17 totally delectable butter need slathering body right
1,1,12,21,6,8,0,33,0,**for agent jack raze only. stop. read**
1,1,10,25,0,9,0,35,0,cook real feast seven fish
1,2,13,60,0,13,2,73,0,25 child selected across india revered national bravery award
1,1,13,46,0,13,2,59,0,23 word completely different meaning grew london
1,1,10,36,1,10,2,46,0,19 people sadly get birthday present year
1,1,14,53,0,13,0,67,0,easy pizza grilled cheese probably delicious thing make
1,1,16,44,3,14,0,60,0,(kind of) like producer buzzfeed motion picture
1,1,7,30,0,7,2,37,0,21 thing ulta beauty fan understand
1,1,10,27,3,10,2,37,0,"here's 20 hour ""star wars"" person"
1,3,1,42,4,8,3,43,0,"woman shot dead; great-grandson, 13, among 3 teen charged"
1,1,11,49,0,10,0,60,0,hilarious game help get thanksgiving travel hell
1,1,12,53,1,12,2,65,0,12 jimmy fallon impression make actually believe someone else
1,1,12,44,0,11,0,56,0,know many twitter follower based five question
1,1,6,18,0,5,0,24,0,suck making plan
1,1,11,39,0,10,0,50,0,guess studio ghibli film based background
1,1,6,30,0,5,0,36,0,stereotypically sorority girl
1,2,3,41,1,9,0,44,0,avian flu taking bite mcmuffin availability?
1,1,12,38,0,11,0,50,0,cool outer space shit based zodiac sign
1,1,10,45,4,9,0,55,0,"kristen wiig ""really bummed out"" ""ghostbusters"" backlash"
1,2,9,56,4,9,0,65,0,"blaming russia, hillary clinton campaign conspired elevate trump"
1,1,9,29,0,9,2,38,0,16 reason need preity zinta back life
1,1,12,34,2,11,0,46,0,"far would make ""legends hidden temple"""
1,3,3,80,3,21,0,83,0,ebola rise world better prepared last year business insider
1,1,13,39,5,13,4,52,0,"bet can't tell what's real 2015 headline what's ""the onion"""
1,3,10,49,3,11,2,59,0,gun owner america: paul ryans obamacare 2.0 still contains gun control
1,1,10,32,0,9,0,42,0,bad bitch anthem based zodiac
1,1,10,43,0,10,2,53,0,17 thing see historically black college homecoming
1,3,2,40,0,8,0,42,0,country polygamy legal list
1,1,12,45,4,11,0,57,0,"katie holmes reveal best kisser ""dawson's creek"""
1,3,2,23,0,5,4,25,0,golden globe 2017 list winner
1,3,13,52,4,13,0,65,0,artistic prom dress student painted make scream [video]
1,1,7,26,0,7,2,33,0,horoscope week december 21
1,1,14,44,3,12,0,58,0,here's actually smoke weed traveling u.s
1,2,7,25,1,8,0,32,0,john mayer say: outtake
1,1,14,42,2,13,0,56,0,"lot love defense lawyer ""making murderer"""
1,1,10,32,0,10,2,42,0,18 time tom felton heart true gryffindor
1,1,8,28,1,8,2,36,0,18 adele lyric make cry every time
1,1,7,28,2,4,0,35,0,here's #duraghistoryweek important
1,1,5,28,1,5,2,33,0,13 award amy poehler's definitely earned
1,2,1,58,1,11,0,59,0,world's fastest land animal even threatened thought
1,1,8,30,0,7,0,38,0,bill clinton would greatest first lady
1,3,8,43,1,8,0,51,0,outside source reality check: north american free trade deal
1,2,10,34,0,9,0,44,0,june intelligent oven might better cook
1,3,10,63,0,10,0,73,0,united airline trashed pretty much everyone horrifying passenger incident
1,2,1,47,0,8,0,48,0,president use portrait shape legacy
1,1,16,46,0,15,0,62,0,sushi rice dip best thing ever happened world dip
1,1,9,36,1,9,2,45,0,42 thing always wanted know adam lambert
1,3,2,45,0,8,0,47,0,optical illusion baffling internet list
1,1,8,34,0,9,6,42,0,16 greatest audience reaction 2015 emmy
1,1,12,43,0,11,0,55,0,latte look like disney princess want drink one
1,1,5,23,0,4,0,28,0,colour best represents
1,1,14,42,0,13,0,56,0,olivia wilde taking active role support woman film
1,1,9,26,0,8,0,35,0,guess robot know love
1,1,12,43,3,11,0,55,0,"quiz determine red devil ""scream queens"""
1,1,9,41,0,9,2,50,0,27 product people completely obsessed pizza
1,1,12,38,0,11,0,50,0,much soul destroyed working retail
1,2,16,43,0,13,0,59,0,four word give ceo courage take beauty industry
1,1,9,33,2,9,2,42,0,"14 time princess eleanor ""the royals"""
1,2,13,44,0,12,0,57,0,celebrity chef want change way eat business class
1,1,11,46,1,11,2,57,0,"18 reason spotify ad worse dying horrifying, painful death"
1,1,7,24,0,6,0,31,0,remember song came first
1,3,3,39,2,9,4,42,0,australian year award 2017: nominees?
1,2,17,60,0,16,0,77,0,baby monkey weeps copiously mother died run speeding vehicle
1,3,8,41,0,7,0,49,0,session border plan entire political spectrum abuzz
1,1,6,28,2,6,2,34,0,13 cocktail knock santa's boot
1,1,8,44,0,8,2,52,0,19 completely ridiculous rumour went around every school
1,1,13,57,3,12,0,70,0,"model confess funniest, worst, weirdest experience they've faced job"
1,2,1,60,0,12,0,61,0,gig economy finally give worker right deserve
1,1,9,31,0,9,2,40,0,16 random thing kris jenner ever said
1,1,11,33,1,11,2,44,0,17 time internet nailed like pisces
1,1,7,26,0,7,2,33,0,14 people reveal hate naked
1,3,9,49,1,8,0,58,0,shock video: gunman ambush police officer inside arizona walmart
1,1,10,41,0,8,0,51,0,everything need know creating buzzfeed quiz
1,1,9,25,0,8,0,34,0,need talk hot quasimodo
1,1,6,24,0,5,0,30,0,thanksgiving food best
1,3,4,60,0,11,0,64,0,people sending epa employee chocolate chip cooky thank card
1,1,9,42,0,9,1,51,0,8 brutally honest snapchat geotags share friend
1,2,5,21,0,5,1,26,0,9 product vagina love
1,2,11,33,1,11,0,44,0,team win super bowl next year
1,1,12,52,0,12,2,64,0,21 picture prove real difference facebook twitter
1,1,16,61,2,15,0,77,0,"set example brotherhood, dunkin' donut pakistan offering free meal indian"
1,1,10,38,0,10,1,48,0,5 famous guy master saying one particular word
1,3,11,24,1,10,0,35,0,night owl? may gene mutation
1,1,12,39,1,11,0,51,0,"month coming out, gu kenworthy getting back work"
1,1,11,38,1,11,2,49,0,17 time realized liz lemon wished
1,2,8,23,0,8,2,31,0,24 meme good thisworld
1,1,12,42,1,12,2,54,0,11 adorable dog want burst cracker diwali
1,2,8,54,3,10,1,62,0,internet reacts cavaliers' matthew dellavedova's huge game 3 vs. warrior
1,1,12,42,0,12,2,54,0,17 tweet winter storm jonas make laugh loud
1,1,7,23,0,8,6,30,0,17 thing changed sex life 2015
1,1,4,11,0,3,0,15,0,hate people
1,2,4,28,2,7,4,32,0,"sport 2016: winners, loser cheater"
1,1,13,46,2,12,0,59,0,"america ferrera still lot love ""traveling pants"" sister"
1,1,9,37,0,8,0,46,0,match game controller console
1,1,11,36,4,12,6,47,0,"12 reason relive t. swift's ""1989"" tour many time possible"
1,1,12,37,1,11,0,49,0,here's happens ask chef make breakfast
1,1,10,34,0,9,0,44,0,hogwarts house say sex life
1,3,6,36,2,6,0,42,0,cate blanchett's secret great skin? consistency
1,1,9,31,0,8,0,40,0,song play repeat weekend
1,1,12,53,2,11,0,65,0,"kristen stewart hilariously failed reading lip ""the tonight show"""
1,1,8,32,0,8,2,40,0,15 big boob chart busty girl understand
1,3,8,44,2,8,0,52,0,obama white house refuse call trump legitimate president
1,3,3,55,2,13,0,58,0,sex education lie. get pregnant pregnant list
1,1,9,42,0,8,0,51,0,secret ingredient change grilled cheese game
1,1,10,37,0,10,2,47,0,21 photo give intense kitchen goal
1,1,13,50,0,13,2,63,0,17 minimalist wardrobe make want throw half clothes
1,1,9,36,0,9,2,45,0,28 meme everyone work office understand
1,1,12,41,3,9,3,53,0,102-year-old man perfect advice long-lasting marriage
1,2,11,49,1,11,0,60,0,night owl better changing sleep pattern healthier?
1,2,13,55,1,12,0,68,0,portrait ronald reagan defaced break-in gop office north carolina
1,1,9,33,2,8,0,42,0,"photo snow, clouds, mashed potato"
1,1,11,38,0,11,2,49,0,17 real canadian horror story keep night
1,1,9,26,0,8,0,35,0,well know lyric musical
1,1,13,35,3,10,0,48,0,"wait, wtf ""i saw mommy kissing santa claus"" actually"
1,2,4,43,0,7,0,47,0,marshawn lynch tease raider nation cryptic tweet
1,2,3,33,2,7,0,36,0,europe trump's travel ban?
1,1,11,48,2,10,0,59,0,"hogwarts house recent ""doctor who"" character belong"
1,3,9,41,0,9,0,50,0,hailey baldwin show skin cutout gown feather skirt
1,1,10,32,1,9,0,42,0,bet can't identify disney movie
1,1,13,42,0,12,0,55,0,everything need know woman standing field
1,2,17,62,1,16,0,79,0,iskcon temple utah celebrated world's biggest holi video make happy
1,2,1,41,0,7,0,42,0,smartphone theft drop kill switch usage grows
1,2,2,35,2,5,0,37,0,google's latest project: improving city life
1,1,12,33,3,12,2,45,0,"26 time ""would lie you?"" best show television"
1,1,11,38,0,11,2,49,0,22 sign suffer terrible case resting shade face
1,3,13,49,1,8,0,62,0,watch: protester burn american flag outside trump international hotel
1,1,9,36,0,8,0,45,0,everything need know traveling mexico
1,1,7,28,0,7,2,35,0,27 brilliant book must read winter
1,1,14,50,0,13,0,64,0,video sufi artist playing christmas carol going make day
1,1,6,27,0,6,1,33,0,9 realest sex struggle lesbian
1,2,11,48,0,11,2,59,0,19 snack childhood literally forgot right
1,2,9,36,0,9,2,45,0,29 gift even heartless people wouldadore
1,1,5,33,0,6,6,38,0,23 unforgettable wedding moment defined 2015
1,1,16,53,4,15,0,69,0,"elle wood ""legally blonde"" andy sachs ""the devil wear prada"""
1,2,12,43,0,10,2,55,0,19 hilarious tweet coachella make actually lol
1,1,17,41,0,14,0,58,0,guy us led hula hoop turn travel photo pure magic
1,1,12,64,0,11,0,76,0,even hilarious harry potter comic prove dumbledore totally irresponsible
1,1,10,30,1,10,1,40,0,8 thing wish i'd known money twenty
1,1,15,50,1,14,0,65,0,sat entire new justin bieber album here's sound like
1,1,8,32,0,8,2,40,0,22 thing winter relationship
1,3,11,37,4,10,0,48,0,jimmy kimmel: trump epa nominee scott pruitt piece sh*t
1,1,7,24,1,6,0,31,0,"moms, tell u survived bedrest"
1,1,9,29,0,9,2,38,0,11 way actually become person work
1,1,15,46,1,13,0,61,0,singer-songwriter got stuck car best damn jam session
1,1,9,28,0,8,0,37,0,band nicest damn thing ever
1,3,8,35,0,8,0,43,0,high schooler jump plane epic promposal
1,1,9,37,2,10,6,46,0,"17 unforgettable moment ""the bachelor"" 2015"
1,1,6,35,0,6,2,41,0,20 delightfully honest shirt lazy exerciser
1,1,8,32,0,8,2,40,0,23 made america clothing brand know
1,1,9,35,0,9,2,44,0,12 place make wish lived underground
1,1,6,25,0,7,6,31,0,26 beauty product reader loved 2015
1,1,9,38,0,9,2,47,0,26 amazingly cute thing also keep organized
1,2,12,48,0,11,0,60,0,simple kitchen hack make grocery last muchlonger
1,1,12,41,2,12,2,53,0,"guess age gender 14 ""would rather"" question"
1,3,11,35,0,10,0,46,0,husband planned surprise wife hedied
1,3,5,28,0,4,0,33,0,educated millennials moving
1,1,7,23,0,7,2,30,0,18 snapchats hit close home
1,1,8,28,0,7,0,36,0,boozy drink work
1,3,1,16,0,3,0,17,0,living dead
1,1,9,23,0,6,0,32,0,bff basically sister
1,3,1,28,2,7,0,29,0,girl 'stolen' soldier
1,2,5,59,1,9,0,64,0,maryland president: would expect shutdown unc academic allegation
1,1,8,37,0,8,2,45,0,19 painfully honest card human valentine
1,1,8,24,0,9,6,32,0,13 terrible email father sent 2015
1,1,12,55,1,11,0,67,0,caitlyn jenner say favorite holiday tradition kris's christmas eve bash
1,1,9,33,1,8,0,42,0,here's look inside harry potter coloring book
1,1,8,28,1,7,2,36,0,17 heart-shaped gift people love love
1,3,2,30,0,7,0,32,0,donald trump par course
1,1,12,48,0,13,6,60,0,21 funniest tweet captured feeling love life 2015
1,1,10,39,0,9,0,49,0,identify disney movie based screenshot
1,1,6,28,0,6,2,34,0,11 adorable mini dessert holiday
1,1,12,39,2,10,1,51,0,3-year-old know way periodic table
1,1,5,16,0,6,6,21,0,21 best picture book 2015
1,2,4,42,0,11,0,46,0,burger king make whopper mess google home ad
1,1,9,32,2,9,2,41,0,"17 reason ""jingle way"" truly masterpiece"
1,2,2,29,2,7,2,31,0,swansea bay's tidal lagoon 60 second
1,1,18,48,1,16,0,66,0,celebs flip cd glass people's choice award mess
1,1,6,14,1,5,0,20,0,owe anyone body
1,2,4,71,2,15,0,75,0,murderous attack russian diplomat revenge turkey's dirty deal putin?
1,1,6,28,0,6,2,34,0,14 detention slip well deserved
1,1,10,41,3,9,0,51,0,"here's annoying moment ""sonic hedgehog"" game"
1,3,7,24,3,7,0,31,0,get organized get moving -- here's
1,1,7,40,0,6,0,47,0,ashley madison password motivational poster
1,3,4,53,2,15,0,57,0,ignore bad back could warning sign die young
1,2,12,54,1,10,3,66,0,gujarati diamond multi-millionaire pay wedding 236 fatherless girl
1,1,10,34,2,9,0,44,0,"""i think hear girlfriend calling you"" puzzle"
1,2,7,35,0,7,1,42,0,6 item totally overreact microwaved
1,1,9,26,2,8,0,35,0,let's settle this: would dog wear pant
1,1,13,36,2,10,0,49,0,"""the powerpuff girls"" voice actor look like irl"
1,1,12,37,0,12,1,49,0,7 quick delicious dinner make free time
1,2,9,33,0,11,0,42,0,avon freshens bid win back middle america
1,3,11,38,2,11,2,49,0,"19 impressive fact ocean make say ""wow"""
1,1,8,28,1,7,2,36,0,14 life-changing reason work right
1,2,3,42,3,8,0,45,0,chinese burger designed asia's 'best female chef'
1,1,10,29,2,8,0,39,0,carrie-anne moss aging must magic
1,1,7,18,0,6,0,25,0,type penis would
1,1,7,30,0,6,0,37,0,american try micheladas first time
1,1,8,21,0,7,0,29,0,like jacob evie frye
1,3,11,38,1,10,0,49,0,would universe change grew extra dimension?
1,1,13,46,0,12,0,59,0,new issue essence favorite magical black girl
1,1,6,21,2,5,0,27,0,"animal ""skyrim"""
1,1,11,39,2,9,0,50,0,"according ""ghostbusters ii"" world end sunday"
1,1,7,30,1,6,2,37,0,19 jaw-dropping wedding venue book lover
1,1,7,25,0,5,0,32,0,buzzfeed writer try handstand
1,1,8,33,0,8,2,41,0,15 blasphemous thing ever said twitter
1,2,11,42,2,10,6,53,0,2017 nba power rankings: post-trade deadline standing 30 team
1,2,6,61,0,12,0,67,0,difference donald trump justin trudeau two picture list
1,1,8,31,1,7,2,39,0,23 hilarious tweet grown-ass adult
1,1,11,33,4,9,0,44,0,u.s. men's gymnastics team hot problematic
1,1,7,21,0,6,0,28,0,name emo band
1,1,10,32,0,10,2,42,0,19 time happiness sucked world
1,1,12,43,1,11,0,55,0,here's typical week fantasy football player look like
1,1,9,43,0,9,2,52,0,47 breathtaking shot quentin tarantino movie
1,2,14,54,1,14,2,68,0,took exactly 15 minute female politician asked shes childless
1,1,7,15,0,6,0,22,0,feel crush
1,1,12,44,0,11,0,56,0,vine toddler listening adele destroy ovary
1,1,14,54,0,13,0,68,0,people got tested see actual ethnicity pretty surprised
1,1,9,38,0,8,0,47,0,disney holiday film watch weekend
1,3,3,44,0,9,0,47,0,prince wale try traditional dance romania
1,2,13,68,3,13,0,81,0,obama vs. trump: ex-president return radical community organizing save tattered legacy
1,1,8,22,2,7,0,30,0,"movie could next ""the room"""
1,2,3,23,1,5,0,26,0,african think trump?
1,1,10,37,0,9,0,47,0,decade british history lived
1,1,4,11,0,4,4,15,0,year 2015 chart
1,1,12,45,1,11,0,57,0,rob kardashian posted first selfie video snapchat odd
1,2,1,52,0,12,0,53,0,bus driver buy hat glove child need route
1,3,1,59,0,12,0,60,0,restaurant pay eat soup temperature fall zero
1,1,11,35,2,10,0,46,0,"spot real ""family guy"" character fake"
1,2,14,54,6,12,0,68,0,"amul again, give 'engaging' twist virat-anushka's engagement rumor!"
1,1,10,32,2,9,0,42,0,would rather: hot guy new year's eve kiss edition
1,3,13,59,1,14,0,72,0,tax day justice: doj investigation lois lerner called way mean chairman
1,1,9,39,1,8,0,48,0,"jon snow definitely dead, according maisie williams"
1,2,5,43,1,8,0,48,0,surprise foreigner u business insider
1,1,3,24,0,3,2,27,0,17 inspirational desk succulent
1,1,9,31,0,8,0,40,0,transfer playlist spotify
1,3,2,60,1,13,0,62,0,"two aussie play horrible prank friend, telling killed man"
1,1,14,46,1,13,0,60,0,tell u embarrassing thing that's ever happened gym
1,1,10,46,0,9,0,56,0,drastic appearance change shock parent
1,1,4,22,0,3,0,26,0,lesbian bride frankenstein
1,1,10,36,2,10,2,46,0,"75 thought watching ""selena"" first time"
1,1,10,40,0,9,0,50,0,guess personality based underwear color
1,1,14,56,3,13,0,70,0,"here's lady gaga's next album sound like, according little monster"
1,2,1,39,1,8,0,40,0,apps drain phone's battery
1,1,11,31,2,11,2,42,0,what's best christmas gift ever got '90s kid
1,1,9,39,0,9,2,48,0,10 amazing donut mandatory eating fall
1,3,12,43,5,12,0,55,0,'rogue one': one prop felicity jones much want keep [video]
1,2,6,30,2,7,0,36,0,(seriously) upgrade gin tonic
1,1,9,28,2,7,0,37,0,need talk janet jackson's side-eye
1,1,9,33,2,10,4,42,0,"29 moment jenna ""30 rock"" made cry laughing"
1,3,13,53,1,12,2,66,0,10 home cutting-edge solution save thousand dollar every year
1,1,15,48,2,14,0,63,0,"cast ""pretty little liars"" think wine mom still basement"
1,1,8,31,0,8,2,39,0,21 celebrity instagrams need see week
1,1,12,32,1,11,2,44,0,14 star wars-themed church sign jedi u
1,3,3,33,1,7,2,36,0,60 minutes' odd journey north korean border
1,3,2,32,1,6,0,34,0,life death thailand's lethal road
1,1,12,38,2,10,0,50,0,remember people thought green m&m's made horny
1,1,6,30,0,5,0,36,0,loaded cheese stuffed mashed potato ball
1,2,2,54,1,10,0,56,0,man lost penis flesh-eating superbug sue essex hospital
1,1,9,34,0,9,2,43,0,15 people brilliant reaction new ipad pro
1,1,5,32,0,5,2,37,0,28 alternative pixar halloween costume idea
1,1,10,36,1,9,0,46,0,tom hardy look exactly like dog terrifying
1,2,3,44,1,10,0,47,0,see happen final four happens
1,1,9,28,0,7,2,37,0,20 gifs perfecly sum teacher struggle
1,2,13,47,3,13,2,60,0,"there store making donut based 90 snacks, heaven isreal"
1,3,6,27,0,6,0,33,0,medicaid hard republican
1,3,10,44,3,12,2,54,0,betty white: 95 thing need know birthday girl [video]
1,3,10,70,5,11,0,80,0,obamas organizing action partner soros-linked indivisible disrupt trump agenda
1,1,8,42,2,8,2,50,0,"17 thing ""gossip girl"" actually got right relationship"
1,1,6,36,0,6,2,42,0,20 people immediately recognized mistake
1,2,1,52,1,10,2,53,0,new 10-minute eye surgery may help toss reading glass
1,1,10,43,1,9,0,53,0,subscription service wish known sooner
1,1,10,40,4,8,2,50,0,"29 remarkable behind-the-scenes photo ""back future"""
1,1,6,31,1,7,4,37,0,29 thing every '90s emo kid definitely remembers
1,2,11,47,2,10,0,58,0,helen mirrens instagram delightful thing youll seetoday
1,3,4,54,0,11,0,58,0,spike lee call team signing free agent colin kaepernick
1,3,7,40,2,12,5,47,0,ranking best game 2017 nfl season: super bowl rematch no. 1
1,1,13,32,0,12,0,45,0,wore smart ring month happened
1,3,10,25,1,9,2,35,0,delta paid family $11k give seat
1,3,9,37,0,9,1,46,0,7 amazing hack make daily life effortless
1,1,6,31,0,5,0,37,0,men get transformed disney princess
1,3,10,41,0,10,2,51,0,32 thing literally everyone done life
1,2,8,40,1,8,0,48,0,democrat bet buyer remorse trump speech response
1,1,18,51,8,12,0,69,0,"know favorite celebrity based favorite ""agents s.h.i.e.l.d."" character"
1,1,11,49,2,10,0,60,0,"""friends"" character date based food preference"
1,1,3,24,0,3,2,27,0,11 shameful twerking confession
1,1,10,37,4,9,0,47,0,"hardest ""fuck, marry, kill"" game ever beauty addict"
1,1,10,43,1,9,0,53,0,sarah paulson holland taylor dating everything
1,2,6,55,1,9,0,61,0,jaromir jagr: florida panther winger move second behind wayne gretzky
1,1,8,26,0,8,2,34,0,14 text receive kid
1,2,4,40,3,12,4,44,0,"would take new 1,300 dna test could save life?"
1,1,10,34,1,9,0,44,0,mother's eating disorder taught
1,3,19,53,1,17,0,72,0,m dhoni forgot split second captain demanded review!
1,1,11,36,0,10,0,47,0,little girl ruining hair hot new toy
1,1,6,20,1,6,2,26,0,25 cat ready winter
1,1,10,39,2,10,2,49,0,19 picture make sense unless older sister
1,1,8,29,0,8,2,37,0,16 time panda one mattered
1,3,11,45,5,13,0,56,0,"could thyroid; could ennui. either way, drug isnt helping."
1,1,10,35,0,10,2,45,0,16 time bonfire night confused hell world
1,2,6,31,0,8,0,37,0,american might get visa europe
1,3,1,42,1,5,0,43,0,"ridiculously successful people eat, revealed"
1,1,8,33,0,8,2,41,0,17 thing unmarried arab girl tired hearing
1,1,5,26,0,5,2,31,0,17 hilarious tweet columbus day
1,2,5,63,2,13,0,68,0,hope troop antibiotic show could 'exciting new treatment' ptsd
1,1,10,43,1,9,0,53,0,toddler's instagram photo guaranteed make feel
1,1,13,51,0,12,0,64,0,jennifer lawrence excited new kardashian baby
1,3,1,49,1,12,4,50,0,10 social medium sin every 40-year old need avoid
1,1,8,30,0,7,2,38,0,15 great youtube channel learn science
1,2,2,43,2,7,2,45,0,"hockey, weed taxes? 11 canadian stereotype debunked"
1,1,8,41,0,8,2,49,0,71 zara larsson lyric make perfect instagram caption
1,3,6,39,1,9,0,45,0,japan pm shinzo abe's diplomatic hole one trump
1,3,12,45,1,10,0,57,0,couple met twitter gorgeous twitter-themed wedding
1,1,12,37,0,10,0,49,0,get best buzzfeed day daily newsletter
1,1,8,24,2,9,6,32,0,"39 time reached peak ""new york times"" 2015"
1,1,12,49,1,12,1,61,0,rihanna posted perfect response latest no. 1 single
1,1,9,41,0,9,2,50,0,18 struggle people simply cannot actual clothing
1,1,10,31,1,9,0,41,0,solve puzzle challenge
1,3,9,47,0,11,0,56,0,get patient take control medical decision
1,3,2,53,2,12,0,55,0,american diet hasnt changed year except one thing
1,2,12,41,3,12,0,53,0,obama harvard law review: prayer wont it; need gun control
1,1,8,25,0,8,2,33,0,27 powerful photo week
1,1,5,15,0,4,0,20,0,cook perfect egg
1,1,11,37,2,12,4,48,0,43 song love graduated high school late '00s
1,2,9,45,1,8,0,54,0,francois hollande seek re-election french president
1,1,14,55,1,13,0,69,0,look wittle doggy practising india's republic day parade
1,2,3,56,4,8,0,59,0,whats little oil neighbors? venezuela-guyana tension flare.
1,1,11,45,0,11,2,56,0,19 musical theater song every human listen die
1,1,12,26,1,8,2,38,0,17 low-sugar dessert recipe need try asap
1,1,11,41,1,10,0,52,0,haqq twin take side kardashian's epic fight
1,1,10,39,2,10,2,49,0,"78 ""treehouse horror"" segment ranked worst best"
1,1,8,40,1,8,1,48,0,"6 cringeworthy questions, answered science"
1,1,12,46,4,11,0,58,0,"real winner drake's ""hotline bling"" video dance move"
1,1,11,44,4,10,0,55,0,"what's fucked thing done ""rollercoaster tycoon"""
1,1,7,40,0,7,2,47,0,44 secret sentence college student understand
1,1,12,46,0,11,0,58,0,people stick head hole surprised puppy
1,1,10,38,1,9,0,48,0,here's adorable puppy dreaming need
1,1,11,44,3,10,0,55,0,"here's cast ""jessica jones"" next comic counterpart"
1,1,14,49,3,13,0,63,0,"know soulmate's eye color based favorite ""game thrones"" lady"
1,2,1,47,1,9,0,48,0,self-charging battery could put end phone dying
1,2,15,62,3,16,0,77,0,"'lucky alive,' say woman claimed see escaped murderer new york prison break"
1,1,9,27,0,8,0,36,0,tell u debt twenty
1,1,14,41,0,13,0,55,0,cake look like giant candy corn actually easy make
1,1,7,25,1,9,8,32,0,20 movie believe turning 20 2016
1,3,14,67,0,13,0,81,0,fake femme fatale stealing google account journalist human right activist
1,1,9,38,2,8,0,47,0,what's stupidest way ever broken computer
1,2,10,48,1,9,0,58,0,kellyanne conways inauguration outfit gave people lot offeelings
1,3,13,51,1,12,0,64,0,"monster dad rape minor daughter months, finally delivers baby girl"
1,1,11,42,1,11,2,53,0,gave nicholas hoult '90s nostalgia quiz failed adorably
1,1,9,28,0,10,6,37,0,26 dangerous thing pit bull 2015
1,1,7,35,0,6,0,42,0,answer embarrassing body question
1,1,15,35,0,12,0,50,0,new std report make never want sex
1,1,13,58,0,12,0,71,0,alabama teacher investigated wearing blackface kanye west costume
1,1,9,25,2,8,0,34,0,what's best thing buy trader joe's
1,3,10,36,1,12,0,46,0,want get rid obamacare? careful wish
1,1,15,66,0,14,0,81,0,study claiming blotting pizza save calorie might marketing campaign
1,1,8,32,0,8,2,40,0,16 time amandla stenberg wisest teen ever
1,3,18,59,1,14,0,77,0,"day massive layoff begin, espnw celebrates black power icon fugitive cop killer"
1,2,6,40,1,6,0,46,0,america troop celebrate christmas around world
1,3,3,48,0,10,0,51,0,cory booker bert take selfie childhood dream
1,1,8,25,0,8,2,33,0,16 stunning easy way tie hijab
1,1,8,36,0,7,0,44,0,blood type determine personality type
1,1,8,35,2,7,0,43,0,what's shocking way injured
1,1,9,31,0,9,2,40,0,22 vine prove kid worse drunk
1,3,3,48,0,10,0,51,0,nba star apologizes everyone person screamed
1,1,11,40,1,10,0,51,0,here's color hair halloween without ruining
1,1,14,44,0,12,0,58,0,two single af people got married week thing got interesting
1,1,9,43,0,9,2,52,0,23 tumblr post perfectly explain addiction tumblr
1,2,15,57,2,15,0,72,0,"ahsaan qureshi slam sunil grover, twinkle take dig yogi adityanath ent"
1,1,8,26,1,7,0,34,0,here's diwali carol thing
1,1,7,21,0,6,0,28,0,trying cool pointless
1,1,7,34,1,5,0,41,0,co-worker surprise compliment
1,3,1,65,4,13,0,66,0,tried potato chip prisoner obsessed here verdict
1,3,0,24,0,7,5,24,0,9 show get excited 2017
1,1,8,31,1,8,2,39,0,19 photo appreciate love rainy day
1,3,2,56,4,16,1,58,0,5-year-old scared go bed himself. get sleep?
1,1,15,46,1,14,0,61,0,know celeb start twitter feud based emoji test
1,3,5,40,3,9,0,45,0,fed: wage going 'modestly' across america
1,1,14,61,2,13,0,75,0,"indian classical version ""harry potter"" soundtrack blow goddamn mind"
1,1,12,41,4,10,2,53,0,"18 slightly horrifying airport moment make say ""why?!"""
1,2,7,39,1,7,2,46,0,24 beautifully stunning model arent kendalljenner
1,1,11,45,1,10,0,56,0,people treat mental illness vs. treat physical illness
1,1,6,19,0,6,2,25,0,17 chart help eat healthy
1,3,10,40,2,8,0,50,0,psychology behind bad gift-giving: buyer go wrong
1,1,9,40,2,8,0,49,0,serious question: orlando bloom katy perry's uber driver
1,1,6,21,0,7,6,27,0,23 picture pretty much sum 2015
1,1,6,11,0,4,0,17,0,booze iq
1,3,4,14,1,3,0,18,0,patriotic you?
1,2,6,41,0,7,2,47,0,17 alleged mexican cartel operative charged colorado
1,3,3,34,0,8,0,37,0,best way stream live tv without cable
1,1,10,35,1,9,0,45,0,pug dog rollin' motorcycle give zero shit
1,1,8,39,0,8,2,47,0,33 beautiful hilarious piece advice grandma
1,1,8,28,1,7,0,36,0,hardest book cover quiz ever take
1,1,12,43,0,11,0,55,0,photo literally potato sold one million dollar
1,1,7,27,1,6,2,34,0,25 thing every grown-ass adult
1,1,9,40,0,9,2,49,0,26 ingenious product literally light life
1,1,9,41,0,9,2,50,0,21 food spectacularly failed live expectation
1,1,7,28,0,6,0,35,0,would pas fourth grade anatomy today
1,2,5,70,2,17,0,75,0,one loser aftermath obama's attack israel united nation
1,2,12,50,2,14,0,62,0,emma watson modern princess expect paid disney [video]
1,1,9,36,0,9,2,45,0,16 gourmet pizza put cheese pepperoni shame
1,1,12,45,0,11,0,57,0,ariana grande shook gram revealed new platinum hair
1,3,10,38,3,10,2,48,0,"youre guaranteed laugh 70% food tweets,minimum"
1,1,11,30,1,10,2,41,0,18 thing call mom grown-ass adult
1,1,7,31,0,7,2,38,0,21 halloween costume really make sense
1,1,7,45,0,6,0,52,0,actress respond sexist hollywood casting description
1,1,17,48,0,16,0,65,0,penguin beach buddy man saved melt heart
1,2,11,41,1,11,2,52,0,32 powerful photo womens march around theworld
1,1,11,36,1,10,0,47,0,finally get rid iphone's dumb default apps
1,1,8,35,0,8,2,43,0,window 98 screensavers ranked worst best
1,3,11,59,2,10,0,70,0,northwestern mutualvoice: starting business? choose structure
1,2,2,79,3,17,0,81,0,amazon created version skype improve company meeting here's work
1,3,16,49,2,13,0,65,0,"mp cop fat-shamed shobhaa de, undergoes weight loss surgery mumbai"
1,3,18,65,3,19,2,83,0,father killed: woman break silence 30 year hiring hit man shoot abusive dad [video]
1,1,9,27,0,8,0,36,0,loving memory joe jonas gigi hadid
1,3,17,73,0,16,0,90,0,mayweather promotion ceo say race reason people want see floyd mayweather fight conor mcgregor
1,1,10,37,1,10,2,47,0,14 picture sum christmas actual worst
1,1,10,35,0,9,0,45,0,puzzle everyone suffers bug bite
1,2,3,42,0,8,0,45,0,airline trolled united hard twitter
1,1,6,18,3,7,2,24,0,"7 high 4 low ""grease: live"""
1,1,11,51,0,10,0,62,0,tina amy proved present every lifetime achievement award
1,1,9,28,0,9,2,37,0,27 best call center meme internet
1,1,11,37,2,10,0,48,0,"emo kylo ren new favorite ""star wars"" parody account"
1,1,8,40,1,7,2,48,0,23 picture right-handed people never ever understand
1,2,9,40,5,9,6,49,0,2017 summer movie preview: 40 must-see film (with exclusive photos!)
1,3,8,37,0,8,2,45,0,17 tweet prove cartoon kinda educational
1,2,2,37,1,8,0,39,0,map world's happiest country list
1,2,3,44,3,9,0,47,0,cant tv tap play today marginalised?
1,1,9,43,0,8,0,52,0,sleeping position say relationship
1,1,19,45,2,16,0,64,0,m.i.a dispute french football club using kit video
1,3,10,64,0,11,0,74,0,justin trudeau face unprecedented ethic probe private island getaway imam
1,1,11,45,2,11,2,56,0,"75 thought rewatching first episode ""downton abbey"""
1,1,10,47,2,10,2,57,0,18 thing understand slightly obsessed sock
1,1,10,35,1,7,2,45,0,14 people revolutionising india's fight lgbt right
1,1,9,47,0,8,0,56,0,dad failing riding hoverboards ruined christmas everyone
1,3,1,54,3,15,2,55,0,trump approval hit new low 36 percent thats bad news
1,2,11,52,5,12,2,63,0,fact check: treasury nominee's bank foreclose 90-year-old widow? insider
1,1,13,42,0,13,4,55,0,pillow hoodie let nap anywhere start 2016 right
1,2,7,65,2,12,0,72,0,carter incident: wa police leave traumatised aboriginal family stranded?
1,1,13,39,1,10,0,52,0,miley cyrus' iconic vma look match zodiac sign
1,1,5,18,2,4,0,23,0,"""saw"" character"
1,1,13,50,4,11,0,63,0,"demi lovato nude, no-makeup, unretouched photo shoot everything"
1,1,7,24,2,6,0,31,0,"""friday night lights"" guy"
1,3,18,73,4,17,0,91,0,watch nbc nightly news excerpt free online inspiring america: update chicago superhero nurse yahoo view
1,2,6,26,1,6,0,32,0,pretty doll spying children?
1,1,7,32,1,6,0,39,0,hailee steinfeld's song actually
1,2,8,42,3,10,0,50,0,use instagram lose weight get healthier (really!)
1,1,8,34,0,7,0,42,0,portrait reveal brutal beauty dance
1,2,4,66,1,13,0,70,0,rock went failed football player highest-paid actor hollywood
1,2,10,45,0,10,2,55,0,42 slightly gross thing female best friend secretly done
1,1,8,29,2,7,2,37,0,day 6 buzzfeed's 7-day clean eating challenge
1,1,9,29,0,10,6,38,0,19 place wale seriously need visit 2016
1,1,5,22,0,4,0,27,0,fish gape replaced duckface
1,1,5,22,2,5,1,27,0,"""empire"" season 2 drinking game"
1,1,13,39,0,12,0,52,0,tell weird tweet martha stewart cher
1,3,2,66,1,16,0,68,0,december best time get fit perfect party season exercise plan
1,1,8,50,0,8,2,58,0,19 heartbreaking confession men suffering emotional abuse
1,1,9,26,0,8,0,35,0,herbivore carnivore
1,2,7,44,1,8,0,51,0,neil gorsuch became donald trump's supreme court nominee
1,1,5,28,0,4,0,33,0,cookie match personality
1,1,12,34,0,11,0,46,0,muppet baby grew went high school
1,1,12,39,2,12,2,51,0,"21 tweet ""explain film plot badly"" make laugh"
1,2,1,37,1,7,0,38,0,women's sport prof best buy business
1,1,8,23,0,8,2,31,0,26 fandom ship war end
1,1,8,29,1,7,0,37,0,couple instagram vs. couple real life
1,1,13,56,1,12,0,69,0,little girl see shadow becomes instantly terrified adorable
1,1,8,32,0,8,2,40,0,22 school play disaster make cringe
1,1,10,38,1,8,0,48,0,kardashian/jenner based birth month
1,1,10,46,0,9,0,56,0,emily blunt john krasinski officially another baby
1,3,6,38,2,5,4,44,0,before-and-after meme encapsulate 2016 perfectly
1,3,4,40,0,12,2,44,0,13 ted talk teach live happier life
1,2,13,44,1,14,3,57,0,25 feared dead schoolbus hit truck 5 story today
1,1,12,50,0,11,0,62,0,every girl tried makeup tutorial recognize struggle
1,1,7,28,2,7,1,35,0,"9 character return ""teen wolf"""
1,1,8,30,0,9,6,38,0,22 podcasts subscribing 2016
1,2,18,58,5,14,0,76,0,"srk-abrams fun car ride, ranbir kapoors look sanjay dutt biopic entertainment"
1,1,8,27,0,9,6,35,0,16 clapbacks prove 2015 year shade
1,1,7,29,0,7,2,36,0,14 woman reveal faked pregnant
1,2,10,39,4,10,0,49,0,"morgan freeman: trump winner, hope good president"
1,1,9,20,0,8,0,29,0,yoga pose sex position
1,2,10,56,3,12,0,66,0,"radio burst traced faraway galaxy, caller probably ordinary physic"
1,1,6,20,0,5,0,26,0,item splurge
1,1,8,22,0,7,0,30,0,every day want quit social medium
1,2,2,64,0,12,1,66,0,growing number analyst dismissing iphone 8 curved display rumour
1,1,12,43,0,12,2,55,0,23 tweet emotion make laugh loud every time
1,1,14,47,0,13,0,61,0,group young indian revealed lie parent told kid
1,1,12,45,0,12,4,57,0,raccoon stole doughnut toronto inspiration 2016
1,3,4,80,3,21,0,84,0,"first attempt brexit negotiations, uk made fool there's come"
1,1,6,24,0,6,2,30,0,27 time michael scott fucking blew
1,1,9,24,0,9,2,33,0,21 reason fall love dog person
1,3,3,60,0,13,0,63,0,china state newspaper say donald trump idea lead superpower
1,1,8,29,2,8,2,37,0,"14 time ""extras"" best show television"
1,3,7,44,3,8,0,51,0,george clooney: trump bannon real hollywood elitist
1,1,15,42,1,14,2,57,0,17 woman whose pin-up hair makeup make want turn back time
1,3,3,59,1,10,0,62,0,washington state became epicenter resistance trump agenda
1,2,9,40,2,10,0,49,0,pitching tim tebow: like actually pitch tebow
1,1,12,36,1,11,0,48,0,ask expert: mindfulness try
1,3,20,56,0,19,0,76,0,friend really happy see long doctor got hug broke rib
1,1,12,43,0,11,0,55,0,fan sharing beautiful image david bowie age
1,3,16,66,5,17,0,82,0,dnc senior adviser: trump emasculated putin come back pick transgendered kid
1,1,10,35,0,9,0,45,0,way making morning waffle
1,1,10,41,2,9,0,51,0,favorite *new* emoji say personality
1,2,10,44,0,10,0,54,0,men injecting ball botox disturbing new trend
1,2,3,29,1,4,0,32,0,airport expansion: heathrow v gatwick
1,1,7,23,1,6,0,30,0,where's best place buy bedding
1,1,10,34,1,9,0,44,0,here's traveling actually help win life
1,1,10,30,0,8,0,40,0,australian tv high school go
1,1,9,29,1,9,2,38,0,guess late '00s song one screenshot
1,3,9,39,3,7,0,48,0,valerie jarrett: obamas white house scandal-free
1,1,6,25,0,5,0,31,0,people try iconic music video dance
1,1,12,41,0,11,0,53,0,playboy released last nude issue cover model
1,1,7,36,0,7,2,43,0,19 reason straight woman stay single forever
1,3,3,69,1,13,0,72,0,tesla emerged brink bankruptcy become america's coolest car company
1,1,10,49,0,9,0,59,0,fundamentalist christian discovered feminist writer
1,2,10,51,2,13,0,61,0,risk it! pay attention expiration date pantry item
1,1,11,38,3,11,2,49,0,"22 time tina belcher ""bob's burgers"" crush"
1,1,13,68,0,12,0,81,0,photo shoot backdrop ganesh chaturthi celebration absolutely stunning
1,3,2,75,0,18,0,77,0,dark circle around eye could sign something serious list
1,2,6,31,2,8,0,37,0,young thug wear dress 'jeffery' cover
1,1,8,24,0,7,0,32,0,ronda rousey holly holm
1,1,6,25,0,6,2,31,0,22 time anthropologie went way far
1,1,15,50,0,14,0,65,0,need talk insanely perfect zac efron sami miro together
1,1,12,51,3,12,2,63,0,"45 thing probably know ""the sisterhood traveling pants"""
1,1,14,45,0,13,0,59,0,need talk people putting mint leaf coffee
1,1,9,38,0,8,0,47,0,guy proposed amazing custom monopoly board
1,1,8,35,0,8,2,43,0,18 struggle everyone hate crowd relate
1,3,9,41,2,11,1,50,0,7 thing probably missed first listen 'more life'
1,1,5,35,0,5,2,40,0,19 brutally honest confession bridesmaid
1,1,8,34,1,8,2,42,0,16 canadian ready another winter
1,1,13,33,0,13,2,46,0,18 thing college student adult
1,1,9,43,0,8,0,52,0,apple picking test determine true personality
1,2,10,41,0,10,0,51,0,three per cent newly arrived migrant found work
1,1,9,38,1,8,2,47,0,25 subtle halloween decoration keep year-round
1,1,14,48,2,13,0,62,0,"happened watched ""the little mermaid"" first time"
1,1,7,19,0,6,0,26,0,much love oscar isaac
1,1,11,37,1,10,0,48,0,look dead body guess movie they're
1,1,7,33,1,7,2,40,0,12 thing probably know happiness
1,1,12,43,0,11,0,55,0,know celebrity husband based one question
1,2,6,31,1,7,1,37,0,5 key takeaway president trump speech
1,1,10,47,0,10,4,57,0,everyone became completely obsessed kendall jenner 2015
1,1,8,38,1,7,0,46,0,now? favorite forgotten president
1,2,8,43,0,8,2,51,0,10 underrated city millennials actually buy home
1,1,10,37,0,9,0,47,0,asked parent question make squirm
1,2,10,51,1,10,0,61,0,european establishment try new election tactic: full embrace eu
1,1,11,44,0,10,0,55,0,hot dude kitten instagram account matter
1,3,1,38,1,7,0,39,0,"fake news becomes popular, trending topic"
1,3,9,26,0,9,2,35,0,13 way amy schumer make u proud woman
1,1,11,34,2,10,0,45,0,what's best cheap dinner ever made hostel
1,3,2,25,0,5,0,27,0,clock ticking spotify
1,2,4,81,2,16,4,85,0,"ramadan 2015: holy month approaches, debate emerges long muslim northern europe fast"
1,3,6,39,0,6,0,45,0,immigration officer injured texas sanctuary city
1,2,7,40,1,8,0,47,0,"winter storm make messy travel plains, northeast"
1,1,14,36,0,13,0,50,0,guess old based colour iphone
1,1,7,15,0,6,0,22,0,seagull goose
1,2,6,38,4,8,5,44,0,"$50,000 reward facebook killer manhunt go national"
1,1,9,42,0,9,2,51,0,27 dating relationship tweet guaranteed make laugh
1,1,10,40,1,9,0,50,0,here's inclusive nude fashion look like black woman
1,2,6,44,2,7,0,50,0,recalled newsweek madam president clinton issue hit ebay
1,1,5,22,0,4,0,27,0,horrible truth bagel
1,1,7,19,0,9,8,26,0,29 movie 20 year old 2016
1,1,8,22,0,8,2,30,0,19 time kale needed stay lane
1,1,11,34,2,10,0,45,0,let's settle this: peel bite string cheese
1,1,12,47,1,11,0,59,0,woman somehow photographed seal riding whale spectacular
1,2,0,36,0,7,6,36,0,19 time nature completely terrifying 2016
1,1,11,36,3,12,6,47,0,"33 reason we'll miss hell ""parks recreation"" 2016"
1,1,8,31,0,8,2,39,0,17 gift people wear black everything
1,1,7,27,2,6,0,34,0,what's worst thing ever smelled
1,3,7,45,0,8,0,52,0,foot locker responds allegation shady sneaker release
1,1,8,27,0,8,2,35,0,25 thing everyone must eat north east
1,3,10,40,2,12,0,50,0,ten way get good return cash (stocks included)
1,2,1,68,0,11,0,69,0,caffeine may help protect inflammation heart disease find new study
1,1,9,30,0,9,2,39,0,27 gift every book lover ask year
1,3,4,59,4,12,0,63,0,welcome new (and improved?) wrigley: banner raising start next cub era
1,2,3,67,4,16,0,70,0,one scary thing ive ever seen: hero saved skier lift considers fate
1,3,3,53,1,9,0,56,0,doctor warn gwyneth paltrow's advice vaginal jade egg
1,1,14,53,0,13,0,67,0,guy spent six month making sandwich ingredient scratch
1,1,11,28,0,9,2,39,0,16 gifs actually help math class
1,1,12,36,0,11,0,48,0,romantic film need see right second
1,1,6,24,1,4,0,30,0,show u geeky-inspired tattoo
1,1,8,27,0,8,2,35,0,25 book every pop culture nerd need read
1,1,7,28,0,7,2,35,0,20 perfect pin people simply cannot
1,1,8,38,2,7,0,46,0,"drew disney princess ""adventure time"" princess"
1,1,7,21,0,6,0,28,0,need talk mariah carey
1,3,1,53,0,7,0,54,0,courageous bus driver apprehends thief witnessing crime
1,2,9,41,2,8,0,50,0,jesus may walked jerusalem via dolorosa: scholar
1,1,10,45,0,10,1,55,0,5 official stage canadian accepting winter coming
1,1,10,35,1,8,0,45,0,non-mexicans try guess meaning mexican slang
1,1,18,28,0,12,0,46,0,ruby rose wore many hot af outfit host mtv emas
1,1,17,59,0,16,0,76,0,harry potter cursed child ticket gone sale people losing shit
1,1,10,38,2,8,2,48,0,37 trunk-or-treat idea guaranteed win halloween
1,3,18,57,3,15,0,75,0,"middle assembly session, tripura mla grab speaker mace try sprint away!"
1,3,12,41,2,8,0,53,0,"iit madras website hacked, pro-pakistan message posted page"
1,1,6,16,3,5,0,22,0,bucket 'o' pups: game show
1,1,8,29,0,7,0,37,0,everything need know empress
1,1,9,18,0,7,0,27,0,dj khaled chef dee
1,3,11,49,2,11,2,60,0,"13 thing much bigger threat america ""refugee terrorists"""
1,1,8,22,1,6,0,30,0,first male co-star
1,1,10,37,0,10,2,47,0,31 tweet fast food actually make laugh
1,1,9,43,0,9,2,52,0,22 picture prove constantly surrounded genitals
1,1,4,26,0,4,2,30,0,11 surprising never nude confession
1,1,11,30,1,9,0,41,0,here's mcflurry spoon look way
1,1,10,34,0,10,2,44,0,24 picture make way much sense runner
1,1,10,54,0,9,0,64,0,imaginary friend choose determines primary personality trait
1,1,9,28,0,9,2,37,0,18 red flag learned drink boston
1,1,5,16,2,5,2,21,0,"21 lie ""harry potter"" told u"
1,3,8,27,1,7,0,35,0,normal way abbreviatewords?
1,2,9,34,2,9,1,43,0,7 time jennifer aniston stood woman [video]
1,2,2,57,2,11,0,59,0,sinkhole explained: caused warning signs?
1,1,12,33,0,10,0,45,0,know favorite tv show based birth month
1,1,9,41,1,9,2,50,0,21 healthyish recipe people can't live without cheese
1,1,11,45,1,10,0,56,0,here's people around world find baffling britain
1,1,11,47,2,10,0,58,0,"director ""twilight"" reveals thing probably never knew"
1,3,2,60,0,14,0,62,0,country woman sent exile period list
1,1,10,35,1,9,0,45,0,one question predict lotto winner
1,1,13,47,0,12,0,60,0,patti labelle cursed fan stripped performed stage
1,1,8,22,1,6,0,30,0,need talk martin o'malley
1,3,5,49,2,10,0,54,0,host star 'turned down' great british bake presenting role
1,3,4,44,1,9,0,48,0,barrow stem flow young gambian heading europe?
1,3,5,21,0,6,0,26,0,new view refugee crisis
1,2,2,53,3,10,0,55,0,sure what's really important college hoops? here's guide
1,2,3,87,7,24,3,90,0,"near future, we'll live age 120 need way money it'll easy, follow warren buffett's lead"
1,1,11,32,0,8,0,43,0,bffs imitated hilarious
1,3,7,38,1,8,0,45,0,sleeping enough? arianna huffington want help
1,2,10,36,3,9,0,46,0,"well remember chapter one ""stranger things""?"
1,2,19,66,1,18,0,85,0,"take photo shoot video instead helping accident victims, may need punished"
1,1,14,57,0,14,2,71,0,19 completely fucking exquisite piece jewelry best friend curse lot
1,1,10,44,3,9,0,54,0,"dear britney spears, please add ""overprotected"" vega show"
1,2,13,53,3,12,2,66,0,college football best sign espn's 'college gameday' week 15 baltimore
1,3,3,59,1,13,0,62,0,stop put timelapse milky way fullscreen
1,3,15,44,1,14,2,59,0,"super bowl ad flap, 84 lumber ceo say back trump border wall"
1,1,5,22,0,6,6,27,0,16 weirdest misheard lyric 2015
1,1,8,23,1,6,0,31,0,shout-out real hero hanukkah
1,1,12,47,2,12,2,59,0,"39 thing always wanted know ""harry potter"" star matthew lewis"
1,1,13,42,2,12,0,55,0,"new york is, without doubt, greatest reality star ever exist"
1,1,10,35,0,10,2,45,0,23 tweet make feel better life
1,3,8,41,0,10,0,49,0,great sleep habit feel winning lottery
1,1,5,18,0,4,0,23,0,drive abuela crazy
1,2,9,46,1,9,0,55,0,amazon jeff bezos exploring legal challenge trump travel ban
1,1,12,38,1,11,0,50,0,here's photo young harrison ford working carpenter
1,2,6,29,1,5,0,35,0,putin still favor sidekick medvedev?
1,1,10,35,0,9,0,45,0,kid explain lesson probably need hear
1,2,7,34,4,7,0,41,0,movement third gender option 'exploding' u.s.
1,1,7,32,0,7,2,39,0,10 surprisingly delicious way cook beer
1,2,7,40,2,8,4,47,0,brit award 2017: watch chris martin's george michael tribute
1,1,6,31,0,6,2,37,0,23 picture literally everyone relate
1,1,6,20,0,5,0,26,0,british food really bad
1,2,2,17,0,3,4,19,0,celebrity wedding 2016
1,1,9,32,0,8,0,41,0,well remember classic sega game
1,3,8,40,2,9,0,48,0,gilmore girl lauren graham growing around world
1,1,17,61,3,16,0,78,0,"""harry potter"" valentine's day card give crush based zodiac sign"
1,3,9,54,2,11,0,63,0,coachload korean tourist robbed horror attack linked paris riot
1,1,16,52,0,15,0,68,0,must never forget ben affleck hillary swank best movie ever
1,3,1,31,0,7,2,32,0,15 worst city rush hour traffic
1,2,12,30,2,11,0,42,0,"noticed ""easy a"" mind blown"
1,1,17,58,0,17,2,75,0,group college friend dressed 90 bridal party halloween fake wedding
1,1,10,28,0,10,2,38,0,22 time elf shelf felt like horror movie
1,3,7,53,2,12,0,60,0,"princess diarist carrie fisher review fame, sex harrison ford"
1,2,9,42,0,9,2,51,0,16 product instagram account looking fire
1,3,2,54,2,11,2,56,0,verizon's future could hinge $80 billion legacy cable company
1,1,9,39,0,8,0,48,0,know personality based question color
1,1,8,36,1,8,2,44,0,17 clever iphone accessory know needed
1,2,10,24,0,8,0,34,0,new case fgm reported every hour uk
1,3,4,33,5,8,0,37,0,"who's happy, who's not: norway top list, u fall"
1,1,12,45,0,11,0,57,0,guess secret sexual desire based favourite emoji
1,1,7,32,1,8,6,39,0,15 duet early 2000s forgotten existed
1,1,5,22,0,5,2,27,0,21 pizza recipe worth feasting
1,1,17,57,2,16,0,74,0,"people obsessed ""mermaid pillow"" change swipe hand"
1,2,5,52,3,9,0,57,0,"everyone love bernie sanders. except, seems, democratic party"
1,1,8,42,0,7,0,50,0,british celebrity invite thanksgiving
1,1,13,55,2,12,0,68,0,"hey indian politicians, totally asking photoshop joint hand"
1,2,1,52,1,12,0,53,0,"bird attempt woo mate love heart, get nasty surprise"
1,1,7,23,1,8,5,30,0,18 fact every lesbian know 100% true
1,1,8,26,1,7,0,34,0,take quiz taylor swift
1,1,13,60,2,12,0,73,0,"jimmy fallon perfectly photobombed bunch toddler ""sesame street"" muppets"
1,2,9,40,5,10,0,49,0,here dozen celebrity making w sign [video]
1,1,16,48,5,15,0,64,0,"listened adele's new album, i'm pretty sure"
1,3,5,27,2,5,0,32,0,schumer trump: stop name-calling
1,1,9,30,0,9,2,39,0,13 thing stop feeling bad right
1,2,2,57,1,12,0,59,0,new drone footage give u best look apple's spaceship campus yet
1,2,3,45,3,9,0,48,0,"fun home take home five tonys, including best musical"
1,3,3,58,0,14,1,61,0,4 claim trump white house made travel ban look silly
1,1,9,35,2,8,0,44,0,"proof ""zoolander"" character aged"
1,1,7,34,1,6,1,41,0,7 postcard people long-term relationship
1,1,12,51,0,12,2,63,0,13 ridiculously tasty super bowl snack make crescent roll dough
1,2,14,45,0,14,1,59,0,school van driver held raping minor girl car 6 month
1,1,8,28,0,7,0,36,0,hardest alcohol quiz ever take
1,1,13,45,3,12,0,58,0,"short video make laugh, smile, save friends' life"
1,1,13,42,0,12,0,55,0,crocodile standing tail mean surely end near
1,3,1,16,1,6,0,17,0,ok cry work?
1,1,9,29,2,9,2,38,0,"13 way wanted live like ""george shrinks"""
1,1,12,49,0,12,2,61,0,19 important thing happened modi went silicon valley
1,1,10,32,0,9,0,42,0,match quote charles dickens book
1,1,9,36,1,8,0,45,0,what's stance unspoken rule society
1,1,7,31,0,6,0,38,0,jaden smith tweet college textbook
1,1,9,27,0,8,0,36,0,guess brother sister
1,3,9,49,1,13,0,58,0,"beautiful woman world, according new poll"
1,1,7,27,0,6,0,34,0,much actually love stationery
1,1,13,45,0,12,0,58,0,know zodiac sign date based favorite color
1,2,3,49,1,9,0,52,0,detail emerge george michael's many quiet act kindness
1,1,14,59,0,13,0,73,0,tattoo artist covering scar domestic violence survivor free charge
1,3,9,35,3,5,0,44,0,aclu attorney: dismemberment abortion inhumane
1,3,1,56,1,9,0,57,0,restaurant print pro-immigrant note bottom every receipt
1,1,14,44,0,13,0,58,0,guess disney movie single letter title screen
1,1,16,48,0,16,2,64,0,practiced free throw 30 day see could beat pro basketball player
1,1,7,24,0,6,0,31,0,italian city live
1,1,8,32,0,7,0,40,0,asian beauty product know
1,3,14,54,2,13,0,68,0,brie larson say reaction casey affleck winning oscar 'speaks itself'
1,2,10,44,0,13,0,54,0,guide knowing need professional file tax
1,3,5,29,0,5,0,34,0,best sleepover strategy parent
1,2,10,45,5,9,0,55,0,fired arlington pre-school teacher sorry kill jew tweet
1,1,12,51,0,11,0,63,0,justin trudeau perfect response question gender balance
1,3,2,67,0,11,0,69,0,surviving chapecoense player memory loss told disaster doctor
1,1,14,40,2,13,0,54,0,"true ""the office"" fan able ace jim halpert quiz"
1,1,16,62,3,15,0,78,0,"oprah revealed repeatedly yelled ""you get car!"" everyone confused fuck"
1,1,8,38,0,8,2,46,0,21 useful thing actually organize closet
1,3,2,49,3,10,0,51,0,secret namibia's 'fairy circles' may explained last
1,1,12,46,2,9,0,58,0,"amy schumer hilariously dissed kardashians ""snl"" monologue"
1,1,12,36,2,11,0,48,0,"misophonia real, awful thing, might"
1,1,11,38,0,11,2,49,0,21 picture prove ever drink room
1,3,9,45,0,8,0,54,0,soulja boy taunt chris brown karrueche restraining order
1,1,7,39,0,7,2,46,0,12 confession people struggle depression
1,2,8,44,3,8,0,52,0,"london, donald trump, keystone pipeline: evening briefing"
1,1,8,38,0,7,0,46,0,adorable home decoration make pinecone
1,2,13,56,4,10,0,69,0,detroit free press sport op-ed insists player become left-wing activist
1,1,5,18,0,4,0,23,0,percentage cat
1,1,13,46,0,13,2,59,0,27 guy thinking bride walked aisle
1,3,1,76,0,15,0,77,0,spreadsheet full text people want send ex really something special
1,3,2,40,1,7,0,42,0,bill gate limit children's use technology
1,3,9,32,0,9,2,41,0,17 best beauty product around theworld
1,3,1,41,2,9,3,42,0,taxpayer-owned bank lost $74 billion 9 year
1,1,10,37,1,10,2,47,0,14 lipstick trick people can't make sense makeup
1,1,7,36,0,7,2,43,0,17 dad almost definitely traumatized kid
1,3,1,47,0,9,0,48,0,mercedes formed new alliance develop robot taxi
1,2,18,47,2,15,5,65,0,21-year-old took ubreakifix bedroom 262 store deal google
1,1,15,48,2,14,0,63,0,"emma watson malala hung out, exactly awesome imagine"
1,1,4,18,2,3,0,22,0,"ultimate ""friends"" poll"
1,2,4,47,2,8,0,51,0,advantage: tim tebow? bizarre batting behavior made u wonder
1,1,6,27,1,5,0,33,0,sign already semester
1,3,2,45,2,12,5,47,0,"spending penny street cost italian man fine 10,000"
1,1,6,19,1,6,6,25,0,10 life-changing thing try 2016
1,2,1,77,1,13,0,78,0,google want fix tech diversity problem outpost historically black college
1,1,10,31,1,8,0,41,0,color test determine go-to sex move
1,1,11,36,0,10,0,47,0,many must see action movie watched
1,2,1,33,2,5,2,34,0,new planet discovered 15-year-old intern
1,1,9,40,0,9,2,49,0,17 dish prove japanese food totally fucking insane
1,1,7,26,0,7,2,33,0,21 animal give makeup goal
1,1,17,51,1,14,0,68,0,every parent need watch psa story child telling
1,1,8,26,1,6,0,34,0,filmed co-worker eating placenta
1,2,9,40,2,10,0,49,0,characteristic men likely go bald [video]
1,1,13,45,0,13,2,58,0,17 tweet remind u life used look like facebook
1,1,8,28,0,9,6,36,0,17 cleanses help start 2016 right
1,3,3,43,3,8,0,46,0,pantone color institute's color year 'greenery'
1,1,6,20,0,6,4,26,0,biggest box office flop 2015
1,1,14,50,4,11,0,64,0,"know ""harry potter"" trick-or-treating partner based birth month"
1,1,9,31,2,8,0,40,0,know whether alone valentine's day
1,3,11,53,1,12,0,64,0,"von miller rock fur vest, cowboy hat bandana coachella music festival"
1,1,9,40,0,9,2,49,0,23 photo definitively prove moon landing faked
1,1,6,32,0,5,0,38,0,people try weird peanut butter combination
1,2,13,46,3,11,0,59,0,watch: girl viral 'missing legs' photo explain mystery insider
1,3,2,54,0,12,0,56,0,two determined woman take tech industry sexism new secret ad
1,2,9,33,0,10,6,42,0,26 photo make want spend 2017 travelling
1,1,5,21,0,4,0,26,0,percent voldemort
1,1,8,35,0,7,0,43,0,really deserve christmas present year
1,1,9,42,2,8,0,51,0,here's happens already excited halloween
1,1,11,44,1,10,0,55,0,beautiful wedding dress never seen asia
1,2,2,48,2,12,0,50,0,new year's resolutions: lose fat get fit free
1,1,13,52,1,12,0,65,0,here's happened road tripped around southern california week
1,3,5,37,2,10,0,42,0,best roster coach america? big ten
1,1,10,41,0,10,2,51,0,19 tweet celebrity make laugh every time
1,1,8,39,0,8,2,47,0,19 time internet hilariously summed essay writing
1,1,6,22,0,5,0,28,0,one asked daylight saving
1,2,7,52,6,11,0,59,0,'jurassic world' worthy successor 'jurassic park'?| latest news video
1,1,9,36,0,8,0,45,0,relative nemesis holiday
1,3,1,82,1,14,0,83,0,high-risk pancreatic cancer candidate tested first time fight deadly disease
1,1,9,38,0,8,0,47,0,darth vader mixed donald trump quote hilarious
1,1,6,14,0,5,0,20,0,best moment date
1,3,6,58,3,12,0,64,0,"'genuine leader short supply', joe biden tell justin trudeau canada"
1,2,8,43,0,7,0,51,0,activist fund put executive pay formula microscope
1,1,7,40,2,8,2,47,0,23 confession abercrombie fitch employee tell
1,1,6,29,1,7,6,35,0,29 time shay mitchell's instagram slayed 2015
1,3,12,63,3,16,0,75,0,watch dad's hysterical video 'joys' daughter home college insider
1,1,7,25,2,6,0,32,0,"well remember ""freaky friday"""
1,2,7,33,0,8,0,40,0,trump era invite bolder hollywood red carpet
1,1,8,22,0,7,0,30,0,date would zac efron take
1,1,9,32,0,8,0,41,0,would lifetime movie called
1,1,15,67,2,14,0,82,0,"best husband ever surprised wife incredibly detailed ""harry potter"" birthday party"
1,1,7,41,0,7,2,48,0,19 movie poster significantly improved amazon review
1,1,10,42,2,7,0,52,0,here's celebrity saying #oscarssowhite
1,1,11,40,0,10,0,51,0,colour test reveal kind masturbator
1,1,11,46,0,11,2,57,0,19 strikingly beautiful italian baby name take
1,1,16,64,2,15,0,80,0,"australian mobbed, harassed, threatened india hindu goddess tattoo"
1,1,7,30,0,7,2,37,0,24 stage getting shitfaced week
1,1,5,23,1,4,0,28,0,what's horoscope january
1,1,7,25,0,6,0,32,0,well actually know scotland
1,1,8,39,0,7,0,47,0,hogwarts professor drinking buddy
1,1,9,41,1,7,0,50,0,here's definitive proof leonardo dicaprio immortal
1,3,4,72,1,13,0,76,0,danny meyer explains biggest mistake he's made starting burger chain shake shack
1,1,2,14,0,2,2,16,0,12 nanny confession
1,1,9,34,0,8,0,43,0,baby meerkat precious world
1,1,9,34,0,9,2,43,0,22 fact make feel better
1,1,9,36,1,8,0,45,0,men review women's sex toy get uncomfortable
1,1,7,31,0,7,2,38,0,21 teen mom confession shockingly raw
1,2,2,45,0,8,0,47,0,ton juice flood russian town factory accident
1,1,9,37,0,9,2,46,0,19 stupidest way people broken laptop
1,3,16,56,4,16,0,72,0,"katrina kaif turn barber, dear zindagi's deleted scene world ent!"
1,1,11,49,2,8,0,60,0,david beckham look ridiculously hot behind-the-scenes photo
1,1,7,27,0,8,6,34,0,27 brilliantly irish moment 2015
1,2,0,45,2,12,2,45,0,"13 sign work spouse, even feel like"
1,1,15,50,0,14,0,65,0,look incredibly rare albino baby sea turtle making way ocean
1,2,7,25,0,8,6,32,0,19 people already shitty2017
1,2,12,57,2,11,0,69,0,"alexander acosta? trump labor nominee support amnesty, cheap foreign labor"
1,1,9,29,2,8,0,38,0,here's get sick traveling
1,1,11,30,1,8,0,41,0,hardest wwe royal rumble quiz ever take
1,1,6,20,0,7,6,26,0,21 best lady suit moment 2015
1,2,4,70,4,15,1,74,0,here's question author 'the 4-hour workweek' asks keep wasting time
1,3,4,36,1,10,0,40,0,"survive nuclear war, case list"
1,3,13,52,3,12,0,65,0,emma stone's response tired 'what wearing' question perfection
1,1,5,25,0,4,0,30,0,disney prince average body
1,1,12,41,0,11,0,53,0,know method falling asleep based shirt color
1,2,4,45,2,9,2,49,0,sweet 16 big board: ranking tourney's best draft prospect
1,1,8,23,1,7,0,31,0,said it: chandler bing liz lemon
1,3,16,53,2,14,0,69,0,captain anymore? problem! m dhoni come party brilliant hundred
1,1,11,42,1,10,0,53,0,here's delete facebook friend like donald trump
1,1,10,52,0,9,0,62,0,australian cartoon depicted indian villager eating solar panel
1,3,1,43,1,7,0,44,0,trump destroying healthy health-care system
1,2,10,41,1,10,0,51,0,"hair dye killing you, according advocacy group"
1,3,2,57,6,16,0,59,0,likes. joy: inside high-rise world parkour
1,3,9,32,5,9,2,41,0,new actor officially cast r2-d2 'star wars' [video]
1,1,9,32,0,8,0,41,0,make easy skillet sweet potato frittata
1,1,7,25,0,6,2,32,0,18 amazing disney song cover youtube
1,1,16,46,1,14,0,62,0,know k-pop idol boyfriend based born
1,3,5,37,0,7,1,42,0,9 timeless leadership lesson cyrus great
1,2,15,73,2,14,0,88,0,"journalist booked official secret act, abetment suicide soldier's death sting video"
1,1,8,28,0,7,0,36,0,guess sherlock holmes said
1,3,19,52,3,16,3,71,0,"jud get 'rebranded', rbi issue new r 100 note must read story saturday"
1,3,2,53,2,10,0,55,0,"trump's piano guy cello player trolled hillary fans, bigly"
1,3,10,50,4,11,0,60,0,dr. sebastian gorka astroturf protesters: victim fake news
1,1,9,36,1,8,2,45,0,21 insanely delicious oven-fried food make right
1,2,5,78,1,17,0,83,0,donald trump's closest advisor steve bannon think war china next year
1,3,9,49,5,9,0,58,0,haim saban deeply disturbed obamas biased action israel
1,1,8,30,3,7,2,38,0,"17 sign ""younger"" next binge-watch"
1,1,12,39,1,13,4,51,0,19 thing know partner since 14
1,1,9,40,0,9,2,49,0,36 tweet guaranteed make british people laugh every time
1,1,14,48,0,13,0,62,0,successfully proposed girlfriend advice
1,3,5,28,1,9,0,33,0,abc news quiz: go weekly test
1,1,10,42,3,10,1,52,0,"7 essay read: asian parent kissing, catcalls, gun control"
1,1,11,28,4,10,0,39,0,"""game thrones"" ""lord rings"""
1,1,7,37,0,7,2,44,0,19 photo accidentally look like renaissance art
1,2,3,28,0,6,0,31,0,inside mind ultrawealthy
1,1,9,43,2,8,0,52,0,"people furious billboard ""sexualizing"" north west"
1,1,7,20,3,6,0,27,0,"said it: harry, ron, hermione"
1,1,16,53,1,14,0,69,0,doctor quiet cry baby second trick totally mind-blowing
1,1,12,40,3,10,0,52,0,"amber rose called gq's sexist ""ignorant"" portrayal"
1,1,12,44,4,11,0,56,0,"gwen stefani add fire blake shelton dating rumors: ""he's hot"""
1,1,11,33,3,10,0,44,0,"emily kinney took ""what kind coffee you?"" quiz"
1,1,7,30,0,6,0,37,0,bring friendsgiving
1,2,9,35,0,9,2,44,0,23 office worker perfected art sarcasm
1,3,8,60,1,7,0,68,0,republican congresswoman marsha blackburn obamacare twitter poll backfire
1,3,11,38,3,10,0,49,0,"please, i'm begging you, tell u like chainsmokers"
1,1,8,25,0,7,0,33,0,donald trump donald duck
1,1,7,30,0,7,2,37,0,27 time twitter really confused sex
1,2,14,46,0,13,0,60,0,jimmy kimmel break ivanka trump got plum white house job
1,1,11,49,4,10,0,60,0,"blake lively's ""gossip girl"" audition tape resurfaced amazing"
1,1,11,36,0,10,0,47,0,jimmy fallon terrible liar vince vaughn know
1,1,8,26,0,8,2,34,0,48 thing basic guy love fall
1,2,6,37,3,8,0,43,0,graphic: a-z tony blair's global business deal
1,3,1,47,0,11,0,48,0,guy set new world record finger snap minute
1,1,10,35,0,11,6,45,0,18 time nick bateman hottest guy instagram 2015
1,1,8,37,0,8,2,45,0,21 thing inevitably happen container store
1,1,13,55,3,12,0,68,0,"nicki minaj's face jennifer lopez danced ""anaconda"" everything"
1,1,17,58,0,16,0,75,0,proof god gay man straight woman ryan reynolds officially silver daddy
1,1,13,46,0,12,0,59,0,know people love based favorite sandwich
1,3,10,45,1,9,4,55,0,capital onevoice: top international event worth traveling 2017
1,3,13,52,1,14,2,65,0,11 time akshay kumar proved humble grounded bollywood actor
1,1,9,50,1,9,2,59,0,19 bookish valentine's day gift every literature lover appreciate
1,1,10,29,1,10,2,39,0,19 easy way prove kid
1,1,7,38,1,6,0,45,0,fictional lesbian couple ruining people's life
1,1,13,50,0,12,0,63,0,jennifer lawrence surprised amy schumer best gift emmy win
1,3,2,63,3,13,0,65,0,freezing low put blossom risk weekend. here protect them.
1,3,14,53,5,13,0,67,0,"trump spread gross rumor madonna, he's calling 'disgusting'?"
1,3,2,64,2,13,0,66,0,american need relearn fight politics. sitcom ready help.
1,1,9,28,2,8,0,37,0,"well know lyric ""reflection"""
1,3,3,43,0,8,0,46,0,chinese millennials reflect root new year
1,3,6,24,1,6,0,30,0,hater's guide loving port wine
1,1,13,51,3,13,2,64,0,"37 thing probably know ""harry potter chamber secrets"""
1,1,7,17,1,7,6,24,0,12 ps1 game look 100% better
1,1,8,28,0,8,2,36,0,15 thing never noticed owning cat
1,1,7,23,0,7,2,30,0,24 cutest reindeer ever see
1,1,12,35,0,10,0,47,0,british teen tv squad friend group
1,1,14,46,3,13,0,60,0,"need listen ukulele cover selena gomez's ""hands myself"""
1,1,9,25,2,7,2,34,0,pas math test 11-year-olds
1,1,6,35,0,6,2,41,0,23 picture extrovert never understand
1,1,4,15,0,3,0,19,0,force awakened
1,3,8,38,2,7,0,46,0,wildcard: trumpcare's failure could hurt big pharma
1,1,11,48,1,10,2,59,0,14 next-level grilled cheese sandwich better boyfriend
1,3,11,48,6,12,0,59,0,"frank luntz: obama fu tour, trying settle score republican"
1,1,5,24,1,5,1,29,0,3 time woman taken seriously
1,3,12,49,1,11,0,61,0,report: megyn kelly kick nbc show kardashian family interview
1,1,11,34,1,9,0,45,0,x-men character based zodiac sign
1,1,12,48,2,11,0,60,0,"first teaser ""pride prejudice zombies"" insanely badass"
1,1,11,33,2,11,2,44,0,"21 time mr potato head shadiest toy ""toy story"""
1,1,5,29,0,4,0,34,0,people review japanese beauty product
1,1,6,17,0,5,0,23,0,place best ice
1,1,6,26,0,6,2,32,0,17 lesson cat taught u menswear
1,1,14,43,0,13,0,57,0,best friend kendall cara kendall gigi
1,1,6,20,1,7,5,26,0,17 time sonam kapoor 100% point
1,3,5,56,2,14,0,61,0,fan losing jon snow theory new 'game thrones' photo
1,3,2,32,1,5,0,34,0,"trump inauguration, seen infrared"
1,2,11,27,4,12,2,38,0,7 thing want hear j. cole's '4 eyez only'
1,1,11,38,1,11,2,49,0,22 picture life fucking made money
1,2,2,53,2,9,0,55,0,"mysterious, blood-sucking fish fell alaskan sky"
1,2,8,46,2,14,6,54,0,"man raised 250,000 make nsfw donald trump doll list"
1,1,12,32,1,11,0,44,0,ellie goulding new hair pretty fire
1,1,13,46,1,11,0,59,0,genius put gopro inside washing machine mesmerizing
1,2,4,43,0,8,0,47,0,barbie battle star war hatchimals register
1,1,11,42,2,9,0,53,0,two cutest part trudeau's swearing-in ceremony
1,2,16,59,0,15,0,75,0,people totally obsessed dad sending family weird photo hugecube
1,2,10,39,3,8,0,49,0,billionaire's path one-room flat mega-store empire
1,1,11,38,3,10,0,49,0,"here's feel like ""american idol"" host"
1,1,6,21,0,6,2,27,0,16 picture gal pal
1,1,7,23,0,6,0,30,0,dog actually see world
1,3,9,31,2,8,3,40,0,hottest spring new-car lease deal $200 month
1,1,10,41,0,10,2,51,0,15 time calvin hobbes reminded never stop exploring
1,1,3,12,0,3,2,15,0,21 cat wearing wig
1,1,16,56,2,15,0,72,0,"john krasinski want clear jenna fischer never ""genuinely love"""
1,3,7,27,0,8,1,34,0,eat 8 food fight crappy cold
1,1,12,41,6,12,1,53,0,"7 essay read: blaxicans, text flirting, ""doing 'gram"""
1,1,4,20,0,4,2,24,0,13 celebrity brace
1,1,9,21,0,9,4,30,0,know 2015 pop hit hate
1,1,11,42,3,9,0,53,0,"couple got married ""star-studded"" autistic wedding"
1,3,9,24,5,8,0,33,0,"y'all, new ""zelda"" game freakin' fun"
1,1,10,46,2,10,2,56,0,"19 thought batshit insane ""lucha underground"" trailer"
1,1,9,34,0,9,2,43,0,19 genius idea people obsessed pasta
1,1,9,48,3,9,2,57,0,"18 important lesson ""little nemo: adventure slumberland"" taught u"
1,3,5,14,1,4,0,19,0,fragile ego?
1,2,2,67,2,14,0,69,0,britain already fragile union risk scotland government
1,1,10,35,0,10,2,45,0,19 parent share keep magic alive kid
1,3,14,46,2,13,0,60,0,move dubai: doha middle east's next big destination
1,1,12,36,3,11,1,48,0,"here's live tv production ""grease 2"" look like"
1,3,0,42,1,8,1,42,0,9 incredible way we're using drone social good
1,3,5,23,0,6,0,28,0,wrong way speak child
1,3,11,43,1,10,0,54,0,go vacation? let personality type decide
1,3,2,64,1,13,2,66,0,cadbury's freddo chocolate bar price rise 30p due rising commodity price
1,1,18,57,1,17,0,75,0,here's need know indian law let police arrest actor mimicry
1,1,9,51,0,8,0,60,0,inspiring portrait capture emotional fight cancer
1,1,12,54,1,11,0,66,0,trans woman using topless photo challenge facebook's nipple policy
1,2,7,27,1,7,0,34,0,carrie fisher urn giant prozac pill
1,1,10,36,2,11,6,46,0,"21 time woman destroyed men ""waste time 2016"" hashtag"
1,1,7,31,0,7,2,38,0,17 people difficulty biracial
1,2,10,50,7,10,0,60,0,behar: hillary supporter sore loser trump didnt win legitimately
1,1,7,36,1,6,2,43,0,14 teeth-curlingly awkward funny mumsnet thread
1,1,15,55,1,13,0,70,0,gabrielle union dwyane wade made wedding video look like rom-com trailer
1,1,7,41,0,7,2,48,0,16 british politician dramatically altered man bun
1,2,9,52,0,9,0,61,0,climate scientist fire back house science committee hearing
1,2,6,26,0,7,6,32,0,22 time people got hilariously drunk in2016
1,3,1,51,1,8,0,52,0,fillon's enemy hope family affair end presidential bid
1,3,13,64,2,14,0,77,0,"jon batiste clipper star chris paul talk giving back, new orleans motivational anthem"
1,1,11,39,3,11,1,50,0,"first ""agent carter"" season 2 promo fabulous"
1,1,6,20,0,5,0,26,0,girl text back
1,1,7,23,0,7,1,30,0,7 easy way eat healthier week
1,3,9,51,3,11,0,60,0,spicer: sanctuary city blood dead american hand
1,3,3,48,3,8,0,51,0,who's hindu hardliner running india's populous state?
1,1,11,30,0,10,2,41,0,11 time mythbusters took job bit far
1,3,11,29,4,11,2,40,0,"23 tweet make say wow, writethat?"
1,3,6,48,2,10,0,54,0,"source: white sox, national advanced talk chris sale trade"
1,3,8,75,1,16,0,83,0,passed warren beatty wrong envelope? really happened la la land moonlight
1,1,8,27,0,7,0,35,0,people try lychee jelly first time
1,1,7,25,2,7,2,32,0,"27 best ""meanwhile canada"" tweet"
1,1,7,22,0,7,2,29,0,19 reason date tall girl
1,1,11,41,0,11,2,52,0,17 donald trump photo improved wise word ralph wiggum
1,2,10,56,0,12,0,66,0,cartel gunman wish merry christmas beheading rival front child
1,1,13,46,2,13,2,59,0,"23 thing understand ""harry potter"" made friend"
1,2,4,50,3,11,0,54,0,study: kid learn much sesame street preschool
1,1,16,59,4,14,1,75,0,"awesome dad built backyard course 3-year-old love ""american ninja warrior"""
1,1,10,34,1,9,2,44,0,14 way tray make space feel put-together
1,3,3,34,3,7,0,37,0,briton can't identify sparrow. you?
1,3,2,26,1,4,0,28,0,pictures: portrait welcome
1,1,10,40,0,9,0,50,0,power position according sign
1,1,13,38,4,12,0,51,0,"watch ""rent"" adult realize annoying"
1,3,6,48,0,11,0,54,0,bill tory mp philip davy filibustered
1,3,8,43,1,10,4,51,0,screen actor guild award 2017: star react nomination
1,3,2,51,0,7,0,53,0,revived cavalier find simplified defense winning approach
1,1,9,31,0,9,2,40,0,26 important question people go gym
1,1,7,37,0,6,0,44,0,snuffleupagus without fur goddamned nightmare
1,1,9,48,1,8,0,57,0,fuckboy shamelessly attracted determines zodiac
1,1,7,37,2,7,2,44,0,"12 burning question ""making murderer"" answered"
1,1,18,48,0,16,2,66,0,16 gifs anyone trying get life order relate spiritual level
1,1,15,46,1,14,0,61,0,ryan gosling's new movie go far try make economic crisis fun
1,1,8,33,0,8,2,41,0,21 picture work guaranteed make laugh
1,2,1,67,2,14,2,68,0,machine used considered punishment $1.4 billion fitness industry
1,2,3,62,0,12,0,65,0,khalil rafati quit crack cocaine heroin become juice millionaire
1,1,4,21,1,3,2,25,0,21 modern make-ahead casserole
1,2,1,41,2,6,0,42,0,indian army cancel recruitment exam 'leak'
1,3,6,21,1,8,6,27,0,best album 2017 far: 27 staff pick
1,1,11,30,0,8,2,41,0,17 iconic halloween episode watch asap
1,3,7,41,3,7,0,48,0,"gorsuch, rockefeller, brady: monday evening briefing"
1,1,7,24,0,8,6,31,0,42 dog found forever home 2015
1,1,12,44,3,9,1,56,0,one-size-fits-all beauty product look like 4 different woman
1,1,5,19,0,4,0,24,0,worst type roommate
1,1,11,32,0,10,0,43,0,one ever tell therapy
1,2,3,30,2,7,0,33,0,here mall across u dying
1,1,11,43,1,10,0,54,0,here's climb mount everest without leaving house
1,1,9,36,0,9,2,45,0,19 reason getting period goddamn worst
1,3,2,46,1,9,0,48,0,"craving family time, called everyone dinner table"
1,3,5,57,2,10,0,62,0,pcos: diet help treat little-understood fertility problem
1,1,7,28,2,6,0,35,0,"""a different world"" character"
1,2,8,48,1,9,0,56,0,beauty industry finally starting recognize curvy models?
1,1,5,19,0,6,6,24,0,21 great book music 2015
1,2,10,41,3,8,2,51,0,29 mind-blowing thing probably didnt know mcdonalds
1,1,6,22,0,6,2,28,0,23 gift people hate cooking
1,3,6,28,0,6,2,34,0,33 first time every woman experienced
1,1,11,45,2,9,0,56,0,j.k. rowling important advice gryffindors anxiety
1,3,17,62,3,16,0,79,0,pakistani loco driver trouble stopping train front dhaba ...to eat pakoras
1,1,8,35,1,7,0,43,0,remember last relationship vs. reality
1,1,11,45,4,11,3,56,0,"heartbroken little girl sang fetty wap's ""679"" goldfish's funeral"
1,2,9,44,0,10,0,53,0,dealmakers let secret slip leak lead higher offer
1,1,8,36,3,7,0,44,0,"""american horror story: hotel"" character"
1,2,3,79,0,13,0,82,0,freshman killed hammer throw volunteering wheaton college track field event
1,1,7,33,0,7,2,40,0,19 time contouring got completely control
1,1,9,28,0,7,0,37,0,get oscar leonardo dicaprio
1,1,11,44,0,10,0,55,0,celebrity girlfriend based birth month
1,1,11,35,0,10,0,46,0,uzo aduba need character like crazy eye
1,1,8,24,0,9,6,32,0,26 time chris pratt ruined men 2015
1,1,5,24,0,5,2,29,0,25 normal people normal thing
1,1,10,29,1,11,4,39,0,17 book definitely read grew '00s
1,3,8,33,1,8,2,41,0,21 little thing ruin every retail workersday
1,3,2,48,1,8,0,50,0,true meaning christmas found family's magical reunion
1,3,9,44,1,10,0,53,0,uber us psychological trick push driver button
1,1,12,62,1,11,0,74,0,"obama compared republican grumpy cat, whipped uncanny grumpy cat impersonation"
1,1,10,43,2,9,0,53,0,"mom opposite reaction son ""secret"" tattoo"
1,3,0,46,0,11,6,46,0,10 challenge 2016 taught u teen still rule world
1,1,6,20,0,5,0,26,0,grammy award would win
1,1,7,36,0,7,2,43,0,19 silly assumption single thirty
1,1,8,33,0,7,0,41,0,chris pratt hot also really inspirational
1,1,5,14,0,4,0,19,0,candy best
1,3,3,20,1,5,0,23,0,vr alter brain?
1,3,2,51,2,10,0,53,0,"there's another united horror story, break heart"
1,1,11,37,1,9,0,48,0,pete wentz's emo dating profile make nostalgic af
1,2,9,31,1,8,0,40,0,saddest salad ever happened?
1,3,10,35,5,9,0,45,0,hanoi jane fonda lead l.a. womens march trump
1,3,12,59,2,10,3,71,0,stanford accepts muslim teenager wrote blacklivesmatter 100 time application
1,1,8,37,0,8,2,45,0,18 thing literally everyone earth identify
1,1,9,28,0,8,0,37,0,well actually see color purple
1,3,2,58,2,11,0,60,0,'smart condom' measure performance bedroom list
1,1,8,28,0,7,0,36,0,pizza chart internet
1,2,7,41,0,7,2,48,0,28 time celebrity asked hilarious question twitter
1,1,8,30,2,9,6,38,0,"13 way world changed since ""1989"" released"
1,1,9,26,0,8,0,35,0,fake way super bowl
1,1,6,25,0,5,0,31,0,starbucks cup actually
1,1,11,30,0,9,2,41,0,21 wtf crime could ever happen britain
1,1,6,27,0,5,0,33,0,dad made inspirational poster
1,1,8,32,2,7,0,40,0,"know favorite ""high school musical"" movie"
1,1,11,36,1,10,0,47,0,epic chili bar easiest party ever throw
1,2,9,46,2,9,0,55,0,surprise: good economic news isnt always great news investor
1,3,5,59,2,13,2,64,0,eight better way waste 26 buck capital president trophy t-shirt
1,1,18,62,0,17,0,80,0,summer officially forever find white sand beach made fish poop
1,2,7,39,3,7,0,46,0,"london, gorsuch, syria: wednesday evening briefing"
1,1,6,11,4,5,0,17,0,"say ""awnt"" ""ant"""
1,1,12,42,1,12,1,54,0,6 artist might play surprise show apple's top secret event
1,2,8,42,2,12,0,50,0,steve martin teaching (and himself) comedian
1,1,8,30,0,7,0,38,0,people try suicide sprint first time
1,1,10,42,0,10,2,52,0,18 milestone friend must go become best friend
1,1,8,32,1,8,1,40,0,6 transgender women's memoir need read
1,3,13,53,0,12,0,66,0,inspiring quote famous athlete inspire push limit
1,3,5,77,1,17,3,82,0,ed sheeran tour: ticket go sale additional show celebrating 10th anniversary o2 arena
1,3,3,47,0,8,0,50,0,absolut upset south korean mixing vodka politics
1,2,13,42,1,10,0,55,0,video: officer drive woman allegedly shoot police
1,2,1,47,1,9,1,48,0,gluten-free diet linked reduced risk type 2 diabetes
1,1,11,38,0,10,0,49,0,angela bassett showed golden globe slayed
1,1,11,32,0,10,0,43,0,type friend based zodiac sign
1,3,8,46,0,8,0,54,0,behind dizzying student loan game navient allegedly played
1,2,1,65,1,11,0,66,0,"cheap, widely available drug could stop thousand mother bleeding death"
1,2,14,73,3,17,0,87,0,stephen miller: trump better sense pulse people president since andrew jackson
1,3,13,42,1,13,2,55,0,"tracee elli ross golden globe 44 year mom, dianaross"
1,1,13,30,4,10,0,43,0,"omg, david bowie could've ""the lord rings"""
1,1,14,43,3,12,0,57,0,"sky high actually ""avatar: last airbender"" high school au"
1,3,1,77,3,20,2,78,0,60% british woman busy wash hair often shampooing locks?
1,1,11,42,2,10,0,53,0,here's shopping love victoria's secret
1,1,11,40,1,9,0,51,0,mike tyson falling hoverboard make laugh-cringe
1,3,3,53,0,9,0,56,0,meghan markle pen revealing essay biracial hollywood
1,3,1,67,2,12,0,68,0,mysterious rogue planet floating space may even odder thought
1,3,11,55,2,12,0,66,0,street artist depicts caitlyn jenner clown poster outside fox studio
1,1,10,35,1,9,0,45,0,learned rory gilmore perfect role model
1,3,7,47,1,10,0,54,0,there scientific way leave work frustration office
1,1,14,51,0,13,0,65,0,photo series show instagram photo india hide big picture
1,1,14,45,0,14,2,59,0,bride 11th person family wear wedding dress
1,1,8,27,0,8,2,35,0,19 thing happen date scientist
1,2,6,39,4,9,2,45,0,"5 thing monday, april 3: china, supreme court, colombia"
1,2,10,38,0,12,2,48,0,10 cool way hang flat screen finally saved
1,1,8,33,0,7,0,41,0,spoof kid book hipster hilarious
1,1,10,38,1,8,0,48,0,lame-ass joke tell thanksgiving dinner
1,1,14,52,2,13,0,66,0,"taylor swift revealed ""bad blood"" might actually katy perry"
1,3,5,36,2,6,2,41,0,"gwyneth paltrows wellness philosophy, 10 quote"
1,1,17,49,0,16,0,66,0,watch baby adorably prank dad fake cry try cut nail
1,1,12,44,0,11,0,56,0,disney princess feeling yr foot get fall asleep
1,2,1,54,0,10,0,55,0,airfare destination could drop time spring break
1,1,12,40,0,10,0,52,0,guess ariana grande video youtube comment
1,2,12,51,1,13,6,63,0,"gujarat boy went missing 2001 earthquake, return 16 year later monk"
1,2,2,51,0,11,0,53,0,uk beauty queen cured severe acne one simple diet trick
1,1,14,31,0,13,0,45,0,kylie jenner get hit face hot dog
1,3,8,34,1,7,0,42,0,here's oscar nomination look like
1,1,17,51,0,16,0,68,0,new coen brother movie time everyone sort closet
1,2,6,30,0,5,0,36,0,bargain street style london shopper
1,1,17,46,2,16,0,63,0,"dressed dog chanel ""scream queens"" want murder"
1,1,9,45,0,9,2,54,0,27 picture mildly irritate anyone love stationery
1,1,8,30,1,9,4,38,0,31 song early '00s woman never forget
1,2,6,33,1,8,4,39,0,here's full list 2017 academy award nominee
1,1,10,27,0,5,0,37,0,impossibly cute diy bff halloween costume
1,1,8,30,2,7,0,38,0,"many ""star wars"" starship identify"
1,1,15,43,0,14,2,58,0,12 thing black woman told hair may total b
1,1,12,31,0,11,0,43,0,james harris david parnes play game
1,1,8,27,0,7,0,35,0,actually know word mean
1,3,1,32,0,6,2,33,0,10 top tip london correspondent
1,3,10,19,1,9,1,29,0,get 5 ap english exam?
1,1,11,36,1,9,0,47,0,need listen kanye west-weezer mashup album
1,1,11,37,0,10,0,48,0,know avenger based shawarma order
1,1,7,24,0,6,0,31,0,birthday say
1,1,10,41,2,10,2,51,0,"19 reason ""elf"" always favorite christmas movie"
1,3,1,39,2,10,0,40,0,"love social media, even love back"
1,2,3,60,1,11,0,63,0,mexican politician took protest right trump front door
1,1,6,16,0,5,0,22,0,joe jonas blue hair
1,2,4,62,1,11,0,66,0,"isi still hold thousand slaves, giving brisk business human smuggler"
1,1,10,38,1,9,0,48,0,here's deal insanely annoying mouth issue
1,1,7,19,3,7,2,26,0,"20 time ""bones"" got way, way real"
1,1,9,29,0,9,2,38,0,19 glorious way smart as christmas
1,1,8,34,3,7,0,42,0,"""avatar: last airbender"" character"
1,1,8,24,1,8,2,32,0,well know '00s teen movie quote
1,1,10,38,0,9,0,48,0,choose squiggle determine current frame mind
1,3,2,49,5,13,0,51,0,"'global gag rule', trump support it? video"
1,1,10,43,0,9,0,53,0,solange shuts instagram commenter called son ugly
1,1,12,44,0,11,0,56,0,ricky gervais made joke caitlyn jenner golden globe
1,3,3,40,2,8,0,43,0,'flipper' helping teach dolphin rescue oman
1,3,4,56,3,11,0,60,0,"wilson, weatherill, wyatts: winner loser week politics"
1,1,9,39,0,9,2,48,0,19 picture true diet coke lover understand
1,1,13,46,3,12,0,59,0,"wake up, america: time realize amazing anne hathaway really"
1,2,6,78,1,14,0,84,0,many questions: hilarious photo around world capture people puzzling scenario
1,1,7,27,0,8,6,34,0,19 time gizmo griffon instagram 2015
1,2,3,72,0,14,2,75,0,destination 19 photograph prove japan beautiful place earth right
1,2,13,67,5,12,0,80,0,"ten arrested, including four illegal aliens, savage gang-related killing maryland teen"
1,1,12,42,0,12,2,54,0,22 product prove obsession drake gone way far
1,2,10,35,0,10,2,45,0,28 thing every person hate doesanyway
1,1,12,51,0,12,2,63,0,family making amazingly awkward christmas card 13 year
1,1,6,27,0,7,6,33,0,17 reason mariah carey incredible 2015
1,1,7,30,0,7,2,37,0,41 totally legitimate reason quit job
1,2,8,28,0,8,2,36,0,21 coffee hack step game immensely
1,3,9,26,1,9,2,35,0,12 reason happy
1,1,9,26,0,9,1,35,0,watch woman style hijab 7 easy way
1,1,10,40,2,9,0,50,0,"scene ""the little mermaid"" ruin childhood"
1,1,10,35,0,9,0,45,0,know favorite artist based zodiac sign
1,2,12,51,3,11,0,63,0,"marijuana eas pain, jury's health benefits, scientist say"
1,1,8,27,0,7,0,35,0,everyone upstate new york
1,1,15,54,0,14,0,69,0,blake lively sent taylor swift birthday pie topped mini version cat
1,1,9,37,0,9,2,46,0,19 people every student black college recognize
1,1,6,21,0,5,0,27,0,fanfic helped find
1,1,7,24,0,5,0,31,0,identify u president
1,2,1,37,0,7,0,38,0,chemist bad news cough syrup
1,2,1,58,0,9,0,59,0,bartender reveal shocking thing drunk customer done
1,2,6,69,4,14,4,75,0,"u election 2016 pill popping, post-it note hot dogs: american coping post-election"
1,1,8,27,0,8,2,35,0,19 food shut winter
1,1,11,45,1,11,2,56,0,21 word totally different meaning lifeguard
1,1,10,37,0,10,1,47,0,member 5 second summer brother
1,1,14,35,0,13,0,49,0,single woman new york movie v real life
1,1,9,33,0,8,0,42,0,company sends grilled cheese every week
1,1,13,39,0,12,0,52,0,know perfect board game based zodiac sign
1,1,9,21,2,7,2,30,0,"season 41 ""snl"" cast member"
1,3,6,42,1,6,2,48,0,15 breathtaking eyelash transformation thatll shockyou
1,1,11,20,0,7,0,31,0,forget take adhd med
1,2,10,38,0,9,0,48,0,explore planet new improved google earth
1,1,5,18,1,4,0,23,0,lilly singh vs. aussie slang
1,1,7,26,0,6,0,33,0,test reveal biggest flaw
1,3,7,37,1,8,1,44,0,5 trait hiring manager look ashford university
1,1,8,26,1,9,4,34,0,21 thing make '00s girl feel old
1,2,5,26,0,5,0,31,0,banning tablet best child
1,1,7,40,0,7,2,47,0,12 picture perfectly depict reality versus fantasy
1,1,10,40,0,9,0,50,0,adulthood look like according stock photo
1,3,7,28,0,7,2,35,0,14 creative way reuse empty wine bottle
1,1,12,39,2,11,0,51,0,"ellen portia named new puppy ""kid"" best reason"
1,1,10,40,1,10,2,50,0,18 cute animal sometimes that's need
1,3,10,44,1,11,4,54,0,33 product $15 basically already shoppingcart
1,2,9,47,2,10,1,56,0,6 celebrity embraced donald trump president [video]
1,1,14,60,1,13,0,74,0,district magistrate meal cooked widow dispel villagers' superstition
1,1,10,30,0,9,0,40,0,amy poehler hiding donald trump u
1,1,11,46,4,10,0,57,0,"cast ""grease: live!"" competes bubblegum blowing competition"
1,1,8,19,1,6,2,27,0,pigskin blanket: nfl week 11 pick
1,2,12,39,0,11,0,51,0,pregnant mom took love starbucks nextlevel
1,1,12,51,0,11,0,63,0,official harry potter anime character make squeal joy
1,2,9,46,2,9,2,55,0,mapping $27 billion federal funding america's sanctuary city
1,1,10,45,1,11,4,55,0,24 forgotten item late '90s teen girl slightly obsessed
1,2,4,38,0,7,0,42,0,celebrate world gin day easy cocktail
