title,clickbait,set,char_capital,char_small,char_special,blank,numerical,letters,outlier
Weak Federal Powers Could Limit Trump’s Climate-Policy Rollback ,0,2,9,45,2,8,0,54,0
Son of boxer Muhammad Ali reportedly detained at Florida airport and asked whether he was Muslim,0,3,5,76,0,15,0,81,0
Takk's great escape: The UCLA pass-rusher's remarkable journey,0,3,6,45,4,7,0,51,0
Soulja Boy Apologizes for Chris Brown Feud in New Twitter Video: 'I've Been Acting Out',0,3,13,56,4,14,0,69,0
Football sex abuse: Scotland Yard launches investigation into abuse claims at London clubs,0,3,4,73,1,12,0,77,0
"For Fact-Checking Website Snopes, a Bigger Role Brings More Attacks ",0,3,10,46,2,10,0,56,0
Shares in Blackstone Group fall below IPO price,0,1,6,34,0,7,0,40,0
"Free trade warning – IMF, WTO and World Bank say it must be defended",0,2,9,44,2,13,0,53,0
GOP health care bill advances despite opposition from conservatives ,0,2,3,56,0,9,0,59,0
Justin Trudeau takes on Trump with a perfectly timed photo,0,3,3,46,0,9,0,49,0
"Former FBI Second-In-Command says he was ""Deep Throat""",0,1,9,34,4,7,0,43,0
A Celebration on Wheels in Observance of Purim,0,1,5,34,0,7,0,39,0
India Andhra Pradesh train crash leaves 39 dead and scores injured,0,2,3,51,0,10,2,54,0
Scientists See Signs of Dinosaur Blood in 75-Million-Year-Old Fossils,0,3,9,47,3,8,2,56,0
Carrie Fisher's Death Highlights The Reality Of Heart Disease In Women,0,3,11,48,1,10,0,59,0
"UFC Champion Conor McGregor To Appear On Game Of Thrones, Waiting For Season 7 Just GoT Harder",0,3,20,56,1,16,1,76,0
Adam West is back as Batman,0,2,3,19,0,5,0,22,0
Drug overdose deaths increased by 33-percent  in past 5 years ,0,3,1,46,1,11,3,47,0
EU urged to clarify if states are funding mass executions in Iran,0,3,3,51,0,11,0,54,0
People Have A Lot Of Feelings About The New Power Rangers Movie Featuring A Queer Ranger,0,2,16,57,0,15,0,73,0
"When a Partner Dies, Grieving the Loss of Sex ",0,3,6,30,1,9,0,36,0
"Woolly Mammoth Could Be 'De-Extinct' In 2 Years, Scientist Says",0,2,10,39,4,9,1,49,0
Sanctuary city mayors fire back at Trump administration's threat to cut fed funding ,0,3,2,68,1,13,0,70,0
Sweden celebrates its first national day as a public holiday,0,1,1,50,0,9,0,51,0
"Someone Just Bought Hitler's Personal Phone For $243,000",0,3,7,33,3,7,6,40,0
This Fashion Line Is Changing How We Define Nude,0,3,9,31,0,8,0,40,0
Myanmar Presses Case Against Pro-Democracy Leader,0,1,7,36,1,5,0,43,0
Warriors' JaVale McGee Shows Off Another Unconventional Haircut,0,3,10,45,1,7,0,55,0
Israeli navy fires on Gazan fishing vessels,0,1,2,35,0,6,0,37,0
Man becomes first to swim at North Pole,0,1,3,29,0,7,0,32,0
Doll based on transgender teen to debut at New York Toy Fair ,0,2,5,44,0,12,0,49,0
Ethiopian fighter jets attack Somalian towns,0,1,2,37,0,5,0,39,0
Judge to decide on Nigerian election re-run,0,1,2,34,1,6,0,36,0
Shaun Walmsley: police put up escaped killer's own money as reward,0,3,2,52,2,10,0,54,0
DeMarcus Cousins totally kicked this chair's ass. Hope it was worth the price.,0,3,4,59,3,12,0,63,0
"Parents Welcome New Year's Twins Born Minutes Apart, in Different Years ",0,2,10,49,2,11,0,59,0
Deflection in Overtime Helps Capitals Force Game 7,0,1,6,36,0,7,1,42,0
"Draymond Green Defends Kyrie Irving, Might Also Be a Flat Earth Truther",0,3,11,48,1,11,0,59,0
Australia hits new Telstra privatization hurdles,0,1,2,41,0,5,0,43,0
Drug Stocks Plunge as Trump Threatens to Force Price Bidding,0,3,8,43,0,9,0,51,0
"Barrier Reef at risk of winding up on UNESCO 'danger' list, Queensland Government says",0,3,10,60,3,13,0,70,0
Brexit latest: Average real wage growth falls to zero in February,0,3,3,51,1,10,0,54,0
"Five killed in mid-air collision over Warwickshire, England",0,1,3,47,2,7,0,50,0
Conservatives hope that Trump victory on Gorsuch will breed other successes,0,2,3,62,0,10,0,65,0
Quit Your Office Job: Tips From 4 Women Who Transformed Their Lives With Travel,0,3,13,51,1,13,1,64,0
"Peter Buffett Talks Creativity, Music, Philanthropy, And Life With Dad Warren Buffett",0,3,12,59,3,11,0,71,0
Hello world! Polar bear cub gives a wave to the cameras at German zoo which is asking for the public to name it ,0,3,3,85,1,23,0,88,0
LeBron James Throws Major Shade at Donald Trump,0,3,8,32,0,7,0,40,0
"Ditch hostile approach of 'Brexit zealots', Europhile Tories urge ministers",0,3,4,59,3,9,0,63,0
Oil rebounds on Saudi assurances Russia will extend supply cuts,0,2,3,51,0,9,0,54,0
Banned Chinese medicine still on sale in United Kingdom,0,1,4,43,0,8,0,47,0
Champions League: fans from around Europe reflect on the last-16 draw,0,3,3,52,2,10,2,55,0
Terps turn to March Madness after maddening loss to Northwestern in Big Ten tournament,0,2,6,67,0,13,0,73,0
Jaden Smith joins Baz Luhrmann's Netflix drama,0,2,5,34,1,6,0,39,0
Tom Hardy Describes Aches and Pains After Roles Like Bane in 'Dark Knight Rises',0,3,12,53,2,13,0,65,0
Gus Fring Is Fucking Back In A Los Pollos Hermanos Commercial,0,3,11,40,0,10,0,51,0
The highest-paid player on every NBA team,0,3,4,30,1,6,0,34,0
Lingering baby weight? Don't blame the pregnancy,0,3,2,38,2,6,0,40,0
Prince's Palace in Toronto Goes on the Market for $13M [Video],0,3,7,39,4,10,2,46,0
"Iquique, Chile struck by moderate earthquake",0,1,2,36,1,5,0,38,0
"Serge Ibaka Trade Rumors: Latest News, Speculation Surrounding Magic PF",0,3,11,49,2,9,0,60,0
Ohio Moves To Ban Abortion After 6 Weeks Of Pregnancy,0,3,9,34,0,9,1,43,0
"Ziff Davis sells 1UP to UGO Networks/Hearst, closes Electronic Gaming Monthly",0,1,12,52,2,10,1,64,0
Cyberbullying app at center of probe into teen’s suicide,0,2,1,46,1,8,0,47,0
"John Glenn, American Hero of the Space Age, Dies at 95 ",0,3,7,33,2,11,2,40,0
Critics honor 2004-2005 best in U.S. TV,0,1,5,17,3,6,8,22,0
"""Skippy"" the cat rescued after getting head stuck inside peanut butter jar",0,3,1,60,2,11,0,61,0
George W. Bush: Free Press ‘Indispensable to Democracy’,0,3,7,37,4,7,0,44,0
British Minister Is Suspended in Expense Inquiry,0,1,6,36,0,6,0,42,0
Nintendo Wii sales decrease in Japan,0,1,3,28,0,5,0,31,0
"The terror and glory of a Game 6, which has Rangers desperate",0,2,3,45,1,11,1,48,0
"Trump now considering more than four for secretary of state, Conway says",0,3,2,58,1,11,0,60,0
Jon Gruden Comments on Interest in Coaching Amid Rumors Surrounding the Rams,0,2,9,56,0,11,0,65,0
Canada’s Foreign Minister Voices Concerns Over U.S. Trade Proposals ,0,3,10,46,3,9,0,56,0
Saudi Arabia fears Hajj swine flu outbreak as four pilgrims die,0,1,3,50,0,10,0,53,0
Republican aide fired for trying to hire hackers to raise his GPA,0,1,4,50,0,11,0,54,0
Stephen Colbert to Host the 2017 Emmy Awards ,0,2,5,28,0,8,4,33,0
"Inspired By An MBA Project, This Woman Created India's Largest Pre-School And Daycare Chain",0,3,17,58,3,13,0,75,0
Dutch member of Parliament proposes to abolish the Cabinet,0,1,3,47,0,8,0,50,0
Death Threats Aimed at K-Pop Band BTS Prompt Security Alert for US Tour,0,3,15,43,1,12,0,58,0
"Canadian gasoline tops $1 a litre, politicians consider options",0,1,1,51,2,8,1,52,0
"Israeli president shakes hands with leaders of Syria, Iran at Pope's funeral",0,1,4,59,2,11,0,63,0
Fallout over Philadelphia's soda tax bubbles up,0,3,2,38,1,6,0,40,0
"Giving Back, by Backpack",0,1,3,17,1,3,0,20,0
"Why synthetic marijuana like K2 or Spice can cause ""really bizarre"" symptoms",0,2,3,59,2,11,1,62,0
Study Reveals Changes Among Second-Generation Hispanics,0,1,7,42,1,5,0,49,0
'Mario Kart 8 Deluxe' might resurrect Battle Mode for the Nintendo Switch,0,3,7,52,2,11,1,59,0
Crisis Underscores Need to Save for a Rainy Day,0,1,6,33,0,8,0,39,0
New rocky planet discovered in orbit around nearby star,0,1,1,46,0,8,0,47,0
US sanctions 271 Syrian government workers after chemical attack ,0,3,3,50,0,9,3,53,0
NASCAR: Edwards wins 2010 Kobalt Tools 500,0,1,9,19,1,6,7,28,0
Czech Ministry Suffered Cyber-Attack Possibly From Foreign State,0,3,9,47,1,7,0,56,0
The Situation RoomVerifizierter Account,0,3,5,31,0,3,0,36,0
Red colored EU passports worry Lithuanian politicians,0,1,4,43,0,6,0,47,0
14 Things We Learned From Caitlyn Jenner’s ‘20/20’ Interview [Video],0,3,8,39,6,9,6,47,0
UK storms predicted amid hot spell,0,2,2,27,0,5,0,29,0
Woman falls to her feath inside World Trade Center Oculus ,0,3,5,43,0,10,0,48,0
The Republican-Democrat Divide Extends To Hats And Prepaid Cellphones,0,2,10,50,1,8,0,60,0
The Terrible Hollowness of “Ghost in the Shell”,0,3,5,33,2,7,0,38,0
Chevron pipeline in Nigeria attacked by gunmen,0,1,2,38,0,6,0,40,0
"UN hides facts about war in Sri Lanka, says French Le Monde",0,1,7,40,1,11,0,47,0
"Governing, not Elections, Is Europe’s Big 2017 Challenge",0,3,6,36,3,7,4,42,0
Nettles and other 'thuggish' plants forcing out endangered wildflowers ,0,3,1,59,2,9,0,60,0
U.S. Opens Inquiry Into Google Books Deal,0,1,8,25,2,6,0,33,0
Racial Attacks On Africans To Be Taken To UN Human Rights Council + 5 Must Read Stories,0,3,16,53,1,16,1,69,0
Pharrell And Celebs Put on the Ritz With Chanel In Paris,0,3,9,37,0,10,0,46,0
"Honors for a President, but Not Without Debate",0,1,5,33,1,7,0,38,0
"'Have them all shot': BBC gets 21,000+ complaints over Jeremy Clarkson's public sector striker comments",0,1,6,72,6,14,5,78,0
48th International Children's Festival in Šibenik - 2008,0,1,4,37,2,7,6,41,0
Refugees in Kenya hit by US travel ban after years of waiting for asylum,0,2,4,55,0,13,0,59,0
An iPhone Upgrade to Counter the Naysayers,0,1,5,31,0,6,0,36,0
DJ Khaled Tries to Impress Audience With Basketball Skills at Antonio Brown Celebrity Game,0,2,13,64,0,13,0,77,0
"Run the Refinancing Numbers, Then Run Them Again",0,1,7,33,1,7,0,40,0
Vance Joseph Hired as Broncos' Head Coach,0,3,6,28,1,6,0,34,0
Doe and her unborn baby injured by a car are saved by rescuers,0,3,1,49,0,12,0,50,0
North Korea conducts test of nuclear weapon,0,1,2,35,0,6,0,37,0
"Governing Party, Facing Challenge, Moves Left in South Africa",0,1,8,43,2,8,0,51,0
"Disney boss drops hot new details on Han Solo, Luke Skywalker",0,3,5,45,1,10,0,50,0
Shakira & Maluma's 'Chantaje' Reaches 1 Billion Views on YouTube,0,3,8,42,4,9,1,50,0
Jailed British-Iranian woman 'dreams of watching daughter play',0,3,3,50,3,7,0,53,0
"Nearly 100,000 protest for closure of US military base in Japan",0,1,4,42,1,10,6,46,0
10 Ugly Holiday Sweaters You Can Wear to Your Next Party,0,3,9,35,0,10,2,44,0
First executions in post-Saddam Iraq held in Baghdad,0,1,4,40,1,7,0,44,0
'Molester' YouTuber who kissed unknown girls on the streets to make 'prank' videos now faces jail,0,3,3,75,4,15,0,78,0
Pepsi pulls Kendall Jenner advert amid outcry,0,2,3,36,0,6,0,39,0
"One Moran Helps Another, in Race for Virginia Governor",0,1,7,38,1,8,0,45,0
Justin Jackson Has the North Carolina Brotherhood on the Brink of a Championship,0,3,8,60,0,12,0,68,0
Bombing Near Shiite Place of Worship Kills 22 in NW Pakistan ,0,2,9,39,0,11,2,48,0
Turkish terrorism watch list includes over 400 suspected Australian jihadists,0,3,2,63,0,9,3,65,0
Brand Names Live On After the Stores Are Closed,0,1,8,31,0,8,0,39,0
First Case Of Someone On Daily PrEP Getting HIV,0,2,13,26,0,8,0,39,0
British Spies Tapped King Edward’s Phone to Eavesdrop on Wallis Simpson Calls,0,3,10,55,1,11,0,65,0
Consumer Prices Remained Steady in April,0,1,5,30,0,5,0,35,0
Is Selena Gomez Back in the Studio? See the New Pic That Has Fans (and Nick Jonas) Buzzing!,0,2,14,56,4,17,0,70,0
Company Will Raise $1 Billion To Create Blood Test To Detect Cancer,0,3,11,43,1,11,1,54,0
Why High School Students Need More Than College Prep,0,2,9,35,0,8,0,44,0
Dennis Hastert pleads not guilty on all counts,0,2,2,37,0,7,0,39,0
FBI Director James Comey was 'incredulous' over Trump's tweets,0,3,7,44,3,8,0,51,0
Getting 50-Somethings to Pay for Streaming Music,0,2,5,34,1,6,2,39,0
Gorsuch faces questions in Supreme Court hearing's second day: Watch live ,0,3,4,57,2,11,0,61,0
Air Force Cautions Trump Team on Defense Costs ,0,2,7,32,0,8,0,39,0
Venezuela bans Coke Zero over unspecified health problems,0,1,3,47,0,7,0,50,0
PaycomVoice: Honoring Women in Business,0,3,5,29,1,4,0,34,0
Andre Johnson Breaks Down Crying During NFL Retirement Speech,0,2,11,42,0,8,0,53,0
What’s New in the West Bank? Blessed Outposts and Donald Trump,0,2,8,42,2,10,0,50,0
"Witnesses saw truck ""rev up and race"" before recent Texas oil refinery blast",0,1,2,60,2,12,0,62,0
The Land That GM Forgot,0,3,6,13,0,4,0,19,0
"Trump Said Not To Believe The Jobless Rate. Sadly For Him, People Don’t.",0,3,13,43,4,12,0,56,0
Echoes of Watergate resurface as Trump-Russia links probed,0,3,4,46,1,7,0,50,0
"SAG Leader, in Shift, No Longer Seeks Strike Vote",0,1,10,29,2,8,0,39,0
US nationals arrested for alleged abduction of Haitian children,0,1,3,52,0,8,0,55,0
Aides for Donald Trump and Hillary Clinton Start Shouting Match in Post-Election Forum,0,2,11,62,1,12,0,73,0
Terry Stotts 'can't tolerate' George Karl blaming Damian Lillard for Blazers' woes,0,3,7,60,4,11,0,67,0
Over 400 Militants Surrender In Pakistan's Balochistan Province That Is Seeking Independence,0,2,11,66,1,11,3,77,0
Hundreds of Companies Raise Their Hands to Build Trump’s Border Wall,0,3,9,48,1,10,0,57,0
The Westminster attack shows the new challenges facing UK counter-terrorism,0,3,4,61,1,9,0,65,0
Twitter Loses It Over Report Rex Tillerson Doesn't Allow Eye Contact,0,3,11,46,1,10,0,57,0
'Great chemistry': Trump abandons China criticism as Russia ties suffer,0,2,4,55,3,9,0,59,0
Hamas ends truce with Israel,0,1,2,22,0,4,0,24,0
'CS:GO' pro kicked off team after complaining about players' rights,0,2,4,50,4,9,0,54,0
UK judge clears policeman of fraud during London bomb probe,0,1,3,47,0,9,0,50,0
Golf and rugby set to return to the Olympic Games,0,1,3,37,0,9,0,40,0
How kitty litter has helped Wyoming through drilling slump,0,3,2,48,0,8,0,50,0
The Best Two Days in Sports,0,1,5,17,0,5,0,22,0
O.J. Simpson named suspect in robbery,0,1,3,27,2,5,0,30,0
Cancer Pill Gleevec Keeps Patients Alive and Well for a Decade,0,3,8,44,0,10,0,52,0
Montreal restaurant Marche Ferdous warms hearts with free meals policy,0,3,3,58,0,9,0,61,0
Porsche Introduces a Luxury Sedan to the  Chinese Market,0,1,6,41,0,9,0,47,0
Slain NYC Jogger's Best Friend Says 'Stop Feeling Sad' for Murder Suspect ,0,3,13,46,3,12,0,59,0
"Hong Kong's recession ends, economy grows 3.3%",0,1,2,32,4,6,2,34,0
First signs of recovery from horse flu outbreak,0,1,1,39,0,7,0,40,0
One-time DACA recipient deported as Homeland Security disputes status ,0,2,7,53,1,9,0,60,0
Evgeny Adamov will be extradited to Russia,0,1,3,33,0,6,0,36,0
Ichiro Suzuki Delivers Memorable Conclusion to W.B.C.,0,1,8,36,3,6,0,44,0
Barclays Net Profit Tumbles on Africa Write-Down ,0,3,7,34,1,7,0,41,0
"North Korea: China needs to put pressure on rogue state, Malcolm Turnbull says",0,3,5,59,2,12,0,64,0
Government of the Bahamas isssues warning over Hurricane Hanna,0,1,4,50,0,8,0,54,0
McDonald's Worker Jumps Through Drive-Thru In Attempt To Save Woman's Life,0,2,13,48,3,10,0,61,0
Kerry Laments Lack of Progress on Trump Transition at State,0,3,7,43,0,9,0,50,0
"Beyonce Shows Off Maternity Style, Baby Bump on Instagram",0,3,8,40,1,8,0,48,0
NZ Government passes bill to legalise controversial electioneering overspending,0,1,3,68,0,8,0,71,0
Exclusive report on New Zealand's digital TV service,0,1,5,39,1,7,0,44,0
"Banks Have Raised Billions Since Test, Geithner Says",0,1,8,36,1,7,0,44,0
Internet warriors: inside the dark world of online 'trolls',0,3,1,47,3,8,0,48,0
The Oscars red carpet was its own live action 'Beauty and the Beast',0,3,4,50,2,12,0,54,0
Luxembourg head of government resigns after eighteen years,0,1,1,50,0,7,0,51,0
Faith Hill and Carrie Underwood Twin in Red at 2017 Grammy Awards,0,2,8,42,0,11,4,50,0
Iran says it's ready for standoff over nuclear activities,0,1,1,47,1,8,0,48,0
Viscount Rothermere: a media baron who keeps his distance,0,3,2,46,1,8,0,48,0
Faith Hill & Tim McGraw Weigh In on Fellow Famous Musical Couples,0,3,11,42,1,11,0,53,0
Big Sean Receives the Key to Detroit,0,2,5,25,0,6,0,30,0
US Air Force fighter jets escorted an American Airlines plane into Hawaii after a passenger disturbance,0,2,7,81,0,15,0,88,0
Russia voids border treaty with Estonia,0,1,2,32,0,5,0,34,0
"Binge-drinking women depicted as 'helpless, immoral' in media, study finds",0,3,1,59,5,9,0,60,0
Black Hole Caught Devouring Star For An Entire Decade,0,2,9,36,0,8,0,45,0
U.S. Markets Spend the Day Treading Water,0,1,7,26,2,6,0,33,0
Brexit is an opportunity to reverse the tragic decline of marriage in Britain,0,3,2,63,0,12,0,65,0
"Steelers, Cardinals win championship games to advance to Super Bowl XLIII",0,1,9,53,1,10,0,62,0
"Twenty One Pilots Reimagine 5 Songs With Mutemath for Live Video, Free EP: Watch",0,3,13,51,2,13,1,64,0
United Airlines in Twitter trouble over dress code rules,0,2,3,45,0,8,0,48,0
Federal judge in Hawaii extends block on Trump travel ban,0,3,3,45,0,9,0,48,0
Football: Wigan 1-3 Bolton Wanderers,0,1,4,24,2,4,2,28,0
Mississippi church member charged in 'Vote Trump' arson  ,0,2,3,43,2,9,0,46,0
J.C. Penney Postpones Store Closures Amid ‘Better-Than-Expected’ Customer Traffic,0,3,12,55,6,8,0,67,0
Trump’s tax plan: massive cuts for the 1% will usher ’era of dynastic wealth’,0,2,1,57,5,13,1,58,0
Tencent Apologizes for Sexually Graphic Game at Annual Party,0,3,7,45,0,8,0,52,0
Berlin Christmas market attacker Anis Amri used 14 different identities after coming to Germany in 2015 ,0,3,5,77,0,16,6,82,0
Bears Fans React in Disgust After Team Moves Up to Draft QB Mitchell Trubisky,0,3,13,51,0,13,0,64,0
J. Crew Flounders in Fashion’s Shifting Tides ,0,3,6,31,2,7,0,37,0
Clemson shocks Alabama to win first national title in 35 years,0,3,2,48,0,10,2,50,0
"Custody of Saddam Hussein given to Iraq, to be executed 'today or tomorrow'",0,1,4,56,3,12,0,60,0
'Life is winning': Pence fired up March for Life crowd ,0,2,4,38,3,10,0,42,0
Get to Know Rising K-Pop Band ASTRO: Exclusive Video Interview,0,3,14,37,2,9,0,51,0
Historian Richard Milner Performs the Humor in Darwin,0,1,6,40,0,7,0,46,0
Protesters rally in Beirut,0,1,2,21,0,3,0,23,0
Apple’s Next iPhone Will Have a Curved Screen ,0,3,7,30,1,8,0,37,0
AG Sessions: I Would 'Plead' With Maryland Not to Become a Sanctuary State  Insider,0,3,13,53,3,14,0,66,0
Britain is in chaos – and now the Tories may destroy the union,0,2,2,47,1,12,0,49,0
Harriet Harman: I should have run for Labour leadership in 2010,0,3,4,44,1,10,4,48,0
Venezuelan regional elections both a win for supporters and opponents,0,1,1,59,0,9,0,60,0
The United States Just Dropped the Biggest Non-Nuclear Bomb in Existence on Afghanistan,0,3,11,63,1,12,0,74,0
Discovery docks with International Space Station,0,1,4,39,0,5,0,43,0
Freed Chibok girls return home for joyful Christmas,0,3,3,41,0,7,0,44,0
"This Couple Did A ""La La Land"" Engagement Shoot And It’s Pretty Cute",0,3,13,40,3,12,0,53,0
Debenhams apologises to homeless man for Boxing Day drenching,0,2,3,50,0,8,0,53,0
US Student reveals book visit a hoax,0,1,3,27,0,6,0,30,0
Lesnar Defends His U.F.C. Title,0,1,7,17,3,4,0,24,0
"New Michael Brown video does not change outcome, some experts say ",0,3,3,51,1,11,0,54,0
Jeb Bush Stresses Military Might in Europe,0,3,6,30,0,6,0,36,0
No love for Tom Hanks or Amy Adams? See the biggest Oscar snubs and surprises,0,2,7,55,1,14,0,62,0
BBC crew attacked in China and forced to sign confession,0,3,4,43,0,9,0,47,0
Could Donald Trump’s ‘junta’ be his salvation?,0,2,3,33,4,6,0,36,0
Thousands of academics sign letter opposing Trump's travel ban,0,3,2,51,1,8,0,53,0
Tomi Lahren Asks Glenn Beck and The Blaze to 'Let Me Move On',0,2,11,36,2,12,0,47,0
Mother of Waco Sect Leader Is Fatally Stabbed,0,1,7,31,0,7,0,38,0
Congo Refugee Rebuilds His Life in Connecticut ,0,2,6,34,0,7,0,40,0
N.F.L. Draft: Analysis of Every Pick in Round 1 ,0,2,8,26,4,9,1,34,0
Skateboarding in Afghanistan Provides a Diversion From Desolation,0,1,6,52,0,7,0,58,0
"Missing Nottingham mother poses 'risk of harm' to sons, court says",0,3,2,51,3,10,0,53,0
"For Traveling Mothers, Hurdles in Pumping Breast Milk",0,1,7,38,1,7,0,45,0
AG Jeff Sessions Unveils Program to Accelerate Deportation of Imprisoned Illegals - Breitbart,0,2,11,69,1,12,0,80,0
"To Sleep, Perchance to Analyze Data",0,1,5,24,1,5,0,29,0
Samsung DeX gadget transforms the Galaxy S8 into a PC,0,2,7,36,0,9,1,43,0
Depression Strikes Today’s Teen Girls Especially Hard,0,2,7,39,1,6,0,46,0
House Backs Ban on Primate Sales,0,1,5,22,0,5,0,27,0
Strictly Come Dancing 2016: Everything to know about the live final,0,3,4,48,1,10,4,52,0
"Government of Canada okays WIND Mobile launch, overturning CRTC decision",0,1,11,51,1,9,0,62,0
"New Day, weekdays 6-9am ET Tim Kaine: Trump's talk with allies 'amateur hour'",0,3,7,50,6,12,2,57,0
Dazzling color postcards of the cities and countryside of the 1890s Netherlands,0,3,2,62,0,11,4,64,0
Can Tom Price save Republicans from their Obamacare mess?,0,2,5,43,1,8,0,48,0
Selena Gomez Style: Her Fashion Evolution,0,2,6,29,1,5,0,35,0
Former Press Secretaries Say Donald Trump's Relationship With Journalists Will Be Unprecedented,0,3,12,71,1,11,0,83,0
Prison Worker Joyce Mitchell Planned to Be Getaway Driver: Sources,0,2,9,47,1,9,0,56,0
Philippines ties highlight Donald Trump's global conflicts of interest,0,3,3,58,1,8,0,61,0
"As Others Run Out of Fuel, Martin Wins LifeLock 400 at Michigan",0,1,10,38,1,11,3,48,0
Trump’s Dual Roles Collide With Openings in Dubai and Vancouver ,0,3,8,45,1,10,0,53,0
"22-Year-Old Paid $1,100 to Have Her Ears Reshaped Like an Elf’s",0,3,9,33,5,10,6,42,0
"Terry Teen, 1960s Rockabilly artist, injured in collision",0,1,3,41,2,7,4,44,0
"UEFA Cup: April 3rd, 2008",0,1,6,8,2,4,5,14,0
"Mermaid, vampire and zombie emoji are coming to your iPhone in 2017",0,3,2,49,1,11,4,51,0
US Senate passes stimulus package,0,1,3,26,0,4,0,29,0
Trump Proposal Would Deport More Immigrants Immediately ,0,3,7,42,0,7,0,49,0
"Zach Orr Retires Due to Injury: Latest Details, Comments and Reaction",0,3,9,48,2,10,0,57,0
"Thanks to Her 'Love Story,' Gwen Stefani Is the New Face of Revlon",0,2,10,41,3,12,0,51,0
Five Things You Need to Know to Start Your Day,0,3,8,29,0,9,0,37,0
Section 18C: Political debate prompts Australians to share their experiences with racism,0,3,4,70,1,11,2,74,0
Trump Signs Another Executive Order to Further Slash Regulations,0,3,8,48,0,8,0,56,0
Aleppo under bombardment,0,3,1,21,0,2,0,22,0
Surgeon claiming he will transplant volunteer's HEAD to another body says he needs America's help to do it,0,3,6,81,2,17,0,87,0
England remembers Bobby Robson,0,1,3,24,0,3,0,27,0
Don't Let the Oscar F**k Up Overshadow 'Moonlight's' Historic Moment,0,3,9,44,6,9,0,53,0
SunTrustVoice: 5 Things To Know About Getting An Accurate Business Valuation,0,3,12,52,1,10,1,64,0
Selena Gomez Sings and Dances in New Studio Clips: Watch,0,3,8,38,1,9,0,46,0
"James Corden taking ""Late Late Show"" to U.K. in June",0,3,8,31,4,9,0,39,0
Scientists recreating the 1918 flu virus say 'it came from birds',0,1,1,48,2,10,4,49,0
Czech Ministry Suffered Cyber-Attack Possibly From Foreign State,0,2,9,47,1,7,0,56,0
Why Republican candidates should want to be shut out of debates,0,2,2,51,0,10,0,53,0
Proposal to Raise Income Tax in Pennsylvania,0,1,5,33,0,6,0,38,0
"How actor Dev Patel spent eight months preparing for ""Lion""",0,3,4,44,2,9,0,48,0
"Week 14 fantasy football inactives watch: Who's in, and who's out?",0,2,2,47,5,10,2,49,0
Football: FA charges Chelsea for player misconduct; John Terry investigated over alleged racial abuse,0,1,6,80,2,13,0,86,0
UMG's Deal With Spotify: How Grainge and Ek (Finally) Got It Done,0,2,13,37,4,11,0,50,0
"Ben Affleck Says He's Not Directing 'The Batman,' Surprising Nobody",0,3,10,44,4,9,0,54,0
Julie Ditty wins ColemanVision Tennis Championship,0,1,6,39,0,5,0,45,0
"Trump calls for lower drug prices, fewer regulations in meeting with pharmaceutical executives",0,2,1,80,1,12,0,81,0
"Fuse of Fear, Lit in China, Has Victims on 2 Sides",0,1,7,30,2,10,1,37,0
The Atlantic Politics & Policy Daily: A Nation at Half-Staff,0,2,9,39,3,9,0,48,0
Government is guilty of dereliction of duty on social care funding,0,2,1,55,0,10,0,56,0
Kellyanne Conway Defends Trump's Twitter Use As A 'Free' Way To Share Information,0,2,13,53,3,12,0,66,0
Toughest UN sanctions yet to cost North Korea $800 million,0,3,5,40,1,9,3,45,0
Bird-Flu Outbreak Brings Pain for Poultry Producers in Asia,0,3,8,42,1,8,0,50,0
"Protests, Violence Flare Around Inaugural Ceremony",0,3,6,38,1,5,0,44,0
Police who shot dead father of two on M62 found gun in his car,0,2,2,45,0,13,2,47,0
Donald Trump is 2nd president to laud unfinished Intel plant,0,3,3,47,0,9,1,50,0
31 Earrings That Are Cheap AF For People Who Always Lose Theirs,0,3,12,38,0,11,2,50,0
€8bn bank bailout in Ireland,0,1,1,21,1,4,1,22,0
Woman Gives Birth Amid Tornado Destruction in Tennessee - Yahoo,0,2,8,45,1,9,0,53,0
Toni Erdmann review – talk about embarrassing parents…,0,2,2,43,2,7,0,45,0
No. 7 Blue Devils Top No. 13 Lady Vols in Knoxville,0,1,8,28,2,10,3,36,0
Nancy Pelosi calls Steve Bannon a ‘white supremacist’ [Video],0,3,5,44,4,8,0,49,0
Aaron Hernandez's Family Could End Up Making Millions of Dollars as a Result of His Death,0,3,12,61,1,15,0,73,0
"Shania Twain Announces New Single 'Life's About to Get Good,' First Album in 15 Years",0,3,12,53,4,14,2,65,0
Fox News Host Jesse Watters Announces Vacation Amid Ivanka Trump Comments,0,3,11,52,0,10,0,63,0
"Self-made millionaire: If you want to get rich, start working 95 hours a week",0,2,2,57,3,13,2,59,0
Tiwi Plantations Corporation denies it is on verge of collapse and unable to repay debts,0,3,3,71,0,14,0,74,0
A Series of Unfortunate Events: Count Olaf reveals all in a hilarious new interview,0,3,6,63,1,13,0,69,0
13-year-old boy dies of suspected heroin overdose,0,3,0,39,2,6,2,39,0
Hiring Hurdle: Finding Workers Who Can Pass a Drug Test - The New York Times,0,2,13,47,2,14,0,60,0
Bill Snyder expected to attend K-State spring practice despite throat cancer diagnosis,0,3,4,70,1,11,0,74,0
Wall St. Lending to Main St. Even as Many Decry Dodd-Frank ,0,2,10,35,3,11,0,45,0
Barack Obama Designates 3 Civil Rights Monuments To Preserve 'Vibrant History',0,3,10,55,2,10,1,65,0
"Fearing Wildfires, Utility Plans Power Shutdowns",0,1,6,36,1,5,0,42,0
This smart billboard coughs if you smoke near it,0,3,1,39,0,8,0,40,0
My wife seems closer amid the noise of Christmas,0,3,2,38,0,8,0,40,0
CanadaVOTES: NDP incumbent David Christopherson running in Hamilton Centre,0,1,13,52,1,8,0,65,0
Class-Action Suit Filed in Chinese Milk Scandal,0,1,7,33,1,6,0,40,0
The Internet of Everything â $12.6 trillion ROI expected over the next decade [SLIDE DECK],0,3,15,54,6,14,3,69,0
Female Scientists Share ‘Distractingly Sexy’ Photos to Fight Sexism [Video],0,2,9,53,4,9,0,62,0
Brain cancer survivor running 7 marathons on 7 continents in 7 days,0,3,1,52,0,11,3,53,0
"People Are Thanking George Michael For Proving ""There’s No One Right Way To Be A Man""",0,3,16,51,3,15,0,67,0
"Horse racing in NSW, Queensland cancelled indefinitely",0,1,5,42,1,6,0,47,0
Golden Globes 2017: La La Land sweeps awards,0,3,5,27,1,7,4,32,0
Japan Avalanche Kills 8 Teenage Mountaineers on School Trip ,0,3,7,43,0,9,1,50,0
"Pinned to the ground, a Florida deputy begged a passerby to shoot his attacker",0,3,2,62,1,13,0,64,0
Rabobank Contacted by Doping Investigators,0,1,4,34,0,4,0,38,0
Columbia Moves a Game Behind First Place in the Ivy,0,1,7,35,0,9,0,42,0
Preet Bharara Is Said to Refuse Order to Step Down as U.S. Attorney ,0,3,11,42,2,13,0,53,0
U.S. Appetite for Organic Food Prompts Jump in Grain Imports; Farmers Cry Foul,0,3,12,51,3,12,0,63,0
"After Pre-Election Surge, Apprehensions at Southern Border Hit Five-Year Low",0,3,11,53,3,9,0,64,0
Taliban bombing in Kabul supermarket leaves eight dead,0,1,2,45,0,7,0,47,0
"Bob Dylan to Release New Three-Disc Album, 'Triplicate'",0,2,8,36,4,7,0,44,0
Melania Trump Defamation Suit Against Political Blogger Can Move Forward,0,2,10,53,0,9,0,63,0
Matt Miller's Scouting Notebook: Latest Pro Day Buzz and Updated 2017 Mock Draft,0,2,11,51,2,12,4,62,0
John Key resigns: What's next for New Zealand politics?,0,3,5,39,3,8,0,44,0
Netmarble Looks Set to Score South Korea’s Biggest IPO Since 2010 ,0,3,11,39,1,11,4,50,0
Involtini Recipe - NYT Cooking,0,3,6,19,1,4,0,25,0
Billboard 200 Chart Moves: Prince's '4Ever' Marks Late Icon's 40th Charting Album,0,3,10,49,5,11,6,59,0
DE Myles Garrett says he won't attend NFL draft in Philadelphia,0,3,8,44,1,10,0,52,0
"BuzzFeed Posts Unverified Claims on Trump, Igniting a Debate ",0,3,8,43,1,9,0,51,0
The Cool Kids on Kanye West's Influence: 'Ain’t Nobody Played Lil Yachty' Before Yeezy Season 3,0,3,14,60,5,15,1,74,0
Boy battling leukaemia conducts orchestra,0,2,1,36,0,4,0,37,0
Boy killed by shark in Australia,0,1,2,25,0,5,0,27,0
Massive power failure hits Brazil,0,1,2,27,0,4,0,29,0
Smoking causes 1 in 10 deaths across the world: 6.4 million lives lost each year as a result of the bad habit,0,3,1,80,2,21,5,81,0
People Aren’t Happy About This Karlie Kloss ‘Geisha’-Themed Shoot,0,3,10,43,4,8,0,53,0
"2015 NBA Playoffs -- Cleveland Cavaliers, J.R. Smith need each other",0,3,9,40,5,10,4,49,0
"After a Decade Of Service, Mumbai Airport Says Goodbye To Its Canine Cops",0,2,12,48,1,12,0,60,0
"This Teen Admitted She Made Up Claims She Was Abducted And Raped By ""Three Black Males""",0,3,16,54,2,15,0,70,0
"Women cheat on men who don't do house chores, French survey finds",0,3,2,50,2,11,0,52,0
Leftist Party Wins Salvadoran Vote,0,1,5,25,0,4,0,30,0
Is your library under threat? Share your experiences with us,0,3,2,48,1,9,0,50,0
Poem celebrating Donald Trump's inauguration describes Barack Obama as a 'tyrant',0,2,5,63,3,10,0,68,0
Romania may soon name a little-known woman as the E.U.’s first Muslim prime minister,0,2,4,63,4,13,0,67,0
Four million California voters live in neighborhoods that backed Clinton 3 to 1,0,3,3,62,0,12,2,65,0
‘We Have to Do More’: Defense Secretary Carter on PTSD in Wake of Airport Shooting,0,3,14,51,3,14,0,65,0
Turkey wants to ’cleanse’ strip of territory on Syrian border,0,2,2,48,2,9,0,50,0
FedEx driver handles jackknifed big rig like a boss,0,2,2,41,0,8,0,43,0
Woman dies when pet camel tries to mate with her,0,1,1,38,0,9,0,39,0
Melbourne train operator Metro investigating contractor accused of underpaying guards,0,3,2,74,0,9,0,76,0
Beijing Investigates Transplants for Tourists,0,1,4,37,0,4,0,41,0
"‘Islamophobia’ Is Still Not the Problem: In Kansas, Another Case Study",0,2,10,46,4,10,0,56,0
Yoko Ono Tweets 'Still Miss Him' on Anniversary of John Lennon's Murder ,0,3,10,47,3,12,0,57,0
"Truck crashes into British Columbia wedding party, killing six",0,1,3,50,1,8,0,53,0
Michael Vick says he's retired after not playing 2016 season,0,3,2,44,1,9,4,46,0
Steve Harvey Absolutely Destroyed on Social Media After Meeting With Trump,0,3,10,54,0,10,0,64,0
Here's How Scott Van Pelt Paid Tribute to Laid-Off ESPN Employees on 'SportsCenter',0,3,16,51,4,12,0,67,0
The price of admission to the press: You can't riot while you're working and expect your pass to protect you ,0,2,2,84,3,20,0,86,0
"How Americans Think About Climate Change, in Six Maps ",0,3,8,36,1,9,0,44,0
"North Korean Missile Launch Fails, and a Show of Strength Fizzles ",0,3,8,46,1,11,0,54,0
"Essence magazine to honor ""Hollywood's next generation"" of black women",0,3,2,56,3,9,0,58,0
"Trump, CIA on collision course over Russia’s role in U.S. election",0,3,7,45,4,10,0,52,0
Egypt's Sisi declares state of emergency after church attacks,0,2,2,50,1,8,0,52,0
Moanas in real life: Samoan man teaches his daughters traditional Pacific voyaging skills,0,2,3,73,1,12,0,76,0
"Endangered Species and the Stuff We Buy, All Mapped Out ",0,3,8,37,1,10,0,45,0
Syria: Al Qaeda-linked group claims responsibility for Damascus attacks,0,3,4,57,2,8,0,61,0
Ray Buckley Drops Out Of DNC Chair Race And Endorses Keith Ellison,0,3,14,41,0,11,0,55,0
"Air strike hits Syrian market, opposition says truce must be respected",0,2,2,57,1,10,0,59,0
Sessions emphasizes the primacy of the law over his political views,0,3,1,56,0,10,0,57,0
Industrial Output Declines for a 4th Month,0,1,4,31,0,6,1,35,0
"Somali pirates release Greek ship, 19 sailors",0,1,2,34,1,6,2,36,0
100 million records sold: George Michael's top 10 songs,0,3,2,38,2,8,5,40,0
‘They brought me back from death’: How a woman survived six days without lungs,0,3,2,60,3,13,0,62,0
Philadelphia's Mummers undergo sensitivity training before parade ,0,2,2,56,1,7,0,58,0
Great Leaders Don't Speak Ill Of Their Predecessors,0,2,8,35,1,7,0,43,0
Levee Break Causes Long-Lasting Trouble in Nevada,0,1,7,35,1,6,0,42,0
China’s Upset Soccer Win Over South Korea Averts Fan Unrest,0,2,10,39,1,9,0,49,0
Trump’s Trade Rep Pick Gets Some Actual Praise From Progressives,0,3,10,44,1,9,0,54,0
British spies removed from operations after Russia and China crack codes to leaked Snowden files,0,2,4,78,0,14,0,82,0
China's military spending increases by 7.5%,0,1,1,32,3,5,2,33,0
"Who should direct Donald Trump: the Movie? Step forward, Werner Herzog",0,2,7,50,3,10,0,57,0
Bush calls for expanding Federal authority,0,1,2,35,0,5,0,37,0
Miami Hurricanes Defensive End Chad Thomas Produces Song for New Rick Ross Album,0,3,12,56,0,12,0,68,0
Philippines Senate and House of Representatives to probe ‘P50-million drug bribe mess’,0,1,5,65,3,11,2,70,0
Colbert’s Ratings Surge: Why Aggressive Political Humor Is Paying Off [Video],0,3,11,52,4,10,0,63,0
A Rapidly Expanding Snapchat Is Angering Its Neighbors in L.A.,0,3,10,41,2,9,0,51,0
"Ban on Head Scarves at Work Is Legal, E.U. Court Rules ",0,3,10,31,3,11,0,41,0
Trampoline park injuries trigger hundreds of ambulance call-outs,0,3,1,55,1,7,0,56,0
"World Anti-Doping Agency Report Implicates at Least 1,000 Russian Athletes in Scandal",0,2,10,58,2,11,4,68,0
Here's a twist: M. Night Shyamalan is king of the box office again,0,2,4,47,3,12,0,51,0
The Stimulus Plan: Beaker-Ready Projects? Colleges Have Quite a Few,0,1,10,45,3,9,0,55,0
"6.5 magnitude earthquake hits Acre, Brazil",0,1,2,31,2,5,2,33,0
Nine Killed as Tornado Rakes Oklahoma,0,1,5,27,0,5,0,32,0
Le Pen Says All French Banks Have Refused to Meet With Her,0,3,11,36,0,11,0,47,0
"Right before they gave up, investigators figured out where to look for MH370",0,2,3,57,1,12,3,60,0
Speaker Ryan defends CBO estimate the 24M would lose insurance by 2026,0,2,6,47,0,11,6,53,0
Troian Bellisario And Patrick J. Adams Got Married,0,3,8,34,1,7,0,42,0
"Bad Economy Leads Patients To Put Off Surgery, or Rush It",0,1,10,36,1,10,0,46,0
United Nations passes Declaration on human cloning,0,1,3,41,0,6,0,44,0
"Exclusive: Corey Lewandowski Escorted Out of Trump Tower, Out of Trump Campaign - Breitbart",0,2,11,64,3,13,0,75,0
World-Beater Status at Risk as India Rebuts Threat to Growth,0,2,8,42,1,9,0,50,0
"Schumer, Pelosi among Democrats to react to Syria strike ",0,3,4,43,1,9,0,47,0
Anti-immigrant One Nation party shunned in Western Australia poll ,0,3,5,51,1,9,0,56,0
Scarlett Johansson's 'SNL' Monologue Highlights How Many Times She's Hosted,0,3,12,50,4,9,0,62,0
Air France to launch new daily flight from Paris to Bucharest,0,1,4,47,0,10,0,51,0
Winter is coming,0,2,1,13,0,2,0,14,0
"Leery of Debt, Germany Shuns a Spending Spree",0,1,6,31,1,7,0,37,0
Audrey Hepburn photos to go on display in London,0,3,3,37,0,8,0,40,0
"John Carroll, Editor Who Reinvigorated The Los Angeles Times, Is Dead at 73 ",0,3,11,48,2,13,2,59,0
Khizr Khan and the Media’s Donald Duck Hunting,0,2,6,32,1,7,0,38,0
Full video of Tigger incident reveals different story,0,1,2,44,0,7,0,46,0
Footage shows people fleeing Stockholm truck crash scene,0,3,2,47,0,7,0,49,0
"Netanyahu Urges Pope Benedict, in Israel, to Denounce Iran",0,1,7,41,2,8,0,48,0
Furry fans flock to Further Confusion 2007,0,1,3,29,0,6,4,32,0
North Carolina governor-elect says lawmakers will call session to repeal bathroom bill,0,3,2,72,1,11,0,74,0
"Southern Sudanese, Delivering Aid, Are Killed in Ambush",0,1,7,39,2,7,0,46,0
Hhgregg is closing 88 stores that aren't profitable due to the collapse of physical retail,0,3,1,72,1,14,2,73,0
Turbines on the Tundra,0,1,2,17,0,3,0,19,0
"Russian troops advance into Georgia, violating truce",0,1,2,43,1,6,0,45,0
Fraud Victims Want Maximum for Madoff,0,1,5,27,0,5,0,32,0
"Commuting To Gurugram Just Became A Nightmare, Haryana Govt. Introduces New Tax On Cabs",0,3,14,58,2,13,0,72,0
Interscope Blankets L.A. Bus Stops With Ads Celebrating Steve Berman's 25th Year at Label,0,3,13,58,3,13,2,71,0
"'If this is true, does not get much bigger:' Trump blasts the media and Russia investigation",0,3,3,70,4,15,0,73,0
"As Trump moves to privatize America’s national parks, visitor costs may rise",0,2,3,60,2,11,0,63,0
"Pre-teen Nigeria bomber detonates early, second bomber lynched ",0,2,2,51,2,8,0,53,0
"India's Revered Yamuna River Is Also The Most Polluted In The Country, Bubbles With Toxic Foam",0,3,16,61,2,15,0,77,0
Thrillist Staff Votes To Unionize,0,3,5,24,0,4,0,29,0
"The Best TV Shows and Movies New to Netflix, Hulu and More in October - The New York Times",0,2,15,55,2,18,0,70,0
Typhoon Ketsana reaches Cambodia; up to eleven people killed,0,1,3,48,1,8,0,51,0
Iraq Launches Offensive to Re-Take Western Mosul From ISIS: Prime Minister,0,3,14,48,2,10,0,62,0
No evidence of engine fire at Aeroflot-Nord Flight 821 crash site,0,1,4,47,1,10,3,51,0
Jesse Rose Talks Retiring on Top in Exclusive Miami Music Week Interview: Watch,0,3,11,55,1,12,0,66,0
Robert De Niro Just Broke His Snapchat Cherry And We Couldn't Be Prouder,0,3,13,46,1,12,0,59,0
"Trump says ‘torture’ works, but he’ll defer on decision over tactics to his defense secretary",0,3,1,74,4,14,0,75,0
Ringside Seat: The guide to Anthony Joshua versus Wladimir Klitschko,0,3,7,51,1,9,0,58,0
Spain in danger of Eurovision disqualification after scheduling snafu at RTVE,0,1,6,61,0,10,0,67,0
Gordon Brown becomes Prime Minister of the United Kingdom,0,1,6,43,0,8,0,49,0
"LaBeouf, Rönkkö & Turner Spend a Month in Isolated Cabins for #ALONETOGETHER Performance",0,3,22,51,3,12,0,73,0
A robot healed this 9/11 hero,0,2,1,19,1,5,3,20,0
Baseball Tickets Too Much? Check Back Tomorrow,0,1,7,32,1,6,0,39,0
Unicorn macaroons are a thing FINALLY The list,0,3,9,30,0,7,0,39,0
Florida High School Flier Tells Women Which Prom Dress Makes Them a 'Good Girl',0,2,13,51,2,13,0,64,0
Massive sand trucks added to NYC's New Year's Eve security plans,0,3,7,45,2,10,0,52,0
Police attempt to change scope of undercover officers inquiry,0,2,1,52,0,8,0,53,0
Peacekeepers in Somalia Are Killed by Islamists,0,1,5,36,0,6,0,41,0
UN says more investment in agriculture needed to tackle world hunger,0,1,2,56,0,10,0,58,0
"Parenting in the age of genetic testing, from the author of ‘The Gene Machine’",0,3,4,58,3,13,0,62,0
Felix becomes Category 1 hurricane as it threatens Aruba,0,1,3,44,0,8,1,47,0
Dear Mr. President: This is how federal funding to universities works,0,3,4,53,2,10,0,57,0
Synagogue Restored at Eastern State Prison in Philadelphia,0,1,6,45,0,7,0,51,0
A Floating Courthouse Takes the Rule of Law to Brazil’s Frontier ,0,3,8,45,1,11,0,53,0
Gabourey Sidibe opens up about her weight-loss surgery,0,3,2,44,1,7,0,46,0
"Eying Georgia and Arizona, Clinton campaign looks to narrow Trump’s path",0,2,5,55,2,10,0,60,0
"Pacaya volcano erupts; ""state of public calamity"" declared",0,1,1,47,3,7,0,48,0
Highlights of 2008 Taipei County Jin Shi Marathon,0,1,6,32,0,7,4,38,0
"Official Myanmar death toll increases to 78,000",0,1,2,33,1,6,5,35,0
French farmer on trial for helping migrants: 'My job is feeding people',0,3,2,55,3,11,0,57,0
This Trump Protest Sign Reminds Us The Resistance Is Just Beginning,0,3,11,46,0,10,0,57,0
'Nazi-chic': Why dressing up in Nazi uniforms isn't as controversial in Asia,0,3,4,56,5,11,0,60,0
Paris Shootout Leaves Police Officer and Gunman Dead ,0,3,7,38,0,8,0,45,0
Over 1.5m apply for British Live 8 tickets,0,1,3,28,1,7,3,31,0
Johnny Manziel reaches agreement to dismiss domestic violence charge,0,2,2,58,0,8,0,60,0
Deadly ice storm creates treacherous conditions for Midwest ,0,3,2,50,0,8,0,52,0
Manhattan Hawk Population Is Soaring  ,0,3,5,27,0,6,0,32,0
Limbaugh: ‘It Isn’t Unreasonable at All for Donald Trump to Suspect That He’s Being Tapped’,0,3,12,60,5,14,0,72,0
EBay Plans to Spin Off Skype in Public Offering,0,1,8,31,0,8,0,39,0
Urban Battle Looms Ahead for Pakistan in Swat,0,1,6,32,0,7,0,38,0
Delta Operations Returning to Normal After Systems Outage ,0,3,7,43,0,8,0,50,0
Politicians were complaining about 'fake news' 78 years ago The list,0,2,2,52,2,10,2,54,0
Prince Charles shows off dance moves at Christmas party,0,3,3,44,0,8,0,47,0
China's Currency Policy Approaches Breaking Point,0,2,6,37,1,5,0,43,0
Bikers Rally In Waco,0,2,4,13,0,3,0,17,0
Stockholm remains defiant after deadly truck attack,0,2,1,44,0,6,0,45,0
’Harry Potter’ star Emma Watson named in latest Panama Papers leak,0,2,6,48,2,10,0,54,0
GOLDMAN: Trump is bad news for the world economy,0,2,8,31,1,8,0,39,0
Green Army: Tony Abbott speaks out against axing of environmental project,0,3,4,58,1,10,0,62,0
Horse flu damage spreads,0,1,1,20,0,3,0,21,0
J.K. Rowling and Ricky Gervais join forces to shut down Donald Trump,0,3,7,48,2,11,0,55,0
Justices Side With AT&T on Maternity Leave,0,1,8,27,1,6,0,35,0
Beyoncé bows out of Coachella due to pregnancy,0,3,2,37,0,7,0,39,0
"In Missouri, a Free Speech Fight Over a Highway Adoption",0,1,8,38,1,9,0,46,0
Student killed in San Bernardino shooting endured great deal in short life,0,2,3,60,0,11,0,63,0
Google Earth gets a mobile-friendly makeover,0,3,2,36,1,5,0,38,0
"Joss Whedon Hops From Marvel to DC, Signs on to Direct Standalone 'Batgirl' Film",0,3,12,52,3,13,0,64,0
The latest silly knock against Colin Kaepernick: He’s a vegan,0,3,4,46,2,9,0,50,0
Olympic gold medalist Evan Lysacek gets hero's welcome in hometown,0,1,3,53,1,9,0,56,0
Turkish Producer Mahmut Orhan Talks Hit Single 'Feel' & Signing With Ultra Records,0,2,12,55,3,12,0,67,0
Report: Elon Musk on Mission to Link Human Brains with Computers in Four Years - Breitbart,0,2,11,62,2,15,0,73,0
CM Punk Calls Out Hulk Hogan for Twitter Comment After Lightning vs. Blackhawks,0,2,12,54,1,12,0,66,0
The Duchess Of Cambridge Needs A New Secretary. Could It Be You?,0,3,12,39,2,11,0,51,0
British Columbia teachers dropping the chalk and walking out,0,1,2,50,0,8,0,52,0
The Ironic Health Risks Of Worrying About Your Health,0,3,9,36,0,8,0,45,0
Catalan ex-leader Artur Mas banned from office over illegal referendum,0,2,3,57,1,9,0,60,0
California jury orders Skilled Healthcare to pay $671 million in damages,0,1,3,55,1,10,3,58,0
J.K. Rowling has the best response to Trump's non-existent Sweden attack,0,3,5,53,4,10,0,58,0
Trump privately signs anti-Planned Parenthood law,0,2,3,40,1,5,0,43,0
Homeless in Sacramento Tent City Will Be Moved to State Fairground,0,1,9,47,0,10,0,56,0
GOP candidates race to the bottom on deportation of illegal immigrants,0,2,3,57,0,10,0,60,0
"Wounded, and Stories of Loss, Fill a Hospital",0,1,5,31,2,7,0,36,0
Pioneer Cabin Tree in California felled by storms,0,3,4,38,0,7,0,42,0
Manhunt: Escaped killers 'could literally be anywhere',0,3,2,43,3,6,0,45,0
4 reasons to love the weird science of Fringe,0,2,1,35,0,8,1,36,0
"Russian peacekeepers will not leave Transdniestria, official says",0,1,2,55,1,7,0,57,0
New York Post to Carry News From Jerusalem Post,0,1,8,31,0,8,0,39,0
Russian ambassador to Turkey shot in Ankara ,0,2,3,34,0,7,0,37,0
Uganda at breaking point as Bidi Bidi becomes world's largest refugee camp,0,3,3,59,1,11,0,62,0
Author and playwright Keith Waterhouse dies at 80,0,1,3,37,0,7,2,40,0
Four feared dead in Ireland helicopter crash,0,1,2,36,0,6,0,38,0
Firefighters battled a massive 10-alarm blaze in Cambridge ,0,3,2,46,1,8,2,48,0
"Yasiel Puig's Home Reportedly Burglarized in LA, $500k in Jewelry Stolen",0,3,9,47,3,10,3,56,0
Man claims 84 percent ownership of Facebook,0,1,2,33,0,6,2,35,0
Man has 420 kidney stones removed in one operation... and doctor says his love of TOFU is the reason to blame,0,3,5,78,3,20,3,83,0
When would burqa-banning Paul Nuttall show his face?,0,3,3,40,2,7,0,43,0
Pakistan to Turkey container train service launched,0,1,2,43,0,6,0,45,0
Intellectuals Call for Release of Uighur Economist,0,1,5,39,0,6,0,44,0
Beats Presents: Kid Cudi Featuring Virgil Abloh & Dot Da Genius At Art Basel 2016,0,3,13,48,2,14,4,61,0
NFL Draft 2017: Projected Salary For Mitchell Trubisky And Other First-Round Picks,0,3,14,51,2,11,4,65,0
Hyperloop One Taps the Brakes on Testing ,0,3,5,29,0,7,0,34,0
Yahoo Slides As Hack Stirs Doubts Over Verizon Deal,0,3,9,34,0,8,0,43,0
Coulter on Refugees in Europe: ‘What Other Immigrant Group Could Not Stop Themselves From Raping Women?’,0,3,14,71,4,15,0,85,0
Shea Moisture Nixes Ad After Huge Backlash,0,3,7,29,0,6,0,36,0
"The Bears, Chiefs and Texans gave up plenty for risky QB prospects ... here's why",0,3,6,56,5,14,0,62,0
A leftist candidate tries to hold the line in Ecuador as Latin America moves right,0,3,4,64,0,14,0,68,0
The Top 5 Bollywood Films You Can't Miss This Summer,0,2,9,32,1,9,1,41,0
Police make significant progress in London bombings investigation,0,1,2,56,0,7,0,58,0
Horror Film About Racism Earned Coveted 100 Percent On Rotten Tomatoes,0,3,10,47,0,10,3,57,0
Texas police officer seen pushing teen to ground in controversial video resigns ,0,3,1,67,0,12,0,68,0
"Heat wave, industrial action cripples Melbourne railways",0,1,2,47,1,6,0,49,0
Bernie Sanders predicts Trump will only be a one-term president,0,2,3,50,1,9,0,53,0
"Chilling New Trailer Of GoT Season 7 Finally Out - Cersei, Jon Snow & Daenerys Take The Arena!",0,3,16,56,4,17,1,72,0
Report: ISIS's 'business model' near collapse ,0,3,5,31,4,6,0,36,0
Obama Says America Will Be ‘OK’ In Final Press Conference,0,3,11,35,2,9,0,46,0
"Duke and Virginia Advance, Completing Final Four Field",0,1,7,39,1,7,0,46,0
Pollster Frank Luntz Melts Down After Former Client Rubio Drops Out - Breitbart,0,2,12,54,1,12,0,66,0
"Stephen Colbert Spoofs Alex Jones, Gets Into A Sticky Situation",0,3,10,43,1,9,0,53,0
Brexit debate: Labour hit by backbench revolt over Article 50 'Tory trap' fears,0,3,4,58,3,12,2,62,0
White House Hosts Star-Studded Farewell Bash for Obamas,0,2,8,39,1,7,0,47,0
Business PR And Politics: How Will Trump's 'Endorsement' Affect L.L. Bean?,0,2,13,44,7,10,0,57,0
Advisory Against Visiting Caves,0,1,4,24,0,3,0,28,0
USMNT Reveals World Cup Qualifying Roster Including Return of Clint Dempsey,0,3,14,51,0,10,0,65,0
Gambia President-elect Barrow 'to stay in Senegal until inauguration',0,3,4,54,3,8,0,58,0
Craigslist founder gives $1 million to fight fake news,0,3,1,43,1,8,1,44,0
Bad Economy Is  Good Time for College Basketball Coaches to Have  Bad Season,0,1,11,51,0,14,0,62,0
"RAY DALIO ON TRUMP: 'If you havenât read Ayn Rand lately, I suggest that you do'",0,3,19,42,6,15,0,61,0
Study finds 'staggering' rise in mastectomies in these states,0,3,1,50,2,8,0,51,0
2017 NFL Offseason Could Be a Uniquely Epic Year for the QB Carousel,0,2,12,40,0,12,4,52,0
"Vandals spill 400,000 bottles of Italian sparkling wine in act of 'sabotage'",0,3,2,54,3,11,6,56,0
Big Bird flies into your stories with Sesame Street's first Snapchat filter,0,3,5,58,1,11,0,63,0
Wikinews interviews UK pro darts player Kirk Shepherd,0,1,5,41,0,7,0,46,0
U.S. Laws Will No Longer Sound Like a Vaguely Racist Uncle,0,2,11,35,2,10,0,46,0
"Shiv Sena MP Who Took Train Back Home After Airlines Banned Him, Goes Missing",0,2,15,48,1,13,0,63,0
'Full House' Creator Buys Home Used in Show ,0,3,7,27,2,8,0,34,0
"Betsey Johnson, fashion's free spirit",0,2,2,29,2,4,0,31,0
2010 FIBA World Championship starts,0,1,6,21,0,4,4,27,0
"Arturo Gatti, Former Boxing Champion, Found Dead in Hotel Room",0,1,9,42,2,9,0,51,0
Hate Hoax: Black Man Arrested for ’Racist’ and ‘Nazi’ Trump Graffiti,0,2,9,44,5,10,0,53,0
"Special Ops Chief: US troops have killed 60,000 ISIS militants the past two years ",0,3,9,52,2,14,5,61,0
"Muhammad Ali's Son Detained At Airport, Asked 'Are You Muslim?'",0,3,10,39,5,9,0,49,0
"Joseph Wapner, judge who presided over The People’s Court, dies at 97",0,2,5,48,3,11,2,53,0
Israel summoned 10 foreign ambassadors to Jerusalem to reprimand them,0,3,2,56,0,9,2,58,0
"A Couple Canceled Their $350,000 Wedding After A Fight At Their Rehearsal Dinner",0,3,12,48,2,12,6,60,0
Ahmed Fahour hits back at Hanson: 'Does she have an issue with the colour of my skin?' – video,0,2,4,67,5,18,0,71,0
Disney’s ‘Rogue One’ Surges With $155 Million Weekend Haul,0,2,8,35,4,8,3,43,0
AG Sessions to MS-13 gang: 'We are coming after you' ,0,2,6,31,4,10,2,37,0
Facebook to Review Content Reporting System in Wake of Cleveland Murder,0,3,8,53,0,10,0,61,0
India’s Air Pollution Rivals China as World’s Deadliest ,0,3,7,39,2,8,0,46,0
Four men arrested in India after US tourist accuses them of gang rape,0,2,4,53,0,12,0,57,0
Emergency spacewalks planned to fix International Space Station,0,1,4,52,0,7,0,56,0
Did Curt Schilling tweet his way out of Cooperstown?,0,3,4,39,1,8,0,43,0
Emily Blunt's First Photo as Magical Nanny in 'Mary Poppins Returns': Compare Her Look to Julie Andrews in '64,0,2,14,71,5,18,2,85,0
Meet The Press with Chuck Todd SUNDAY MORNINGS MTP: 70 Years in 70 Seconds,0,3,24,32,1,13,4,56,0
Fukushima radiation reaches United States shores for first time,0,2,3,52,0,8,0,55,0
Italian priest nixes Nativity scene to avoid offending Muslims ,0,3,3,51,0,9,0,54,0
"Breitbart blames the Republican health-care failure on Paul Ryan, not President Trump",0,2,6,66,2,11,0,72,0
ABC Open: Your best pictures from around Australia this week,0,3,6,44,1,9,0,50,0
Secretary of State Kerry Not Commenting on Tlllerson Pick,0,3,7,42,0,8,0,49,0
Death after ‘extreme sexual behavior’ ruled homicide,0,2,1,43,2,6,0,44,0
Antiglobalization protestors march near site of G8 summit,0,1,2,47,0,7,1,49,0
Miranda Kerr is really feeling the wrath of Spiegel's alleged India comments,0,2,4,60,1,11,0,64,0
"US government reports decline in teen birth rate and binge drinking, rise in poverty and drug abuse",0,1,2,80,1,16,0,82,0
An iceberg the size of Delaware is about to break off Antarctica,0,2,3,50,0,11,0,53,0
Arabsat puts Arabic news channel back on the air,0,1,2,38,0,8,0,40,0
"Lesbian and bisexual women are being incorrectly told they don't need smear tests, LGBT charities say",0,3,5,79,2,15,0,84,0
"Behind in the polls, Trump returns to friendly ground in the South",0,2,3,51,1,11,0,54,0
Fiscal Crisis Stalls Agenda of Obama,0,1,5,26,0,5,0,31,0
President Obama’s Farewell Address: Full Video and Text ,0,2,7,39,2,8,0,46,0
Lego Making ‘Women of NASA’ Figures,0,3,8,20,2,5,0,28,0
Italian petrol prices rocket to a record EUR 1.30 per litre,0,1,4,41,1,10,3,45,0
Ex-K.G.B. Agent Buying London Tabloid,0,1,8,21,4,4,0,29,0
Black box found near crash site of Ethiopian Airlines flight,0,1,3,48,0,9,0,51,0
Venezuela Will Push U.S. to Hand Over Man Tied to Plane Bombing,0,1,11,39,2,11,0,50,0
"Kay Hagan sues Elizabeth Dole over ""Godless"" television advertisement",0,1,5,54,2,8,0,59,0
Symantec to acquire LifeLock for $2.3 billion,0,2,3,32,2,6,2,35,0
Backpacker tax passes Senate with Greens support,0,3,3,39,0,6,0,42,0
Investor Euphoria Has Stocks Set to Race Past Fair Value,0,3,9,38,0,9,0,47,0
Northern Ireland’s Kyle Lafferty will be Romania’s main target,0,3,5,47,2,8,0,52,0
London fire extinguisher throw suspect bailed,0,1,1,39,0,5,0,40,0
"Government to create 200,000 new apprenticeships",0,2,1,35,1,5,6,36,0
"As Trump Orders Wall, Mexico’s President Considers Canceling U.S. Trip ",0,3,11,46,4,10,0,57,0
Penalty rates: Australian principles under attack with decision to cut wages,0,3,2,63,1,10,0,65,0
"With 2 'Must-Win' Games Left, Chicago Bulls Have a Dwyane Wade Problem",0,3,11,43,4,11,1,54,0
No longer ‘Mayberry’: A small Ohio city fights an epidemic of self-destruction,0,3,4,59,4,11,0,63,0
Cleaning Up the Oceans' 'Plastic Soup',0,3,5,25,3,5,0,30,0
Israel Approves Legislation Retroactively Legalizing Settlements ,0,2,6,53,0,6,0,59,0
Tennant Creek deluged with 'one-in-50-year' flood,0,3,2,35,5,5,2,37,0
Wild storms lash New South Wales South Coast,0,1,6,31,0,7,0,37,0
"In Olympic Rerun, Wanjiru Captures London Marathon",0,1,7,36,1,6,0,43,0
It only took five seconds for assassins to kill Kim Jong Nam,0,2,4,45,0,11,0,49,0
Knicks' Derrick Rose for Ricky Rubio Trade Reportedly Rejected by Timberwolves,0,3,9,58,1,10,0,67,0
Hiring of Isiah Thomas Angers Some F.I.U. Faculty Members,0,1,10,36,3,8,0,46,0
Volcano erupts in the Aleutian Islands,0,1,3,30,0,5,0,33,0
"Debbie Reynolds, Hollywood Legend and Mother of Carrie Fisher, Dies at 84 ",0,3,8,50,2,12,2,58,0
Grads of LifeVoice: How Out-of-School Enrichment Can Close The STEM Talent Gap,0,3,16,48,3,11,0,64,0
How Three Self-Made Women Overcame Life's Greatest Obstacles,0,3,9,42,2,7,0,51,0
"An iPhone’s Journey, From the Factory Floor to the Retail Store ",0,2,8,43,2,11,0,51,0
Trump: Clinton ’trying to smear’ my supporters,0,2,2,35,3,6,0,37,0
Kamchatka deep-focus underwater earthquake reaches Moscow,0,1,2,49,1,5,0,51,0
How Canada Curbed Foreign Workers and Hobbled Its Meat Industry,0,2,9,45,0,9,0,54,0
"Trumps plot big hotel expansion, but political problems loom",0,3,1,50,1,8,0,51,0
"New Year’s Day Brings New Laws Regulating Phones, Guns and Soft Drinks",0,3,11,46,2,11,0,57,0
Once-conjoined twins going to rehab 9 weeks after separation ,0,3,1,49,1,9,1,50,0
"If elected, neither Fillon nor Le Pen can be charged with the crimes they're accused of for at least five years",0,3,4,85,2,20,0,89,0
"Trump's America Trump approaches 100-day milestone, but what progress has he made on his agenda?",0,3,3,72,4,14,3,75,0
Manitoba's flood creating hazardous conditions,0,1,1,40,1,4,0,41,0
Germany’s Angela Merkel Urges Trump to Work With U.N. on Syria,0,3,10,39,3,10,0,49,0
LeBron James Beats Damon Jones in Shooting Contest While Wearing Backpack,0,3,11,52,0,10,0,63,0
Can Georgia's dedicated liberal women turn red state blue?,0,2,2,46,2,8,0,48,0
"The Global Music Industry Grew By 6% In 2016, Signaling Brighter Days Ahead",0,2,11,45,2,12,5,56,0
Reggie Jackson's Trade Value for Pistons Reportedly Revealed,0,3,7,45,1,7,0,52,0
Cattle Rustling Plagues Ranchers,0,1,4,25,0,3,0,29,0
7 Times Kangana Ranaut Roasted KJo Like A 'Queen' & Stunned Saif Ali Khan On Koffee With Karan 5!,0,2,17,56,4,18,2,73,0
Are Skrillex & Fifth Harmony Collaborating?,0,3,5,31,2,5,0,36,0
US Fed chairman Bernanke says recession could end this year,0,1,4,46,0,9,0,50,0
Fred Thompson to make Presidential announcement on The Tonight Show,0,1,6,52,0,9,0,58,0
Vendee Globe: Armel Le Cleac'h wins round-the-world race in record time,0,3,5,52,4,10,0,57,0
On Growing Up With The 'Girls',0,3,6,17,2,5,0,23,0
"Alarmed By Washington, Liberal Protesters Bring Concerns Home To Lawmakers",0,2,10,54,1,9,0,64,0
Dev Patel Is Only The Third Indian Actor Ever To Receive An Oscar Nod,0,2,14,42,0,13,0,56,0
"Palin Is Putting Personal Ambition Ahead of Alaska, Critics Say",0,1,9,44,1,9,0,53,0
'Heartbroken' RuPaul On Trump Win: 'It Feels Like The Death Of America',0,2,13,42,5,11,0,55,0
Where Do We Draw the Line When It Comes to Free Speech Online?,0,3,11,38,1,12,0,49,0
New Federal Rule Bans Smoking in Public Housing Nationwide,0,3,8,42,0,8,0,50,0
Liverpool beats Milan on penalties in Champions League final,0,1,4,48,0,8,0,52,0
Missing cat from California ends up in Canada years later ,0,2,3,45,0,10,0,48,0
"Plans To Convert INS Viraat Into A Museum Fails, India’s Oldest Warship May Be Sold For Scrap",0,3,19,56,2,16,0,75,0
Flight attendants can't 'think straight' after 'toxic fumes' leak ,0,3,1,51,5,9,0,52,0
Israel threatens to give Trump 'evidence' that Obama orchestrated UN resolution,0,3,5,62,2,10,0,67,0
"Fallen Navy SEAL gets posthumous promotion, recalled as devoted family man ",0,3,6,57,1,11,0,63,0
Bernie Sanders explains opposition to Syria strike,0,3,3,41,0,6,0,44,0
'I Am Tougher Than a Bullet': Utah Girl Allegedly Shot and Left for Dead by 2 Teen Boys Speaks Out,0,2,15,60,3,19,1,75,0
iOS 9 will give your iPhone up to 3 extra hours of battery life,0,2,3,45,0,13,2,48,0
"Bergdahl bears some responsibility for risky missions to find him, judge says ",0,3,1,64,1,12,0,65,0
Ukraine parliament sacks government,0,1,1,31,0,3,0,32,0
"Here's Why Nicki Wouldn't Let Kanye Appear on ""Right Thru Me"" Even Though He Begged",0,2,14,51,4,14,0,65,0
American’s CEO Sides With Airline Workers Against Wall Street,0,2,11,41,1,8,0,52,0
What Kendrick Lamar's Coachella Performance Could Mean for an Upcoming Tour,0,3,9,55,1,10,0,64,0
Beer Industry Could Lose $2 Billion From Legal Marijuana,0,3,8,38,1,8,1,46,0
Affidavit: Josh Jackson threatened to 'beat' women's player,0,2,3,45,4,7,0,48,0
‘Everyone Has a Price’: Readers React to Passenger Removed from United Flight ,0,2,9,54,3,12,0,63,0
Church accuses Mexicans who work on Trump wall of 'treason',0,2,3,45,2,9,0,48,0
CBS making push to hire Tony Romo,0,2,5,22,0,6,0,27,0
Iraq Bombings Shatter Lull,0,1,4,19,0,3,0,23,0
The Gambian footballer who drowned in search of a better life,0,3,2,49,0,10,0,51,0
"Naked pictures are traded 'like football stickers' in playgrounds, Education Secretary told",0,3,3,74,3,11,0,77,0
Gaga backs gay rights in Trump's America,0,3,3,30,1,6,0,33,0
Fisher Ready to Give Up Open to Support Wife,0,1,7,29,0,8,0,36,0
Blake Lively And Ryan Reynolds' Beautiful Babies Make Their First Red Carpet Appearance,0,3,13,61,1,12,0,74,0
"The Global Refugee Crisis, Region by Region ",0,3,6,30,1,7,0,36,0
"Republicans Are Grappling With How to Repeal Obamacare
",0,3,7,40,0,8,0,47,0
‘Liquid’ Cancer Test Offers Hope for Alternative to Painful Biopsies - The New York Times,0,2,12,60,3,14,0,72,0
Counseling Was Ordered for Soldier in Iraq Shooting,0,1,6,38,0,7,0,44,0
Russian and US satellites collide,0,1,3,26,0,4,0,29,0
How Many Harry Potter Characters Can You Name In Three Minutes?,0,3,11,41,1,10,0,52,0
Brands all over the world are praying that Trump attacks them,0,3,2,49,0,10,0,51,0
F-Secure detects security flaw in Sony memory sticks,0,1,3,41,1,7,0,44,0
At least eight die in Afghan capital suicide bombing,0,1,2,42,0,8,0,44,0
Chris Paul Questionable to Return from Injury for Clippers vs. Spurs,0,3,7,50,1,10,0,57,0
Localities Want U.S. Support for Muni Bonds,0,1,7,28,2,6,0,35,0
China Moves to Keep Its Deadly Opioids Out of U.S.,0,3,9,30,2,9,0,39,0
The Mets Remain Unbeaten in the Replay Booth,0,1,6,31,0,7,0,37,0
Libyan government forces capture eastern town from rebels,0,1,1,49,0,7,0,50,0
"‘Brexit’ Prompts Many British C.E.O.s to Consider Relocating, Survey Finds - The New York Times",0,2,15,59,7,14,0,74,0
These EPA programs protect kids from lead paint. Trump’s budget would end them.,0,3,5,59,3,12,0,64,0
"Chelsea Manning Fundraiser Garners More Than $83,000 in One Week",0,2,8,40,2,9,5,48,0
China Detains Building Chief in TV Complex Blaze,0,1,8,33,0,7,0,41,0
Fashion marketer LuLaRoe sued over sales tax charges,0,3,4,41,0,7,0,45,0
Is YOUR phone safe? Security expert says hackers can attack your device via dozens of popular iOS apps,0,2,8,76,1,17,0,84,0
"Hacks to fight off a cold in MINUTES - including sipping black tea, nibbling Brazil nuts and munching on garlic ",0,2,9,81,2,20,0,90,0
Henry Rollins: White People Would ’Lose Their Minds’ If Forced to Be Black,0,2,12,47,3,12,0,59,0
"Suit alleges Kiffin, FAU defrauded ex-Bama player on assistant job",0,3,6,49,2,9,0,55,0
Brie Larson To Play First Woman To Run For President,0,2,10,33,0,9,0,43,0
"Waitress evicts huge, pesky goanna that snuck into her restaurant",0,3,1,54,1,9,0,55,0
Wikimedia Foundation addresses controversial content conflict,0,1,2,54,0,5,0,56,0
A Slight Deficit Can Actually Be an Edge,0,1,7,26,0,7,0,33,0
Student Set for Sentencing in Failed Bombings,0,1,5,34,0,6,0,39,0
A Charity Auction for Coffee With Ivanka Trump Appears to Be Canceled ,0,3,10,48,0,12,0,58,0
"John Glenn's widow turns 97, says she misses him 'terribly' ",0,2,2,42,4,10,2,44,0
Philip Hammond announces tax rises for self-employed and free school funds – budget live,0,3,2,71,2,13,0,73,0
Trump Immigration Order Shakes Africa,0,3,5,28,0,4,0,33,0
"Let students live alongside elderly in care homes to fight 'inter-generational apartheid', says report",0,2,1,84,4,13,0,85,0
"Yasmin Seweid, Muslim teen who reported harassment on New York subway, found safe",0,3,5,62,2,12,0,67,0
"Car bomb in Buenaventura, Colombia kills at least six",0,1,3,41,1,8,0,44,0
US says Colombia's coca production surges to record levels ,0,3,3,46,1,9,0,49,0
Scarlett Johansson accidentally kills a stripper in the 'Rough Night' trailer,0,3,4,61,2,10,0,65,0
Ashish Nehra Continues To Defy Age With His Fitness And Maintains That He Is Still A Fast Bowler,0,3,18,61,0,17,0,79,0
Pittsburgh Penguins fan stabbed in head refuses treatment until end of game,0,3,2,62,0,11,0,64,0
Hidden Figures: How Nasa hired its first black women 'computers',0,2,4,48,3,9,0,52,0
Dave Chappelle's 'SNL' Monologue Drew a Number of FCC Complaints for Using the 'N-Word',0,2,15,53,6,13,0,68,0
Gurugram Residents Come Together To Start India's First Organic Veggies Market,0,3,11,56,1,10,0,67,0
Whole Foods moves to renewable energy,0,1,2,30,0,5,0,32,0
"Eurovision '09 competitor Chiara talks about her current song ""What If We"" and her past accolades",0,1,5,72,3,15,2,77,0
Academy of Motion Picture Arts and Sciences apologizes for Oscars mix-up ,0,3,6,55,1,11,0,61,0
Astronomers find changes in Saturn's rings,0,1,2,34,1,5,0,36,0
You can pre-order the Galaxy S8 and get a free Gear VR,0,3,6,35,1,11,1,41,0
U.S. Supreme Court Denies Arkansas Request to Begin Executions,0,3,9,43,2,8,0,52,0
Venture capital investment in Ireland soars by 35%,0,1,2,38,1,7,2,40,0
Italian Court Boosts Renzi’s Push for Early Elections,0,3,7,38,1,7,0,45,0
HP Inc.Voice: Three Ways To Reinvent For The Fourth Industrial Revolution,0,3,13,48,2,10,0,61,0
"Lady Gaga Talks Super Bowl, Says Her Sister Lobbied to 'Suspend' Her in the Air",0,3,12,50,3,14,0,62,0
Former Clinton adviser: Bannon on NSC shows 'bad judgment',0,3,6,41,3,8,0,47,0
Horowitz: Anti-Bannon Hysteria More Evidence the Left Has Lost Touch with the American People - Breitbart,0,2,13,74,3,15,0,87,0
"12-year-old school boy has sex change in Sussex, England",0,1,2,41,3,8,2,43,0
A columnist wrote about trying to breast-feed a stranger’s baby — ‘to see what it felt like’,0,3,1,70,5,16,0,71,0
Vermont Holds Hearings on Same-Sex-Marriage Bill,0,1,7,34,2,5,0,41,0
"Steve Kerr out for Game 4 vs. Blazers with Back Injury, Playoff Status Uncertain",0,3,9,55,2,13,1,64,0
Mobile that keeps tabs on elderly relatives: Device will send a warning message should they wander off ,0,3,2,83,1,17,0,85,0
"Scott Pruitt, Trump's environment pick, gets Senate approval",0,2,4,46,3,7,0,50,0
Five people in hospital after 'taking prescription drugs and alcohol',0,3,1,57,2,9,0,58,0
US - India nuclear deal sent for US Congress ratification,0,1,6,41,1,9,0,47,0
Iraqi Women Vie for Votes and Taste of Power,0,1,6,30,0,8,0,36,0
Senator Says Orlando Shooter Posted Pro-ISIS Messages On Facebook,0,2,13,43,1,8,0,56,0
Mets Bullpen Continues Its Hard Work,0,1,6,25,0,5,0,31,0
Tim Allen Hammers ‘Precious Snowflakes’ Over ‘Microaggressions’ On ‘Last Man Standing’ (Video),0,2,12,63,8,11,0,75,0
Ecuador Election Could Determine Fate of WikiLeaks Founder Julian Assange ,0,3,10,54,0,10,0,64,0
Is Springwatch putting us back in touch with nature?,0,3,2,41,1,8,0,43,0
"The Trump Rally Has a Long Way to Go, if Japan Is Any Guide",0,3,11,34,1,13,0,45,0
Health Care Is Front and Center in Democrats’ Response to Trump Address ,0,2,9,50,1,12,0,59,0
Harvard Dropout James Murdoch Steps Into Limelight at Fox,0,2,8,41,0,8,0,49,0
Senate Democrats vow legislation to block Trump’s travel ban,0,3,3,48,1,8,0,51,0
French woman admits to killing her eight infants,0,1,1,40,0,7,0,41,0
UN claims over a quarter million human trafficking victims in EU,0,1,4,50,0,10,0,54,0
NASCAR driver Kyle Busch wins 2011 Jeff Byrd 500,0,1,10,23,0,8,7,33,0
UN to kick off talks on global nuclear weapons ban â but all major nuclear powers oppose it,0,3,2,72,2,17,0,74,0
North Korean military detains two American journalists,0,1,3,45,0,6,0,48,0
Plane crashes into Toronto office building,0,1,2,35,0,5,0,37,0
Voters must ask themselves: who is fit to govern Britain?,0,3,2,44,2,9,0,46,0
Rafael Nadal reaches Stuttgart semis after struggle with Bernard Tomic,0,2,5,56,0,9,0,61,0
'Orange is the New Black' cast rocks red-carpet looks,0,3,3,39,3,8,0,42,0
Social Media Content Editor,0,3,4,20,0,3,0,24,0
The Voice UK: Calls to sack Sir Tom Jones for comments about previous winner's weight,0,3,8,61,2,14,0,69,0
Ukrainian journalist Gongadze's skull may have been found,0,1,2,47,1,7,0,49,0
Man arrested in India after mid-air hijack threat on domestic flight,0,1,2,55,1,10,0,57,0
David Bowie Fans Reveal Plans To Build A Giant Lightning Bolt In His Hometown,0,3,14,50,0,13,0,64,0
4.5-kilometre bridge to link Crimea with Russia,0,1,2,35,2,6,2,37,0
"Fear and loathing on the campaign trail, July 2008",0,1,2,35,1,8,4,37,0
Southern Rail passengers 'having job applications rejected' over crisis-hit commuter line,0,3,2,74,3,10,0,76,0
Egyptian politician ElBaradei says ousted President Mubarak must stand trial,0,1,5,62,0,9,0,67,0
In Trump They Trust: Inside The Global Web Of Partners Cashing In On The President,0,2,15,52,1,14,0,67,0
Undercover investigation into protests planned for July's G8 summit,0,1,3,54,1,8,1,57,0
"God Aided Us In Carrying Out 9/11 Attack, Mastermind Khalid Shaikh Mohammed Wrote In A Letter To Barack Obama",0,3,18,68,2,18,3,86,0
"Unable to Enter U.S., and Still Stranded Abroad ",0,3,7,30,3,8,0,37,0
"In A Heartfelt Message To MS Dhoni, Virat Kohli Tells Him 'You'll Always Be My Captain'",0,3,17,51,4,15,0,68,0
Times Co. Is in Talks to Sell Part of Building,0,1,7,29,1,9,0,36,0
Two British Police Officers Used a Taser on Their Own Black Race Relations Advisor,0,3,12,57,0,13,0,69,0
YouTube wants YouTubers to be less angry about subscriptions,0,3,4,48,0,8,0,52,0
‘We are all the same’: Woman assaulted for speaking Swahili forgives her attacker,0,3,3,63,3,12,0,66,0
Major storms batter Europe,0,1,2,21,0,3,0,23,0
"Manafort Is Willing to Talk With House Committee, Nunes Says",0,2,9,41,1,9,0,50,0
Why ‘Moonlight’ resonated as strongly with me as ‘Brokeback Mountain’ did 12 years ago,0,2,4,63,4,13,2,67,0
"If they had any sense, Remainers would get behind a war with Spain over Gibraltar",0,2,4,62,1,14,0,66,0
Ephemeral New York ,0,2,3,13,0,3,0,16,0
NFL1000: Where Does Jabrill Peppers Fit in the NFL?,0,3,11,26,2,8,4,37,0
APNewsBreak: New Orleans to take down Confederate statues ,0,2,7,42,1,8,0,49,0
American Pharoah announces he’s a new dad on Facebook,0,2,3,41,1,8,0,44,0
"1 Dead, Suspect Surrenders in Las Vegas Strip Bus Shooting and Standoff",0,2,9,49,1,11,1,58,0
The trials of those involved in the Turkey Coup have begun,0,2,3,45,0,10,0,48,0
"Listen to Maroon 5's New Song with Future, 'Cold'",0,3,6,30,4,8,1,36,0
Watch Rihanna Struggle to Watch Her Sex Scene in 'Bates Motel',0,2,9,41,2,10,0,50,0
Watch Live: Interest Rate Announcement,0,2,5,28,1,4,0,33,0
"Andrew Bogut Rumors: Cavaliers, Spurs and Celtics Among Teams Considering Center",0,2,10,58,2,10,0,68,0
Singer Joy Villa wears Trump dress to the Grammys ,0,2,5,36,0,9,0,41,0
He was president when Twitter was banned; now he's tweeting,0,3,2,46,2,9,0,48,0
Oil spikes as inventories post their biggest drop of the year,0,2,1,50,0,10,0,51,0
Daimler Posts $1.7 Billion Loss in 1st Quarter,0,1,5,29,2,7,3,34,0
Man charged following bomb threats which closed 14 Tesco supermarkets in UK,0,1,4,58,0,11,2,62,0
Europe’s Expanding CLO Market to Build on Record Year in 2017,0,2,9,37,1,10,4,46,0
Higher U.S. Stocks Expected in 2017 by Most in Bloomberg Poll,0,3,8,37,2,10,4,45,0
US study examines suicide trends in depressed youth,0,1,2,42,0,7,0,44,0
"Social Media in Government: Benefits, Challenges, and How it’s Used",0,2,7,47,4,9,0,54,0
First television channel in Esperanto launches online,0,1,2,45,0,6,0,47,0
"'Becoming Us': Transgender Parents, Conflicted Kids",0,2,6,36,4,5,0,42,0
Are Wages and Benefits Growing Faster Than We Think? - Real Time Economics,0,2,11,49,2,12,0,60,0
"A young man died in police custody, and middle-class Chinese are outraged",0,3,2,58,2,11,0,60,0
Mal Peet in line for posthumous win as Carnegie shortlist announced,0,3,3,54,0,10,0,57,0
Israeli Settlements: What It’s Like to Live Inside a Divided Land,0,2,9,44,2,10,0,53,0
Demand for Tires in China Is Making Your Rubber Gloves Pricier,0,3,9,43,0,10,0,52,0
Russian inflation keeps tumbling,0,3,1,28,0,3,0,29,0
Just How Badly Did Ellen DeGeneres Butcher Rae Sremmurd's Name?,0,3,11,41,2,9,0,52,0
Barbra Streisand Says Trump's Presidency Is Making Her Gain Weight,0,2,10,46,1,9,0,56,0
Drake's 'More Life' Has Surpassed 'Views' in First-Week Streaming Numbers,0,3,10,48,6,9,0,58,0
"Long Unseen By Readers, H.G. Wells Ghost Story Finally Debuts In Print",0,2,13,43,3,11,0,56,0
Top Trump Aide: U.S. Working With China To Counter North Korean Threat,0,3,13,43,3,11,0,56,0
Mike Baird: How NSW Premier went from popular to political scrapheap,0,3,7,50,1,10,0,57,0
Justice Dept. Seeks Equity in Sentences for Cocaine,0,1,6,37,1,7,0,43,0
Verizon to Begin 5G User Trials in 11 Markets by Middle of Year,0,3,8,40,0,12,3,48,0
CanadaVOTES: NDP incumbent Wayne Marston running in Hamilton East—Stoney Creek,0,1,15,52,2,9,0,67,0
Two people die in bus crash in North Yorkshire,0,1,3,35,0,8,0,38,0
"Jennifer Holliday cancels Trump inauguration performance, apologizes to LGBT community",0,3,7,69,1,9,0,76,0
Watch this massive block of icicles come crashing down,0,3,1,45,0,8,0,46,0
I.M.F. to Release Second Part of a $16.4 Billion Loan to Ukraine,0,1,9,36,5,11,3,45,0
"Clouded leopard cub is not only beyond cute, but a conservation breakthrough",0,2,1,63,1,11,0,64,0
The Trump-Like Figures Popping Up in Central Europe ,0,2,8,35,1,8,0,43,0
"Syria has secretly executed thousands of political prisoners, rights group says",0,3,1,67,1,10,0,68,0
Obama Announces Strategy Against Cyberattacks,0,1,5,36,0,4,0,41,0
P.J. Fleck named Minnesota coach: 'I am here to change the culture',0,3,5,46,5,11,0,51,0
Microsoft's attempt to buy out Yahoo may never happen,0,1,2,42,1,8,0,44,0
Benoît Hamon Takes Lead in France’s Socialist Primary in Setback to Party Moderates ,0,2,10,60,1,13,0,70,0
"Ahead Of Pope's Encyclical, Few U.S. Catholics Hear Climate Change Discussed In Church",0,3,14,56,4,12,0,70,0
Donald Trump Actually Just Ended His News Conference By Saying 'You're Fired',0,3,12,51,3,11,0,63,0
Pakistan's Anti-Narcotics Force burns up 57 tons of drugs and alcohol worth over $152 million,0,3,4,67,3,14,5,71,0
Barack Obama Will Make First Post-Presidency Public Appearance in Chicago Next Week,0,3,12,59,1,11,0,71,0
Lebanese-Syrian meetings reach full withdrawal accord,0,1,2,45,1,5,0,47,0
UK tourist in Australia 'rape ordeal' released from hospital,0,2,3,47,2,8,0,50,0
The 'Going Clear' director is making a documentary about ousted Fox News boss Roger Ailes,0,3,7,66,2,14,0,73,0
Egypt's Sisi declares state of emergency after church attacks,0,3,2,50,1,8,0,52,0
Kevin Chappell Holes Eagle from 131 Yards at Masters,0,3,6,35,0,8,3,41,0
Vehicles Tupac and Notorious B.I.G. Were Killed In Are Both Up for Auction,0,3,13,46,3,12,0,59,0
New bridge lowered into position as East London line extension work progresses,0,1,3,64,0,11,0,67,0
Love All: Serena Williams Is Engaged,0,2,6,24,1,5,0,30,0
'El Chapo' Guzman faces life in prison; not-guilty plea entered ,0,3,3,47,4,10,0,50,0
The Modern Allegories of Suicide Squad,0,2,5,28,0,5,0,33,0
"US officials: Russian drone may have turned camera off, right before Syrian attack",0,3,4,64,2,12,0,68,0
"¡Obámanos! President Barack Obama’s Legacy, Through a Latino Lens",0,2,8,45,4,8,0,53,0
"Hundreds of Tibetans defy China, gather at birthplace of Buddhism in India",0,2,5,57,1,11,0,62,0
Coaches Arrive at Same Sideline by Different Paths,0,1,6,37,0,7,0,43,0
Downward spiral: how addiction decimated a Wyoming family,0,2,2,47,1,7,0,49,0
New Study Shows Anti-Semitism Soared Last Year,0,2,8,31,1,6,0,39,0
"5 Things to Read Today: Trump’s Travel Ban Awaits Court Ruling, the Insane Super Bowl Comeback and More ",0,3,14,68,3,18,1,82,0
"Ivanka Trump, Jared Kushner inch closer to Washington",0,3,5,40,1,7,0,45,0
French election: Le Pen and Macron hold rival rallies,0,3,4,40,1,8,0,44,0
James Taylor Bemoans End of Obama Era: 'It Feels Like It's Raining All Over the World',0,3,14,53,4,15,0,67,0
"Sharks, sandbags and surfing: Cyclone Debbie brings floods to Queensland",0,2,4,57,2,9,0,61,0
How a new source of water is helping reduce conflict in the Middle East,0,2,3,55,0,13,0,58,0
"Behold, the Hubble Telescope’s latest close-up photo of Jupiter",0,3,4,48,3,8,0,52,0
Sperm bank cited after deputy's death from liquid nitrogen,0,3,1,48,1,8,0,49,0
China Plans to Challenge U.S. Ban on Its Poultry,0,1,8,30,2,8,0,38,0
"Redskins Sign Haynesworth, but They Pay Top Dollar",0,1,7,35,1,7,0,42,0
Sexist Political Criticism Finds a New Target: Kellyanne Conway ,0,3,8,46,1,9,0,54,0
White House denies UN resolution was swipe at Netanyahu,0,3,5,42,0,8,0,47,0
Full size Titanic replica built in China will stage ‘simulation’ of iceberg collision,0,2,3,68,2,12,0,71,0
"Sarkozy says burqa is ""not welcome"" in France",0,1,2,34,2,7,0,36,0
Watch the Brit Awards Live Stream Here,0,3,6,26,0,6,0,32,0
Jacobs Wants to See Burress Return to Giants,0,1,6,31,0,7,0,37,0
"Two divers' bodies found in Scapa Flow, Scotland",0,1,4,35,2,7,0,39,0
Tensions boil up between Democrats and FBI director,0,3,5,39,0,7,0,44,0
"Esma Redzepova, the “Queen of Gypsy music,” dies age 73",0,3,4,36,4,9,2,40,0
U.S. Sanctions 18 Syrians for Chlorine-Gas Attacks ,0,3,7,32,3,7,2,39,0
"Growing feud: Trump, Cruz escalate attacks on each other",0,2,3,43,2,8,0,46,0
Report: German Vice Chancellor Sigmar Gabriel will challenge Angela Merkel in this year's elections,0,3,8,76,2,13,0,84,0
"Canadian jail inmates used nail clippers to escape, report finds",0,1,1,53,1,9,0,54,0
Chuck Berry dead: Read Carl Sagan's letter to Berry on his 60th birthday,0,3,6,50,2,12,2,56,0
60 reported dead in Congo train crash,0,1,1,28,0,6,2,29,0
Sunnis withdraw from Iraqi government,0,1,2,31,0,4,0,33,0
Qualcomm Warns of Lower Profit as Apple Dispute Hits Patent Revenue,0,3,9,48,0,10,0,57,0
How well do you remember Love Actually? Take our quiz,0,3,4,39,1,9,0,43,0
Ex-Chief Settles Fraud Suit for $2.5 Million,0,1,6,27,3,6,2,33,0
Retail sales fall for a second straight month as auto sales tumble,0,3,1,54,0,11,0,55,0
"What You Need To Know About Alexander Acosta, Trump's New Pick For Labor Secretary",0,3,14,53,2,13,0,67,0
’The Revenant’ becomes Oscar front-runner; actors of color ignored,0,2,3,51,4,8,0,54,0
IS conflict: Iraqi force 'retakes ancient city of Hatra',0,3,4,41,3,8,0,45,0
Anti-Love Drug May Be Ticket to Bliss,0,1,7,23,1,6,0,30,0
Ambushes and fatal shootings fuel increase in police death toll this year,0,3,1,61,0,11,0,62,0
Geysers of water on one of Saturn's moons,0,1,2,31,1,7,0,33,0
Polar bear and wild reindeer decline worsening as climate change continues to melt Arctic ice: study,0,3,2,82,1,15,0,84,0
New Zealand Parliament reconvenes after election,0,1,3,40,0,5,0,43,0
"Game of Thrones, NBA Edition (Game of Zones, Episode 4)",0,3,9,32,4,9,1,41,0
Foxconn’s Gou Says 'Very Serious' About Toshiba Chip Unit Bid,0,3,10,39,3,9,0,49,0
"HP Recalls 101000 Laptop Batteries Fearing They Catch Fire, Check If You’re Affected",0,3,13,51,2,12,6,64,0
"Inspired by Wolverine, Scientists Develop Self-Healing Artificial Material",0,3,8,57,2,7,0,65,0
"Common Debuts New Song, Discusses Chance the Rapper & the State of Hip-Hop at Tribeca Film Festival",0,3,13,67,3,16,0,80,0
The origins of Black History Month [Video],0,3,5,29,2,6,0,34,0
"Clockwatch: Premier League, Ghana v Mali, and more – as it happened",0,3,5,47,4,11,0,52,0
Akzo Nobel-PPG: Why This Trans-Atlantic Megadeal Could Actually Happen ,0,3,13,46,3,9,0,59,0
The death toll in a bomb attack on Syrian evacuees has risen to 112,0,3,2,49,0,13,3,51,0
Europe's airline chaos: in depth,0,1,1,25,2,4,0,26,0
"Wheaton Academy, Illinois boys basketball team plays Benet Academy, suffers first in-state loss",0,1,5,75,3,12,0,80,0
MLB tries to keep young Dominicans from dying behind the wheel. It’s not working.,0,2,5,60,3,13,0,65,0
"Zoe Saldana And Her Husband Welcomed Their Third Son, Zen, To The World",0,3,13,44,2,12,0,57,0
500 stranded melon-headed whales rescued in Philippine bay,0,1,1,46,1,7,3,47,0
Trump sidesteps Russia inquiry at Kentucky rally ,0,3,3,39,0,7,0,42,0
Hillary Clinton Broke Down How Impossible It Is For Ambitious Women To Be 'Likable',0,3,14,54,2,13,0,68,0
Pink and husband Carey Hart welcome a son,0,2,3,31,0,7,0,34,0
Chinese Luxury Homes in Demand as Cities Post World's Best Gains,0,3,9,44,1,10,0,53,0
These festive holiday cards are perfect for the typography enthusiast,0,2,1,59,0,9,0,60,0
New Zealand holiday road toll: 20 fatalities,0,1,2,33,1,6,2,35,0
"As North Korea fires missiles, some in Japan want the ability to launch strikes",0,3,4,61,1,13,0,65,0
Resilience of the Resistance ,0,3,2,23,0,4,0,25,0
Nail-biting moment that a helpless dog is winched up to safety from a well by children using a makeshift lasso,0,3,1,89,1,19,0,90,0
Canadian 2007 Genie Award nominations announced,0,1,3,35,0,5,4,38,0
"Police ease rules on tattoos, turbans, beards ",0,3,1,36,2,7,0,37,0
Wow! Tesla’s ‘mass market’ Model 3 is sexy and fast,0,2,3,34,4,9,1,37,0
Emerging Markets Suffer Largest Outflow in Seven Years,0,2,7,40,0,7,0,47,0
New DNC Leader Vows United Democrats Will Be Trump's Nightmare,0,2,12,40,1,9,0,52,0
"St Petersburg explosion: Subway blast was suicide attack, Russian investigators say",0,2,4,67,2,10,0,71,0
Watch Live: Reactions to Circuit Court Ruling Against Trump's Immigration Ban Executive Order,0,3,12,67,2,12,0,79,0
"Belgium Commemorates Waterloo With a Coin, and France Is Not Pleased ",0,3,9,48,1,11,0,57,0
Stock exchange merger could end San Francisco stock trading,0,1,3,48,0,8,0,51,0
"Video shows armless basketball player, 13, winning game with last second shot ",0,3,1,61,2,12,2,62,0
This Watermelon Ceviche Recipe Hits The Perfect Balance Of Salty And Sweet,0,3,12,51,0,11,0,63,0
The kids suing Donald Trump are marching to the White House,0,3,5,44,0,10,0,49,0
Budweiser turned a classic '90s Super Bowl ad into a Snapchat game,0,3,4,48,1,11,2,52,0
Spaghetti source: Inside the history of pasta production,0,3,2,46,1,7,0,48,0
NASCAR: Edwards wins 2010 Ford 400; Johnson claims championship,0,1,9,37,2,8,7,46,0
"Clinton Foundation to restrict foreign, corporate donations if Hillary Clinton wins",0,2,4,68,1,10,0,72,0
A Corner of the Soccer Field That No U.S. Player Has Claimed,0,1,11,36,2,11,0,47,0
Anwar's lawsuit over gay slur by former Malaysian premier is dismissed,0,1,2,57,1,10,0,59,0
"With Her Oscar Win, Viola Davis Is One Grammy Away From An EGOT",0,3,16,34,1,12,0,50,0
Uber Executive: Workplace Culture Needs a Lot of Work,0,3,7,37,1,8,0,44,0
India's Cash Woes Are Just Beginning,0,3,6,24,1,5,0,30,0
Charity Accounts Become the Hot Holiday Must-Have,0,2,7,35,1,6,0,42,0
A sleep doctor explains how your sleep position could cause wrinkles,0,3,1,57,0,10,0,58,0
"As Scandal Roils South Korea, Fingers Point to Mixing of Politics and Business ",0,2,10,55,1,13,0,65,0
Professor Tied to Shootings Found Dead,0,1,5,28,0,5,0,33,0
Mariano Rivera Jr to Nationals: Twitter Reacts as RHP Selected in 2015 MLB Draft,0,3,14,48,1,13,4,62,0
Syrian Band Brings Music of Aleppo to Berlin,0,2,6,31,0,7,0,37,0
Iran's ex-president Ali Akbar Hashemi Rafsanjani dies at 82,0,3,5,42,2,8,2,47,0
Dave Chappelle Roasts Trump Supporter During Stand-Up Set,0,3,9,40,1,7,0,49,0
The Story Behind a Well-Timed Photo of Debbie Reynolds and Carrie Fisher ,0,3,10,50,1,12,0,60,0
Trump’s Trade Rep Pick Gets Some Actual Praise From Progressives,0,2,10,44,1,9,0,54,0
"For First Time Since 1800s, Britain Goes a Day Without Burning Coal for Electricity ",0,2,11,54,1,14,4,65,0
Cleveland Browns Robert Griffin III Injury: Updates on Browns QB's Shoulder and Return,0,3,14,58,2,12,0,72,0
JK Rowling and Piers Morgan engage in Twitter spat over talk show row with Jim Jefferies,0,3,8,65,0,15,0,73,0
Trump Revives Voter Fraud Claims in Lunch With Senators ,0,2,8,39,0,9,0,47,0
"Boy, 12, arrested trying to drive across Australia avoided suspicion because 'he is 6ft tall and looks 19'",0,2,2,78,4,17,5,80,0
Journalist: Trump brought Electoral map handouts of his wins to interview,0,2,3,59,1,10,0,62,0
Weed Weddings Are Now a Thing,0,2,5,19,0,5,0,24,0
A Memphis Mural Goes Beyond Stereotypes,0,1,6,28,0,5,0,34,0
Dolphins fear ACL injury for QB Ryan Tannehill,0,3,8,31,0,7,0,39,0
"Vandals spill 400,000 bottles of Italian sparkling wine in act of 'sabotage'",0,2,2,54,3,11,6,56,0
15 Home Decor Tips From Joanna Gaines That You’ll Want To Steal Immediately,0,3,12,48,1,12,2,60,0
People in Iceland are being left off the weather map and they're pissed,0,3,2,56,1,12,0,58,0
Meetup leaps into the Trump resistance movement,0,3,2,39,0,6,0,41,0
Man Accused of Killing Five in Washington State Mall Massacre Found Dead in Jail Cell,0,3,12,59,0,14,0,71,0
Los Angeles Mayor Eric Garcetti wins second term ,0,3,5,36,0,8,0,41,0
Merck-Schering Merger Awaits Reaction From Johnson & Johnson,0,1,8,43,2,7,0,51,0
US infant mortality rates down 15%,0,3,2,24,1,5,2,26,0
Ex-judge Richard Gee dies after being found in swimming pool,0,2,3,47,1,9,0,50,0
"Brock Lesnar, John Cena Lead The List Of WWE's Highest-Paid Wrestlers",0,3,14,42,3,10,0,56,0
In Aaron Hernandez’s Jail Cell: Three Handwritten Notes Found Beside Bible,0,2,11,51,2,10,0,62,0
Lakers Survive Slow Start to Take 3-1 Series Lead,0,1,7,31,1,8,2,38,0
"Trump tries to move past controversies, says he is keeping promises",0,2,1,55,1,10,0,56,0
Stop looking at me! Confused rooster has a staring contest with its own reflection and then tries to ATTACK it,0,2,8,82,1,19,0,90,0
Tesla blog post declares the Model S superior to the Model 3,0,2,4,44,0,11,1,48,0
House to vote Thursday on health care bill: GOP leader,0,2,5,39,1,9,0,44,0
"Thank You, Censor Board! Lipstick Under My Burkha Is Now Eligible For Golden Globes",0,2,14,54,2,13,0,68,0
Third major earthquake rocks California,0,1,2,33,0,4,0,35,0
Tomi Lahren’s Fall From Conservative Grace Has Been a Long Time Coming,0,3,11,47,1,11,0,58,0
President of Guinea-Bissau assassinated,0,1,3,32,1,3,0,35,0
"The 10-Point: Gerard Baker on Deutsche Bank Resignations, Trade Agreements, Turkey Elections and More",0,2,12,70,4,13,2,82,0
Nick Xenophon defends deal to pass Government's company tax cuts,0,2,3,51,1,9,0,54,0
"‘Ninjas came to my home and killed my family,’ boy tells police after Alaska slayings",0,3,2,66,3,14,0,68,0
Catholic Church paid A$276m to abuse victims in Australia,0,3,4,41,1,8,3,45,0
Moto GP rider Marco Simoncelli dies in 2011 Malaysia Grand Prix,0,1,8,41,0,10,4,49,0
This dentist put a 'Where's Wally' scene on his ceiling for patients The list,0,2,4,57,3,13,0,61,0
"In Israeli Vote, With Two Parties Nearly Tied, the Winner Is Gridlock",0,1,11,45,2,11,0,56,0
Finland claims second world record for karaoke,0,1,1,39,0,6,0,40,0
Watch a Trump surrogate get shut down after calling Trump the 'Martin Luther King of healthcare',0,3,6,73,2,15,0,79,0
Transgender Sister Of Singer At Trump Inauguration Wins Federal Court Bathroom Ruling,0,3,12,62,0,11,0,74,0
17 Arrested In Kim Kardashian Paris Jewelry Heist: Update,0,2,8,38,1,8,2,46,0
Colson Whitehead on George Saunders’s Novel About Lincoln and Lost Souls ,0,3,9,52,1,11,0,61,0
EPA declares 'emergency' asbestos cleanup in Montana town,0,1,4,44,2,7,0,48,0
Weak Federal Powers Could Limit Trump’s Climate-Policy Rollback ,0,3,9,45,2,8,0,54,0
"David Brock: Democrats ’in a Bad Situation,’ Hillary Loss ’Exposed the Lack of Democratic Power’ - Breitbart",0,2,12,73,7,16,0,85,0
NFL Free Agency 2017: Which Teams Have Improved the Most so Far?,0,3,11,36,2,11,4,47,0
Officials admit that China faked part of Olympics opening ceremony,0,1,3,54,0,9,0,57,0
Commuter chaos in Sydney after wind damages lines on Harbour Bridge,0,1,4,53,0,10,0,57,0
Off to Practice Before a Round of Golf? Think Again,0,1,7,34,1,9,0,41,0
Leicester fans sing 'Gibraltar is ours' in clashes with Spanish police ahead of Atletico Madrid quarter-final,0,2,5,86,3,15,0,91,0
"Altidore, Afterthought in Spanish League, Stars for the U.S.",0,1,7,41,4,8,0,48,0
Rajinikanth's Daughter Aishwarya To Perform Bharatnatyam At UN Headquarters On Women’s Day,0,2,13,64,2,11,0,77,0
"Berkshire, Buffett More Than Double Stake in Apple",0,3,7,35,1,7,0,42,0
2010 FIFA World Cup: Spain beats Chile; both go to second round,0,1,8,38,2,11,4,46,0
"Flights, massages and other freebies to enjoy on Tax Day",0,2,3,43,1,9,0,46,0
"Skype launches ""Unlimited"" monthly service to change communication style",0,1,2,60,2,8,0,62,0
England and Wales Director of Public Prosecutions to seek bomb plot retrial,0,1,5,59,0,11,0,64,0
"As Indian Growth Soars, Child Hunger Persists",0,1,7,31,1,6,0,38,0
The history of Henry Mancini's Moon River,0,3,5,29,1,6,0,34,0
Pentagon Reaches New Deal With Lockheed Martin for F-35 Jets ,0,2,9,39,1,10,2,48,0
7 undercover inmates spent 2 months in jail — here are the most outrageous things they witnessed,0,2,0,77,1,16,2,77,0
"With a Reunion Up Next, Bush Eases Back Into the Public Eye",0,1,10,37,1,11,0,47,0
Mexican cartoonist Gabriel Vargas dies at 95,0,1,3,33,0,6,2,36,0
George Michael’s Family Say They Will Not Speculate Over How He Died,0,3,12,44,1,11,0,56,0
Australian rules football: 2010 Gippsland Football League finals week one,0,1,4,55,1,9,4,59,0
Trump's absurd statement on health care gets trolled because how could it not?,0,3,1,63,2,12,0,64,0
Philippine ministry asks Duterte to clarify military’s role in drug war,0,2,2,58,1,10,0,60,0
Demi Lovato Says She's 1 Percent African -- And Twitter Absolutely Loses It,0,3,11,48,3,12,1,59,0
Hong Kong 'tutor king' applies for bankruptcy,0,1,2,35,2,6,0,37,0
"Nearly Half Of Syrian Refugee Kids Are Not Attending Schools In Turkey, Says UNICEF",0,3,19,50,1,13,0,69,0
"Drugmaker fined $100M for hiking price 85,000%",0,3,2,27,3,6,8,29,0
100-Mile-Long Crack in Antarctic Ice Shelf Keeps Growing,0,3,8,36,2,7,3,44,0
People are sharing #DisabledAndCute photos to fight stigma The list,0,3,5,52,1,9,0,57,0
Scientists confirm new superheavy element,0,1,1,36,0,4,0,37,0
Father of newborn baby girl found BURIED ALIVE in a field in India is arrested for attempted manslaughter ,0,2,13,75,0,18,0,88,0
Olympic Committees Work to Resolve Revenue-Sharing Dispute,0,1,7,44,1,6,0,51,0
Big Apple Circus springs back to life,0,3,3,28,0,6,0,31,0
Humpback whales dying at alarming rate off East Coast ,0,3,3,42,0,9,0,45,0
Oregon running back LeGarrette Blount's college football career ends with a punch,0,1,4,65,1,11,0,69,0
"Seeking Re-election, Barroso Sweats for His Job",0,1,6,33,2,6,0,39,0
Dark: Netflix's new German-language drama series looks terrifying,0,3,3,52,3,7,0,55,0
Judges Plead Guilty in Scheme to Jail Youths for Profit,0,1,7,39,0,9,0,46,0
Damaged DNA Evidence Shrinks Serial Killer Case,0,1,9,32,0,6,0,41,0
US nuclear security director asked to resign,0,1,2,36,0,6,0,38,0
Studying at Aleppo University: 'You get used to seeing blood on the floor',0,2,4,55,3,12,0,59,0
Moon shot! SpaceX announces plans to send 2 'private citizens' around moon ,0,2,3,56,3,12,1,59,0
Baby pygmy hippo in debut splash,0,2,1,26,0,5,0,27,0
'A runaway crisis': Argentina activists aid shanty towns state has left behind,0,3,2,62,3,11,0,64,0
Australians Rage Against Arson Suspect,0,1,5,29,0,4,0,34,0
"1,000-Year-Old Iconic California Tree Topples During Weekend Storms",0,3,9,44,3,7,4,53,0
TRUMP: 'I would have far less reason to tweet' if the media covered me 'honorably',0,2,6,57,5,14,0,63,0
The Masters Tops The List For Private Aviation Travel To Sporting Events,0,3,12,49,0,11,0,61,0
Morgan Heritage Wants Everyone to Feel Good on 'Reggae Night': Premiere,0,2,9,49,3,10,0,58,0
China Wins Big With Stakes in $22 Billion Abu Dhabi Oil Venture,0,3,10,39,1,11,2,49,0
A Mexican Tradition Runs on Pageantry and Faith,0,1,6,34,0,7,0,40,0
"U.N. Report: 2,000 Killed in Turkey Since End of PKK Cease-Fire",0,3,12,32,5,10,4,44,0
Oculus unveils new prototype 'Virtual Reality' headset,0,1,3,43,2,6,0,46,0
Wikipedia publishes 10 millionth article,0,1,1,33,0,4,2,34,0
U.S. Service-Sector Activity Surged in November,0,3,7,32,3,5,0,39,0
Insurers paid out $50bn for natural disaster claims in 2016,0,2,1,42,1,9,6,43,0
Suspect in 2001 anthrax attack dies of apparent suicide,0,1,1,42,0,8,4,43,0
Google has a new plan to cripple the iPhone app-store model and rule the mobile world,0,2,2,67,1,15,0,69,0
EU launches channel on YouTube,0,1,4,22,0,4,0,26,0
Michael Jackson's Son Prince Pays Tribute to Dad With New Tattoo,0,2,10,43,1,10,0,53,0
"Trump’s News Conference, Russia, Facebook: Your Evening Briefing ",0,3,8,45,4,8,0,53,0
The disappearance of Jonathan Spollen,0,3,3,30,0,4,0,33,0
Franken: 'We don't know what the Russians have on Donald Trump' ,0,3,5,44,4,11,0,49,0
Missouri airports may soon serve alcohol to go ,0,3,1,38,0,8,0,39,0
Amber alert issued for missing Utah girl,0,1,2,32,0,6,0,34,0
Kevin Durant Hires Extra Security for Return to Oklahoma City,0,3,8,44,0,9,0,52,0
Terror suspects arrested in connection with bombing public bus in Israel,0,1,2,60,0,10,0,62,0
"King of Tonga to hand power to Prime Minister, ending era of absolute monarchy",0,1,4,60,1,13,0,64,0
"France Lets Workers Turn Off, Tune Out and Live Life ",0,3,9,33,1,10,0,42,0
"Pence: Congress wasn't ready to repeal, replace Obamacare ",0,3,3,44,3,8,0,47,0
Lance Stephenson Reportedly to Sign with Minnesota Timberwolves,0,3,6,50,0,7,0,56,0
24 Million People Stand To Lose Insurance Under GOP Obamacare 'Replacement',0,3,12,49,2,10,2,61,0
2016 No. 1s: Iggy Pop on Working With Josh Homme: 'I Was Looking to Do a No. 1 Album',0,3,13,42,6,18,6,55,0
ESA's ExoMars Prepares To Sample Lower Martian Atmosphere,0,3,11,38,1,7,0,49,0
Venezuela Government Said to Sell $5 Billion of New Dollar Bonds,0,3,8,44,1,10,1,52,0
Judge Declines To Release Dreamer Swept Up Under Trump's New Deportation Wave,0,3,12,53,1,11,0,65,0
"MP CM Attends Wedding Of Late Bhopal Jail Employee's Daughter, Gifts Her A Job Appointment Letter",0,2,18,62,2,15,0,80,0
Consumers Take a Credit-Card Breather ,0,3,5,27,1,5,0,32,0
Gambling industry finds plenty of political guns for hire to defend the status quo,0,2,1,68,0,13,0,69,0
President Trump’s Official Twitter Account Was Registered To A Personal Gmail Address,0,2,12,61,1,11,0,73,0
‘Sherlock’ Opens Up the Old Boys’ Club to Women ,0,3,7,29,3,9,0,36,0
Severe morning sickness — known as HG — can leave women starving,0,2,3,48,2,11,0,51,0
"China puts new weapons on South China Sea islands, report says",0,3,4,47,1,10,0,51,0
Briton jailed for three decades in US gets chance to prove innocence,0,3,3,54,0,11,0,57,0
Grieving Sisters Say 'Rude' Flight Attendant Led to Their Removal From Flight - Yahoo,0,3,12,57,3,13,0,69,0
Ford recalls F-250 trucks because of roll away risk,0,2,2,37,1,8,3,39,0
Marijuana Prices Fall In 2016 As Growers Flood The Market With Pot,0,2,11,40,0,11,4,51,0
13 Ordinary Things You Use Everyday And The Not-So-Ordinary Stories Behind Them,0,3,13,51,2,11,2,64,0
"Two alligators involved in Disney World attack on boy, says father",0,2,3,52,1,10,0,55,0
"Nine dead, scores injured after bombing in Iran",0,1,2,37,1,7,0,39,0
Top-Ranked Men and Women Focused on Australian Open Title,0,1,8,40,1,8,0,48,0
"Two killed, two seriously injured after boulder collapses onto house in Stein an der Traun, Germany",0,1,4,78,2,15,0,82,0
A South American country wants Trump to deport its former president,0,2,4,53,0,10,0,57,0
Tainted Supplements Raise New Questions for Sports Leagues,0,1,7,44,0,7,0,51,0
The Sketchy Ethics of Donald Trump Jr.’s Speech,0,2,7,31,2,7,0,38,0
Indonesian police kill two militants in raid on house in Java,0,3,2,49,0,10,0,51,0
"Girls, 11 and 12, Shot in Head in Separate Chicago Attacks ",0,3,6,36,2,11,4,42,0
"After Less Than A Week Of GOP Control, Kentucky Passes 20-Week Abortion Ban",0,3,15,44,2,12,2,59,0
"In Mr. Pence’s new D.C. neighborhood, not exactly the welcome wagon",0,2,5,47,5,10,0,52,0
Trump’s Commerce Department Pick Wilbur Ross to Sever Ties to His Firm to Avoid Financial Conflicts ,0,3,13,70,1,16,0,83,0
NASA solar sail passes first major test,0,1,4,29,0,6,0,33,0
Extra-terrestrial life more likely after NASA discovery about Saturn's moon Enceladus,0,2,7,66,2,10,0,73,0
"Isaiah Thomas 'Struggling' After Sister's Death, Plans to Play, Per Brad Stevens",0,3,11,53,5,11,0,64,0
Donald Trump To Nominate Scott Brown As Ambassador To New Zealand,0,3,11,44,0,10,0,55,0
Boorishness Works for Berlusconi,0,1,3,26,0,3,0,29,0
Here are all the comic book movies coming out in 2017,0,3,1,38,0,10,4,39,0
'Justice failed Austin Callaway': Town attempts to atone for 1940 lynching,0,2,4,53,3,10,4,57,0
Loan-servicing company crashes after regulator says big errors cost borrowers their homes,0,3,1,76,1,11,0,77,0
Gronk Reveals Why He Goes Sleeveless…and Why He Won't Need to Anymore,0,3,11,45,2,11,0,56,0
Endangered Luzon Buttonquail photographed alive by Philippines documentary,0,1,4,63,0,7,0,67,0
"Watch Pedro CapÃ³, Luis Figueroa and Christian PagÃ¡n Perform at the 2017 Billboard Latin Music Awards",0,3,14,66,2,15,5,80,0
"Filly Champions Are Rare, but Rachel Alexandra Is No Ordinary Filly",0,1,10,46,1,10,0,56,0
Twitter Dragged Paul George for Missing Final Shot After Saying He Should Take Final Shot,0,3,14,61,0,14,0,75,0
Ex-Apple Executive Is Named Chief of Palm,0,1,7,27,1,6,0,34,0
World's oldest leather shoe found in Armenia,0,1,2,35,1,6,0,37,0
"86-year-old woman beat killer with walking stick during attack, friend says",0,3,0,60,3,10,2,60,0
Ex-British PM cracks joke about Trump's wiretap claim,0,3,5,39,2,7,0,44,0
"California mom run over, killed while mourning slain relative",0,3,1,51,1,8,0,52,0
Brazil opens first elephant sanctuary,0,2,1,32,0,4,0,33,0
India police detain six suspects over NYE attacks on women amid 'copying Westerners' furore,0,2,5,71,2,13,0,76,0
New Zealand policeman caught speeding,0,1,2,31,0,4,0,33,0
"""Apprentice"" contestant sues Trump for defamation",0,3,2,40,2,5,0,42,0
Were New Orleanians caught in political crossfire?,0,1,3,40,1,6,0,43,0
"Gerardo Ortiz & La Septima Banda Announce '2 Mundos, Una Historia 5' U.S. Tour",0,2,12,45,6,13,2,57,0
Donald Trump Spent His Sunday Morning Beefing With Mark Cuban on Twitter,0,3,11,50,0,11,0,61,0
Russia Begins War Games Near Georgia,0,1,6,25,0,5,0,31,0
This London Underground advert is causing a massive sexism row The list,0,3,4,56,0,11,0,60,0
Barack Obama only mentions Donald Trump by name once in his farewell speech,0,3,4,59,0,12,0,63,0
Large earthquake strikes coast off French Guiana,0,1,3,39,0,6,0,42,0
Malcolm Turnbull indicates opposition to allowing super for home deposits,0,3,2,62,0,9,0,64,0
Clinton staffers considered joking about email server the day before congressional subpoena,0,2,1,79,0,11,0,80,0
Tillerson: Russia 'failure allowed Syria chemical attack',0,3,3,45,3,6,0,48,0
At least fourteen dead after eating toxic fish in Madagascar,0,1,2,49,0,9,0,51,0
"Election Commission Issues Notice To Sakshi Maharaj On '4 Wives, 40 Children' Comment",0,3,11,56,3,12,3,67,0
Coast Guard seizes 16 tons of cocaine worth over $400M in Pacific ,0,2,4,44,1,12,5,48,0
Twitter Stock Falls Following COO Departure - Breitbart,0,2,9,38,1,7,0,47,0
"New Mix: Explosions In The Sky, Parquet Courts, Wire, Told Slant, More",0,2,12,42,5,11,0,54,0
Why Apple’s Critics Are Right This Time,0,2,7,25,1,6,0,32,0
Northern Cyprus opposition party wins elections,0,1,2,40,0,5,0,42,0
Officials: Chemical in Texas city water identified; warning still in place ,0,3,3,59,2,11,0,62,0
Austrian students protest new government's student fees plan,0,1,1,51,1,7,0,52,0
Italy Just Handed the Global Economy Another Giant Variable ,0,3,8,43,0,9,0,51,0
"Snapchat Video Appears to Show Ian Kahaloa Drug Use, Reds Release Statement",0,3,11,52,1,11,0,63,0
Split Up the Ninth Circuit,0,2,4,18,0,4,0,22,0
Former Pantera-guitarist Dimebag Darrell killed on stage,0,1,4,45,1,6,0,49,0
Brazilian President: not continuing to use biofuels would be a 'crime against humanity',0,1,2,70,3,12,0,72,0
Belly & Future Link Up for Trippy 'Frozen Water' Video: Watch,0,2,9,38,4,10,0,47,0
Celtics well aware that Bulls' Rajon Rondo steps up when it matters,0,3,4,51,1,11,0,55,0
J.K. Rowling drops Twitter hints about a big 'Fantastic Beasts 2' plot point,0,2,6,53,4,12,1,59,0
What Is The OA Actually About?,0,2,7,17,1,5,0,24,0
Jessa Duggar Seewald and Ben Seewald welcome baby no. 2,0,3,5,39,1,9,1,44,0
Inside The Immigrant-Prosecuting Machine That Transformed America's Deportation Policy,0,3,10,66,2,8,0,76,0
A Reality Check of Trump's first week in office,0,3,4,34,1,8,0,38,0
Report Says Principal Put Dallas Students in Fight Cage,0,1,8,39,0,8,0,47,0
Adrian Peterson Won't Return to Vikings After Latavius Murray Signing,0,2,9,50,1,9,0,59,0
Monica Seles Among 4 Inducted Into Hall of Fame,0,1,7,31,0,8,1,38,0
USA under pressure at climate talks,0,1,3,27,0,5,0,30,0
Newtown leaders call on Trump to denounce Sandy Hook conspiracies,0,2,4,52,0,9,0,56,0
Tough Choices Loom on Long Road to Replacing Obamacare,0,2,7,39,0,8,0,46,0
Bomb blasts kill several in Iran,0,1,2,25,0,5,0,27,0
Second hack of federal records hit intelligence and military personnel,0,2,1,60,0,9,0,61,0
Ed Sheeran Just Revealed He’s Releasing New Music This Week,0,3,10,39,1,9,0,49,0
"'Blade Runner 2049' First Teaser Introduces Ryan Gosling to Harrison Ford: ""I Had Your Job Once""",0,3,14,58,5,15,4,72,0
"Charmian Carr – Liesl von Trapp in The Sound of Music – dies, aged 73",0,2,7,43,3,14,2,50,0
Diver Captures Underwater Video Of Sudden 5.6 Magnitude Earthquake,0,3,8,47,1,8,2,55,0
Bill Gates Urges Sharper Military Focus on Bioterror ,0,2,7,38,0,8,0,45,0
Can playing Tetris ease our minds after a trauma? A study suggests it can.,0,2,3,56,2,13,0,59,0
Kate McKinnon Returns to Troll Jeff Sessions as Forrest Gump in 'SNL' Cold Open,0,3,14,50,2,13,0,64,0
"Police discover five bodies in Victoria, Canada home",0,1,3,41,1,7,0,44,0
"Spurs honor Richard Overton, the oldest living U.S. veteran at Military Appreciation Night",0,3,8,67,3,12,0,75,0
NHL: Detroit wins the 2008 Stanley Cup,0,1,6,21,1,6,4,27,0
Gordon Brown: I can lead Britain through economic crisis,0,1,4,43,1,8,0,47,0
Obama urges Cameron to keep 2% defence spending target,0,2,2,42,1,8,1,44,0
GOP congressman: Democrats acting the same way they did leading up to Civil War,0,3,6,59,1,13,0,65,0
Call for compulsory driving tests at 70 after young mother mown down,0,3,1,54,0,11,2,55,0
Here's the perfect way to participate in Random Acts of Kindness Week,0,3,5,52,1,11,0,57,0
Saturn moon Enceladus may have salty ocean,0,1,2,34,0,6,0,36,0
Mexico OKs Trump trademarks for hotels and tourism industry ,0,3,4,47,0,9,0,51,0
Cricket's pregnancy clause wars: Proxy battle over growing revenue stream?,0,2,2,60,3,9,0,62,0
PC Palmer deserved our respect. We owe it to all public-sector workers,0,3,4,53,2,11,0,57,0
"Dozens dead in twin Damascus bombings, says rights monitor",0,2,2,47,1,8,0,49,0
'Expelled' producers accused of copyright violations,0,1,1,44,2,5,0,45,0
Hundreds Of Queer People Held A Guerrilla Dance Party Outside Mike Pence's Home,0,3,13,53,1,12,0,66,0
Does your house make more money in a year than you do from your day job?,0,3,1,55,1,15,0,56,0
New Search Technologies Mine the Web More Deeply,0,1,7,34,0,7,0,41,0
Space Shuttle Atlantis completes mission STS-122,0,1,6,33,1,5,3,39,0
"Jill Stein, US Green Party candidate, drops election recount bid in Pennsylvania",0,3,7,60,2,11,0,67,0
Mexico City legalises gay marriages,0,1,2,29,0,4,0,31,0
The ‘Sioux Chef’ Reviving Native American Cuisine,0,2,7,34,2,6,0,41,0
"China: Heavy flooding displaces over a million, kills dozens",0,1,2,48,2,8,0,50,0
No Need To Stand Up If The National Anthem Is Played In A Film's Storyline Says Supreme Court,0,3,18,57,1,17,0,75,0
"Marvin Wilson settles National Signing Day ‘second thoughts,’ commits to FSU",0,3,8,55,3,10,0,63,0
"In stark farewell, Obama warns of threat to U. S. democracy",0,2,4,42,3,10,0,46,0
UK Mobile Data Network Collapses,0,1,6,22,0,4,0,28,0
Australian MPs demand Islamic headscarf ban in schools,0,1,4,43,0,7,0,47,0
Obamas begin moving possessions into luxury new home ahead of White House exit ,0,3,3,63,0,13,0,66,0
Oil Hovers in Tight Trading Range Amid Global Supply Tug of War,0,3,10,42,0,11,0,52,0
Museum Shuts Down Shia LaBeouf's Anti-Trump Installation Over Safety Concerns,0,2,12,54,2,9,0,66,0
Sonos Founder John MacFarlane Stepping Down as CEO,0,3,10,33,0,7,0,43,0
Coroner says Michael Jackson's death was due to sedative overdose,0,1,3,52,1,9,0,55,0
"Most Of Bengaluru's 1.5 Million Two-Wheeler Riders Choose To Go Helmetless, Cops Plan To Provide Free Headgear",0,3,17,71,4,16,2,88,0
Google Executive to Replace Two Fired From AOL,0,1,9,30,0,7,0,39,0
Harry Winks: ‘The buzz I get from playing for Tottenham … I don’t think it will ever go’,0,3,6,60,5,17,0,66,0
Man in Thailand streams murder of baby daughter on Facebook Live before killing himself,0,3,4,70,0,13,0,74,0
US avoids Syria talks as deadly explosion rocks refugee camp,0,3,3,48,0,9,0,51,0
"Premiere: Meek Mill Drops ""King"" Off Ethika's New 'RGB' Mixtape",0,3,12,36,6,9,0,48,0
Google's dream of a steering-wheel-free future is reportedly being curtailed,0,3,1,63,3,9,0,64,0
163 dead after lead poisoning in Nigeria,0,1,1,30,0,6,3,31,0
McDonald's gives up control of its China business in $2 billion deal,0,3,3,51,2,11,1,54,0
Lady Gaga Super Bowl halftime show to feature hundreds of drones in aerial light show ,0,2,4,67,0,15,0,71,0
Tennessee wildfires: Death toll rises to 11,0,3,2,32,1,6,2,34,0
China Population Crisis: New Two-Child Policy Fails To Yield Major Gains,0,3,12,48,2,10,0,60,0
"Gunman In Zurich Mosque Shooting Is Dead, Police Say",0,3,9,34,1,8,0,43,0
Donald Trump to hold talks with Vladimir Putin 'within weeks' of becoming President,0,3,5,64,2,12,0,69,0
Trevor Noah: Trump's Executive Orders Prove He Should've Seen 'Hamilton',0,2,10,48,5,9,0,58,0
"Despite 50% Gain, Banks Yet to Win Over Europe Fund Managers",0,3,9,37,2,10,2,46,0
Surgeon claiming he will transplant volunteer's HEAD to another body says he needs America's help to do it,0,2,6,81,2,17,0,87,0
‘Not My President’s Day’: Thousands Protest at Anti-Trump Rallies Across U.S.,0,3,12,48,7,10,0,60,0
Oscars red carpet 2017: Best-dressed stars from Hollywood's big night,0,3,3,50,3,9,4,53,0
"100 days of Russia drama for the Trump White House, with no end in sight",0,2,4,50,1,14,3,54,0
"Trump to slash State Department budget by 28 percent, shift money to defense ",0,3,3,58,1,13,2,61,0
Outsiders Selected by Trump Aim to Unnerve Washington ,0,3,6,40,0,8,0,46,0
Time magazine asks Trump to remove fake covers from display at golf clubs,0,2,2,59,0,12,0,61,0
Donald Trump says US relations with Russia 'may be at all-time low',0,3,5,48,3,11,0,53,0
The 10 NBA Free Agents Most Likely to Be Overpaid in 2017 Offseason,0,2,11,38,0,12,6,49,0
Turkish Cargo Plane Crashes into Kyrgyz Village,0,3,6,35,0,6,0,41,0
A Look at New State and Local Laws in 2017,0,2,6,23,0,9,4,29,0
"Senate confirms Pompeo as CIA director, Tillerson clears committee vote ",0,3,6,55,1,10,0,61,0
Obama Reluctant to Look Into Bush Programs,0,1,6,30,0,6,0,36,0
Male survivors of sex assaults often fear they won’t be taken seriously,0,2,1,58,1,11,0,59,0
Estonian soldier killed in southern Afghanistan,0,1,2,40,0,5,0,42,0
UK employment falls in months after Brexit vote,0,3,3,37,0,7,0,40,0
'Fearless Girl' statue will stay through early next year,0,3,2,44,2,8,0,46,0
Storing IP-addresses of Swedish copyright infringers deemed illegal,0,1,4,55,1,7,0,59,0
"From Elle to Game of Thrones, why is culture obsessed with rape?",0,2,4,47,2,11,0,51,0
"Massimino, an N.C.A.A. Winner, Becomes N.A.I.A. Success",0,1,12,27,10,6,0,39,0
House Bill Expected on F.D.A. Control of Tobacco,0,1,8,30,3,7,0,38,0
Bush meets with President of Guatemala,0,1,3,30,0,5,0,33,0
Celebrity deaths in 2016 captured in one heartbreaking photo ,0,2,1,47,0,9,4,48,0
Joy Villa's Grammy Trump Dress Boosts Album Sales,0,3,8,33,1,7,0,41,0
"In Nashville, a Ballot Measure That May Quiet All but English",0,1,9,41,1,10,0,50,0
Here’s the Final Version of the Oculus Rift — and Some Insane New Controllers,0,2,9,53,2,13,0,62,0
Insurer Lincoln National to Take Bailout Money,0,1,6,34,0,6,0,40,0
Bill O'Reilly sexual allegations spur advertiser exodus,0,3,3,45,1,6,0,48,0
Green Party accuses Jeremy Corbyn of ‘capitulating to the Tories’ on immigration,0,2,5,62,2,11,0,67,0
Former JetSmarter President Faces Embezzlement Charges,0,3,7,42,0,5,0,49,0
New Yorkers Hold Vigil for Victims of 'Bowling Green Massacre',0,2,8,43,2,9,0,51,0
"Trevor Hoffman Keeps Low Profile, Savoring Fresh Start With Brewers",0,1,10,47,1,9,0,57,0
Japan's lunar probe performing 'smoothly' after successful launch,0,1,1,54,3,7,0,55,0
Canada's leadership debate: the Green Party will take part,0,1,3,45,2,8,0,48,0
"Vincent T. Bugliosi, Manson Prosecutor and True-Crime Author, Dies at 80 ",0,2,9,47,4,11,2,56,0
"The Bestselling Business Books, From 'Blink' To 'The Big Short'",0,3,10,39,5,9,0,49,0
"Led By Tesla, U.S. EV Sales Rocket In December, Pushing Annual Numbers To New Heights",0,2,17,50,4,14,0,67,0
James Mattis Strikes Far Harsher Tone Than Trump on Russia ,0,3,9,40,0,10,0,49,0
March for Science: Bill Nye rallies thousands in DC amid threat of Trump budget cuts ,0,3,7,62,1,15,0,69,0
"In Tour de France, French Pride Fades in Pack",0,1,7,29,1,8,0,36,0
Some baby teething toys may contain hormone-disrupting chemicals,0,3,1,55,1,7,0,56,0
Nusra Front Militants Kill Druze Villagers In Syria,0,3,8,36,0,7,0,44,0
Trump 'compromising' claims: How and why did we get here?,0,2,2,42,4,9,0,44,0
3D Glasses Can Give Your Doctor a Complete View of Your Insides,0,3,10,41,0,11,1,51,0
Trump Contradicts State Department On Iran Deal,0,2,7,34,0,6,0,41,0
Chrysler Revamp Plan Could Block Lawsuits From Current Vehicle Owners,0,1,10,50,0,9,0,60,0
GoPro finally realizes that smartphones can do exactly what its cameras can,0,3,2,62,0,11,0,64,0
Linux fifth most searched tech word on Google in 2004,0,1,2,38,0,9,4,40,0
Your ‘Z’s Might Be ‘A+’ but MyPillow Just Got Rated an ‘F’,0,3,11,29,7,11,0,40,0
Ex-Cyclone Debbie forces mass closure of Queensland schools,0,2,4,47,1,7,0,51,0
N-word written in the snow at Idaho black history museum,0,2,2,44,1,9,0,46,0
Post Malone's Debut Album 'Stoney' Is Here,0,2,7,26,3,6,0,33,0
Jordan Spieth Comments on Professional Autograph Seekers,0,3,6,44,0,6,0,50,0
"The trick to persuading Trump? Flattery, proximity and snappy pitches",0,2,3,55,2,9,0,58,0
Second body found in search for missing Missouri woman ,0,2,2,44,0,9,0,46,0
Blame the media for TV’s sequel obsession,0,2,3,31,1,6,0,34,0
Iraqi based war video game pulled by publisher,0,1,1,38,0,7,0,39,0
Here’s Why I Wear Insanely Bold Lipstick And You Should Too,0,2,11,37,1,10,0,48,0
Trump Claims Japan's Richest Tech Billionaire Will Invest $50 Billion In U.S. Business,0,3,13,55,4,12,2,68,0
Financial Crisis Stings British Expatriates,0,1,5,34,0,4,0,39,0
Trump Administration Issues Perplexing Statement on Whereabouts of Ukraine Conflict,0,3,8,66,0,9,0,74,0
Atlanta Police Admit Their Beyonce Pregnancy Tweet Backfired,0,2,8,45,0,7,0,53,0
Rangers can’t turn McDonagh injury into familiar rationalization,0,2,3,53,1,7,0,56,0
"5 Ways to Ditch Dull, Dry Skin This Winter",0,3,7,25,1,8,1,32,0
Stanley McChrystal Calls Picking Military Spending Over PBS 'A False Choice’,0,2,14,50,2,10,0,64,0
US and Vietnam begin talks to decontaminate areas affected by Agent Orange,0,1,5,58,0,11,0,63,0
Taya Kyle: John McCain Should Apologize for Calling Yemen Raid Unsuccessful  Insider,0,3,12,59,1,12,0,71,0
Brexiteers – read the 'Trump Trade Doctrine' and weep. A trade deal with Trump will harm Britain,0,3,7,69,4,16,0,76,0
Anger Over Afghan Civilian Deaths Shows Limits of U.S. Air Power,0,1,11,41,2,10,0,52,0
Trump wire-tap claim denied by ex-spy chief Clapper,0,2,2,40,2,7,0,42,0
Facebook Is Turning To Fact-Checkers To Fight Fake News,0,3,10,36,1,8,0,46,0
"Army Challenges Older Recruits, and Vice Versa",0,1,6,33,1,6,0,39,0
Ethiopia rejects UN investigation over protest deaths,0,2,3,44,0,6,0,47,0
The secret to an unforgettable smile: Chinese tour guides practice perfect grin by biting on a chopstick ,0,3,2,85,1,17,0,87,0
Mariah Carey Had A Rough Time With Her New Year’s Eve Performance,0,2,12,41,1,11,0,53,0
Ex-Ernst Partner Guilty of Insider Trading,0,1,6,30,1,5,0,36,0
Rapper Rick Ross arrested on suspicion of pot possession,0,2,3,45,0,8,0,48,0
"Trump Rejects Climate Change, but Mar-a-Lago Could Be Lost to the Sea",0,3,10,45,3,11,0,55,0
Hawaii files first lawsuit against new travel ban,0,3,1,41,0,7,0,42,0
"Diane Greene, one of the most powerful women in tech, just promised to protect other women at Google",0,2,3,78,2,17,0,81,0
Met Police officer sacked for lying about 'on-duty' late-night parking on red route,0,3,2,65,4,12,0,67,0
"Tom Cruise parody site defiant in face of Scientology threats, demands its day in court",0,1,3,69,1,14,0,72,0
A Free-Speech Case for a Debt-Ridden Age,0,1,7,25,2,6,0,32,0
Indian police accused of raping women in restive Chhattisgarh state,0,3,2,56,0,9,0,58,0
Amazon is worth almost twice as much as Walmart,0,3,2,37,0,8,0,39,0
Israel will no longer return bodies of Palestinian Hamas militants,0,3,3,54,0,9,0,57,0
Aleppo Twitter Sensation Bana al-Abed Evacuated From Syrian City,0,3,9,46,1,8,0,55,0
Obama Poll Sees Doubt on Budget and Health Care,0,1,7,32,0,8,0,39,0
What happens if we all live to 100?,0,2,1,23,1,7,3,24,0
The SEC might be about to wade into a war between Wall Street traders,0,3,6,50,0,13,0,56,0
Some Fancy Footwork in Auditions for Knicks?,0,1,5,32,1,6,0,37,0
"Icahn says Herbalife is undervalued, business can create jobs",0,2,2,50,1,8,0,52,0
She’s 59 and Fit to Jump From an Airplane,0,3,5,25,1,8,2,30,0
Wikinews previews the 2009 Queensland state election,0,1,2,40,0,6,4,42,0
"Trump Tells G.O.P. to Fall in Line, Demanding House Vote on Health Overhaul ",0,3,12,47,4,13,0,59,0
Social care reviewer condemns UK system and calls for new tax,0,3,3,48,0,10,0,51,0
How Far-Right Groups Are Using Orlando to Turn LGBT People Against Muslims and Immigrants,0,2,16,59,1,13,0,75,0
"In Trump's White House, CEOs are shaping economic policy",0,3,7,39,2,8,0,46,0
Analysis: Here’s Why Pakistan Finally Arrested Hafiz Saeed,0,3,8,41,2,7,0,49,0
Tim Berners-Lee calls for tighter regulation of online political advertising,0,3,3,63,1,9,0,66,0
Man charged with gunpoint carjackings after binmen apprehend suspect,0,3,1,59,0,8,0,60,0
"Bank of America beats on the bottom line, misses on the top",0,3,2,45,1,11,0,47,0
Afghan provincial governor killed in mosque bomb attack,0,1,1,47,0,7,0,48,0
Video shows moment bungee ride nearly turned fatal at Paris fair ,0,3,2,52,0,11,0,54,0
Mexicans march to protest Trump — but also their own leaders and politicians,0,3,2,61,1,12,0,63,0
3 jurors booted from Holmes trial after judge hears one discussed case ,0,2,1,57,0,12,1,58,0
Forging a Hot Link to the Farmer Who Grows the Food,0,1,7,34,0,10,0,41,0
Referee Appears to Push Scorekeeper During High School Basketball Game,0,2,9,52,0,9,0,61,0
Bitcoin Is an Escapist Safe Haven,0,3,5,23,0,5,0,28,0
"Once a Trump Critic, Nikki Haley Casts Herself as His Leading Diplomat ",0,3,10,48,1,12,0,58,0
"Yankees Fans Top Mets Fans in City, Poll Finds",0,1,8,29,1,8,0,37,0
"LISTEN: There's Now a New, PC Remix of a Classic Christmas Song  Insider",0,3,16,40,3,13,0,56,0
Rickey Henderson and Jim Rice Elected to Hall of Fame,0,1,7,37,0,9,0,44,0
NASA photo reveals a startling 300-foot-wide rift in Antarctic Ice Shelf,0,3,7,50,2,10,3,57,0
Senate Focuses on Price’s Obamacare Plans in Confirmation Debate,0,3,7,48,1,8,0,55,0
New Year's Day: The biggest day of the year for takeaways,0,2,4,41,2,10,0,45,0
Bo Jackson opens up about football's CTE risk,0,3,5,32,1,7,0,37,0
Lindsey Graham: House Health Care Bill Is 'Mortally Wounded',0,2,9,40,3,8,0,49,0
Steve Harvey Talks Housing With President-Elect Trump - The New York Times,0,2,12,49,2,11,0,61,0
Steve King: Nikki Haley Could Be ’Face’ Of GOP Because ’She’s Beautiful’,0,2,14,41,6,11,0,55,0
Politicians Fail to Grasp Peer-to-Peer,0,1,5,27,2,4,0,32,0
"If Voting Machines Were Hacked, Would Anyone Know?",0,2,8,33,2,7,0,41,0
New Leader Overhauls Ford Foundation,0,1,5,27,0,4,0,32,0
GNOME Project unveils latest version of Linux and Unix desktop,0,1,8,45,0,9,0,53,0
California Gets Federal Help to Ease Its Water Woes,0,1,8,35,0,8,0,43,0
Turkey lifts ban on YouTube,0,1,3,20,0,4,0,23,0
Shaq and Other Ex-NBA Players Remember the Night Biggie Died,0,2,11,39,1,9,0,50,0
Bloggers investigate social networking websites,0,1,1,42,0,4,0,43,0
"Investors Waver, but Markets Close Higher",0,1,5,30,1,5,0,35,0
Aleppo Evacuations Move Toward Conclusion,0,2,5,32,0,4,0,37,0
Study: Violent Crime And Murders Slightly On The Rise This Year In Largest Cities,0,2,14,53,1,13,0,67,0
CNN talent then and now: 'The Seventies',0,2,5,26,3,6,0,31,0
"Queen's Birthday Honours: BEM for Katie Cutler, beautician who helped mugging victim Alan Barnes",0,2,10,70,3,13,0,80,0
"Kushner Took a Stricter Approach on Ethics Than Trump, Emails Show",0,3,9,46,1,10,0,55,0
Farrah Fawcett's funeral arrangements announced,0,1,2,40,1,4,0,42,0
"Explosion, steam eruption near Grand Central Terminal in New York City",0,1,7,52,1,10,0,59,0
DEA laments that “media attention” is making it tough to put people in jail for pot,0,3,3,63,2,15,0,66,0
Where Is Oil Going Next?,0,1,5,14,1,4,0,19,0
"Free wifi trial on Sydney buses puts commuter privacy at risk, Greens claim",0,3,3,59,1,12,0,62,0
Church of England gay marriage vote thrown into chaos after members 'get confused and press wrong button' ,0,2,2,85,2,17,0,87,0
Meet the first British man to get pregnant The list,0,3,3,39,0,9,0,42,0
Report: Members of Iranian Revolutionary Guard arrested for joining 'people's movement',0,1,5,68,4,10,0,73,0
Katy Perry Debuts New Blonde Hair at Trump Portrait Unveiling,0,2,9,43,0,9,0,52,0
The Boss Baby director addresses 'timely' Donald Trump comparisons,0,2,5,51,2,8,0,56,0
An updated (and depressing) list of all the April Fools’ pranks on the Internet,0,2,4,59,3,13,0,63,0
U.S. asks Czech Republic to grant asylum to Guantanamo Bay prisoners,0,1,6,50,2,10,0,56,0
Roomba creator responds to reports of ‘poopocalypse’: ‘We see this a lot’,0,2,2,55,5,11,0,57,0
Spotlight on BOJ Moves From Monetary Policy to Market Operations,0,3,10,45,0,9,0,55,0
Tables Turn in Transaction of 2 Auto Giants,0,1,5,30,0,7,1,35,0
Red State Homes Are Luring Young Blue Buyers Inland,0,3,9,34,0,8,0,43,0
"Feeling Some Relief, the Knicks Move on Without Marbury",0,1,7,39,1,8,0,46,0
The emotional moment Obama waves goodbye to D.C.,0,3,4,35,2,7,0,39,0
Solange Just Won Her First Grammy Ever,0,3,7,25,0,6,0,32,0
Chinese yuan revalued against dollar,0,1,1,31,0,4,0,32,0
"Earnings, Not Donald Trump, Are Stocks’ Best Friend in 2017 ",0,3,8,35,3,10,4,43,0
Quebec City mosque shooting: Police charge 'lone wolf' student suspected of terrorist attack,0,3,3,74,3,12,0,77,0
"Raids of Illegal Immigrants Bring Harsh Memories, and Strong Fears ",0,3,8,48,1,10,0,56,0
Clinton pitches her foreign policy to American Legion,0,2,3,43,0,7,0,46,0
10 injured by volcanic explosion on Italy's Mount Etna ,0,3,3,40,1,9,2,43,0
Recep Tayyip Erdogan’s Narrow Win Could End Up Undermining Him,0,3,10,42,1,9,0,52,0
U2 Posts Christmas Message for Fans,0,3,5,24,0,5,1,29,0
Uzzle's 'Puzzles': 'You can't make this stuff up',0,3,3,32,7,7,0,35,0
Anti-Trump rant woman removed from Alaska Airlines plane,0,3,4,44,1,7,0,48,0
"NFL Jeremy Hill Scores TD vs. Steelers, Celebrates by Trashing Terrible Towel",0,3,13,51,2,11,0,64,0
A Fan Petition Aims to Make Carrie Fisher's Leia an Official Disney Princess,0,3,11,52,1,12,0,63,0
Scientists uncover oldest known DNA on Earth,0,1,5,33,0,6,0,38,0
Scores killed in bombings at Pakistani shrine,0,1,2,37,0,6,0,39,0
New York Giants Seize Control in NFC Wild-Card Race,0,2,11,31,1,8,0,42,0
"Twitter glitch made 560,000 people follow Trump's @POTUS account ",0,3,7,40,3,9,6,47,0
"Hormones and surgery do not make trans women 'real women', Dame Jenni Murray says",0,2,4,61,3,13,0,65,0
Ant Financial to Invest $200 Million in South Korea’s Kakao Pay,0,3,8,40,2,10,3,48,0
Yemen's war leaves children on the brink of famine,0,3,1,40,1,8,0,41,0
Jailed Navy sailor's family hopeful after Trump tells Hannity he is considering pardon ,0,3,4,69,1,13,0,73,0
Wal-Mart Is Under Pressure to Fix Its Crime Problem,0,3,9,33,1,8,0,42,0
The future president is blocking people on Twitter like there's no tomorrow,0,3,2,61,1,11,0,63,0
"Amid Protests, Asian Summit Is Canceled",0,1,6,27,1,5,0,33,0
Chad Says It Hit Rebels in Air Raids Inside Sudan,0,1,9,31,0,9,0,40,0
"Russell Westbrook: Was thanking trainer's daughter, not Kyrie Irving",0,2,5,52,3,8,0,57,0
NBC Still Waiting for a Hit From Its Hit Maker,0,1,10,27,0,9,0,37,0
Hillary Clinton’s Campaign Team Accuses Trump Strategists of Appealing to White Supremacists ,0,3,10,70,1,12,0,80,0
News Outlets Seek a Boost as Inauguration Watch Parties Are Planned,0,1,9,48,0,10,0,57,0
"Kevin Durant's Mother Wanda Wears Cupcake Shirt, Speaks on Warriors vs. Thunder",0,3,10,55,3,11,0,65,0
"NFL to expand fan access at combine, opens ticket registration",0,2,3,49,1,9,0,52,0
Rulings on Trump’s Immigration Order Are First Step on a Long Legal Path ,0,2,10,49,1,13,0,59,0
Meet Sandhurst's first Pakistani instructor,0,2,3,35,1,4,0,38,0
"ASAP Ferg And Remy Ma Rep The ""East Coast"" On New Song",0,2,15,26,2,11,0,41,0
LOOK: Climate Change Protesters Carve Message on Trump Golf Course Green  Insider,0,2,14,54,1,12,0,68,0
UN Security Council approves Libya no-fly zone,0,1,5,34,1,6,0,39,0
Hijacked Arms Ship Limps Into Port,0,1,6,23,0,5,0,29,0
Apple gives back gigabytes: iOS 9 'app thinning' feature will finally give your phone's storage a boost,0,2,3,79,4,16,1,82,0
Donald Trump inauguration: How to watch and stream the Presidential ceremony online,0,3,4,67,1,11,0,71,0
"Trump's Cabinet nominees get their day before Senate, as partisan wrangling intensifies ",0,3,3,71,2,12,0,74,0
Syria strike 'vindicates' North Korea's nuclear choice,0,3,3,42,3,6,0,45,0
VW pleads guilty to US emissions charges,0,3,4,30,0,6,0,34,0
Blake Griffin and Ryan Kalil Will Produce 'White Men Can't Jump' Remake,0,3,11,46,3,11,0,57,0
Hamas Puts Militant Yahya Sinwar in Charge of Gaza,0,2,7,35,0,8,0,42,0
"In Myanmar, Celebrating With Water, Letting Off Steam",0,1,8,36,2,7,0,44,0
Mets Can Produce Only More Late-Inning Frustration,0,1,8,35,1,6,0,43,0
Blair could face inquiry into terror vote,0,1,1,34,0,6,0,35,0
"Investors, Mindful of Negative Data, Sell Holdings",0,1,6,36,2,6,0,42,0
Appeals Court Rejects Suit by Protesters,0,1,5,30,0,5,0,35,0
Ephemeral New York ,0,3,3,13,0,3,0,16,0
Peru Floods: Woman Climbs Out of Rushing Floodwaters to Safety,0,3,8,44,1,9,0,52,0
30 Under 30 Asia 2017: Consumer Technology,0,2,4,23,1,6,8,27,0
Prison Workers Fired After Shocking Children With Stun Guns,0,1,9,42,0,8,0,51,0
"ISIS Is Winning the Social Media War, U.S. Concludes ",0,3,12,29,3,9,0,41,0
Hurricane Earl threatens eastern US,0,1,4,27,0,4,0,31,0
"Former Holy Cross Center, 'Game of Thrones' Actor Neil Fingleton Dies at Age 36",0,3,11,50,3,13,2,61,0
U.S. Hurricane Center director leaves position,0,1,4,35,2,5,0,39,0
Suicide bomber kills 30 in northwest Pakistan,0,1,2,35,0,6,2,37,0
TV presenter Vernon Kay has to deny death claims after Wikipedia article claims he is dead,0,1,5,70,0,15,0,75,0
Here's a Deeply Disturbing First Look at A&E's Docuseries 'Escaping the KKK',0,3,12,48,5,11,0,60,0
Trump-Impervious Market,0,3,3,18,1,1,0,21,0
Cory Bernardi to split with Coalition to form Australian Conservatives party,0,2,5,61,0,10,0,66,0
Tropical Storm Gabrielle eyes US east coast,0,1,5,32,0,6,0,37,0
China Outlines Plans for Making Electric Cars,0,1,6,33,0,6,0,39,0
At least four dead and hundreds of homes destroyed after week of wildfires rage throughout Texas,0,1,2,79,0,15,0,81,0
"With Another Shutout, Capitals Force Rangers to Game 6",0,1,7,37,1,8,1,44,0
Can Tom Price save Republicans from their Obamacare mess?,0,3,5,43,1,8,0,48,0
"Boys Ask Santa To Bring Military Dad Home, But Can He Deliver?",0,3,12,37,2,11,0,49,0
'Flip or Flop' stars Tarek and Christina El Moussa separate ,0,3,6,42,2,10,0,48,0
"The latest NASA images of Jupiter reveal giant, white storms in its turbulent south pole",0,3,6,67,1,14,0,73,0
Report: Teacher continued to work despite sexual assault claims ,0,2,2,52,1,9,0,54,0
Climate change is hurting U.S. corn farmers -- and your wallet,0,3,3,45,4,10,0,48,0
Krauthammer: Russia Now Knows '8 Years of Free Lunch is Over'  Insider,0,3,9,45,3,12,1,54,0
"As tensions rise with North Korea, Pence embarks on trip to Asia",0,2,5,47,1,11,0,52,0
New Guidance Issued on Military Trials of Detainees,0,1,6,38,0,7,0,44,0
"Tanker crash kills two in Brevard County, Florida",0,1,4,37,1,7,0,41,0
"Behind Chamberlain, Relieved Yankees Coast to Victory",0,1,6,40,1,6,0,46,0
"Veterans Back on Patrol, This Time to Protect Marijuana - The New York Times",0,2,11,50,2,13,0,61,0
"Amid campaign shake-up, Jeb Bush heads to Europe",0,2,4,35,2,7,0,39,0
"One Day After Epic, Syracuse Reaches Big East Final",0,1,9,33,1,8,0,42,0
"Brown Panther to miss Gold Cup at Royal Ascot, confirms Michael Owen",0,3,8,48,1,11,0,56,0
US Congressional panel claims Turkey committed genocide,0,1,4,45,0,6,0,49,0
Dutch Trains Are Now Powered By Wind,0,2,7,23,0,6,0,30,0
Trump Cites Voter Fraud in NH Without Providing Evidence ,0,3,9,39,0,9,0,48,0
"'Denmark will be attacked' says one expert, 'Denmark safe' says another",0,1,2,54,5,10,0,56,0
"Egyptian groups: Government has been kidnapping students, activists",0,2,2,56,2,7,0,58,0
"Job interviews are utterly pointless, research shows The list",0,3,2,50,1,8,0,52,0
Bombings in Iraq Kill 11 People,0,1,4,20,0,5,2,24,0
Palestinian gunmen assassinate ex-security chief,0,1,1,42,1,4,0,43,0
Who’s Going To Pay For Trump’s Wall? How About Nobody.,0,3,10,31,4,9,0,41,0
"The chain collision of Pepsi, United and Sean Spicer fail — in one meme",0,2,5,51,2,13,0,56,0
Ed Sheeran Drops Official Lyric Video for Irish-Tinged 'Galway Girl' on St. Patrick's Day: Watch,0,3,14,62,6,14,0,76,0
"ISIS claims responsibility for Baghdad bomb blasts, at least 28 killed ",0,3,5,52,1,11,2,57,0
Mystery Has Been Solved! Sachin Tendulkar Is Making His Singing Debut Alongside Sonu Nigam,0,3,14,62,1,13,0,76,0
Sophie Reade wins UK's Big Brother series 10,0,1,6,28,1,7,2,34,0
World's First Fully Mass-Produced Atlas For The Visually Impaired People Has Been Made In India,0,3,16,63,2,14,0,79,0
"How much to tip everyone in your life for the holidays, from your landlord to the mail carrier",0,3,1,75,1,17,0,76,0
"To Prove Her Love, NRI Woman Joins Sex Racket In Rajasthan That Blackmailed Wealthy People",0,2,17,58,1,14,0,75,0
"All hail the ACC, the new king of bowl season",0,2,4,31,1,9,0,35,0
"Princess Charlotte 'sleeps through night', reports Prince Charles",0,2,4,51,3,7,0,55,0
Brexit Has An Official Start Date,0,3,6,22,0,5,0,28,0
Jake Arnott: ‘I fear the sack every day from the best job I’ve ever had’,0,3,4,50,4,14,0,54,0
Australia announces levy bill to offset cost of Queensland floods,0,1,2,54,0,9,0,56,0
Colombian Constitutional Court passes presidential re-election,0,1,3,53,1,5,0,56,0
"Chess champion is ""Fritzed"" by computer",0,1,2,30,2,5,0,32,0
"Obama, at Caterpillar Plant, Lobbies for Stimulus Package",0,1,6,42,2,7,0,48,0
Syria Decries ‘Aggression’ as U.S. Launches Cruise Missiles,0,3,8,40,4,7,0,48,0
Running a Business After Doing Time,0,1,5,25,0,5,0,30,0
Salt Bae Fulfilled His Civic Duty And Wow It Was Exactly What You Would Expect,0,3,15,49,0,14,0,64,0
Former US Senator Ted Stevens among five killed in Alaska plane crash,0,1,7,51,0,11,0,58,0
What’s to be done about fake news?,0,3,1,25,2,6,0,26,0
"Trump’s Travel Ban, Aimed at Terrorists, Has Blocked Doctors ",0,3,8,41,3,9,0,49,0
Fugitive Mexican ex-governor detained in Guatemala ,0,3,3,41,1,6,0,44,0
Even Car Sales Have Been Hit by India’s Chaotic Cash Clampdown,0,3,10,41,1,10,0,51,0
Watch Latina Silence Woman's Bigoted Rant With Message Of Solidarity,0,2,10,48,1,9,0,58,0
South Korea corruption: Choi ordered to appear before hearing,0,2,3,49,1,8,0,52,0
2017 Mercedes-Benz E400 Review: Making Better Drivers of Us All,0,2,9,36,2,9,7,45,0
US stocks see 9% drop before making recovery,0,1,2,33,1,7,1,35,0
'Pangolin Princess' detained in China after posting images online of cooked wildlife,0,3,3,68,2,11,0,71,0
Alabama OC Lane Kiffin to be next head coach of Florida Atlantic,0,3,7,46,0,11,0,53,0
"U.S. Has the Capacity to Prosper, Obama and Volcker Say",0,1,8,35,3,9,0,43,0
An Earthling’s Guide to Black Holes ,0,3,5,24,1,6,0,29,0
Speed of Delphi Bankruptcy Deal Draws Scrutiny,0,1,6,34,0,6,0,40,0
"School district weighs ban of ‘Mockingbird,’ ‘Huckleberry Finn’ after complaint",0,3,4,61,5,9,0,65,0
This baby panda takes better selfies than you,0,2,1,37,0,7,0,38,0
Jennifer Aniston Has Been Laughing at Jason Bateman for 22 Years: Inside Their Friendship,0,2,11,62,1,13,2,73,0
AFP ordered to return former senator Stephen Conroy's seized documents,0,3,5,55,1,9,0,60,0
13-year-old is new pinball world champion switch-check switch-x switch-check switch-x switch-check switch-x,0,2,0,86,8,11,2,86,0
Tibet women's football team 'denied US visas',0,2,3,33,3,6,0,36,0
Study suggests 48% of US soda fountain machines have coliform bacteria,0,1,3,54,1,10,2,57,0
Badass ballerina Misty Copeland rebuts Under Armour CEO's praise of Trump,0,3,9,53,1,10,0,62,0
Janelle Monae & More Performers Announced for Women's March,0,2,7,42,2,8,0,49,0
Hazelwood's closure raises threats of east coast blackouts and manufacturers quitting Australia,0,2,2,81,1,11,0,83,0
This perfect Los Pollos Hermanos training video prepares you for 'Better Call Saul',0,3,7,62,2,12,0,69,0
"5 Dead, 7 Injured After Tornadoes in Alabama and Tennessee ",0,3,6,40,1,10,2,46,0
The Rhino-Horn Trade Returns to South Africa,0,2,7,30,1,6,0,37,0
"Vinod Khanna, India Bollywood actor, dies of cancer",0,3,4,38,2,7,0,42,0
Small-town store under fire for racist sign display,0,2,1,42,1,7,0,43,0
Donald Trump Is Helping Republicans Make It Harder To Vote,0,3,10,39,0,9,0,49,0
South Australian father and daughter in sexual relationship,0,1,2,50,0,7,0,52,0
"Hey, Siri: How'd you and every other digital assistant get its name?",0,3,3,50,4,11,0,53,0
Russia accuses Foreign Secretary Boris Johnson of trying to start a new Cold War,0,3,7,60,0,13,0,67,0
"ATTACK AT THE LOUVRE: Machete-wielding man shouting ‘Allahu akbar’ stopped by soldier, police say ",0,3,19,60,5,14,0,79,0
"It's Christmas! The best festive songs, chosen by Slade, Neil Diamond, the Waitresses and more",0,3,7,68,5,14,0,75,0
NBA memo: Rules prohibit mocking of opponents on social media,0,2,4,47,1,9,0,51,0
Sri Lanka Attacks Said to Kill Dozens in Hospital,0,1,7,34,0,8,0,41,0
"Mário Soares, Central Player in Portugal’s Transition to Democracy, Dies at 92",0,2,8,54,3,11,2,62,0
How Nepal quake turned women into builders,0,2,2,34,0,6,0,36,0
What Red Ink? Wall St. Paid Fat Bonuses,0,1,8,22,2,7,0,30,0
America's Cup: Team New Zealand wins third race,0,1,5,33,2,7,0,38,0
"Hold Off on the Steph Curry Hate, His Time Will Come",0,2,9,32,1,10,0,41,0
A guide to making holiday returns,0,2,1,27,0,5,0,28,0
Intel committee chairman: Report on Russia meddling conflicts with DNI testimony ,0,2,6,63,1,11,0,69,0
"Woman assaulted and forced into car, sparking police chase",0,3,1,48,1,8,0,49,0
UK holds referendum on voting system,0,1,2,29,0,5,0,31,0
These Adorable Dogs Are All Dressed Up For Christmas,0,3,9,35,0,8,0,44,0
Trump Concedes Health Law Overhaul Is ‘Unbelievably Complex’ ,0,2,8,43,2,8,0,51,0
Radiohead Guitarist Jonny Greenwood Will Perform His 'There Will Be Blood' Score Live,0,3,13,58,2,12,0,71,0
A Shakeout Approaches Among Real Estate Investors,0,1,7,36,0,6,0,43,0
Why Does Mount Rushmore Exist? ,0,3,5,20,1,5,0,25,0
Sainsbury's is selling same-sex Valentine's Day cards for the first time ever,0,3,3,60,3,11,0,63,0
Taylor Swift Didn’t Go To The Women’s March And People Are Mad,0,3,12,37,2,11,0,49,0
Watch Alec Baldwin Turn Trump Into 'The Bachelor',0,3,8,32,2,7,0,40,0
"Donald Trump’s Pick for Army Secretary, Vincent Viola, Withdraws",0,3,8,45,3,8,0,53,0
Phil Mickelson Halts Play to Be With Ailing Wife,0,1,8,32,0,8,0,40,0
Roche Offer for Genentech Turns Hostile,0,1,5,29,0,5,0,34,0
Shots reported during Superdome evacuation,0,1,2,36,0,4,0,38,0
Roland Mouret brings high-voltage to a grey Sunday in fashion week,0,2,3,52,1,10,0,55,0
George W. Bush’s best-selling book of paintings shows curiosity and compassion,0,3,3,62,3,10,0,65,0
Southern rail users face another day of chaos as Acas talks resume,0,3,2,53,0,11,0,55,0
The Chainsmokers Tease Upcoming 'Paris' Video,0,3,6,32,2,5,0,38,0
Cuba Gooding Jr. Pays Tribute To Late Father With Sweet Instagram Post,0,3,12,46,1,11,0,58,0
Judge: Dad accused of dropping girl off bridge ready to stand trial,0,3,2,53,1,11,0,55,0
"German army probes alleged Neo-Nazis over 'Heil Hitler' greeting, Nazi salutes ",0,3,6,58,4,11,0,64,0
A Journey From Ebbets Field to the Steps of the Capitol,0,1,7,38,0,10,0,45,0
Working Out the Details of Guns in National Parks,0,1,6,35,0,8,0,41,0
Fox News Poll:  Trump and the Carrier deal ,0,2,5,28,1,9,0,33,0
Boaty McBoatface: Popular Opinion Wins Out With Sub’s New Name,0,3,11,40,2,9,0,51,0
Ohio State gunman kills employee before committing suicide,0,1,2,49,0,7,0,51,0
Samsung Leaks A New Galaxy S8 Feature,0,3,7,23,0,6,1,30,0
Marines' Nude Photo Scandal Goes Beyond That One Facebook Group: Reports,0,3,11,49,2,10,0,60,0
Nokia and Intel to Work Together on Mobile Computing,0,1,6,38,0,8,0,44,0
Ta-Nehisi Coates on Creating Black Superheroes ,0,3,6,34,1,6,0,40,0
Snapchat IPO: Firm valued at $24bn despite losses,0,2,5,33,2,7,2,38,0
"Shelby Foote, 88, noted historian and author, dies",0,1,2,36,3,7,2,38,0
Power Rankings: Warriors jump to top spot -- now the real work begins,0,3,3,51,3,12,0,54,0
Former UKip MP charged with electoral fraud,0,3,5,32,0,6,0,37,0
"Predictions for Malik Zaire, Scott Pagano and College Football's Top Free Agents",0,3,10,57,2,11,0,67,0
Suspect Charged With Federal Crimes in Fort Lauderdale Airport Attack ,0,3,9,51,0,10,0,60,0
"Over 250 dead in Haiti cholera outbreak, thousands infected",0,1,2,45,1,8,3,47,0
To defeat Trumpism will take an extraordinary popular resistance,0,3,2,54,0,8,0,56,0
French fashion designer Yves Saint Laurent dead at 71,0,1,4,39,0,8,2,43,0
Shine of MySpace May Fade a Bit,0,1,6,19,0,6,0,25,0
Princess Kate speaks out on loneliness of motherhood - Yahoo,0,3,3,47,1,9,0,50,0
Payoff Over a Web Singing Sensation Is Elusive,0,1,7,32,0,7,0,39,0
Judge rejects Roman Polanski’s bid to end sex abuse case,0,3,3,43,1,9,0,46,0
Sepp Blatter pick for FIFA World Cup draw presenter labelled as sexist,0,1,8,51,0,11,0,59,0
"Who Should Win the Grammy for Best Latin Rock, Urban or Alternative Album? Vote!",0,3,11,53,3,13,0,64,0
Libyan government accuses three Dutch helicopter crew of transporting spies,0,1,2,64,0,9,0,66,0
US cut to United Nations Population Fund 'devastating' for vulnerable,0,2,6,52,2,9,0,58,0
"Success of Jerry Brown, and California, Offers Lesson to National Democrats - The New York Times",0,2,12,66,3,15,0,78,0
"Athletes, fans honor Stockholm truck attack victims ",0,3,2,42,1,7,0,44,0
"FBI asks Wikimedia Foundation to remove seal from websites, Wikimedia declines",0,1,6,61,1,10,0,67,0
Cable Wars Are Killing Objectivity,0,1,5,25,0,4,0,30,0
Czech Police Expel Ex-Leader of Klan,0,1,6,24,1,5,0,30,0
Alexei Navalny: Russian Court Convicts Main Opposition Leader,0,3,8,45,1,7,0,53,0
21st Century Fox Reaches Preliminary Deal to Buy Sky ,0,3,7,35,0,9,2,42,0
The Currencies to Watch in 2017,0,3,3,19,0,5,4,22,0
Yemen's war leaves children on the brink of famine,0,2,1,40,1,8,0,41,0
Texas lawmaker on four-day hunger strike in protest of ‘sanctuary city’ bill,0,3,1,61,3,11,0,62,0
Baltimore house fire kills 6 children from same family,0,3,1,44,0,8,1,45,0
Layoffs for Prize-Winning and Bullet-Taking Journalists,0,1,6,42,2,5,0,48,0
Here are 6 fables of fixed-income investing â in cartoon form narrated by the actor who played Dumbledore,0,3,2,84,3,17,1,86,0
Ann Coulter On Verge of Pulling Out of Speech at Berkeley ,0,3,8,39,0,11,0,47,0
Tests Confirm Mosquitoes in Miami Beach Are Carrying Zika Virus - The New York Times,0,2,13,56,1,14,0,69,0
Assad says Syria chemical attack that killed dozens is ’fabrication’,0,2,2,55,2,9,0,57,0
Calling Out a Presidential Lie,0,2,4,22,0,4,0,26,0
Japanese man rescued after night at sea on surfboard,0,3,1,43,0,8,0,44,0
Facebook Messenger Brings Group Video Calling to Apps and Web ,0,3,8,44,0,10,0,52,0
Watch 2 New Action-Packed 'Rogue One' Clips Ahead of Its Release,0,2,10,40,3,10,1,50,0
"Emma Watson Was Basically Hermione IRL On The ""Harry Potter"" Set",0,3,13,39,2,10,0,52,0
Colorado counties consider forming new U.S. state,0,1,3,38,2,6,0,41,0
Doug Pederson Says Eagles Will Evaluate Jamaal Charles in Free Agency,0,3,10,49,0,10,0,59,0
"Fires ravage rural areas of New South Wales, Australia",0,3,5,40,1,8,0,45,0
Colossus found in Cairo slum thought to be of revered Pharaoh Ramses II,0,3,6,53,0,12,0,59,0
No Hard Sign of Reverse Migration,0,1,5,23,0,5,0,28,0
Wind Power Gets a Leg-Up in Biggest U.S. Electricity Market,0,3,10,37,3,9,0,47,0
"Commuters Across Delhi NCR Likely To Get Some Relief As Ola, Uber Driver Strike Called Off Partially",0,2,19,64,1,16,0,83,0
Holder Wants Some Detainees Tried in the U.S.,0,1,7,29,2,7,0,36,0
"Tourists strip, a sacred mountain shakes and Malaysia gets very angry",0,3,2,56,1,10,0,58,0
Fatboy Slim: 'I've witnessed religious moments to Love Is In The Air',0,3,8,46,4,11,0,54,0
Salesforce invests in wearables startup APX Labs  - Business Insider,0,2,7,50,1,10,0,57,0
Florida Leader Wants U.S. Money to Fill Budget Gap,0,1,9,31,2,8,0,40,0
Two time Tour de France winner Laurent Fignon dies at age 50,0,1,5,42,0,11,2,47,0
Saturday Night Live: Aziz Ansari explains the rise of the 'lowercase kkk' in scorching monologue,0,2,5,74,3,14,0,79,0
Police Officers Overwhelmingly Agree That Bad Cops Aren’t Held Accountable,0,2,10,54,1,9,0,64,0
Ukraine election results delayed by court,0,1,1,35,0,5,0,36,0
Zimbabwe presidential run-off date set,0,1,1,32,1,4,0,33,0
Former US President Jimmy Carter meets with Hamas Leader,0,1,8,40,0,8,0,48,0
Airplane crashes in Nigeria,0,1,2,22,0,3,0,24,0
US military says 'fireballs' spotted over Texas are not related to satellite collision,0,1,3,69,2,12,0,72,0
The Get: Selena Gomez's Rebecca de Ravenel Earrings,0,3,7,35,2,7,0,42,0
Octavia Spencer in the Spotlight,0,2,3,25,0,4,0,28,0
Winners and losers in President Trump's proposed budget,0,3,3,44,1,7,0,47,0
LeBron James Injured With Cut On His Head After Colliding With Courtside Cameraman,0,3,14,56,0,12,0,70,0
Gaza Strip reports first swine flu cases,0,1,2,32,0,6,0,34,0
"More unmarried couples with children breaking up than married couples for first time, ONS figures show",0,3,4,82,1,15,0,86,0
Russian aircraft buzzed US Navy ship 3 times in a day ,0,3,4,38,0,11,1,42,0
"Avalanche in Vail, Colorado kills one",0,1,3,28,1,5,0,31,0
Senate Republicans have birthed new troubles for the Supreme Court,0,2,4,53,0,9,0,57,0
Chilean earthquakes: in pictures,0,1,1,27,1,3,0,28,0
"With Local Control, New Troubles in Iraq",0,1,6,27,1,6,0,33,0
Footbridge construction delay could jeopardise Ashes Test at new stadium,0,3,3,60,0,9,0,63,0
"E-cigarettes major concern, says US",0,3,3,26,2,4,0,29,0
European Games 2015: The Britons to look out for each day,0,3,4,38,1,10,4,42,0
'Kung Fu Kenny' Is Just the Latest Example of Hip-Hop's Fascination With Martial Arts,0,2,13,55,4,13,0,68,0
President Obama Commutes Chelsea Manning’s Prison Sentence,0,2,7,44,1,6,0,51,0
IEEE approves S1600 & S3200 transmission standards,0,1,6,29,1,6,8,35,0
Once-booming gun industry now recalibrating under Trump ,0,3,2,46,1,7,0,48,0
India announces its largest solar rooftop tender,0,3,1,41,0,6,0,42,0
Donald Trump once asked out Emma Thompson and invited her to sleep at LA Trump Tower,0,3,8,61,0,15,0,69,0
Nunes says information from Trump surveillance ‘concerned me’ ,0,3,2,50,2,8,0,52,0
Colorado school district decides to allow teachers to arm themselves on campus ,0,3,1,66,0,12,0,67,0
Is this the healthiest chicken you could possibly eat?,0,2,1,44,1,8,0,45,0
Subsidy Plan Seeks to Cut Malaria Drug Cost,0,1,7,29,0,7,0,36,0
Tegla Loroupe Gives Refugee Olympians a Lesson in Hope - The New York Times,0,2,11,50,1,13,0,61,0
Cuomo’s odd blow for accountability in government,0,2,1,41,1,6,0,42,0
'The People's Court' Judge Joseph Wapner Dies At 97,0,2,8,30,3,8,2,38,0
The internet roasts a photo of Donald Trump writing his inauguration speech,0,3,3,61,0,11,0,64,0
Court unanimously ousts South Korea's leader for corruption ,0,2,3,48,1,8,0,51,0
'Flip or Flop' stars Tarek and Christina El Moussa separate ,0,2,6,42,2,10,0,48,0
"Listen to Future's Solo Version of ""Grammys""",0,2,5,30,3,6,0,35,0
"Study: cognitive therapy as good as medication, but lasts longer",0,1,1,52,2,9,0,53,0
At least 24 dead in clashes in central Kenya,0,1,2,32,0,8,2,34,0
Northeast gears up for more blizzard conditions,0,3,1,40,0,6,0,41,0
"Stephen Hawking will travel to space on board Richard Branson's ship, professor says",0,2,4,66,2,12,0,70,0
North Korea says it 'will go to war' if US provokes it,0,3,4,37,2,11,0,41,0
Care home restaurant becomes first in UK to win AA rosette after hiring chef from The Ivy,0,3,7,66,0,16,0,73,0
Check Out the Full Credits for Drake 'More Life' Album,0,2,8,35,2,9,0,43,0
Janet Jackson Shares First Photo of Baby Eissa,0,3,7,32,0,7,0,39,0
Ranking the Top 16 College Football Running Backs of All Time,0,2,8,41,0,10,2,49,0
"For 1st time since Cold War, U.S. tanks roll into Russia's backyard",0,2,6,45,4,11,1,51,0
3 dead as man on trial for rape escapes,0,1,0,30,0,8,1,30,0
"Late-night hosts demolish Trump administration’s Russia denials, taking jabs at Jeff Sessions",0,3,5,74,3,11,0,79,0
Vodafone buys Connex and Oskar,0,1,3,23,0,4,0,26,0
Wikinews visits the 2008 Reno Air Races,0,1,4,25,0,6,4,29,0
"Citing Knee Tendinitis, Nadal Withdraws From Wimbledon",0,1,7,40,1,6,0,47,0
"Watch Ed Sheeran Perform 'Divide' Singles, Cover Little Mix in Live Lounge",0,3,11,49,3,11,0,60,0
EU regulation prevents sale of 'small' kiwi fruit in Bristol shop,0,1,3,50,2,10,0,53,0
Union Official Blames Staffing Shortage for Guard Death ,0,2,7,41,0,8,0,48,0
"J. Cole Explains Why He Has Moved Away From Pursuing Fame, Previews His New Documentary",0,3,15,56,2,14,0,71,0
'Justice failed Austin Callaway': Town attempts to atone for 1940 lynching,0,3,4,53,3,10,4,57,0
"Warrant: Clinton, Abedin emails led feds to seize Weiner laptop",0,3,4,48,2,9,0,52,0
Army Sergeant in Texas Admits Funneling Weapons to Cartel ,0,2,7,42,0,9,0,49,0
"Wisdom the albatross, the oldest known wild bird, just laid an egg at age 66",0,3,1,57,2,14,2,58,0
Nokia is reportedly planning a relaunch of the iconic 3310 and people are freaking out about it,0,3,1,74,0,16,4,75,0
White officer seeking to throw out fatal shooting video ,0,2,1,46,0,9,0,47,0
President Trump vows to start renegotiating NAFTA,0,2,7,36,0,6,0,43,0
Singapore's Economy Stages Comeback in Second Quarter,0,1,6,40,1,6,0,46,0
"Fiery Pileup On Baltimore Interstate Leaves 2 Dead, 23 Injured",0,3,8,41,1,9,3,49,0
Scientology ties at New Village Leadership Academy stir controversy for Will Smith and Jada Pinkett-Smith,0,1,10,80,1,14,0,90,0
A startup's $1 million flying car is officially rolling out to buyers in 2020,0,3,1,56,2,13,5,57,0
Treasury Secretary Steven Mnuchin says tax reform unlikely to happen by August,0,3,5,62,0,11,0,67,0
Georgia student in police beating video says he feared for his life,0,3,1,55,0,11,0,56,0
Violence erupts in Guadeloupe after labor dispute,0,1,2,41,0,6,0,43,0
"Four US, eight Afghan troops killed in Afghanistan after attacks",0,1,5,49,1,9,0,54,0
Former DNC Chair Endorses Underdog Candidate in Party Leadership Race,0,3,11,49,0,9,0,60,0
'The truth needs an advocate': why scientists will be marching on Saturday,0,3,2,58,3,11,0,60,0
Lee Foss' Debut Album 'Alchemy' Is the Spring Weekend Soundtrack You Need: Listen,0,3,12,53,4,12,0,65,0
Why Richard Branson Says You Should Never See Yourself As 'Big Business',0,3,12,47,2,11,0,59,0
Kellyanne Conway Blasts 'Haters' for Sexist Criticism  Insider,0,3,7,45,2,8,0,52,0
"A year after ’Je suis Charlie’, a divided France struggles",0,2,4,42,3,9,0,46,0
Brexit: UK's most prominent ex-ministers unite against Theresa May's 'no deal' threat,0,3,5,63,6,11,0,68,0
John Constable painting location mystery solved after 195 years,0,1,2,50,0,8,3,52,0
Agriculture's impact on human evolution clarified,0,1,1,42,1,5,0,43,0
An Artist in Los Angeles Threw Up a Life-Sized Kanye West Jesus Statue on Hollywood Boulevard,0,2,14,63,1,15,0,77,0
Tina Fey tells female Donald Trump voters: 'You can't look away',0,2,5,45,4,10,0,50,0
Marco Rubio reveals his presidential campaign staffers were hacked,0,3,2,56,0,8,0,58,0
Dresden Unveils Controversial Monument that Looks Like Radical Islamist Fortification,0,2,9,67,0,9,0,76,0
Rob Kardashian leaves hospital after diabetes-related scare,0,3,2,50,1,6,0,52,0
National Parks Service OK with Renaming Alaska's Mt. McKinley,0,3,10,41,2,8,0,51,0
"Why pay for child care you don't use, like on public holidays?",0,2,1,47,3,11,0,48,0
"Donald Trump: Germany Owes 'Vast Sums Of Money' To NATO, U.S.",0,3,15,30,6,10,0,45,0
Venezuela’s Maduro Appoints Sanguino as New Central Bank Chief,0,3,8,45,1,8,0,53,0
Race Officials Look to Expand Tour of California,0,1,6,35,0,7,0,41,0
Chicago's Sears Tower renamed Willis Tower,0,1,5,31,1,5,0,36,0
Rakhi Sawant Is Likely To Get Arrested For Her Objectionable Comments Against Sage Valmiki,0,3,14,63,0,13,0,77,0
Mexicans Are Boycotting US Products To Protest Trump’s Wall Tax,0,3,11,42,1,9,0,53,0
Human leg found attached to cinder block in search for missing woman ,0,2,1,56,0,12,0,57,0
Olympic torch extinguished three times in Paris,0,1,2,39,0,6,0,41,0
"Desperate Children Flee Zimbabwe, for Lives Just as Desolate",0,1,7,44,1,8,0,51,0
"Chicago torture video: 4 charged with hate crimes, kidnapping",0,3,1,49,2,8,1,50,0
"Former Trump adviser on Taiwan call: 'If China doesn't like it, screw 'em'",0,2,5,51,6,12,0,56,0
The Limit Does Not Exist by Forbes on iTunes,0,3,7,29,0,8,0,36,0
Congressman Thad McCotter to run for U.S. President,0,1,7,35,2,7,0,42,0
One million pilgrims attend open-air mass with Pope,0,1,2,41,1,7,0,43,0
A Fitting Time to Honor Mentor of Ashe and Gibson,0,1,7,33,0,9,0,40,0
JPMorgan Quant Frets Stock Complacency Too High After Dutch Vote,0,3,12,43,0,9,0,55,0
What does Scotland's new push for independence mean?,0,3,2,41,2,7,0,43,0
Eldest son of Khadr family denied bail; purchased weapons for Afghan militants,0,1,3,63,1,11,0,66,0
Iran imposes sanctions on 15 American companies,0,3,2,37,0,6,2,39,0
HSBC May Sell 3 Prominent Office Buildings,0,1,9,26,0,6,1,35,0
Nigerian Migrant Arrested for Stabbing Female ‘Refugee Helper’ to Death,0,3,8,52,2,9,0,60,0
"Kings won't deal DeMarcus Cousins before Feb. 23 deadline, Divac says",0,3,6,48,3,10,2,54,0
Intel Shifts Image Advertising to a Smaller Agency,0,1,6,37,0,7,0,43,0
A Trap for a Trader,0,2,3,12,0,4,0,15,0
Daredevil Season 2: Walking Dead Alum Jon Bernthal Cast as The Punisher,0,3,10,48,1,11,1,58,0
CNN talent then and now: 'The Seventies',0,3,5,26,3,6,0,31,0
Former WWE wrestler Jimmy 'Superfly' Snuka dead at age 73 ,0,3,7,37,2,10,2,44,0
"Gavin DeGraw talks travel, his crazy schedule and nostalgia of New York City",0,2,6,57,1,12,0,63,0
Baseball Tragedy: Two Players Die in Crashes in the Dominican Republic ,0,3,8,51,1,11,0,59,0
Web Site Offers Anonymous Chats With Strangers,0,1,7,33,0,6,0,40,0
Syria conflict: Army cuts IS supply route into al-Bab,0,2,5,38,2,8,0,43,0
Ivana Trump writing memoir about raising kids with Donald ,0,3,3,46,0,9,0,49,0
Mojo Rawley Wins WWE Andre the Giant Battle Royal with Help from Rob Gronkowski,0,3,13,53,0,13,0,66,0
Trump White House Bars News Organizations From Press Briefing,0,3,9,44,0,8,0,53,0
NCAA Tournaments to Return to North Carolina After Bathroom Bill Compromise ,0,3,12,53,0,11,0,65,0
WATCH: 'Fox & Friends' Celebrates Vets' Heroism on Medal of Honor Day  Insider,0,3,14,46,5,13,0,60,0
Finnish Olympic champion skier Mika Myllylä found dead,0,1,4,43,0,7,0,47,0
Sciatica medication Pregabalin found to be no more effective than placebo,0,3,2,61,0,10,0,63,0
"Sea Ice Around Antarctica Has Shrunk To The Smallest Size, All Because Of Global Warming",0,3,15,58,1,14,0,73,0
'Who said that it will end with this?': Russia is on edge over NATO's moves in Eastern Europe,0,3,8,63,5,17,0,71,0
Hospital Cafeteria Worker Saves Thousands of Dollars to Buy Toys for Kids at Christmas - Yahoo,0,2,11,67,1,15,0,78,0
Appy New Year: the best apps to help you achieve your resolutions for 2017,0,3,3,53,1,13,4,56,0
"A Blood Test Could Soon Help You Gauge How Long You'll Live, According To Scientists",0,2,15,53,2,14,0,68,0
MATTIS: Moscow needs to 'prove itself' before the US and Russian militaries can work together,0,3,10,66,3,14,0,76,0
You could be flying nonstop to Cuba from the US this fall,0,2,4,42,0,11,0,46,0
India frustrated against Bangladesh as Ajinkya Rahane makes 98,0,2,4,48,0,8,2,52,0
'Lord of the Rings' Cast Reunites in a Series of Instagram Photos [Video],0,3,8,49,4,12,0,57,0
Donald Trump's Supreme Court nomination: Why it matters and how it could change the US,0,3,7,63,2,14,0,70,0
Internet Companies and Ad Agencies Find Some Common Ground,0,1,8,42,0,8,0,50,0
"NFL: Colts, Saints kick off season",0,1,5,22,2,5,0,27,0
"’They called me the antichrist’: JT LeRoy, Laura Albert and the literary hoax",0,2,7,54,4,12,0,61,0
’Veto Gunmageddon’ Launched to Repeal California Gun Controls,0,2,7,45,2,7,0,52,0
"PTSD symptoms go beyond psychological, from sleep apnoea to irritable bowel syndrome: study",0,3,4,73,2,12,0,77,0
"Sunday: Reince Priebus, John McCain, Keith Ellison",0,3,8,33,3,6,0,41,0
Why Europe fears this great US ambassador,0,2,4,31,0,6,0,35,0
"Stephen Colbert, Michael Stipe, and James Franco Bid Farewell to 2016 With Perfect R.E.M. Parody",0,3,14,59,5,14,4,73,0
Kendall Jenner criticised over Pepsi advert,0,3,3,35,0,5,0,38,0
Democrat staffers obtained Maryland lt. governor's credit report illegally,0,1,2,62,2,8,0,64,0
A body cam captured a cop’s violent encounter with a teen — but a new law keeps the video secret,0,3,1,74,2,19,0,75,0
General Warns Against Quick End to Afghan Combat,0,1,7,34,0,7,0,41,0
The Grand Tour's Christmas special is eye-wateringly lavish – The Beach (Buggy) Boys Part 1 review,0,2,9,68,5,15,1,77,0
Tibetans demand that China release Panchen Lama boy,0,1,4,40,0,7,0,44,0
76ers D-League Team Shows Off R2-D2 Jerseys for 'Star Wars' Night,0,3,11,36,4,10,4,47,0
Indonesia Keeps Key Rate Unchanged as Rupiah Slumps on Fed,0,2,8,41,0,9,0,49,0
"The Cellphone, Navigating Our Lives",0,1,5,25,1,4,0,30,0
"Madonna, Shania Twain, Kesha & More Honored at Billboard Women in Music 2016",0,3,9,48,3,12,4,57,0
Man Who Sent Manifesto to Donald Trump Is Captured After Manhunt ,0,2,10,44,0,11,0,54,0
"'This Is Populism': Tucker, Hume, Wallace & Perino on Trump's Inaugural Address  Insider",0,3,11,57,7,13,0,68,0
The Fifth Harmony Shuffle: Ryan Seacrest and Jenny McCarthy Weigh In,0,3,11,46,1,10,0,57,0
"Big Sean’s New Video For ""Halfway Off The Balcony"" Is Here",0,3,11,34,3,10,0,45,0
"At Art Basel, a Powerful Jury Controls the Market ",0,3,7,33,1,9,0,40,0
Tony Romo Joins Instagram with Hilarious Video Teaching His Young Kids a Play,0,3,11,54,0,12,0,65,0
'Now I can hold my daughter': Hope for Bangladesh 'Tree Man'  after 16 surgeries to remove growths,0,3,6,68,5,17,2,74,0
CoverGirl's first male spokesmodel angers Twitter with insensitive Africa tweet,0,3,4,65,1,9,0,69,0
Californian Governor denies clemency for Stanley Tookie Williams,0,1,5,52,0,7,0,57,0
Candace Cameron Bure to Leave ‘The View’,0,3,6,26,2,6,0,32,0
Actor Jerry Orbach dead at age 69,0,1,3,22,0,6,2,25,0
Revealed: The true scale of Tony Blair's global business empire,0,2,4,48,2,9,0,52,0
"Trump praises Jim DeMint, who soon might be ousted from Heritage Foundation job",0,3,6,60,1,12,0,66,0
Azealia Banks Takes Aim at Protesters for Women's March,0,2,7,39,1,8,0,46,0
Al-Qaeda threatens UK over Rushdie's knighthood,0,1,5,35,2,5,0,40,0
Trump’s Rapid Rapprochement Plans With Russia Fade ,0,3,7,36,1,7,0,43,0
Mexican Authorities Arrest Sinaloa Cartel’s New Boss,0,2,7,38,1,6,0,45,0
Lars von Trier eyeing up Cannes return following controversial Nazi comments,0,3,4,62,0,10,0,66,0
Nicki Finally Responded To Remy Ma And People Have A Lot Of Different Feelings About It,0,2,16,56,0,15,0,72,0
South Africa Bars Dalai Lama From a Peace Conference,0,1,8,36,0,8,0,44,0
Five things we learned from the Sally Yates hearing,0,2,3,40,0,8,0,43,0
Hipster Nativity features Mary and Joseph taking selfies,0,3,4,45,0,7,0,49,0
Kevin Durant's Mom to Oklahoma City Thunder Fans: 'It Didn't Have to Be Like This',0,3,13,50,5,14,0,63,0
Technical problem on Airbus A400M maiden flight,0,1,4,34,0,6,3,38,0
How cartoons portrayed the Women’s March and Trump’s historic weekend,0,2,4,54,2,9,0,58,0
Wife Creatively Includes Deployed Air Force Husband in Family Christmas Card - Yahoo,0,3,11,60,1,12,0,71,0
Sumner Redstone: taking risks and banning Tom Cruise,0,2,4,40,1,7,0,44,0
U.S. Soccer Takes Its Reclamation Project on the Road,0,2,8,35,2,8,0,43,0
"Well Ahead of Final Group at Masters, Woods and Mickelson Put On Show",0,1,10,46,1,12,0,56,0
‘Who buys fish with a credit card here?’ Traders scoff at Goa’s bid to ditch cash,0,3,3,59,4,15,0,62,0
NPR Contest: Send Us Your Stories Of Happy Accidents In Science,0,2,13,39,1,10,0,52,0
"Winter Storm Socks Midwest, East, Spawning Accidents, Deaths ",0,2,8,42,3,8,0,50,0
Bangladesh plants million trees to cut lightning toll,0,3,1,45,0,7,0,46,0
Documentary suggests nuns were excommunicated for exposing paedophilic priest,0,1,1,68,0,8,0,69,0
"Trump Kicks Off ‘Thank You’ Tour, Reveling in Crowd and Campaign Themes ",0,3,10,47,3,12,0,57,0
"Cavaliers to work out Kirk Hinrich, Mario Chalmers, Lance Stephenson, Jordan Farmar",0,3,9,60,3,11,0,69,0
"Solar Employs More People In U.S. Electricity Generation Than Oil, Coal And Gas Combined",0,3,15,57,3,13,0,72,0
107 former Justice officials think this case was handled unjustly. DOJ must act.,0,3,4,59,2,12,3,63,0
Dakota Access Pipeline protesters meet with authorities over emergency evacuation order ,0,2,3,74,0,11,0,77,0
Where could Adrian Peterson land if he leaves Vikings?,0,3,4,41,1,8,0,45,0
Arriva Rail North staff to consider strike action over role of train guards,0,2,3,60,0,12,0,63,0
NSA to participate in U.S. cybersecurity,0,1,5,28,2,5,0,33,0
Reflation Trade Hangs in the Balance as Health Care Vote Looms,0,3,8,44,0,10,0,52,0
In a Syrian refugee camp: I would tell President Trump ‘to come and see’ us [Video],0,3,6,57,5,15,0,63,0
Child protection report highlights concerns of abuse and neglect continuing to rise,0,3,1,71,0,11,0,72,0
"With Vote on F-22 Jet, Panel Defies a Veto Threat",0,1,8,28,2,9,2,36,0
"Up To 1,000 Piglets Presumed Killed In Ohio Truck Crash",0,2,9,32,1,9,4,41,0
Former Serbian president Milutinovic acquitted of war crimes,0,1,3,50,0,7,0,53,0
Investor alert: Trump’s tax cuts are looking iffy,0,3,2,38,2,7,0,40,0
"These photographers are selling photos to incite change, #Resist by Noor Images",0,2,4,62,2,11,0,66,0
"Wikileaks release Afghan ""war logs"" in co-operation with mainstream media",0,1,2,59,3,9,0,61,0
MTV Faces Backlash for 'Resolutions for White Guys' Video  Insider,0,3,10,44,2,10,0,54,0
TSA Fails to ID 73 Airport Employees With Links to Terrorism,0,3,11,37,0,10,2,48,0
"DNA Tests Prove Michigan Man, Searching for Origins, Was Not Kidnapped Toddler",0,1,13,52,2,11,0,65,0
"In 30 years, the world's best CEO will be a ROBOT claims billionaire Alibaba founder Jack Ma",0,3,12,60,2,16,2,72,0
The Rumored Jay Z and Zaytoven Collaboration Is Headed Our Way,0,3,10,42,0,10,0,52,0
Trump lays out military plan; formally introduces James 'Mad Dog' Mattis,0,3,5,54,3,10,0,59,0
10 Key Moments From Thursday’s Trump Nominee Hearings ,0,3,7,36,1,8,2,43,0
HMRC changes decision over VAT for adult colouring books,0,3,7,41,0,8,0,48,0
Luther Strange to Succeed Jeff Sessions in Senate,0,3,6,36,0,7,0,42,0
"Out Millions, Elie Wiesel Vents About Madoff",0,1,7,30,1,6,0,37,0
Barack Obama Helps Michelle Stunt on the Gram by Taking Photo of Her on a Yacht,0,3,10,54,0,15,0,64,0
"Homeland Security chief: No ’specific, credible’ threat to US",0,2,5,44,4,8,0,49,0
Jeff Sessions Rejects Charges He Holds Racist Views,0,3,8,36,0,7,0,44,0
Ukip cannot be allowed to lead the Eurosceptic campaign,0,3,2,45,0,8,0,47,0
Prospects for N.C.A.A. Bid Go From Problematic to Automatic,0,1,10,37,4,8,0,47,0
30 Under 30 Asia 2017: Finance & Venture Capital,0,2,5,25,2,8,8,30,0
Mexico Gains Share of North American Light-Vehicle Production,0,3,8,45,1,7,0,53,0
"This Spring, You Won’t Have to Be Rich to Own a Picasso",0,2,9,33,2,11,0,42,0
Army in Mexico Seizes 25 Gunmen,0,1,4,20,0,5,2,24,0
NASA: Hopes raised for shuttle flights to resume soon,0,1,5,39,1,8,0,44,0
Trump to speak with Putin on Tuesday,0,2,3,27,0,6,0,30,0
Lady Gaga Shuts Down Body Shamers After Super Bowl Criticism: 'I'm Proud of My Body',0,3,14,52,4,14,0,66,0
A genuinely believable CGI actor? It won't be long,0,2,5,35,2,8,0,40,0
Milo Ventimiglia Recreates Memorable ‘This Is Us’ Push-Ups Scene on ‘Ellen’ [Video],0,3,12,53,7,11,0,65,0
Texas defeats USC in 2006 Rose Bowl,0,1,6,19,0,6,4,25,0
The Host-Country Curse Bears Down on England,0,1,7,30,1,6,0,37,0
Syrian war: Fears for civilian lives on both sides as Syrian army takes control of Aleppo,0,3,4,69,1,15,0,73,0
"Why do some women have acne in adulthood? Poor diets and high stress levels could be to blame, experts say",0,3,2,83,2,19,0,85,0
North Dakota teen gets accepted by all 8 Ivy League schools,0,2,4,44,0,10,1,48,0
Steve Bannon Was Doomed ,0,2,4,16,0,4,0,20,0
"Jaime Lannister Almost Spoiled A Major ""Game Of Thrones"" Plot Point And I Kinda Wish He Had",0,2,17,56,2,16,0,73,0
"Smoking causes one in 10 deaths worldwide, study shows",0,3,1,42,1,8,2,43,0
Mother of ISIS hostage begs for mercy,0,2,5,26,0,6,0,31,0
"Television appeal for 1984 murder in Bath, England",0,1,3,35,1,7,4,38,0
'Dunk League' Is An NBA Fan's Wet Dream,0,3,10,19,3,7,0,29,0
"Palmyra: Islamic State fighters recapture ancient Syrian city, nine months after being expelled",0,2,4,77,2,12,0,81,0
"Peter Vaughan, Maester Aemon in ‘Game of Thrones,’ Dies at 93 - The New York Times",0,2,11,49,5,15,2,60,0
Maria Sharapova Is Suspended From Tennis for Two Years - The New York Times,0,2,12,49,1,13,0,61,0
Trumponomics Gets The Thumbs Down From Nobel-Winning Economists,0,3,9,46,1,7,0,55,0
Jane Birkin: ‘I learned French off a tape recorder. All the French people laughed’,0,2,6,59,4,13,0,65,0
Supreme Court tackles racial gerrymander cases,0,2,2,39,0,5,0,41,0
Earnhardt makes NASCAR return in Daytona 500 practice ,0,3,8,35,0,8,3,43,0
"Woman 'wins £37,000 damages' after she was strip-searched and left naked by Met police",0,3,2,61,5,13,5,63,0
Police Release Mexican Beauty Queen,0,1,5,26,0,4,0,31,0
New Yorker's Obama cover sparks outrage,0,1,3,30,1,5,0,33,0
Gunfire Rattles Capital of Equatorial Guinea,0,1,5,34,0,5,0,39,0
"Chuck Berry, rock 'n' roll's founding guitar hero and storyteller, dies aged 90",0,3,2,58,5,12,2,60,0
Australian rules football: 2010 Gippsland Football League round 2 - Traralgon v Wonthaggi,0,1,6,64,2,12,5,70,0
Congo Presses for Extradition of Warlord,0,1,4,31,0,5,0,35,0
Debated Home Run Recalls a Moment of Yankees Lore,0,1,7,34,0,8,0,41,0
Physics A-level question mistake,0,3,2,26,1,3,0,28,0
Armed conflicts in the world down by 40% since early 1990s,0,1,1,40,1,10,6,41,0
Donald Trump Tweeted About Enlisting The Full Potential Of Women. It Fell Short.,0,3,13,53,2,12,0,66,0
Quebec supermarket donation program aids food banks as it tackles waste,0,3,1,60,0,10,0,61,0
Well-preserved baby mammoth found in Siberia,0,1,2,36,1,5,0,38,0
Yoga you can do on a plane - CNN Video,0,2,5,23,1,9,0,28,0
"Traffic Deaths Continued To Rise In 2016, But Reasons Why Are Elusive",0,2,11,42,1,11,4,53,0
'Shawshank' escape: prison sewing instructor jailed as alleged accomplice to murderers on the run,0,2,1,80,3,13,0,81,0
"Justice Sotomayor, at Princeton, avoids any talk of Gorsuch ",0,3,4,45,2,9,0,49,0
"Get Your Snack on With the Full Version of Migos' ""Dab of Ranch""",0,3,9,40,3,12,0,49,0
Immigration Accord by Labor Boosts Obama Effort,0,1,6,35,0,6,0,41,0
NYPD Will Now Allow Officers to Wear Turbans and Beards for Religious Reasons,0,3,13,52,0,12,0,65,0
"At Liberty University, All Sins Are Forgiven on the Altar of Football ",0,2,9,48,1,12,0,57,0
Insurers Ask Whether TARP Aid Is on Its Way,0,1,11,24,0,8,0,35,0
Who are the winners and losers in Trump's tax plan?,0,3,2,38,2,9,0,40,0
GLAAD Media Awards nominees announced,0,1,7,26,0,4,0,33,0
Thousands protest privatisation of Australian electricity industry,0,1,2,58,0,6,0,60,0
"House Republicans Propose Rules to Punish Broadcasting, Photography From Chamber Floor",0,3,10,65,1,10,0,75,0
"Korfball, Tug of War and Others Apply for 2020 Olympic Games Inclusion",0,2,8,46,1,11,4,54,0
Want to help your northern child? Become a pushy southern parent,0,3,2,51,1,10,0,53,0
Osborne Editorship Spurs Review of U.K. Lawmakers in Second Jobs,0,2,9,44,2,9,0,53,0
President Trump’s First Foreign Trip Will Include Red-Carpet Welcome In Saudi Arabia,0,2,13,58,2,11,0,71,0
Saudi Arabia launches Girls' Council to empower women — without any girls,0,3,4,56,2,11,0,60,0
"Location, Location: It Still Pays to Be Near",0,1,7,28,2,7,0,35,0
Ex-British spy behind Trump dossier has been identified,0,2,3,44,1,7,0,47,0
Darwinism Must Die So That Evolution May Live,0,1,8,30,0,7,0,38,0
"After 1,000 Year Slumber, China Vows to Invent Again",0,3,7,31,2,8,4,38,0
"15 People Shot, One Dead in ‘Horrific’ Cincinnati Nightclub Shooting: Police",0,2,9,51,4,10,2,60,0
Liverpool 2-0 Tottenham Hotspur: Premier League – as it happened,0,3,5,45,3,9,2,50,0
Marc Anthony Launches New Mobile App With escapex,0,3,7,35,0,7,0,42,0
Meryl Streep slams Trump at Golden Globes and Trump hits back,0,3,6,45,0,10,0,51,0
"Report: Cheetahs, the world's fastest land animals, racing toward extinction",0,3,2,61,4,9,0,63,0
James Earl Jones to get Tony Award for lifetime achievement ,0,3,5,45,0,10,0,50,0
"House Republicans tout healthcare plan, Democrats call it inadequate",0,3,3,56,1,8,0,59,0
WATCH: Trump Opens Up About Criticizing Obama to His Face at Inauguration  Insider,0,3,15,53,1,13,0,68,0
IBMVoice: AI For Social Good: How Humans And Machines Are Making A Better World,0,2,18,46,2,13,0,64,0
UK sends stress balls to US scientists worried about Donald Trump,0,3,6,49,0,10,0,55,0
"Putting Country First, and a Career in Jeopardy",0,1,5,34,1,7,0,39,0
You can now transfer money internationally through Facebook,0,3,2,50,0,7,0,52,0
"Director Paul Feig: ’Ghostbusters’ Haters are ’Misogynistic,’ ’Right-Wing Radio Monsters’ - Breitbart",0,2,11,69,10,11,0,80,0
"Cruz, Rubio, Face off in Nasty Battle for Second in S.C.",0,2,8,34,4,10,0,42,0
North Carolina Beats Radford in First Round Without Lawson,0,1,8,42,0,8,0,50,0
"Ex-AG Mukasey: Comey should resign, Trump should pardon Clinton",0,3,7,45,3,8,0,52,0
Pro Football Hall of Fame 2017: Complete List of NFL Inductees to Canton,0,2,11,44,1,12,4,55,0
Housing Starts Rise an Unexpected 3.6%,0,1,4,25,2,5,2,29,0
"Watch Live: President-Elect Trump Returns to Grand Rapids, Mich.",0,2,9,43,4,8,0,52,0
Harold Ehrlich Built Name on Wall Street With ‘Fearless Forecasts’,0,2,9,46,2,9,0,55,0
Nurturing the father-daughter relationship I didn’t have,0,3,2,46,2,6,0,48,0
IBM reveals new pride logo as a wave anti-LGBTQ legislation rolls out across the nation,0,3,8,64,1,14,0,72,0
"NSW weather: Brace for a third day of storm activity, BOM warns",0,3,7,43,2,11,0,50,0
Ted Cruz’s strange prediction of an upcoming Supreme Court vacancy,0,3,4,52,1,9,0,56,0
"Lindsey Vonn Wins Downhill, Picking Up Second Gold at World Championships",0,1,10,52,1,10,0,62,0
"Jeremy Tyler, N.B.A. Prospect, Is Groomed to Play His Own Way",0,1,12,34,5,10,0,46,0
Homeless man accused of murdering mother and son at family's Stourbridge home remanded in custody,0,3,2,80,1,14,0,82,0
James Harden Gives Game Ball to Fan on Her 100th Birthday,0,3,8,36,0,10,3,44,0
Ten Things Every Job-Seeker Should Be Doing On LinkedIn,0,3,11,35,1,8,0,46,0
Clingy panda video racks up 163m hits online,0,3,1,33,0,7,3,34,0
Seattle judge demands an explanation after undocumented 'dreamer' arrested,0,3,1,63,2,8,0,64,0
Kim Jong-un's nuclear missiles CAN reach the US and Europe says South Korean military officials ,0,3,10,69,2,15,0,79,0
"Getting your newborn to sleep involves knowing when to accept help, midwifery expert says",0,3,1,74,1,13,0,75,0
Christie Brinkley Kills It In Sports Illustrated Swimsuit Issue Return At Age 63,0,3,12,54,0,12,2,66,0
Police: Man charged in shooting death of Chicago toddler ,0,2,3,44,1,9,0,47,0
Mosquitoes Thrive in U.S. But Don't Blame Climate Change,0,3,9,36,3,8,0,45,0
"NBC News Video See Brazil Soccer Team, Pilot’s Final Interview Before Fatal Flight",0,2,15,53,2,12,0,68,0
Ten killed by suicide bomber in southern Afghanistan,0,1,2,43,0,7,0,45,0
Davis Cup Opens With a Weekend Full of Twists,0,1,7,30,0,8,0,37,0
Two more UN peacekeepers killed after attack in Darfur,0,1,4,42,0,8,0,46,0
Kris Jenner on Caitlyn Jenner's transition: 'Why would you not explain all this to me?',0,3,5,63,5,14,0,68,0
Russians Mint 'In Trump We Trust' Coin Ahead Of U.S. Inauguration,0,3,12,39,4,10,0,51,0
Supreme Court Neil Gorsuch: Who is Trump's nominee?,0,3,6,35,3,7,0,41,0
"This Week in Billboard Chart History: In 1991, Gloria Estefan's 'Dark' Lit Up the Hot 100",0,3,12,50,5,15,7,62,0
'Stranger Things' Kids Already Look Like Winners On The Golden Globes Red Carpet,0,3,13,53,2,12,0,66,0
Trump's America Donald Trump being sued by nine-year-old Levi Draheim over his climate policies,0,3,6,73,3,13,0,79,0
"With his presidency in turmoil, Trump keeps returning to past victories — and old foes",0,2,2,68,2,14,0,70,0
3-Year-Old Got a Suit for Christmas So He Can Dress Just Like Local Meteorologist [Video],0,2,14,56,4,14,1,70,0
Oman Navigates Between Iran and Arab Nations,0,1,6,32,0,6,0,38,0
WhatsApp: ‘Unsend’ message feature and new shortcuts arrive in beta,0,2,3,52,3,9,0,55,0
Hammer kills Illinois student in freak athletics accident,0,3,2,48,0,7,0,50,0
Separatists In Kashmir Consider Cancelling Friday Protest As It Coincides With Mahashivratri,0,3,12,69,0,11,0,81,0
Mariners imposing order limit on popular toasted grasshoppers,0,2,1,53,0,7,0,54,0
Pregnancy May Result in Long-Term Changes to a Woman's Brain - Yahoo,0,3,9,45,3,11,0,54,0
"Paul Ryan says he ""can't answer"" how many will lose coverage under GOP health care plan",0,3,5,64,3,15,0,69,0
Four killed in militant attack on Karachi military base,0,1,2,45,0,8,0,47,0
Unsealed search warrants reveal further details of Prince's drug use before death - Yahoo,0,3,3,71,2,13,0,74,0
The Wraithing of Rod Rosenstein,0,2,4,23,0,4,0,27,0
Israel-Palestinian conflict: Summit warns against unilateral actions,0,3,3,57,2,6,0,60,0
Trump Is Running the White House Like a Democrat,0,3,7,33,0,8,0,40,0
"UK failing Syrian refugees who survived torture, say MPs",0,2,5,42,1,8,0,47,0
Rubio says US can’t defeat ISIS until Syria's Assad is removed ,0,3,9,41,2,11,0,50,0
Federal Government announces review into retail electricity prices,0,3,2,57,0,7,0,59,0
Christopher Lee: readers' tributes and memories,0,3,2,38,2,5,0,40,0
"NHS at breaking point, according to British Medical Association",0,2,6,48,1,8,0,54,0
"From Arctic Soil, Fossils of a Goliath That Ruled the Jurassic Seas",0,1,9,46,1,11,0,55,0
Bush nominates Alito to U.S. Supreme Court,0,1,6,28,2,6,0,34,0
Gbagbo detained by opposition forces and taken to meet Ouattara in Ivory Coast hotel,0,1,4,67,0,13,0,71,0
"In A Shocking Twist, Paper Owned By Trump’s Son-In-Law Endorses Trump",0,2,13,42,4,10,0,55,0
Australia Introduces ‘Values’ Test for Citizenship,0,2,5,38,2,5,0,43,0
Iranian media: Professor of Tehran University killed in bombing,0,1,4,50,1,8,0,54,0
"Brothers Osbourne, Maren Morris and Jon Pardi Win Best New Artist Categories at the ACM Awards",0,3,15,63,1,15,0,78,0
Rutgers Rally Falls Short Against Purdue,0,1,6,29,0,5,0,35,0
"Does Carlos Slim And Donald Trump's ""Cordial"" Dinner Signal A Role For The Mexican Tycoon?",0,3,15,57,4,14,0,72,0
Californians foot $25G bill for 40 hours of Holder's anti-Trump time ,0,2,4,47,3,11,4,51,0
Violence in Iran increases,0,1,2,21,0,3,0,23,0
The Payoff: How to shop for Obamacare [Video],0,3,5,30,3,7,0,35,0
Charles Manson prosecutor Vincent Bugliosi dies at 80 ,0,3,4,40,0,8,2,44,0
New Zealand to send out bird flu brochures,0,1,2,33,0,7,0,35,0
Kings of Leon Rock the iHeartRadio Theater with Classic Set,0,3,8,42,0,9,0,50,0
"After a Pause, Wall Street Pay Bounces Back",0,1,7,28,1,7,0,35,0
"Family accuses cremation company of running ""the ultimate scam"" in Colorado",0,3,2,61,2,10,0,63,0
Roger Stone: All You Need to Know About Trump & Khizr Khan,0,2,10,35,2,11,0,45,0
‘No apology will give me back my life’: The man who served 43 years for a murder he didn’t commit,0,3,2,70,4,19,2,72,0
"Mexico: 1st Independent Governor Elected, Ruling Party Leads Congress",0,3,8,50,2,8,1,58,0
Sarita Devi Announces Arrival On The Big Stage With A Victory On Her Professional Boxing Debut,0,3,16,63,0,15,0,79,0
Kobe Bryant and Nike Form Youth Basketball 'Mamba League' in Los Angeles,0,3,10,49,2,11,0,59,0
Trace the journey of one of the world's rarest and largest diamonds,0,3,1,54,1,11,0,55,0
"Pet tigers, cheetahs, lions banned in United Arab Emirates under new laws",0,3,4,56,2,11,0,60,0
Pentatonix's 'Christmas' Album Spends Second Week at No. 1 on Billboard 200,0,3,8,48,4,11,4,56,0
Zimbabwean police raid MDC party's offices,0,1,4,32,1,5,0,36,0
Bullying of desperate 999 call handlers 'led to suicide attempts’ at scandal-hit ambulance service,0,3,1,78,3,13,3,79,0
This Heroic Pup Jumped In Front Of A Bus To Save His Blind Owner,0,3,14,37,0,13,0,51,0
"Tonight During Earth Hour, Here's How You Can Help Save 7,618 Tonnes Of Coal In Just 1 Hour",0,3,16,50,3,17,5,66,0
Covering Northern Virginia Family of 6 Takes in Family of 13 After Fire,0,2,8,48,0,12,3,56,0
New Zealand MP to be present at state funeral of Gerald Ford,0,1,6,43,0,11,0,49,0
How To Benefit From The Battle Between Credit Card Companies,0,3,10,41,0,9,0,51,0
EBay buys VeriSign payment service division,0,1,4,34,0,5,0,38,0
"Tim Russert, NBC News ""Meet the Press"" moderator dies at age 58",0,1,8,39,3,11,2,47,0
Maxine Waters: 'Sex Actions' Allegations in Trump Dossier Are 'Absolutely True'  Insider,0,2,11,60,5,12,0,71,0
"Truck Attacker Plows Into Jerusalem Crowd, Killing at Least Four",0,2,9,45,1,9,0,54,0
Women Are Stocking Up On The Morning-After Pill Before Trump Takes Office,0,3,13,48,1,11,0,61,0
Fernando Alonso wins 2007 European Grand Prix,0,1,5,30,0,6,4,35,0
Neither Blairism nor Corbynism can help the working-class,0,3,3,46,1,7,0,49,0
Adam Lambert and James Corden Have a Sing-Off Battle to Lead Queen: Watch,0,3,11,48,2,12,0,59,0
H.R. McMaster Breaks With Administration on Views of Islam ,0,3,9,39,2,9,0,48,0
Kid Rock Being Discussed as Potential Senate Candidate: Report,0,3,8,45,1,8,0,53,0
7 ways to boost your happiness,0,3,0,24,0,5,1,24,0
Elon Musk: Tesla will unveil a semi-truck in September,0,2,4,40,2,8,0,44,0
Heavy rain causes flooding across the UK,0,1,3,31,0,6,0,34,0
Australian PM Gillard pressured to address human rights crackdown in China,0,1,5,59,0,10,0,64,0
4 Reasons All Millennials Should Develop Their Public Speaking Skills,0,3,9,50,0,9,1,59,0
Helicopter crash in Hong Kong injures thirteen,0,1,3,37,0,6,0,40,0
Indian engineer named Saddam Hussain cannot get a job,0,3,3,42,0,8,0,45,0
"New Congress prepares to undo Obamacare, weigh Trump personnel picks",0,2,4,54,1,9,0,58,0
Maori flag to fly along side the New Zealand Flag on Waitangi day,0,1,5,48,0,12,0,53,0
Everything's in Play After Day of Chaos in French Race,0,2,7,37,1,9,0,44,0
Kyrgyzstan authorities identify suspect in Russia subway bombing ,0,2,2,55,0,8,0,57,0
Five Campaign Logos Hillary Should Use to Up Her Pandering Game in the New Year,0,2,12,53,0,14,0,65,0
Chicago Aviation Security Chief Is Fired Weeks After United Episode ,0,3,10,48,0,10,0,58,0
Bank Mergers Spread in Mideast as Low Oil Signals Boom Days Over,0,2,10,43,0,11,0,53,0
Nebraska's two nuclear plants near Omaha on alert,0,1,2,39,1,7,0,41,0
Geography Made America Great. Has Globalization Undone Its Influence? - The New York Times,0,2,13,61,3,13,0,74,0
Cillizza: Trump just keeps creating smokescreens to mask his Russia problem,0,3,3,61,1,10,0,64,0
Mary J. Blige Talks Divorce & 'Strength of a Woman' Album on NPR,0,3,11,37,4,12,0,48,0
US governor unveils dung on budget plan,0,2,2,31,0,6,0,33,0
Beehives stolen as New Zealand honey prices soar; crime ring blamed ,0,2,3,53,1,11,0,56,0
Everyone is missing the big picture in Trump’s Yemen raid,0,2,3,44,1,9,0,47,0
Microsoft Flight Simulator series grounded after layoffs,0,1,3,47,0,6,0,50,0
Murder charge dropped against US Marine who admitted killing Iraqi detainee,0,1,5,60,0,10,0,65,0
Pilots in 16-death crash jailed for praying instead of flying,0,1,1,48,1,9,2,49,0
Dozens of Afghan troops dead in Taliban base attack,0,3,3,40,0,8,0,43,0
"Many Plans to Curtail Use of Plastic Bags, but Not Much Action",0,1,9,41,1,11,0,50,0
"No one asked McDonald's to start serving crab sandwiches, but it did anyway",0,3,3,58,2,12,0,61,0
"For Just $4 Million, You Can Watch YG Perform ""FDT"" At Trump's Inauguration",0,3,15,42,5,12,1,57,0
Christian Slater Looked Perplexed During Tom Hiddleston's Golden Globes Speech,0,3,10,58,1,9,0,68,0
Nigeria to Cut Stake in Oil Assets Under Buhari's Economic Plan,0,3,9,43,1,10,0,52,0
Defense Secretary Jim Mattis distances himself from Trump's media bashing,0,3,5,58,1,9,0,63,0
Justice Iftikhar Muhammad Chaudhry reinstated as Chief Justice of Pakistan,0,1,7,58,0,9,0,65,0
Obama Watchdog in Congress Has New Target in Trump Era: Postal Reform ,0,3,10,47,1,12,0,57,0
Regional German Polling Gives Merkel Some Good News,0,3,8,36,0,7,0,44,0
Amazon Is Dominating the Holiday Shopping Season to a Shocking Degree,0,2,8,51,0,10,0,59,0
Jack Daniel's wants to fill your morning with whiskey-infused coffee,0,3,2,55,2,9,0,57,0
Slovakia on track to adopt euro in 2009,0,1,1,27,0,7,4,28,0
Donald Trump Has a Big Dick,0,2,5,17,0,5,0,22,0
One Side Makes Offer in Honduran Impasse,0,1,6,28,0,6,0,34,0
2008 Google Developer Day focuses on Internet APIs in Australia,0,1,8,42,0,9,4,50,0
It's Not The US But Singapore That Has Blocked Visas For Indian IT Professionals,0,3,16,50,1,13,0,66,0
"More than 100 die in riots in Ürümqi, China",0,1,3,28,1,8,3,31,0
Minnesota players' boycott could affect lead-up to Holiday Bowl,0,3,3,50,2,8,0,53,0
Oscars 2017: Test Your Knowledge ,0,3,4,19,1,5,4,23,0
Virginia crime commission endorses tougher dog law legislation,0,1,1,54,0,7,0,55,0
Swimmer Mary DeScenza Mounts Comeback After Missing Cut for Beijing,0,1,10,48,0,9,0,58,0
Survivors desperately need aid after deadly tornadoes slam Southeast ,0,3,2,58,0,9,0,60,0
"Ogilvy Lets Lead Dwindle, but Finishes on Top",0,1,6,31,1,7,0,37,0
Trump Health Secretary Pick’s Longtime Foes: Big Government and Insurance Companies ,0,2,10,61,2,11,0,71,0
General election: UK Parliament approves Theresa May's snap vote,0,3,6,48,2,8,0,54,0
"Missing teen's dismembered remains found, mom charged in disappearance ",0,3,1,59,2,9,0,60,0
More Home Buyers Backed Out of Offers in 2016,0,3,6,27,0,8,4,33,0
Net Neutrality Rules to Go Into Effect as Appeals Court Denies Stay,0,2,10,46,0,11,0,56,0
Faye Dunaway says she felt 'very guilty' about Oscars envelope fiasco,0,3,3,54,2,10,0,57,0
Migos Earns First No. 1 Album on Billboard 200 Chart With 'Culture',0,3,9,40,3,11,4,49,0
GM says Venezuela has seized its car plant,0,2,3,32,0,7,0,35,0
Two strong earthquakes rock Vanuatu,0,1,2,29,0,4,0,31,0
'Wayne's World' Turns 25: Here's What the Critics Said in 1992,0,3,7,34,5,10,6,41,0
Nonprofits Seek Lobby Rule Exceptions,0,1,5,28,0,4,0,33,0
Conservatives Map Strategies on Court Fight,0,1,5,33,0,5,0,38,0
"McKinney, Texas, Cop Placed on Leave After Pulling Gun on Teens at Pool Party",0,3,12,50,2,13,0,62,0
Steelers Shared Resources With 2 Teams During World War II,0,1,10,38,0,9,1,48,0
15 Survivors Seek $250M-Plus in Deadly Biloxi Train-Bus Crash,0,2,9,36,3,8,5,45,0
Ronald Moore Lifts Siena While Carrying Own Burden,0,1,8,35,0,7,0,43,0
Princeton Is Latest Ivy League School to Suspend Team Over Vulgar Materials ,0,2,11,53,0,12,0,64,0
World's largest reindeer herd plummets,0,3,1,32,1,4,0,33,0
8 ways we've changed since the last time we had a new president,0,3,0,49,1,12,1,49,0
Berlin attack: Brexit figurehead Arron Banks suggests Angela Merkel 'might as well have' driven lorry herself,0,3,6,85,3,15,0,91,0
Tim Tebow Hits 2nd Home Run of the Season for Columbia Fireflies,0,3,8,44,0,11,1,52,0
From me to you: readers' photos on the theme of gift,0,3,1,39,2,10,0,40,0
Peter King: Trump Surveillance Report Shows 'Shameful' Intel Violations  Insider,0,3,10,57,3,10,0,67,0
Trump Trade Agenda In Disarray Amid Signs Of Deal With China,0,3,11,39,0,10,0,50,0
UK Parliament: We Won’t Ban Trump Because Don’t Want To Give Him More Attention,0,2,15,48,3,13,0,63,0
Israel's Moshe Katsav to be freed on parole,0,3,3,32,1,7,0,35,0
Citi mortgage units fined $28.8 million,0,3,1,28,2,5,3,29,0
Moldovan wines win three medals at contest in Bordeaux,0,1,2,44,0,8,0,46,0
Marriage probabilities - Business Insider,0,3,3,33,1,4,0,36,0
"Mexican Tourism, Already Hurt by Violence, Bears Blow of a Health Scare",0,1,9,49,2,11,0,58,0
Out of space in outer space: Special report on NASA's 'space junk' plans,0,1,6,50,4,12,0,56,0
ECB Expected to Extend Bond-Buying Program,0,2,8,28,1,5,0,36,0
Live French election results and exit polls live: Centrist Emmanuel Macron tipped to win ,0,3,5,69,1,14,0,74,0
Of course Drake admits to drunk texting J-Lo on 'More Life',0,3,6,40,3,10,0,46,0
Kellyanne Conway's husband tipped for DOJ role,0,3,5,34,1,6,0,39,0
WikiLeaks denies Roger Stone's claim of backchannel to the group,0,2,4,50,1,9,0,54,0
DELINGPOLE: Rules for Righties — a War-Winning Manifesto for 2017,0,3,15,34,3,9,4,49,0
Greek government faces censure motion by opposition,0,1,1,44,0,6,0,45,0
A Woman Hasn't Been Nominated For A Directing Oscar In 7 Years Now,0,3,12,40,1,12,1,52,0
"As David Villa Scores, Rich Clubs Ponder Their Checkbooks",0,1,9,39,1,8,0,48,0
"‘No one eats alone’: Muslim-owned restaurant offers free Christmas meal for homeless, elderly",0,3,3,73,5,12,0,76,0
Children's hospital units forced to close to new patients due to staff shortages,0,3,1,66,1,12,0,67,0
European Union Lifts Ban on Indonesian Airlines,0,1,6,35,0,6,0,41,0
Sweden’s Telia Has Another Problem at Turkcell: Free Speech,0,2,8,41,2,8,0,49,0
Deer Debacle Exacerbates New York City Rivalry,0,3,7,33,0,6,0,40,0
"Britain will face 'very hefty bill' for Brexit, Jean-Claude Juncker warns",0,3,5,54,4,10,0,59,0
Latest Citigroup Rescue May Not Be Its Last,0,1,8,28,0,7,0,36,0
"From Israel to the N.B.A., Missing the Hummus",0,1,7,27,4,7,0,34,0
WATCH NOW: Lindsey Graham Faces Town Hall Crowd,0,2,14,25,1,7,0,39,0
6 LGBTQ Events Worth Traveling for in 2017,0,2,8,22,0,7,5,30,0
"Entry of lawful permanent residents in ""national interest,"" DHS secretary says",0,3,4,61,3,10,0,65,0
Victoria Beckham's Spice Girl Carpool Karaoke Is Here. Sort Of.,0,3,10,41,3,9,0,51,0
Western Stars win Women's National Wheelchair Basketball League championship in a thriller,0,1,7,71,1,11,0,78,0
Kyrgyzstan votes on referendum for new constitution,0,1,1,44,0,6,0,45,0
U.S. Returns Largest Tract of Okinawa Land to Japan in 44 Years,0,3,9,39,2,11,2,48,0
Streaming Online  - WatchESPN,0,2,7,17,1,4,0,24,0
"Odell Beckham Shows Off Supreme x Louis Vuitton, 'Toy Story' Cleats for Pro Bowl",0,3,12,52,3,13,0,64,0
Pakistan Wins World Twenty20 Championship,0,1,5,30,0,4,2,35,0
"What's Behind Turkey's Crisis-Era Inflation Levels, in 5 Charts",0,3,8,42,4,8,1,50,0
The United States And China Have Ratified The Paris Climate Agreement,0,2,11,48,0,10,0,59,0
Modest 6% Growth in Revenue for Google,0,1,4,26,1,6,1,30,0
White House: Feds will step up marijuana law enforcement,0,3,3,44,1,8,0,47,0
"A Drunk Driver Crashed Into A Parade Crowd at Mardi Gras, Hopsitalizing Least 21 People",0,3,13,57,1,14,2,70,0
Last of raisers of first U.S. flag over Iwo Jima dies,0,1,5,36,2,10,0,41,0
"***Live Updates*** Trump vs. Clinton, Round One - Breitbart",0,2,7,35,9,8,0,42,0
"A Nice, Staid Corner of Real Estate: Medical Offices",0,1,8,34,2,8,0,42,0
"Afghan teenager detained in rape, slaying of German student ",0,3,2,48,1,9,0,50,0
Broward County Sheriff’s police dog killed in shootout in Florida,0,1,4,51,1,9,0,55,0
Major League Baseball's Dirtiest Tradition May End With New Chemically Treated Balls,0,3,12,60,1,11,0,72,0
20th Century Fox Gives Real Apology for a Fake News Campaign ,0,2,8,40,0,11,2,48,0
Dear John: We’d best tread lightly with China,0,2,4,32,2,7,0,36,0
Bloomberg-backed Group to Help Poorer Students Graduate From College,0,2,8,51,1,8,0,59,0
2 suburban Chicago men arrested on terrorism charges ,0,3,1,43,0,8,1,44,0
Men 'bullied' out of generous divorce settlements by breadwinning wives,0,3,1,59,2,9,0,60,0
"Mark Zuckerberg Trolls Snapchat: Says 'Facebook Is For Everyone, Not Just The High End'",0,3,14,56,4,13,0,70,0
Manhattan Luxury Co-Ops Fall Out of Favor,0,2,7,27,1,6,0,34,0
Afghanistan: Suicide attackers kill several people in Kabul,0,1,3,48,1,7,0,51,0
His murder was put on Facebook. But his family’s message of forgiveness could be his legacy.,0,3,3,71,3,15,0,74,0
Former Motown Singer Chrisette Michele Will Perform at Donald Trump's Inauguration,0,2,10,61,1,10,0,71,0
Former Irish politician Liam Lawlor dies in car crash,0,1,4,41,0,8,0,45,0
"After Three Straight Titles, Jimmie Johnson Is Still Not Favored",0,1,10,44,1,9,0,54,0
Pence to open Asian trip amid increasing tensions with North Korea ,0,3,4,52,0,11,0,56,0
"Drake Darts to No. 1 Artist 100, Chuck Berry Debuts in Top 40",0,3,8,33,2,12,6,41,0
Singapore's 2017 Budget: Economist Takeaways,0,2,4,30,2,4,4,34,0
"Scotland predicted to have worst recession since 1980, but not as bad as rest of UK",0,1,3,60,1,15,4,63,0
University of Minnesota Football Team Ends Boycott After Sex-Assault Suspensions,0,3,10,60,1,9,0,70,0
Lou Piniella retires after fifty years of baseball,0,1,2,41,0,7,0,43,0
"California, at Forefront of Climate Fight, Won’t Back Down to Trump ",0,3,8,46,3,11,0,54,0
UK businesses call on Government to embrace low-carbon future and enact climate change legislation,0,3,3,81,1,13,0,84,0
'Don't Tip Black People': Racists Stiff Waitress Despite 'Great Service' At Virginia Restaurant (UPDATED),0,3,20,64,8,13,0,84,0
46 Die in Taliban Attack on Pakistani Troops,0,1,5,30,0,7,2,35,0
"Personalities can transform almost beyond recognition over a lifetime, study finds",0,2,1,70,1,10,0,71,0
Pelosi: ‘Of Course’ You Can Be a Democrat and Against Abortion,0,3,9,40,3,10,0,49,0
The Secret to Selling Manhattan’s Biggest Condo Project: Raise Prices,0,3,9,49,2,9,0,58,0
Obama: 'Vladimir Putin is not on our team',0,3,3,29,3,7,0,32,0
FCC Regulators Vote to Ease a Limit on TV Station Ownership,0,3,11,38,0,10,0,49,0
Another Silicon Valley guy locks down an escape plan,0,3,3,41,0,8,0,44,0
Immigration Tensions Seep Into South by Southwest,0,3,6,37,0,6,0,43,0
Was Barack Obama Bad for Democrats? ,0,3,5,24,1,6,0,29,0
Five-year-old boy dies after being pinned at rotating restaurant in Atlanta ,0,2,2,61,2,11,0,63,0
Child sex abuser Henry Clarke tracked down to Canada,0,2,4,40,0,8,0,44,0
"Intel acquires mobile Linux developer, OpenedHand",0,1,4,39,1,5,0,43,0
New Jersey real estate investor charged with $2 million theft,0,1,2,48,1,9,1,50,0
"Review: Allison Crutchfield, ’Tourist In This Town’",0,2,7,34,4,6,0,41,0
Texas Mayor Jess Herbst Comes Out As Transgender,0,2,8,33,0,7,0,41,0
'Late Show' Animation Expertly Skewers Donald Trump’s Reversal Of Transgender Bathroom Policies,0,3,12,69,3,11,0,81,0
Great British Bake Off: James accused of 'cheating' in Christmas special,0,3,6,53,3,10,0,59,0
Chris Berman's New Role with ESPN Revealed,0,2,9,26,1,6,0,35,0
"Trump says ""someone should look into who paid for"" tax return rallies",0,3,1,55,2,11,0,56,0
Kenya election: Kenyatta blames primaries chaos on turnout,0,3,2,48,1,7,0,50,0
Rolling Stones unleash new song critical of Bush,0,1,3,38,0,7,0,41,0
US free speech lawyer Marc Randazza discusses Glenn Beck parody,0,1,6,48,0,9,0,54,0
"Snap crackled, then popped: Shares fall below $20 for first time",0,3,2,47,3,10,2,49,0
"Cause of death determined for mother, teen daughter found in well",0,3,1,53,1,10,0,54,0
"Zenefits Lays Off 430 Employees, One Year After Founder's Departure",0,3,9,44,2,9,3,53,0
In Solidarity: Women's Marches Across the World - Video - NYTimes.com,0,3,10,44,5,10,0,54,0
Mondelez Lays Groundwork to Replace Its Chief Executive Irene Rosenfeld,0,3,9,53,0,9,0,62,0
Italians protest in mafia stronghold of Locri,0,3,2,37,0,6,0,39,0
Squid may become favourite UK meal as seas become warmer,0,3,3,44,0,9,0,47,0
The trick to getting credit card fees waived? Just ask.,0,3,2,42,2,9,0,44,0
"Wall collapse kills twelve in Chhattisgarh, India",0,1,3,39,1,6,0,42,0
G.M. to Maintain Legal Liability for Claims,0,1,6,29,2,6,0,35,0
Dan Coats Expected to Be Named Intelligence Director ,0,3,7,38,0,8,0,45,0
FIFA and European Union are set to collide,0,1,6,29,0,7,0,35,0
Spanair mechanics to be questioned under criminal suspicion over Flight 5022 crash,0,1,2,65,0,11,4,67,0
Twitter Sues Feds to Keep Anti-Trump Admin User ‘ALT_USCIS’ Anonymous,0,3,17,39,4,9,0,56,0
"Feds, Trump attorneys wrangle over president’s D.C. hotel lease",0,3,4,47,4,8,0,51,0
Hell Hath No Fury like a Weiner Scorned - Breitbart,0,2,7,34,1,9,0,41,0
Emerson Hyndman: ’I want to be part of this US team as quickly as possible’,0,2,5,53,3,14,0,58,0
"Paul George Survived the Trade Deadline, Now What?",0,2,7,34,2,7,0,41,0
Delaware Legalizes Betting on Sporting Events,0,1,5,35,0,5,0,40,0
"Brexit with no trade deal would cause 'significant damage' to service sector, say peers - Politics live",0,2,2,81,4,16,0,83,0
Pittsburgh Dominates San Diego to Reach A.F.C. Title Game,0,1,10,36,3,8,0,46,0
James Harden: Playing in all games should matter in MVP race,0,3,6,43,1,10,0,49,0
Study Warns of Threat to Coasts From Rising Sea Levels,0,1,8,37,0,9,0,45,0
Republic of Molossia hosts state visit,0,1,2,31,0,5,0,33,0
Mark Zuckerberg’s Wife Is Expecting a Baby Girl — and He Praises the Importance of Sisters,0,2,11,62,2,15,0,73,0
"Carl Paladino, a Trump Ally, Says Racist Remarks About Obamas Were Sent in Error ",0,3,12,53,2,14,0,65,0
Colson Whitehead on George Saunders’s Novel About Lincoln and Lost Souls ,0,2,9,52,1,11,0,61,0
Congressional panel concludes Gulf War Syndrome a legitimate condition,0,1,4,58,0,8,0,62,0
USA upsets Canada in Olympic ice hockey,0,1,5,28,0,6,0,33,0
Scientists improve cancer research techniques,0,1,1,40,0,4,0,41,0
"J.K. Just Maybe, Possibly, Probably Called Trump A ""Populist Maniac""",0,2,11,42,6,9,0,53,0
American Airlines Flight Attendant Suspended After Video of Altercation With Passenger Surfaces,0,3,11,73,0,11,0,84,0
Explorer-Scouts Train in Post-9/11 Law Enforcement Methods,0,1,7,39,3,6,3,46,0
"Reports: Model Kate Moss escorted off flight, accused of being disruptive",0,3,4,57,2,10,0,61,0
Blasts at 2 churches in Egypt kill dozens on Palm Sunday,0,2,4,41,0,10,1,45,0
Mexican Drug Lord Joaquin ‘El Chapo’ Guzman Extradited to U.S.,0,3,10,39,4,9,0,49,0
Australia lost $4.8b in 2014 to tax-dodging multinationals: Oxfam,0,3,2,45,4,8,6,47,0
Man Shot Dead After Sentence Was Commuted by Obama; Feds Move Halfway-House Inmates,0,3,13,56,2,12,0,69,0
Venezuela security forces battle anti-Maduro protesters,0,2,2,47,1,5,0,49,0
John Oliver Wants To Make You Finally Care About Gerrymandering,0,3,10,44,0,9,0,54,0
Exxon admits it lost up to a year’s worth of Rex Tillerson’s ’Wayne Tracker’ emails,0,2,5,60,4,14,0,65,0
2017 NFL Draft Big Board: Matt Miller's Post-Super Bowl Rankings,0,3,12,36,3,9,4,48,0
"Asylum-seekers held without clear reason in Pa. facility, advocates say",0,3,2,57,3,9,0,59,0
Italian Court Ruling Could Pave Way for Elections ,0,3,7,35,0,8,0,42,0
Donald Trump says he's not scared of a trade war with Canada,0,3,3,45,1,11,0,48,0
White House wealth: Trump employees disclose their finances ,0,3,3,48,1,8,0,51,0
Sony Music CEO confirms Apple's streaming service 1 day before WWDC,0,3,10,45,1,10,1,55,0
Two veteran actors to depart beleaguered soap 'Days of our Lives',0,1,3,50,2,10,0,53,0
Cleveland Browns punter Andy Lee to wear No. 8 to honor late child,0,3,5,47,1,12,1,52,0
Eastern Indonesia struck by earthquake,0,1,2,32,0,4,0,34,0
Stephen Colbert calls out Kellyanne Conway's 'free commercial' for Ivanka Trump's clothing,0,2,6,69,4,11,0,75,0
Secret Service fires two officers over March fence-jumping incident,0,2,3,55,1,8,0,58,0
'Late Show' Imagines Candidate Donald Trump Running Against President Donald Trump,0,2,11,59,2,10,0,70,0
"Gale Sayers and Dwight Clark, NFL legends with bad diagnoses, ‘suspect’ football is to blame",0,3,7,67,4,14,0,74,0
BP Sees Signs of Growth as Oil Prices Rise After Two-Year Slump,0,3,12,39,1,11,0,51,0
"U.S. automaker GM plans to close 1,100 dealerships",0,1,4,32,3,7,4,36,0
Voyager space probes face shutdown,0,1,1,29,0,4,0,30,0
"We went to the 24-hour 'ultimate' Taco Bell in Las Vegas, where they serve alcoholic Baja Blast slushies",0,3,7,74,4,17,2,81,0
Djibouti says war with Eritrea is inevitable unless UN intervenes,0,1,4,52,0,9,0,56,0
DHS will continue to enforce Trump's travel ban ,0,3,4,35,1,8,0,39,0
US fall foliage report: September 17,0,1,3,25,1,5,2,28,0
Inauguration Workers Cover Up 'Don's Johns' on Portable Toilets on Capitol Hill  Insider,0,2,11,61,3,13,0,72,0
"With Winks and Dunks, Players Stump for Votes",0,1,6,31,1,7,0,37,0
"For Trump, alleged use of sarin in Syria prompted a different reaction than other chemical weapons",0,3,3,79,1,15,0,82,0
Live updates from Hillary Clinton’s 2016 campaign kickoff rally in NYC [Video],0,3,7,53,3,11,4,60,0
At least twenty dead after landslides in Tanzania,0,1,2,40,0,7,0,42,0
NATO Official Sounds Alarm on Russia Libya Role ,0,2,10,30,0,8,0,40,0
"'Unprecedented' divide: Democrats fear recession, Republicans see a boom",0,3,3,57,4,8,0,60,0
9/11 Lawsuits Against Saudi Arabia Flow Into Federal Court Under 2016 Law,0,3,10,44,1,11,7,54,0
Health-care exchange sign-ups fall far short of forecasts,0,2,1,47,2,7,0,48,0
Trump's America Donald Trump's revised travel ban blocked by Hawaii court,0,3,5,56,2,10,0,61,0
"This Couple Did A ""La La Land"" Engagement Shoot And It’s Pretty Cute",0,2,13,40,3,12,0,53,0
"Serena Williams vs. Mirjana Lucic-Baroni: 2017 Australian Open Score, Reaction",0,3,9,52,4,9,4,61,0
Janice Min Transitions to Hollywood Reporter Parent Company,0,3,7,45,0,7,0,52,0
House votes to repeal Washington D.C. handgun ban,0,1,4,36,2,7,0,40,0
"Cargo Plane Crashes in Kyrgyzstan, Killing 37 ",0,3,5,31,1,7,2,36,0
"Ohio policeman helps girl, 10, with maths homework",0,3,1,38,2,7,2,39,0
U.S. Solar Industry Clamors for Workers as Jobs Climb by 25%,0,3,8,37,3,10,2,45,0
Meet President Trump’s Outside Legal Team,0,2,6,29,1,5,0,35,0
Mass industrial walkouts in UK,0,1,3,23,0,4,0,26,0
"Neolithic noodles found in Qinghai, China",0,1,3,32,1,5,0,35,0
Viceroy's House review – soapy account of India's birth agonies,0,3,3,48,3,9,0,51,0
Twenty dead after double suicide bombing in Iraq,0,1,2,39,0,7,0,41,0
Beck Completes His Fast: Calls Breitbart Executive Chairman ‘Goebbels’,0,2,9,50,3,8,0,59,0
Mark Bittman’s Shrimp In Green Sauce Recipe - NYT Cooking,0,3,11,35,2,9,0,46,0
Nine tips for apartment decorating on a budget,0,2,1,38,0,7,0,39,0
"Steven Yeun of ""The Walking Dead"" marries girlfriend Joana Pak",0,2,7,44,2,9,0,51,0
Corbyn’s anti-cuts message falls flat again as Tories take Copeland,0,3,3,53,2,9,0,56,0
"Half of GP surgeries open for under eight hours a day, Telegraph investigation reveals",0,3,4,68,1,13,0,72,0
Hackers are selling Yahoo data on the dark web,0,3,2,36,0,8,0,38,0
Burkini Ban: Police Have Already Punished Ten Muslim Women For Islamic Swimwear,0,2,12,55,1,11,0,67,0
"Florida Speaker Steps Down, Citing Corruption Investigation",0,1,7,45,1,6,0,52,0
Virgin Media and Universal Reach Download Deal,0,1,6,34,0,6,0,40,0
Hapless man is catapulted into the air by exploding cement as he climbs onto a heavy lorry to check the vehicle,0,3,1,90,0,20,0,91,0
Apple Inc. doubled its profits,0,1,2,23,1,4,0,25,0
People Are So Inspired By This Montreal Restaurant Giving Away Free Meals,0,2,12,50,0,11,0,62,0
"Cancer-stricken 5-year-old's photo used in charity scam, family claims",0,3,1,55,5,8,1,56,0
"New mom Carrie Underwood hits her stride at CMA Music Festival, discovers 'really good place' ",0,2,8,68,3,15,0,76,0
BP Nominates Russian to Oversee TNK-BP,0,1,10,22,1,5,0,32,0
Canadian church volunteers 'stopped from entering US over fears they'd steal American jobs',0,3,4,72,3,12,0,76,0
"Those Crazy Dongles Frustrate Apple, Too",0,3,6,28,1,5,0,34,0
A Textile Capital of China Is Hobbled by the Downturn,0,1,7,37,0,9,0,44,0
Ukraine presidential election headed for runoff,0,1,1,41,0,5,0,42,0
Chill wind blows though naturists' ranks as row splits world of nudism,0,3,1,57,1,11,0,58,0
Amsterdam Rediscovered: 6 Reasons To Visit Now,0,3,6,32,1,6,1,38,0
Heartbreaking Death Rocks 'The Vampire Diaries' Series Finale,0,2,8,44,2,7,0,52,0
Germany spends more on defence but misses Nato target,0,3,2,43,0,8,0,45,0
Tyson Launches $150 Million VC Fund That Could Help Hedge Against A Meatless Future,0,3,14,52,1,13,3,66,0
CanJet Flight 918 hijacked,0,1,3,17,0,3,3,20,0
Russian oil depot burning after explosion,0,1,1,35,0,5,0,36,0
People are pretty unimpressed that a bunch of American guys formed a K-pop group,0,2,3,63,1,13,0,66,0
Trump Chooses Ben Carson to Lead HUD ,0,3,8,22,0,7,0,30,0
James Harden is Our NBA MVP at the All-Star Break,0,3,12,27,1,9,0,39,0
Curious Case of Billion-Dollar Lithium Mine Sold for a Song,0,3,8,41,1,9,0,49,0
J.K. Rowling Reveals She's Working On New Books,0,3,9,28,3,7,0,37,0
"Finland, Estonia and Greece ratify the EU's Treaty of Lisbon",0,1,7,42,2,9,0,49,0
BREAKING NEWS: Man ‘kidnaps two young children then drives his car into crowds in Munich’ ,0,3,14,58,3,15,0,72,0
Future Makes It Rain in 'Drippin' Video,0,3,6,25,2,6,0,31,0
Report: Aging New York nuclear plant to close by 2021 ,0,3,4,35,1,10,4,39,0
Teacher Creates Tennis Ball Chair to Help Students With Autism With Sensory Issues ,0,3,12,58,0,13,0,70,0
Opposition Wins Presidency in Mongolia,0,1,4,30,0,4,0,34,0
Nicola Sturgeon says Margaret Thatcher inspired her Scottish nationalism,0,2,5,59,0,8,0,64,0
Rainbow 'Ziggy Stardust' snake among new Mekong delta discoveries,0,3,4,51,2,8,0,55,0
"Under Vladimir Putin, Russia Plays a Smart Round of Global Martial Arts ",0,3,10,49,1,12,0,59,0
Singapore Prime Minister Says Prospects of Trans-Pacific Partnership Have Dimmed,0,3,10,60,1,9,0,70,0
West Virginia public schools sued over Bible classes,0,3,3,42,0,7,0,45,0
A Dose of Skepticism on Government  Spending,0,1,5,32,0,7,0,37,0
This women's rugby player broke her nose -- and then made two big hits before leaving,0,3,1,66,3,15,0,67,0
'La La Land' looks set to smash yet another awards ceremony,0,3,3,44,2,10,0,47,0
UK elections: Gordon Brown offers resignation to secure Labour-Liberal coalition,0,1,6,63,2,9,0,69,0
Netflix Spokesperson Says Prince Discussed Reality Show ,0,2,7,42,0,7,0,49,0
St. Petersburg Subway Bomb Suspect Named as Akbarzhon Jalilov: Reports,0,3,9,50,2,9,0,59,0
"Dressed to frill: like her outfits, designer Molly Goddard’s reputation just keeps growing",0,3,3,72,3,12,0,75,0
Bruins’ mindless Julien penny-pinching can perfectly backfire,0,2,2,51,2,6,0,53,0
Senator Obama's passport records breached in January 2008,0,1,3,42,1,7,4,45,0
Washington state mumps outbreak nears 300 cases,0,3,1,37,0,6,3,38,0
Apple teases a new show that's basically 'Shark Tank' for apps plus celebrities,0,2,3,61,3,12,0,64,0
Theresa May risks becoming an accidental Europe-wrecker,0,3,3,45,1,6,0,48,0
"Playing Near Home, 12th-Seeded Gonzaga Upsets Fifth-Seeded Xavier",0,1,9,44,3,7,2,53,0
Pope attacked during Christmas Eve Mass,0,1,4,30,0,5,0,34,0
Italian ambassador to South Africa dies in accident,0,1,3,41,0,7,0,44,0
Economists: Working Class Whites ‘Dying Disproportionately’ from ‘Deaths of Despair’,0,3,8,62,5,9,0,70,0
2010 UK general election results,0,1,2,22,0,4,4,24,0
Ex-ESPN Employee Colin Cowherd Makes Grim Prediction About Company's Future,0,2,14,50,2,9,0,64,0
Uber Releases Diversity Report and Repudiates Its ‘Hard-Charging Attitude’ - The New York Times,0,2,13,65,4,13,0,78,0
Iraq Sentences 28 Cultists to Death for Attacks on Pilgrims,0,1,6,42,0,9,2,48,0
"Trump, Boeing CEO Discuss Air Force One Requirements ",0,3,10,34,1,8,0,44,0
"After Audience Fails To React At His Jokes, Kapil Sharma Cancels Shoot Within 15 Minutes!",0,3,14,57,2,14,2,71,0
How to Be Optimistic About a Post-Brexit Britain,0,2,7,33,1,7,0,40,0
Fake Shark Brings New Single 'Heart 2 Heart' to Life in Colorful Video: Premiere,0,2,11,52,3,13,1,63,0
American Woman Is Freed After Philippines Abduction,0,1,7,38,0,6,0,45,0
Louis Tomlinson’s mother Johannah Deakin dies aged 42,0,2,4,39,1,7,2,43,0
Minor earthquake shakes Illinois,0,1,2,27,0,3,0,29,0
Italian Opposition Leader Says He Failed,0,1,6,29,0,5,0,35,0
Contractor says Trump refusing to pay for work at DC hotel,0,3,4,44,0,10,0,48,0
Global stock markets plunge,0,1,1,23,0,3,0,24,0
"Super Bowl Commercials: Sony/ATV Leads Synchs, But It's a Big Year for Indie Publishers",0,3,15,55,4,13,0,70,0
Inside Taylor Swift's $25 Million Beverly Hills Mansion - Yahoo,0,3,8,41,3,9,2,49,0
17 troops killed in bombing on Afghanistan-Pakistan border; Separate bombing kills dozens of civilians,0,1,3,82,2,13,2,85,0
Donald Trump tax plan to cut income tax of wealthiest Americans by five per cent,0,3,3,63,0,14,0,66,0
"Graham Swift: ‘As a novelist, I’m in for the long haul’",0,3,4,36,5,10,0,40,0
‘It’s about a lot of things’: Trump team defends level of diversity in Cabinet [Video],0,3,4,62,6,14,0,66,0
Sweeping Federal Review Could Affect Consent Decrees Nationwide ,0,3,8,48,0,8,0,56,0
Chile Ravaged by Worst Fires in Its History,0,3,6,30,0,7,0,36,0
Miso-Ginger Dressing Recipe - NYT Cooking,0,3,8,26,2,5,0,34,0
"Twin bomb blasts in 2 Philippine malls kill 6, injure 38",0,1,2,39,1,10,4,41,0
State Senator Stewart Greenleaf enters New Hampshire primary,0,1,6,47,0,7,0,53,0
Stephen Colbert Addresses 'Golden Shower' Claims Like A Whiz,0,3,9,41,2,8,0,50,0
Press conference to be held Thursday on new 'Star Trek 11' movie,0,1,4,45,2,11,2,49,0
5 Shows to See in New York When You Have Only an Hour - The New York Times,0,2,13,42,1,17,1,55,0
"How Microsoft avoided billions in taxes, and what the GOP says it will do about it",0,3,5,61,1,15,0,66,0
Up for a ride? Chinese mall unveils a giant slide that can take shoppers down four floors in 12 seconds,0,3,2,79,1,19,2,81,0
Quaker website editor launches music podcast programme,0,1,1,47,0,6,0,48,0
Willow Smith Drops A Three-Song Project Called 'Mellifluous',0,2,9,41,3,7,0,50,0
SpaceX Will Take Two Travelers Around The Moon On A Trip Beginning Next Year!,0,2,15,48,1,13,0,63,0
Iraqi General Filing Suit to Close Newspaper and TV Channel Over Alleged Misquotes,0,1,12,58,0,12,0,70,0
China Lodges Diplomatic Protest After Trump's Call With Taiwan's President ,0,3,10,53,2,10,0,63,0
Samsung expects its Q4 profit to increase 50 percent despite the Note 7 fiasco,0,3,3,58,0,13,4,61,0
Remains of a child discovered in Jersey care home,0,1,2,39,0,8,0,41,0
U.S. shocks another European power in beating world champion Germany (Video),0,3,5,57,4,10,0,62,0
Why the apparel industry is embracing Muslim fashion,0,3,2,43,0,7,0,45,0
Adrian Peterson Rumors: RB Would Consider Pay Cut to Play for Patriots,0,3,11,47,1,11,0,58,0
Tent City For Homeless Heads to University of Washington Campus,0,3,8,46,0,9,0,54,0
"1,500 people, two Mercedes Benzes, 459 tonnes of luggage and a golden escalator: how the Saudi King travels",0,3,4,75,4,17,7,79,0
P!nk showed off all the weight she hasn't loss since giving birth and it's incredible,0,3,1,67,3,14,0,68,0
Solar powered plane completes first leg of transcontinental trip,0,1,1,55,0,8,0,56,0
"Pop Shop Podcast: Martin Garrix on Music Taking Him Around the World, Plus Grammy Nominations & More",0,2,14,67,3,16,0,81,0
MORNING BRIEF: Trump set to undo Obama's action against global warming ,0,2,14,44,2,11,0,58,0
Golf Balls in Hash Browns Lead to Recall,0,2,6,27,0,7,0,33,0
REPORT: Anthony Scaramucci is headed to the White House as an assistant to Trump,0,2,11,55,1,13,0,66,0
Madoff Never Made Supposed Investments,0,1,5,29,0,4,0,34,0
Firms Track and Sell Data on All Your Web Clicks,0,1,8,31,0,9,0,39,0
Delta Operations Recovering; Trump Blames Airline for Delays ,0,2,7,45,1,8,0,52,0
"Fair Hearing Ordered in Iran for Appeal by Reporter, Saberi",0,1,7,42,1,9,0,49,0
Doomsday Clock Moves Closer to Midnight Following Trump Election,0,3,8,48,0,8,0,56,0
S is for spray paint: share your artwork now,0,3,1,34,1,8,0,35,0
Thousands march in Moscow in opposition to Putin,0,3,3,38,0,7,0,41,0
Hurricane Matthew forces postponement of LSU-Florida football game; other sporting events in jeopardy,0,2,6,81,2,12,0,87,0
Australian growth forecast reduced to 2.7%,0,1,1,32,2,5,2,33,0
Electors Call for Intelligence Briefing on Russian Hacking Allegations ,0,3,7,55,0,9,0,62,0
Chinese Dissident Charged With Subversion,0,1,5,32,0,4,0,37,0
"Dog with nose, ears cut off undergoes reconstructive surgery",0,3,1,50,1,8,0,51,0
"Libby, former Cheney aide, pleads not guilty",0,1,2,34,2,6,0,36,0
Larry Bird's Exit a Warning That the Pacers Could Be in for a Tough Summer Ahead,0,3,11,53,1,15,0,64,0
British anti-Isil fighter Ryan Lock shot himself to avoid being taken hostage ,0,2,4,61,1,12,0,65,0
"In Loneliness, Immigrants Tend the Flock",0,1,5,29,1,5,0,34,0
Schumer: I wish we hadn't triggered 'nuclear option',0,3,2,39,4,7,0,41,0
Belgrade: demonstration against independent Kosovo escalates into riots,0,1,2,61,1,7,0,63,0
MLB All-Star Game Will No Longer Decide Home-Field Advantage for World Series,0,3,15,49,2,11,0,64,0
Why Leaking Information Is as American as Apple Pie,0,3,7,36,0,8,0,43,0
Watch this woman count money faster than a cash-counting machine,0,3,1,53,1,9,0,54,0
"Britain is heading for the hardest of hard Brexits, but Theresa May can limit the damage",0,2,4,68,1,15,0,72,0
Fillon France election: Party brings forward crisis meeting,0,3,3,48,1,7,0,51,0
A Clearing in the Fog of Complicated Air Travel,0,1,6,33,0,8,0,39,0
"Trump Inauguration Acts Unveiled: Toby Keith, 3 Doors Down to Perform",0,3,9,47,2,10,1,56,0
US First Lady undergoes neck surgery,0,1,4,27,0,5,0,31,0
Storm Sweeps Northeast From Texas; at Least 23 Are Dead,0,1,8,35,1,9,2,43,0
California congressman George Radanovich to leave office,0,1,3,47,0,6,0,50,0
Venezuela walks back move to strip congress' power ,0,3,1,41,1,8,0,42,0
Chicago Transit Authority announces repairs to Blue and Red Line,0,1,6,49,0,9,0,55,0
Tyler Lockett Injury: Latest on Seahawks WR's Leg and Recovery,0,3,9,42,2,9,0,51,0
Donald Trump to Discuss Personal Health Regimen on ’Dr. Oz Show’,0,2,9,42,3,10,0,51,0
"India's Favourite Chef, Vikas Khanna Features In The Top 10 Chefs Around The World List",0,2,14,55,2,14,2,69,0
"This Spring, You Won’t Have to Be Rich to Own a Picasso",0,3,9,33,2,11,0,42,0
Australian Immigration department removal of citizen was unlawful,0,1,2,56,0,7,0,58,0
Donald Trump’s First Six Days in Office: Here’s What He’s Done,0,2,10,38,4,10,0,48,0
NASA to announce new discoveries about ocean worlds,0,3,4,40,0,7,0,44,0
Donald Trump seemingly forgot Obama had an inauguration concert,0,3,3,52,0,8,0,55,0
Retail Pain Is Plain in March Jobs Report,0,2,7,27,0,7,0,34,0
Ralph Nader: Obama will likely face challenge in Democratic primaries,0,1,4,55,1,9,0,59,0
Japan school: Donation row grows for PM Shinzo Abe,0,3,6,35,1,8,0,41,0
U.S. News Reveals 2018 Best Graduate Schools Rankings,0,3,8,32,2,7,4,40,0
The Lumineers' 'Cleopatra' Climbs to No. 1 on Alternative Songs Chart,0,2,8,46,4,10,1,54,0
There’s nothing wrong with gawking over Richard Simmons’s disappearance,0,3,3,58,2,8,0,61,0
Trump doesn't represent American views on climate change: a visual guide,0,3,2,58,2,10,0,60,0
"Ted Cruz: Yes, Mitch McConnell Lied To Me And I Don’t Regret Saying It",0,2,15,39,3,13,0,54,0
"Half of the world's species could become extinct, biologists say",0,3,1,52,2,9,0,53,0
"Carrie Fisher 'Out of Emergency Room' After Suffering Heart Attack on Plane, Says Brother",0,3,12,61,3,13,0,73,0
Police Officer in Hot Water After Letting Women Twerk on His Police Car,0,3,11,48,0,12,0,59,0
Real books are back. E-book sales plunge nearly 20%,0,3,2,36,3,8,2,38,0
George Michael: His Life in Photos,0,3,5,23,1,5,0,28,0
Ikea drivers living in trucks for months,0,3,1,33,0,6,0,34,0
10 Seniors with the Best Chance to Win the Heisman Trophy in 2017,0,3,6,41,0,12,6,47,0
NBC News Video Disabled Vet And His Service Dog Land Job Together,0,3,14,40,0,11,0,54,0
'Supernatural' boss previews Sam and Dean's prison blues,0,3,3,43,3,7,0,46,0
Grammys get political early-on with James Corden as host ,0,3,3,44,1,9,0,47,0
2016 Was A Banner Year For HIV/AIDS Research,0,2,13,19,1,7,4,32,0
Radical Group declares Tsunami punishment from God,0,1,4,40,0,6,0,44,0
"After Obama sanctions Russia, Trump says it’s time ‘to move on to bigger and better things’",0,3,4,68,4,15,0,72,0
Dollar Rises Despite Jobs Miss,0,3,5,21,0,4,0,26,0
'Back to square one': Berlin is on high alert as authorities search for a culprit still at large,0,3,2,74,3,17,0,76,0
18 Things You’ll Get If You’re The Best And The Worst Person You Know,0,3,13,39,2,13,2,52,0
These Astrology-Inspired Makeup Looks Are Magical AF,0,2,9,36,1,6,0,45,0
John McCain’s cold-blooded revenge on Ted Cruz,0,2,5,33,2,6,0,38,0
Corpse of former President of Cyprus Tassos Papadopoulos stolen,0,1,5,50,0,8,0,55,0
"Highly contagious Hand, foot and mouth disease killing China's children",0,1,3,57,2,9,0,60,0
Indian Students Think Twice About Attending U.S. Universities,0,2,9,43,2,7,0,52,0
Young cancer victim's wish to 'blow stuff up' comes true,0,3,1,43,3,9,0,44,0
NFL players blast Kaepernick’s decision to sit during national anthem,0,2,4,55,1,9,0,59,0
"Flash flooding in Greece kills one, dozens of buildings flooded",0,1,2,51,1,9,0,53,0
'Deadpool 2' is Bringing Back Negasonic Teenage Warhead and Colossus,0,3,7,49,2,9,1,56,0
"Bomb attack in Londonderry, Northern Ireland injures two police officers",0,1,4,58,1,9,0,62,0
Somalia’s New Army Chief Survives Car Bomb That Kills 13,0,2,9,35,1,9,2,44,0
"Banker who worked as Russian secret agent to be released early, deported",0,3,2,58,1,11,0,60,0
Suicide bomber kills three people in Afghanistan,0,1,2,40,0,6,0,42,0
"Paul George, Jimmy Butler Celtics Trade Rumors Reportedly Had Cavaliers on Edge",0,3,11,56,1,11,0,67,0
Rupert Murdoch plans to step down as 21st Century Fox CEO,0,3,7,38,0,10,2,45,0
NSFW: Joe Soto Singlehandedly Turns UFC Fight Night 106 into a Bloodbath,0,3,14,43,1,11,3,57,0
Former athlete Sophie Cape says 'experimental' surgery crushed Olympic hopes and left her scarred,0,2,4,78,2,13,0,82,0
Nepal plane crash kills 19,0,1,1,19,0,4,2,20,0
Trump Vows to Contest Appeals Court's Ruling on Travel Ban,0,3,8,40,1,9,0,48,0
Here's why this general election matters more than any other in a generation,0,2,1,62,1,12,0,63,0
People Are Taking Their Frustrations Out On United Airlines By Trolling Them Hard,0,3,13,56,0,12,0,69,0
"Don Rickles, Comedy’s Equal Opportunity Offender, Dies at 90 ",0,3,7,40,3,9,2,47,0
Strike shuts down Toronto's transit system,0,1,2,34,1,5,0,36,0
BBC World Service to drop five languages,0,1,5,29,0,6,0,34,0
Tips for surviving switch to Daylight Saving Time - Yahoo,0,3,5,42,1,9,0,47,0
Space Shuttle Lands in California,0,1,4,25,0,4,0,29,0
Michael Jackson's Son Prince Pays Tribute to Dad With New Tattoo,0,3,10,43,1,10,0,53,0
"Jordan attack: Foreign tourist among nine killed in medieval castle attack, nearby shootings",0,3,2,76,2,12,0,78,0
What to Cook This Week ,0,3,4,14,0,5,0,18,0
China: 'the Dalai Lama is scheming to take the Beijing Olympics hostage',0,1,5,53,3,11,0,58,0
Drought Adds to Hardships in California,0,1,4,30,0,5,0,34,0
The Latest: Indonesia Search Efforts Hampered as Night Falls ,0,3,8,43,1,9,0,51,0
Thailand is struggling to handle its tourism boom,0,3,1,41,0,7,0,42,0
Erdogan Claims Vast Powers in Turkey After Narrow Victory in Referendum ,0,3,9,52,0,11,0,61,0
Bidding for tuna at Tsukiji,0,3,2,21,0,4,0,23,0
Korea's Chaebol Will Be Just Fine,0,3,6,21,1,5,0,27,0
Allergan just got exclusive access to a treatment that could revolutionize how we treat genetic diseases,0,3,1,88,0,15,0,89,0
Redskins defense comes up big to preserve 16-10 win against Ravens,0,2,2,49,1,10,4,51,0
Space Shuttle Discovery launch on indefinite hold,0,1,3,40,0,6,0,43,0
Police Arrest Gang of Migrants After Homeless Man Set Alight on Christmas Day,0,2,11,54,0,12,0,65,0
"‘Evil, evil, evil as can be’: Emotional testimony as Dylann Roof trial begins",0,3,4,56,5,12,0,60,0
"Watch Bill Paxton Talk About His Most Iconic Parts, from 'Weird Science' to ‘Titanic’ [Video]",0,3,13,59,7,14,0,72,0
Professor Keeps His Cool As Children Crash His Live BBC Interview,0,3,13,42,0,10,0,55,0
US troops in Iraq operating closer to front lines ,0,2,3,38,0,9,0,41,0
Venezuelan women’s response to the country’s economic crisis: Get sterilized,0,2,2,62,3,9,0,64,0
Donald Trump to fire army commander charged with inauguration security halfway through ceremony,0,2,2,81,0,12,0,83,0
The Universal Remote Dormant in Your Smartphone,0,1,6,35,0,6,0,41,0
Secret Service Agent on Leave After Saying She Wouldn't Take Bullet for Trump  Insider,0,3,12,59,1,14,0,71,0
Fifa bans Ghanaian referee Joseph Lamptey for life for 'match manipulation',0,3,4,59,2,10,0,63,0
Supreme Court Scraps Transgender Teen Gavin Grimm's Bathroom Case,0,3,9,47,1,8,0,56,0
"UCLA defeats USC, ends Trojans' BCS title hopes",0,1,11,27,2,7,0,38,0
Phelps Is a Touch Behind Peirsol at the UltraSwim Meet,0,1,8,37,0,9,0,45,0
Several GOP States Move to Block Their Own Funding to Sanctuary Cities  Insider,0,3,13,53,0,13,0,66,0
Tired of big companies using your data for profit? Use yours for good,0,3,2,54,1,12,0,56,0
UNC's Isaiah Hicks on Doorstep of Redemption After 2016 Title Game Heartbreak,0,3,11,50,1,11,4,61,0
Lindsey Graham: Russia's 'trying to undermine democracies all over the world',0,3,3,60,4,10,0,63,0
"Robert Gibbs: It Wasn’t Racism, Hillary Lost Because She Had No Economic Message - Breitbart",0,2,14,60,4,14,0,74,0
UK Jobcentre call centre staff on 48-hour strike,0,1,3,35,1,7,2,38,0
Bishop turns down promotion after protests over stance on women,0,3,1,53,0,9,0,54,0
Taste-Testing Wine Seized from Bernie Madoff’s Private Collection,0,3,8,48,2,7,0,56,0
Singer Bjork denounces sexism in pop music industry,0,3,2,42,0,7,0,44,0
Donald Trump's visit to the UK 'will be rescheduled' to avoid embarrassing him,0,3,4,59,3,12,0,63,0
MMA Fighter Leaves Opponent Stiff on Canvas Floor Via Overhand Right at TKO37,0,3,15,48,0,12,2,63,0
Man 'Bursting Out Of His Pants' Arrested For Cocaine Smuggling At Airport,0,3,12,48,2,11,0,60,0
British Airways give medals to Flight 38's crew,0,1,3,34,1,7,2,37,0
UK regulator warns MasterCard,0,1,4,22,0,3,0,26,0
Philippines taxi driver rewarded for returning valuables,0,3,1,49,0,6,0,50,0
Explosion injures 11 in Beirut,0,1,2,22,0,4,2,24,0
Baseball: Former Houston Astros pitcher José Lima dies suddenly at 37,0,1,6,50,1,10,2,56,0
"Website of Bill O'Reilly, FOX News commentator, hacked in retribution",0,1,8,49,3,9,0,57,0
Cyprus reunification talks: Everything you need to know about one of the world's most intractable disputes,0,3,2,87,2,15,0,89,0
Theresa May’s assumption of absolute power over Brexit spells disaster,0,3,3,57,1,9,0,60,0
Brady Aiken Rejected $5M and Got Hurt; Now Past No. 1 Pick Fights for MLB Future,0,3,15,45,3,15,2,60,0
Tsunami warning issued after earthquake near Japan,0,1,2,42,0,6,0,44,0
Tree surgeons scrambled to Blenheim Palace cedar made famous by Harry Potter,0,3,5,60,0,11,0,65,0
Russia launches most powerful nuclear attack submarine yet,0,2,1,50,0,7,0,51,0
Officer dies after accident in President Bush's motorcade,0,1,3,46,1,7,0,49,0
Q&A: Jacqui Lambie and Yassmin Abdel-Magied exchange barbs over sharia law,0,2,7,54,3,10,0,61,0
"Fourteen garden villages to be built in England totalling 48,000 homes",0,3,2,52,1,10,5,54,0
UN warns of humanitarian crisis in Gaza,0,1,3,30,0,6,0,33,0
Death Toll Rises in Tennessee Wildfires,0,3,5,29,0,5,0,34,0
At Least 74 Miners Are Killed in China Blast,0,1,7,27,0,8,2,34,0
President Obama names 16 recipients of the 2009 Presidential Medal of Freedom,0,1,5,55,0,11,6,60,0
Why is Trump suddenly talking about World War III?,0,2,7,34,1,8,0,41,0
Ebola nurse Pauline Cafferkey to return to Sierra Leone for 'closure',0,2,5,52,2,10,0,57,0
Manchester by the Sea plotline 'inspired couple to kill son',0,3,2,47,2,9,0,49,0
"Siemens Profit Drops 81%, but Revenue Is Up",0,1,6,26,2,7,2,32,0
"Turkish president's party loses parliamentary majority, faces struggle to form government ",0,3,1,76,2,11,0,77,0
Pringles gets 'loud' with line of potato-free chips,0,3,1,40,3,7,0,41,0
WARNING GRAPHIC: The Most Brutal Murders Linked to El Chapo’s Sinaloa Cartel - Breitbart,0,2,24,48,3,13,0,72,0
Telegraph Now Showing,0,3,3,16,0,2,0,19,0
This is 'Hellfire' â Americaâs missile of choice that can hit a target five miles away,0,2,3,66,6,15,0,69,0
Less-Famous Players From a 2004 Trade Are Joined on the Mets,0,1,8,37,1,10,4,45,0
"Raiders Punter Marquette King Challenges Broncos Fan to Fight, Deletes Account Instead",0,3,11,63,1,11,0,74,0
Al Franken may be the perfect senator for the Trump era — a deadly serious funnyman,0,3,3,64,1,15,0,67,0
Castor Pollux Wins Madoff Trading Business at Auction,0,1,7,39,0,7,0,46,0
U.S. Attorney Preet Bharara Fired After Refusing Justice Department Request to Quit,0,3,12,58,2,11,0,70,0
Spicer holds rapid-fire first press briefing,0,2,1,37,1,5,0,38,0
TRUMP'S TREASURY SECRETARY: No 'absolute tax cut' for the wealthy,0,3,24,28,4,9,0,52,0
"At Chesapeake Energy, Shareholders Who Act Like Owners",0,1,8,38,1,7,0,46,0
How To Blow $9 Billion: The Fallen Stroh Family,0,3,8,28,2,8,1,36,0
"US soldier convicted of Afghanistan massacre asked for reduced sentence, letter reveals ",0,3,3,72,1,12,0,75,0
Search for harmful Asian carp in Chicago area turns up nothing,0,1,3,49,0,10,0,52,0
Blue Jays' Chris Coghlan Soars over Cardinals Catcher Yadier Molina to Score,0,2,10,54,1,11,0,64,0
CDC Reminds Doctors to Watch Out for MERS,0,3,11,23,0,7,0,34,0
"Report: Gingrich, Giuliani, Priebus on Short List for Top Jobs in a Trump Administration - Breitbart",0,2,11,70,4,15,0,81,0
US aid flows in to Cuba to preserve Ernest Hemingway’s estate,0,2,5,45,1,10,0,50,0
Spurs Acquire Jefferson From Bucks for 3 Players,0,1,6,34,0,7,1,40,0
Tim Dowling: gigging with the band – and playing with fire,0,3,2,44,2,10,0,46,0
Bolivia Detains Airline Boss in Chapecoense Soccer Team Crash Probe,0,2,9,49,0,9,0,58,0
Winners of 2006 New Zealand Music Awards announced,0,1,5,34,0,7,4,39,0
Divorce in U.S. Plunges to 35-Year Low,0,2,6,21,3,6,2,27,0
"Clinton team to take part in U.S. state vote recount, Trump blasts effort",0,2,4,54,3,12,0,58,0
United Airlines Sued by Passenger Over Alleged Seat Removal,0,3,8,43,0,8,0,51,0
President Trump on Dow 20K: ‘I’m Very Proud of That’,0,2,8,29,4,9,2,37,0
Conan Dissects Donald Trump's Habit Of Taking Credit Where It Isn't Due,0,3,12,46,2,11,0,58,0
Scotland's oldest detainee facing attempted murder charges,0,1,1,50,1,6,0,51,0
"Resolve To Work 20 Hours A Day Or Leave, UP CM Yogi Adityanath Tells Babus",0,3,16,41,1,14,2,57,0
Nancy Pelosi Calls For Sean Spicer's Ouster Amid Holocaust Flap,0,3,10,43,1,9,0,53,0
Hugo Chavez meets Iran's Imam Khamenei,0,1,5,27,1,5,0,32,0
"For Wright and Dixon, the Drama",0,1,4,21,1,5,0,25,0
New Orleans: At least 28 injured after vehicle ploughs into mardi gras crowd,0,3,3,58,1,12,2,61,0
Trump White House Appears to Send Veiled Warning to Black Lives Matter Protesters,0,3,11,58,0,12,0,69,0
'The system works on goodwill': how cuts are affecting magistrates,0,3,1,53,3,9,0,54,0
The Time Has Come: Moving Vans Spotted Outside the Obama Family’s New D.C. Home,0,3,14,48,4,13,0,62,0
"Trump signals new hope for ObamaCare overhaul, says 'Do not worry!' ",0,2,4,49,4,11,0,53,0
Bon Iver's Justin Vernon Narrates Trailer for 'The Dundee Project' UFO Doc,0,3,13,47,3,11,0,60,0
New Fleet of Fume-Free Trash Collectors Heads to Central Park ,0,2,9,42,1,10,0,51,0
Draymond Green Stars in Parody of Kendrick Lamar's 'Humble' Video,0,3,8,45,3,9,0,53,0
Earth Gifted With Very First Pig-Human Embryo Thanks to Science,0,3,10,43,1,9,0,53,0
6 of Rihanna's Coziest Looks From Her Fenty x Puma Line,0,2,8,35,1,10,1,43,0
Oscar predictions: Who will win big?,0,3,2,27,2,5,0,29,0
NFL: Cowboys cornerback Pacman Jones can't discuss police incident,0,1,6,50,2,8,0,56,0
Fifth Harmony Cancels NHL All-Star Game Performance,0,2,10,34,1,6,0,44,0
Regulator bans UK video-on-demand service,0,1,3,32,2,4,0,35,0
Apple fights back against $14B tax bill,0,2,2,28,1,6,2,30,0
Syracuse's John Gillon Upsets Duke with Buzzer-Beater 3,0,3,7,38,2,7,1,45,0
"Kushner and Flynn Met With Russian Envoy in December, White House Says ",0,3,10,48,1,12,0,58,0
Lloyds Bank buys credit card company MBNA from Bank of America for £1.9bn,0,3,8,49,2,12,2,57,0
Wikinews interviews Dr. Phil Klotzbach on upcoming hurricane season,0,1,4,54,1,8,0,58,0
Local police don’t go after most cybercriminals. We need better training.,0,3,2,58,3,10,0,60,0
Pervert raped a hen because he ‘could not get a girlfriend’ as court hears bird ‘died from exhaustion’ ,0,3,1,80,4,18,0,81,0
A Russian Zoo is suing because someone made an 'erotic' video with one of their raccoons The list,0,3,4,74,2,17,0,78,0
US banking stocks record worst trading session in three weeks,0,3,2,50,0,9,0,52,0
German BND claims U.S. exaggerated Iraq WMD claims,0,1,10,31,2,7,0,41,0
"Warren Buffett Builds An $18 Billion Apple Stake, Creating A 'Big Seven' At Berkshire Hathaway",0,3,14,60,4,14,2,74,0
Wall Street dealmaking has exploded since Trump took office,0,3,3,48,0,8,0,51,0
Clemson's Jadar Johnson: J.T. Barrett not best QB we've faced,0,3,8,39,5,9,0,47,0
"Trump to 'repeal a lot' of Obama's actions on day one, top aide says",0,3,2,49,4,13,0,51,0
New video shows Texas police officer pulling gun on teenagers at pool party,0,2,2,61,0,12,0,63,0
"A Jets Quarterback, With Cheesecake on the Side",0,1,6,33,1,7,0,39,0
"Ted Cruz spanks his daughter, and Republicans are A-OK with that",0,2,6,46,2,10,0,52,0
Australia's Governor-General cuts trip short over looming election,0,1,3,54,2,7,0,57,0
Donald Trump: 'You always have to be concerned' about thermonuclear war with North Korea,0,3,5,67,3,13,0,72,0
"Merkel Pushes Back on Trump's Media Attacks, Calls for ‘Respect’",0,3,8,43,4,9,0,51,0
Texas trooper who arrested Sandra Bland officially fired,0,2,3,46,0,7,0,49,0
Trump on Russian hacking: 'I don't believe it',0,3,3,32,4,7,0,35,0
"Cristiano Ronaldo Is A Hero Off The Field Too, Saves 80 Dogs And Prevents Portuguese Kennel From Closing Down",0,2,18,70,1,18,2,88,0
Summers and Eurasia Start the New Year With Dire Global Warnings,0,3,9,45,0,10,0,54,0
South Korean President Park Seen Likely to Be Voted Out ,0,3,9,37,0,10,0,46,0
Mass murderer Anders Breivik gives Nazi salute in court ,0,3,4,43,0,9,0,47,0
Knicks President Phil Jackson and Lakers President Jeanie Buss End Engagement,0,3,10,57,0,10,0,67,0
Porn movie streamed through municipality loudspeaker in Turkish town,0,2,2,58,0,8,0,60,0
How Lasers and a Goggle-Wearing Parrot Could Aid Flying Robot Designs,0,3,10,48,1,10,0,58,0
Great Barrier Reef: Two-thirds damaged in 'unprecedented' bleaching,0,3,4,52,4,7,0,56,0
Bill O'Reilly goes on vacation for some 'R&R' amid sexual harassment scandal,0,3,5,56,4,11,0,61,0
Kimi Räikkönen wins 2008 Spanish Grand Prix,0,1,5,28,0,6,4,33,0
Hillary Clinton Holds Fire On GOP,0,2,8,20,0,5,0,28,0
Boeing and Airbus Prepare (Again) for Tanker Battle,0,1,6,36,2,7,0,42,0
"Mom Spends $2,000 on Nearly 300 Presents for Her Kids [Video]",0,3,7,33,4,10,7,40,0
Stabbing at Massachusetts high school leaves one dead,0,1,2,44,0,7,0,46,0
7.4 earthquake strikes Bonin Islands in Japan,0,1,3,33,1,6,2,36,0
"Now, People Harassed, Roughed Up For Not Standing Up For The National Anthem At Chennai Film Festival",0,3,17,66,2,16,0,83,0
It Takes a Suburb: A Town Unites to Tackle Student Stress ,0,3,9,37,1,11,0,46,0
Obama says his family's ready to leave the White House,0,3,3,41,1,9,0,44,0
UK mountain run abandoned as participants seek shelter from appalling conditions,0,1,2,68,0,10,0,70,0
Dez Bryant Tries to Attend Cowboys QB Meeting After TD Pass vs. Lions,0,2,13,43,1,12,0,56,0
"Katy Perry Apologizes to Ryan Phillippe for Dating Rumors: 'Nice to Meet You, Sorry Bout That'",0,3,13,62,4,15,0,75,0
"Labour is in deep trouble, but it’s our only defence against a Tory landslide",0,3,2,60,2,13,0,62,0
Trump’s Dual Roles Collide With Openings in Dubai and Vancouver ,0,2,8,45,1,10,0,53,0
"World Bank says more people are poor, but fewer are in extreme poverty",0,1,2,55,1,12,0,57,0
Nintendo of America Co-Founder Alan Stone Dead at 71 - Breitbart,0,2,8,42,2,10,2,50,0
Check out Antarctica's growing ice shelf crack from space,0,3,2,46,1,8,0,48,0
Russia’s RT Network: Is It More BBC or K.G.B.? ,0,2,13,19,6,9,0,32,0
Togo unanimously vote to abolish the death penalty,0,1,1,42,0,7,0,43,0
Cars Talking to One Another? They Could Under Proposed Safety Rules ,0,3,10,46,1,11,0,56,0
Controversial wind farm approved by US government,0,1,3,40,0,6,0,43,0
April the giraffe in NY has calf before 1.2 million online ,0,3,3,42,1,11,2,45,0
Rodrigo Duterte: Philippines leader 'not ready' to talk to rebels,0,2,3,50,3,9,0,53,0
Man 'ran into ocean to avoid £375 restaurant bill',0,3,1,35,3,8,3,36,0
Secret Teacher: our 'perfect' school is just keeping up appearances,0,2,2,53,3,9,0,55,0
"U.S. Cassette Album Sales Increased by 74% in 2016, Led by 'Guardians' Soundtrack",0,3,9,48,6,12,6,57,0
"Two Great Players, One Great Moment at the British Open",0,1,8,37,1,9,0,45,0
"See inside the $5.5 million Washington, DC, home where Ivanka Trump and Jared Kushner are reportedly moving",0,3,8,77,4,16,2,85,0
Ukraine wants to blacklist French presidential candidate Marine Le Pen over her comments on Crimea,0,3,6,78,0,14,0,84,0
2008 TaiSPO: Interview with Ideal Bike Corporation and Gary Silva,0,1,10,41,1,9,4,51,0
Brexit Migration Cap Gets Backing of Former U.K. Tory Ministers,0,3,10,42,2,9,0,52,0
Boris Johnson pressed for UK to keep selling bombs to Saudi Arabia after air strike killed 140 at funeral,0,3,6,78,0,18,3,84,0
American Woman Found Dead in Panama Was Columbia Graduate ,0,3,8,41,0,9,0,49,0
Student Debt in America Has Hit a New Record,0,3,7,29,0,8,0,36,0
Sean Spicer disrespected millions of people with his thoughtless remarks about Adolf Hitler,0,3,4,75,0,12,0,79,0
Dozens of cats removed from feces-ridden New Jersey house,0,1,3,45,1,8,0,48,0
5 Times That Christopher Lee Played Great Movie Villains,0,2,8,39,0,8,1,47,0
Fats Domino rescued in New Orleans,0,1,4,25,0,5,0,29,0
Drake Pays Tribute to President Obama with Strange Mash-Up Image (And It's Blowing Up Online),0,3,14,61,4,14,0,75,0
Eli Manning Says He's Done 'Nothing Wrong' Amid Memorabilia Scandal,0,3,10,45,3,9,0,55,0
Research in Motion to launch new tablet device,0,1,2,37,0,7,0,39,0
Mariah Carey Confirms Relationship With Backup Dancer Bryan Tanaka,0,3,9,49,0,8,0,58,0
Tropical Storm Andres is designated,0,1,3,28,0,4,0,31,0
Rioting develops throughout England,0,1,2,30,0,3,0,32,0
Pence says Gorsuch would be worthy successor to Scalia,0,2,3,43,0,8,0,46,0
Fans Tweet About Mental Illness to Honor Carrie Fisher ,0,3,8,38,0,9,0,46,0
"‘My Life as a Zucchini’ Review: Magical, Youthful Resilience ",0,2,7,41,4,9,0,48,0
Golden Gate Bridge Finally Getting A Suicide Barrier,0,2,8,37,0,7,0,45,0
Pakistan Building Its 'First Missile Warship' That Would Protect CPEC Route,0,2,14,49,2,10,0,63,0
"Car bomb in Ciudad Juárez, Mexico kills several, many injured",0,1,4,46,2,9,0,50,0
India announces Lok Sabha elections for 2009,0,1,3,31,0,6,4,34,0
Some Cleveland Cavaliers feel team would benefit by giving more players minutes,0,3,3,65,0,11,0,68,0
"If Republicans Can’t Get This Lawmaker, Obamacare Repeal May Be Dead",0,2,11,45,2,10,0,56,0
Trump throws weight around Washington,0,2,2,31,0,4,0,33,0
Skyward: Fox buys film about family trying to escape over a wall,0,3,2,50,1,11,0,52,0
Melania Trump's first official White House portrait revealed ,0,3,4,48,1,8,0,52,0
How to resist Trump 101: Harvard students launch new course for activists,0,3,3,55,1,11,3,58,0
13 Times Emma Watson Totally Nailed The Whole Feminism Thing,0,3,9,40,0,9,2,49,0
India Set To Triple The Amount Of Nuclear Power It Produces By 2024,0,2,12,39,0,12,4,51,0
The Economy Intrudes on a Haven of Faith,0,1,5,28,0,7,0,33,0
Colombian police claim that Venezuelan government paid FARC rebels $300 million,0,1,6,59,1,10,3,65,0
B1A4 Get Intimate With Fans & Spotlight Musicality at New York Concert Return,0,3,12,50,1,12,2,62,0
"Redskins in great shape to make the playoffs, thanks to the Cowboys",0,3,2,53,1,11,0,55,0
Joe Biden Signed That Viral Picture Of His Hot Younger Self Because 2017,0,3,12,44,0,12,4,56,0
Why California banned holding smart phones in cars The list,0,3,3,47,0,9,0,50,0
"New mom Carrie Underwood hits her stride at CMA Music Festival, discovers 'really good place' ",0,3,8,68,3,15,0,76,0
Army Leaker Chelsea Manning on Obama’s ‘Short List’ for Commutation,0,2,8,47,3,9,0,55,0
Betty White Requests a 'Golden Girls' Reboot for Her 95th Birthday ,0,2,8,44,2,11,2,52,0
G.E. to Build Research Center Near Detroit,0,1,7,27,2,6,0,34,0
Cheney meets with Israeli and Palestinian leaders,0,1,3,40,0,6,0,43,0
"SXSW: Pope Francis’ Twitter, Instagram Accounts Get Help From This Bishop",0,3,14,46,3,10,0,60,0
House Intelligence Committee Chairman Devin Nunes Steps Aside From Russia Probe,0,3,11,58,0,10,0,69,0
Testosterone gel shows no benefit for older men's memories ,0,2,1,48,1,9,0,49,0
H.H. Prince Karim Aga Khan IV visits Pakistan,0,1,9,27,2,7,0,36,0
"Hall Passes, Buses, Lunch Duty: What If The Principal Could Focus On Achievement?",0,2,13,52,4,12,0,65,0
FEMA head relieved of duties,0,1,4,20,0,4,0,24,0
Housing options help autistic adults find independence ,0,2,1,47,0,7,0,48,0
"Revealed: 1,900-year-old Roman house covered in PENIS-shaped amulets is discovered in Israel",0,3,8,64,5,11,4,72,0
U.S. Intel Agencies Preparing Dossier to Prove Russian Hacks,0,3,9,41,2,8,0,50,0
Ex-State Senator in Pennsylvania Is Sentenced for Fraud,0,1,7,40,1,7,0,47,0
Syria conflict: Army cuts IS supply route into al-Bab,0,3,5,38,2,8,0,43,0
Kangaroos escape in France,0,1,2,21,0,3,0,23,0
"Comcast ‎Xfinity Truck Blocks Traffic, Sends Cars Careening Off Icy Road",0,2,11,49,2,10,0,60,0
"ISIS Is Winning the Social Media War, U.S. Concludes ",0,2,12,29,3,9,0,41,0
Gene therapy lets a French teen dodge sickle cell disease,0,2,2,46,0,9,0,48,0
Aleppo evacuation: Thousands wait to leave as 'new deal reached',0,3,2,50,3,9,0,52,0
The Code Switch Podcast Extra: No Words,0,2,7,25,1,6,0,32,0
"David Rockefeller, Billionaire Businessman and Philanthropist, Dies at 101",0,3,6,55,2,8,3,61,0
The Isis campaign against Iraq’s Shia Muslims is not politics. It’s genocide,0,3,6,56,3,11,0,62,0
Drop in Newspaper Circulation Accelerates,0,1,4,33,0,4,0,37,0
Teräsbetoni frontman J. Ahola on representing Finland at Eurovision 2008 & more,0,1,5,57,2,11,4,62,0
Mike Freeman's 10-Point Stance: Belichick Sets Sights on Latest NFL Juggernaut,0,3,12,51,3,10,2,63,0
"Record numbers of Americans are giving up their citizenship, government data shows",0,3,2,68,1,11,0,70,0
The Schuyler Sisters from 'Hamilton' give sisterhood a shout out in stellar Super Bowl performance,0,3,6,76,2,14,0,82,0
Trump Launches Attack on Unnamed Press Sources,0,3,6,34,0,6,0,40,0
China Bans Veils and ‘Abnormal’ Beards in Western Province of Xinjiang,0,3,8,50,2,10,0,58,0
"Moon, Ahn and a Self-Described Strongman Vie to Lead South Korea",0,3,9,43,2,10,0,52,0
"Malcolm Turnbull grilled by Leigh Sales over 'Australian values', citizenship test overhaul",0,3,5,72,3,11,0,77,0
Trump's new health secretary already planning changes to Obamacare,0,2,2,55,1,8,0,57,0
April the giraffe gives birth before online audience - ABC News,0,3,5,47,1,10,0,52,0
Beyonce Expecting Twins With Jay Z ,0,3,6,23,0,6,0,29,0
Profit Rises but Johnson & Johnson Expects a Weak Year,0,1,7,37,1,9,0,44,0
"Floyd Mayweather, Manny Pacquiao Top Forbes' 2015 List of Highest-Paid Athletes",0,2,10,52,3,10,4,62,0
Carpenters' Surviving Member Suing Universal Music Group Over Digital Royalties,0,2,10,59,1,9,0,69,0
"Tour Gary Player's Incredible South African Stud Farm, Now for Sale",0,3,10,45,2,10,0,55,0
Kris Kobach: Democrats Already Attacking Election Integrity Commission,0,2,8,54,1,7,0,62,0
US military to withdraw military trainers from Pakistan,0,1,3,45,0,7,0,48,0
Is That A Brown Recluse Spider Bite Or Skin Cancer?,0,2,10,31,1,9,0,41,0
Qatar Said to Be Pondering a Stake in Porsche,0,1,6,31,0,8,0,37,0
Israel rules out talks with Palestinian hunger striking inmates,0,3,2,53,0,8,0,55,0
Kentucky coal museum switching to solar power,0,2,1,38,0,6,0,39,0
LeBron James causes stir with message to Instagram model,0,2,4,44,0,8,0,48,0
Where the Still Flourishing Underground Economy Is the Only Economy,0,1,8,50,0,9,0,58,0
"NASA and ""Hidden Figures"" team honor John Glenn and female space pioneers",0,3,8,52,2,11,0,60,0
Best Buy employees pool money to buy Wii for boy who visited daily,0,2,3,51,0,12,0,54,0
Melania Trump re-files Daily Mail lawsuit without controversial wording,0,3,4,58,1,8,0,62,0
What We Know in France: Macron and Le Pen Appear Headed for Runoff ,0,3,10,43,1,13,0,53,0
What the Hell Did Conor McGregor Wear to the Grand National?,0,3,9,40,1,10,0,49,0
Egypt Accuses Hezbollah of Plotting Attacks and Arms Smuggling to Gaza,0,1,8,52,0,10,0,60,0
Suicide bomber attacks Egypt's Luxor temple tourist site,0,2,3,45,1,7,0,48,0
Watch Live: Officials Give Update on Fort Lauderdale Airport Shooting,0,2,9,50,1,9,0,59,0
Magazine Ad Pages Down Almost 26% in Quarter,0,1,6,28,1,7,2,34,0
"7.1 magnitude earthquake strikes Araucanía, Chile; no tsunami warning",0,1,2,54,3,8,2,56,0
Kosher Label Missing From Girl Scout Cookies,0,1,7,31,0,6,0,38,0
"Skin-to-skin contact safe for vulnerable premature babies, research shows",0,3,1,61,3,8,0,62,0
Police Believe New York Judge Found in Hudson River Committed Suicide ,0,3,10,49,0,11,0,59,0
Here are the Most Innovative States in America in 2016,0,3,5,36,0,9,4,41,0
Billie Lourd posts touching Instagram tribute to Carrie Fisher and Debbie Reynolds,0,2,7,64,0,11,0,71,0
Mother drugged 9-year-old daughter and burnt her to death amid bitter custody battle,0,3,1,68,2,12,1,69,0
"In South Korea, All of Life Is Mobile",0,1,7,22,1,7,0,29,0
American actress Estelle Getty dead at age 84,0,1,3,33,0,7,2,36,0
George Bush meets with US governors,0,1,4,26,0,5,0,30,0
Aaron Hernandez Trial Aaron Hernandez Acquitted in Double Murder,0,3,8,48,0,8,0,56,0
1MDB scandal: Singapore files 16 charges against Falcon branch manager amid bank probe,0,3,5,65,1,12,3,70,0
"Historic building in Moscow collapses, three people killed",0,1,2,48,1,7,0,50,0
2011 'Pichileminian Week' ends,0,1,2,19,2,3,4,21,0
Major American Airlines delays in Philly affecting other cities,0,2,4,51,0,8,0,55,0
Trump Force One Is Ready for Takeoff,0,3,6,24,0,6,0,30,0
NBA Lakers to Erect Shaquille O'Neal Statue 10 Feet off Ground at Staples Center,0,3,13,51,1,13,2,64,0
"Another Setback For Kapil Sharma, Stand Up Comedian Accuses Him Of Plagiarism In A Long FB Rant",0,2,18,60,1,16,0,78,0
"In Madoff, a Court Trusts",0,1,4,16,1,4,0,20,0
Friar dog adopted by monastery becomes online sensation ,0,2,1,47,0,8,0,48,0
Eurovision 2008: First semi-final held in Belgrade,0,1,3,35,2,6,4,38,0
"Man jailed for 1957 murder to be freed, granted new trial",0,2,1,41,1,10,4,42,0
Bonn meeting ends with last-minute compromise on Paris climate text,0,2,2,55,1,9,0,57,0
’I Am No Longer A Dem’: Hillary Clinton Blasted Over Racist Skit - Breitbart,0,2,13,46,4,13,0,59,0
"Medtronic Paid $788,000 to Doctor Accused of Faking Study",0,1,6,35,2,8,6,41,0
There’s no evidence that Trump’s inauguration was the most-watched in history. Period.,0,3,3,67,5,11,0,70,0
Why press freedom is under the cosh in the UK,0,2,3,33,0,9,0,36,0
North Korea warns Australia of possible nuclear strike if it 'blindly toes US line',0,3,5,63,2,13,0,68,0
NASA to extend the Phoenix probe mission by 5 weeks,0,1,5,36,0,9,1,41,0
Nancy Pelosi in Balancing Act on ‘Fast-Track’ Powers for Trade Deal,0,2,9,45,3,10,0,54,0
"Study: Cancer Deaths Vary Depending On Where You Live, In Some Cases Dramatically",0,3,13,54,2,12,0,67,0
Rahul Dravid's Students Do The Country Proud As India Defeat Sri Lanka To Win 3rd Consecutive Under-19 Asia Cup!,0,3,18,70,3,18,3,88,0
Property Taxes in New York City Skyrocket ,0,3,6,29,0,7,0,35,0
Canadian PM vows to push ahead with same-sex marriage bill,0,1,3,45,1,9,0,48,0
Officials: US drone strike kills five in Pakistan,0,1,4,37,1,7,0,41,0
Avril Lavigne Condemns Mark Zuckerberg Over Nickelback Joke,0,3,8,44,0,7,0,52,0
Laura Prepon and Ben Foster expecting first child,0,2,4,38,0,7,0,42,0
"Despite the ‘Yuck Factor,’ Leeches Are Big in Russian Medicine ",0,3,8,42,3,10,0,50,0
"ISIS has sent 400 fighters to attack Europe, officials say",0,2,5,40,1,9,3,45,0
Inspiring America: Chicago Program Helps Steer Young Men Away From Violence,0,3,11,53,1,10,0,64,0
General of Egyptian army intends to use full force to stop protests,0,1,2,54,0,11,0,56,0
Watch: Rapper Waka Flocka Flame Wipes Butt with Fan’s Trump Jersey,0,3,10,44,2,10,0,54,0
Ashley Madison owner agrees to pay $1.6 million to settle U.S. investigations,0,3,4,56,4,11,2,60,0
Unlikely 1-2 Finish for Brawn Team in Formula One Season Opener,0,1,8,42,1,10,2,50,0
Same-sex marriage reaffirmed in Canada,0,1,2,31,1,4,0,33,0
"Wendy's is roasting people on Twitter, and it's hilarious",0,3,2,44,3,8,0,46,0
"Pfizer, Allergan scrap $160 billion deal after U.S. tax rule change",0,2,4,46,4,10,3,50,0
Live coverage from ABC News [Video],0,2,6,22,2,5,0,28,0
Trump’s ’America First’ Agenda Marks Sharp Break In U.S. Economic Policy,0,2,12,45,5,10,0,57,0
Lebanon: UN resolution won't end conflict,0,1,3,31,2,5,0,34,0
Baseball: Oakland Athletics defeat LA Angels 10 to 4,0,1,6,34,1,8,3,40,0
Penalty rates: Government offers few recommendations to Fair Work Commission,0,3,5,61,1,9,0,66,0
"‘Demonic activity was palpable’ at Trump’s rally, pastor says",0,2,2,47,4,8,0,49,0
"Small farmers struggle worldwide, but Palestinian farmers really have it rough",0,3,2,65,1,10,0,67,0
Detroit Courts Vie to Host Potential Bankruptcies,0,1,6,37,0,6,0,43,0
Sean Spicer Inaccurately Claims Paul Ryan’s Health Care Bill ’Fully’ Repeals Obamacare - Breitbart,0,2,13,68,4,13,0,81,0
Canada's Conservatives launch new ad campaign,0,1,2,37,1,5,0,39,0
How to resist Trump 101: Harvard students launch new course for activists,0,2,3,55,1,11,3,58,0
South China Sea: US aircraft carrier strike group conducts patrols in disputed waters,0,3,5,67,1,12,0,72,0
St Petersburg metro attack: 'Bomb' found in city raid,0,3,3,39,3,8,0,42,0
"Pence Does What Trump Couldn’t, with Solid Debate",0,2,7,33,2,7,0,40,0
Preet Bharara’s Probes Likely to Continue After His Exit,0,2,8,39,1,8,0,47,0
Germans on trial over refugee attacks,0,3,1,31,0,5,0,32,0
Aerodynamics on Land: Aiming for 800 M.P.H.,0,1,6,24,4,6,3,30,0
The maker of EpiPen won’t answer this yes or no question about its DOJ settlement,0,2,6,60,1,14,0,66,0
2 Other Times Kellyanne Conway Referenced Bowling Green 'Massacre' or 'Attack' ,0,3,9,54,4,11,1,63,0
Northern Irish police raid women's homes in crackdown on abortion pills,0,2,2,58,1,10,0,60,0
France Looks to Help Airbus With Loan Guarantees,0,1,7,34,0,7,0,41,0
Winners and losers in President Trump's proposed budget,0,2,3,44,1,7,0,47,0
Leader of Indian BJP party visits Navi Mumbai to support candidates for general election,0,1,7,68,0,13,0,75,0
Lebanon to Auction Energy Rights in Area Contested by Israel,0,2,7,44,0,9,0,51,0
Old-School Dr. Seuss Drawings Skewer Fascism One Frightening Drawing At A Time,0,3,13,52,2,11,0,65,0
"In Mr. Pence’s new D.C. neighborhood, not exactly the welcome wagon",0,3,5,47,5,10,0,52,0
Southern Sudan's defence minister among those killed in major plane crash,0,1,2,60,1,10,0,62,0
What Kids Wish Their Teachers Knew ,0,3,6,23,0,6,0,29,0
Obama's failed trade agenda leaves wake of winners and losers set for Capitol Hill  rematch ,0,3,3,72,1,16,0,75,0
"Hello, World: The Winter Olympics in one year",0,2,5,31,2,7,0,36,0
Justin Amash Emerges as Leading Critic of Fellow Republican Donald Trump,0,2,9,53,0,10,0,62,0
"Priyanka Chopra's Koffee Teaser, SRK's Valuable Teachings For His Sons & More From Ent!",0,3,15,54,5,13,0,69,0
Ice Hockey: Detroit Red Wings beat San Jose Sharks 7-1 in fourth NHL quarter final match,0,1,11,58,2,15,2,69,0
Ex-NFL star Aaron Hernandez found not guilty of 2012 double murder,0,2,6,45,1,10,4,51,0
"Obama, Visiting G.O.P. Lawmakers, Is Open to Some Compromise on Stimulus",0,1,11,46,5,10,0,57,0
General Tso's chicken inventor dies at 98,0,3,2,30,1,6,2,32,0
DNC chair candidate wants to 'shut other white people down' ,0,2,3,45,2,10,0,48,0
Exclusive: Iraq plans to sell oil through Iran if talks with Kurds fail,0,2,4,54,1,12,0,58,0
Times Journo Calls for Assassination of President Trump,0,2,6,42,0,7,0,48,0
Janice Dean: Always read the fine print -- the last two months have been a real pain in the neck ,0,2,3,71,3,20,0,74,0
Election in Moldova instigates rioting mob demanding recount,0,1,2,51,0,7,0,53,0
Reporter Jailed in Iran Passes Week on Fast,0,1,6,30,0,7,0,36,0
Trump says H&R Block will be unhappy with his tax plan,0,2,4,39,1,10,0,43,0
This Is The Coolest Electric Bus In The World,0,2,9,28,0,8,0,37,0
It's two weeks till Trump takes office. Time for a plan to improve 2017,0,3,3,49,2,13,4,52,0
"Beyond Sports, a Lesson From Desmond Tutu",0,1,6,28,1,6,0,34,0
"Watch The Weeknd's New Video for ""I Feel It Coming""",0,2,9,30,3,9,0,39,0
Patience and time in the gym pay off for Kia Nurse in UConn's second-round win,0,2,5,57,2,14,0,62,0
White House releases Benghazi emails,0,1,3,29,0,4,0,32,0
David Tennant Is Going To Voice Scrooge McDuck In 'DuckTales' Reboot,0,3,13,43,2,10,0,56,0
Cruises Cunard's Queen Victoria cruise ship is getting a £34m facelift – here's how it will look,0,2,4,70,4,16,2,74,0
Turkey expects improved relations with the Trump administration,0,3,2,54,0,7,0,56,0
Queen Elizabeth: 90-year-old monarch to step back from some charity work,0,3,2,55,3,10,2,57,0
New sanctions on Iran announced by Trump administration,0,3,3,45,0,7,0,48,0
Natalie Portman: Ashton Kutcher was paid three times more than me on No Strings Attached,0,2,7,66,1,14,0,73,0
Insurers Are Worried About The House GOP Health Care Bill,0,2,12,36,0,9,0,48,0
What’s sinking US-Russia relations? Team Trump’s truth-telling,0,2,6,45,5,6,0,51,0
Woman gives birth to own grandson as surrogate for her cancer survivor daughter,0,3,1,66,0,12,0,67,0
Syria's Aleppo: Almost 150 Vulnerable People Evacuated From Old City,0,3,9,45,2,9,3,54,0
"Teachers at Australian school shocked at no warning over redundancies, can apply before 'externals'",0,1,2,81,3,13,0,83,0
World's Most Indebted Developer Battles It Out With Shorts Again,0,3,10,44,1,9,0,54,0
This fiery video captures Mount Etna's magical oozing lava,0,3,3,46,1,8,0,49,0
Trump Has Flip-Flopped. But His Supporters Aren't Upset — Or Haven't Noticed.,0,3,12,48,6,11,0,60,0
10 Underclassmen with Best Shot at 2017 Heisman Trophy,0,2,5,35,0,8,6,40,0
Budget 2017: final plea to soften impact of business rates rise,0,3,1,47,1,10,4,48,0
"Myanmar Again Closes Trial of Dissident, Aung San Suu Kyi",0,1,9,38,1,9,0,47,0
Dallas PD Loses 99 Officers in 75 Days,0,2,6,21,0,7,4,27,0
Celebrate Orlando Bloom’s 40th Birthday With His Dreamiest Photos [Video],0,3,9,50,3,9,2,59,0
Robot Zoe detects life in Atacama Desert,0,1,4,30,0,6,0,34,0
President Obama: Hanukkah 'Has Inspired an American Tradition of Religious Freedom' ,0,3,9,61,3,11,0,70,0
Trump’s Wall Is an Outlandish Promise Even By Campaign Standards,0,2,9,45,1,9,0,54,0
"Kangaroo knocks jogger unconscious in Canberra, Australia",0,1,3,47,1,6,0,50,0
Australian man threatens to shoot down chopper with tomato-bazooka,0,1,1,56,1,8,0,57,0
NFL Players Reportedly to Be Fined for Participating in Las Vegas Arm Wrestling,0,3,12,55,0,12,0,67,0
The Senate’s criminal justice reform repeats one of the worst mistakes of the war on drugs,0,2,2,72,1,15,0,74,0
Qantas says A380 aircraft are safe to fly after 'serious' incident,0,1,2,49,2,10,3,51,0
Online Fragrance Startups Smell Money,0,2,5,28,0,4,0,33,0
The First Big Company to Say It’s Serving the Legal Marijuana Trade? Microsoft. - The New York Times,0,2,15,64,4,17,0,79,0
Bannon in Rare Remarks: Trump Is 'Maniacally Focused' on Fulfilling Campaign Promises  Insider,0,3,11,67,3,13,0,78,0
Fast food worker saves toddler's life,0,3,1,30,1,5,0,31,0
Hillary Clinton: Women's voices 'have never been more vital' ,0,3,3,45,4,9,0,48,0
Live by Night: Ben Affleck's description of film's sex scenes will leave you scratching your head,0,2,4,75,3,15,0,79,0
Marc Leishman Converts Eagle from 149 Yards at the Masters,0,2,6,40,0,9,3,46,0
Watch Alec Baldwin as Trump Fail to Protect Earth from Aliens on 'Saturday Night Live',0,3,11,59,2,14,0,70,0
American War Hero congressman wants U.S. troops out of Iraq soon,0,1,6,46,2,10,0,52,0
Navy facing heaviest Russian activity since Cold War says First Sea Lord,0,3,7,54,0,11,0,61,0
'They are not going to lie down': Boxing Day hunt crowds remain strong amid fight to scrap fox hunting ban,0,3,3,81,3,19,0,84,0
"13,000 people participate in Bristol running event",0,1,1,37,1,6,5,38,0
Martin McGuinness ex IRA commander dead at 66,0,3,6,30,0,7,2,36,0
"High School teacher is auctioning off 1,100-item toy collection to help boy, 4, get a special off-road wheelchair",0,2,2,84,5,17,5,86,0
"Bill Shorten argues against reducing restrictions on book imports, wants 'Australian stories told'",0,3,3,80,3,12,0,83,0
'How do you explain your Twitter?': Senator grills CIA nominee over whether he thinks WikiLeaks is credible,0,2,8,79,4,16,0,87,0
"Missouri man executed for killings of girlfriend, her daughter ",0,3,1,52,1,9,0,53,0
Soyuz TMA-11 spacecraft lands,0,1,4,19,1,3,2,23,0
Alec Baldwin criticises 'constipated' Donald Trump on James Corden's Late Late Show,0,3,9,60,3,11,0,69,0
The cutest #TBT flashback with the U.S. Women's Soccer Team,0,3,9,37,4,9,0,46,0
Cat Sneaks Out Of Christmas Gift Box At Exact Right Moment,0,3,11,37,0,10,0,48,0
Russian spies seek a White House source ,0,3,3,30,0,7,0,33,0
The epic showdown over presidential power and American identity,0,2,2,53,0,8,0,55,0
New Zealand dollar hits new high versus the United States dollar,0,1,4,50,0,10,0,54,0
Starbucks CEO says company isn’t anti-Trump: ‘We all want the president-elect to do well’,0,3,6,64,6,13,0,70,0
'We fear soldiers more than gangsters': El Salvador's 'iron fist' policy turns deadly,0,2,3,64,6,12,0,67,0
Abuse Photos Part of Agreement on Military Spending,0,1,6,38,0,7,0,44,0
Wind-powered land vehicle breaks speed record,0,1,1,38,1,5,0,39,0
San Francisco anti-G8 rally turns violent,0,1,3,31,1,5,1,34,0
"Brock Lesnar Informs UFC of Retirement from MMA, Removed from Drug-Testing Pool",0,3,14,52,2,11,0,66,0
UK storms predicted amid hot spell,0,3,2,27,0,5,0,29,0
Grammys Deliver on Promise of a Politically Charged Show,0,3,6,42,0,8,0,48,0
Kristen Stewart is super chill about her starring role in a Trump Twitter rant,0,3,4,61,0,13,0,65,0
More Than 1 Million Rally at Women's Marches in US and Around World ,0,3,10,43,1,13,1,53,0
U.S. jobs picture not improving,0,1,2,23,2,4,0,25,0
"NuCaptcha introduces a video captcha service, ads included",0,1,2,48,1,7,0,50,0
Pizza Hut to offer crust made out of 28 miniature hot dogs ,0,3,2,43,0,12,2,45,0
What We Learned from the Special Election in Kansas,0,3,6,37,0,8,0,43,0
Drought stricken Somalia nears famine,0,1,2,31,0,4,0,33,0
"American Indians to protest Trump, pipeline in Washington ",0,3,4,45,1,8,0,49,0
U.S. force-feeding Guantanamo hunger strikers,0,1,3,35,3,4,0,38,0
"Shetland Islands could go independent if Scotland leaves UK, former Chancellor claims",0,2,6,67,1,11,0,73,0
"Mozilla, Internet Explorer adopt universal RSS symbol",0,1,6,40,1,6,0,46,0
Study Criticizes N.C.A.A. for Beer Advertising,0,1,8,29,4,5,0,37,0
Sudan’s Vice President killed in helicopter crash,0,1,3,39,1,6,0,42,0
Tom Price Is Confirmed as Health Secretary ,0,3,6,30,0,7,0,36,0
"When Bail Is Out of Defendant’s Reach, Other Costs Mount ",0,2,9,36,2,10,0,45,0
BP Profit Misses Estimates as Oil’s Rally Hurts Refining,0,2,9,38,1,8,0,47,0
Rise above: will Donald Trump's America trigger a punk protest renaissance?,0,3,4,58,3,10,0,62,0
My Swings With Annika,0,1,4,14,0,3,0,18,0
"Police crime figures 'dead in the water', says City of London police chief",0,2,3,56,3,12,0,59,0
"On Chinese New Year, Fake Donald Trump Tweets Break The Internet In China",0,3,13,47,1,12,0,60,0
Everyone's Laughing At This Fox News Tweet About Trump's 'Weekend Working',0,3,11,49,4,10,0,60,0
Tributes to rainbow flag creator Gilbert Baker,0,3,3,37,0,6,0,40,0
People Are Calling This Pupper A Hero After Her Forever Family Wrote The Shelter This Heartbreaking Letter,0,2,17,73,0,16,0,90,0
Jets Trade Up to Draft Mark Sanchez,0,1,6,23,0,6,0,29,0
Taibu quits Zimbabwe cricket team after further threats,0,1,2,46,0,7,0,48,0
The Big Move To Improve Head Start,0,2,7,21,0,6,0,28,0
Second body found in search for missing Missouri woman ,0,3,2,44,0,9,0,46,0
India A Vs England - The Game Where MS Dhoni Will Lead 'Men In Blue' For One Last Time,0,3,19,46,3,18,0,65,0
Russians Strengthen Their Faith and a Tradition With an Icy Water Plunge,0,1,9,52,0,11,0,61,0
This Is What Famous Latinos Have To Say About Immigration,0,2,10,38,0,9,0,48,0
Assad has unleashed horror on Syria. The EU must not make a deal with him,0,2,5,53,1,14,0,58,0
Australia reclaim Ashes in Perth,0,1,3,25,0,4,0,28,0
Sarah Palin Dines With Trump at White House ,0,3,7,29,0,8,0,36,0
"June 9, 2015 — Pictures of the Day ",0,2,3,17,2,8,5,20,0
Drop in Air Travel Offsets  Cheaper Fuel Costs at American,0,1,8,40,0,10,0,48,0
"Serial killer suspected loose in New York, more bodies found",0,1,3,47,1,9,0,50,0
"More than 1,100 law school professors call on Congress to reject Donald Trump's pick for Attorney General",0,3,6,77,2,16,4,83,0
Donald Trump still can’t escape Hillary Clinton,0,3,4,36,1,6,0,40,0
Chicago Mayor Touts New Requirement to Graduate: Proof of a Plan   ,0,2,8,45,1,13,0,53,0
This app will tell you when a pregnant woman needs a subway seat,0,2,1,51,0,12,0,52,0
One Tiny Widget’s Dizzying Journey Shows Just How Critical Nafta Has Become,0,3,12,51,1,11,0,63,0
"FBI director Comey: 'We're not on anybody's side, ever.' ",0,3,5,36,7,9,0,41,0
Christie denies knowledge of settlement that reduced Trump casino debt by millions,0,2,2,69,0,11,0,71,0
Serena Williams Says She Revealed Pregnancy on Snapchat by Accident,0,3,8,50,0,9,0,58,0
Black boxes retrieved from lost Indonesian airliner after eight months,0,1,2,59,0,9,0,61,0
"So, does Michael Phelps believe in flossing?",0,2,3,33,2,6,0,36,0
Why The Republicans Don't Have An Obamacare Replacement Plan,0,3,9,42,1,8,0,51,0
Democrats’ empty anti-Trump stunts have made the Senate a circus,0,2,3,50,2,9,0,53,0
LAPD Commission Faults One Officer In Fatal Shooting Of Mentally-Ill Man,0,2,15,46,1,10,0,61,0
"Five Reasons Trump Is Right to Cut NPR, PBS - Breitbart",0,2,13,30,2,10,0,43,0
"Flash floods kill over a hundred in India, 500 missing",0,1,2,39,1,9,3,41,0
Texas Tech coach may move to University of Miami,0,1,4,36,0,8,0,40,0
Phil Knight & family,0,3,2,14,1,3,0,16,0
"All the 'Star Wars' movies, ranked from worst to best",0,3,3,38,3,9,0,41,0
The 9 need-to-know takeaways from your 2017 Golden Globe nominees,0,3,3,46,2,9,5,49,0
"2002 Oscar Flashback! Halle Berry, Nicole Kidman, Denzel Washington, and More",0,3,9,50,4,10,4,59,0
When Retail Boycotts Stopped Making Sense,0,3,6,30,0,5,0,36,0
Next Big Film Has a Premiere in Your Living Room,0,1,8,31,0,9,0,39,0
Obama under mounting pressure to disclose Russia’s role in US election,0,2,4,55,1,10,0,59,0
African Union Readmits Morocco Three Decades After Withdrawal,0,3,8,46,0,7,0,54,0
Olympic torch faces protests in San Francisco,0,1,3,36,0,6,0,39,0
UN: Military attacks on Darfur violated international law,0,1,4,45,1,7,0,49,0
"Study: Yup, Voter ID Laws Dampen Turnout For Minorities And Liberals",0,2,12,44,2,10,0,56,0
Zambian shoppers run in terror when strange 'Harry Potter Dementor' figure appears in clouds,0,3,4,73,2,13,0,77,0
East Timor - Australia problematic billion-dollar gas and oil accord,0,1,3,54,2,9,0,57,0
Homeland Security chief wants border wall built in two years,0,3,2,49,0,9,0,51,0
Dick Costolo's departure raises questions about what success means at Twitter,0,3,3,63,1,10,0,66,0
Reporter's Notebook: Is Donald Trump Palm Beach’s Most High-Profile Homebody? ,0,3,11,52,5,10,0,63,0
Russian Officials Among 7 Killed in Copter Crash,0,1,6,34,0,7,1,40,0
All aboard Morocco's high-speed train,0,3,2,29,2,4,0,31,0
"A steelworker won $100,000 in Warren Buffett’s March Madness pool. He may lose his job.",0,3,6,56,5,14,6,62,0
Matthew McConaughey has a great story about his dad winning a motorbike,0,3,3,57,0,11,0,60,0
The Electoral College Meets Monday. Here’s What to Expect. ,0,3,8,39,3,9,0,47,0
"Tracy Claeys Fired by Minnesota: Latest Details, Comments and Reaction",0,3,8,51,2,9,0,59,0
'Not acceptable': White House comments on Iranian navy vessel challenging US ships in Persian Gulf,0,3,8,73,3,14,0,81,0
Look Past 2008 Stars for Gains in Bonds,0,1,5,23,0,7,4,28,0
Washington Muslims put human faces to Trump immigration actions,0,3,3,52,0,8,0,55,0
Hillary Clinton Is No Champion of Religious Freedom,0,2,7,37,0,7,0,44,0
Doctors who treated John Ritter cleared of negligence lawsuit,0,1,3,50,0,8,0,53,0
Scientists issue dire warning about Cape Cod shark attacks,0,3,3,47,0,8,0,50,0
Let The Thrill Of Harley-Davidson Big Five Accelerate Your Love For Adventure,0,3,13,52,1,11,0,65,0
Man in Killing of Ex-NFL Player Admitted to Shooting: Sheriff,0,3,10,40,2,9,0,50,0
"Charges filed against suspected ""Pizzagate"" gunman",0,2,2,41,2,5,0,43,0
Microsoft drops bid for Yahoo,0,1,2,23,0,4,0,25,0
Revenge killings follow shooting of Karachi politician,0,1,2,46,0,6,0,48,0
Super Bowl LI live prop bet tracker,0,3,4,25,0,6,0,29,0
"Mobile operator Orange bills French doctor €160,000 for one month of Internet use",0,1,4,57,2,12,6,61,0
Pete Wentz and His D.I.Y.-Inspired Art Collection ,0,2,9,30,4,7,0,39,0
CBO: New Health Care Bill Would Leave Millions More Uninsured and Save Less,0,2,14,48,1,12,0,62,0
"A year on, few answers from probe into Prince's death ",0,2,2,40,2,10,0,42,0
Illinois jury sentences Brian Dugan to death,0,1,3,35,0,6,0,38,0
Why You Should Schedule A Dentist Appointment Before The Next Winter Storm,0,3,12,51,0,11,0,63,0
Gay play about Jesus Christ to open in Brazil,0,1,4,33,0,8,0,37,0
Mike Tyson Promises to Teach Chris Brown 'Every Dirty Trick' in Bout With Soulja Boy,0,3,13,55,2,14,0,68,0
Pepsi Pulls Ad Accused of Trivializing Black Lives Matter ,0,2,8,41,0,9,0,49,0
"After Indian And Chinese Navy Saved the Ship From Pirates, China Now Hijacks The Credit",0,2,14,58,1,14,0,72,0
"Trump has no favorite in the French election, Priebus insists, despite the president’s tweet",0,3,3,73,3,13,0,76,0
"On Friday, Congress could make it a lot harder for rich people to move to the U.S.",0,3,5,58,3,16,0,63,0
Congressional Black Caucus Members Tell The Trump Administration How They Really Feel,0,3,12,62,0,11,0,74,0
CBI cuts UK growth forecasts while warning of EU uncertainty,0,2,7,44,0,9,0,51,0
Stones thrown by protesters in Kashmir kill civilian,0,1,2,43,0,7,0,45,0
Trump EPA declines to ban pesticide that Obama had proposed outlawing,0,2,5,54,0,10,0,59,0
Luxury Knows No Limits On This 623-Foot-Long Superyacht Concept,0,3,10,40,2,8,3,50,0
Exit poll: 55% of French voters say no to EU constitution,0,1,4,39,2,10,2,43,0
Chelsea ready to reward Thibaut Courtois and retain Michy Batshuayi,0,3,5,53,0,9,0,58,0
Jobs Data Show Trump's Challenge: Pay Raises,0,3,7,29,2,6,0,36,0
AMD Betting on Wi-Fi to Open Up Virtual Reality,0,2,10,28,1,8,0,38,0
Brook Lopez Jokes About Brother Robin Getting Ejected From Game for Fighting With Serge Ibaka,0,3,14,65,0,14,0,79,0
Argentine admiral Emilio Eduardo Massera dies at age 85,0,1,4,41,0,8,2,45,0
"Knicks, Without Lee, Fall to Orlando",0,1,5,24,2,5,0,29,0
"‘She’s pretty special:’ Defying odds, the D.C. area’s first heart transplant patient is still alive 30 years later",0,3,4,83,8,17,2,87,0
"John Glenn, First American to Orbit Earth, Dies at 95",0,3,7,33,2,9,2,40,0
North Korea says Syria airstrikes prove its nukes justified ,0,3,3,48,0,9,0,51,0
Tiny Island Surrounded by Tension in the Gulf,0,1,5,33,0,7,0,38,0
Iraqi Christians celebrate Christmas in Irbil,0,3,4,36,0,5,0,40,0
This Is The Coolest Electric Bus In The World,0,3,9,28,0,8,0,37,0
RAF Typhoon jets scrambled to intercept Russian bombers circling UK,0,2,7,51,0,9,0,58,0
Trump national security pick Monica Crowley plagiarized multiple sources in 2012 book,0,3,3,67,0,11,4,70,0
A flood disaster in N.C.: Satellite photos before and after Hurricane Matthew,0,2,6,57,3,11,0,63,0
"Syria's conflict: More war crimes, more peace talks-and more radicalization by Russian design ",0,3,3,74,4,13,0,77,0
Trump Embraces Pillars of Obama’s Foreign Policy ,0,3,6,35,1,7,0,41,0
"Sergey Kislyak, Russian Envoy, Cultivated Powerful Network in U.S. - The New York Times",0,2,13,56,5,13,0,69,0
Justices Neil Gorsuch and Anthony Kennedy Speak to the Nation,0,2,7,45,0,9,0,52,0
Moscow revisited: A congested journey to Russia's past Featured Stories Additional stories,0,3,6,71,2,11,0,77,0
Berlin Police: Truck Attack On Christmas Market Was Intentional,0,2,9,45,1,8,0,54,0
UK military deaths in Afghanistan reach 327,0,1,3,31,0,6,3,34,0
Moscow celebrates Victory Day with military parade,0,1,3,41,0,6,0,44,0
"After Gaza, Israel Grapples With Crisis of Isolation",0,1,7,37,1,7,0,44,0
Illinois House impeaches Blagojevich,0,1,3,30,0,3,0,33,0
Weed business set to be one of fastest growing job generators in US,0,2,3,52,0,12,0,55,0
"Amid Poor Auto Ad Sales, Reasons to Be Upbeat",0,1,8,28,1,8,0,36,0
Neil Gorsuch confirmed: US Senate vote Donald Trump's Supreme Court nominee to the bench,0,3,9,64,2,13,0,73,0
John Oliver Astutely Compares Republicans' Obamacare Plans to Your Dad's A** in a Thong,0,3,11,59,4,13,0,70,0
"Netflix's 'Mystery Science Theater' gets release date, perfect cast photo",0,2,4,56,4,9,0,60,0
Islamic State Claims Responsibility for Istanbul Nightclub Attack,0,3,7,51,0,7,0,58,0
Blake Shelton to Perform at 2017 People's Choice Awards,0,2,6,36,1,8,4,42,0
Obama Tries Out His Dexterity in the World Cup,0,1,7,31,0,8,0,38,0
Botched castle restoration is deemed a ’heritage massacre’,0,2,1,48,2,7,0,49,0
2008 AutoTronics Taipei: Participants from IT industry to participate COMPUTEX uncertainly,0,1,14,61,1,10,4,75,0
"Crime and Courts Undercover Cop Cleared of Top Counts in Biker Melee, SUV Attack, Convicted of Lesser Charges",0,3,16,74,2,17,0,90,0
Colleges offering admission to displaced New Orleans students,0,1,3,51,0,7,0,54,0
"Three dead, over 70 injured in Bangkok blasts",0,1,2,33,1,7,2,35,0
Decoding Battery-Life Numbers for Laptops,0,1,5,31,1,4,0,36,0
Baby goats ditch sweaters for PJs and we are totally here for it,0,3,3,49,0,12,0,52,0
"UConn Nears Perfection, but Has Room to Improve",0,1,7,32,1,7,0,39,0
Trillion-Dollar Tab to Renew U.S. Nuclear Triad to Be Reviewed,0,3,10,40,3,9,0,50,0
Australian rules football: West Gippsland Latrobe Football League Grand Final,0,1,8,59,1,9,0,67,0
"Soon, Cars May Take Away the Keys of a Drunken Driver ",0,2,8,34,1,11,0,42,0
Barbra Streisand Says Trump's Presidency Is Making Her Gain Weight,0,3,10,46,1,9,0,56,0
40 million credit cards compromised,0,1,0,29,0,4,2,29,0
Seton Hall Center Leads With His Legs,0,1,7,24,0,6,0,31,0
Complete 2017-18 CBB title odds,0,3,4,16,1,4,6,20,0
100 moments from Obama's presidency,0,3,1,26,1,4,3,27,0
Honda Names New Chief Executive,0,1,5,22,0,4,0,27,0
Muhammad Ali's son says he was detained at airport again ,0,3,2,44,1,10,0,46,0
Google phases out IE6 support,0,1,3,21,0,4,1,24,0
South Africa’s First Black Female Winemaker Launches Her Own Brand,0,2,10,46,1,9,0,56,0
Michelle Obama: 'I won't run for office' for my children,0,3,3,40,4,9,0,43,0
USA lifts remaining sanctions on Serbia and Montenegro,0,1,5,42,0,7,0,47,0
Trump’s presidency is teaching elites like me a lesson,0,2,1,44,1,8,0,45,0
Outrage as Italian judge clears man of raping a woman on a hospital bed because she didn't SCREAM,0,3,8,71,1,17,0,79,0
"Older Viewers and Conservatives Are Watching Less NFL, Survey Finds",0,3,11,46,1,9,0,57,0
"Manhunt Intensifies for Joseph Jakubowski, Man Who Allegedly Stole Guns and Mailed Manifesto to Trump",0,2,12,74,1,14,0,86,0
Mike Pence will go to the Super Bowl,0,3,4,25,0,7,0,29,0
"Magnitude 3.6 earthquake shakes Washington, D.C.",0,1,4,33,4,5,2,37,0
Miami Heat's Dwyane Wade Completes 4-Day Executive Course at Harvard,0,3,9,47,2,9,1,56,0
The Worldâ€™s Longest Rail Tunnel,0,2,5,22,2,4,0,27,0
Centrelink debts slashed after welfare recipients speak out in media,0,3,1,58,0,9,0,59,0
Air France lets female crews skip Tehran flights to avoid wearing headscarves,0,2,3,63,0,11,0,66,0
FX Announces Premiere Date for 'X-Men' Series 'Legion' With Trippy New Trailer,0,3,13,49,5,11,0,62,0
Canada Reaches Carbon Agreement With Provinces ,0,3,6,35,0,6,0,41,0
"President Mugabe bulldozes homes of 200,000 across Zimbabwe",0,1,3,42,1,7,6,45,0
"Led Zeppelin, J. Geils Band Classics Return on Hot Rock Songs Chart",0,3,11,43,2,11,0,54,0
"Oakland Raiders Raiders Punter Marquette King Picks Up Flag, 'Hits Dem Folks'",0,3,12,51,3,11,0,63,0
"Crossing guard killed by truck in Glasgow, Scotland",0,1,3,40,1,7,0,43,0
Spies Keep Intelligence From Donald Trump on Leak Concerns,0,2,8,42,0,8,0,50,0
"Barry star Devon Terrell on playing Barack Obama, struggling to fit in and hope under Donald Trump",0,3,7,74,1,16,0,81,0
Greek parliament passes austerity bill,0,1,1,33,0,4,0,34,0
China to deliver economic report card at lawmakers' meeting,0,3,1,49,1,8,0,50,0
The Dark Days Are Over: Bruce Arena Is Making the USMNT Fun Again,0,3,16,36,1,12,0,52,0
How to get involved with the Women's March on Washington if you're not in D.C.,0,3,6,54,4,14,0,60,0
Rihanna named Harvard University's humanitarian of the year - Yahoo,0,2,4,52,2,9,0,56,0
Cui Jian and Chui Wan: the changing sound of Chinese rock music,0,3,5,46,1,11,0,51,0
Hearing for Supreme Court Nominee Gorsuch Set for March,0,2,7,40,0,8,0,47,0
"How ""The Color Purple"" changed actress Cynthia Erivo's life",0,3,6,42,3,8,0,48,0
"In China, Pelosi Talks With Hu and Wen About Climate Change",0,1,10,38,1,10,0,48,0
"With Streaming, Musicians and Fans Find Room to Experiment and Explore ",0,2,8,51,1,11,0,59,0
Volkswagen’s Ex-CEO Denies Prior Knowledge of Emissions Cheating,0,3,10,45,2,7,0,55,0
Australian TV networks reprimanded for breaching code of practice,0,1,3,54,0,8,0,57,0
Spicer denies report Trump wants meeting with Putin in Iceland ,0,2,4,49,0,10,0,53,0
"Cinnabon ""truly sorry"" for Carrie Fisher tweet after backlash",0,3,3,48,2,8,0,51,0
"Two Coaches, Like the Ball, Are Always on the Move",0,1,7,32,2,9,0,39,0
Just 29% of Brits think Brexit will be good for the economy,0,3,3,42,1,11,2,45,0
"Trump Travel Ban Makes America Less Safe: Ex-Top Security, State Officials",0,3,12,49,3,10,0,61,0
Reserve Bank stuck between rock and a hard place on interest rates,0,3,2,53,0,11,0,55,0
Winning British EuroMillions lottery ticket worth £56 million claimed,0,1,4,54,1,8,2,58,0
Shahid Kapoor’s Brother Ishaan Is All Set To Make His Acting Debut & Here's All The Dope,0,3,16,53,3,16,0,69,0
How labor beat Obama on trade — for now,0,3,2,28,1,8,0,30,0
Officer who killed Polish dissident during Communist era sentenced to 4 years prison,0,1,3,68,0,12,1,71,0
"Everyone Is Super Confused About Trump’s ""Last Night In Sweden"" Comments",0,3,11,48,3,10,0,59,0
"Israeli PM, Ariel Sharon, woken from coma, moves limbs",0,1,5,38,3,8,0,43,0
"A Placid Man on Land, Caught in a Pirate Drama at Sea",0,1,8,33,1,11,0,41,0
Teaching Intelligent Design: Incumbent Dover PA school board fails reelection,0,1,7,60,1,9,0,67,0
Maine Gov. Paul LePage Endorses Donald Trump,0,2,8,29,1,6,0,37,0
IMF Panel Adopts G-20 View on Trade as Trump Considers Options,0,3,11,38,1,10,2,49,0
US-Israeli teen charged over threatening calls to Jewish community centres,0,3,4,60,1,9,0,64,0
Draymond Green Rips Raiders for Leaving Oakland for Las Vegas: 'You Just Don't Do That',0,3,13,56,4,14,0,69,0
"EU leader declares Trump a ""threat"" to European Union",0,2,5,38,2,8,0,43,0
"Adani: Prime Minister Malcolm Turnbull meets with chairman, reiterates support for mine",0,3,5,69,2,11,0,74,0
Got a weird skin rash? Maybe Facebook can help,0,3,3,34,1,8,0,37,0
"Lucas Glover, Sleeper Pick",0,1,4,18,1,3,0,22,0
Rohingya refugees in Bangladesh face relocation to island,0,3,2,48,0,7,0,50,0
JCPenney to close up to 140 stores,0,3,3,22,0,6,3,25,0
Trump’s Legal Options in Travel Ban Case ,0,2,6,27,1,7,0,33,0
Free Trade: NBA Deals That Could Jolt the Playoff Race,0,3,11,33,1,9,0,44,0
People Are Desperately Waiting For Nicki Minaj To Respond To Remy Ma’s Diss Track,0,2,14,53,1,13,0,67,0
Comprehensive immigration bill fails in United States Senate,0,1,4,49,0,7,0,53,0
GOP Congressman Says the Poor ‘Just Don’t Want Health Care’,0,2,11,36,3,9,0,47,0
Over One Million Indian Muslims Sign Petition To Ban Triple Talaq,0,3,11,44,0,10,0,55,0
Re-evaluation of National Security Ordered,0,1,4,33,1,4,0,37,0
U.N. Penalizes North Korean Companies Over Nuclear Arms,0,1,9,37,2,7,0,46,0
A second climate-change skeptic is leaving the EPA and will return to Heritage,0,3,5,60,1,12,0,65,0
The New Playboy and the End of Adulthood,0,2,5,28,0,7,0,33,0
The Inexplicable Online Absence Of Aaliyah’s Best Music,0,2,8,39,1,7,0,47,0
"The Cost Can Be Debated, but Meals on Wheels Gets Results ",0,2,9,37,1,11,0,46,0
Search Widens for Facebook Murder Suspect,0,3,5,31,0,5,0,36,0
SI model is taking MMA commitment to next level,0,2,5,34,0,8,0,39,0
NHL: Ducks charge to two game lead over Wild,0,1,5,30,1,8,0,35,0
It's Now or Never for DeMarcus Cousins and the Sacramento Kings Kings Insider's Notebook,0,2,11,62,2,13,0,73,0
Flyers Take Round 3 in Series With Penguins,0,1,6,29,0,7,1,35,0
$60 million 'Pink Star' diamond goes back on sale next month,0,2,2,43,3,10,2,45,0
Student forced to urinate in bucket awarded $1.6 million payout in California court,0,2,2,65,2,12,2,67,0
This is the top dog on Coney Island — and it’s not Nathan’s,0,2,4,40,3,12,0,44,0
Ben Simmons Injury: Updates on 76ers Forward's Foot and Return,0,3,7,42,2,9,2,49,0
Tyrod Taylor's Future with Bills Reportedly Unclear Heading into Free Agency,0,2,9,56,1,10,0,65,0
Trump says top priority is to 'protect and serve' America amid backlash over extreme vetting ,0,2,2,74,2,15,0,76,0
"Danny Dyer's Cockney accent? It's more like The Only Way Is Essex, says co-star June Brown",0,3,11,59,5,15,0,70,0
Man arrested in connection with July 21 London bomb attempts,0,1,3,46,0,9,2,49,0
Francisco Lindor Is Trying to Save Baseball from Itself,0,3,7,40,0,8,0,47,0
"Its Muscle Car Glory Faded, Pontiac Shrivels Up",0,1,8,31,1,7,0,39,0
"The crazy, eccentric, successful life of Google cofounder Sergey Brin",0,3,4,54,2,9,0,58,0
4 People Found Alive 6 Days After Building Collapse In Kenya,0,2,9,39,0,10,2,48,0
"Most Anticipated Latin Tours of 2017: Maluma, Los Fabulosos Cadillacs & More",0,3,9,49,3,11,4,58,0
Australian PM promises to assist Corby,0,1,4,29,0,5,0,33,0
Russia Rejects Trump’s Charge That Iran Is Top Terrorist State,0,3,10,42,1,9,0,52,0
Inventor of instant noodles passes away,0,1,1,33,0,5,0,34,0
Trump Tax Plan Would Shift Trillions From U.S. Coffers to the Richest ,0,3,11,45,2,12,0,56,0
Serbian firefighters shot at from Kosovo,0,1,2,33,0,5,0,35,0
Hawaii Prepares for Missile Threat,0,1,4,26,0,4,0,30,0
We're up to six Patriots players who have publicly said they won't visit the White House,0,3,4,67,2,15,0,71,0
George Clooney Opens Up About Becoming a Father in His 50s: ‘We Are Really Happy and Really Excited’,0,3,14,64,3,17,2,78,0
Australian academic study supports nuclear power,0,1,1,42,0,5,0,43,0
Supreme Court Temporarily Blocks Redrawing of North Carolina Districts,0,3,8,54,0,8,0,62,0
"50 Italian parliamentarians call for global summit for ""a new financial architecture""",0,1,1,69,2,11,2,70,0
Lance Bass Cracks 'Alternative Facts' Joke in Response to Trump Advisor Kellyanne Conway's Remarks,0,3,12,70,3,13,0,82,0
"FIFA’s World Cup Expansion Is About Money, Chinese Sponsor Says",0,3,13,39,2,9,0,52,0
Crime-fighting robots will be keeping America’s malls safe,0,2,2,47,2,7,0,49,0
Paul Tagliabue apologizes for 1994 comments regarding concussions,0,3,2,52,0,7,4,54,0
Phil Jackson's Ghostwriter Takes Shots at Carmelo Anthony in Blog Post,0,3,9,50,1,10,0,59,0
Kashmir clashes: Eight dead as troops surround gunmen,0,3,2,43,1,7,0,45,0
Live St Petersburg Metro explosion: At least 10 dead after 'shrapnel-filled device' explodes in 'terror attack',0,3,5,83,6,15,2,88,0
"Dusty Rhodes, WWE Hall of Famer, Dies at Age 69",0,2,9,25,2,9,2,34,0
Despondent Rosie O'Donnell: 'I Hate What Has Become Of US',0,3,12,33,4,9,0,45,0
English jury returns mix of verdicts in policeman's serial rape trial,0,1,1,57,1,10,0,58,0
St. Vincent's 'Guitar World' cover is a sly nod to the magazine's sexist history,0,2,4,58,5,13,0,62,0
Times Co. Plans Temporary Pay Cuts and Unpaid Leave for  Many Employees,0,1,10,48,1,12,0,58,0
Cardboard boxes as cribs? Safety sleep program expands ,0,3,2,44,1,8,0,46,0
Former South Korean president facing possible life sentence,0,3,3,49,0,7,0,52,0
Another woman accuses Cosby of sexual assault,0,2,2,37,0,6,0,39,0
Australian rules football: Maffra go a game clear ahead of Traralgon clash,0,1,3,59,1,11,0,62,0
China Accuses Dissident of Subversion,0,1,4,29,0,4,0,33,0
Fox News Taps Tucker Carlson to Replace Megyn Kelly ,0,3,8,35,0,9,0,43,0
Yet Another Vogue for iPhones: Video Games,0,1,6,29,1,6,0,35,0
Sara Bareilles Covers Joni Mitchell During 2017 Oscars In Memoriam Segment,0,3,10,50,0,10,4,60,0
One man's search for diamonds,0,3,1,23,1,4,0,24,0
"Blair: ""Labour must be the party of change makers""",0,1,2,37,3,8,0,39,0
U.N. human rights official criticizes federal relationship with Indian tribes,0,3,3,63,2,9,0,66,0
A pair of managers from Izzy Englander's $35 billion hedge fund are setting off on their own,0,3,3,69,2,16,2,72,0
Trump repeatedly to Obama in 2013: Don't attack Syria,0,3,4,35,2,8,4,39,0
More than 150 dead as overflowing rivers rip through city,0,3,1,44,0,9,3,45,0
Evacuations ordered over concerns at California dam system,0,2,2,49,0,7,0,51,0
’No turning back’: PM May triggers ’historic’ Brexit,0,2,5,35,5,7,0,40,0
Riots in England continue for a fourth night,0,1,2,35,0,7,0,37,0
Police bust cockfighting ring and recover 100 roosters,0,3,1,43,0,7,3,44,0
Bros at a city council meeting demand a 12-foot statue of Paul Walker and it's perfect,0,2,3,64,2,15,2,67,0
"Thai Rebels Recruiting in Schools, Study Says",0,1,6,32,1,6,0,38,0
Watership Down author Richard Adams dies aged 96,0,3,4,35,0,7,2,39,0
Honduran President Is Ousted in Coup,0,1,5,26,0,5,0,31,0
It's two weeks till Trump takes office. Time for a plan to improve 2017,0,2,3,49,2,13,4,52,0
After Crackdown On Slaughterhouses Meat Suppliers In Lucknow Go On Indefinite Strike,0,3,12,61,0,11,0,73,0
"Smirnoff Sound Collective Aims to Tackle Dance Music's Diversity Problem, Launches Program With Live Stream",0,3,14,77,2,14,0,91,0
Manhattan Luxury Co-Ops Fall Out of Favor,0,3,7,27,1,6,0,34,0
Chaffetz investigating security protocols at Trump's Mar-a-Lago resort ,0,2,4,56,3,8,0,60,0
China and Economic Reform: Xi Jinping’s Track Record ,0,3,7,36,2,8,0,43,0
Miley Cyrus had a weed bar at Liam Hemsworth and Wayne Coyne's birthday party,0,3,6,57,1,13,0,63,0
When Eagles and Ravens Fly With Blue Hens,0,1,7,27,0,7,0,34,0
White House Is Said to Draft Plan for U.S. Break From Nafta ,0,2,11,35,2,12,0,46,0
Beyoncé surprised a group of young girls backstage after a dance performance,0,3,1,64,0,11,0,65,0
Rainbow 'Ziggy Stardust' snake among new Mekong delta discoveries,0,2,4,51,2,8,0,55,0
"Q&A: Citizenship, visa changes dominate program forcing Alex Hawke to defend policies",0,3,5,66,3,11,0,71,0
"Robots that take people's jobs should pay taxes, says Bill Gates",0,2,3,49,2,10,0,52,0
"Oakland 'Ghost Ship' Warehouse Manager Derick Almena Says ""Heart is Broken""",0,3,10,51,4,10,0,61,0
Japan's Air Self-Defense chief fired over essay on wartime history,0,1,4,51,2,9,0,55,0
How to ace your college football bowl office pool,0,3,1,40,0,8,0,41,0
Bulk of Iraqi debt to Paris Club to be forgiven,0,1,4,34,0,9,0,38,0
Water park under fire for Muslim-friendly event,0,3,2,38,1,6,0,40,0
"As France becomes latest target, are election hacks the new normal?",0,2,2,53,2,10,0,55,0
NASA releases stunning new image of Earth as seen from space at night,0,2,5,52,0,12,0,57,0
Tegan and Sara Launch Fight For Equality and Justice with Hollywood Event,0,3,9,53,0,11,0,62,0
Kevin Durant and ‘cheap’ LeBron count their millions differently,0,2,4,50,2,8,0,54,0
Physicist Lawrence Krauss on the greatest scientific story ever told,0,2,3,56,0,9,0,59,0
"Golden Globes: Jimmy Fallon Braves Teleprompter Failure, Opens With Musical Number [Video]",0,3,12,63,4,11,0,75,0
"Trump's America Donald Trump: Reince Priebus asked FBI to dispute Russia reports, White House official says",0,3,12,77,3,15,0,89,0
Donald Trump's pick to head up US army withdraws over potential conflicts of interest,0,3,4,67,1,13,0,71,0
YouTube restores influential conservative website's channel ,0,3,2,51,1,6,0,53,0
Louisville Tops Rutgers for 11th Straight Victory,0,1,5,36,0,6,2,41,0
Beauty and the Beast: Emma Watson on why she chose Belle over Cinderella,0,2,6,53,1,12,0,59,0
Everything you need to know about Trump's executive actions so far,0,3,2,53,1,10,0,55,0
Australian Treasury related agencies spend 17000 AUD on massages in 2004,0,1,5,48,0,10,9,53,0
"With Trump, Russia Goes From Thursday’s Foe of U.S. to Friday’s Friend ",0,2,11,43,5,12,0,54,0
"Opposing Thai protesters mass, PAD to march on parliament",0,1,5,43,1,8,0,48,0
Russia Ready to Resume Gas Shipments to Europe,0,1,6,33,0,7,0,39,0
Texas man charged for firing 'indiscriminately' at 2 men attacking his fiance ,0,2,1,62,2,12,1,63,0
"Michael Flynn Initially Failed to Disclose Payments from Russia-Linked Firms, Docs Show",0,3,11,63,2,11,0,74,0
At Least 32 Die in a Wave of Violence Across Iraq,0,1,7,30,0,10,2,37,0
Casey Stoner wins 2011 Catalunya MotoGP,0,1,6,24,0,5,4,30,0
Glenbard East defeated by Benet Academy in Illinois basketball sectional,0,1,5,58,0,9,0,63,0
College Basketball Player Slaps Opposing Fans for Heckling Him During Game,0,3,10,54,0,10,0,64,0
New York Times reporter rescued in Afghanistan,0,1,4,36,0,6,0,40,0
"Syrian regime secretly hanged 13,000 people at Assad's notorious Saydnaya Prison, says Amnesty International",0,3,6,81,3,13,5,87,0
House Panels to Take Up Obamacare Replacement Measure Next Week,0,2,9,45,0,9,0,54,0
‘Just horrific’: Police say man video-recorded his sexual assaults of girls younger than 5,0,3,2,70,4,13,1,72,0
From sea to plate: how plastic got into our fish,0,3,1,37,1,9,0,38,0
Wall St: US shares creep higher on upbeat Fed comments,0,2,5,39,1,9,0,44,0
"Wind blows down little pig's house, so pig takes a trip to Home Depot",0,3,3,51,2,13,0,54,0
Thinking of Going Blond? Consult the Kiosk First,0,1,6,34,1,7,0,40,0
"In chaotic scene, Rand Paul demands to see the House GOP's Obamacare repeal bill",0,3,8,57,2,13,0,65,0
Instagram snapshots: Pádhraic Mulholland's Christmas dip in a Norway fjord,0,3,5,58,2,9,0,63,0
Casey Affleck responds to sexual harassment allegations after Oscar win,0,3,3,59,0,9,0,62,0
Flooding in Nakhon Sri Thammarat,0,1,4,24,0,4,0,28,0
US dog food recall after euthanasia drug found,0,3,2,37,0,7,0,39,0
Democrats Rev Up Health Care Offensive as Bill Clears Committees,0,3,9,46,0,9,0,55,0
"Inauguration protesters to be barred from National Mall, other sites",0,2,3,55,1,9,0,58,0
Public Concern Over Russia Hits Highest Level Since The Cold War,0,3,11,43,0,10,0,54,0
American Airlines flight attendants want new uniforms recalled,0,3,2,53,0,7,0,55,0
"Nine children abandoned at hospital emergency room in Nebraska, USA",0,1,5,52,1,9,0,57,0
Actor Bill Paxton Dead at 61 Due to Complications from Surgery,0,3,7,43,0,10,2,50,0
Trump's America Donald Trump signs executive order sweeping away Obama-era climate change policies,0,3,5,79,2,12,0,84,0
Phoenix spacecraft makes first 'impression' on Mars,0,1,2,41,2,6,0,43,0
"Berkeley, Reversing Decision, Says Ann Coulter Can Speak After All ",0,2,10,45,2,10,0,55,0
The Industrious Formula For Productive Coworking Spaces,0,3,7,42,0,6,0,49,0
Manus Island asylum seeker charged with raping local woman,0,2,2,48,0,8,0,50,0
Court Rules for Deportee on Custody,0,1,4,26,0,5,0,30,0
English Cricket Teams Get Uneven Treatment Everywhere but on the Field,0,1,8,52,0,10,0,60,0
"HSBC to Reduce Head Count by 50,000 as Part of Overhaul",0,2,9,30,1,10,5,39,0
People Are In Love With This Dog’s Reaction To Seeing His Family On Facetime,0,3,14,48,1,13,0,62,0
Thailand Cancels Summit After Protests,0,1,5,29,0,4,0,34,0
Northern Ireland child abuse inquiry to publish report in Belfast,0,3,3,53,0,9,0,56,0
Pakistanis Rejoice Over Restoration of Justice,0,1,5,36,0,5,0,41,0
mrk.tv - Diese Website steht zum Verkauf! - Informationen zum Thema mrk.,0,2,5,51,5,11,0,56,0
Can they search my phone?,0,2,1,19,1,4,0,20,0
Oil Producers Promised Output Cuts. Here’s the Reality.,0,2,7,38,3,7,0,45,0
"Lindsey Graham campaigns with a smile, one wisecrack at a time",0,3,2,49,1,10,0,51,0
8th Circuit Court rules 'partial birth' ban unconstitutional,0,1,2,48,2,7,1,50,0
ISIS Drowns Former Member In Shampoo Because He Called The Terrorist Group Dirty,0,3,16,52,0,12,0,68,0
David Bowie did not know he was dying until final few months,0,3,2,47,0,11,0,49,0
U.S. tries to stop feuding allies from unraveling Syria strategy,0,2,3,50,2,9,0,53,0
Andy Roddick Presents Challenge for Coach Larry Stefanki,0,1,7,42,0,7,0,49,0
Is the SUPERVOLCANO under Naples about to blow? Campi Flegrei crater shows signs of 'reawakening',0,3,16,64,3,14,0,80,0
UK threat level reduced to 'severe',0,1,2,26,2,5,0,28,0
Trump family hosts its 1st White House Egg Roll ,0,3,5,33,0,9,1,38,0
"Dairy Queen Owner Makes Racist Insults Against Customer, Loses Business",0,2,10,51,1,9,0,61,0
Small-Business Owners Split on Raising Minimum Wage - Real Time Economics,0,3,10,51,2,10,0,61,0
Baidu’s Loss Is a Setback for AI in China,0,3,7,25,1,8,0,32,0
America And Russia Are Once Again At Loggerheads And That's A Real Threat To Global Security,0,3,16,60,1,15,0,76,0
NASA launches Space Shuttle Atlantis,0,1,7,25,0,4,0,32,0
Emma Roberts And Evan Peters Have Reportedly Called Off Engagement,0,2,10,47,0,9,0,57,0
Kellyanne Conway's husband tipped for DOJ role,0,2,5,34,1,6,0,39,0
Tennis: Justine Henin defeats Jelena Jankovic to win Rogers Cup,0,1,7,46,1,9,0,53,0
Jaipur's Queen Gayatri Devi dies at 90,0,1,4,25,1,6,2,29,0
Keith Urban on His Pair of 2017 Grammy Nominations: 'It's a Euphoric Feeling',0,2,9,48,4,12,4,57,0
Wikinews discusses the H1N1 pandemic with the CDC,0,1,6,34,0,7,2,40,0
Kroger Makes New York City Debut With Murray’s Cheese Purchase,0,3,10,42,1,9,0,52,0
Jon Voight Thinks Miley Cyrus And Shia LaBeouf Are ‘Teaching Treason’,0,3,12,45,2,10,0,57,0
Father Blamed in 2 Killings,0,1,3,19,0,4,1,22,0
Obama Resists Calls for a Tougher Stance on Iran,0,1,6,34,0,8,0,40,0
APEC leaders wear Driza-Bones for group photo,0,1,6,32,1,6,0,38,0
Parishioners survive tornado inside church ’by the grace of God’,0,2,2,51,2,9,0,53,0
The Week in Pictures: Feb. 24 - March 3,0,3,5,20,3,8,3,25,0
Why Apple’s Critics Are Right This Time,0,3,7,25,1,6,0,32,0
Facebook’s Zuckerberg questioned at trial over virtual-reality technology,0,2,2,62,2,7,0,64,0
Getting Theirs Cuts Both Ways on Wall Street,0,1,7,30,0,7,0,37,0
Peace Corps Volunteer Is As Strong As Legendary Horse Of Kyrgyzstan,0,2,11,46,0,10,0,57,0
Gilead to Buy CV Therapeutics for $1.4 Billion,0,1,6,29,2,7,2,35,0
Trump Offers Britain Quick Trade Accord as He Shuns Europe,0,3,9,40,0,9,0,49,0
Jeremy Corbyn's biggest supporter Len McCluskey to be challenged for Unite union leadership,0,3,6,72,1,12,0,78,0
Deadly Tenn. school bus crash case heads to grand jury ,0,3,2,42,1,10,0,44,0
N.C. Syringe Factory Tied to Deaths Went Uninspected Despite Complaints,0,1,10,50,2,9,0,60,0
19 Times Siblings Masterfully Recreated Their Childhood Photos,0,3,7,46,0,7,2,53,0
New Jersey Native Helps Italy Defeat United States,0,1,8,35,0,7,0,43,0
"Calls for Special Prosecutor Driven by Politics, Not Law - Breitbart",0,2,8,48,2,10,0,56,0
"Sharks, sandbags and surfing: Cyclone Debbie brings floods to Queensland",0,3,4,57,2,9,0,61,0
"Charles Oakley arrested, charged with assault after MSG altercation",0,3,5,53,1,8,0,58,0
With friends like these: China’s awkward position after North Korea’s missile test,0,3,4,64,3,11,0,68,0
Justin Bieber teams up with Rob Gronkowski for Super Bowl ad,0,3,6,44,0,10,0,50,0
Matthew McConaughey Says We Need to ‘Embrace’ President Trump,0,3,9,42,2,8,0,51,0
The internet roasts a photo of Donald Trump writing his inauguration speech,0,2,3,61,0,11,0,64,0
The Fake Freedom of American Health Care ,0,2,6,28,0,7,0,34,0
4 Solutions to Common Tax Issues,0,2,4,22,0,5,1,26,0
"Hazelwood closure leaves major energy black hole, electricity prices will inevitably rise",0,2,1,76,1,11,0,77,0
President Trump's motorcade hit by wood; 5 students face charges,0,3,2,50,2,9,1,52,0
Buyout Firm Buys $800 Million of Assets From Itself,0,3,7,32,1,8,3,39,0
"Ship sunk by Indian navy was a fishing boat, says owner",0,1,2,42,1,10,0,44,0
Luke Shaw vows to stay at Manchester United and prove José Mourinho wrong,0,2,6,55,0,12,0,61,0
League of Legends prodigy Faker carries his country on his shoulders,0,2,3,55,0,10,0,58,0
"Earth is overdue an ‘extinction-level’ event, Nasa scientist warns The list",0,3,3,58,4,10,0,61,0
Trump Promised to ‘Open the Mines’ — Here’s Why That Is Unlikely,0,3,9,40,4,11,0,49,0
Carrie Fisher Mourned by Fellow Stars: ‘Our Princess Has Passed Away’,0,2,10,46,3,10,0,56,0
Cocaine Trade Helps Rebels Reignite War in Peru,0,1,7,33,0,7,0,40,0
Pope Francis Invited Mothers To Breastfeed In The Sistine Chapel,0,2,10,45,0,9,0,55,0
Babies born in London hospital 'could leave with wrong mother',0,3,2,49,2,9,0,51,0
"Second-hand tyres up to 23 years old putting lives at risk on Britain's roads, trading standards warn",0,3,2,78,3,16,2,80,0
Best actor Casey Affleck pays tribute to Denzel Washington in acceptance speech ,0,2,5,63,0,12,0,68,0
There's been a breathtaking swing in Putin's popularity among Republicans in the Trump era,0,2,4,71,2,13,0,75,0
Rat Boy responds to Kendrick Lamar sampling him on 'LUST',0,3,8,38,2,9,0,46,0
Junior Hockey League Player Climbs over Glass to Fight Fans,0,3,8,42,0,9,0,50,0
Connecticut Serial Killer Competent- Waives Further Appeals,0,1,7,45,1,6,0,52,0
Facebook admits to miscalculating more of its advertising metrics,0,2,1,56,0,8,0,57,0
SpaceX Will Wait Until January To Launch Rockets Again,0,3,10,36,0,8,0,46,0
Dear Donald Trump: I want my $49 back,0,2,4,22,2,7,2,26,0
"Mitchelle Blair, Mom Who Allegedly Put Dead Kids in Freezer, Flips Off Court",0,2,12,50,2,12,0,62,0
"Pokemon Go Finally Launches In India, Reliance Jio Users To Have Extra Poke Fun!",0,3,14,51,2,13,0,65,0
Telecom New Zealand bounces gay e-mail,0,1,3,29,1,5,0,32,0
Westminster attack: police hunt for clues after five dead in 'sick and depraved' incident,0,3,1,72,3,13,0,73,0
Public High School Launches Club ‘To Support the Goals of Planned Parenthood’ - Breitbart,0,2,11,62,3,13,0,73,0
Alec Baldwin Jumps To Kendall Jenner's Defense In Pepsi Ad Fiasco,0,3,11,43,1,10,0,54,0
South Park’s Creators Have Given Up on Satirizing Donald Trump,0,2,9,43,1,9,0,52,0
Roy Keane has complete faith in Robbie Keane for Ireland’s qualifier,0,2,5,52,1,10,0,57,0
Macy's is closing 68 stores — here's where they will shut down,0,3,1,45,3,11,2,46,0
Super Bowl LI reminded a ton of people of Trump’s victory on Election Night,0,2,7,54,1,13,0,61,0
Facebook Debuts Live Audio Broadcasts,0,3,5,28,0,4,0,33,0
Fans launch petition to keep Neighbours on British TV after fears it could be axed,0,2,5,63,0,14,0,68,0
Questioning Role of Politics in Secrecy of Kenyan Election Poll,0,1,7,47,0,9,0,54,0
Fox News Poll: President Trump's first 100 days getting mixed reviews ,0,3,5,49,2,11,3,54,0
Space Shuttle Lands in Florida,0,1,4,22,0,4,0,26,0
Sanders Adviser Says Campaign May Have To ’Re-Evaluate’ After Tuesday,0,2,11,46,3,9,0,57,0
Facebook is super thirsty for your Facebook Lives,0,2,3,39,0,7,0,42,0
"Jo Cox, Member of British Parliament, Is Killed in Attack - The New York Times",0,2,12,49,3,14,0,61,0
Watch Live: John Glenn Remembered,0,3,5,23,1,4,0,28,0
Leicester City sack Claudio Ranieri nine months after Premier League title win – video report,0,2,6,72,1,14,0,78,0
Wallace and Gromit sets destroyed by fire,0,1,2,33,0,6,0,35,0
'Pizzagate' shooting suspect facing new federal charge,0,3,1,45,2,6,0,46,0
Six children feared dead in Baltimore house fire,0,3,2,39,0,7,0,41,0
Dick Van Dyke 'joins cast of Mary Poppins Returns',0,3,6,34,2,8,0,40,0
Trump Picks Former Texas Governor Perry as Energy Secretary,0,3,8,43,0,8,0,51,0
Dakota Access oil pipeline protesters unroll huge banner at Vikings game,0,2,3,59,0,10,0,62,0
New Zealand citizenship requirements tighten in 2006,0,1,2,40,0,6,4,42,0
'Incident' at East London tube station,0,1,3,28,2,5,0,31,0
Noynoy Aquino elected Philippine president,0,1,3,35,0,4,0,38,0
Technology giants battle for USB 3.0 standards,0,1,4,33,1,6,2,37,0
"No Red Cape, or Red Ink, in South Korean Bullrings",0,1,8,31,2,9,0,39,0
Debbie Reynolds was more than just beauty,0,2,2,33,0,6,0,35,0
"The Public, Not the Pro, Rules at Bethpage Black",0,1,7,31,2,8,0,38,0
Ranking Potential for Upsets in First-Round NBA Playoff Matchups,0,3,10,45,1,8,0,55,0
AG Sessions on Hawaii Remark: ‘Nobody Has a Sense of Humor Anymore’,0,3,10,43,3,11,0,53,0
"Ignatieff, Rae say they'll run in next Canadian election",0,1,3,43,2,8,0,46,0
'Anti-democratic and un-American': Bruce Springsteen slams 'Muslim ban',0,3,5,52,7,7,0,57,0
Yankees Grab a Share of First Place as Everyone Lends a Hand,0,1,8,41,0,11,0,49,0
Extremely gracious teacher thanks 46 years worth of students on a billboard,0,3,1,61,0,11,2,62,0
Undocumented Student Who Posted Viral Tax Form Selfie Asks Trump For His Receipts,0,3,13,56,0,12,0,69,0
Brexit: EU judges to decide on UK cases ‘for years after EU withdrawal’,0,3,7,49,3,12,0,56,0
"A Trump Inauguration Casualty: The Silent, Smiling Rockettes ",0,3,8,43,2,8,0,51,0
Cubs' Javier Baez Honors 2016 World Series with Tattoo Before Spring Training,0,2,10,51,1,11,4,61,0
How Trump And Pence Are Doing Their Rallies Is “Totally Unprecedented”,0,2,11,47,2,10,0,58,0
"Alleged getaway driver 'instructed' slain teen burglary suspects to rob home, court documents say ",0,3,1,80,3,14,0,81,0
Helicopter crash in Australia kills four,0,1,2,33,0,5,0,35,0
New Delhi hits chilliest temperature this season and people won't stop complaining,0,2,2,68,1,11,0,70,0
Reliance Jio Website Now Hints At Fibre Broadband And Television Services Coming Soon,0,3,13,60,0,12,0,73,0
"In Mexico, Curbing Violence Before It Is Learned",0,1,8,32,1,7,0,40,0
"Crane levels New York City townhouse, leaving 4 dead",0,1,4,38,1,8,1,42,0
Louisiana Lawmakers Advance Bill to Abolish the Death Penalty,0,3,7,46,0,8,0,53,0
"Tropical storm Richard forms, drifts towards Honduras",0,1,3,43,1,6,0,46,0
"Whatever the IMF thinks, we are a long way from the boom time of 2007",0,2,4,46,1,14,4,50,0
Melbourne gunman missed court,0,1,1,25,0,3,0,26,0
William Morris and Endeavor to Become One Talent Agency,0,1,7,40,0,8,0,47,0
UK film board rejects Japanese horror 'Grotesque',0,1,4,37,2,6,0,41,0
Tax Time Travel Ban: IRS Can Take Your Passport,0,3,11,27,1,8,0,38,0
Air Force Sergeant Hacks Colleague Into Pieces Over Alleged Love Affair With His Wife,0,3,14,58,0,13,0,72,0
Sam Moore Sings 'America the Beautiful' at Trump Inaugural Concert,0,2,8,47,2,9,0,55,0
James McBride Discusses ‘To Kill a Mockingbird’ for the WSJ Book Club,0,2,12,44,2,11,0,56,0
"House Democrats rebuff Obama on trade, delivering major defeat",0,2,3,50,1,8,0,53,0
"Families, Lawmakers Want to Know More About What Becomes of College Students ",0,2,10,54,1,12,0,64,0
Students 'given dose equivalent to 300 coffees' in botched test,0,3,1,48,2,9,3,49,0
Guns N' Roses Fans Smashed A Piñata Made To Look Like Donald Trump,0,3,13,40,1,12,0,53,0
Gloria Steinem Refuses to Pay Taxes If Planned Parenthood’s Funding Eliminated,0,3,10,57,1,10,0,67,0
Kellyanne Conway: Reporters Who 'Talked Smack' About Trump Should Be Fired,0,3,11,50,3,10,0,61,0
Trump: 'Venezuela is a mess',0,3,2,19,3,4,0,21,0
Afghan policeman shoots and kills five British soldiers,0,1,2,46,0,7,0,48,0
Orkney to explore independence from Scotland and UK following Brexit,0,3,5,54,0,9,0,59,0
Lady Gaga Shuts Down Piers Morgan's Faulty Assumptions About PTSD And Rape,0,3,15,47,1,11,0,62,0
Troops Enter Gambia as New President Is Sworn In - The New York Times,0,2,12,43,1,13,0,55,0
"On State Secrets, Obama Is Sounding Like Bush",0,1,8,29,1,7,0,37,0
Former ISIS Recruit Now A Weapon Against Terrorism,0,2,11,32,0,7,0,43,0
"Teen Allegedly Kidnapped As Infant Reunites With Parents, 18 Years Later",0,3,10,49,1,10,2,59,0
Why Donald Trump’s message is ‘poison’ to swing voters,0,2,3,40,3,8,0,43,0
Congressman Raps 'Juicy' On The House Floor In Honor Of Notorious B.I.G.,0,3,14,42,5,11,0,56,0
Consumer Confidence Hits a 9-Month High,0,1,5,27,1,5,1,32,0
Golden Globes 2017: Lola Kirke's unshaven armpits sends body positive message at awards ceremony,0,3,4,73,2,13,4,77,0
U.S. Military Expresses Concern About Perception of an Iraqi Crackdown on Sunnis,0,1,10,57,2,11,0,67,0
Which Iconic Kim Kardashian Instagram Photo Got The Most Likes?,0,2,10,43,1,9,0,53,0
Freddie Flintoff and Professor Green discuss their battles with mental illness,0,2,4,64,0,10,0,68,0
UN: World hunger at all-time high due to economic slowdown,0,1,3,44,2,9,0,47,0
Republicans’ 4-Step Plan to Repeal the Affordable Care Act ,0,3,7,40,2,9,1,47,0
Everything You Need to Know About Donald Trump’s Inauguration ,0,3,8,44,1,9,0,52,0
Paul Ryan listening to Papa Roach in the NYT is fake news,0,3,7,39,0,11,0,46,0
"Manipuri Employee Beaten Unconscious In Gurgaon In Office, Accused Of Data Theft",0,2,12,56,1,11,0,68,0
Cypriot plane with 121 on board crashes in Greece,0,1,2,36,0,8,3,38,0
Cam Newton Says Fatherhood Has ‘Helped Me Be a Better Man’,0,3,10,36,2,10,0,46,0
Bernie Sanders wants to take back “family values” from the GOP,0,2,5,45,2,10,0,50,0
Jennifer Lopez & Marc Anthony Reunite on the Charts,0,3,6,36,1,8,0,42,0
Mike Birbiglia’s 6 Tips for Making It Small in Hollywood. Or Anywhere. - The New York Times,0,2,13,57,4,16,1,70,0
Watch 2 New Action-Packed 'Rogue One' Clips Ahead of Its Release,0,3,10,40,3,10,1,50,0
Those Who Lost Savings Find Little Comfort,0,1,7,29,0,6,0,36,0
"George Michael dies at 53; the singer passed away ‘peacefully at home,’ rep says",0,3,2,59,4,13,2,61,0
Eddie Lampert blames the media for Sears’ troubles,0,2,3,39,1,7,0,42,0
China Roars Back to Lift Global Outlook as U.S. Consumer Weakens,0,2,10,42,2,10,0,52,0
State of the UnionVerifizierter Account,0,2,4,31,0,4,0,35,0
"End humiliating restraint of mentally ill people, say charities",0,3,1,53,1,8,0,54,0
Inter Milan's tour of England back on,0,1,3,27,1,6,0,30,0
Al-Qaeda says another bin Laden tape to be released,0,1,3,39,1,8,0,42,0
Carson: I’d Be Anti-Trump If I Weren’t So Worried About My Grandkids’ Future,0,2,14,45,5,12,0,59,0
Reykjavik time-lapse captures overnight snowfall,0,2,1,42,1,4,0,43,0
Jabrill Peppers Reportedly Tested Positive for Dilute Sample at 2017 NFL Combine,0,3,11,54,0,11,4,65,0
Sanders Camp Deletes Bloody Sunday Tweet Showing March From ’Selma’ Film,0,2,11,49,2,10,0,60,0
"Booming Iceland Needs to Sober Up, Governor Warns After Rate Cut",0,3,10,43,1,10,0,53,0
Wall St: US shares limp to modest fall,0,3,4,26,1,7,0,30,0
"Security Guards at Church Services As ‘New Clientele’ Defecate, Masturbate in Pews",0,3,10,58,3,11,0,68,0
"At a School in Kansas, a Moment Resonates",0,1,5,28,1,7,0,33,0
‘Is that not correct?’: Male GOP lawmaker asks why men should pay for prenatal coverage,0,3,5,64,4,14,0,69,0
Nate Robinson Signs D-League Contract: Latest Details and Reaction,0,3,9,47,2,8,0,56,0
Proverbial Sins,0,2,2,12,0,1,0,14,0
Donald Trump Explains Sweden Terror Comment That Baffled a Nation,0,3,9,47,0,9,0,56,0
"On Monday Night, 'The Bachelor' Actually Addressed Racism",0,3,8,39,3,7,0,47,0
The Truck’s Path Through a Crowded Christmas Market in Berlin ,0,3,8,43,1,10,0,51,0
Trump to Union Leaders: 'We're Gonna Put People Back to Work',0,2,9,38,4,10,0,47,0
The Power of a Nudge Toward Thrift,0,1,5,23,0,6,0,28,0
Sister of US tourist killed on Melbourne flight remembers her brother as 'a great guy' ,0,2,4,66,2,15,0,70,0
Le Pen Wins Over Women Voters Who Feel Left Behind in France,0,2,11,38,0,11,0,49,0
Gallup poll finds Trump approval rating at 37 percent,0,3,2,41,0,8,2,43,0
"Almost 500 die in watercraft activities in decade, Royal Life Saving Society reports",0,3,5,63,1,12,3,68,0
U.S. Rep. Conyers raises Bush censure issue,0,1,5,29,3,6,0,34,0
SCOTUS Upholds Gun Ban For Those Convicted Of Domestic Violence - Breitbart,0,2,16,47,1,11,0,63,0
"Turkey suspends more than 9,000 police officers over 'Gulen links'",0,3,2,48,3,9,4,50,0
Dustin Johnson Takes Four-Shot Lead at Pebble Beach,0,1,8,35,1,7,0,43,0
"3 Dead in Georgia Shooting, and a Professor Is Sought",0,1,6,36,1,9,1,42,0
Union leader says No 10 demonising working people in strikes row,0,2,2,50,0,10,2,52,0
"Once Scorned, ‘Multispeed Europe’ Is Back ",0,3,6,27,3,6,0,33,0
Australia announces plans to close five mainland refugee detention centres,0,1,1,64,0,9,0,65,0
Proud Mom Julia Louis-Dreyfus Cheers On Her Son at NCAA B-Ball Game  Insider,0,3,17,44,2,13,0,61,0
Deputy dead after apparently inhaling liquid nitrogen at sperm bank,0,3,1,57,0,9,0,58,0
Osama bin Laden praises martyrdom in video,0,1,2,34,0,6,0,36,0
#LifeAtComplex: Nick Young Chooses the Ultimate G.O.A.T.,0,3,11,33,6,6,0,44,0
U.N. backs Russian-Turkish efforts to end Syria's war,0,3,5,37,4,7,0,42,0
Caught on Camera: Package Thief Poses As Pizza Man,0,3,8,33,1,8,0,41,0
"Drugmaker fined $100M for hiking price 85,000%",0,2,2,27,3,6,8,29,0
Cricket: Buderim to fill half Politicians team on Australia Day,0,1,5,48,1,9,0,53,0
Grantchester star James Norton criticises trend for faith being portrayed as 'exorcisms and cults',0,2,3,80,2,13,0,83,0
Republic of Ireland women's team could go on strike in row over treatment by FAI,0,3,5,60,1,14,0,65,0
VMwareVoice: The Cloud Will Drive Your Car,0,3,9,26,1,6,0,35,0
Full Text of Supreme Court Nominee Gorsuch's Remarks to Senate Panel,0,2,9,48,1,10,0,57,0
Polaroid goes bankrupt,0,1,1,19,0,2,0,20,0
Iran Lifts Ban Preventing US Wrestlers From Attending Tournament ,0,2,10,46,0,9,0,56,0
How to tame frizzy hair: the products that actually work,0,2,1,45,1,9,0,46,0
Nigerian Migrant Arrested for Stabbing Female ‘Refugee Helper’ to Death,0,2,8,52,2,9,0,60,0
"Boot camps, victim conferencing to be expanded in NT in bid to curb youth crime",0,3,3,61,1,14,0,64,0
"Donald Trump Said The Country Is Waiting For ‘Easy D,’ And, Well, Yeah",0,3,13,40,5,12,0,53,0
Chinese Tesla Wannabe Pushes Ahead Despite Government Jam,0,3,8,42,0,7,0,50,0
"Robert Alford Intercepts Tom Brady, Returns Pick for Score",0,2,8,41,1,8,0,49,0
A New Map for America ,0,3,4,13,0,5,0,17,0
Bitcoin is taking off,0,3,1,17,0,3,0,18,0
Remembering Srebrenice massacre,0,1,2,27,0,2,0,29,0
MMA Fight Ends in Jaw-Dropping Fashion with Rare Double Knockout,0,3,11,43,1,9,0,54,0
Rex Tillerson Suggests The U.S. Should Stay In Paris Climate Agreement,0,2,12,46,2,10,0,58,0
"Global Economy Week Ahead: Fed and Bank of England Meetings, U.S. Jobs Report",0,2,12,49,4,12,0,61,0
South Korea’s President Removed From Power After Impeachment,0,3,8,44,1,7,0,52,0
Amazon CEO Jeff Bezos is now the second richest man in the world,0,3,6,46,0,12,0,52,0
.tel top-level domain launched,0,1,0,25,2,3,0,25,0
"Millions Across Plains and Midwest Face Heavy Snow, Deep Freeze Over the Weekend",0,3,11,56,1,12,0,67,0
"Benches Clear After Matt Kemp Is Hit by Pitch, Ump Shows off His Blocking Skills",0,3,13,52,1,14,0,65,0
Three Simple Rules for Eating Seafood ,0,3,5,27,0,6,0,32,0
Altercation erupts between rock musicians at MTV Music Video Awards,0,1,7,51,0,9,0,58,0
Google Makes Nevada Land Grab for Data Center,0,3,7,31,0,7,0,38,0
ROBERT SHILLER: 'This market is way overpriced',0,3,14,24,3,6,0,38,0
Google’s YouTube to Launch $35-a-Month Web-TV Service ,0,3,9,31,5,7,2,40,0
NCAA Championships Will Return To North Carolina After An Anti-LGBT Law Was Partially Changed,0,2,21,58,1,13,0,79,0
"Affordable Care Act remains ‘law of the land,’ but Trump vows to explode it",0,3,4,55,3,13,0,59,0
Australian family rescued after night on Japan mountain,0,2,2,46,0,7,0,48,0
ICE agent shoots man during arrest attempt in Chicago,0,3,4,41,0,8,0,45,0
"France and Germany resume growth, exit recession",0,1,2,39,1,6,0,41,0
"A Day Best Captured by Image, Not Narrative",0,1,7,28,1,7,0,35,0
European Military Plane Faces Even More Delays,0,1,7,33,0,6,0,40,0
LGBTQ Community Worried About Hate Crime Prosecutions,0,2,11,36,0,6,0,47,0
"Former U.S. soldier convicted of raping Iraq teen, four murders",0,1,4,47,3,9,0,51,0
"Instead of Glory, the Finder of a Rare Dinosaur Fossil Faces Charges of Theft",0,1,9,54,1,13,0,63,0
Morning Brief: Trump gives 'Fox & Friends' exclusive preview of tonight's speech ,0,3,5,59,5,12,0,64,0
British schools to inform parents of overweight children,0,1,1,48,0,7,0,49,0
"Young Thug Acts Like A Jerk In The Airport, Twitter Claps Back",0,3,12,38,1,11,0,50,0
U.N. Vote on Syria Fails as Russia Blocks Measure,0,3,8,31,2,8,0,39,0
Controversy after leak of preliminary report into Spanair disaster,0,1,2,56,0,8,0,58,0
Murder and Hate Verdict in Transgender Case,0,1,5,32,0,6,0,37,0
The Online Ad That Knows Where Your Friends Shop,0,1,9,31,0,8,0,40,0
Leopoldo Lopez: Venezuela court upholds 14-year prison sentence,0,2,3,49,2,7,2,52,0
The 13 best beaches in the USA,0,2,4,18,0,6,2,22,0
5 hilarious fathers on Twitter who tell more than 'dad jokes',0,2,1,47,2,10,1,48,0
"Epic Drug Lab Scandal Results in More Than 20,000 Convictions Dropped",0,2,9,44,1,10,5,53,0
Power crisis in Moscow and central Russia largest ever recorded,0,1,3,51,0,9,0,54,0
At least 30 inmates killed with three 'beheaded' in Brazil prison riot,0,2,2,53,2,11,2,55,0
Recruit's dad to Urban Meyer: Don't recruit my son,0,3,4,35,3,8,0,39,0
"Planes, Trains and Automobiles",0,3,3,23,1,3,0,26,0
Eight teens shot outside Indiana skating rink,0,1,2,37,0,6,0,39,0
How Much Wealth Will You Have 30 Years Into Retirement?,0,3,9,34,1,9,2,43,0
Blind man puts camera on guide dog to expose daily abuse from commuters,0,3,1,58,0,12,0,59,0
Beyoncé Just Announced She’s Pregnant With Twins,0,2,7,34,1,6,0,41,0
"Major fire reported in Soho, London",0,1,3,26,1,5,0,29,0
Why Trump Killed TPP — And Why It Matters To You,0,3,12,25,1,10,0,37,0
"All confirmed dead on Kata Air An-32, Moldova asks for Russian investigatory help",0,1,6,59,2,12,2,65,0
"There Are More Than 60,000 Species Of Trees In The World, And Over 10,000 Of Them May Go Extinct Soon",0,3,18,51,3,19,10,69,0
Pork Industry Fights Concerns Over Swine Flu,0,1,7,31,0,6,0,38,0
Uber passes Starbucks as business travelers' no. 1 expense,0,3,2,45,2,8,1,47,0
"Warner Music CEO Stephen Cooper Touts Market Share Gains, Praises Craig Kallman in Year-End Message to Staff",0,3,18,72,2,16,0,90,0
Community forum held after attacks on Mormon teens in Arizona,0,1,3,49,0,9,0,52,0
"United Airlines video: Jimmy Kimmel, Ava DuVernay and more react to clip of passenger being dragged off plane",0,3,7,83,2,17,0,90,0
Wikipedia again blocked in China,0,1,2,26,0,4,0,28,0
Game of Thrones season 7: Mark Gatiss confirms his return (and presumably the Iron Bank),0,2,6,64,3,14,1,70,0
Science in the Quest to Ease Figure Skating's Strains,0,1,6,38,1,8,0,44,0
"A Skeleton 4,000 Years Old Bears Evidence of Leprosy",0,1,7,32,1,8,4,39,0
Ashish Nehra Feels That MS Dhoni May Not Be Looking So Far Ahead Right Now To See If He Will Play The 2019 World Cup,0,3,25,63,0,24,4,88,0
Torrential downpours cause significant flooding in northeastern Scotland,0,1,2,63,0,7,0,65,0
"CMO Today: Trump Clashes With CNN, BuzzFeed at Press Conference",0,3,14,38,2,9,0,52,0
Yahoo Discloses New Breach of 1 Billion User Accounts,0,2,7,37,0,8,1,44,0
Pretax Loss Weakens British Banking Merger,0,1,6,31,0,5,0,37,0
Merkel heads to North Africa to reduce migrant flows,0,3,3,41,0,8,0,44,0
"Suspect Shoots Three Dead In Fresno, Yells ‘Allahu Akbar’ When Tackled by Police",0,3,12,53,3,12,0,65,0
YouTube unveils $35 a month TV service as it reveals viewers watch a BILLION hours of video a day,0,3,11,65,1,18,2,76,0
"Brantley Gilbert, Thomas RhettÂ Collect New Country Chart No. 1s",0,2,10,42,2,9,1,52,0
Janus Chief Resigns After Shaking Up Fund Manager,0,1,8,34,0,7,0,42,0
"Fidel Castro's ashes laid to rest in Cuba, ending nine days of mourning",0,3,3,54,2,12,0,57,0
Northwestern MutualVoice: The New Entrepreneurial Face: Minority Business Women,0,3,10,59,2,8,0,69,0
Keystone Pipeline Is A Risky Bet On Higher Oil Prices,0,3,10,34,0,9,0,44,0
Lewandowski: Trump's staff is letting him down,0,3,2,36,2,6,0,38,0
Croydon 'hate crime': Six arrested on suspicion of attempted murder after attack on refugee boy,0,2,2,76,3,14,0,78,0
Ai Weiwei’s Latest Artwork: Building Fences Throughout New York City ,0,3,10,47,2,10,0,57,0
David Fahrenthold tells the behind-the-scenes story of his year covering Trump,0,2,3,63,2,10,0,66,0
6 Shot at Memorial For Victim of Chicago Gun Violence,0,3,7,36,0,9,1,43,0
Barry Manilow Kept Sexuality Secret for Fear of ‘Disappointing’ Fans,0,3,8,49,2,9,0,57,0
Facebook video helps man find the woman who saved his life,0,3,1,47,0,10,0,48,0
Relatives of missing Flight MH370 passengers fly to Madagascar to 'take search into own hands',0,2,5,70,2,14,3,75,0
Just How Badly Did Ellen DeGeneres Butcher Rae Sremmurd's Name?,0,2,11,41,2,9,0,52,0
We became scientists to help the world. Now we need to take to the streets.,0,3,2,57,2,14,0,59,0
True Pro-Life Convictions Are Non-Negotiable,0,2,7,31,2,4,0,38,0
The 9 Highest-Calorie Meals At Chain Restaurants,0,2,7,33,1,6,1,40,0
PaycomVoice: Honoring Women in Business,0,2,5,29,1,4,0,34,0
"Our Mob, God's Story: Indigenous artists share Christian faith through painting",0,2,6,60,3,10,0,66,0
South by Southwest faces firestorm of scrutiny over immigration clause in contract ,0,3,2,69,0,12,0,71,0
Jimmy Fallon Kills It With Hilarious Donald Trump Presser Spoof,0,3,10,44,0,9,0,54,0
NASA's Mars rovers exceed all expectations,0,1,5,31,1,5,0,36,0
Iran tests new centrifuges,0,1,1,22,0,3,0,23,0
Investors Await Moves From the Fed,0,1,5,24,0,5,0,29,0
Stocks Retreat as Iron Ore Hurts Commodity Shares: Markets Wrap,0,3,9,44,1,9,0,53,0
Apple’s Siri learns Shanghainese as voice assistants race to cover languages,0,2,3,62,1,10,0,65,0
China's Xi to Hold First Meeting With Trump Next Week in Florida,0,3,10,42,1,11,0,52,0
Australian Marcos Ambrose Is Rising Nascar Star,0,1,7,34,0,6,0,41,0
Cricket: England beat India in third one-day international,0,1,3,46,2,7,0,49,0
Premio Lo Nuestro 2017: See the Full Winners List,0,3,7,29,1,8,4,36,0
Drug website surveys LSD users and culture,0,1,4,32,0,6,0,36,0
Lorde Releases New Song 'Liability',0,2,5,24,2,4,0,29,0
Trump is sending his national security adviser H.R. McMaster to Afghanistan,0,3,6,57,2,10,0,63,0
Welsh swimming squad named for 2006 Commonwealth Games,0,1,3,40,0,7,4,43,0
Judge uses retirement speech to confess that he drew rude graffiti on an official court computer,0,3,1,80,0,15,0,81,0
Adidas Readies the Next Ultra Boost,0,3,5,25,0,5,0,30,0
Stephen Colbert Does The Real Math On Donald Trump's Promised Border Wall,0,3,12,49,1,11,0,61,0
"Amid Trump Twitter controversies, White House preparing to expand social media team",0,2,5,66,1,11,0,71,0
Nintendo releases GameBoy Micro in the US,0,1,6,29,0,6,0,35,0
The Missing Step To Getting Out (And Staying Out) Of Debt,0,3,11,34,2,10,0,45,0
Bernie Sanders Loyalists Are Taking Over the Democratic Party One County Office at a Time,0,2,12,63,0,14,0,75,0
Kim Jong Un party paradise: North Korean dictator's resort revealed as his people starve ,0,3,5,68,2,14,0,73,0
Oscars 2017: Complete winners list ,0,3,2,23,1,5,4,25,0
"Hillary Clinton's back in the spotlight, but decidedly not on the campaign trail",0,3,2,64,2,12,0,66,0
Samantha Bee and Jane Pauley Are Breaking the News ,0,2,7,35,0,9,0,42,0
Helicopter crash in Turkey kills six,0,1,2,29,0,5,0,31,0
China bans burqas and 'abnormal' beards in Muslim province of Xinjiang,0,3,3,55,2,10,0,58,0
Here are the 8 retail CEOs who met with Trump to discuss stopping the border tax,0,3,5,59,0,15,1,64,0
Golden Globes 2017: Stars React to Nominations ,0,3,5,30,1,7,4,35,0
Arjun Kapoor's Sister Anshula Requests Arun Jaitley To Make Sanitary Napkins Tax-Free,0,3,13,59,2,11,0,72,0
Theresa May signals that Britain will leave Single Market so it can take control of immigration,0,3,5,75,0,15,0,80,0
Medtronic Links 13 Deaths to Faulty Heart Device,0,1,6,33,0,7,2,39,0
Collingwood win 2010 AFL Grand Final replay,0,1,6,27,0,6,4,33,0
Obama considers 'comprehensive' exit strategy from Afghanistan,0,1,2,52,2,6,0,54,0
Gold Miners Burned by Bad Deals Are Again Rushing to M&A,0,3,10,35,1,10,0,45,0
Governors of Mexico Write to Support Detained Seattle ‘Dreamer’,0,3,7,46,2,8,0,53,0
French Socialist Parliament Leader May Not Back Party Candidate,0,3,9,46,0,8,0,55,0
Facebook Live update allows video to be streamed from browsers,0,2,2,51,0,9,0,53,0
"Trump, Putin both seek to boost their nuclear capability",0,3,2,45,1,8,0,47,0
Trump takes aim at ‘Sleepy Eyes’ Chuck Todd,0,2,5,29,2,7,0,34,0
“Scientific racism” is on the rise on the right. But it’s been lurking there for years.,0,2,2,65,5,15,0,67,0
Tom Brady Posts Odd Cartoon Trolling Texans Fans After Pats’ Win,0,3,11,42,1,10,0,53,0
Israel seizes ship claimed to be carrying weapons for Gaza,0,1,2,47,0,9,0,49,0
"Economy Remains Weak, but Fed Sees Bright Spots",0,1,7,32,1,7,0,39,0
London attacks: Adelaide woman injured in Westminster recovering after surgery,0,2,3,65,1,9,0,68,0
Up to one-half of Somali food aid diverted from needy,0,1,2,41,1,9,0,43,0
U.S. Begins Third Effort to Convict 6 in Terror Case,0,1,8,32,2,9,1,40,0
Rubio camp says it's raised $100G after NYT articles ,0,2,5,34,2,9,3,39,0
"Free trade warning – IMF, WTO and World Bank say it must be defended",0,3,9,44,2,13,0,53,0
Serena Williams Beats Venus Williams to Win Her 7th Australian Open Title ,0,3,10,51,0,12,1,61,0
Adrian Peterson Won't Return to Vikings After Latavius Murray Signing,0,3,9,50,1,9,0,59,0
"A Drugmaker Tries To Cash In On The Opioid Epidemic, One State Law At A Time",0,2,16,44,1,15,0,60,0
The Weaknesses That Doomed Ted Cruz,0,2,6,24,0,5,0,30,0
UMG's Deal With Spotify: How Grainge and Ek (Finally) Got It Done,0,3,13,37,4,11,0,50,0
The Many Ways ’Buy American’ Can Harm the Economy,0,2,8,31,2,8,0,39,0
North Korea Says It Tested New ‘High-Thrust’ Rocket Engine,0,3,10,37,3,8,0,47,0
More Americans disapprove than approve Trump's handling of transition,0,2,3,57,1,8,0,60,0
"An Effort to Save Flint, Mich., by Shrinking It",0,1,7,29,3,8,0,36,0
100 participate in Zagreb Pride,0,1,2,22,0,4,3,24,0
This week in finance: Trump tax cuts and inflation set to dominate markets,0,3,2,59,1,12,0,61,0
Man's NSFW 'complaint' about donuts escalates spectacularly on Twitter,0,3,6,53,3,8,0,59,0
Washington Monument shut until at least 2019 for repairs,0,3,2,42,0,8,4,44,0
New legal British tender revealed,0,1,2,27,0,4,0,29,0
Tracee Ellis Ross Delivers Inspiring Acceptance Speech at the Golden Globes,0,3,9,56,0,10,0,65,0
French Workers stay at home for Whit Monday,0,1,4,32,0,7,0,36,0
6 Holiday Finance Tips To Help Manage Your Seasonal Spending,0,3,9,41,0,9,1,50,0
Gregg Popovich compared Becky Hammon to Steve Kerr and says she has what it takes to be an NBA coach,0,2,9,72,0,19,0,81,0
Hillary Clinton 2016 campaign rally on Roosevelt Island – as it happened,0,3,4,52,1,11,4,56,0
Yukio Hatoyama named as Japan's new Prime Minister,0,1,5,37,1,7,0,42,0
Berlin attack: Merkel vows 'national effort' on deportation,0,3,2,47,3,7,0,49,0
Wegmans supermarket sells out of Trump wine after proposed boycott ,0,3,2,55,0,10,0,57,0
Japanese manga artist Jiro Taniguchi dies aged 69,0,3,3,37,0,7,2,40,0
"UK failing Syrian refugees who survived torture, say MPs",0,3,5,42,1,8,0,47,0
Journey to the Center of the Country,0,2,3,27,0,6,0,30,0
Ranking the Most Overpaid Coaches in College Football Today,0,2,7,44,0,8,0,51,0
"The week in apps: Yahoo gets caller ID, Yelp does 411, and more",0,2,5,40,3,12,3,45,0
"Venezuelan opposition, security forces clash in anti-Maduro protests",0,2,2,57,2,7,0,59,0
El Chapo’s lawyers say drug kingpin is subjected to overly strict jail conditions,0,2,2,66,1,12,0,68,0
"Wie, Creamer and Lincicome Lurk Behind Leaders at Sybase Classic",0,1,8,46,1,9,0,54,0
40th H1N1 swine flu death recorded in Scotland,0,1,3,32,0,7,4,35,0
239 People Are Dead. Should Searchers Keep Looking for Malaysia Airlines Flight 370? ,0,2,10,54,2,13,6,64,0
"EU, Microsoft agree on browser ballot",0,1,3,28,1,5,0,31,0
Unseen pictures of Paul McCartney and his Eighties touring band in rehearsals - exclusive,0,3,5,70,1,13,0,75,0
Snowstorms may lead to blizzard of heart troubles,0,2,1,41,0,7,0,42,0
"Maine Gov. Paul LePage Is Still Questioning Election Results, For No Apparent Reason",0,3,14,56,2,12,0,70,0
Trump files paperwork turning over company offices to sons,0,2,1,49,0,8,0,50,0
European court in Strasbourg rules UK's Terrorism Act in breach of human rights law,0,1,6,63,1,13,0,69,0
Auto Crisis Adviser Is Called Pro-Labor Pragmatist,0,1,8,35,1,6,0,43,0
When You Bomb at the Book Club,0,3,5,19,0,6,0,24,0
Facebook bans nude Women Lovers painting by acclaimed artist ,0,3,3,49,0,9,0,52,0
The ‘heinous’ case of a child whose mother allegedly kept him locked in a bathroom for months,0,2,1,74,2,16,0,75,0
Universal Studios Adding ’Super Nintendo World’ to Japanese Theme Park - Breitbart,0,2,10,58,3,11,0,68,0
"Berlin Christmas market: 12 dead, 48 hospitalized in truck crash",0,3,2,47,2,9,4,49,0
Ikea significantly expanding paid parental leave,0,3,1,42,0,5,0,43,0
Lawyer for Russian Whistleblower’s Family Falls Out of Window,0,3,7,45,1,8,0,52,0
"3 Years Later, Childhood Cancer Survivors Recreate Viral Photo [Video]",0,3,9,48,3,9,1,57,0
"Coast, a Medical Trial Company, Agrees to Suspension",0,1,6,37,2,7,0,43,0
Alistair Brownlee: ‘Mexico brought us to people’s attention’,0,3,3,46,4,7,0,49,0
"Brown Backtracks, Saying Iraq Panel Can Hold Some Open Hearings",0,1,10,43,1,9,0,53,0
Sesame Street helps poor kids learn faster,0,2,2,34,0,6,0,36,0
"Which? survey finds household appliances to blame for almost 12,000 fires in three years",0,3,1,67,2,13,5,68,0
Texas pool party chaos: 'Out of control' police officer resigns,0,2,2,49,3,9,0,51,0
Judge Jeanine on Potential Voter Fraud: 'Dead People Vote All the Time'  Insider,0,3,11,53,3,13,0,64,0
Seven million dollar Iraq bank heist leaves eight dead,0,1,2,44,0,8,0,46,0
Highly Taxed Companies Need Trump to Deliver to Justify Post-Election Rallies,0,3,10,56,1,10,0,66,0
Pressure mounts as Senate subpoenas Flynn again over Trump-Russia inquiry,0,2,5,58,1,9,0,63,0
Your car wants to say hello. And that’s only the start.,0,2,2,40,3,10,0,42,0
Syrian army reportedly seizes Aleppo Old City from rebels,0,3,4,45,0,8,0,49,0
Investors Look Past Headlines as Bull Market Roars Ahead ,0,3,8,40,0,9,0,48,0
Man shot after attempting to drive through US-Mexico border,0,1,4,46,1,8,0,50,0
"I bought a comfortable desk chair, and it was one of the best purchases I made last year",0,2,2,68,1,17,0,70,0
"YouTube Being Blocked in China, Google Says",0,1,7,29,1,6,0,36,0
Australian Is Shot Dead Near a Mine in Indonesia,0,1,7,33,0,8,0,40,0
See and Be Seen ,0,3,3,9,0,4,0,12,0
Fisherman survives six-hour ordeal in remote waters off Australia,0,2,2,54,1,8,0,56,0
"Trump administration drops lawsuit against N.C. over ""bathroom bill""",0,3,3,53,4,8,0,56,0
"Texas Cop, Wife Shoot Muggers at Gas Station",0,2,7,29,1,7,0,36,0
Martin Shkreli's Twitter account suspended after he posts creepy photo collage,0,3,3,64,1,10,0,67,0
"Rapper Bun B Talks Super Bowl, Pimp C and Education",0,3,9,32,1,9,0,41,0
Republicans Firing Blanks at Obama,0,1,4,26,0,4,0,30,0
"¡Obámanos! President Barack Obama’s Legacy, Through a Latino Lens",0,3,8,45,4,8,0,53,0
"Hertfordshire, England police arrest armed suspect after stand-off",0,1,2,55,2,7,0,57,0
State Department not issuing passports overseas due to computer glitch,0,3,2,59,0,9,0,61,0
A Sheriff and His Fiancée Scared Friends and Family With Their Wedding Invitations,0,2,11,59,0,12,0,70,0
Fans Are Still Finding Value in Shea Stadium,0,1,7,30,0,7,0,37,0
Controllers for Nintendo's newest console start at $70,0,3,2,41,2,7,2,43,0
Chapecoense crash: Bolivian Defence Minister calls plane disaster 'murder',0,3,4,59,3,8,0,63,0
Amazon's $200 Echo Look will judge your outfits,0,3,3,32,2,7,3,35,0
"Substitute allegedly brought boxed wine to school, vomited in class ",0,3,1,56,1,10,0,57,0
"Nigel Slater’s sweet potato, brussels and cream recipe",0,3,2,43,2,7,0,45,0
Mother of four builds home from scratch after watching YouTube tutorials,0,3,3,59,0,10,0,62,0
"MAP: All of the Sears, Macy's, and Kmarts that are closing",0,3,7,37,4,10,0,44,0
Oliver! actor Ron Moody dies aged 91,0,3,3,24,1,6,2,27,0
Trump Names Michael Glassner to Oversee Campaign Committee ,0,3,7,44,0,8,0,51,0
Less NHS waste: Is Lord Carter's report a case of deja vu?,0,2,7,37,3,11,0,44,0
Yanks Reaping Benefits of Gardner-Cabrera Competition in Center,0,1,7,48,1,7,0,55,0
Tony Romo dressed for the Dallas Mavericks and was introduced with the starting lineups,0,3,4,70,0,13,0,74,0
Coca Cola's sexy new ad bubbles up surprising social media reactions ,0,2,2,55,1,11,0,57,0
"If You Use WhatsApp Or Telegram On PC, Your Account Can Be Compromised",0,3,15,42,1,12,0,57,0
UN agencies urge Donald Trump to allow refugees entry in vital resettlement program,0,3,4,67,0,12,0,71,0
Hills Hoist ownership changes hands but iconic clothesline hangs on to its place in backyard culture,0,2,2,83,0,15,0,85,0
Feud between CNBC and The Daily Show continues to escalate,0,1,8,41,0,9,0,49,0
Case Could Open Borders of Doping Fight in Cycling,0,1,7,35,0,8,0,42,0
The collapse of Barbara Cook’s show is heartbreaking for all concerned,0,2,3,56,1,10,0,59,0
French leader: Trump administration poses challenges for Europe,0,2,3,52,1,7,0,55,0
Where Women Rule Finance and Men Think Banking Is Boring,0,3,9,38,0,9,0,47,0
French Interior Minister Bruno Le Roux Resigns       ,0,3,7,33,0,13,0,40,0
Election Commission To Launch Campaign Reassuring Public That Electronic Voting Machines Are Safe,0,3,13,72,0,12,0,85,0
"After Turkey’s failed coup, a sense of fatalism has set in",0,3,2,44,2,10,0,46,0
'I love you Mommy': Heartbroken mother shares 4-year-old son's final moments of cancer battle ,0,3,3,70,6,14,1,73,0
Slain DNC staffer's father doubts WikiLeaks link as cops seek answers ,0,3,6,52,1,11,0,58,0
"Meet Gar Ryness, the Batting Stance Guy",0,1,6,26,1,6,0,32,0
Feds Go After Concessions Company That Shorted Senate Workers $1 Million,0,3,10,50,1,10,1,60,0
Shiites protest against discrimination in Bahrain,0,1,2,42,0,5,0,44,0
Cops Hunt Accused Gun Thief Who Sent Anti-Government Manifesto To Trump,0,3,12,48,1,10,0,60,0
Insane Clown Posse Sued for Stealing a Poem From 'Chicken Soup for the Soul',0,3,10,51,2,13,0,61,0
"Great little ski resorts: Val d’Arly, France",0,3,4,31,3,6,0,35,0
"In Europe, a Stronger Push to Oversee Banks",0,1,6,29,1,7,0,35,0
Titanic: Diving tours of wreck site to begin in 2018,0,3,2,36,1,9,4,38,0
One of the best 4K mirrorless cameras is now even better,0,3,2,43,0,10,1,45,0
"Bryshere Gray, Woody McClain & Algee Smith on Working With Legends for BET's 'The New Edition Story'",0,2,17,62,5,16,0,79,0
2nd-Largest Mall Operator Files for Bankruptcy,0,1,5,34,1,5,1,39,0
Trump’s Visa Freeze Stands on Solid Legal Ground,0,2,7,33,1,7,0,40,0
"Dear world, I wasn't all bad. Signed, 2016",0,2,3,24,4,7,4,27,0
Suspect in trooper's death killed in encounter with police ,0,3,1,48,1,9,0,49,0
'March 4 Trump' Rallies Run into Counter-Protests,0,3,6,33,3,6,1,39,0
Double-Amputee Sprinter Oscar Pistorius Hurt in Boating Accident,0,1,8,48,1,7,0,56,0
An Entire Family Of Bears Died In A Church Parking Lot After Eating A Poisonous Plant,0,2,16,54,0,15,0,70,0
US Congresswoman Stephanie Tubbs Jones dies at age 58,0,1,6,37,0,8,2,43,0
"Report: Cheetahs, the world's fastest land animals, racing toward extinction",0,2,2,61,4,9,0,63,0
New immigration crime hotline becomes target of prank calling campaign,0,3,1,60,0,9,0,61,0
Iran to Trump: 'Now is not the time to build walls',0,3,3,35,3,10,0,38,0
Emerging Markets Show Fed Resistance,0,2,5,27,0,4,0,32,0
Bomb explosions in northeastern India kill at least seven,0,1,2,47,0,8,0,49,0
"Taliban militants kill 20 Afghan police officers in attack, official says ",0,3,2,58,1,11,2,60,0
Sanctuary cities threatened with loss of federal grant money ,0,2,1,51,0,9,0,52,0
Israeli President chooses Likud leader to form the 18th Knesset government,0,1,4,58,0,10,2,62,0
Lady Gaga drove a Lamborghini to the Super Bowl ,0,3,5,34,0,9,0,39,0
UEFA president Platini confirms Euro 2012 to be hosted in Poland and Ukraine,0,1,8,52,0,12,4,60,0
"Bellagio catches fire, causing closure of Las Vegas Strip ",0,3,4,44,1,9,0,48,0
E.P.A. Takes Step to Cut Emissions From Planes ,0,3,9,27,3,8,0,36,0
Here’s Why Chance The Rapper Doesn’t Think You Should Fear Trump,0,3,11,41,2,10,0,52,0
Sometimes Cancer Is Just Bad Luck,0,3,6,22,0,5,0,28,0
Obama Administration Rushed to Preserve Intelligence of Russian Election Hacking ,0,2,8,63,0,10,0,71,0
Trade Barriers Rise as Slump Tightens Grip,0,1,6,30,0,6,0,36,0
Starbucks barista wins $900K Westgate Las Vegas SuperContest,0,3,7,42,1,7,3,49,0
Ferguson to Decide if It Wants a New Mayor for First Time Since Michael Brown Killing,0,3,12,58,0,15,0,70,0
The 98-Year-Old Tao Can Give You Serious Fitness Goals And Can Help You Live A Positive Life,0,3,18,54,2,16,2,72,0
Sources: Trump signed off on checking White House staffers' phones,0,3,4,51,2,9,0,55,0
Inauguration Workers Cover Up 'Don's Johns' on Portable Toilets on Capitol Hill  Insider,0,3,11,61,3,13,0,72,0
After Fukushima: the tenants rebuilding a destroyed community,0,3,2,51,1,7,0,53,0
Tottenham Hotspur v Watford: Premier League – live!,0,3,5,36,3,7,0,41,0
Twitter decides to keep Vine as a camera app,0,3,2,34,0,8,0,36,0
"Turkey dismisses 4,400 public servants in latest post-coup attempt purge",0,2,1,56,2,9,4,57,0
"Seniors’ Teeth Need Dental Care, But Insurance Coverage Is Rare",0,2,10,42,2,9,0,52,0
'I Committed First Murder At 12' SP Candidate In UP Heard Bragging In Leaked Audio Clip,0,3,17,51,2,15,2,68,0
"Mayor of Baltimore indicted on theft, perjury",0,1,2,36,1,6,0,38,0
Super Rare Frog Seen for the First Time in More Than 50 Years,0,3,9,38,0,12,2,47,0
The Charm and Silliness of Round 1,0,1,4,23,0,6,1,27,0
"Truly Nolen, Pest-Control Magnate, Deployed His Odd Name and Funny Cars ",0,3,11,47,3,11,0,58,0
US Department of Housing and Urban Development to provide housing for Katrina refugees,0,1,7,67,0,12,0,74,0
The world's tallest solar tower is being built in Israel,0,3,2,44,1,9,0,46,0
Senate Committee hears bailout proposal,0,1,2,33,0,4,0,35,0
Canadian singer Justin Bieber to publish memoir,0,1,3,38,0,6,0,41,0
Romanian parliament ratifies EU accession treaty,0,1,3,40,0,5,0,43,0
Former Australian PM attacks parliament on apology to the Stolen Generations,0,1,6,60,0,10,0,66,0
Donald Trump must now work with those he rose to power railing against,0,2,2,56,0,12,0,58,0
Kidnappers Threaten to Kill U.N. Official Abducted in Pakistan,0,1,8,44,2,8,0,52,0
What Trump’s Done—or Undone—for Business in 100 Days,0,2,6,33,3,7,3,39,0
Donald Trump has a handy scapegoat when economic clouds appear,0,3,2,51,0,9,0,53,0
Gina Rodriguez Reminds Us Fierceness Has Nothing To Do With Size,0,3,11,43,0,10,0,54,0
Griffin and Oklahoma Overpower Michigan,0,1,4,31,0,4,0,35,0
Extent of Tennessee wildfire damage revealed; at least 13 killed ,0,3,2,50,1,10,2,52,0
Farmers block main road in South Italy,0,1,3,29,0,6,0,32,0
Grand Theft Auto under fire,0,1,3,20,0,4,0,23,0
Economist: Stock Market Gained $2T in Wealth Since Trump Elected  Insider,0,3,10,49,2,11,1,59,0
"This heartbreaking video tells the story of two child refugees, 80 years apart",0,3,1,62,1,12,2,63,0
Brexit: 1m EU citizens in Britain 'could be at risk of deportation',0,3,4,48,3,11,1,52,0
Melania Trump hires White House social secretary,0,2,4,38,0,6,0,42,0
All the looks from the 2017 Grammys red carpet,0,3,2,32,0,8,4,34,0
"Four injured after three earthquakes strike Sumatra, Indonesia",0,1,3,51,1,7,0,54,0
NBA Tim Duncan Gets Huge Back Tattoo with Machine Design,0,2,11,36,0,9,0,47,0
Teenager arrested after hijacking Japanese bus,0,1,2,39,0,5,0,41,0
"Pentagon: Out with 'ISIL,' in with 'ISIS' ",0,2,10,19,6,7,0,29,0
Man died 36 hours after marrying the love of his life in the hospital,0,3,1,53,0,13,2,54,0
Airports Boost Security After Fort Lauderdale Shooting ,0,3,7,41,0,7,0,48,0
ADPVoice: Does Unlimited Vacation Time Really Work? And For Whom?,0,3,13,40,3,9,0,53,0
V.M.I. Revived by a High-Octane Offense,0,1,7,23,4,5,0,30,0
Serena Williams reveals she is 20-weeks pregnant ,0,3,2,37,1,7,2,39,0
Hate Speech Is On the Rise Following U.S. Presidential Election,0,3,10,42,2,9,0,52,0
Delta passenger kicked off flight after bathroom emergency - Yahoo,0,3,2,54,1,9,0,56,0
"Q-Tip, Talib Kweli, El-P And More React To George Michael's Death",0,2,13,37,5,10,0,50,0
'Tinder for Christmas' social media service helping holiday 'orphans' make connections,0,3,2,70,4,10,0,72,0
"Be kind, rewind: Blockbuster stores kept open in Alaska",0,2,3,42,2,8,0,45,0
Bolivian President-Elect takes 50% pay cut to aid social programs,0,1,3,49,2,9,2,52,0
Justin Trudeau Brought Ivanka Trump to a Broadway Musical About Helping Foreigners,0,2,10,61,0,11,0,71,0
Stan Lee turns 94: His 25 best cameos in Marvel films,0,3,4,34,1,10,4,38,0
LAPD Sees Drop in Latino Reports of Crime Amid Deportation Fears,0,2,12,42,0,10,0,54,0
NASA unveils plans for moon base,0,1,4,23,0,5,0,27,0
Ranking the Top 4 NBA Draft Prospects in the Final Four,0,3,9,35,0,10,1,44,0
Bank of America to Retain Merrill Lynch Name,0,1,6,31,0,7,0,37,0
Green Party refines 'Buy Kiwi Made' scheme,0,1,5,29,2,6,0,34,0
At least 85 dead in shooting at Norwegian youth camp,0,1,2,39,0,9,2,41,0
Earnings Worries Push Markets Lower,0,1,5,26,0,4,0,31,0
Former US Congressman Tom DeLay sentenced to three years in prison,0,1,7,49,0,10,0,56,0
Here’s How Trump’s White House Shut Down National Parks’ Twitter,0,2,10,42,3,9,0,52,0
"Take a look at the making of the hit scam email prank show, 'Scamalot'",0,2,2,52,3,13,0,54,0
Singer Joy Villa Wears ‘Make America Great Again’ Dress at 2017 Grammy Awards,0,3,11,48,2,12,4,59,0
Trump administration says Iran complying with nuclear deal ,0,2,2,49,0,8,0,51,0
Jazz Reportedly Interested in Re-Acquiring Deron Williams from Mavericks,0,3,8,55,1,8,0,63,0
Trump administration says it will keep LGBTQ protections,0,3,6,43,0,7,0,49,0
Dieses Video ist nicht verfügbar. This dog is the best mum ever,0,3,3,48,1,11,0,51,0
"Virginia Commonwealth, Now Well Known, Gains an N.C.A.A. Berth",0,1,11,37,6,8,0,48,0
Family pays tribute to killed Derbyshire woman,0,2,2,38,0,6,0,40,0
Supreme Court Rejects Challenge to Lethal Injection,0,3,6,39,0,6,0,45,0
Warriors Become Fastest Team in NBA History to Clinch Playoff Berth,0,3,11,46,0,10,0,57,0
Former I.M.F. Chief Sees Opportunity in Crisis,0,1,8,29,3,6,0,37,0
Media outlets report bogus news after tweet about Trump,0,2,2,45,0,8,0,47,0
Bryson Tiller on 2017 Grammy Nomination: 'It Was a Shocker',0,2,7,36,3,9,4,43,0
Wikipedia suffers outage,0,1,1,21,0,2,0,22,0
Journalists deported from Fiji,0,1,2,25,0,3,0,27,0
Soviet statue returns to Moscow,0,1,2,25,0,4,0,27,0
"Murdered ex-lawmaker knew 'misdeeds of Russian elites,' Kremlin critic says ",0,3,3,59,4,10,0,62,0
"Future schools: core subjects only, parents pay for the rest",0,3,1,48,2,9,0,49,0
Carmelo Anthony Trade Rumors: Celtics Not Interested in Deal for Knicks Star,0,3,10,54,1,11,0,64,0
Rainbow Food Is Literally Garbage,0,3,5,24,0,4,0,29,0
"Martin McGuinness, former Northern Ireland Deputy First Minister, dies aged 66",0,3,8,56,2,10,2,64,0
"Tales from the Coast with Robson Green review: seals, eels and no bare bums",0,3,4,56,2,13,0,60,0
Judge Orders Release of Some Documents Related to Clinton Email Inquiry - The New York Times,0,2,13,63,1,15,0,76,0
Yemeni Bodega Owners Say They’re Shutting Down To Take A Stand,0,2,11,40,1,10,0,51,0
Man who tried to take his own life given 'miracle' face transplant,0,3,1,52,2,11,0,53,0
Trump relaxes US policy on Middle East two-state solution,0,3,5,43,1,8,0,48,0
Injuries Force Meissner and Hughes to Pull Out of Nationals,0,1,7,43,0,9,0,50,0
"Kobe Bryant Performs Slam Poetry About Steve Urkel, Sings 'Moana' Song on 'Fallon'",0,2,12,53,5,12,0,65,0
Guardrail Maker Trinity to Pay $663M for Not Revealing Design Change,0,2,9,45,1,10,3,54,0
"Sydney, protesters reach agreement with police",0,1,1,39,1,5,0,40,0
Student Loan Debt In 2017: A $1.3 Trillion Crisis,0,3,7,25,3,8,6,32,0
Rise of women over the age of 65 getting married to avoid spending a long retirement alone,0,2,1,71,0,16,2,72,0
Coming Soon To A Tortilla Near You: A Vitamin To Prevent Birth Defects,0,2,13,44,1,12,0,57,0
Iranian opposition group leader says Iran regime 'cannot be trusted'  ,0,2,2,55,2,11,0,57,0
Sisters Reunite With Long-Lost Mother After 4 Decades: 'Miracles Do Happen' - Yahoo,0,3,12,53,5,12,1,65,0
"New movies, 9 September 2005",0,1,2,16,1,4,5,18,0
Ronda Rousey Loses Again; What Now? ,0,3,6,22,2,6,0,28,0
"Despite Torture Video, U.S. and Emirates Sign Key Pact",0,1,9,34,3,8,0,43,0
Scientists Discover Scores of Weird Species in Philippine Waters,0,3,7,49,0,8,0,56,0
"Pittsburgh Issues Boil Order for Water Affecting 100,000 People ",0,3,7,41,1,9,6,48,0
Woman Wearing Anti-Trump Sign Barred From Lincoln Center's David Geffen Hall,0,2,12,52,2,10,0,64,0
$20 million prize offered in lunar rover contest,0,1,0,38,1,7,2,38,0
This 14-Year-Old Latina Is Leading Her Team To The World Robotics Championship,0,3,13,50,2,11,2,63,0
"Dude builds the epic Lego train set of your dreams, puts a camera on it",0,3,2,54,1,14,0,56,0
Trump Administration Launches National-Security Probe on Steel Imports,0,3,8,54,1,7,0,62,0
Family has an extremely close encounter with a bear and her cubs,0,3,1,52,0,11,0,53,0
Bomb explodes on busy Beirut street,0,1,2,28,0,5,0,30,0
A top hedge fund manager who said he generated $7 billion in revenue is prepping his own fund launch,0,3,1,79,1,18,1,80,0
Man convicted of ex-wife’s death 25 years ago gets new trial,0,2,1,45,2,10,2,46,0
Rod Stewart Thought It Was A Good Idea To Stage A Mock Beheading In Abu Dhabi Desert,0,2,17,51,0,16,0,68,0
Congressman Ted Lieu Trolls Donald Trump With 'Bigly' Crowd: 'They Don't Like You',0,3,13,51,6,12,0,64,0
"State Cuts Delay U.S. Benefits, Official Says",0,1,8,28,3,6,0,36,0
Quorn recalls frozen meat free mince over fears it may contain metal pieces,0,3,1,62,0,12,0,63,0
Bodies Bending Sound in the Guggenheim - Video - NYTimes.com,0,3,8,40,3,9,0,48,0
BBC newsreader sacked after conviction for wounding teenager,0,1,3,50,0,7,0,53,0
Man busted stealing Scotch from airport bar,0,2,2,35,0,6,0,37,0
Bishop Who Denied Holocaust Ousted,0,1,5,25,0,4,0,30,0
"Lego Worlds review – filled with potential, but also confusion",0,3,2,49,2,9,0,51,0
Guatemalan news reporter killed by Pacaya volcano,0,1,2,41,0,6,0,43,0
Kendall Jenner's Pepsi ad sparks social media outcry ,0,3,3,41,1,8,0,44,0
Twentieth anniversary of the Tiananmen Square protests passes in China,0,1,4,57,0,9,0,61,0
"Champs-Elysees shooting: 1 police officer killed, another injured in Paris attack ",0,3,3,64,3,11,1,67,0
NFL Schedule 2017: Biggest Highlights of This Year's Schedule,0,3,9,38,2,8,4,47,0
Syrian war: We can't say we didn't know,0,3,2,27,3,7,0,29,0
Hindus celebrate festival of colour,0,3,1,30,0,4,0,31,0
"In Flynn’s wake, top Democrats want wider probe into Russian meddling ",0,3,4,53,2,11,0,57,0
2008 TaiSPO & Taipei Cycle: A reunion with more opportunities,0,1,7,39,2,9,4,46,0
Poll: 55 Percent Concerned About Russia's Interference in Election,0,3,7,47,2,8,2,54,0
More Californians dreaming of a country without Trump: poll,0,2,3,47,1,8,0,50,0
George Michael: world mourns pop star and gay rights champion – tributes and reactions,0,3,2,69,2,13,0,71,0
Dell would be 'happy' to sell PCs running Mac OS X,0,1,7,31,2,10,0,38,0
U.S. superbug expected to emerge in Canada,0,1,3,31,2,6,0,34,0
Trump Backers Like His First Draft of a New America ,0,3,8,34,0,10,0,42,0
Ohio fetal heartbeat abortion bill heads to governor's desk ,0,2,1,49,1,9,0,50,0
Early Week California Prison Riot Leaves Four Prisoners Injured,0,3,9,46,0,8,0,55,0
Confirmed bird flu death in Nigeria,0,1,2,28,0,5,0,30,0
North Korea vows to respond to US Navy's 'reckless' show of force,0,3,5,46,3,11,0,51,0
Cavaliers Give Cleveland a Shot at Reversing Roles,0,1,6,37,0,7,0,43,0
"Media organisations including BBC, New York Times challenge 'unprecedented' White House briefing ban",0,3,9,76,3,12,0,85,0
'I know he is alive': wife of Taiwan activist seized by China pleads for release,0,3,3,60,3,14,0,63,0
"With the Economy Stalled, Could Oil Go Lower?",0,1,7,29,2,7,0,36,0
US to deliver humanitarian aid to Georgia,0,1,3,32,0,6,0,35,0
Trump just nominated a top Boeing executive to be Mattisâ second-in-command,0,2,3,60,4,10,0,63,0
IAEA: North Korea to begin shutting down nuclear reactor next week,0,1,6,49,1,10,0,55,0
Kansas Shrugs Off Dayton to Reach Round of 16,0,1,6,29,0,8,2,35,0
"How a bunny, baskets and eggs got connected with Easter - Yahoo",0,2,3,47,2,11,0,50,0
’We need to clean this up’: Clinton aide cried foul on Obama’s email denial,0,2,3,55,4,13,0,58,0
"‘Governors Are The Front Line’ Against Donald Trump, Connecticut Governor Says",0,3,11,54,3,10,0,65,0
"Ohio police officer admits to fabricating shooting story to cover up suicide attempt, cops say ",0,3,1,78,1,15,0,79,0
@OutFrontCNN,0,3,5,6,1,0,0,11,0
The First Single From the Faith-and-Biggie Duets Album is Here,0,3,9,42,2,9,0,51,0
A Rising but Doubted Dream on a Reservation,0,1,5,31,0,7,0,36,0
"EU behaving 'like the mafia' over Brexit, says Nigel Farage – video",0,3,5,47,4,11,0,52,0
"Treasuries Fall, Stocks Mixed as Commodities Gain: Markets Wrap",0,3,8,45,2,8,0,53,0
"Watch Kate McKinnon's re-enact ""Fatal Attraction"" as Kellyanne Conway on 'SNL'",0,3,11,51,6,10,0,62,0
Trump’s Big Bomb,0,3,3,10,1,2,0,13,0
Twitter Absolutely Roasted James Harden's Metallic All-Star Outfit,0,3,9,48,2,7,0,57,0
Treasury reveals cost of carbon tax on Australian families,0,1,2,48,0,8,0,50,0
"Louisville Pitcher Josh Rogers Catches Line Drive, Hits the Shimmy",0,2,9,47,1,9,0,56,0
Tensions and tunnels in an ever-changing border,0,3,1,39,1,6,0,40,0
Dr. Luke Wants to Subpoena Kesha Fan Who Organized #FreeKesha Protests,0,2,11,47,2,10,0,58,0
Amazing New Font Shows What It's Like to Have Dyslexia,0,3,9,35,1,9,0,44,0
Crashed WW2 Spitfire flies again after £3m refit,0,2,4,34,1,7,2,38,0
Poll analysis: Theresa May’s extended honeymoon as Prime Minister is officially over,0,2,5,66,2,11,0,71,0
Government planning possible take-over of Southern rail – report,0,2,2,52,2,8,0,54,0
Iceland nationalises Kaupthing Bank,0,1,3,29,0,3,0,32,0
"US jobless claims lower than forecast, futures rise",0,1,2,41,1,7,0,43,0
'Nervous' Patti Smith forgets Bob Dylan lyrics,0,3,5,33,2,6,0,38,0
Hate Groups In The U.S. Are Flourishing [Infographic],0,3,9,33,4,7,0,42,0
"Emma Watson Was Basically Hermione IRL On The ""Harry Potter"" Set",0,2,13,39,2,10,0,52,0
The Golden State Almost-Warriors ,0,3,5,23,1,4,0,28,0
Will North Carolina Gov. Pat McCrory Concede This Week?,0,2,10,35,2,8,0,45,0
Regazzoni dies in road accident,0,1,1,26,0,4,0,27,0
Mystery of the spike in deaths between Christmas and New Year’s gets curiouser and curiouser,0,2,4,73,1,14,0,77,0
Defeating cancer was once a ‘war’; now it’s a ‘moonshot’,0,3,1,40,6,9,0,41,0
Texas man sentenced to 15 years for assaulting pregnant girlfriend,0,2,1,54,0,9,2,55,0
Trump's America Donald Trump: How do Americans rate the President 100 days in?,0,3,7,53,3,12,3,60,0
Schaeuble's 'Wrong Message' Barb on Greece Causes Spat in Berlin,0,3,8,44,3,9,0,52,0
"New Day Say They'd Never Leave WWE to Fight in UFC, Comment on Conor McGregor",0,2,17,44,2,14,0,61,0
Joe Root demands more England fire in second ODI against New Zealand,0,2,8,49,0,11,0,57,0
"Dems have enough votes to filibuster Gorsuch, increasing odds of 'nuclear option' ",0,3,2,65,3,12,0,67,0
30 Under 30 2017: Consumer Tech,0,3,3,14,1,5,8,17,0
This $5 Million Desert Mansion Comes With Built-In Art,0,2,9,34,2,8,1,43,0
Spaghetti donuts are the latest frankenfood obsession,0,3,1,46,0,6,0,47,0
Hong Kong Stocks Climb to One-Month High Amid Mainland Inflows,0,3,10,42,1,9,0,52,0
Kellyanne Conway Explains Spying Microwave Claim by Confirming She's 'Not Inspector Gadget',0,2,11,66,3,11,0,77,0
U.S.-Backed ‘Moderate’ Syrian Rebels: Beheading Boy Was a ’Mistake’,0,2,10,41,8,8,0,51,0
"'The risk is very, very high, and we need to pay very close attention to what’s happening in Europe'",0,3,2,75,5,18,0,77,0
Lady Bird Johnson buried today,0,1,3,23,0,4,0,26,0
CafÃ© Tacvba Premieres New Psychedelic Track 'Disolviendonos': Listen,0,3,9,49,4,7,0,58,0
Chilling Reports Indicate Record-Breaking Temperature Highs Have Hit Cities Across the Northeast,0,3,12,72,1,11,0,84,0
Watch Shawn Mendes & Camila Cabello Crush a Cover of Ed Sheeran's 'Kiss Me',0,3,11,47,4,13,0,58,0
"Russia says Trump intel claims a ""fabrication and utter nonsense""",0,3,2,52,2,9,0,54,0
"Indonesia: J.P. Morgan Was Tasked to Find Buyers, But Instead Said ‘Sell’",0,3,12,44,6,11,0,56,0
"Church massacre, other killings strain forgiveness for many ",0,2,1,50,1,8,0,51,0
Flickr launches video-sharing service,0,1,1,32,1,3,0,33,0
Oklahoma home invasion shooting: 3 victims broke into property earlier that day ,0,3,1,65,1,12,1,66,0
A History of Chuck Berry's Biggest Billboard Hits,0,3,7,34,1,7,0,41,0
Man who tried to take his own life given 'miracle' face transplant,0,2,1,52,2,11,0,53,0
"At least twelve killed after building collapses in Alexandria, Egypt",0,1,3,55,1,9,0,58,0
Sri Lankan Forces Takes Control of Coast,0,1,6,28,0,6,0,34,0
Steelers Owner Dan Rooney Turns His Business Into a Family,0,1,9,40,0,9,0,49,0
Joy Villa: 'I Lost Friends' After Wearing Pro-Trump Gown to Grammys  Insider,0,2,12,48,4,12,0,60,0
England v New Zealand: Morgan hails 'close to perfect' display,0,2,4,46,3,9,0,50,0
From Syria with Love - the 'Putin-funded propaganda calendar' showing 'Syrian girls eulogising Russian forces',0,2,6,84,6,14,0,90,0
"163 new species, including 'Klingon Newt', discovered ",0,2,2,38,4,7,3,40,0
U.S. Rejects Afghan Tally for Much Lower Civilian Death Toll,0,1,10,39,2,9,0,49,0
"Hot on the Trail of ‘La La Land,’ Here Come More Movie Musicals ",0,2,10,38,3,13,0,48,0
Nicola Sturgeon calls for second Scottish independence referendum - Politics live,0,3,4,66,1,10,0,70,0
Trump adviser’s son loses transition team job for spreading fake news,0,3,1,57,1,10,0,58,0
Journalist accuses Algerian footballer of assault after World Cup exit,0,1,4,57,0,9,0,61,0
"Zuckerberg Talks About ‘Global Community’, Cites PM Modi’s Example In His Latest Facebook Post",0,3,15,62,4,13,0,77,0
Look At These Beautiful And Haunting Photos Of African Wildlife,0,2,10,44,0,9,0,54,0
"Honda, Governments Unveil C$492 Million in Canada Plant Upgrades",0,3,8,43,2,8,3,51,0
Mandarin Gets One Shining Moment in a First-Round N.C.A.A. Game ,0,3,12,37,5,10,0,49,0
Pelosi to Democrats: Treat Trump voters like a friend whose boyfriend is a jerk,0,3,4,61,1,13,0,65,0
"Stan Grant on the search for Frank Foster, the missing part of his family tree",0,2,4,59,1,14,0,63,0
Indian Olympian Krishna Poonia Chases Down Bikers And Saves Two Girls From Being Harassed,0,3,14,62,0,13,0,76,0
2 Held Hostage in Ongoing Situation at Delaware Prison ,0,3,6,39,0,9,1,45,0
"The trick to persuading Trump? Flattery, proximity and snappy pitches",0,3,3,55,2,9,0,58,0
Israeli President Shimon Peres collapses in Tel Aviv,0,1,6,39,0,7,0,45,0
Norwegian politicians face voter suppression allegations,0,1,1,50,0,5,0,51,0
Stockholm attack suspect was failed asylum-seeker; 2nd man arrested ,0,3,1,55,2,9,1,56,0
Why Centrelink should adopt a light touch when data matching,0,3,2,49,0,9,0,51,0
"British Columbia could get an earthquake, survey warns",0,1,2,44,1,7,0,46,0
Quebec ‘Terrorist Attack’: College Student Alexandre Bissonnette Charged,0,3,8,54,3,7,0,62,0
British PM Theresa May calls for early election to strengthen Brexit hand,0,3,6,56,0,11,0,62,0
Shell Signs Preliminary Iran Oil Deal Despite Uncertainty Over Trump       ,0,3,10,49,0,16,0,59,0
Byron Wien Sees Stock Rally After Last Year’s Calls Fizzled,0,3,10,39,1,9,0,49,0
"This company secretly runs the internet, and now it’s raised another $8 million to rule everything else, too",0,2,1,85,4,17,1,86,0
Graham Rahal Prepares for His Second Indy 500,0,1,6,29,0,7,3,35,0
Azaria Chamberlain: Newly released NT Cabinet documents detail decision to review convictions,0,2,6,75,1,11,0,81,0
More troops for southern Thailand troubles,0,1,2,35,0,5,0,37,0
People Are Freaking Out Over Patrick Stewart In Drag Compared To Kellyanne Conway,0,3,13,56,0,12,0,69,0
Britney Spears announces she is pregnant,0,1,2,33,0,5,0,35,0
Saudi blogger's flogging reportedly delayed amid international outcry ,0,2,1,60,1,8,0,61,0
Oil Producers Promised Output Cuts. Here’s the Reality.,0,3,7,38,3,7,0,45,0
PetSmart to Acquire Online Pet Store Chewy in E-Commerce Push,0,3,10,41,1,9,0,51,0
This Girl Captured The Exact Moment A Seagull Stole Her Ice Cream And It's Intense,0,3,15,52,1,14,0,67,0
Former Mexican governor who has been on the run from police for months is arrested in Guatemala,0,3,3,76,0,16,0,79,0
Social Security Checks Are Being Reduced for Unpaid Student Debt,0,2,9,46,0,9,0,55,0
Detroit Tigers to Offer Pizza-Hot Dog Combo at Home Games,0,3,9,38,1,9,0,47,0
McEnroe Wants Academy to Revive Tennis in New York,0,1,8,34,0,8,0,42,0
Army Vet Hassled at Chili’s Restaurant Is Forced from Home After Media Reveals Address - Breitbart,0,2,13,68,2,15,0,81,0
Republicans Catch Up In Georgia Special Election Early Voting,0,3,9,44,0,8,0,53,0
CPAC’s Organizer Explains Why He Invited (and Disinvited) Milo Yiannopoulos,0,3,12,51,3,9,0,63,0
"Syria Discloses Missile Facility, Europeans Say",0,1,6,35,1,5,0,41,0
Suicide Bomber Kills 13 at Protest in Pakistan ,0,2,5,32,0,8,2,37,0
BlackBerry spending $75 million on autos hub over several years,0,2,2,49,1,9,2,51,0
Head of China's People's Choice Awards Trashes Matt Damon's 'The Great Wall',0,2,11,49,5,11,0,60,0
Three football World Cup journalists robbed at gunpoint in South Africa,0,1,5,56,0,10,0,61,0
Lawyer Defends Conspiracy Theorist Alex Jones: 'He's Playing a Character' on Air  Insider,0,3,11,61,4,13,0,72,0
Teen girl's burned body found at Vegas apartment complex ,0,2,2,45,1,9,0,47,0
Space Shuttle Discovery resumes rollout to launch pad,0,1,3,43,0,7,0,46,0
Camel sacrificed at major Turkish airport,0,1,2,34,0,5,0,36,0
Your Vegetable Opinions Will Determine How High Or Low Maintenance You Are,0,3,12,51,0,11,0,63,0
"The Batcave, a Graffiti Landmark in Brooklyn, Grows Up - The New York Times",0,2,11,48,3,13,0,59,0
Conservative provocateur James O'Keefe says he plans to leak 'hundreds of hours of tape' in CNN exposÃ©,0,2,8,75,4,16,0,83,0
Judge rules to keep Virginia man in jail until trial on aiding terror charge ,0,3,2,61,0,14,0,63,0
"Freedom Tower renamed ""1 World Trade Center""",0,1,5,30,2,6,1,35,0
Studying at Aleppo University: 'You get used to seeing blood on the floor',0,3,4,55,3,12,0,59,0
NCAA tournament 2017 preview: South regional,0,2,5,29,1,5,4,34,0
Seahawks teammates: Don't take Earl Thomas' retirement talk too seriously,0,3,4,57,3,9,0,61,0
"GOLDMAN SACHS: This should be a good year for stock-pickers, and it's great news for us",0,3,13,55,4,15,0,68,0
Nicki Minaj Takes Over For Jennifer Lopez at Miami New Year's Eve Gig,0,3,12,44,1,12,0,56,0
London bombing: Police search houses in Leeds,0,1,3,35,1,6,0,38,0
Tesla Has Its Best Quarterly Production And Deliveries. Can It Quintuple Them?,0,3,12,53,2,11,0,65,0
Federal judge in Hawaii halts Trump travel ban ,0,3,3,36,0,8,0,39,0
"Leave It To Tyler, The Creator And Bill Nye To Make Science Literally Sound Cool",0,3,15,50,1,14,0,65,0
Journalist Gebran Tueni murdered,0,1,3,26,0,3,0,29,0
World Chess Has a Big Problem,0,3,5,19,0,5,0,24,0
India conducts fourth test launch of Agni-V missile,0,2,3,40,1,7,0,43,0
13th Juror: Words of wisdom for all the angry young men,0,2,2,40,1,10,2,42,0
"Learn from human rights fallout at European Games, Uefa and F1 told",0,3,5,49,1,11,1,54,0
UCLA Cheerleader Takes 2 Scary Falls During a Single Timeout,0,3,11,39,0,9,1,50,0
J&K’s Extreme Weather Deadlier Than Enemy For Indian Soldiers,0,3,10,41,2,8,0,51,0
"Rob Gronkowski Guzzles Water as Young Students Chant 'Chug It,' Ends with Spike",0,3,11,53,3,12,0,64,0
"US, UK persuade Russia and China of laptop authenticity",0,1,6,40,1,8,0,46,0
India plans to give 88 million cows 'identity cards' which can be tracked online ,0,2,1,62,2,14,2,63,0
Tottenham Hotspur v Bournemouth: Premier League – live!,0,3,5,40,3,7,0,45,0
Workers Protest Across France,0,1,4,22,0,3,0,26,0
Silicon Valley: Twitter CEO Dick Costolo had it tough,0,2,8,36,1,8,0,44,0
'This Is Us' Writers To Take A Stab At Second 'How I Met Your Mother' Spinoff,0,2,16,42,4,15,0,58,0
US Senate meets in private session,0,1,3,26,0,5,0,29,0
Even Well-off Consumers Aim to be Less Conspicuous,0,1,6,36,1,7,0,42,0
Green Energy Features Big Among Trump's Top 50 Infrastructure Projects,0,3,9,49,1,9,2,58,0
Wisconsin man dies after snowmobile goes through ice,0,3,1,44,0,7,0,45,0
Anti-dowry summit sparks call for Australian law against ancient tradition,0,3,2,62,1,9,0,64,0
Wikinews interviews Dr Thomas Scotto and Dr Steve Hewitt about potential US military intervention in Syria,0,1,10,81,0,15,0,91,0
Police search for man who took selfie at the wheel - after he's caught out by reflection in sunglasses,0,3,1,81,2,18,0,82,0
Music Producer Draws Term of 19 Years to Life for Killing,0,1,7,38,0,10,2,45,0
"1,600 Flights Across Midwest Canceled as Winter Blast Rolls East",0,3,8,42,1,9,4,50,0
'Crazy Ex-Girlfriend' Star Rachel Bloom Breaks Down Four Standout Songs From New Season 2 Soundtrack,0,2,15,67,3,14,1,82,0
6 new Frapp flavors at Starbucks,0,3,2,24,0,5,1,26,0
The American Health Care Act is a good start,0,3,5,31,0,8,0,36,0
Meet Forrest - the five-legged lamb,0,3,2,26,2,5,0,28,0
Robert De Niro on Trump and inauguration boycotts: 'Everybody has to be on guard',0,3,5,60,3,13,0,65,0
Libyan Jet Hijackers Surrender After Releasing Passengers and Crew ,0,3,8,50,0,9,0,58,0
Britain's Antarctic research centre to be towed inland away from expanding ice chasm,0,3,2,69,1,12,0,71,0
Martin Shkreli Price-Hike Drug Reproduced by Schoolkids,0,3,7,41,1,6,0,48,0
Mexico ready to retaliate by hurting American corn farmers,0,3,2,48,0,8,0,50,0
The Bangladeshi Traffic Jam That Never Ends - The New York Times,0,2,11,41,1,11,0,52,0
Riots in Greece enter fourth night,0,1,2,27,0,5,0,29,0
A Binary Bet on the Bitcoin Twins,0,2,5,22,0,6,0,27,0
Rhode Island man gets prison time for fatally beating neighbor's small dog with cane,0,2,2,68,1,13,0,70,0
Google’s future depends on Trump’s FTC pick,0,2,5,30,2,6,0,35,0
The Koch brothers and the Republican Party go to war — with each other,0,3,4,52,1,13,0,56,0
Twitter strikes comedy gold with stream of jokes over Trump report,0,3,2,54,0,10,0,56,0
Emmys 2015: John Stamos and Uzo Aduba to Announce This Year's Nominations,0,3,9,47,2,11,4,56,0
Vanderbilt's Matthew Fisher-Davis takes blame for late foul -- with lead,0,3,4,54,4,10,0,58,0
Sesame Street to promote healthy lifestyles,0,1,2,36,0,5,0,38,0
Justin Trudeau takes aim at Matthew Perry and the best of the rest on April Fools' Day,0,2,7,62,1,16,0,69,0
RNC on FBI Re-Opening Clinton Investigation: ’Should Be Disqualifying’ - Breitbart,0,2,14,53,5,10,0,67,0
Clare Balding: The Queen gave us a Shetland pony when I was born and it became part of the family,0,2,6,71,1,19,0,77,0
Palestinians Stop Paying Israeli Hospitals for Gaza and West Bank Patients,0,1,9,55,0,10,0,64,0
Why It May Be Hard to Convict an Officer in Cases of Police-Involved Deaths ,0,3,11,50,1,14,0,61,0
Sci-fi and fantasy author Andre Norton dies,0,1,3,33,1,6,0,36,0
It’s 1980s All Over Again for FX Desks Looking at Trade Flow,0,3,10,34,1,11,4,44,0
Palestinian radio station broadcasts praise for London terror attacks,0,1,2,59,0,8,0,61,0
John M. Spratt Jr.,0,1,4,9,2,3,0,13,0
Theresa May visited a school in Copeland today and it really didn't go well The list,0,3,4,64,1,15,0,68,0
China’s Upset Soccer Win Over South Korea Averts Fan Unrest,0,3,10,39,1,9,0,49,0
World Anti-Doping Agency report details scope of massive Russian scheme,0,2,5,56,1,9,0,61,0
Bowe Bergdahl appeals to Obama for pardon,0,3,3,32,0,6,0,35,0
"Somali pirates attack US-flagged ship, vessel evades capture",0,1,3,48,2,7,0,51,0
French workers get 'right to disconnect' from emails out of hours,0,3,1,52,2,10,0,53,0
Clemson Beats Alabama 35-31 with Last-Second Touchdown,0,3,6,36,2,6,4,42,0
Hometown Kid PJ Dozier Is Guiding South Carolina's Cinderella Run,0,2,11,44,1,9,0,55,0
Hip-Hop Legend DMC On Why Innovation Is Key For Success,0,3,13,32,1,9,0,45,0
Cowboys CB Anthony Brown Gets Tattoo of Potato Chip on Shoulder,0,3,10,43,0,10,0,53,0
Jahlil Okafor Reportedly a Trade Target for Indiana Pacers Before 2017 Deadline,0,2,9,55,0,11,4,64,0
Golden State Warriors Charter Plane to Fly Employees to NBA Finals Game 3,0,3,12,48,0,12,1,60,0
U.S.: Only half of Baiji in Iraqi hands,0,3,5,24,3,7,0,29,0
#LifeAtComplex: Are You Ready for Shoot Your Shot SZN?,0,3,12,31,3,8,0,43,0
"Spring bloom is coming early, and not just for D.C.’s cherry blossoms",0,3,3,51,4,11,0,54,0
America’s Rich Get Richer and the Poor Get Replaced by Robots,0,3,8,42,1,10,0,50,0
'BBC dad' announces CNN interview with the perfect dad joke,0,3,6,42,2,9,0,48,0
Harry Potter and the Half-Blood Prince released,0,1,5,35,1,6,0,40,0
Retaliation for Russian Election Hack Could Be Announced Soon ,0,3,8,45,0,9,0,53,0
Russian Ambassador to Turkey Is Assassinated in Ankara ,0,3,6,41,0,8,0,47,0
NASA Optimistic That Debris Did Not Damage Shuttle,0,1,11,32,0,7,0,43,0
History of Vinsanity,0,3,2,16,0,2,0,18,0
Iraqi Policeman killed while protecting leader of 'Sons of Iraq',0,1,4,49,2,9,0,53,0
Vatican Calls the Apology of a Bishop Insufficient,0,1,5,38,0,7,0,43,0
"Pair of threats close parts of White House, Congress hearing",0,3,4,46,1,9,0,50,0
Abel prize 2008 awarded to John G. Thompson and Jacques Tits,0,1,6,39,1,10,4,45,0
Aurora Borealis caused by electrical space tornadoes,0,1,2,44,0,6,0,46,0
Mariah Carey Talking About All The Pop Stars She Does And Doesn’t Know Is Iconic,0,3,15,50,1,14,0,65,0
More than 80 false killer whales die in largest stranding in Florida history,0,3,2,60,0,12,2,62,0
Saudi Arabia calls an end to tax-free living as oil slump continues to bite,0,2,2,59,1,13,0,61,0
Colombian air traffic controller: 'I did what was humanly possible',0,2,2,53,3,9,0,55,0
Abu Dhabi Said to Meet Asia Fixed-Income Investors This Week,0,3,10,40,1,9,0,50,0
Oakland Seeking Answers in Police Killings,0,1,5,32,0,5,0,37,0
Bart Simpson used to promote Scientology,0,1,3,32,0,5,0,35,0
How Jukin Media Built a Viral-Video Empire ,0,2,7,28,1,7,0,35,0
NDIS debate: Pyne says Government has 'no intention' of increasing taxes to fund program,0,3,6,66,3,13,0,72,0
Gingrich: All 'Real Evidence' of Russian Influence Points to Democrats  Insider,0,3,9,56,3,11,0,65,0
"Skittles, I Hardly Knew Ye - Breitbart",0,2,6,24,2,6,0,30,0
Russia's ambassador to the UN has died,0,3,3,28,1,6,0,31,0
Get your tissues 'cos Steve Irwin's son is basically a mini-Steve on 'Tonight Show',0,3,6,59,5,13,0,65,0
New South Wales Premier criticised over government structure,0,1,4,49,0,7,0,53,0
People Are Sharing Beautiful Selfies To Celebrate The Bisexual Community On Twitter,0,3,12,60,0,11,0,72,0
Tennis Star Petra Kvitova Badly Injured in Home Invasion ,0,2,8,40,0,9,0,48,0
Mexican official: Cartels send $64B in drugs into US annually ,0,3,5,43,2,10,2,48,0
A family found a rattlesnake in their toilet — then 23 more,0,2,1,44,1,11,2,45,0
Non-verbal six-year-old boy and deaf dog learn to communicate using sign language,0,2,1,66,3,11,0,67,0
We May See The End Of An Era As Leander Paes Hints That He Could Give Up Tennis Pretty Soon,0,2,20,52,0,19,0,72,0
Al Qaeda in Kentucky: US May Have Let 'Dozens' of Terrorists Into Country as Refugees ,0,3,13,55,3,15,0,68,0
A Utah Congressman Faces the ’Resistance’ in his Home State,0,2,7,41,2,9,0,48,0
"After golf with Trump, Paul says 'very optimistic' about ObamaCare repeal ",0,3,5,55,3,11,0,60,0
Report says modernizing and repairing US bridges to cost $140 billion,0,1,3,52,1,10,3,55,0
Man gives jail a ‘pleasantly surprised’ TripAdvisor-style review,0,2,3,51,3,7,0,54,0
Clapper Denies Trump Wiretap as White House Demands a Probe,0,2,8,42,0,9,0,50,0
Maryland governor: No guarantees of children's safety amid rape case ,0,3,2,55,2,10,0,57,0
"!Sdrawkcab: Missy Elliott, the Beatles and the joy of backwards lyrics",0,2,4,53,3,10,0,57,0
Stephen Colbert Accuses Trump in a ‘Usual Suspects’ Parody ,0,2,7,41,2,9,0,48,0
Burning Questions for College Basketball's 2017 April Signing Period,0,2,7,48,1,8,4,55,0
Trudeau Braces for Trump Nafta Gambit With Oil-Patch Huddle,0,2,9,41,1,8,0,50,0
Appeals Court Shoots Down DOJ Request To Immediately Restore Travel Ban,0,2,13,48,0,10,0,61,0
‘Rise of China’: Beijing Unveils New Aircraft Carrier to Much Fanfare,0,3,9,47,3,10,0,56,0
The North Pole may possibly be ice free by summer,0,1,3,37,0,9,0,40,0
Meet The Inventors Who Turned Billions Of Phones Into Cameras,0,3,10,42,0,9,0,52,0
"House prices rise, affordability expected to worsen despite property slowdown later this year: CBA",0,3,4,79,2,13,0,83,0
German authorities detain man over possible links to Berlin Christmas market truck attack,0,2,3,74,0,12,0,77,0
TNT blamed for Chinese karaoke bar explosion that killed 25,0,1,4,44,0,9,2,48,0
"2008 COMPUTEX Taipei: Three awards, One target",0,1,11,23,2,6,4,34,0
Disturbing footage of circus animal abuse leads to widespread reform,0,3,1,58,0,9,0,59,0
"Gutfeld on Trump: 'Even When He's Losing, He Ends Up Winning'  Insider",0,3,11,42,5,12,0,53,0
These ancient Asian primate fossils might be the missing pieces of a major evolutionary puzzle,0,2,2,78,0,14,0,80,0
US and France to work together for new Iran sanctions,0,1,4,40,0,9,0,44,0
Robert Mugabe: Give Donald Trump a chance,0,2,5,29,1,6,0,34,0
UCLA Cheerleader Takes 2 Scary Falls During a Single Timeout,0,2,11,39,0,9,1,50,0
An Effort to Change Cosby ‘Optics’ as Trial Nears ,0,3,7,32,2,9,0,39,0
Russian jet flies close to Nato ships in the Baltic Sea in a show of military force,0,3,4,63,0,16,0,67,0
George Michael: Ladies and Gentlemen returns top 10 album charts,0,3,4,48,1,9,2,52,0
Obese fathers may harm their child’s ability to make friends ,0,3,1,49,1,10,0,50,0
"False dawn for Air France flight; debris not from crash, search continues",0,1,3,57,2,11,0,60,0
"US, UK And France Back India's Demand To Ban JeM Chief Masood Azhar In UNSC, China Backs Pak",0,3,24,48,3,17,0,72,0
"Muhammad Ali's Grandson, a Cal Recruit, Channeling 'The Greatest' with Football",0,2,9,55,5,10,0,64,0
"Trump Tops Obama, Bush and Clinton in Golfing and Private Getaways So Far ",0,3,10,50,1,13,0,60,0
Embraceable You: When the CEO Is a Hugger,0,3,8,25,1,7,0,33,0
22 Powerful Women You’ll Want Your Daughter To Look Up To,0,3,10,34,1,10,2,44,0
Greta Garbo’s Manhattan Apartment Goes on the Market,0,3,6,38,1,7,0,44,0
Police Find $1.2 Million Worth of Weed in Old Nuclear Bunker,0,2,8,38,2,10,2,46,0
Engine troubles delay Airbus superjumbo tour,0,1,2,37,0,5,0,39,0
Wikipedia Founder Jimmy Wales Launches Project to ‘Fix the News’,0,3,8,45,2,9,0,53,0
Man found sleeping in Melbourne living room holds knife to woman's throat,0,3,2,59,1,11,0,61,0
Muslim teen denied entry into US despite being a citizen,0,2,3,44,0,9,0,47,0
The Emerging Trump Doctrine: Don’t Follow Doctrine ,0,3,7,35,2,7,0,42,0
N. Korean Missile Reportedly in Place,0,1,5,26,1,5,0,31,0
Fears that Paris shooting will affect presidental election as first round looms,0,2,2,66,0,11,0,68,0
"Microsoft Monday: Surface Pro 4 Price Drop, Patent For Phone That Folds And Is Windows 7 Dangerous?",0,2,15,63,3,16,2,78,0
Cancer Patient Speaks Out on Samantha Bee's 'Inconsiderate' Mocking of His 'Nazi Hair'  Insider,0,3,12,64,5,14,0,76,0
Merged Inquiries Could Mean One Big Problem for U.S.C.,0,1,10,33,3,8,0,43,0
"Not a Candidate, Rafsanjani Tries to Defeat Ahmadinejad in Iran Race",0,1,8,49,1,10,0,57,0
"Green river water leaves these residents seeing red, feeling blue ",0,2,1,54,1,10,0,55,0
Tillerson and Kelly visit Mexico amid tension over deportation guidelines ,0,3,3,61,0,10,0,64,0
Easter Egg Nest Cake Recipe - NYT Cooking,0,3,9,24,1,7,0,33,0
"Mom Told to Stop Breastfeeding at Mall, Records Incident on Facebook",0,2,8,49,1,10,0,57,0
More Than 600 People Arrested by U.S. Immigration Officials in One Week,0,3,10,45,2,11,3,55,0
"Resolve To Work 20 Hours A Day Or Leave, UP CM Yogi Adityanath Tells Babus",0,2,16,41,1,14,2,57,0
Donald Trump Tweets Holiday Greetings ,0,3,5,28,0,5,0,33,0
China Says 21 More People Will Go to Prison in Tibet Protests,0,1,9,39,0,11,2,48,0
Mitt Romney is now top contender for secretary of state,0,2,2,44,0,9,0,46,0
Students Wear White Pins as Reminder to Check Their White Privilege,0,3,9,48,0,10,0,57,0
Valfrejus avalanche: One dead and two missing in France,0,2,3,43,1,8,0,46,0
Vernon Davis Will Guest Star on Episode of 'Whose Line Is It Anyway?',0,3,11,43,3,12,0,54,0
"Cat in Rhode Island, USA nursing home 'senses death'",0,1,6,35,3,8,0,41,0
Mike Pence's New Neighborhood Gets Plastered With 'Trust Women' Signs,0,2,10,47,3,9,0,57,0
Professional wrestler Chris Benoit and family found dead,0,1,3,46,0,7,0,49,0
North Carolina 'bathroom' law: Deal reached on repeal,0,3,3,40,3,7,0,43,0
Explosion kills 35 in Pakistan; many injured,0,1,2,33,1,6,2,35,0
Spain's Ibiza airport evacuated after bomb alert,0,1,2,39,1,6,0,41,0
From diving with sharks to sleeping with polar bears: The VERY exciting life of a globetrotting photographer,0,2,6,85,1,16,0,91,0
"A Community Arts Center Exhibit Was Vandalized With ""Make America Great Again""",0,2,12,53,2,11,0,65,0
"Putting his love to the test: Boyfriend, 20, caught dressing up as his 17-year-old girlfriend so he can take her exams ",0,2,2,87,5,21,4,89,0
Ignorance Does Not Lead to Election Bliss,0,2,6,29,0,6,0,35,0
How Atlanta's conservative suburbs became a frontier of liberal resistance – video,0,3,2,67,2,11,0,69,0
Manus police want more officers on island as tension over refugee deal mounts,0,3,1,64,0,12,0,65,0
'Immigrants are America': protesters mass at US airports – in pictures,0,2,4,52,4,10,0,56,0
Jailed American journalist in Iran sentenced to eight years in prison,0,1,3,56,0,10,0,59,0
Tom Hanks Is Publishing A Short Story Collection,0,3,8,33,0,7,0,41,0
South Carolina Merchandise Sales Increase By 320% After Duke Upset,0,3,9,44,1,9,3,53,0
NERDSCREEN: The Importance of the Campaign Announcement Speech,0,2,15,39,1,7,0,54,0
Lego Making ‘Women of NASA’ Figures,0,2,8,20,2,5,0,28,0
2008 e21FORUM: Intel confronts Microsoft again,0,1,7,27,1,5,6,34,0
Trump: Only 'stupid' people think warm ties with Russia are a bad thing,0,3,3,53,3,12,0,56,0
Filipino Food Is the Next Big Thing—Again,0,3,7,27,1,6,0,34,0
"Boaty McBoatface, From Internet Joke to Polar Explorer ",0,3,8,38,1,8,0,46,0
Retired New York Police Officer Charged with Murder During Drug Deal,0,3,10,48,0,10,0,58,0
"The Apple tax ruling – what this means for Ireland, tax and multinationals",0,2,3,57,2,12,0,60,0
Watch National Geographic’s stunning climate-change documentary starring Leonardo DiCaprio,0,2,6,74,2,8,0,80,0
"REAL EU Immigration Figures Twice As High As Previously Thought, Government Admits",0,2,16,54,1,11,0,70,0
British actress Natasha Richardson dies at age 45,0,1,3,37,0,7,2,40,0
California teamsters picket Orange County transit system in contract dispute,0,1,3,64,0,9,0,67,0
Citigroup beats on earnings,0,3,1,23,0,3,0,24,0
Stock market holds its breath for Trump tax plan,0,3,2,38,0,8,0,40,0
Jets Reach Five-Year Deal With Sanchez,0,1,7,25,1,5,0,32,0
Young Thug Hints At Upcoming Collab With The Weeknd,0,3,9,34,0,8,0,43,0
General promises D.C. National Guard is ready for Inauguration Day despite furor,0,3,7,60,2,11,0,67,0
Riders and Residents Greet Second Avenue Subway’s Opening ,0,2,7,42,1,8,0,49,0
Netflix dominates Saturdays â here's how it stacks up against TV networks the rest of the week,0,2,4,73,3,16,0,77,0
"Home for recess, lawmakers face fiery town hall crowds on Trump, abortion and more",0,3,2,65,2,13,0,67,0
Could statins be the miracle cure for Alzheimer's? Taking the tablets for just 2 years reduces the risk by up to 15%,0,3,3,86,3,21,3,89,0
"For $12,500, You Can Train With Olympic Medalists in France",0,3,8,34,3,9,5,42,0
At least nineteen dead after suicide bomb blast in Pakistan,0,1,2,48,0,9,0,50,0
"Colombian Plans, Part III",0,2,6,15,1,3,0,21,0
Clinton Delivers Rebuke to Pakistan,0,1,4,27,0,4,0,31,0
Business Travelers Will Pay Less To Fly In 2017 Despite Airlines' Efforts To Limit Capacity Growth,0,3,15,63,1,15,4,78,0
Westinghouse Seeks to Reassure Chinese Customer After Bankruptcy ,0,3,7,50,0,8,0,57,0
Tour de France Officials and Teams at Impasse Over Radio Ban,0,1,8,42,0,10,0,50,0
"Yeah, but What Has He Done Since the Derby?",0,1,7,26,2,8,0,33,0
A body cam captured a cop’s violent encounter with a teen — but a new law keeps the video secret,0,2,1,74,2,19,0,75,0
Coca Cola's sexy new ad bubbles up surprising social media reactions ,0,3,2,55,1,11,0,57,0
Bodies of victims of Typhoon Fengshen appear on Philippine shores,0,1,4,52,0,9,0,56,0
Woman who killed abusive husband pardoned by French president,0,2,2,51,0,8,0,53,0
Goldman Settles Subprime Complaint in Massachusetts,0,1,5,41,0,5,0,46,0
Fire survivor teaches children fire-safety tools that saved his family ,0,3,1,59,1,10,0,60,0
Joint session 2017: Who are Trump's special guests?,0,3,3,34,3,7,4,37,0
Beyond the Boldface Names in the IndyMac Deal,0,1,6,32,0,7,0,38,0
Electors Call for Intelligence Briefing on Russian Hacking Allegations ,0,2,7,55,0,9,0,62,0
At least four killed by bomb thrown from motorcycle in Cairo,0,1,2,48,0,10,0,50,0
Two NATO soldiers captured in Afghanistan,0,1,6,30,0,5,0,36,0
A dozen 7-Elevens transformed into Kwik-E-Marts to promote Simpsons movie,0,1,6,54,3,9,1,60,0
Massive 7.5 earthquake strikes Indonesia,0,1,2,31,1,4,2,33,0
American held over 900 days in Egypt begs US for help before Trump's reign,0,3,5,52,1,13,3,57,0
Was Donald Trump's official @POTUS account registered with a Gmail address?,0,3,9,53,3,10,0,62,0
Adele Sends Her Love To Emma Stone For Best Actress Oscar Win,0,3,12,38,0,11,0,50,0
90-year-old pilot who crashed into a tree may have felt pressure to fly despite bad conditions ,0,3,0,75,2,16,2,75,0
"Under New Chief, Another Shake-Up at Yahoo",0,1,7,27,2,6,0,34,0
Woman Whose Accusations Led to Lynching of Emmett Till Admits She Lied,0,3,10,49,0,11,0,59,0
Cat Caught in Garage Door Saved by Deputy ,0,3,6,28,0,8,0,34,0
Gambian army chief pledges allegiance to defeated president,0,3,1,51,0,7,0,52,0
"Baby in California born with 12 functioning fingers and toes, in a rare case of polydactylism",0,1,2,73,1,15,2,75,0
Emmanuel Macron: the French outsider who would be president,0,3,3,47,1,8,0,50,0
Former Louisiana Tech University President F. Jay Taylor dies aged 87,0,1,8,48,1,10,2,56,0
"Carnival parade float crashes in Brazil, injuring 20 ",0,3,2,40,1,8,2,42,0
Labor calls for overhaul of 'Mickey Mouse' work for the dole courses,0,3,3,52,2,11,0,55,0
Uber Shares Unbelievable List of Outrageous Sh*t People Have Left Behind,0,3,10,51,1,10,0,61,0
Willie Geist: ’Things Predicted By Conservatives Many Years Ago’ Are Happening With Obamacare - Breitbart,0,2,14,73,4,14,0,87,0
Australia leads international push to protect far eastern curlew from extinction,0,3,1,69,0,10,0,70,0
Europe Moves to Ease Tensions on Protectionism,0,1,5,35,0,6,0,40,0
Commander of US Naval forces implies that Chinese navy ships can't 'fight their way out of a wet paper bag',0,2,5,80,3,19,0,85,0
Jack Wilshere ‘wants to be wanted by Arsenal’ amid Manchester City talk,0,2,5,53,2,11,0,58,0
United Has Changed Its Policy for Overbooking Flights and Removing Passengers,0,3,9,58,0,10,0,67,0
New Brazilian prison riots leave 26 dead,0,2,2,30,0,6,2,32,0
Snow storm hits Arizona and New Mexico,0,1,4,28,0,6,0,32,0
Rodriguez Has Been Identified From 2003; What About the Others?,0,1,8,40,2,9,4,48,0
"20 years later, Ellen's coming out episode remains one of the best in television history",0,3,1,69,2,14,2,70,0
Facebook unblocked in Bangladesh,0,1,2,27,0,3,0,29,0
Zayn Malik Reveals New Collaboration With PartyNextDoor,0,3,9,40,0,6,0,49,0
World Book Day gives many children first chance to buy one,0,2,3,45,0,10,0,48,0
Elizabeth II annuls Fred Goodwin knighthood,0,1,5,33,0,5,0,38,0
Suicide bomb kills at least 29 at Somalia's main port,0,3,2,39,1,9,2,41,0
"Sea lions take over dock at Moss Landing, California",0,1,4,39,1,8,0,43,0
CNN Spanish service moves to YouTube after Venezuela ban,0,3,7,41,0,8,0,48,0
Donations from all over the world save cat no one wanted to touch - Yahoo,0,3,2,56,1,14,0,58,0
"From the Vatican, a Tough Read",0,1,4,20,1,5,0,24,0
Grammy winning singer Richard Marx helps take down unruly passenger on flight,0,3,3,63,0,11,0,66,0
Temporarily Unavailable,0,2,2,20,0,1,0,22,0
Trump China Trash Talk Risks Collateral Damage to Global Economy,0,2,9,46,0,9,0,55,0
"Drug Abuse-Related Government Spending Hit $468 Billion, Report Says",0,1,9,45,3,8,3,54,0
Bullish Bets on Crude Cut by Most Ever as Price Falls Below $50,0,3,9,39,1,12,2,48,0
South Africa clashes at anti-foreigner protest in Pretoria,0,2,3,47,1,7,0,50,0
Trump superfan Eric Bolling gets a new show on Fox News. That’s a win for the White House.,0,2,8,62,3,17,0,70,0
Dungeons & Dragons co-creator Dave Arneson dies,0,1,4,35,2,6,0,39,0
Ben Simmons' Foot Injury Reportedly Hasn't Fully Healed After Surgery,0,3,10,48,2,9,0,58,0
Dog food recalled after euthanasia drug found in it,0,3,1,42,0,8,0,43,0
Jared Kushner to speak to Senate committee over his meeting with Russian ambassador Sergei Kislyak,0,3,6,78,0,14,0,84,0
Logan's Hugh Jackman: 'People think it’s easier to stay in your own backyard' – video interview,0,2,4,70,6,15,0,74,0
G.E. to Reduce Its Dividend,0,1,5,16,2,4,0,21,0
State-of-the-art Chinese ballistic missile appears in military drills ,0,3,2,57,3,8,0,59,0
Murdered woman's sister supports executing ex-soldier in potentially historic move ,0,3,1,70,2,10,0,71,0
Robin Thicke Posts Tribute to Late Father Alan ,0,3,7,32,0,8,0,39,0
Climate scientists criticize government paper that erases ‘pause’ in warming ,0,3,1,64,2,10,0,65,0
"Discover the Anvil Hotel, the Wild West’s Dude Ranch for Hipsters",0,3,8,45,2,10,0,53,0
'We have grave concerns': There could be trouble ahead for the NDIS if the ACT's problems go national,0,3,9,71,4,17,0,80,0
The Democratic Party’s Empty Rage,0,3,5,23,1,4,0,28,0
Alan Turing Building opens at University of Manchester,0,1,5,42,0,7,0,47,0
"Migrant train derails in Tabasco, Mexico",0,1,3,31,1,5,0,34,0
Home Sales Better Than Expected in December,0,1,6,31,0,6,0,37,0
Many People Hugely Overestimate Their Country's Muslim Population [Infographic],0,3,9,59,3,8,0,68,0
Al Jarreau: Seven-time Grammy-winning jazz singer dies at 76,0,3,4,43,3,8,2,47,0
"1 Dead, Suspect Surrenders in Las Vegas Strip Bus Shooting and Standoff",0,3,9,49,1,11,1,58,0
The Incredible Shrinking Baseball Player,0,1,5,31,0,4,0,36,0
"Sukumaran and Chan families deserve more help, says wife of death row man",0,3,2,58,1,12,0,60,0
Study estimates first human HIV infection 100 years ago,0,1,4,40,0,8,3,44,0
"Jefferies Profit Quadruples as Fixed Income, Equities Climb",0,3,7,44,1,7,0,51,0
A Ban on Drooping Drawers Leads to a Legal Challenge,0,1,7,36,0,9,0,43,0
What will change for your finances in 2017,0,3,1,30,0,7,4,31,0
"North Dakotans Reconsider a Corporate Farming Ban, and Their Values - The New York Times",0,2,12,60,2,14,0,72,0
1.5 Crore Homes Switched To LPG Cylinders In Last 8 Months Under 'Ujjwala' Scheme,0,3,14,48,3,13,3,62,0
Ecuador says it has ’temporarily restricted’ WikiLeaks founder Assange’s internet access,0,2,4,71,3,10,0,75,0
"Get To Know The Bleak, Post-Apocalyptic Comic That Inspired 'Logan'",0,3,11,43,4,9,0,54,0
Please enjoy Obama photographer Pete Souza's latest flawless Trump troll,0,2,5,57,1,9,0,62,0
"Josh Beckett Maintains Order, and His Image, on the Mound",0,1,7,39,2,9,0,46,0
Ukranian railway accident generates huge phosphor cloud,0,1,1,48,0,6,0,49,0
"Amber alert canceled: Aylin Hernandez safe, murder suspect father arrested, cops say",0,3,3,67,3,11,0,70,0
Indian taxi driver charged with molesting Australian woman in Mumbai,0,3,3,56,0,9,0,59,0
The Kurds are pushing deeper into an ISIS stronghold on the Syria/Turkey border - Business Insider,0,3,10,71,2,15,0,81,0
"Theranos will shrink by almost half, laying off 155 employees",0,3,1,47,1,9,3,48,0
Gold Slides to 10-Month Low as Fund Selling Binge Haunts Market,0,3,9,41,1,10,2,50,0
Miranda Kerr is really feeling the wrath of Spiegel's alleged India comments,0,3,4,60,1,11,0,64,0
Steph Curry Appears in Eye-Popping Ad to Promote Mental Health and Wellness Campaign,0,3,11,60,1,12,0,71,0
Russia's Andrey Pavlov Needs 17 Shots on 1st Hole at the Lyoness Open,0,2,8,45,1,12,3,53,0
Scottish lawmakers back independence referendum call ,0,3,1,46,0,6,0,47,0
Brexit Timeline: From the Referendum to Article 50,0,3,5,35,1,7,2,40,0
Review: A ‘Sweeney Todd’ That Gets Into Your Face ,0,3,9,29,3,9,0,38,0
US bombers to train in Australia,0,1,3,24,0,5,0,27,0
"After Recapturing Palmyra, Islamic State Destroys Parts Of Historic Roman Theater In Syrian City",0,3,14,68,1,13,0,82,0
Zambian shoppers run in terror when strange 'Harry Potter Dementor' figure appears in clouds,0,2,4,73,2,13,0,77,0
Elon Musk Has an Awkward Problem at Tesla: Employee Parking,0,3,8,41,1,9,0,49,0
"For the love of charity, look at these dog bellies",0,3,1,39,1,9,0,40,0
"Pentatonix Get Into the Christmas Spirit in 'O Come, All Ye Faithful' Video: Watch",0,2,12,53,4,13,0,65,0
Trump hasn’t ruled out raising the national debt to cut taxes,0,3,1,49,1,10,0,50,0
Beyonce & Jay Z's 38 Sweetest PDA Moments,0,3,8,22,2,7,2,30,0
"Mark Sanchez agrees to one-year deal with Bears, sources say",0,2,3,46,2,9,0,49,0
2007 European football friendly match: England vs. Germany,0,1,3,42,2,7,4,45,0
Charles Oakley Will Attend Knicks vs. Cavaliers in Cleveland,0,3,7,44,1,8,0,51,0
Exclusive: Watch Cazzie David's Hilarious New Web Series 'Eighty-Sixed',0,2,10,48,5,8,0,58,0
"Son of Robert Levinson, ex-FBI agent missing in Iran: 'Trump can get him home' ",0,3,8,52,5,14,0,60,0
Yoenis Cespedes Hits 3 Home Runs vs. Philadelphia Phillies,0,2,7,41,1,8,1,48,0
Votes in Sri Lankan presidential elections counted,0,1,3,41,0,6,0,44,0
Prince Charles presented with a king during card game in Florence,0,3,3,52,0,10,0,55,0
Philippine impeachment unlikely to succeed,0,1,1,37,0,4,0,38,0
"Following Earnings Miss, Costco Plans To Hike Membership Fees",0,2,9,43,1,8,0,52,0
This app connects refugees to volunteer translators via Facebook Messenger,0,3,3,62,0,9,0,65,0
Wolf Blitzer grills Donald Trump: Why are white supremacists supporting you?,0,2,5,59,2,10,0,64,0
U.S. Shale's Great Reawakening,0,2,5,19,3,3,0,24,0
NCAA Tournament 2017: Strengths and Weaknesses for Top Contenders,0,3,9,43,1,8,4,52,0
"Krauthammer: ’Childish,’ ’Pathetic’ Hillary Won’t Take Blame for Election Loss - Breitbart",0,2,10,61,8,11,0,71,0
"Grand Plans for Moon and Mars, Budget Permitting",0,1,6,34,1,7,0,40,0
Why Zegna is Getting Into the Sheep Farm Business,0,3,7,34,0,8,0,41,0
The Austrians voted with Europe in mind this weekend – the Italians didn't,0,3,4,56,2,12,0,60,0
Mickelson and Watney Share Lead at Doral,0,1,5,29,0,6,0,34,0
"Two Santa Clara, Utah teens in critical condition after lightning strike",0,1,4,57,1,10,0,61,0
Hurricanes equipment manager Jorge Alves makes (brief) NHL debut in net — at age 37,0,2,6,58,3,14,2,64,0
Sara Bareilles Calls Congress in Video: 'Make Your Voice Known',0,2,9,42,3,9,0,51,0
'The X-Files' Will Return To Fox ... Again,0,3,8,21,6,7,0,29,0
Petraeus: ’Pragmatic’ Trump Will Place Campaign Rhetoric ’in a Strategic Context’ - Breitbart,0,2,10,65,6,12,0,75,0
Threat on New York City subway system heightens security alert level,0,1,4,54,0,10,0,58,0
"Finding coach, spending $50M and other Giants offseason keys",0,2,3,45,2,8,2,48,0
Avalanche Kills 10 Hikers at a Remote Mountain in Turkey,0,1,6,39,0,9,2,45,0
Crocodiles maul tour guide to death at farm in South Africa,0,3,3,46,0,10,0,49,0
US X Factor producers confirm line-up changes,0,1,4,34,1,6,0,38,0
Does Melissa McCarthy Upset Trump More Than Alec Baldwin?,0,3,10,38,1,8,0,48,0
North Korea Detains Third American Citizen: Officials,0,3,7,39,1,6,0,46,0
U.N. Leader Presses Sri Lanka on Speeding Relief to War Refugees in Camps,0,1,11,48,2,12,0,59,0
Facebook launches artificial intelligence technology to identify users who are showing signs of suicide,0,3,1,89,0,13,0,90,0
NYT Mag: Facebook’s ‘Building Global Community’ Manifesto ‘Bound to Be Considered Partisan’,0,2,13,61,6,11,0,74,0
7 mental tricks US Olympic athletes use to perform under pressure,0,3,3,51,0,10,1,54,0
"Cambodia's Deputy PM Sok An dies aged 66, government spokesman says",0,3,6,47,2,10,2,53,0
Growing number of women leading US police departments ,0,2,3,43,0,8,0,46,0
Trump White House Appears to Send Veiled Warning to Black Lives Matter Protesters,0,2,11,58,0,12,0,69,0
Holly Bobo murder trial: Jury selection begins after months of delays ,0,3,3,55,1,11,0,58,0
Shell Exits Third Saudi Project After Ending Sabic Venture,0,2,9,41,0,8,0,50,0
Israelis Cede More Control of West Bank Security,0,1,7,34,0,7,0,41,0
John Lewis: Trump slammed for attack on rights icon,0,2,3,39,1,8,0,42,0
Afghanistan suicide bomb leaves seven Americans dead,0,1,2,44,0,6,0,46,0
NFL Writers Realize Ben Roethlisberger Blocked Many of Them on Twitter,0,2,11,49,0,10,0,60,0
18 Funny-Ass Posts About Panic! At The Disco,0,3,8,25,2,7,2,33,0
Fashion PR Firm LaForce Cancels Christmas Party Because Trump Won,0,3,12,44,0,9,0,56,0
A Stockholm suburb is redesigning its streets to be 'feminist',0,3,2,49,2,9,0,51,0
Aetna CEO: Why the Merger With Humana Fell Apart,0,3,10,29,1,8,0,39,0
Jimmy Kimmel Suggests The Perfect Vacation Spots For Bill O'Reilly,0,2,11,45,1,9,0,56,0
Prince William Proves He’s a Kid at Heart While Building a Tent Blindfolded [Video],0,3,11,56,3,13,0,67,0
Sharp Trade Contraction Knows No Borders,0,1,6,29,0,5,0,35,0
"Don't blackmail us over security, EU warns May",0,2,4,33,2,7,0,37,0
"Residents fear environmental hazard on site of partially collapsed building in Buffalo, New York",0,1,4,78,1,13,0,82,0
‘Snatch’: Rupert Grint Goes Gangster,0,2,5,24,3,4,0,29,0
Entertainment Live: 8 June 2015,0,3,3,18,1,4,5,21,0
John Kasich Critiques GOP Health Care Plan Over Medicaid Cuts,0,2,12,40,0,9,0,52,0
Brazil prison escape: Fugitive posts selfies on the run,0,3,2,44,1,8,0,46,0
Seven Moroccans killed in bus crash in central France,0,1,3,42,0,8,0,45,0
Allegations President Bush staged photo-ops in aftermath of Hurricane Katrina tragedy,0,1,5,69,1,10,0,74,0
"Jonathan Coulton, Non-Rock Star, Needs a Roadie",0,1,7,31,3,6,0,38,0
Mylan announces nationwide EpiPen recall over potential defect,0,3,3,52,0,7,0,55,0
Theresa May warns Donald Trump about ‘Iran’s malign influence’ during speech to Republicans in Philadelphia,0,2,7,83,3,14,0,90,0
'Here we go again!': internet reacts as Government loses Article 50 Supreme Court case,0,3,5,62,4,13,2,67,0
"Laura Ingraham Considering Senate Run in Virginia, Challenging Tim Kaine  Insider",0,3,10,59,1,11,0,69,0
UNC tops Gonzaga for national title,0,2,4,26,0,5,0,30,0
Gmail 1st Birthday; Storage capacity increased to 2GB,0,1,5,38,1,7,2,43,0
GOP Rep. Says Obama’s Syrian Refugee ‘Bait and Switch’ Endangers Americans - Breitbart,0,2,13,56,5,12,0,69,0
Watch Octavia Spencer Mock 'Hidden Fences' on 'Saturday Night Live',0,3,9,45,4,9,0,54,0
South Korean presidential candidate promises to legalise non-ActiveX technologies for banking,0,1,4,78,1,10,0,82,0
Three Things Every Entrepreneur Needs To Do This Holiday Season,0,3,10,44,0,9,0,54,0
"Ford, Toyota Form Telematics Bloc to Stymie Google and Apple",0,3,8,42,1,9,0,50,0
Sheryl Sandberg Donated $1 Million To Planned Parenthood,0,3,7,40,1,7,1,47,0
How did the global women's marches affect you?,0,3,1,36,2,7,0,37,0
American Airlines is offering its pilots and flight attendants a raise,0,3,2,58,0,10,0,60,0
Immigrant rights groups brace for more deportation raids: 'This is the beginning',0,3,2,65,3,11,0,67,0
Why It's Time To Take A Luxurious Look At Mexico City,0,3,11,31,1,10,0,42,0
Selena Gomez Talks Being Bullied During Her Days on Disney Channel: ‘The Biggest High School in the World’,0,3,15,71,3,17,0,86,0
Nets PG Jeremy Lin Channels Jimmy Neutron with Towering Hairdo,0,3,10,43,0,9,0,53,0
Al Jazeera cameraman killed in eastern Libya,0,1,3,35,0,6,0,38,0
Executive Orders 101: What are they and how do Presidents use them?,0,2,4,47,2,11,3,51,0
"X-ray images just as useful when viewed on smartphone, study finds",0,3,1,53,2,10,0,54,0
Referendum result may lead nowhere for Italy's Five Star and Northern League,0,3,6,58,1,11,0,64,0
The first Mars astronauts may be trapped inside of a tube for 3 years with no chance of escape,0,3,2,73,0,18,1,75,0
Netflix wants to start selling you merch,0,2,1,33,0,6,0,34,0
Hero service dog breaks his leg after throwing himself into the path of a bus to save his blind owner,0,2,1,81,0,19,0,82,0
"27 Savage Quotes That Prove You Should Never Fuck With Khloé, Kourtney Or Scott",0,3,13,50,1,13,2,63,0
Australian MPs' private numbers mistakenly published online,0,3,3,49,1,6,0,52,0
"Ed Sheeran, Sam Hunt & More Are Spotify Editors' Picks for New Music Friday",0,3,12,47,3,13,0,59,0
Megyn Kelly Being Replaced by Tucker Carlson at Fox ,0,3,7,36,0,9,0,43,0
New York asks U.S. government for $35 million in Trump security costs,0,3,5,48,3,11,2,53,0
Watch These Politicians Morph Into Their 'SNL' Characters,0,3,10,38,2,7,0,48,0
"Michelle Obama tells Oprah Winfrey the election ""was painful""",0,2,4,47,2,8,0,51,0
Supreme Court Neil Gorsuch: Who is Trump's nominee?,0,2,6,35,3,7,0,41,0
Woman Wearing Anti-Trump Sign Barred From Lincoln Center's David Geffen Hall,0,3,12,52,2,10,0,64,0
"Embracing figures at Pompeii 'could have been gay lovers', after scan reveals they are both men",0,3,2,75,3,15,0,77,0
Tennessee school bus driver indicted in deaths of 6 children ,0,3,1,49,0,10,1,50,0
Americans have never been this conflicted about the economy's direction,0,3,1,60,1,9,0,61,0
Driving to the South Pole Is Coolest Road Trip You've Never Heard Of,0,3,11,44,1,12,0,55,0
Obama Brings Flush Times for Black News Media,0,1,7,31,0,7,0,38,0
Tour de France: The race begins in earnest,0,1,3,31,1,7,0,34,0
Canada’s detention of Mexicans surges after visa lift,0,2,2,43,1,7,0,45,0
Fiona Donnison jailed for murdering her children in UK,0,1,4,42,0,8,0,46,0
"Candid Hitler Photos Sell for $41,000 to Unidentified Bidder ",0,3,6,39,2,9,5,45,0
Australian government accused of hypocrisy over World Court statement,0,1,3,58,0,8,0,61,0
Diego Luna Found His Son Spilling 'Rogue One' Secrets To Impress Girls,0,3,12,45,2,11,0,57,0
Banks fined £413m over euro rate rigging,0,3,1,29,1,6,3,30,0
"Tesco pricing error in Cambridgeshire, England allows customers to get cheaper fuel",0,1,3,68,1,11,0,71,0
Republican Leaders Search for Health-Care Bill Votes ,0,3,7,38,1,7,0,45,0
Feral cats' diet tracked ahead of calicivirus release,0,3,1,44,1,7,0,45,0
Trump rants protesters took away his First Amendment rights,0,2,3,48,0,8,0,51,0
Profile: Is France finally ready to choose Marine Le Pen as president?,0,2,6,51,2,11,0,57,0
Getting Out From Behind the Wheel,0,1,5,23,0,5,0,28,0
Woman Says Man Groped Her On United Flight And Attendants Kept Bringing Him Whiskeys,0,3,14,57,0,13,0,71,0
September Trial Planned for Trey Songz If No Plea Agreement,0,3,9,41,0,9,0,50,0
Teacher awarded almost half a million pounds after being hit over head with skate board by violent pupil ,0,3,1,86,0,18,0,87,0
Why Trump Is Doomed With Black Voters,0,2,7,24,0,6,0,31,0
"Katy Perry, Maroon 5, Niall Horan to Headline 2017 Wango Tango Concert",0,2,9,43,2,11,5,52,0
Trump To Crowd: This Race Would Be ‘Boring As Hell’ If I Acted ‘Presidential!’,0,2,14,45,6,13,0,59,0
United Airlines Faces Backlash After Refusing to Allow Girls to Board Plane in Leggings,0,3,11,63,0,13,0,74,0
The Super Bowl Synch Master: UMPG's Tom Eaton Is Finalizing Ads 3 Days Before Kick-Off,0,3,18,50,3,14,1,68,0
Jarvis Landry Predicts Dolphins Will Sweep Patriots in 2017 Season,0,3,8,45,0,9,4,53,0
"Eleven days later, a survivor pulled from rubble after Chinese earthquake",0,1,2,60,1,10,0,62,0
POLL: Across Political Spectrum Massive Majority Reject Islam After Migrant Crisis,0,2,14,57,1,10,0,71,0
Veterans unite for second 'deployment' against Dakota Access Pipeline,0,3,4,55,2,8,0,59,0
Tom Brady Spent April Fools' Trolling a 'Fake News' Headline Claiming He Lost the Super Bowl,0,2,14,60,3,15,0,74,0
"President Trump, Canadian PM Trudeau to Meet Monday",0,3,8,35,1,7,0,43,0
"UEFA Champions League: April 1, 2008",0,1,7,17,2,5,5,24,0
Donald Trump Considers Moving VA Toward Privatization ,0,3,8,39,0,7,0,47,0
L.L. Bean’s Duck Boot Finally Gets a Fresh Look,0,3,9,27,3,8,0,36,0
"The Week in Pictures: Feb. 10, 2017 ",0,3,4,16,3,7,6,20,0
Jared Kushner actually speaks in front of people,0,2,2,39,0,7,0,41,0
Tensions continue to rise between North Korea and United States,0,1,5,49,0,9,0,54,0
Michael Jackson's Neverland Ranch back on market for $67M,0,3,5,40,2,8,2,45,0
Early Canadian federal election set for October 14,0,1,3,38,0,7,2,41,0
Breeze transforms a thinly seeded field into a rippling upland river,0,2,1,57,0,10,0,58,0
If Only The Rest Of America Got Concussion Care Like NFL Players,0,2,14,39,0,11,0,53,0
It's Official Everyone! Sachin Tendulkar's Biopic Will Release On May 26,0,3,10,47,3,10,2,57,0
You can FINALLY 'like' or disable comments on Instagram posts,0,3,9,41,2,9,0,50,0
A Measure of Identity: Are You Wedded to Your Party? ,0,2,8,33,2,10,0,41,0
"Every Marvel TV show ranked from worst to best, according to critics",0,3,4,52,1,11,0,56,0
Royal Mail union warns of industrial action over pension scheme closure,0,3,2,59,0,10,0,61,0
"Anne Frank may not have been betrayed to Nazi occupiers, but captured by chance",0,2,3,62,1,13,0,65,0
LGBTQ Community Worried About Hate Crime Prosecutions,0,3,11,36,0,6,0,47,0
"Richard becomes a hurricane, threatens Belize",0,1,2,37,1,5,0,39,0
"Kaczynski elected as the new president of Poland, according to polls",0,1,2,55,1,10,0,57,0
Blagojevich Calls Impeachment Process Unfair,0,1,5,35,0,4,0,40,0
MSNBC’s O’Donnell: Maybe Putin Masterminded Chemical Attack So Trump Could Look Good by Striking Syria,0,3,19,66,3,14,0,85,0
What is the 'holy grail of climate science' and how will scientists find it?,0,3,1,59,3,13,0,60,0
"Leading DNA scientist sacked, 27 criminal cases in doubt, WA Attorney-General says",0,3,8,58,3,11,2,66,0
Virginia Woman Sentenced to 30 Months in Counterfeit Designer Handbag Scheme,0,3,8,56,0,10,2,64,0
"TSA Rolls Out New Pat-Downs, Some Travelers Say They’re Invasive",0,3,13,39,3,9,0,52,0
Aides Say No Pardon for Libby Irked Cheney,0,1,7,28,0,7,0,35,0
France Seeks to Lure More Tourists With Better Welcome,0,2,8,38,0,8,0,46,0
Tunisian swimmer Oussama Mellouli stripped of championship for doping,0,1,3,58,0,8,0,61,0
Miami 'Toxic Tush' Doctor Sentenced to 10 Years for Providing Lethal Butt Injections,0,2,10,58,2,12,2,68,0
Stakes High in Armenia-Turkey Talks,0,1,5,25,1,4,0,30,0
Syrian Family Arrives in Chicago After Long Wait,0,3,7,34,0,7,0,41,0
This week’s hottest fashion sales,0,2,1,27,1,4,0,28,0
Barack Obama's last day as 44th president,0,3,2,30,1,6,2,32,0
Female leopard shows off her pace in the wild as she hunts down a warthog in incredible wildlife pictures ,0,3,1,86,0,19,0,87,0
Vladimir Putin warns of Olympic ‘schism’ after Russian doping revealed,0,2,4,55,2,9,0,59,0
Seth Meyers Rips Trump For Ridiculous Mar-A-Lago Weekend,0,3,10,37,2,7,0,47,0
Kalief Browder and what we do and don’t know about solitary confinement in the U.S.,0,2,4,62,3,14,0,66,0
Cleveland Man Makes Awesome Crying Jordan-Themed Uniforms for His League Team,0,2,11,55,1,10,0,66,0
"Trump: Leaked transcripts of Mexico, Australia calls 'disgraceful' ",0,2,4,51,4,8,0,55,0
Alleged rapist files charges against victim in Sweden on HIV infection grounds,0,1,5,62,0,11,0,67,0
Love Parade Tragedy: German Court Orders Trial Over 2010 Festival Deaths,0,2,10,47,1,10,4,57,0
May Pledges More Action to Support Freedom of Religion,0,3,7,39,0,8,0,46,0
U.S. Is Arms Bazaar for Mexican Cartels,0,1,7,24,2,6,0,31,0
"Manafort Is Willing to Talk With House Committee, Nunes Says",0,3,9,41,1,9,0,50,0
Eating at Disneyland's newest restaurant costs as much as your rent,0,3,2,54,1,10,0,56,0
White House ‘confident’ of averting shutdown as Trump shows flexibility on wall,0,3,3,63,2,11,0,66,0
"After investigation, Walmart joins Target in pulling Egyptian cotton sheets",0,2,4,61,1,9,0,65,0
Bomb ruled out in Mexico plane crash that killed twelve,0,1,2,44,0,9,0,46,0
A California waiter refused to serve 4 Latina women until he saw ‘proof of residency’,0,3,3,65,2,14,1,68,0
Warriors' Marreese Speights Misses Wide-Open Dunk in Wild End to 3rd Quarter,0,3,10,52,2,11,1,62,0
Comcast to expand streaming service amid cord-cutting trend,0,2,1,50,1,7,0,51,0
The CEO of Arconic has stepped down after an ugly battle with hedge fund titan Paul Singer,0,3,7,67,0,16,0,74,0
Trump Attacks Senator’s Credibility Over Gorsuch’s Comments ,0,3,7,44,2,7,0,51,0
Stephin Merritt: 50 songs for 50 years,0,3,2,25,1,6,4,27,0
"BitTorrent tracker site sued by movie studios, will mount defense",0,1,2,53,1,9,0,55,0
"MSNBC's Lawrence O’Donnell: Trump Is 'The Laziest, Most Ignorant President In History'",0,3,17,52,6,11,0,69,0
"Donald Trump Responds to Obama: ’When You Rattle Someone, That’s Good’ - Breitbart",0,2,11,53,6,12,0,64,0
Here's what it's like to use a computer in North Korea,0,3,3,39,2,10,0,42,0
"Daniel Kaluuya: 'In Britain I’m too black, in America I'm not black enough'",0,3,7,50,6,12,0,57,0
Snopp Dogg Will Induct Tupac Shakur Into Rock and Roll Hall of Fame,0,3,11,44,0,12,0,55,0
Suicide bombers kill 9 in Iraq ,0,3,2,22,0,6,1,24,0
Cumbrian zoo where almost 500 animals died is refused new licence,0,3,1,51,0,10,3,52,0
"In corporate America, uncertainty overtakes early optimism about Trump",0,2,3,58,1,8,0,61,0
"Trump to inherit more than 100 court vacancies, plans to reshape judiciary",0,2,1,58,1,11,3,59,0
Trump Administration Seeks Delay in Lawsuit Over Health-Law Subsidies   ,0,2,9,51,1,11,0,60,0
"Trump is taking hair loss drug, doctor says",0,3,1,34,1,7,0,35,0
Chicago Bans Bottles With BPA Plastic,0,1,8,24,0,5,0,32,0
"1 killed, 2 hurt in shooting in downtown Fresno, California ",0,3,2,44,2,10,2,46,0
Dive Instructor Saves Shark With A Large Knife Wedged In Its Head,0,2,12,42,0,11,0,54,0
Macy’s 'Change-of-Control' Bonds Fall as Takeover Terms Become Less Clear,0,3,10,49,5,9,0,59,0
Indian heart disease 'more severe than in West',0,1,2,36,2,7,0,38,0
Your Guide to Inauguration Day 2017 ,0,3,4,22,0,6,4,26,0
Police: Women “trained” to poison Kim Jong Un’s half brother,0,3,5,42,4,9,0,47,0
NFL Free Agency 2017: Winners and Losers of Day 2,0,3,8,26,1,9,5,34,0
Inauguration Week: A User Guide to Donald J. Trump’s Big Day in Washington,0,3,11,48,3,12,0,59,0
Texas wildfires push public resources to the limit,0,1,1,42,0,7,0,43,0
"Pet tigers, cheetahs, lions banned in United Arab Emirates under new laws",0,2,4,56,2,11,0,60,0
Union leader threatens illegal strikes if Government tightens rules on industrial action,0,3,2,75,0,11,0,77,0
Obama wins Wyoming caucus,0,1,2,20,0,3,0,22,0
Young Scooter Links With Young Thug on New Cut 'Cook Up': Premiere,0,2,11,41,3,11,0,52,0
"US Department of Defense reports Iraqi Al Qaeda ""safe house"" hit",0,1,7,45,2,10,0,52,0
Internet Providers Try to Charge More as  Costs Fall,0,1,7,36,0,9,0,43,0
Jackie Evancho's Transgender Sister Juliet Wins Federal Court Ruling Over School Bathrooms,0,2,12,66,1,11,0,78,0
Patent Feud Is Underappreciated Risk at Biogen,0,3,6,34,0,6,0,40,0
"Ryan Gosling Wore A Ruffled Shirt To The Oscars And Honestly, I’m Here For It",0,3,15,46,2,14,0,61,0
"World will suffer 'vacuum of leadership' if Trump refugee ban goes ahead, charities warn",0,3,2,70,3,13,0,72,0
Harvard Law School just dropped the LSAT as an admissions requirement,0,3,7,52,0,10,0,59,0
England vs Slovenia live: Latest score as Jack Wilshere goal equalises for England in Euro 2016 qualifier,0,2,7,77,1,16,4,84,0
’Star Wars’ actress Carrie Fisher is dead at 60,0,2,4,31,2,8,2,35,0
Revealed: The elusive ruby seadragon is caught on camera in the wild for the first time,0,3,2,69,1,15,0,71,0
The great outdoors: readers share their best weather photos from 2016,0,3,1,53,1,10,4,54,0
Rupert Murdoch to step down as CEO of Fox,0,2,6,27,0,8,0,33,0
Turning pebbles into pictures of the war in Syria,0,2,2,39,0,8,0,41,0
US travel ban: Officials admit poor communication but defend policy,0,3,3,54,1,9,0,57,0
"WSJ Analysis: Jobs Report Fits Fed Outlook for Labor Market Gains, Rate Raises",0,2,14,50,2,12,0,64,0
Police Chief Killed in Somalia Fighting,0,1,5,29,0,5,0,34,0
Government seeks official advice for postal ballot on same-sex marriage,0,3,1,60,1,9,0,61,0
Pictured: The sewer where 200 partygoers attended illegal rave after wading through water-filled tunnels,0,3,2,84,2,13,3,86,0
"In Rescue of Captain, Navy Kills 3 Pirates",0,1,6,27,1,7,1,33,0
Bill O’Reilly called Putin ‘a killer.’ The Kremlin says it will wait patiently for an apology.,0,3,6,68,5,15,0,74,0
"American Pharoah bettors leave behind $315,829 from Belmont Stakes",0,2,4,46,2,8,6,50,0
This man in a space suit has a message for Earthlings,0,3,2,41,0,10,0,43,0
Frank Ocean Was Super Psyched About Viola Davis' Oscar Win,0,3,10,38,1,9,0,48,0
"New cancer drugs can cost more than $250,000 a year",0,3,1,33,2,9,6,34,0
"Taking the Pill can trigger mood swings and make women miserable, 'alarming' research confirms",0,3,2,76,3,13,0,78,0
Guy in Court for Traffic Ticket Ends Up Behind Bars After Cocaine Falls Out of His Hat,0,2,14,56,0,16,0,70,0
"Chuck Barris, creator and host of the 'Gong Show,' dead at 87 ",0,3,4,40,4,12,2,44,0
Everything you need to know about House Intel Committee Chairman Devin Nunes ,0,3,7,58,0,12,0,65,0
North Carolina House overrides magistrate same-sex marriage veto,0,3,3,53,1,7,0,56,0
deadmau5 Debuts BBC Radio 1 Residency With Tons of Techno: Listen,0,3,10,42,1,10,2,52,0
88 former military leaders write letter backing Donald Trump for president,0,2,2,60,0,10,2,62,0
Mysterious disease kills 31 in China's Sichuan province,0,1,3,42,1,7,2,45,0
"During Practice Rounds, Marines Were on Lookout for Errant Golfers",0,1,8,48,1,9,0,56,0
DeVos’s Education Department misspells name of NAACP co-founder in tweet — and the apology had a mistake,0,3,9,76,3,16,0,85,0
Seven-year-old tenpin bowler stripped of title for wearing jeans,0,2,1,53,2,8,0,54,0
Nicola Sturgeon calls for second Scottish independence referendum - Politics live,0,2,4,66,1,10,0,70,0
AOL to launch VoIP service,0,1,6,16,0,4,0,22,0
Adelaide United stun Melbourne City with 2-1 victory in A-League,0,3,6,45,2,9,2,51,0
Council funding freeze 'means cuts to many essential services',0,2,1,51,2,8,0,52,0
Man found dead after car crash in Shetland,0,1,2,33,0,7,0,35,0
"Sixteen policemen killed in suspected terrorist attack in Xinjiang, China",0,1,3,60,1,9,0,63,0
Bakari Sellers on Trump order: 'The antithesis of Christianity',0,3,5,47,3,8,0,52,0
A day and a half in the life of a top Wall Street tech analyst,0,3,3,45,0,14,0,48,0
Icelandic Kaupthing Bank earnings soar 292%,0,1,3,31,1,5,3,34,0
A Man Is Accused Of Giving Women Foot Massages Without Their Consent At A Mall,0,3,15,49,0,14,0,64,0
Calgary zoo investigating penguin drowning deaths,0,3,1,43,0,5,0,44,0
"Series of earthquakes hit Korea, Indonesia, Turkey and Norway",0,1,5,46,2,8,0,51,0
Trump won't immediately appeal travel ban halt to Supreme Court,0,3,3,50,1,9,0,53,0
"Pakistan shrine custodian fatally stabs 20 people, police say",0,3,1,49,1,8,2,50,0
Super Typhoon Nock-Ten hammers Philippines,0,2,5,32,1,4,0,37,0
Top conservative group backs Pence health care framework ,0,3,2,47,0,8,0,49,0
Northwestern MutualVoice: Are More Rate Hikes On The Way?,0,3,10,37,2,8,0,47,0
New Zealand Tsunami heroes to receive Special Service Medal,0,1,6,45,0,8,0,51,0
A Revolving Door of Editors and Publishers,0,1,5,31,0,6,0,36,0
A group demanded a space for students of color. Now they say they’re being called racists.,0,3,2,70,3,15,0,72,0
"Primary schools will have unisex bathrooms for the first time, council reveals",0,3,1,65,1,11,0,66,0
"U.S. May Not Be Able To Shoot Down North Korean Missiles, Say Experts",0,2,14,40,3,12,0,54,0
Texas executes Arturo Diaz after US Supreme Court refuses to intervene,0,1,7,53,0,10,0,60,0
Ken Livingstone interview: 'I still tend to say what I believe to be the truth – It’s my big weakness',0,2,5,73,5,19,0,78,0
"Holiday shipping deadlines for UPS, FedEx and major retailers",0,2,6,46,1,8,0,52,0
Bill Belichick has a secret retirement date,0,2,2,35,0,6,0,37,0
Why are you protesting the Trump administration?,0,2,2,39,1,6,0,41,0
"Colo, the oldest gorilla in captivity, dies aged 60",0,3,1,38,2,8,2,39,0
"FA is powerless to stop World Cup expansion, says Martin Glenn",0,3,6,45,1,10,0,51,0
Emmanuel Macron: the French outsider who would be president,0,2,3,47,1,8,0,50,0
Senate Democrats Propose $1 Trillion Infrastructure Plan,0,2,6,42,1,6,1,48,0
Community financial service saves vulnerable people from high-interest payday loans,0,3,1,72,1,9,0,73,0
"Vin Diesel and Selena Gomez Are on Kygo’s New Track ""It Ain't Me""",0,3,11,38,4,12,0,49,0
Will Europe ride populist wave? Visual guide,0,2,3,34,1,6,0,37,0
Federer vs. Nadal: Top five memorable matches,0,3,3,34,2,6,0,37,0
Singapore Defaults Seen as Bellwether for 2017 Asia Distress,0,3,6,42,0,8,4,48,0
"Outbreak of swine flu in Mexico kills at least twenty, infects 1,000",0,1,2,49,2,11,4,51,0
Nine 'illegal immigrants' escape from lorry in Cotswold village,0,3,2,51,2,8,0,53,0
Della Famina to sell Hamptons newspaper to billionaire investor,0,2,3,52,0,8,0,55,0
DeLay declares 'victory' in war on U.S. budget fat,0,1,4,34,4,8,0,38,0
"Rationing of NHS services ‘leaving patients in pain and distress’, says new report",0,3,4,63,3,12,0,67,0
California Senate votes to allow gay marriages,0,1,2,38,0,6,0,40,0
"Activist Bela Bhatia Who Helped Tribal Rape Victims Threatened, Asked To Leave Bastar In 24 Hours",0,3,15,64,1,15,2,79,0
Trump will keep list of White House visitors secret,0,3,3,40,0,8,0,43,0
"Vince Staples Talks His New Album, the Corniness of Beef, and Why Fans Don't Really Care",0,3,13,57,3,15,0,70,0
Laurent Robert joins Toronto FC,0,1,5,22,0,4,0,27,0
"No, Chelsea Clinton is not running for office ... 'right now'",0,3,3,42,6,10,0,45,0
Police investigate Uber rider's claim that L.A. driver sexually assaulted her,0,3,4,60,3,10,0,64,0
Research shows HIV virus may hide in bone marrow,0,1,4,36,0,8,0,40,0
Laid-Off Foreigners Flee as Dubai Spirals Down,0,1,7,32,1,6,0,39,0
Top 2017 Emerging EMEA Picks Are All Things Russia; Avoid Turkey,0,2,13,36,1,10,4,49,0
"Trump's critics are pulling a Trump, using Twitter to troll back",0,2,3,49,2,10,0,52,0
REPORT: Ann Coulter Cancels UC Berkeley Speech,0,3,13,26,1,6,0,39,0
"James Doohan, Star Trek's 'Scotty', dies at 85",0,1,5,27,5,7,2,32,0
U.N. rights chief decries ’bigotry’ in U.S. presidential race,0,2,4,43,6,8,0,47,0
"Mark Sanchez agrees to one-year deal with Bears, sources say",0,3,3,46,2,9,0,49,0
Andy Cohen Thinks Trump Is Pretty Much Just A 'Real Housewife',0,2,11,39,2,10,0,50,0
Worst humanitarian crisis hits as Trump slashes foreign aid,0,3,2,49,0,8,0,51,0
7 Hijabi Bloggers Who Challenge Traditional Notions of Beauty,0,3,7,45,0,8,1,52,0
Watch Live: Golden Globes Nominees Revealed,0,2,6,31,1,5,0,37,0
Virgil Abloh Debuts New Furniture Line at Design Miami,0,2,8,38,0,8,0,46,0
UN official criticises Australia's 'disturbing' number of Aboriginal children behind bars,0,2,4,72,3,10,0,76,0
Do You Want Reagan’s Economy or Obama’s?,0,2,6,25,3,6,0,31,0
Paul Nuttall: Ukip leader announces he will stand in the General Election,0,3,5,56,1,11,0,61,0
"In Tough Economy, N.B.A. Prepares for Talks With Union",0,1,10,32,4,8,0,42,0
"What's New on Netflix, iTunes, Hulu and Amazon for January - Yahoo",0,3,8,43,4,11,0,51,0
NZ opposition leader admits to fundamentalist contacts,0,1,2,46,0,6,0,48,0
Russian geographer Andrey Kapitsa dies aged 80,0,1,3,35,0,6,2,38,0
By the numbers: Why millions go uninsured under Republicans' Obamacare alternative,0,3,4,66,2,10,0,70,0
Court Favors Karzai Term Until Election,0,1,6,28,0,5,0,34,0
Passengers from hijacked Libyan plane leave Malta and return home ,0,3,3,53,0,10,0,56,0
"Several large explosions reported in Xinjiang, China",0,1,3,42,1,6,0,45,0
Do LeBron James and Other NBA Stars Really Hate Steph Curry?,0,3,13,36,1,10,0,49,0
"In Minnesota, Big Moment for a Temple for Hindus",0,1,6,33,1,8,0,39,0
This 8-bit ‘A Christmas Story’ retelling is way better than meatloaf,0,3,4,50,3,10,1,54,0
Ariane rocket launches Vietnam's first satellite,0,1,2,40,1,5,0,42,0
"Massachusetts 4 Children, Mother Die in Warwick, Mass. House Fire",0,2,8,44,3,9,1,52,0
The most moved-from state in the US is...,0,3,3,27,4,7,0,30,0
Say Goodbye To The Overhead Bin With American Airlines' New 'Basic Economy' Ticket,0,3,13,54,3,12,0,67,0
Bruce Allen faces greatest Redskins challenge: Getting Daniel Snyder a new stadium deal,0,3,6,68,1,12,0,74,0
How Toshiba Lost $6 Billion,0,3,4,17,1,4,1,21,0
What does LOL look like in space?,0,2,4,22,1,6,0,26,0
Resale market for Super Bowl tickets slips after Cowboys ousted,0,3,4,50,0,9,0,54,0
'Aleppo is being destroyed by the silence of the world',0,3,1,43,2,9,0,44,0
Ms. Frizzle Made The March For Science Protests Magical,0,3,9,37,1,8,0,46,0
"Rape of girl, allegedly by 2 teens, one here illegally, offers new details ",0,3,1,57,3,13,1,58,0
NFL Former NFL RB Jamal Anderson Avoids Arrest After Exposing Penis at Gas Station,0,3,18,51,0,13,0,69,0
Ben Affleck Says That He's Finished Treatment For 'Alcohol Addiction',0,3,10,47,3,9,0,57,0
Fatal Overdoses From Fentanyl Sold as Cocaine Detailed in Harrowing CDC Report ,0,3,12,55,0,12,0,67,0
The Italian design duo who will sex up your home,0,2,2,37,0,9,0,39,0
UPS Takes a Stake in Retail Returns Specialist Optoro,0,3,9,36,0,8,0,45,0
The percentage of empty storefronts in malls barely moved last quarter,0,2,1,59,0,10,0,60,0
Fake News: New York Times Targets Breitbart for Reporting Truth - Breitbart,0,2,10,52,2,11,0,62,0
Two roadside bombs kill at least 14 in Afghanistan,0,1,2,38,0,8,2,40,0
"Los Angeles Dodgers Kenley Jansen Re-Signs with Dodgers: Latest Contract Details, Comments, Reaction",0,2,13,71,4,12,0,84,0
"Pickup truck plows into New Orleans parade crowd, 28 injured ",0,3,3,45,1,10,2,48,0
"Countries around the world send aid, help to Haiti",0,1,2,39,1,8,0,41,0
Departing U.S. Ambassador Warns Against Quick Withdrawal From Iraq,0,1,10,46,2,8,0,56,0
Marlins plan bronze statue of Jose Fernandez in ballpark plaza,0,3,3,50,0,9,0,53,0
Yankees Rally to Beat Lidge and Phillies in Ninth,0,1,6,35,0,8,0,41,0
Donald Trump Says He’s Not Surprised by Meryl Streep’s Golden Globes Speech ,0,3,11,51,2,12,0,62,0
Barack Obama accepts US presidential nomination from the Democratic Party,0,1,6,58,0,9,0,64,0
Woman born without a vagina has genital organ created using her own INTESTINE in pioneering operation ,0,3,10,76,0,16,0,86,0
Chile announces official list of players for South Africa Football World Cup,0,1,6,59,0,11,0,65,0
Nine killed as protests spread to Kandahar over Qur'an burning,0,1,3,49,1,9,0,52,0
Olympic Champion Wanjiru Leads a New Wave of Marathoners,0,1,7,41,0,8,0,48,0
Theresa May Scolds Kerry for Focus on Israel Settlements ,0,3,7,41,0,9,0,48,0
British Airways jet makes rough landing at London City Airport,0,1,5,48,0,9,0,53,0
Balloons let loose for triple murder victim,0,1,1,36,0,6,0,37,0
British government scraps planned rules on pay equality,0,1,1,47,0,7,0,48,0
US actor Patrick McGoohan dead at age 80,0,1,5,26,0,7,2,31,0
Angie Martinez to Develop TV Projects With Endemol Shine,0,2,9,39,0,8,0,48,0
"Flynn saga shifts balance of power between president, Congress",0,3,2,51,1,8,0,53,0
B.P. Scales Back Investment After Drop in Profit,0,1,8,31,2,7,0,39,0
White House Says Trump’s Wiretap Claim Was Meant More Broadly ,0,3,10,41,1,10,0,51,0
House Top 40: Flipping Control Still A Tough Task For Democrats,0,2,10,40,1,10,2,50,0
"Terror alert in Delhi, Mumbai, Kolkata, and Chennai",0,1,5,36,3,7,0,41,0
Tippi Hedren on Doris Day and ‘Sentimental Journey’,0,3,6,36,2,7,0,42,0
Tiniest feminist held up a very important sign at the Women's March,0,3,3,52,1,11,0,55,0
"NATO and Russia talked for 3 hours, but they're still as divided as ever on Ukraine",0,3,6,59,2,15,1,65,0
Is Supreme's Nike Uptempo Collaboration a Disappointment or a Slam Dunk?,0,2,8,52,2,10,0,60,0
These Photos Posted By People Of Color In Love Make A Beautiful Point,0,3,13,44,0,12,0,57,0
Indonesian passenger plane crashes in mountains,0,1,1,41,0,5,0,42,0
Gloria Steinem Refuses to Pay Taxes If Planned Parenthood’s Funding Eliminated,0,2,10,57,1,10,0,67,0
Takata’s $1 Billion Air-Bag Settlement Could Make a Sale Easier,0,2,9,41,3,9,1,50,0
"International Women's Day 2017 and the #March4Women: What is it, how did it start and why is it still needed?",0,3,6,74,5,19,5,80,0
Did You Miss the Presidential Debate? Here Are the Highlights - The New York Times,0,2,12,54,2,14,0,66,0
"Explosions in Hyderabad, India",0,1,3,23,1,3,0,26,0
Investors Find an Appetite for Tech Offerings,0,1,5,34,0,6,0,39,0
100 Of Cher’s Best Tweets From 2016,0,3,5,16,1,6,7,21,0
"Lawmakers react to Trump's inauguration with criticism, optimism",0,2,2,53,2,7,0,55,0
DHS bulletin urges law enforcement to be on high alert ahead of 9/11 anniversary,0,2,3,60,1,13,3,63,0
Bill Gates' wicked sense of humor really shines on Reddit â see for yourself,0,3,3,59,3,13,0,62,0
Is This the Way a Woman Will Reach the White House? ,0,2,8,32,1,11,0,40,0
Nigerian election result will not be annulled,0,1,1,38,0,6,0,39,0
Moussa Dembélé scores as Celtic beat Hamilton for 21st straight win,0,3,4,51,0,10,2,55,0
French election: Marine Le Pen stands down from National Front party ahead of May 7 vote,0,3,7,64,1,15,1,71,0
Controversial rapper dethrones Mariah Carey from No. 1,0,1,4,41,1,7,1,45,0
Hugh Jackman never turned his back on Wolverine,0,3,3,37,0,7,0,40,0
Drop in Net Income and a Warning From U.P.S.,0,1,8,25,3,8,0,33,0
"Ritual sacrifice in Nepal sees 320,000 animals slaughtered to Hindu goddess",0,1,3,55,1,10,6,58,0
"Now Twitter Joins Fight Against Trump, Staff Donates $1.59 Million To Challenge His Visa Ban",0,3,14,58,3,14,3,72,0
Trump secretary of state candidate says Russian hacking reports might be 'false flag',0,2,2,69,2,12,0,71,0
"Judge rules woman can't sue Trump over calling her a ""dummy"" on Twitter",0,2,3,53,3,12,0,56,0
Man Attempts to Light Himself on Fire in DC to Protest Trump's Election  Insider,0,3,11,54,1,14,0,65,0
Florida Sex Worker Arrested for Offering Police Officer Oral Sex in Exchange for Taco Bell,0,2,12,64,0,14,0,76,0
"Philly’s Drink Tax Is Hurting Consumers, Businesses, and the Poor",0,2,8,45,3,9,0,53,0
Study finds a single weekend camping trip can help people get to sleep earlier,0,3,1,64,0,13,0,65,0
"Meet Headspace, The App That Made Meditation A $250 Million Business",0,2,10,43,2,10,3,53,0
Donald Trump Agrees Not to Talk Publicly About Mexico Paying for Border Wall,0,2,11,53,0,12,0,64,0
George Clooney Remembers His Late Cousin Miguel Ferrer: He ‘Made the World Brighter’,0,3,12,57,3,12,0,69,0
At least 41 killed in bombings in Iraq,0,1,2,27,0,7,2,29,0
The desperate families fleeing eastern Aleppo,0,2,2,38,0,5,0,40,0
Los Angeles Woodsy Pop Duo JOME Returns With Blissful New Single 'Mountains': Exclusive Premiere,0,3,17,63,3,13,0,80,0
Brazil footballer 'survived Colombia crash by moving seats',0,3,2,48,2,7,0,50,0
Sleeping Passenger Awakens to Exploding Headphones During Flight,0,2,7,50,0,7,0,57,0
"British government apologises for suggesting the Pope could create a brand of ""Benedict"" condoms",0,1,3,78,2,13,0,81,0
US vice president Biden says Iran sanctions likely by early May,0,1,5,48,0,10,0,53,0
Are Apple iPhone 8 Rumors Titillating Enough To Entice Android Loyalists?,0,3,10,51,1,10,1,61,0
"A ""Top Chef"" Alum Is Trolling Trump With A Pro-Immigrant Message On His Receipts",0,3,15,49,3,13,0,64,0
Charter Companies Flying to Cuba Thrive Despite Complaints,0,1,7,44,0,7,0,51,0
"‘Abandoned’ in New Jersey, Chris Christie Returns to a Changed Landscape ",0,3,8,51,3,11,0,59,0
United States Senator Ted Kennedy rushed to the hospital,0,1,5,43,0,8,0,48,0
"Explosion At French Nuclear Plant, No Risk Of Contamination Or Leakage Yet!",0,3,12,50,2,11,0,62,0
‘The War on Coal Is Over’: Donald Trump Signs Energy Executive Order,0,3,11,43,3,11,0,54,0
Why ‘The Outsiders’ Lives On: A Teenage Novel Turns 50 ,0,2,9,31,3,10,2,40,0
Everything You Need To Know About Hong Kong's Curiously Undemocratic Leadership Vote,0,2,12,60,1,11,0,72,0
Obama Confronts Complexity of Using a Mighty Cyberarsenal Against Russia ,0,3,8,55,0,10,0,63,0
Elderly man in Scotland dies after contracting H1N1 swine flu virus,0,1,4,51,0,10,2,55,0
"Housing affordability: Blame supply for high prices, not tax breaks, says former banker",0,2,2,70,3,12,0,72,0
Probe: Brussels Airport Bombers ‘Wanted to Kill Jews and Americans’,0,2,8,47,3,9,0,55,0
Australia's New South Wales Fire Brigades in crisis over bullying,0,1,6,49,1,9,0,55,0
DETAILS: Utah Man Killed in London Attack While on 'Dream Vacation' With Wife  Insider,0,2,18,51,3,14,0,69,0
"Wikinews interviews journalist Konrad Godlewski, who uncovered BATUTA hoax",0,1,9,56,1,8,0,65,0
Sen. McCain calls Michael Flynn’s request for immunity 'unusual' ,0,3,5,47,4,9,0,52,0
Luxembourg votes Yes to the EU treaty,0,1,4,27,0,6,0,31,0
Arsenal rediscover swagger at Swansea before Alexis Sánchez rages again,0,3,4,58,0,9,0,62,0
"In This Recession, More Men Are Losing Jobs",0,1,8,27,1,7,0,35,0
US presidential race tied as the Democratic National Convention starts,0,1,5,56,0,9,0,61,0
WH Invokes Leaks After Brennan Confirms Trump Camp-Russia Contacts,0,2,11,46,1,8,0,57,0
Scotland stun Ireland as last-gasp Greig Laidlaw penalties seal Six Nations win,0,3,6,61,1,11,0,67,0
Ralph Nader enters US presidential race as independent,0,1,4,43,0,7,0,47,0
Asian parents: Your kids are not robots,0,3,2,30,1,6,0,32,0
"Crucifixes can be displayed in state schools, European court rules",0,1,2,54,1,9,0,56,0
Monkman v Seagull: friendship is winner in University Challenge showdown,0,3,4,58,1,9,0,62,0
Travis Scott's Mother Jokingly Dragged Him for His Twitter Typos,0,3,9,45,1,9,0,54,0
'I'm asking you a simple question': Fox News host confronts RNC chair over Trump's denial of Russia hacks,0,3,8,75,5,17,0,83,0
Donald Trump to repeal Obama-era water rule to allow draining of wetlands and streams,0,3,3,68,1,13,0,71,0
Liberal democracy is facing its worst crisis since the 1930s,0,3,1,46,0,9,4,47,0
The astonishing Amazon 'anumeric' people whose language has no words for numbers,0,3,2,65,2,11,0,67,0
U.S. Marines Enter Syria to Aid Fight for ISIS’ Capital Raqqa,0,3,13,35,3,10,0,48,0
Janelle Monae & More Performers Announced for Women's March,0,3,7,42,2,8,0,49,0
Obama: Sasha And Malia Work A Lot Harder Than I Did As A Kid,0,3,14,32,1,13,0,46,0
"11 revealing answers DeVos gave to Democratic senators’ questions about vouchers, Common Core and more",0,3,5,79,2,14,2,84,0
HP’s Spectre x360 bulks up to add power and battery,0,3,3,35,1,9,3,38,0
"Lion Ted: Cruz Challenges Media, Champions Truth Through Far-Left’s Smear of Jeff Sessions",0,3,13,61,4,12,0,74,0
"Toddlers Dress Up in Celeb Golden Globe Looks, and It’s Adorable [Video]",0,2,10,47,4,11,0,57,0
Republicans to Introduce Health Care Replacement Bill This Week,0,3,8,47,0,8,0,55,0
Obama Actually Writes Back To People Who Call Him An Idiot,0,3,11,37,0,10,0,48,0
A Woman on a Mission to Integrate the Boys Club of Action Sports,0,3,8,44,0,12,0,52,0
Stone Age Flutes Found in Germany Offer Clues to Early Music,0,1,9,41,0,10,0,50,0
"Seven Years Later, Mickelson Remains a Man of the People",0,1,7,39,1,9,0,46,0
Michelle Obama's Twitter Farewell: 'Being Your First Lady Has Been the Honor of a Lifetime' ,0,3,12,61,4,15,0,73,0
12 Runs Throughout The Year That Your Fibit Can Help You Stay Motivated For,0,2,13,47,0,13,2,60,0
"Trump, Egypt's president meet to talk terrorism, foreign aid ",0,2,2,47,3,9,0,49,0
What'd You Miss,0,3,3,9,1,2,0,12,0
17 Great Books About American Presidents for Presidents’ Day Weekend ,0,2,8,48,1,10,2,56,0
2008 Olympic torch arrives in London,0,1,2,25,0,5,4,27,0
Guinea-Bissau to hold elections this June,0,1,3,32,1,5,0,35,0
Twitter apologizes for mistakes around @POTUS account,0,3,6,40,1,6,0,46,0
Chuck Berry: His Life in Photos,0,3,5,20,1,5,0,25,0
Financial stress: We're worrying ourselves sick over money Featured Stories Additional stories,0,2,5,76,2,11,0,81,0
Kellyanne Conway says her Bowling Green interview won praise — before the ‘haters’,0,3,4,63,3,12,0,67,0
German and Swedish foreign ministers agree on Gaza standpoint,0,1,3,50,0,8,0,53,0
The Famous ‘Mary Tyler Moore Show’ House Is Up for Sale,0,3,10,33,2,10,0,43,0
Giuliani blasts Beyoncé for ‘attack’ on cops,0,2,2,34,2,6,0,36,0
3 Steps For Creating Half A Trillion Dollars,0,3,7,29,0,7,1,36,0
Open software developers meet at FOSDEM 2008,0,1,7,27,0,6,4,34,0
"Nelly Furtado on Dev Hynes, Going Indie & Why 'The Ride' Is Her 'Hangover Album'",0,3,13,47,6,14,0,60,0
Gruesome ISIS video shows Turkish soldiers burned alive ,0,3,6,42,0,8,0,48,0
"OSU attack suspect visited Washington DC area days earlier, source says ",0,3,6,54,1,11,0,60,0
Brexit Disruptors Challenge Government’s Plans in Court,0,3,6,42,1,6,0,48,0
Kendrick Lamar's lyrics about photoshop and stretch marks are sparking a lot of feelings,0,2,2,72,1,13,0,74,0
Singer George Michael Dies at Age 53,0,3,5,23,0,6,2,28,0
"In Scientology and the Aftermath, Leah Remini Strikes Back",0,2,7,42,1,8,0,49,0
Expert: 2 escaped convicts are likely still together - CNN Video,0,3,5,46,2,10,1,51,0
"Kobe Bryant's Last Game, from the Players, Reporters and Coaches Who Were There",0,2,10,54,3,12,0,64,0
Trump's Son-In-Law Jared Kushner To Face Questions On Russia Ties,0,3,12,41,3,9,0,53,0
Syria war: Evacuations resume after deadly bombing,0,2,2,41,1,6,0,43,0
Cambodia's water people pushed out of Phnom Penh sewer for billion-dollar ING City,0,3,7,61,2,12,0,68,0
Tokyo Briefly Halts Subway Trains After North Korea Missile Test,0,3,10,45,0,9,0,55,0
Las Vegas Woman Who Walked 26 Miles in Snowy Grand Canyon to Save Family Tells Ordeal,0,3,13,55,0,15,2,68,0
FAA: Jets at New York airport directed by child,0,1,6,32,1,8,0,38,0
White House Appears Ready to Go to the Mat for Its Border Wall,0,2,9,41,0,12,0,50,0
Robin Thicke to Honor His Mother for VH1's Second Annual 'Dear Mama' Special,0,3,12,48,3,12,1,60,0
Widening ethnic cracks raise fears of new war in Bosnia,0,2,2,44,0,9,0,46,0
Rocky Mountain News Is Closing in Denver,0,1,6,28,0,6,0,34,0
"The best movies and TV shows coming to Amazon, iTunes, Hulu, and more in March",0,2,7,54,3,14,0,61,0
Iraqis React to Revised Travel Ban,0,3,5,24,0,5,0,29,0
DON'T PANIC! That Bacon Shortage You Keep Hearing About Isn't Real,0,2,18,35,3,10,0,53,0
Papua New Guinea at risk of AIDS epidemic,0,1,7,27,0,7,0,34,0
"Modi’s Cash Ban May Help India Cut Taxes, Power Minister Says",0,3,11,38,2,10,0,49,0
US and French elections: Spot the difference,0,3,4,33,1,6,0,37,0
Ski Lost in space: In search of backcountry adventures in Klosters,0,3,4,51,1,10,0,55,0
House of Lords approve same-sex marriage bill at third reading,0,1,2,50,1,9,0,52,0
Taliban replaces leader killed in U.S. drone strike,0,2,3,39,2,7,0,42,0
Orlando promises the future of self-driving cars... at Disney World,0,3,3,51,4,9,0,54,0
"The chain collision of Pepsi, United and Sean Spicer fail — in one meme",0,3,5,51,2,13,0,56,0
Kate McKinnon Brought Back Her Hilarious Jeff Sessions Impression on 'Weekend Update',0,3,12,60,2,11,0,72,0
Rituals of the Rich Meet Realities of the Economy,0,1,5,36,0,8,0,41,0
Obama delays arrival to Copenhagen summit by one week,0,1,2,43,0,8,0,45,0
South Africa defeats Australia in second cricket test,0,1,3,43,0,7,0,46,0
"Mom's warning about ""human trafficking"" at IKEA goes viral; what you need to know",0,3,5,59,4,13,0,64,0
Arsenal fall out of top four as Boro woes go on – Football Weekly,0,3,4,47,1,13,0,51,0
Europe will send a rover to Mars but won’t protect Earth from an asteroid,0,2,3,56,1,13,0,59,0
"Mac Miller Releases Epic New Video for ""Cinderella"" f/ Ty Dolla Sign",0,3,10,44,3,11,0,54,0
Finland pays unemployed citizens a monthly income in trial,0,3,1,49,0,8,0,50,0
Cathay Pacific Cuts Costs as Air Travel Remains Sluggish,0,1,8,40,0,8,0,48,0
"Stars react to death of George Michael: ""He was an absolute inspiration""",0,3,4,54,3,11,0,58,0
Kim Jong-nam: VX dose was 'high and lethal',0,2,4,28,4,7,0,32,0
Sound of crickets 'could become a thing of the past',0,3,1,40,2,9,0,41,0
Donald Trump’s Presidency: A Look at His Proposed Policy Shifts,0,3,9,43,2,9,0,52,0
A Last-Place Standout,0,1,4,14,1,2,0,18,0
"ATTACK AT THE LOUVRE: Machete-wielding man shouting ‘Allahu akbar’ stopped by soldier, police say ",0,2,19,60,5,14,0,79,0
Rohingya Muslims in Myanmar are suffering. The world mustn’t look away,0,2,4,54,2,10,0,58,0
Timeline of the alleged kidnapping of Tennessee student Elizabeth Thomas ,0,2,4,59,0,10,0,63,0
"Ahoy, Johnny Depp! He raids his own treasure chest like a pirate",0,3,4,47,2,11,0,51,0
Morning brief: Dems hope for an upset in Georgia special House election ,0,3,4,55,1,12,0,59,0
Study concludes 9/11 firefighters are 19% more likely to develop cancer,0,1,1,53,2,10,5,54,0
AL West Rivals Mariners and A's Trade Shots in Spring Training Twitter Battle,0,2,12,52,1,12,0,64,0
Marijuana Advocates Point to Signs of Change,0,1,5,33,0,6,0,38,0
"Tim Tebow Reports to Mets Spring Training, Says He Hopes to Play at MLB Level",0,3,14,48,1,14,0,62,0
30 Under 30 2017: Marketing & Advertising,0,3,3,22,2,6,8,25,0
Witness Describes Fatal Crash At Berlin Market - Video - NYTimes.com,0,2,11,44,3,10,0,55,0
Joel Embiid to Undergo Surgery on Meniscus Tear in Knee,0,3,7,39,0,9,0,46,0
Watch Out Boy! Today in 1982 Hall & Oates Took on a 'Maneater',0,3,8,34,4,12,4,42,0
Ten dead after earthquake in Bhutan,0,1,2,28,0,5,0,30,0
Would you use this? Parents are sticking decorations to their babies' heads with 'Girlie Glue',0,3,4,72,4,14,0,76,0
These plant 'Twins' are named after Danny Devito and Arnold Schwarzenegger,0,3,6,56,2,10,0,62,0
MillerCoors and Asics Bring Action to Ads on ESPN,0,1,10,31,0,8,0,41,0
"Derek Jeter, wife Hannah expecting their first child",0,2,3,41,1,7,0,44,0
Pope opens free laundromat for Rome's poor,0,3,2,33,1,6,0,35,0
"Body of a Somali Pirate, Carrying $153,000 of a Ransom, Washes Ashore",0,1,7,41,4,11,6,48,0
13 Comics That Will Get You If You’re Having A Rough Time,0,3,11,32,1,11,2,43,0
Teacher turns 'Bad and Boujee' into an educational song about the Civil War,0,3,5,56,2,12,0,61,0
Dear President Trump: Everyday Americans share messages to the 45th president,0,3,5,59,1,10,2,64,0
Homeopathy proponents jailed for allowing daughter to die,0,1,1,49,0,7,0,50,0
LulzSec claims Sony network hack,0,1,3,25,0,4,0,28,0
Trump Called National Park Chief Over Twitter Post on Inaugural Crowd ,0,3,10,49,0,11,0,59,0
Republicans Say They Assume Trump Didn’t Mean To Promise Health Insurance For All,0,2,13,55,1,12,0,68,0
White Lives Matter Has Been Declared a Hate Group - The New York Times,0,2,12,44,1,13,0,56,0
Big Executive Orders,0,2,3,15,0,2,0,18,0
8 Gorgeous Gemstones To Wear On Your Engagement Ring,0,2,8,35,0,8,1,43,0
European Parliament committee backs visa-free travel for Balkan countries,0,1,3,61,1,8,0,64,0
Meek Mill Laughs Off Rumours Linking Him To Nicki Minaj’s Recent Robbery,0,3,12,48,1,11,0,60,0
North Carolina Faces Extra Benefits Charge,0,3,6,31,0,5,0,37,0
Kim Jong-nam: Malaysia expecting more arrests in murder investigation,0,2,3,56,2,8,0,59,0
Japanese court rules against paedophile in 'right to be forgotten' online case,0,2,1,64,2,11,0,65,0
"Frank Ocean Debuts New Song ""Chanel"" on His Beats 1 Show",0,3,9,34,2,10,1,43,0
White House Chief of Staff Rahm Emanuel steps down to run for Mayor of Chicago,0,1,8,56,0,14,0,64,0
"Fan Loses Bet on Warriors-Rockets, Gets Taped to Yield Sign, Explains to Cops",0,2,11,51,3,12,0,62,0
Aussies ignore flag ban at Big Day Out festival,0,1,4,35,0,8,0,39,0
High school junior takes his 93-year-old grandmother to prom - Yahoo,0,3,2,51,3,10,2,53,0
Four arrested in Birmingham UK in connection with July 21 attempted bombings,0,1,5,58,0,11,2,63,0
Farhan Akhtar Gives The Perfect Response To Abu Azmi's Remarks On Bengaluru Mass Molestation,0,3,14,64,1,13,0,78,0
Italian authorities disrupt scheme to steal Enzo Ferrari’s body and hold it for ransom,0,2,3,69,1,13,0,72,0
The Super Bowl gave everyone terrible election night flashbacks,0,3,3,52,0,8,0,55,0
Solar-powered plane completes 26-hour flight,0,1,1,35,2,4,2,36,0
Interview: Danny O'Brien of the Electronic Frontier Foundation,0,1,7,46,2,7,0,53,0
Is a vegetarian diet really more environmentally friendly than eating meat?,0,3,1,63,1,10,0,64,0
Disney’s ‘Zootopia’ and ‘Moana’ will battle it out for Golden Globes’ best animated film,0,3,5,64,6,13,0,69,0
RNC clarifies part of Christmas message after social media criticism ,0,2,4,55,0,10,0,59,0
"Missing woman, 20, found dead in car pulled from Missouri River, report says ",0,3,3,56,3,13,2,59,0
Photos Capture Panic And Chaos After Deadly Ft. Lauderdale Airport Shooting,0,3,11,53,1,10,0,64,0
Space Shuttle Discovery successfully lifts off on mission STS-128,0,1,6,47,1,8,3,53,0
Muslim Women Swimmers Have Earned The Right To Compete In 'Burkinis' In England,0,2,13,52,2,12,0,65,0
'Disappearing' golden eagle sparks murder mystery row on Scottish estate,0,3,2,59,2,9,0,61,0
The king of Sweden is urging news organizations to report 'seriously' on the country,0,2,2,67,2,13,0,69,0
"Counted Out, U.S. Advances in Confederations Cup",0,1,7,32,3,6,0,39,0
"Despite Recession, Demand for Skilled Labor Is High",0,1,7,36,1,7,0,43,0
Beware the Zombie Bowl Games! ,0,2,4,20,1,5,0,24,0
Yahoo launches new Podcast Search,0,1,3,26,0,4,0,29,0
New moth named in honor of Donald Trump,0,3,3,29,0,7,0,32,0
"Mall of America, Nation's Biggest, Hires First Black Santa ",0,3,8,39,3,9,0,47,0
Which Queensland state seats could Pauline Hanson's One Nation win?,0,3,6,50,2,9,0,56,0
Donald Trump protests: Limo 'set on fire' and 217 arrested as police use tear gas on black-clad activists,0,3,3,78,4,17,3,81,0
Third person charged in stabbing death of Conn. man last seen at NYC party,0,2,5,55,1,13,0,60,0
Quake Fears Stall Energy Extraction Project,0,1,6,32,0,5,0,38,0
NSW weather: Three women hit by lightning as storms and hail hit Sydney and Wollongong,0,3,6,65,1,14,0,71,0
First-Ever Overtime Super Bowl Attracts 111.3 Million TV Viewers,0,3,10,40,2,8,4,50,0
"Joey Barton charged by Football Association over breach of betting rules... 1,260 bets over a 10-year period",0,2,4,77,5,16,6,81,0
3-Year-Old Boy Fatally Shot in Arkansas Road Rage Incident,0,3,9,38,2,8,1,47,0
"Ahead of Pro-Trump Rally, KKK Members Claim They're 'Not White Supremacists'",0,3,13,48,5,10,0,61,0
The draft history of players already in the Hall of Fame puts Tom Brady's improbable career in perspective,0,3,5,83,1,17,0,88,0
North Korea: Why military action will be a disaster and a patient solution is required,0,3,3,68,1,14,0,71,0
Live Updates: Manhunt Underway For New Berlin Attack Suspect,0,2,9,42,1,8,0,51,0
Adele dedicates song to her 'soul mate' London in an emotional tribute,0,3,2,55,2,11,0,57,0
"Obama's first State of the Union speech focuses on economy, jobs",0,1,3,49,2,10,0,52,0
Biology and Technology Intersect to Create Art,0,1,5,35,0,6,0,40,0
"North Carolina terrorist ring broken up, seven arrested",0,1,2,45,1,7,0,47,0
Why the ultra-rich are scooping up real estate and ditching hedge funds [Video],0,2,2,62,3,12,0,64,0
A question of trust? Anderson report lays out tests for surveillance laws,0,2,2,59,1,11,0,61,0
"Behind Red Tides, the Swimming and Shape of Plankton",0,1,6,37,1,8,0,43,0
Obama Most of the world doesnât actually see America the way Trump said it did,0,2,4,60,2,14,0,64,0
Few clues on casualties at site of huge U.S. bomb in Afghanistan,0,2,4,47,2,11,0,51,0
'Harry Potter' Actor Jim Tavaré Breaks Neck In Horrific Head-On Car Crash,0,3,13,46,3,11,0,59,0
Ecamm Offers a Wireless Webcam for Macs,0,1,5,28,0,6,0,33,0
Iran seals $16.6B Boeing deal to buy 80 planes ,0,3,3,28,2,9,5,31,0
Senate Democrat Urges Obama To Ensure The CIA Torture Report Won't Disappear,0,2,14,50,1,11,0,64,0
Trump's speech: How'd he do?,0,2,2,18,4,4,0,20,0
Emma Watson 'Beauty and the Beast' doll mocked for looking 'like Justin Bieber',0,2,6,57,4,12,0,63,0
Bahrain executes 3 men convicted in bombing that killed police,0,2,1,51,0,9,1,52,0
Police Officer Ties Tie for Speeding Student,0,3,6,32,0,6,0,38,0
Missouri Is Too Much for Cornell,0,1,5,22,0,5,0,27,0
Trump-Branded Heroin Produces the Latest ‘Florida Man’ Headline,0,3,8,45,3,7,0,53,0
A Better Way to Walk On Ice: Think Like a Penguin,0,3,9,29,1,10,0,38,0
New York prison break: Dogs pick up escapees' scent about mile from prison,0,2,3,57,2,12,0,60,0
"Tennis Star Stanislas Wawrinka Smashes Opponent's Balls, Says Sorry Afterwards!",0,3,10,57,3,9,0,67,0
"Alex Rodriguez Comments on Retirement, Says There's 'Zero' Chance of MLB Return",0,3,12,52,4,11,0,64,0
NYC Mayor Bill de Blasio: Residents Shouldn't Be 'On the Hook' for Trump Security,0,2,13,51,4,13,0,64,0
Chicago Cubs Receive 2016 World Champion Commemorative Mitts,0,2,7,42,0,7,4,49,0
Brexit Bill: These are the MPs who voted against the £350m NHS amendment,0,3,8,47,2,12,3,55,0
"First, an Awful Year for Mutual Funds. Now, the Tax Bill.",0,1,8,35,4,10,0,43,0
Charles Manson releases album under free license,0,1,2,40,0,6,0,42,0
Carson Is New Sign Trump Plans to Govern From the Right ,0,3,9,36,0,11,0,45,0
German opposition launches election campaign,0,1,1,39,0,4,0,40,0
The Grand Tour's Christmas special is eye-wateringly lavish – The Beach (Buggy) Boys Part 1 review,0,3,9,68,5,15,1,77,0
"At first, 55 schools faced sexual violence investigations. Now the list has quadrupled.",0,3,2,68,3,12,2,70,0
Suicide bomber strikes Israeli coastal town,0,1,2,36,0,5,0,38,0
Justices Hear Case on Tuition for Disabled,0,1,5,31,0,6,0,36,0
FEMA accused of misusing trained disaster workers as public-relations workers,0,1,4,63,1,9,0,67,0
Car bomb in Turkey kills 13 soldiers amid growing resistance from separatist Kurds,0,3,3,65,0,12,2,68,0
Donald Trump's Fight With Hotel Workers In Las Vegas Comes To An End,0,2,13,42,1,12,0,55,0
"Megyn Kelly’s Jump to NBC From Fox News Will Test Her, and the Networks ",0,2,13,43,2,14,0,56,0
"James Corden won't be host of 'Carpool Karaoke' spin-off, but tons of other celebrities will be",0,3,4,71,5,15,0,75,0
"Motorola to Cut 4,000 More Jobs",0,1,4,17,1,5,4,21,0
"Fleeing U.S. for Asylum, and Handcuffed in Canada - The New York Times",0,2,10,44,4,12,0,54,0
"Redskins miss out on in-demand Wade Phillips, who agrees to terms with Rams",0,2,4,57,2,12,0,61,0
"Texas flooding puts Cruz, GOP in bind on climate change",0,2,5,40,1,9,0,45,0
Trump praises 'very smart' Putin for not expelling US diplomats,0,3,4,48,2,9,0,52,0
US Election 2016 Donald Trump blasts reports he'll produce Apprentice while US president,0,3,8,63,1,12,4,71,0
Ed Miliband performs a-ha’s hit Take on Me on The Last Leg skit – video,0,3,7,47,3,14,0,54,0
George Michael's partner Fadi Fawaz says the pop star died alone,0,3,4,49,1,10,0,53,0
Israelis hold mass marijuana smoking protest outside parliament,0,3,1,55,0,7,0,56,0
The White House reportedly wants to rename a government anti-terrorism program to focus only on Islam,0,3,4,81,1,15,0,85,0
NAACP Chapter President Rachel Dolezal Plans to Address Race Controversy Monday,0,3,14,55,0,10,0,69,0
Beware Of The Beautiful Resume,0,3,5,21,0,4,0,26,0
"As Military Moving Costs Rise, It’s Difficult For Officials To Keep Track",0,2,12,48,2,11,0,60,0
Facebook reaction GIFs could soon finally be a thing,0,2,4,40,0,8,0,44,0
"Bruins Beat Hurricanes, 4-0, and Stay Alive",0,1,5,27,3,6,2,32,0
Samsung will reportedly reveal results of investigation into why some Galaxy Note 7 caught fire this month,0,2,3,86,0,16,1,89,0
Panama-flagged ship hijacked off Somali coast by pirates,0,1,2,46,1,7,0,48,0
"Queen's Birthday Honours: BEM for Katie Cutler, beautician who helped mugging victim Alan Barnes",0,3,10,70,3,13,0,80,0
Scotland defeats England 15-9 to win Calcutta Cup,0,1,4,34,1,7,3,38,0
"The xx Debuts at No. 2 on Billboard 200 Chart, The Weeknd Holds at No. 1",0,3,9,40,3,15,5,49,0
"Australian startups need more diversity to thrive, not closed borders",0,3,1,58,1,9,0,59,0
U.S. Close to Deal With Colombia on Base Access,0,1,8,29,2,8,0,37,0
Comey gives Hillary a closing argument,0,2,2,31,0,5,0,33,0
Family buys a cadaver to bury with their dead son as a 'ghost bride' but she comes back to LIFE in the coffin,0,3,5,80,2,22,0,85,0
CIA director: Trump equating intelligence community with Nazi Germany is 'outrageous',0,3,6,66,3,10,0,72,0
Donald Trump Narrows List of Supreme Court Nominees,0,3,7,37,0,7,0,44,0
"Bird Flu confirmed in 1,000 UK turkeys",0,1,4,23,1,6,4,27,0
Olympic torch reaches Hong Kong,0,1,3,24,0,4,0,27,0
Jamie Lynn Spears' 8-Year-Old Daughter Reportedly In Critical Condition After Accident [UPDATE],0,3,18,60,5,11,1,78,0
Americans Accused of Stealing Fuel in Iraq,0,1,5,31,0,6,0,36,0
Rebels Routed in Sri Lanka After 25 Years of War,0,1,7,30,0,9,2,37,0
Trump’s firing of Comey seems ’suicidal’ — but it could ’energize’ the Russia probe,0,2,3,61,6,13,0,64,0
Oscars 2017: Celebrities react to 'Moonlight' actually winning best picture after mix-up ,0,2,3,66,4,12,4,69,0
Sixteen people feared dead after helicopter crash in North Sea,0,1,3,50,0,9,0,53,0
Afghan presidential candidate Abdullah withdraws from elections,0,1,2,55,0,6,0,57,0
Jay-Z to become first rapper inducted into Songwriters Hall of Fame,0,3,5,51,1,10,0,56,0
Habertürk media sparks outrage over woman’s murder photo in Turkey,0,1,2,54,1,9,0,56,0
"Make Room, Rich Little Cynics, MTV Wants to Do Some Good",0,1,12,32,2,10,0,44,0
Dominican paper apologizes for using Baldwin photo for Trump ,0,3,3,49,0,9,0,52,0
Charles Schwab’s daughter shares the investing advice her father gave her in her 20s,0,2,2,66,1,13,2,68,0
Donald Trump's 20% Mexican border wall tax plan set to increase price of goods to Americans,0,3,4,68,2,15,2,72,0
This Toddler Made Her Own Sign For The Women’s March And It’s Too Cute,0,3,14,41,2,13,0,55,0
"William Peter Blatty, Author Of 'The Exorcist,' Dead At 89",0,3,9,34,4,9,2,43,0
America's Cup: Alinghi are fifth race victors,0,1,3,34,2,6,0,37,0
"New Filings Fall, but Long-Term Job Claims Rise",0,1,8,30,2,7,0,38,0
The D.C. Court of Appeals Undermines the First Amendment ,0,2,8,38,2,9,0,46,0
"At Liberty University, All Sins Are Forgiven on the Altar of Football ",0,3,9,48,1,12,0,57,0
"President Donald Trump, Justin Trudeau hold press conference ",0,3,5,47,1,8,0,52,0
Hillary Clinton gives first major 2016 presidential campaign speech,0,2,2,53,0,8,4,55,0
A retired hedge fund manager is selling his 2-in-1 St. Barts estate for $67 million â take a look inside,0,2,3,74,6,19,4,77,0
L.A. Times: We regret publishing pro-Japanese internment letters,0,3,5,48,4,7,0,53,0
Investors are loving the champion of the Trump trade,0,2,2,42,0,8,0,44,0
Beneath The Surface: Digging Into Microsoft's Claims About Momentum And The Mac,0,3,12,54,2,11,0,66,0
"Microsoft To Be Worth 1 Trillion Dollars, Ahead Of Apple, Alphabet And Amazon",0,3,12,50,2,12,1,62,0
Mass migrant rescue operation underway in Mediterranean,0,2,2,47,0,6,0,49,0
The Terra Nova expedition: An ambitious and ill-fated attempt to reach the South Pole,0,3,6,64,2,13,0,70,0
There's a secret room inside Mount Rushmore that stores important US documents,0,3,5,61,1,11,0,66,0
Stream Shake And Her 070 Crew's 'The 070 Project: Chapter 1',0,2,8,31,4,10,7,39,0
"Emmanuel Macron: Don't underestimate youth and inexperience, Bernard-Henri Levy says",0,3,6,65,4,9,0,71,0
Liam Payne Of One Direction Just Welcomed A New Son Into The World,0,2,13,41,0,12,0,54,0
"Kim Jong-un's wife is spotted, EIGHT MONTHS after disappearing from public view",0,3,13,52,3,11,0,65,0
Musk Nearing $1.4 Billion Windfall as Tesla Achieves Milestones,0,3,7,44,2,8,2,51,0
Intel buys driverless car technology firm Mobileye,0,3,2,42,0,6,0,44,0
American Airlines Is Bringing Back The Perk You Once Hated,0,3,10,39,0,9,0,49,0
These Parents Don’t Want To Know What’s In Their Baby’s DNA,0,2,13,33,3,10,0,46,0
$112 Million Caterpillar Loss Is First in 17 Years,0,1,6,30,1,8,5,36,0
A Calm Judicial Eye in Storm Over Madoff Bail,0,1,8,29,0,8,0,37,0
Globalization and trade deficit are connected says Greenspan,0,1,2,51,0,7,0,53,0
Washington Taps Into a Potent New Force in Diplomacy,0,1,7,37,0,8,0,44,0
Konrad Reuland dies at 29 following brain aneurysm,0,3,2,39,0,7,2,41,0
Can This Man Revive the Yankees? ,0,3,5,21,1,6,0,26,0
Palin Applauds 'Fearless Leader' Trump for Taking on 'Lying Lapdog Media'  Insider,0,3,10,56,4,12,0,66,0
The government was warned that the Oroville Dam emergency spillway was unsafe. It didn’t listen.,0,3,4,75,3,14,0,79,0
George Michael’s Partner Reveals How He Found Pop Star’s Body,0,3,10,40,2,9,0,50,0
"Rajon Rondo rips Jimmy Butler, Dwyane Wade: 'If anything is questionable, it's the leadership'",0,2,7,68,6,13,0,75,0
NYC Transit asks members to ratify new contracts,0,1,4,37,0,7,0,41,0
What the Federal Interest Rate Hike Means for You,0,3,7,34,0,8,0,41,0
Surviving Tuskegee Airmen Salute Another Trailblazer,0,1,6,41,0,5,0,47,0
"Lead pollution no longer threat to air quality in major Australian cities, study finds",0,3,2,70,1,13,0,72,0
Ireland will hold EU referendum,0,1,3,24,0,4,0,27,0
Steelers Slide Into AFC Playoffs with 28-12 Win Over Browns - Breitbart,0,2,11,43,2,11,4,54,0
Wikinews interviews author and filmmaker Peter John Ross,0,1,4,45,0,7,0,49,0
New Jersey woman identified after fifteen years in psychiatric home,0,1,2,56,0,9,0,58,0
See Darren Criss menace Grant Gustin and Melissa Benoist in 'The Flash' musical episode,0,2,9,63,2,13,0,72,0
Muirfield members face their demons again: is it time to let the ladies in?,0,3,1,59,2,13,0,60,0
"In New Special, Louis C.K. Says We're Heading For Hellish Dystopia",0,3,12,40,4,10,0,52,0
"Coca growth up in Bolivia, Peru, claims U.S. State Department",0,1,7,41,4,9,0,48,0
British backpacker in Thai hospital after falling from moving train ,0,3,2,56,0,10,0,58,0
Inevitable Salt Bae Tattoo Arrives to Pay Tribute to the Current Meme God,0,3,10,51,0,12,0,61,0
"Hrithik's Subtle Hint About ZNMD's Sequel, Salman-Akshay-KJo's Collaboration & More From Ent!",0,2,17,57,8,11,0,74,0
Watch Live: Orlando Police Announce Capture of Officer Shooting Suspect,0,3,9,52,1,9,0,61,0
Samsung confirms battery faults as cause of Note 7 fires,0,3,2,44,0,9,1,46,0
"The Weeknd Tops Billboard Artist 100, George Michael Debuts at No. 8",0,3,9,42,2,11,4,51,0
Philadelphia breaks 80 year old building lease; moves to evict Scouts,0,1,2,54,1,10,2,56,0
Inuk hunter adrift on arctic ice floe,0,1,1,30,0,6,0,31,0
Katy Perry's 'Chained to the Rhythm' is cotton candy political pop,0,2,4,49,3,10,0,53,0
Airbnb continues to push Trips into more Asian countries,0,3,3,45,0,8,0,48,0
Labour MP says General Election is 'not about changing the Government' as she fails to defend Corbyn,0,3,7,75,2,16,0,82,0
"Tbilisi flash floods: Lions, bears and tigers roam Georgian capital as storm hits",0,3,3,64,2,12,0,67,0
These Disney Films Are Eerily Similar Due To Recycled Animation,0,3,10,44,0,9,0,54,0
Trump Cites Voter Fraud in NH Without Providing Evidence ,0,2,9,39,0,9,0,48,0
Geithner Faces Test at Group of 7 Meeting,0,1,5,28,0,7,1,33,0
Air France passenger jet intercepted by Indian Air Force,0,1,5,43,0,8,0,48,0
"UEFA Champions League: April 9, 2008",0,1,7,17,2,5,5,24,0
Trump mocks Wall Street Journal editorial board: ’I don’t think they understand business’,0,2,5,68,4,12,0,73,0
"After uncertain day of Eurovision rehearsals, EBU will place sanctions on Spain and RTVE",0,1,10,64,1,13,0,74,0
Mystery Of Antarctica's Blood Falls Is Finally Solved,0,2,8,37,1,7,0,45,0
Trump says profiling is ’not the worst thing to do’,0,2,1,39,2,9,0,40,0
China Will Reopen Tibet to Tourists,0,1,5,25,0,5,0,30,0
Russian markets to remain closed until Friday,0,1,2,37,0,6,0,39,0
Congressman Backs Libertarian Presidential Candidate in Campaign First - The New York Times,0,2,11,67,1,12,0,78,0
6.1 magnitude aftershock earthquake hits Haiti,0,1,1,37,1,5,2,38,0
Politics in the Guise of Pure Science,0,1,4,27,0,6,0,31,0
Lena Dunham Praises Glamour For Letting Her 'Cellulite Do The Damn Thing',0,3,12,48,2,11,0,60,0
Doctor Wait Times Soar 30% In Major U.S. Cities,0,3,9,25,3,8,2,34,0
Study suggests 'sleeping sickness' parasite mutated to evade immune system defences,0,1,1,70,2,10,0,71,0
Muslim nonprofit groups rejecting federal funds because of Donald Trump,0,3,3,59,0,9,0,62,0
"After Refusing To Marry Her, Boyfriend Allegedly Throws Pregnant Girlfriend Off A Moving Train",0,3,14,66,1,13,0,80,0
"Dude ranch owner asked chef to make 'black people food' for tourists, lawsuit claims ",0,2,1,67,3,14,0,68,0
Trump’s Press Office Confused British Prime Minister Theresa May With a Porn Star,0,3,12,56,1,12,0,68,0
Dateline with Lester Holt FRIDAY 10P/9C Obama: ‘Post-racial America after my election’ unrealistic,0,3,14,64,5,12,3,78,0
Fox News Taps Tucker Carlson to Replace Megyn Kelly ,0,2,8,35,0,9,0,43,0
World Food Program told to leave North Korea,0,1,5,32,0,7,0,37,0
Northwestern MutualVoice: How Doctors and Dentists Need to Save Differently for Retirement,0,2,10,68,1,11,0,78,0
"Lewis ""Scooter"" Libby indicted on five charges",0,1,3,35,2,6,0,38,0
"Minnesota Gov. Mark Dayton 'Doing Great' After Fainting During Speech, Son Says ",0,3,12,52,4,12,0,64,0
"Now, Navjot Singh Sidhu Says He's 'A Born Congressman', This Is His 'Ghar Wapsi'",0,3,14,46,7,13,0,60,0
Space Shuttle Atlantis landing concludes program,0,1,3,40,0,5,0,43,0
Coughlin Is Still Waiting to Make a Decision on Burress,0,1,7,39,0,9,0,46,0
John Oliver drinks to Sepp Blatter's demise with some Bud Light Lime,0,2,7,49,1,11,0,56,0
Politicians call for action after floods cause havoc in the UK,0,1,3,49,0,10,0,52,0
Dairy farmers launch powdery protest,0,3,1,31,0,4,0,32,0
Sushma Swaraj Guarantees Help To A Woman Who Suffered A Heart Problem On Flight,0,2,14,52,0,13,0,66,0
Trump's America Donald Trump's battle with Obamacare leaves US health care in uncertain era,0,2,7,69,2,13,0,76,0
"Closing the Roof on a New Era, for Better and Worse",0,1,6,34,1,10,0,40,0
"Man Spends $1 Million on Strippers, Cars, and Cocaine After Bank Glitch",0,3,9,47,3,11,1,56,0
First US Somali lawmaker gets 'Islamophobic threats' in taxi,0,2,5,45,2,8,0,50,0
Can Under Armour Rebound? ,0,3,4,17,1,4,0,21,0
Perth man dies during Christmas swim while two rescued from rip,0,2,2,51,0,10,0,53,0
From ‘Fancy’ to a canceled tour: A breakdown of Iggy Azalea’s demise,0,3,5,48,4,11,0,53,0
Hard Fouls and Loose Elbows Spark Syracuse in Second Half,0,1,8,40,0,9,0,48,0
Teens Shoveling Snow for Cash Save Stranger’s Life,0,3,7,35,1,7,0,42,0
Tropical Storm Zeta becomes second cross-season tropical storm in history,0,1,3,60,1,9,0,63,0
Musharraf's rape comments spur controversy,0,1,1,36,1,4,0,37,0
Berlin Christmas Market Reopens After Terrorist Truck Attack,0,3,8,45,0,7,0,53,0
FAA grounds Trump’s campaign jet for expired registration,0,2,4,45,1,7,0,49,0
Government shuts off water to California farms in controversial effort to help threatened species,0,1,2,82,0,13,0,84,0
"Disney shows off Star Wars Land, and just shut up and take our money",0,2,4,50,1,13,0,54,0
The Yankees now belong to Gary Sanchez,0,3,4,28,0,6,0,32,0
Alan Thicke dead: 'Growing Pains' actor dies of heart attack aged 69,0,2,4,48,3,11,2,52,0
Mayor Ken Livingstone's suspension frozen pending appeal,0,1,3,46,1,6,0,49,0
"Vroom, Vroom: Companies Design ‘High Performance’ Car Sounds",0,2,8,41,4,7,0,49,0
‘I know something about marching’: John Lewis’s fiery speech at the Women’s March in Atlanta,0,3,6,67,5,14,0,73,0
A Frightened Dog Who Would Tremble At Everything Finally Calmed Down After Meeting This Kid,0,3,15,62,0,14,0,77,0
Mid-flight slumber cut short by exploding headphones,0,3,1,44,1,6,0,45,0
US 'prepared to do more' in Syria if chemical weapons used again ,0,2,3,48,2,12,0,51,0
Why we march against Trump: violence against women and the Earth is linked,0,3,3,58,1,12,0,61,0
Turks and Caicos Islands Premier resigns,0,1,4,31,0,5,0,35,0
Tighten 'noose' so Osama can't operate: Obama,0,1,3,32,4,6,0,35,0
The Knicks And Lakers Head The NBA's Most Valuable Teams 2017,0,3,12,34,1,10,4,46,0
Apple Readies iPhone Overhaul for Smartphone's 10th Anniversary,0,3,6,47,1,7,2,53,0
Number of Homeowners  Facing Foreclosure Rises,0,1,5,35,0,6,0,40,0
London Tube strike to go ahead after union rejects last-ditch offer,0,3,2,54,1,10,0,56,0
Norway wins the Eurovision Song Contest 2009,0,1,4,30,0,6,4,34,0
Fourth Loss in a Row,0,1,3,13,0,4,0,16,0
Pieta Brown Gets by With a Little Help From Her Friends on 'Postcards',0,3,10,46,2,12,0,56,0
Mar-a-Lago remains a top destination for charities despite concerns about Trump,0,3,3,64,2,10,0,67,0
Man Who Led Police In A Crazy L.A. Pursuit Was Driver Trained By Military,0,2,15,43,2,13,0,58,0
"Victory Charge at Players Championship, but From Stenson, Not Woods",0,1,8,48,2,9,0,56,0
Iranian Overture Might Complicate Relations With Israel,0,1,7,42,0,6,0,49,0
Love Trump? Hate Him? That's No Way to Invest.,0,2,8,26,4,8,0,34,0
N. Korea Says It Is Holding Reporters,0,1,7,23,1,6,0,30,0
This Is Ikea's Attempt To Solve Your Annoying Relationship Problems,0,3,10,47,1,9,0,57,0
G.M. Bankruptcy Plan Clears Bondholder Hurdle,0,1,7,31,2,5,0,38,0
Colombian air traffic controller: 'I did what was humanly possible',0,3,2,53,3,9,0,55,0
Visa Posts Better-Than-Expected Profit Results,0,1,7,33,2,4,0,40,0
"Missteps, and Quick Recovery, in White House With Strong Congressional Ties",0,1,9,54,2,10,0,63,0
Morgan StanleyVoice: Retirement And The Coming Longevity Crunch,0,3,9,46,1,7,0,55,0
"New Owners to Reopen Window Plant, Site of a Sit-In in Chicago",0,1,9,40,2,11,0,49,0
Armenian President Kocharyan declares state of emergency,0,1,3,47,0,6,0,50,0
Boston Establishes Gender-Neutral Bathrooms In City Hall,0,2,8,41,1,6,0,49,0
"Slack Grows Up, Debuts New Suite For Large Businesses Called 'Enterprise Grid'",0,3,12,52,3,11,0,64,0
"Move Over, Acai. Here Comes the Maqui Berry",0,2,7,27,2,7,0,34,0
One Bid to Organize Nurses Faces Setback in Congress,0,1,7,37,0,8,0,44,0
Write Your Boss That Kiss-Off Letter. Then Press Delete. - The New York Times,0,2,14,46,4,13,0,60,0
Two nuclear leaks in two weeks trigger security and safety reviews in France,0,1,2,62,0,12,0,64,0
Alistair Darling unveils UK's 2010 Budget,0,1,5,26,1,5,4,31,0
Driver Arrested Near White House Grounds Claimed to Have a Bomb: Police,0,3,10,49,1,11,0,59,0
Slaven Bilic sees cause for optimism but West Ham are still struggling to click,0,2,4,62,0,13,0,66,0
North Carolina’s jarring GOP power grab feels familiar,0,3,5,41,1,7,0,46,0
Miley Cyrus Gets New Tattoo of Her Dog Emu,0,2,8,26,0,8,0,34,0
Myer raid could trigger David Jones merger: analyst,0,3,3,40,1,7,0,43,0
Clinton goes after Trump for having ’six guys named Steve’ on his economic advisory council,0,2,3,72,2,14,0,75,0
Suicide Attack Kills at Least 15 in Iraq,0,1,5,26,0,7,2,31,0
Levi Leipheimer Inches Closer to Tour of California Title,0,1,7,42,0,8,0,49,0
Abducted teen in Florida found,0,1,2,24,0,4,0,26,0
First woman to officially run Boston Marathon finishes race again at 70 ,0,2,3,55,0,12,2,58,0
Security Council recommends Ban Ki-moon for UN Secretary-General,0,1,8,47,2,7,0,55,0
Spain advances to first World Cup Finals,0,1,4,30,0,6,0,34,0
"Photo Of A 'Wall Street Guy' Humping The Fearless Girl Statue Goes Viral, Sparks Outrage Online",0,2,16,61,3,15,0,77,0
Murder Trial Tests Colorado Hate-Crime Statute,0,1,7,33,1,5,0,40,0
Delaware Corrections Officer 'Saved Lives' Before Dying in Hostage Situation: Union ,0,2,10,60,3,11,0,70,0
How Foxconn’s broken pledges in Pennsylvania cast doubt on Trump’s jobs plan,0,3,4,59,2,11,0,63,0
"On social media, who shares a story matters more than who writes it",0,3,1,53,1,12,0,54,0
The Federal Government Just Took The First Step In Building Trump’s Wall,0,3,12,48,1,11,0,60,0
Head of Russia World Cup lashes out at investigations into Fifa,0,2,5,48,0,10,0,53,0
Baby orangutans rescued from Thai taxi,0,3,2,31,0,5,0,33,0
Federal police officer linked to 3 deadly Maryland shootings in custody,0,2,2,58,0,10,1,60,0
Man Proposes to Dream Girl With Legacy Brick at Vikings Stadium,0,2,9,44,0,10,0,53,0
BBC demands new laws to give its shows top billing over rivals in television guides ,0,3,3,66,0,15,0,69,0
"Rachel Dolezal identifying as African American is highly unusual, experts say",0,3,4,62,1,10,0,66,0
Quebec City mayor dies unexpectedly,0,1,2,29,0,4,0,31,0
At least 71 deaths in Mexico 'likely linked' to swine flu outbreak,0,1,2,49,2,11,2,51,0
8-year-old transgender boy kicked out of Cub Scouts because of his identity,0,3,2,59,2,11,1,61,0
Covering Northern Virginia Family of 6 Takes in Family of 13 After Fire,0,3,8,48,0,12,3,56,0
Kawhi Leonard Selected for Random Drug Test Minutes After MVP Performance Against Rockets,0,3,14,63,0,12,0,77,0
NBA memo: Rules prohibit mocking of opponents on social media,0,3,4,47,1,9,0,51,0
Texas counties hope to cash in by filling empty jails with undocumented immigrants,0,2,1,69,0,12,0,70,0
Uproar Over United Video Imperils Chicago Airport Police,0,3,8,41,0,7,0,49,0
McCartney campaign changing minds about IRA,0,1,5,33,0,5,0,38,0
Jeff Sessions just recused himself from any investigations related to the 2016 campaign,0,2,2,69,0,12,4,71,0
Italian MP starts thirst and hunger strike to protest Saddam execution,0,1,4,56,0,10,0,60,0
"Connecticut Beats Marquette, Giving Calhoun 800th Victory",0,1,6,41,1,6,3,47,0
"Violence May Hinder Talks With Iran, Obama Says",0,1,8,31,1,7,0,39,0
Israel releases 26 Palestinian prisoners,0,1,2,32,0,4,2,34,0
"Exposed to Solvent, Worker Faces Hurdles",0,1,5,29,1,5,0,34,0
Beer Diplomacy: Another Investment Follows a Visit by Xi Jinping ,0,2,8,46,1,10,0,54,0
Winners of international postcard-sized art exhibit announced,0,1,1,53,1,6,0,54,0
Chicago House Race Draws a Crowd,0,1,5,22,0,5,0,27,0
Foot and mouth scare in New Zealand likely to be hoax,0,1,3,40,0,10,0,43,0
UNICEF USAVoice: These Americans Will Never Forget: Life Without Vaccines,0,3,18,44,2,9,0,62,0
British author J. G. Ballard dead at 78,0,1,4,24,2,7,2,28,0
Dave East & Beanie Sigel Team Up for Gritty Video 'The Real Is Back': Watch,0,3,13,44,4,14,0,57,0
Family of killed Palestinian boy donates organs to Israeli patients,0,1,3,55,0,9,0,58,0
Posters critical of Pope Francis appear around Rome,0,3,4,40,0,7,0,44,0
Trump Appears to Side With Assange Over Intelligence Agencies’ Conclusions - The New York Times,0,2,13,66,2,14,0,79,0
#AskForbes Chat: The Best Career Advice Of 2016,0,2,8,26,2,7,4,34,0
Judge refuses to stop construction of Dakota Access pipeline ,0,3,3,49,0,9,0,52,0
Chicago White Sox win 2005 American League baseball pennant,0,1,5,42,0,8,4,47,0
Jain Finds Second Act as Ex-Deutsche Bank Chief Joins Cantor,0,3,10,40,1,9,0,50,0
St Paul's cathedral to shut down following 'Occupy' protest,0,1,3,45,3,8,0,48,0
"Men catch 15-foot-long, 144-pound python in the Florida Everglades",0,2,3,46,4,8,5,49,0
"Vast Review Of Cannabis Research Finds Medical, Legal Answers -- And Lack Thereof",0,3,12,54,3,12,0,66,0
Moldovan parliament approves new government,0,1,1,38,0,4,0,39,0
Two N.H.L. Youngsters Are Giving Islanders a Reason to Hope,0,1,10,37,3,9,0,47,0
"Japan's 50 Richest In 2017 Grow Wealthier From Telecom, Videogames And Technology",0,3,10,52,2,11,6,62,0
Suicide bomber detonates explosive-laden car killing at least 32 in Iraq,0,2,2,57,1,10,2,59,0
"SiriusXM Celebrates Two Days of Dance at Miami Music Week 2017 With Above & Beyond, Hardwell, Marshmello & More",0,2,16,69,4,18,4,85,0
Saudis Tell OPEC They Eased Cuts by Pumping 10 Million Barrels,0,3,12,38,0,10,2,50,0
"Venezuela’s Government Plays Santa, After Seizing Millions of Toys ",0,3,8,48,2,9,0,56,0
U.S. Officials Say Israel Struck in Sudan,0,1,7,26,2,6,0,33,0
Sen. Kaine's son arrested at Trump rally in Minnesota ,0,3,4,39,2,9,0,43,0
European East-West Divide Widens Ahead of Brexit ,0,3,7,34,1,7,0,41,0
IMF approves US$1.13 billion loan to Pakistan,0,1,6,28,2,6,3,34,0
Girl found living with monkeys in Indian forest,0,3,2,38,0,7,0,40,0
Sinn Féin leaders believed to have left IRA Army Council,0,1,7,40,0,9,0,47,0
"Instagram Is Good for People With Insecurities and Depression, Says Study",0,3,9,53,1,10,0,62,0
Why people are painting their faces green in Russia,0,3,2,41,0,8,0,43,0
Donald Trump's Press Secretary Won't Say Whether Russia Was Behind The DNC Hack,0,3,15,50,2,12,0,65,0
Man becomes first Briton to have to tell police every time he starts a relationship,0,3,2,67,0,14,0,69,0
Catalans protest in support of independence leaders on trial in Barcelona,0,2,2,61,0,10,0,63,0
15 Home Decor Tips From Joanna Gaines That You’ll Want To Steal Immediately,0,2,12,48,1,12,2,60,0
Diego Costa to Real Madrid: Seven reasons why Chelsea have not offered their striker for a transfer,0,2,6,76,1,16,0,82,0
"Obama press conference: Russia hacks, US election, China and Syria addressed – as it happened",0,3,6,69,4,14,0,75,0
"Thanks to Her 'Love Story,' Gwen Stefani Is the New Face of Revlon",0,3,10,41,3,12,0,51,0
Deadly shark washes up after Cyclone Debbie,0,2,3,34,0,6,0,37,0
HP to aquire EDS for 13.9B,0,1,6,11,1,5,3,17,0
Desiigner And Dak Prescott Are Featured In Champ Sports' Latest 'The Moment' Commercial,0,3,13,59,3,12,0,72,0
Two members of Trump's cabinet reportedly sparred over bathroom protections for transgender students,0,3,2,85,1,12,0,87,0
Chris Childs Remembers Epic Fight With Kobe Bryant: 'I Didn't Want to Knock Him Out',0,3,14,52,4,14,0,66,0
Heartburn drugs may raise risk of stomach infections: study,0,2,1,49,1,8,0,50,0
Take It for a Spin in Lapland! Car Buyers Get Exotic Pitches,0,3,9,39,1,11,0,48,0
Behold These Awesome Little Kids Who Turned Out For The Women’s March,0,3,12,45,1,11,0,57,0
Fiat Chief Warns Chrysler Unions of Need for Cuts,0,1,7,34,0,8,0,41,0
"He Is Playing Dirty To Sell His Book, Says Source Close To Ajay Devgn On KJo's Confession About Kajol",0,3,20,61,2,18,0,81,0
"Vestas Cowes rooftop occupiers: ""Save the environment, scuttle a NIMBY""",0,1,8,50,4,9,0,58,0
The 50 Best Podcasts of 2016,0,2,3,14,0,5,6,17,0
Supreme Court to hear case of Mexican teenager killed in cross-border shooting ,0,3,3,63,1,12,0,66,0
Chile sentences 33 over Pinochet-era disappearances,0,3,2,41,1,5,2,43,0
"Scott Pruitt, Trump’s E.P.A. Pick, Backed Industry Donors Over Regulators ",0,2,12,46,6,10,0,58,0
Ad Campaign Presses Bank on A.I.G. Investments,0,1,8,29,3,6,0,37,0
Explosion in Pakistan mosque kills dozens,0,1,2,34,0,5,0,36,0
Twitter’s NFL Deal No Cure for User and Advertiser Fatigue,0,2,10,38,1,9,0,48,0
The One Where Kyrie Irving Has A 'Friends' Tattoo And Says He's A Fan Of The Show,0,3,17,45,3,16,0,62,0
"In the Trump era, congressional town halls are packed with protesters",0,3,2,56,1,10,0,58,0
CEO Responds To 7-Year-Old Girl Who Asked 'Google Boss' For A Job,0,3,15,34,4,11,1,49,0
"Democratic Republic of Congo adopts new constitution, plans elections",0,1,3,57,1,8,0,60,0
The Force Is Strong With This Photoshop Battle Over Mark Hamill’s Hair,0,3,12,46,1,11,0,58,0
"Gas explosion reported in Hammersmith, London",0,1,3,36,1,5,0,39,0
Migos Are 'Ready' to Perform at Super Bowl If Petition Pans Out,0,2,10,40,2,11,0,50,0
"Iran Test-Fires Missile With 1,200-Mile Range",0,1,7,26,3,5,4,33,0
Final report blames instrument failure for Adam Air Flight 574 disaster,0,1,4,54,0,10,3,58,0
Moscow detains anti-Kremlin protesters,0,1,2,32,1,3,0,34,0
President Trump's first 100 days 'by the numbers' ,0,2,2,34,3,8,3,36,0
UK Court Delays Terror Trial for Muslim to Fast for Ramadan,0,3,9,40,0,10,0,49,0
"Louisiana flooding: 1 family, 13 homes destroyed",0,2,1,36,2,6,3,37,0
US House committee approves daylight saving time amendment,0,1,3,48,0,7,0,51,0
5 things Trump is doing that liberals probably actually like,0,2,1,49,0,9,1,50,0
Salman Khan Rings In His Nephew Ahil's First Birthday With His Khan-Daan In Maldives,0,2,15,54,2,13,0,69,0
Mexicans march against Trump: 'Bad hombre for the whole world',0,3,3,47,3,9,0,50,0
"Taliban Claim Killing of 7 in Afghan Province, Including New Attorney General - The New York Times",0,2,13,66,2,16,1,79,0
General who oversaw military tribunals at Guantanamo is being investigated for abuse of power,0,1,2,78,0,13,0,80,0
Woman found guilty of plotting to sell Coke documents to Pepsi,0,1,3,49,0,10,0,52,0
Twitch streamer and father of 3 dies 22 hours into charity stream,0,2,1,50,0,11,3,51,0
"For UConn, Trouble Ahead and Behind",0,1,6,23,1,5,0,29,0
Red Cross reveals it told U.S. officials about Koran disrespect on multiple occasions,0,1,5,66,2,12,0,71,0
Snapchat's Big Weakness: The Olds,0,3,5,22,2,4,0,27,0
Marketing Campaigns Put Children and Mothers First,0,1,6,38,0,6,0,44,0
Smile! This Restaurant’s Two-Way Mirror Is Filming You Taking Selfies.,0,3,11,46,4,9,0,57,0
Former President Obama: ‘Yes we did. Yes we can.’,0,3,5,31,5,8,0,36,0
"President Barack Obama Speaks on Obamacare Challenge, Iraq, Soccer",0,3,8,48,2,8,0,56,0
"Harry, Niall or Zayn: Which 1D Star's Debut Solo Song Fared the Best?",0,3,11,41,4,12,1,52,0
Standoffs remain after Mumbai attacks,0,1,2,31,0,4,0,33,0
Berlin Attack Echoes ISIS Propaganda Shift,0,3,9,28,0,5,0,37,0
’It’s A Playground’: Meryl Streep On Acting With Abandon,0,2,9,35,4,8,0,44,0
Berkeley protests peaceful as hundreds rally over Coulter ,0,3,2,48,0,8,0,50,0
Magistrate disciplined after Facebook comments on case he oversaw,0,3,2,55,0,8,0,57,0
"Volkswagen, Tata Motors Target Strategic Indian Car Alliance",0,3,8,44,1,7,0,52,0
Brandon Jennings Signs with Wizards After Clearing Waivers,0,3,7,44,0,7,0,51,0
Large earthquake rattles Indonesia; Seventh in two days,0,1,3,44,1,7,0,47,0
Flooding from hurricane hits lower-income North Carolina residents hard,0,2,3,59,1,8,0,62,0
Video Is No Longer An Accessory For Marketing - Here's What You Need To Know,0,3,14,46,2,14,0,60,0
British Songwriter Accuses U2 Of Stealing Song for 'Achtung Baby',0,3,9,44,2,9,1,53,0
Red Wings Dominate Despite Being Short-Handed,0,1,7,32,1,5,0,39,0
Row over Lech Wałęsa's alleged collaboration with communists escalates,0,1,3,58,1,8,0,61,0
Twitter Predicts Donald Trump's Response To Meryl Streep's Speech,0,3,9,46,2,8,0,55,0
New Delhi hits chilliest temperature this season and people won't stop complaining,0,3,2,68,1,11,0,70,0
Cotto Retains W.B.O. Title With Split Decision Over Clottey,0,1,11,37,3,8,0,48,0
Afghan Insurgents Expand Their Use of Increasingly Sophisticated Homemade Bombs,0,1,9,61,0,9,0,70,0
Gardner pleads not guilty to Chelsea King murder,0,1,3,38,0,7,0,41,0
"""Apprentice"" contestant sues Trump for defamation",0,2,2,40,2,5,0,42,0
GOP health-care bill: Ryan visits White House to say he lacks support for health-care bill,0,3,6,67,3,14,0,73,0
Golf Balls in Hash Browns Lead to Recall,0,3,6,27,0,7,0,33,0
Demonetisation: Guard Fires Gun Shots In Air To Disperse Crowd At A Bank In Punjab,0,3,15,52,1,14,0,67,0
New Year's Day: The biggest day of the year for takeaways,0,3,4,41,2,10,0,45,0
"I Should Have Been More Careful, Says Randeep Hooda On Gurmehar Kaur Fiasco",0,3,13,49,1,12,0,62,0
Italy's sleeping beauty: 400-year-old castle near Venice brought back to life,0,2,2,58,4,10,3,60,0
Jackie and Split: this week’s best new films in the UK,0,2,4,38,2,10,0,42,0
Thousands Still Trapped as Aleppo Evacuation Stalls,0,3,6,39,0,6,0,45,0
"Erin Moran, Who Played Joanie on ‘Happy Days’, Dead at 56",0,2,8,33,4,10,2,41,0
"Hear Chance the Rapper & Jeremih's Surprise Mixtape, 'Merry Christmas Lil Mama'",0,3,10,53,5,11,0,63,0
Billie Lourd Shares Sweet Throwback of Mom Carrie Fisher: Her Voice Will Forever Be in My Head and Heart,0,3,16,69,1,18,0,85,0
"Glastonbury line-up leak? Ed Sheeran, Diana Ross and Lorde among alleged performers",0,2,6,63,3,11,0,69,0
Report Claims Kim Kardashian Is Considering Divorcing Kanye West,0,2,9,47,0,8,0,56,0
Sexual harassment allegations emerge in Sterling Jewelers pay discrimination case - Yahoo,0,3,4,73,1,11,0,77,0
Cavaliers' owner Dan Gilbert called out Andre Iguodala and Draymond Green on Twitter,0,3,8,63,1,12,0,71,0
"A USC grad student fatally stabbed his mentor after a ‘personal dispute,’ police say",0,3,4,64,3,13,0,68,0
"Bengaluru Gets Its 1st Vertical Garden To Curb Pollution & It Already Has Over 3,500 Plants",0,3,13,56,2,15,5,69,0
Plastic surgeons often miss patients' mental disorders,0,2,1,46,1,6,0,47,0
Grocery Chain Wegmans Faces Boycott for Selling Trump Wines  Insider,0,3,9,49,0,10,0,58,0
A Tattoo Artist Found The Most Genius Way To Cover Up A Rubbish Pokémon Tattoo,0,2,15,49,0,14,0,64,0
Suit Says Medical Firms Urged Unapproved Use of Devices,0,1,8,39,0,8,0,47,0
Taking a Chance on a Reverse Merger,0,1,4,25,0,6,0,29,0
Trump Adviser Had Twitter Contact With Figure Tied to Russians ,0,3,9,44,0,10,0,53,0
North Queensland Fury sign former Liverpool great Fowler,0,1,5,44,0,7,0,49,0
Guinean military leader in 'favourable' condition after attempted assassination,0,1,1,68,2,8,0,69,0
"George Beall, who led prosecution of Vice President Spiro Agnew, dies at 79",0,3,6,53,2,12,2,59,0
"Near the End, Ozark Was Still Spinning Tales",0,1,7,29,1,7,0,36,0
"Cher Calls 'Hardball' to Talk Trump, Women's March: 'People From All Over the World Don't Like Him'",0,3,15,60,8,16,0,75,0
"Ed Sheeran Reveals 'Divide' Track List, Album Due March 3",0,2,9,35,3,9,1,44,0
Apple's iTunes replaces Wal-Mart as No. 1 U.S. music seller,0,1,7,37,5,9,1,44,0
Look Up — The Moon Is Going To Be Amazing This Weekend,0,2,11,31,1,11,0,42,0
Nigeria votes in parliamentary elections,0,1,1,35,0,4,0,36,0
"Not Just Deepika, Tiger Shroff Also Battled Hardcore Depression After 'A Flying Jatt' Flopped",0,3,14,63,3,13,0,77,0
Doomsday Clock moves 30 seconds closer to midnight as threat of global annihilation grows ,0,2,2,72,0,14,2,74,0
NBC News Video Eyewitness Accounts From The Tennessee Wildfire,0,3,11,43,0,8,0,54,0
Astronauts Let Go of Refurbished Hubble,0,1,5,29,0,5,0,34,0
"President Trump, White House Apprentice ",0,3,5,29,1,5,0,34,0
Shaky Pakistan Is Seen as Target of Qaeda Plots,0,1,7,32,0,8,0,39,0
"Be kind, rewind: Blockbuster stores kept open in Alaska",0,3,3,42,2,8,0,45,0
GEORGE SOROS: Trump is a con man and he will fail,0,3,12,26,1,10,0,38,0
AMD Readies Fight Against Intel In 'Innovation Starved' Data Center,0,3,12,44,2,9,0,56,0
Most patient cat suffers through curious dog's sniff-down,0,3,1,47,2,7,0,48,0
Andrew Rayel Announces New Label Under Armada & More at Miami Music Week: Watch,0,3,12,52,2,13,0,64,0
April the Giraffe Finally Welcomes New Calf,0,3,6,31,0,6,0,37,0
"TSA Rolls Out New Pat-Downs, Some Travelers Say They’re Invasive",0,2,13,39,3,9,0,52,0
Learning to love the secret language of urine,0,2,1,37,0,7,0,38,0
"As the Recession Waxes, Business Meetings Wane",0,1,6,33,1,6,0,39,0
"Truck Attacker Plows Into Jerusalem Crowd, Killing at Least Four",0,3,9,45,1,9,0,54,0
Why Single Women Are Buying Homes at Twice the Rate of Single Men,0,3,10,43,0,12,0,53,0
Donald Trump can be 'blackmailed and bribed' by foreign governments,0,2,2,54,2,9,0,56,0
Fannie Mae Says It Needs Another $15 Billion,0,1,7,27,1,7,2,34,0
Erdogan: ISIS prime suspect in Turkish wedding blast,0,2,6,38,1,7,0,44,0
NY police: Shooting in Home Depot store leaves 2 dead,0,2,5,37,1,9,1,42,0
Obama Spox: Allegations of Wiretapping Trump Tower Are 'Simply False'  Insider,0,2,10,54,3,11,0,64,0
Pratibha Patil becomes the first woman president of the Republic of India,0,1,4,58,0,11,0,62,0
Dallas shooter's father: My son hit his breaking point,0,3,2,42,2,8,0,44,0
"'Rogue One' has the 2nd-best December opening weekend ever, with $155 million",0,3,3,54,5,11,4,57,0
Gulf Air launches direct flights to the Middle East from Dublin,0,1,5,48,0,10,0,53,0
German police just arrested two people suspected of an 'impending' terrorist attack,0,3,1,69,2,11,0,70,0
Republican Health Care Vote: Everything You Need to Know,0,3,8,39,1,8,0,47,0
The ‘heinous’ case of a child whose mother allegedly kept him locked in a bathroom for months,0,3,1,74,2,16,0,75,0
SAPVoice: SAP Teams With Facebook And Uber To Offer Innovative Customer Engagement Solutions,0,3,18,61,1,12,0,79,0
America Doesn’t Have Europe’s Immigration Problems,0,3,6,37,2,5,0,43,0
FBI and Nation’s Leaders Caught Sleeping Through Orlando Wake-up Call - Breitbart,0,2,12,55,3,11,0,67,0
French elections: centrist Bayrou offers alliance with Macron,0,2,3,50,1,7,0,53,0
Osmani Garcia Enters Rehab Due to Physical & Emotional Exhaustion,0,2,8,47,1,9,0,55,0
US automaker bailout deal fails to pass Senate,0,1,3,36,0,7,0,39,0
Almost everyone gets Russia wrong – apart from Obama,0,2,3,40,1,8,0,43,0
Italian police find 24 children living in Rome's sewers,0,1,2,42,1,8,2,44,0
Kong: Skull Island is the best war movie of the year,0,2,3,38,1,10,0,41,0
Germanwings plane crash: Co-pilot acted deliberately,0,2,2,43,2,5,0,45,0
"A 7-Year-Old Girl Wrote A Letter To ""Google Boss"" Sundar Pichai, And He Replied Ever So Sweetly",0,3,18,55,5,16,1,73,0
Anzac Day 2017: Artists honour digger who died in the battle for Bullecourt,0,2,4,54,1,12,4,58,0
Europeans go to the polls to elect Members of the European Parliament,0,1,4,54,0,11,0,58,0
Hurricane Rick becomes Category 5 storm,0,1,3,30,0,5,1,33,0
Why 'Unnecessary' Swearing Is Not Cool And Never Will Be,0,3,10,35,2,9,0,45,0
"Ric Flair Crashes NBA TV Set at NBA Finals Game 4, Unleashes a 'Woo'",0,2,16,35,3,13,1,51,0
"Gunman Robs Florida Blood Bank, Tells Staff He's Hungry",0,3,9,36,2,8,0,45,0
Outrage in Mexico After Cartel Gunmen Rob Team of Journalists,0,2,8,44,0,9,0,52,0
Deputy helps girl build snowman while mom with cancer recuperates - Yahoo,0,3,2,59,1,11,0,61,0
US Commandos Take Out ISIS Leader in Hunt for Top Terrorists as Obama Prepares to Leave Office ,0,3,17,61,0,17,0,78,0
Melania Trump re-files Daily Mail lawsuit without controversial wording,0,2,4,58,1,8,0,62,0
Head of China's People's Choice Awards Trashes Matt Damon's 'The Great Wall',0,3,11,49,5,11,0,60,0
"RBS reports £7bn annual loss, as bank remains in the red for ninth consecutive year",0,2,3,63,2,14,1,66,0
McCain: Dictators 'get started by suppressing free press',0,3,3,44,3,7,0,47,0
2 Firms Accused of Fraud in Debt Settlement Practices,0,1,6,38,0,8,1,44,0
This swim team has an average age of 90 — and they've come back to break records,0,2,1,59,2,16,2,60,0
Fake U.S. embassy shut down in Ghana after issuing visas for 10 years,0,3,4,49,2,12,2,53,0
Ellie Goulding Joins 'Magic Mike Live' Performance,0,2,7,35,2,6,0,42,0
"Municipal Bond Funds, in Starring Roles",0,1,5,28,1,5,0,33,0
Islamic political party seeks registration in Australia,0,1,2,47,0,6,0,49,0
"Australian Open: Roger Federer, Stan Wawrinka primed after Andy Murray, Novak Djokovic exits",0,2,10,67,3,12,0,77,0
The Super Bowl is getting closer to Washington's Birthday and that would be huge for fans and businesses,0,3,5,81,1,17,0,86,0
Huckabee Slams Anti-Trump Press: 'The Zenith of What People Are Disgusted By'  Insider,0,3,13,56,4,13,0,69,0
Toxic soup scenario in New Orleans unlikely,0,1,3,34,0,6,0,37,0
"U.S. factory, private payrolls data point to firming economy",0,2,2,47,3,8,0,49,0
"Two employees are suing Microsoft, alleging their jobs gave them PTSD ",0,2,6,52,1,11,0,58,0
Hundreds Mourn Oakland Warehouse Fire Victims,0,3,6,34,0,5,0,40,0
President-elect Trump Attacks Civil Rights Icon Who Said His Presidency Not 'Legitimate' ,0,3,12,62,3,12,0,74,0
Sudan adopts new currency,0,1,1,21,0,3,0,22,0
"With Trump Defeats, Muni Bonds See Record-Setting Winning Streak",0,2,10,44,2,8,0,54,0
"Melbourne pedestrians hit by car, three dead and man arrested",0,2,1,50,1,9,0,51,0
Would-Be Parents Find Surrogate Agency Closed,0,1,7,32,1,5,0,39,0
Ex-BDO Partner Pleads Guilty in Tax Shelter Case,0,1,10,30,1,7,0,40,0
L.A.-based lawyer sues FBI over Clinton email warrant ,0,3,6,37,3,8,0,43,0
"Lose My Luggage if You Must, but Not My Wheels",0,1,8,28,1,9,0,36,0
Angela Merkel to Meet Donald Trump on Friday After Blizzard Delay,0,3,9,46,0,10,0,55,0
Vibrator Maker Shells Out Millions Over Claims It ‘Secretly’ Tracked User Data,0,2,12,53,2,11,0,65,0
Obliterated! ISIS headquarters in Mosul is blown away by RAF Typhoon strike mission,0,3,10,60,1,12,0,70,0
Concerns for Queen's health after she delays annual break at Sandringham,0,3,3,58,1,10,0,61,0
Ohio Lawmakers Sneak Measure Restricting Minimum Wage Into Bill About Puppies,0,3,11,56,0,10,0,67,0
"Blink 182, AFI Lead Opening Night of 2016 KROQ Almost Acoustic Christmas",0,3,14,39,1,11,7,53,0
"Lewandowski claims Obama WH listened in on Sessions, Russian envoy meetings ",0,2,6,58,1,11,0,64,0
750 people killed in the 78 terror attacks Donald Trump claims went 'under reported' - full details,0,3,2,73,3,16,5,75,0
"In an Uncertain Economy, Charities Try to Retain Donors",0,1,7,39,1,8,0,46,0
Retailer Knockoffs Abound in India,0,1,4,26,0,4,0,30,0
Protesters still plan to march along Mark Zuckerberg's Hawaiian wall,0,3,4,54,1,9,0,58,0
These Charts Show the Change in Scope of Trump’s Immigration Order,0,3,8,47,1,10,0,55,0
Ed Sheeran Will Make a Guest Appearance on Upcoming Season of 'Game of Thrones',0,2,10,54,2,13,0,64,0
Iraqi Elections Face Crucial Test in Violent Mosul,0,1,7,36,0,7,0,43,0
Chance the Rapper Leads Star-Studded Lollapalooza 2017 Lineup,0,3,7,42,1,7,4,49,0
"Bob Knight on ex-Indiana bosses: ""I hope they're all dead""",0,3,4,40,5,9,0,44,0
The Fake Freedom of American Health Care ,0,3,6,28,0,7,0,34,0
"Nazi-Themed Trump Billboard To Stay Up As Long As He's President, Owner Says",0,3,14,47,3,12,0,61,0
‘Stop this nonsense’: ‘Percy Jackson’ author snubs invite from Texas lawmakers over bathroom bill,0,3,4,75,5,13,0,79,0
McCain clinches Republican nomination as Huckabee concedes,0,1,4,48,0,6,0,52,0
USC stabbing kills psychology professor; student arrested,0,3,3,47,1,6,0,50,0
Blue-state lawmakers want to keep Trump off 2020 ballot unless he releases tax returns,0,3,2,66,1,13,4,68,0
Swedish ’gay sailor’ deployed to deter Russian subs,0,2,2,40,2,7,0,42,0
West Virginia’s Bob Huggins has scary moment when defibrillator goes off during game,0,2,4,67,1,12,0,71,0
"Obama, Romney battle over foreign policy in final U.S. presidential debate",0,1,4,57,3,10,0,61,0
Afghanistan begins partial vote recount,0,1,1,34,0,4,0,35,0
Trump gives his hard-line campaign promises a more moderate tone in address to Congress,0,3,2,71,1,13,0,73,0
This Drawing By A Trans Teen Has Become A Symbol In The Fight For Trans Bathroom Rights,0,3,17,54,0,16,0,71,0
Chinese TV Censors Part of Address by Obama,0,1,7,29,0,7,0,36,0
"Downing Street Memo forum to be held June 16th in response to petition of 500,000",0,1,4,54,1,14,8,58,0
Nine Cars Americans Loved or Hated in 2016,0,3,5,26,0,7,4,31,0
No 10 falls for Valentine's Day hoax after comedian claims Donald Trump wants to send Theresa May flowers,0,3,7,78,1,17,2,85,0
Get 9 Assassin’s Creed Games For Just Rs 1000 On Humble Bundle,0,3,10,35,1,11,5,45,0
"The chief economist of an $82 billion asset manager talks Trump, China, and his outlook for 2017",0,3,3,68,3,16,6,71,0
"GOLDMAN SACHS: This should be a good year for stock-pickers, and it's great news for us",0,2,13,55,4,15,0,68,0
First Trojan horse to affect handheld gaming console found,0,1,2,48,0,8,0,50,0
Former President Bush moved to intensive care as wife Barbara also hospitalized ,0,2,4,64,0,12,0,68,0
"Chevron Sells Canadian Refinery, Gas Stations in $1.1 Billion Deal",0,3,8,44,3,9,2,52,0
Canada Beckons International Students With a Path to Citizenship ,0,2,7,49,0,9,0,56,0
Watch the Eerie New Trailer for Selena Gomez-Produced Netflix Series '13 Reasons Why',0,3,11,57,3,12,2,68,0
Turkey faces long and difficult fight against Isis in Syria,0,2,3,47,0,9,0,50,0
Starbucks Pledges to Hire More U.S. Military Veterans ,0,2,8,36,2,8,0,44,0
Apollo I Tragedy Taught NASA Some Very Important Lessons,0,3,12,36,0,8,0,48,0
D.C. watchdog group calls for feds to probe alleged election and tax law violations by NRA,0,3,5,68,2,15,0,73,0
Congress Loves The Syria Strike. But Senators Can't Say Why Trump Thinks It's Legal.,0,3,14,53,4,13,0,67,0
Former rugby union commentator Bill McLaren dies at age 86,0,1,4,43,0,9,2,47,0
World Summit on the Information Society ends in Tunisia,0,1,5,42,0,8,0,47,0
Illinois Governor Blagojevich appoints Roland Burris for vacated U.S. Senate seat,0,1,8,61,2,10,0,69,0
"Meet Intel, Software Maker and Rival to Microsoft",0,1,6,35,1,7,0,41,0
Emma Roberts And Evan Peters Have Reportedly Called Off Engagement,0,3,10,47,0,9,0,57,0
Israeli Leaders Hail ’New Era’ of Donald Trump - Breitbart,0,2,8,38,3,9,0,46,0
Louis Tomlinson’s One Direction Family Sends Love After Mother’s Death,0,3,10,49,2,9,0,59,0
"At Art Basel, a Powerful Jury Controls the Market ",0,2,7,33,1,9,0,40,0
Former Child Soldiers Among Millions of Migrants Making Their Way Into Europe,0,2,11,55,0,11,0,66,0
China Disables Some Google Functions,0,1,5,27,0,4,0,32,0
'Game of Thrones' star wants everyone to stop going to dolphin shows ,0,3,2,53,2,12,0,55,0
$100 Billion Chinese-Made City Near Singapore 'Scares the Hell Out of Everybody',0,3,10,52,4,11,3,62,0
"‘Quiffs were a must’: teddy boys and girls in London, 1955",0,3,2,38,4,10,4,40,0
Larry Bird Says Paul George Trade Rumors Were 'Fake News',0,3,10,36,2,9,0,46,0
Rihanna to Be Honored by Parsons School of Design,0,3,6,35,0,8,0,41,0
"Watch Alan Walker Talk Rihanna Tour, New Music & More at Miami Music Week",0,3,12,46,2,13,0,58,0
Rachel Dolezal claims she doesn't give 'two s***s' about parents' remarks on her ethnicity,0,2,2,68,7,13,0,70,0
Obama to deliver farewell speech in Chicago,0,3,2,35,0,6,0,37,0
Genetic link to migraines discovered by researchers,0,1,1,44,0,6,0,45,0
Christian Leaders Denounce Trump's Hypocrisy Ahead Of National Prayer Breakfast,0,3,10,59,1,9,0,69,0
Dunkirk: New Christopher Nolan film stuns audience at CinemaCon,0,2,6,48,1,8,0,54,0
"In Reno, Nev. Art Canvases That Include Shag Carpet",0,1,9,32,2,8,0,41,0
"Thanks to Contest, a Few Putts at Lunch Could Lead to the United States Open",0,1,10,51,1,14,0,61,0
Banks Brace to Fight Planned Regulatory Agency,0,1,6,34,0,6,0,40,0
Space station crew return to Earth in Soyuz capsule,0,2,3,40,0,8,0,43,0
"9 habits of highly successful people, from a man who spent 5 years studying them",0,3,0,63,1,14,2,63,0
"At Oregon and Yale, this March Madness highlights issue of sexual assault on campuses",0,2,5,66,1,13,0,71,0
Ciara and Russell Wilson Welcome Newborn Daughter Sienna,0,3,7,42,0,7,0,49,0
Why Syria could be Trump's biggest problem,0,2,3,32,1,6,0,35,0
American Alpine ski racer James Heuga dies at age 66,0,1,4,37,0,9,2,41,0
"‘Nobody dies because they don’t have access to health care,’ GOP lawmaker says. He got booed.",0,2,5,67,6,15,0,72,0
Donald Trump just threatened Toyota — but it looks like he got the facts wrong,0,2,3,60,1,14,0,63,0
Why the Syrian Chemical Weapons Problem Is So Hard to Solve ,0,2,9,40,0,11,0,49,0
Russell Westbrook Goes Off on Reporter Questioning Oklahoma City Thunder's Team Play,0,2,11,61,1,11,0,72,0
Mike Trout surprises young fan with gifts - SportsNation - ESPN,0,3,8,43,2,10,0,51,0
Largest companies by revenue in every state - Business Insider,0,2,3,49,1,9,0,52,0
Pressed for time on Ash Wednesday? There's a 'drive-thru' church for that,0,3,4,53,5,11,0,57,0
Carrie Underwood Surprised Her Husband's NHL Team with an Unannounced National Anthem: Watch,0,3,13,65,2,12,0,78,0
30 Under 30 Spotlight: Derek Dolin Of Team Calvin Harris,0,3,8,34,1,9,4,42,0
Watch 'SNL' Pay Tribute to President Obama With 'To Sir With Love',0,3,13,38,4,11,0,51,0
Mary Tyler Moore’s Lobster Tale Shows Her Love For All Creatures,0,3,11,42,1,10,0,53,0
Wall Street drifts with eyes on Fed; Intel drops,0,2,4,35,1,8,0,39,0
"DJ Khaled Enjoying Fatherhood, Calls Son 'Biggest Blessing'",0,3,9,40,3,7,0,49,0
Are you kitten me? Mutant cat with two heads and three eyes is born in China,0,2,3,57,1,15,0,60,0
Cuban athlete banned for life after attack on referee during Olympics,0,1,2,57,0,10,0,59,0
US drone strike kills at least fifteen in Pakistan,0,1,3,39,0,8,0,42,0
"Sam Willoughby, Aussie BMX star, back on the bike as he continues recovery from spinal injury",0,3,6,70,2,15,0,76,0
Dance Academy writer Samantha Strauss says creating children's TV isn't all fun and games,0,3,6,68,2,13,0,74,0
"Blue Ivy Wore a Kids Version of a $26,000 Gucci Dress to the 'Beauty and the Beast' Premiere",0,3,10,56,4,17,5,66,0
BBC DJ duo break radio record,0,1,5,19,0,5,0,24,0
Abbott government's Indigenous Advancement Strategy shows how not to spend $5b taxpayers' dollars,0,3,4,77,3,12,1,81,0
"Pakistan's Musharraf will resign within days, say reports",0,1,2,46,2,7,0,48,0
"Schumer jumps at chance to work with Trump on health care, other issues ",0,3,2,56,1,13,0,58,0
‘Secrets of Churchill’s War Rooms’,0,3,4,23,3,4,0,27,0
Palestinians to elect new president on January 9,0,1,2,38,0,7,1,40,0
Value Fund Managers See Big Opportunities Ahead,0,1,7,34,0,6,0,41,0
Kris Jenner Totally Owns It In A Plunging Dress,0,3,9,30,0,8,0,39,0
'Order is threatened': Gangland violence is picking up in a country on the verge of joining NATO,0,3,6,71,3,16,0,77,0
Don't Believe the Hype: Supreme vs. Fake Supreme,0,3,6,32,3,7,0,38,0
India Rest Ravichandran Ashwin & Ravindra Jadeja For T20Is Vs England While Amit Mishra Comes In,0,3,16,62,1,15,2,78,0
Trump 'willing to work with Russia and China',0,2,3,33,2,7,0,36,0
People Are Confused Because Trump Voters Think He Should Be Able To Have A Private Email Server,0,3,17,62,0,16,0,79,0
Afghanistan's parliament rejects Karzai's cabinet nominations,0,1,2,52,2,5,0,54,0
"Media score a triple-bogey presidency, but Trump is just getting started ",0,3,2,58,2,11,0,60,0
Glencore and Qatar buy $11.3bn stake in Russia's largest oil company,0,3,3,49,3,10,3,52,0
"US Senate Majority leader Harry Reid criticized over ""Negro"" comments",0,1,7,51,2,9,0,58,0
"76ers-Kings postponed due to slick, slippery floor in Philly",0,3,2,46,2,8,2,48,0
Survival Rules for Pro-Trump Californians Living Behind the Blue Curtain - Breitbart,0,2,10,61,2,11,0,71,0
"Elizabeth Thomas, missing Tenn. teen, was spotted with teacher Tad Cummins in Okla.",0,3,6,61,4,12,0,67,0
Bruno Mars And The Time Rock Out To Prince Medley During Grammy Tribute,0,3,13,46,0,12,0,59,0
Kenyans win International Race of São Silvestre,0,1,5,36,0,6,0,41,0
Complete 2017-18 CBB title odds,0,2,4,16,1,4,6,20,0
10 Athletes That Should Have Signature Sneakers,0,3,6,33,0,6,2,39,0
Kellen Winslow Jr. Challenges Antonio Cromartie to Fight After Twitter Argument,0,3,10,58,1,10,0,68,0
The rise of Live Nation and the fear of an emerging music monopoly,0,3,3,51,0,12,0,54,0
Brazilians call for arrest of UK policemen after shooting death,0,1,3,51,0,9,0,54,0
FDA approves powerful new drug for eczema,0,3,3,32,0,6,0,35,0
"Watch Father John Misty Perform ""Total Entertainment Forever” on 'SNL'",0,2,11,46,4,9,0,57,0
12 Oven-Baked Foil Packet Dinners To Try,0,3,7,24,1,6,2,31,0
Catholic archbishops front child abuse royal commission in Sydney for second day,0,2,2,67,0,11,0,69,0
Forest fires burn on in Greece; death toll nears 50,0,1,2,37,1,9,2,39,0
Cost of Borrowing Zooms Higher for Corporations,0,1,5,36,0,6,0,41,0
Boyfriend buys girlfriend the gift of her dreams: a blanket with his face on it,0,2,1,63,1,14,0,64,0
"Secret Service asked for $60 million extra for Trump-era travel and protection, documents show",0,3,3,73,3,13,2,76,0
"Tara Palmer-Tomkinson was almost £200,000 in debt when she died",0,3,3,42,3,9,6,45,0
No Word From I.R.S. on Protest by Pastors,0,1,8,23,3,7,0,31,0
"Just Kidding, 'American Idol' Might Not Be Gone After All",0,3,10,35,3,9,0,45,0
"In Last Jobs Report Of Obama's Presidency, U.S. Adds 156,000 Jobs And Unemployment Rate Ticks To 4.7%",0,2,16,54,7,16,8,70,0
Your Sister Won’t Vaccinate Her Son. Can You Help Him? ,0,3,10,32,3,10,0,42,0
Iranian baby will be allowed into US for emergency procedure ,0,3,3,48,0,10,0,51,0
Obama (as TV Salesman) Pushes Home Refinancing,0,1,7,31,2,6,0,38,0
"Bigfoot, Tasmanian tigers and night parrots: Searching for the mythical or mysterious",0,2,3,69,2,11,0,72,0
Google Launches a YouTube Built for Gamers,0,3,6,30,0,6,0,36,0
Border wall talk leads top Mexican official to float American entry fee ,0,2,3,57,0,12,0,60,0
Four die in Papua New Guinea plane crash,0,1,4,29,0,7,0,33,0
"Chicago Bulls Rajon Rondo Suspended 1 Game by Bulls: Latest Details, Comments, Reaction",0,2,11,60,3,12,1,71,0
Donald Trump’s First Six Days in Office: Here’s What He’s Done,0,3,10,38,4,10,0,48,0
"Donald Trump Finally Releases Partial Records Of His Income Tax Returns, 'But They Are From 2005'",0,3,15,60,3,15,4,75,0
Tapper calls out Trump on conspiracy theories,0,2,2,37,0,6,0,39,0
The 50 Best Movies of 2016,0,3,3,12,0,5,6,15,0
D-Wade interviews LeBron - ESPN Video,0,3,9,21,2,5,0,30,0
"Madison Bumgarner Injured Rib, Shoulder in Dirt Bike Accident, May Miss 8 Weeks",0,2,11,53,2,12,1,64,0
Rare rhino caught on videotape,0,1,1,25,0,4,0,26,0
Destinations Tracy Chevalier: 'Washington DC is one of America's most beautiful cities',0,3,7,65,4,11,0,72,0
"Jon Ossoff, a Democrat, Narrowly Misses Outright Win in Georgia House Race ",0,3,10,51,2,12,0,61,0
House Budget Committee advances GOP health care bill,0,2,6,39,0,7,0,45,0
NFL1000: Top Overall Free-Agent Rankings,0,3,8,22,2,4,4,30,0
This Unseen 'Dirty Dancing' Footage Will Make You Fall In Love With Patrick Swayze & Jennifer Grey All Over Again,0,3,19,72,3,19,0,91,0
The everyday trauma of childbirth made me stop at one child,0,3,1,48,0,10,0,49,0
Are You Attending the Women’s March on Washington? ,0,3,6,35,2,8,0,41,0
Trump’s lies are working brilliantly. This new poll proves it.,0,3,2,48,3,9,0,50,0
That Bison Burger Just Got Pricier Thanks to Canada Ranchers,0,2,9,42,0,9,0,51,0
Did you notice Sarah Palin’s sweater? Good. You were supposed to.,0,2,5,46,4,10,0,51,0
"Billboard Dance Chart Upstarts: Mura Masa & Charli XCX, Rasmus Faber & Adult.",0,2,13,47,5,12,0,60,0
Burgers and burritos come together because goodness exists in the world,0,3,1,60,0,10,0,61,0
49ers RB Tim Hightower Vows to Return Team-Issued No. 21 in Honor of Frank Gore,0,3,12,47,2,14,4,59,0
Chrissy Teigen’s Latest Tweet Proves She’s the Queen of Clap Backs,0,3,9,45,2,10,0,54,0
Oregon Shakespeare Festival Season Includes a Same-Sex ‘Oklahoma!’ ,0,2,8,47,4,8,0,55,0
Cops: Search on for burglary suspect who impaled pet turtle,0,3,2,47,1,9,0,49,0
U.N. Anti-Racism Meeting Reaches Consensus,0,1,7,28,3,4,0,35,0
"Water, water everywhere: utility firms get green light to sell beyond local regions",0,3,1,68,2,12,0,69,0
Comey Asks Justice Dept. to Reject Trump’s Wiretapping Claim ,0,2,8,42,2,9,0,50,0
"Tupac, Pearl Jam and Journey among 2017 Rock Hall of Fame inductees",0,3,7,44,1,11,4,51,0
'I stand with you': Katy Perry's emotional speech for LGBTQ equality,0,2,8,46,4,10,0,54,0
"BOX CEO Aaron Levie Talks Trump, Tech, And How To Stay Nimble As A Public Software Company",0,3,21,51,2,16,0,72,0
Universities warned over 'snowflake' student demands,0,3,1,44,2,5,0,45,0
'History is watching': JK Rowling criticises Theresa May's 'plans to praise' Donald Trump,0,3,8,63,6,12,0,71,0
Militants to present evidence Malacanang sanctioned killings,0,1,2,52,0,6,0,54,0
Alex Salmond accused of rewriting history after he denies 'once in a lifetime' referendum pledge,0,2,2,78,2,14,0,80,0
Carmelo and La La Anthony Reportedly Split After 7 Years of Marriage,0,3,9,47,0,11,1,56,0
Overweight Women Have Increased Risk For Breast Cancer After Menopause,0,3,10,51,0,9,0,61,0
HP France in trouble due to alleged monopolist behavior,0,1,3,44,0,8,0,47,0
GameStop attracts large investors as shorts back off,0,2,2,43,0,7,0,45,0
Study of soft cheese wins oddest book title award,0,1,1,40,0,8,0,41,0
Paul Ryan’s feeling confident about repeal-and-replace. McConnell not so much.,0,3,4,60,5,9,0,64,0
RAY DALIO: 'We are increasingly concerned about the emerging policies of the Trump administration',0,3,10,72,3,13,0,82,0
American Airlines will start flying nonstop from Los Angeles to Australia,0,2,5,58,0,10,0,63,0
Freddie Mac Executive Found Dead,0,1,5,23,0,4,0,28,0
Microsoft: We've already patched the Shadow Broker Windows exploits,0,2,5,52,2,8,0,57,0
Mother's plea to U.S. president gains widespread attention,0,1,3,45,3,7,0,48,0
Japanese tourist travels through 37 countries on just $2,0,1,1,43,1,8,3,44,0
Tony Richardson Misspells 'Jets' During Draft Announcement,0,3,7,43,2,6,0,50,0
Scientists issue dire warning about Cape Cod shark attacks,0,2,3,47,0,8,0,50,0
Speaker Ryan on Trump's Frequent Tweets: 'They're Growing on Me'  Insider,0,3,9,48,5,11,0,57,0
Hacker who stole nude photos of Jennifer Lawrence and other celebrities jailed for nine months,0,3,3,77,0,14,0,80,0
NATO troops kill four people on bus in Afghanistan,0,1,5,37,0,8,0,42,0
Pillow Fights at the Four Seasons,0,1,4,24,0,5,0,28,0
A bloody foot couldn't keep Emma Stone from playing tambourine for Prince,0,3,4,57,1,11,0,61,0
What you need to know: Comey to testify before House intel panel ,0,3,3,49,1,12,0,52,0
Maxine Waters Is More of a Patriot Than Bill O'Reilly Will Ever Be,0,3,12,41,1,12,0,53,0
French Election Results Let Markets Breathe -- For Now,0,3,8,36,2,8,0,44,0
Collarenebri in shock over toxic moonshine that claimed three lives,0,2,1,57,0,9,0,58,0
Donald Trump Goes His Own Way in Vetting Top Picks ,0,2,9,32,0,10,0,41,0
Big Ten Swallows a Bowl of Humiliation,0,2,5,27,0,6,0,32,0
"Drug Overdoses Killed 50,000 in U.S., More Than Car Crashes",0,3,9,32,4,9,5,41,0
Bitcoin dropped sharply and suddenly on more news out of China,0,3,2,50,0,10,0,52,0
Tax breaks promised by Australian Prime Minister as election fast approaches,0,1,4,62,0,10,0,66,0
Split review – M Night Shyamalan twists again – and again,0,2,4,41,2,10,0,45,0
Historic Queen Mary ocean liner could sink without repairs,0,3,3,47,0,8,0,50,0
Ai Weiwei’s Latest Artwork: Building Fences Throughout New York City ,0,2,10,47,2,10,0,57,0
"With pressure from France, Chad and Sudan open door to possible troop deployment",0,1,4,63,1,12,0,67,0
Sean Garrett Recruits Lil Yachty for Sultry 'Look On Your Face' Video: Exclusive Premiere,0,3,13,60,3,13,0,73,0
"Regular bedtimes stop children from becoming overweight, study finds",0,2,1,58,1,8,0,59,0
Space Shuttle Atlantis launches for the final time,0,1,3,40,0,7,0,43,0
Mali: three UN peacekeepers die in attack by Al-Qaida affiliate,0,2,5,47,2,9,0,52,0
Scientists have finally worked out whether the Mona Lisa is smiling The list,0,3,4,60,0,12,0,64,0
"Native Hawaiians blockade historic palace to restore ""Hawaiian nation""",0,1,3,57,2,8,0,60,0
Doctors turn to 3D printing to source medical supplies in earthquake-recovering Nepal,0,3,3,69,1,11,1,72,0
Influential Croat poet Dragutin Tadijanović dies,0,1,4,39,0,5,0,43,0
"Íngrid Betancourt and others rescued, says Colombia",0,1,3,41,1,6,0,44,0
White House could provoke a spending showdown over funding for border wall,0,3,2,61,0,11,0,63,0
"Billboard Dance Chart Upstarts: Miss Tara, Yellow Claw & Grey",0,3,9,40,3,9,0,49,0
Miguel Tejada Gets Probation for Lying to Congress,0,1,6,37,0,7,0,43,0
Sears is closing 150 stores â here's the full list,0,3,1,36,3,9,3,37,0
Redditor Spoofs NBA All-Star Game Sneakers Video with 'Full House' Theme,0,3,13,46,3,10,0,59,0
Credit Card Processor Says Some Data Was Stolen,0,1,8,32,0,7,0,40,0
Lyricist Javed Akhtar awarded Indira Gandhi Prize,0,1,6,37,0,6,0,43,0
Obama questions why Supreme Court took up Obamacare challenge,0,3,4,49,0,8,0,53,0
Czech PM calls Obama's rescue plan a 'road to hell',0,1,4,35,3,9,0,39,0
Syrian regime shelling kills 12 in Wadi Barada,0,2,3,34,0,7,2,37,0
Trump: It Is In ‘Vital National Security Interest of the US’ to Prevent the Use of Chemical Weapons,0,3,14,65,3,17,0,79,0
La La Visits NYC Strip Club Following Split With Carmelo Anthony to Shoot New Series,0,3,16,54,0,14,0,70,0
Saudi Arabia to allow female-only gyms this month,0,2,2,39,1,7,0,41,0
"Trump may move GOP health care bill to the right, dooming it in the Senate",0,3,5,54,1,14,0,59,0
"Ian McKellen: When we weren't facing off on-set, Christopher Lee was a true gentleman and touchingly nervous",0,2,6,82,4,16,0,88,0
NASA flyby of Saturn moon Titan produces first image of liquid on another world,0,1,6,60,0,13,0,66,0
Iranian court upholds five year sentence for jailed Briton Nazanin Zaghari-Ratcliffe,0,3,5,68,1,10,0,73,0
Rage Against The Machine top UK singles chart,0,1,6,32,0,7,0,38,0
Cyclone Debbie: Footage shows 'monster' storm hit Queensland,0,3,4,46,3,7,0,50,0
Pope Francis in New Year Address Says Terrorism Casts Bloodstain over World,0,3,10,54,0,11,0,64,0
MILO to Bill Maher: It’s Now Breitbart Publishing the Exciting Gay Editorials - Breitbart,0,2,14,59,3,13,0,73,0
Person from Indiana wins $314 million Powerball jackpot,0,1,3,41,1,7,3,44,0
"Meet Mike Dubke, the next White House communications director",0,3,5,47,1,8,0,52,0
Eurozone Growth Bucks Political Unease,0,3,5,29,0,4,0,34,0
Etan Patz Case: Killer Pedro Hernandez Gets 25 To Life In Prison,0,2,11,39,1,11,2,50,0
Twitter Has A Field Day Comparing Yogi Adityanath To Vin Diesel & The Result Is Absolutely Gold,0,2,16,62,1,16,0,78,0
"Waka Flocka Drops His Gucci Mane Diss Track ""Was My Dawg""",0,3,11,34,2,10,0,45,0
Morning brief: GOP retains vacated seat in Kansas special House election ,0,2,6,55,1,11,0,61,0
"US father kidnaps daughter, may flee country in yacht",0,1,2,42,1,8,0,44,0
Tencent Opens U.S. Data Center as American Rivals Face Hurdles in China ,0,3,11,47,2,12,0,58,0
San Diego votes for new mayor,0,1,2,22,0,5,0,24,0
Coroner finds that Australian Prime Minister Holt drowned in 1967,0,1,5,47,0,9,4,52,0
Trump pitches unity to Congress amid turbulent start to presidency ,0,2,2,55,0,10,0,57,0
Germany’s Angela Merkel Urges G-7 Leaders to Send Russia ‘United Signal’,0,3,10,47,4,10,1,57,0
You'll Be 'Thunderstruck' By This AC/DC-Themed Christmas Lights Display,0,3,13,45,5,8,0,58,0
Trump’s greatest single achievement almost never gets mentioned,0,3,1,54,1,7,0,55,0
"UK will rejoin European Union some day, says EU commission chief – video",0,2,6,52,2,12,0,58,0
The Guardian view on Philip Hammond: more honesty is needed about budget pain to come,0,3,4,66,1,14,0,70,0
India Opens High-Level Inquiry in Fraud Case,0,1,7,30,1,6,0,37,0
Knicks Find Another Way to Lose,0,1,5,21,0,5,0,26,0
Caitlyn Jenner visits White House for meetings with Trump administration officials ,0,3,5,67,0,11,0,72,0
"Get Ready for The Daily, Your Audio News Report ",0,3,8,30,1,9,0,38,0
Trump’s new Russia expert wrote a psychological profile of Vladimir Putin — and it should scare Trump,0,3,5,78,2,16,0,83,0
"Look at these knockoff Apple AirPods, which you might soon be able to buy",0,3,4,55,1,13,0,59,0
Trump campaign manager Conway grand marshal of Christmas parade in New Jersey ,0,3,5,61,0,12,0,66,0
"Trump aide hid payments from Ukraine party with Moscow ties, new documents say",0,3,3,62,1,12,0,65,0
England delay Six Nations roof call until 11th hour to keep Wales guessing,0,3,4,56,0,12,2,60,0
Drake Spoke Out Against President Trump Last Night During A Concert,0,2,11,46,0,10,0,57,0
Richard Sherman Says He Doesn't Want to Be Traded by Seahawks,0,3,9,41,1,10,0,50,0
Winston Churchill’s Ideas About Alien Worlds Were Surprisingly Modern,0,3,9,51,1,8,0,60,0
Sony’s new toy teaches coding and robot construction to kids,0,2,1,49,1,9,0,50,0
Trump tells conservative gathering that his supporters are the GOP’s future,0,3,4,60,1,10,0,64,0
Here's a list of the best-selling beers in the world,0,3,1,40,2,9,0,41,0
"John Newhouse, author of ‘War and Peace in the Nuclear Age,’ dies at 87",0,3,6,46,4,13,2,52,0
These Are the Six Biggest WTO Disputes You Need to Care About,0,3,12,38,0,11,0,50,0
House Republicans pull plan to gut independent ethics committee after Trump tweets,0,3,3,68,0,11,0,71,0
"American Airlines employee accused of hitting woman with stroller, narrowly missing baby",0,3,2,74,1,11,0,76,0
"Brexit trade deal could take 10 years, says UK's ambassador",0,3,3,43,2,9,2,46,0
LG Electronics to build $250 million home appliance plant in US,0,2,5,44,1,10,3,49,0
Anderson .Paak and The Free Nationals Announce Upcoming Album,0,2,8,44,1,8,0,52,0
Five dead in attack in Pakistan,0,1,2,24,0,5,0,26,0
Artist Defies Web Censors in a Rebuke of China,0,1,6,32,0,8,0,38,0
Alec Baldwin Pokes Fun at Donald Trump’s Relationship With Vladimir Putin in ‘SNL’ Cold Open,0,3,15,60,3,14,0,75,0
Chinese investment in Kushner property in Manhattan called off,0,2,3,51,0,8,0,54,0
Rogue llama prompts comical response from local Georgia sheriff's office,0,2,2,60,1,9,0,62,0
Pay to rise for millions as 19 states increase minimum wage ,0,3,1,46,0,11,2,47,0
Camila Cabello Leaves Fifth Harmony,0,3,5,26,0,4,0,31,0
U.S. Sees a Smaller G.M. in the Future Than G.M. Does,0,1,11,26,6,10,0,37,0
Fox uses Trump's 'pussy grabbing tapes to teach employees about harassment',0,2,2,60,3,10,0,62,0
Bowser quietly signs legislation allowing terminally ill patients to end their lives,0,3,1,72,0,11,0,73,0
Washington state lawmaker looks to outlaw handheld cell phones while driving,0,1,1,65,0,10,0,66,0
"Michael Hubbard, Alabama House Speaker, Is Convicted on 12 Felony Ethics Charges - The New York Times",0,2,14,66,3,16,2,80,0
"An iPhone’s Journey, From the Factory Floor to the Retail Store ",0,3,8,43,2,11,0,51,0
"Acquired in J. J. Putz Trade, Sean Green Also Seen as Valuable to Mets",0,1,11,43,3,13,0,54,0
Eagles likely to pursue DeSean Jackson in free agency,0,2,4,41,0,8,0,45,0
Hooked on Our Smartphones - The New York Times,0,2,7,30,1,8,0,37,0
How to Care for Your Aged Parents — Without Going Broke,0,3,8,36,1,10,0,44,0
"The luxurious, 45-acre compound in Maryland being shut down for alleged Russian espionage",0,3,3,70,2,12,2,73,0
OutFront: HIV-Positive Counselor Shares His Story to Help Others,0,2,12,42,2,8,0,54,0
New ash flight bans ordered in Ireland,0,1,2,30,0,6,0,32,0
Typhoon Megi heads towards China,0,1,3,25,0,4,0,28,0
Francois Fillon placed under formal investigation over 'fake jobs' scandal ,0,2,2,61,2,10,0,63,0
The Perils of Empathy,0,2,3,15,0,3,0,18,0
United Soccer Leagues 2008: Whitecaps sign Pozniak,0,1,5,34,1,6,4,39,0
Ryan Adams Calls Out Donald Trump With Gripping Cover Of 'Karma Police',0,3,12,46,2,11,0,58,0
NASA Crewed Mission To Venus Would Pave Way For Human Mission To Mars,0,3,16,41,0,12,0,57,0
3 US soldiers shot in Afghanistan 'insider attack' ,0,2,3,37,2,8,1,40,0
Royal Easter Show competition heats up at annual Rat and Mouse exhibition,0,3,5,57,0,11,0,62,0
Escaped NY prisoners reportedly were planning to kill prison worker's husband ,0,3,3,63,1,11,0,66,0
"UBS to Cut 7,500 More Jobs After $1.8 Billion Loss",0,1,9,23,3,9,6,32,0
Yankees Profit From Their Own Seventh-Inning Stretch,0,1,8,37,1,6,0,45,0
Reining in the Revelry at the Preakness Stakes,0,1,4,35,0,7,0,39,0
McLaren to 3D-print parts at Bahrain F1 Grand Prix trackside,0,3,7,41,1,9,2,48,0
5 Ways Digital Technology Is Changing Your Job,0,3,7,31,0,7,1,38,0
Passions & Pursuits,0,3,2,14,1,2,0,16,0
Greater Manchester Police Chief found dead,0,1,4,33,0,5,0,37,0
"Rugby star filmed attack on ex-wife's 'new partner' after bugging her home to catch them together, court hears",0,3,1,87,5,17,0,88,0
Business Since Birth: Trump’s Children and the Tangle That Awaits ,0,3,8,46,2,10,0,54,0
15-Year-Old Boston Sports Fan Attends 10th Championship Parade,0,3,8,41,2,7,4,49,0
Paris Jackson Wonders Why Wendy Williams Has So Much to Say About Her Family,0,3,13,50,0,13,0,63,0
Meet The 2017 Class Of 30 Under 30,0,3,5,14,0,7,8,19,0
Ticks carrying Lyme disease confirmed in 9 national parks,0,2,2,46,0,8,1,48,0
Malawi food appeal unanswered by world community,0,1,1,41,0,6,0,42,0
Italy Referendum: Prime Minister Renzi Quits as Voters Deliver Stinging Rebuke,0,3,10,57,1,10,0,67,0
Son of former US VP Al Gore arrested for drug possession,0,1,7,39,0,10,0,46,0
"Storm chasers find unique way to honor ""Twister"" star Bill Paxton",0,3,4,49,2,10,0,53,0
"Chelsea Clinton marries Marc Mezvinsky in Rhinebeck, New York",0,1,7,45,1,8,0,52,0
Multivitamins a waste of money and just create 'very expensive urine',0,2,1,56,2,10,0,57,0
VIDEO: Suspects in Home Invasion Terrorize Woman Hiding in Bathroom  Insider,0,3,13,51,1,11,0,64,0
State Dept 'no knowledge of Mexico visit',0,3,3,30,2,6,0,33,0
2008 Taste of Taiwan Cuisine: A complex to redefine Taiwan's MICE industry,0,1,9,48,2,11,4,57,0
"On Arab TV Network, Obama Urges Dialogue",0,1,8,25,1,6,0,33,0
Russian embassy attacked by Molotov cocktails in Minsk,0,1,3,44,0,7,0,47,0
36 Backstage Photos From The 2017 Academy Awards,0,2,6,29,0,7,6,35,0
Linkin Park's Mike Shinoda Talks 'Heavy' New Single & Hooking up With Kiiara,0,3,11,49,4,12,0,60,0
Iran’s leader says U.S. still hostile after nuclear deal,0,2,3,42,3,8,0,45,0
Biggest Billionaire Gainer Of 2016: Warren Buffett's Fortune Surges More Than Anyone Else In America,0,3,14,66,2,14,4,80,0
"With a whiff of sulphur, George Osborne was gone – but for how long?",0,3,3,49,3,13,0,52,0
Cleveland Clinic Dresses Newborn Babies in Cavaliers Onesies for NBA Finals,0,2,11,54,0,10,0,65,0
That Old Phone Trump Uses for Twitter Could Be an Opening to Security Threats ,0,3,11,53,0,14,0,64,0
"Lance Armstrong should be allowed redemption, says Geoff Thomas",0,3,4,50,1,8,0,54,0
Survey: Most Americans lack savings to cover emergencies,0,2,3,45,1,7,0,48,0
Black Tech Founders Try to Woo Investors at SXSW,0,2,10,30,0,8,0,40,0
Van Jones environmental jobs adviser to US President Barack Obama resigns,0,1,7,56,0,10,0,63,0
Russia celebrates Victory Day,0,1,3,23,0,3,0,26,0
US Senate passes new bankruptcy bill,0,1,3,28,0,5,0,31,0
NATO to expand Afghanistan presence,0,1,5,26,0,4,0,31,0
Updated 2017 NFL draft order for top 24,0,3,4,22,0,7,6,26,0
CBSE Tells Schools To Ensure That There Is No Insult To National Flag,0,2,16,41,0,12,0,57,0
"Three killed amongst Birmingham, England riots",0,1,3,37,1,5,0,40,0
UK's House of Commons Passes Bill Authorizing Brexit ,0,3,8,36,1,8,0,44,0
‘The Walking Dead’ Is Back: 7 Questions for the Second Half Premiere ,0,3,9,44,3,12,1,53,0
Kansas City Royals Pitcher Yordano Ventura Killed in Car Crash,0,3,9,44,0,9,0,53,0
Washington-area clinic Carafem barred from advertising in Metro stations,0,3,3,60,1,8,0,63,0
'Spider-Man: Homecoming' trailer mixes action and awkardness,0,3,3,47,4,6,0,50,0
The most fashionable Englishwoman in Paris,0,3,3,34,0,5,0,37,0
"To Understand Why the White Working Class Voted Trump, See Hacksaw Ridge",0,2,11,49,1,11,0,60,0
British electronica band Faithless to separate,0,1,2,39,0,5,0,41,0
"5 things for Friday, March 16: Wiretapping, North Korea, Africa",0,3,6,41,4,9,3,47,0
Baseball Tragedy: Two Players Die in Crashes in the Dominican Republic ,0,2,8,51,1,11,0,59,0
Lance Stephenson Responds to Raptors' Criticism of Layup with Instagram Post,0,3,8,57,1,10,0,65,0
Russian jet flies close to Nato ships in the Baltic Sea in a show of military force,0,2,4,63,0,16,0,67,0
Muslim Americans unite to raise funds for vandalized Jewish cemetery,0,3,3,56,0,9,0,59,0
Yahoo's Marissa Mayer gives up her 2017 bonus,0,2,3,30,1,7,4,33,0
‘Faith’ proved George Michael was a superstar. ‘Patience’ proved he was a great.,0,2,4,58,6,12,0,62,0
"Priyanka Chopra's Koffee Teaser, SRK's Valuable Teachings For His Sons & More From Ent!",0,2,15,54,5,13,0,69,0
At least nine missing after Russian military plane crashes into Pacific,0,1,3,58,0,10,0,61,0
"La La Land, Hidden Figures and films that squeezed happiness out of 2016",0,2,5,50,1,12,4,55,0
Sprucing up Robert the Bruce: Scottish king's face gets 3D treatment,0,3,5,50,2,10,1,55,0
"With a Nod to Ireland, European Union Lifts Hopes for a Treaty to Strengthen Itself",0,1,10,58,1,14,0,68,0
Senate Confirms Jeff Sessions as Attorney General ,0,2,6,37,0,7,0,43,0
Gregg Allman Scraps All Tour Dates for 2017,0,2,6,26,0,7,4,32,0
"Dallas Cowboys Ezekiel Elliott Scores TD, Celebrates by Donating Himself to the Salvation Army",0,3,12,68,1,13,0,80,0
Goldfrapp Brings Back the Synths for 'Ocean' From Upcoming Album: Premiere,0,3,9,52,3,10,0,61,0
Six-year-old boy told to 'take off hearing aid to look smart for school photo',0,2,1,60,4,13,0,61,0
Nearly 700 Miles of Fencing at the US-Mexico Border Already Exist - Yahoo,0,3,10,46,2,12,3,56,0
U.S. Officials Fault Moscow on Syria Ahead of Tillerson Visit ,0,2,9,41,2,10,0,50,0
"UN reports 222,570 dead in Haiti earthquake",0,1,3,27,1,6,6,30,0
Rocket strike near hotel in Afghan capital injures four,0,1,2,45,0,8,0,47,0
"Tiger Woods Misses Cut at 2017 Farmers Insurance Open: Comments, Reaction",0,3,9,48,2,10,4,57,0
EU treaty anniversary sees protests and marches in major cities - in pictures,0,3,2,62,1,12,0,64,0
The Iowa Straw Poll Is No More,0,3,7,17,0,6,0,24,0
U.S. judge grants Singaporean blogger’s asylum request,0,2,3,42,3,6,0,45,0
Household debt is dangerously close to 2008 levels,0,3,1,38,0,7,4,39,0
Prince Harry meets Lady Gaga at Royal Albert Hall,0,2,7,34,0,8,0,41,0
Peter King: Brussels Proves Islamic State Is ’Willing and Able’ to Strike at Any Time - Breitbart,0,2,13,64,4,16,0,77,0
An asteroid was streaking toward Earth. A collision seemed all too possible.,0,2,3,60,2,11,0,63,0
Teacher has personalised hand shake for every student,0,3,1,45,0,7,0,46,0
Yasiin Bey (Mos Def) Makes Magic at Homecoming Show at Apollo Theater,0,3,10,46,2,11,0,56,0
Politico: Libertarian Koch Brothers Recognize 2016 Defeat by Populists - Breitbart,0,2,8,58,2,10,4,66,0
Former UN head Annan warns Kenya over future poll violence,0,1,5,44,0,9,0,49,0
Women with painful gynaecological problems told by GPs: 'It's all in your head',0,3,4,59,4,12,0,63,0
Family of Amanda Knox plans for appeal in Italian court,0,1,4,42,0,9,0,46,0
Israeli greenhouses to be preserved after Gaza pullout,0,1,2,45,0,7,0,47,0
David Guetta Connects With Nicki Minaj & Lil Wayne on 'Light My Body Up': Listen,0,3,13,49,4,14,0,62,0
Michael Moore's controversial new documentary 'Sicko' opens strongly,0,1,3,55,3,7,0,58,0
"Multiple Dead, 2 Arrested in Quebec City Mosque Shooting",0,2,7,39,1,8,1,46,0
Joe Biden Regrets Not Becoming President,0,2,6,29,0,5,0,35,0
"Meet Serena Unger, Deepika Padukone's Character In 'xXx' Who Represents Women In Today's World",0,2,14,62,5,13,0,76,0
"As #DeleteUber rages, Lyft expands to 54 new cities",0,3,4,35,2,8,2,39,0
Syria Rejects Amnesty's Report of Mass Hangings as 'Untrue',0,2,7,41,3,8,0,48,0
"Judge rules woman can't sue Trump over calling her a ""dummy"" on Twitter",0,3,3,53,3,12,0,56,0
Here’s George Michael In The First Ever Carpool Karaoke Video,0,3,10,41,1,9,0,51,0
"Reports: Model Kate Moss escorted off flight, accused of being disruptive",0,2,4,57,2,10,0,61,0
"Conor McGregor Comments on Potential WWE Appearance, Cultural Impact, More",0,2,12,51,2,9,0,63,0
Mark Cuban: Adam Silver said Tony Romo contract wouldn't be honored,0,3,6,49,2,10,0,55,0
UK to ban Islamist group al-Shabaab,0,1,4,25,1,5,0,29,0
"Madison Bumgarner Injured Rib, Shoulder in Dirt Bike Accident, May Miss 8 Weeks",0,3,11,53,2,12,1,64,0
California Begins Hunt for Deeper Cuts,0,1,5,28,0,5,0,33,0
Eurosceptic views in Scotland pose dilemma for Nicola Sturgeon,0,3,4,50,0,8,0,54,0
Galatasaray clinch 17th Turkish title,0,1,2,29,0,4,2,31,0
India's Barren Island volcano active again,0,3,3,33,1,5,0,36,0
Donald Trump And The End Of “Time”,0,3,7,19,2,6,0,26,0
Tech tools can help rental car drivers avoid — and contest — traffic tickets,0,2,1,60,2,13,0,61,0
Cops: Calif. officer responding to traffic accident shot dead by gang member on parole,0,2,2,69,2,13,0,71,0
China Lowers Growth Target as Lawmakers Meet ,0,3,6,32,0,7,0,38,0
"Poll: Two-Thirds of Voters Want to See Clinton, Trump Medical Records - Breitbart",0,2,11,54,4,12,0,65,0
Tucker Grills BuzzFeed Editor Who Published Trump-Russia Dossier  Insider,0,3,11,52,1,9,0,63,0
Watch Wisin and Ozuna Perform 'Escapate Conmigo' at the 2017 Billboard Latin Music Awards,0,3,10,60,2,13,4,70,0
CIA ‘given new authority to conduct drone strikes’ as Donald Trump rolls back restrictions,0,3,5,70,2,13,0,75,0
Austerity? Not on This Saudi Itinerary ,0,2,5,27,1,6,0,32,0
Joan Baez Tears Into 'Future Dictator' Donald Trump In New 'Nasty Man' Song,0,3,13,46,4,12,0,59,0
Theresa May wins Commons backing for 8 June general election,0,2,4,46,0,9,1,50,0
Number of U.S. women taking maternity leave unchanged for two decades,0,3,3,54,2,10,0,57,0
"Man Charged in Theft of John Legend's Bag, $25K Cufflinks at JFK",0,2,11,37,3,11,2,48,0
"Prayer does not help heart patients, study finds",0,1,1,39,1,7,0,40,0
A Debate: Should the Justice Department Police the Police? ,0,3,7,41,2,9,0,48,0
Schwarzenegger Gets Part in Stallone Film,0,1,5,31,0,5,0,36,0
A Deadline Looms for Dakota Protesters to Leave Campsite ,0,3,7,41,0,9,0,48,0
Beauty in the Bible: Illustrating world's most widely distributed book,0,3,3,56,2,9,0,59,0
"Camille Paglia Blasts Madonna’s ‘Humiliating’ Decline, ‘Embarrassing Inability to Deal with Aging’",0,3,10,71,6,11,0,81,0
New study links carbon pollution to extreme weather,0,2,1,43,0,7,0,44,0
US airstrike kills high-profile terrorist leader ,0,3,2,40,1,6,0,42,0
Kobe Bryant Defends LeBron James' High-Volume Shooting During NBA Finals,0,3,14,47,2,9,0,61,0
'Sherlock' creator shuts down Season 4 critics with poetic open letter,0,3,2,55,2,10,1,57,0
MiLB Team to Wear Mister Rogers Sweater Jerseys,0,3,9,31,0,7,0,40,0
Council of Europe planning to use satellite images in prisons probe,0,1,2,55,0,10,0,57,0
Gazan Doctor and Peace Advocate Loses 3 Daughters to Israeli Fire and Asks Why,0,1,10,54,0,13,1,64,0
Scarponi Wins Stage 6 of Giro; Armstrong Puts Finish in Perspective,0,1,8,47,1,10,1,55,0
Princeton Suspends Men's Swim Team Over 'Vulgar and Offensive' Comments About Women's Team,0,2,12,62,4,12,0,74,0
Blake Griffin's Latest Injury May Finally Send Him in Search of a New NBA Home,0,3,14,49,1,14,0,63,0
"Transgender Does Whatever It Took To Save A Woman And 2 Sons Trying To Commit Suicide, But Failed",0,2,17,61,1,17,1,78,0
Patriots Comeback Over Falcons Fuels Highest-Rated Super Bowl For FOX,0,3,13,46,1,9,0,59,0
Trump has bared his fangs to Merkel. He will do untold damage to Europe,0,3,4,53,1,13,0,57,0
MySpace loses over ten million users in one month,0,1,2,39,0,8,0,41,0
King of Sweden stresses need for ‘serious’ media and source checking after Donald Trump’s immigration claims,0,3,4,86,3,15,0,90,0
White House considers sending Guantanamo Bay prisoners to Illinois,0,1,5,53,0,8,0,58,0
The Syrian army is poised to enter Aleppo's last rebel enclave,0,2,3,48,1,10,0,51,0
Subway Blast in Putin's Hometown Shows Rising Terror Risk,0,3,8,40,1,8,0,48,0
"Mitsubishi Heavy IndustriesVoice: Veterans, Your Next Manufacturing Experts",0,3,9,57,2,7,0,66,0
The first official teaser trailer for 'Guardians of the Galaxy 2' is here and it shows off more of Baby Groot,0,3,5,81,2,20,1,86,0
"Watch Mike Will Made-It, 21 Savage, YG & Migos Floss in 'Gucci On My' Video",0,2,14,39,6,14,2,53,0
Will Allen Sentenced to 6 Years in Prison for Role in Ponzi Scheme,0,2,8,45,0,12,1,53,0
Kevin Durant’s injury may already be imperiling the Warriors’ title chances,0,3,3,60,2,10,0,63,0
Aleppo under bombardment,0,2,1,21,0,2,0,22,0
Insurgent attack in South Thailand injures 24,0,1,3,34,0,6,2,37,0
"Calpine declares bankruptcy, cites natural gas prices",0,1,1,45,1,6,0,46,0
Social care green paper is an opportunity too important to be missed,0,3,1,56,0,11,0,57,0
How NATO and Russia interpret U.S. demands on European allies,0,3,9,41,2,9,0,50,0
Police rescue 'frozen' woman who turns out to be mannequin ,0,3,1,46,2,10,0,47,0
"On day 1 of first foreign trip, Trump was seen but not heard",0,2,2,44,1,12,1,46,0
There’s an ‘Earth-like’ planet with an atmosphere just 39 light-years away,0,3,2,55,5,10,2,57,0
Lahore bomb blast 'kills six',0,3,1,22,2,4,0,23,0
Women Sentenced in Trials That Gripped France,0,1,6,33,0,6,0,39,0
Anthony Lynn Reportedly Hired as Head Coach of Los Angeles Chargers,0,3,9,48,0,10,0,57,0
"Despite Profit Decline, Optimistic Words at Nokia",0,1,6,36,1,6,0,42,0
"Om Puri dead: Bollywood superstar dies aged 66 after decades in Indian, British and American films",0,3,6,73,2,15,2,79,0
Dieses Video ist nicht verfügbar. The Hateful Eighteen-C,0,3,6,41,2,7,0,47,0
Cutting Those Carry-Ons Down to Size,0,1,6,24,1,5,0,30,0
Soaring house prices reduce number of babies born in England,0,3,2,49,0,9,0,51,0
Michelle Obama explains why she probably will never run for office,0,3,2,54,0,10,0,56,0
Flynn's access to classified info suspended after resignation ,0,2,1,52,1,8,0,53,0
"Trump Shows He Is Willing to Act Forcefully, Quickly ",0,2,8,35,1,9,0,43,0
"Hair Loss, Warts, and Scars: Scientists ID the Facial Features Villains Have in Common [Video]",0,3,13,62,5,14,0,75,0
Merkel Challenger Looks to Harness Unruly Party for Election Bid,0,2,8,47,0,9,0,55,0
El Salvador elects leftist president Funes,0,1,3,34,0,5,0,37,0
"Twelve-year-old schoolboy stabbed, dies in Brisbane, Australia",0,1,3,49,4,6,0,52,0
Apple's beefed-up iPad multitasking lets you see apps side by side,0,3,2,52,2,10,0,54,0
New species of dolphin found off Australia,0,1,2,34,0,6,0,36,0
"Levin: ’I Am Not Voting for Donald Trump,’ ’Count Me As Never Trump’ - Breitbart",0,2,13,46,7,14,0,59,0
Indian Olympic body stirs storm over Suresh Kalmadi role,0,3,4,44,0,8,0,48,0
"Former Yahoo exec joins Snapdeal, a billion-dollar Indian marketplace",0,2,4,55,2,8,0,59,0
Testimony by John Travolta that son was autistic raises Scientology questions,0,1,4,63,0,10,0,67,0
Three men charged with indecent assault against a child in Rotherham,0,2,2,56,0,10,0,58,0
Woman charged over alleged 7-Eleven axe attack in Sydney's inner-west,0,3,3,53,3,9,1,56,0
"Same-sex marriage free vote could find consensus, Liberal WA senator Dean Smith says",0,3,6,64,2,12,0,70,0
Baby brain scans may reveal autism risk: study,0,3,1,37,1,7,0,38,0
WFCA's Svyatoslav Shabanov Knocks Out Ali Dikaev in 13 Seconds with Brutal Kick,0,3,13,51,1,12,2,64,0
RFK Jr.’s deadly anti-vaccine ‘gospel’,0,2,4,25,5,4,0,29,0
The I.R.S. Deems UBS Executive a Fugitive,0,1,10,22,3,6,0,32,0
Denzel Washington: Mainstream Media Is Selling 'BS'  Insider,0,3,9,40,3,8,0,49,0
Shorten the Backswing to Calm Things Down,0,1,5,30,0,6,0,35,0
"Reliance Jio Begins Broadband Service With Insane Plan, Offers 100 MBPS Free For 3 Months!",0,3,16,54,2,14,4,70,0
"Russians Paid Mike Flynn $45K for Moscow Speech, Documents Show",0,3,9,41,2,9,2,50,0
Kellyanne Conway: I'm Getting Death Threats Fueled by Pro-Clinton Rhetoric ,0,3,10,52,3,10,0,62,0
Trump superfan Eric Bolling gets a new show on Fox News. That’s a win for the White House.,0,3,8,62,3,17,0,70,0
Four British energy suppliers face investigation into claims of misselling,0,1,2,63,0,9,0,65,0
South Korea's Park leaves presidential palace after impeachment,0,2,3,52,1,7,0,55,0
Jared Kushner in Talks to Sell Stake in Real Estate Technology Company,0,3,9,50,0,11,0,59,0
Islamic State suicide bombing at Pakistan shrine leaves at least 75 dead,0,3,3,56,0,11,2,59,0
House Ways and Means chairman aims to move tax reform bill through committee this spring,0,2,3,71,0,14,0,74,0
Campos-Duffy: Leaked Trump Dossier Is an 'Attack on the American People'  Insider,0,2,10,55,4,12,0,65,0
Europe's first brothel where customers pay £100 an hour for sex with DOLLS opens in Spain ,0,3,7,62,2,16,3,69,0
C of E college apologises for students' attempt to 'queer evening prayer',0,3,2,57,3,11,0,59,0
"Kendall Jenner and ASAP Rocky Step Out Again, Continue to Play With Our Emotions",0,2,15,51,1,13,0,66,0
‘Off the shelf’ bone replacements offer life-changing help to landmine victims,0,3,1,64,3,10,0,65,0
Carling Cup: Match abandoned after player collapses,0,1,3,41,1,6,0,44,0
From IT specialist to guerilla fighter: Estonia's citizen army gears up to deter Vladimir Putin's war machine,0,3,6,84,3,16,0,90,0
'Moonlight' Oscar-Winner Mahershala Ali Used to Be a Rapper,0,3,8,40,3,8,0,48,0
US Congress: Republicans vote to limit ethics body What does all this US jargon mean?,0,2,7,62,2,14,0,69,0
Women Scientists Are Tweeting “Sexy” Photos Of Themselves At Work To Shut Down Sexism,0,3,14,56,2,13,0,70,0
Crash test dummies may get heavier to protect heavier Americans,0,3,2,52,0,9,0,54,0
"Former Pennsylvania State Senator Vincent Fumo convicted of fraud, corruption",0,1,6,61,1,9,0,67,0
"Murder Victim Said Robert Durst Admitted Killing Wife, Witness Says",0,3,10,47,1,9,0,57,0
A publisher of one's own: Virginia and Leonard Woolf and the Hogarth Press,0,2,6,54,2,12,0,60,0
White House authorizes up to 450 additional troops in Iraq,0,2,3,43,0,9,3,46,0
"Woman in her 60s injured in the Stockholm terror truck attack dies in hospital, raising the death toll to five",0,2,2,86,1,19,2,88,0
Military helping kids follow Santa's fabled flight ,0,3,2,41,1,7,0,43,0
Here is yet another reason to cut calories,0,2,1,34,0,7,0,35,0
Colombia plane crash: Brazilian sports channel airs 90 minutes of silence during Chapecoense final slot,0,3,3,83,1,14,2,86,0
"Tiger escapes circus, roams streets of Palermo in Italy",0,2,3,43,1,8,0,46,0
Hamas claims Israeli jet shoot-down; report of Israeli soldiers captured,0,1,3,58,2,9,0,61,0
Donald Trump has lowest approval ratings of any President in US history,0,2,5,55,0,11,0,60,0
"Elect a Dissident to the Board, and Maybe Win a Prize",0,1,6,36,1,10,0,42,0
Church of England threatens legal action over PS3 game,0,1,4,41,0,8,1,45,0
We Really Wish We Could Watch the Expletive-Filled Video Kevin Garnett Created for the Celtics,0,3,13,66,1,14,0,79,0
Several large earthquakes shake Indonesia,0,1,2,35,0,4,0,37,0
NBC News Video Teen Becomes First Contestant to Wear Hijab in Miss Minnesota USA Pageant,0,2,17,57,0,14,0,74,0
Two juveniles charged with arson in Tennessee wildfires that left 14 people dead,0,3,2,64,0,12,2,66,0
Syracuse Univ: Students Should Report Color Coded Signs as 'Bias Incident'  Insider,0,3,11,57,3,12,0,68,0
Harambe's grandmother dies at Zoo Miami,0,3,3,30,1,5,0,33,0
WHO: H1N1 influenza virus still a pandemic,0,1,5,28,1,6,2,33,0
Fujimori intends to run for Peruvian presidency,0,1,2,39,0,6,0,41,0
China finds new love for wildlife films,0,3,1,32,0,6,0,33,0
Lostprophets singer Ian Watkins sentenced to 29 years in prison for attempting to rape baby,0,1,3,72,0,14,2,75,0
Hamas accuses Israel of killing its Tunisian drone expert,0,2,3,46,0,8,0,49,0
"One Hand on Light Switch, Obama Isn’t Flipping to ‘Off’ Just Yet ",0,3,10,39,4,12,0,49,0
Saudi Arabia Says It Will Work With Trump to Contain Iran,0,2,10,37,0,10,0,47,0
A Supreme Court Not So Much Deadlocked as Diminished - The New York Times,0,2,12,47,1,13,0,59,0
"Ginny and Ron Weasley just had a reunion, and we can’t believe how much they still look like siblings",0,3,3,78,2,18,0,81,0
Plotting Path in Congress for an Economic Plan,0,1,5,34,0,7,0,39,0
NBA fines Patrick Beverley over fan altercation,0,3,5,36,0,6,0,41,0
Inauguration Crowd Will Test Cellphone Networks,0,1,6,36,0,5,0,42,0
National Trust blamed for visitors urinating on Avebury stones after deciding to close loos at 4pm,0,3,3,79,0,15,1,82,0
Oil Companies’ Hottest Market Is Low on Fuel ,0,2,7,29,1,8,0,36,0
"Song by indie artists, used in small movie, wins Oscar",0,1,2,41,2,9,0,43,0
Over 400 attend Scottish singer-songwriter Gerry Rafferty's funeral,0,1,4,51,2,7,3,55,0
Offices Go Vacant at Fannie and Freddie,0,1,5,28,0,6,0,33,0
CanadaVOTES: CHP candidate John M. Wierenga running in Yellowhead,0,1,13,42,2,8,0,55,0
Rising Powers Challenge U.S. on Role in I.M.F.,0,1,9,25,5,7,0,34,0
Bobby Ryan Discusses Double Life While Living with Fugitive Father,0,3,9,48,0,9,0,57,0
Endangered animals are already cut off by a border wall. Trump wants it to be much bigger.,0,2,2,70,2,16,0,72,0
"Adele, Rihanna, Beyonce Headline Highest-Paid Grammy Nominees",0,2,8,44,3,6,0,52,0
Independent Member of Australian Parliament calls for better indigenous policy,0,1,4,65,0,9,0,69,0
Melania Trump: Jean Paul Gaultier says he would be happy to dress future First Lady,0,2,7,61,1,14,0,68,0
Sick of Making Lousy Sports Bets? Now You Can Outsource Them ,0,2,10,39,1,11,0,49,0
"Facebook down for ""upgrades""; multiple blogs suggest site was hacked",0,1,1,55,3,9,0,56,0
Dion Lewis Delivers 98-Yard Return for TD Against the Texans,0,3,9,39,1,9,2,48,0
Controversial cancer test gains support,0,1,1,34,0,4,0,35,0
Donald Trump's approval rating is the lowest of any president-elect in two decades,0,3,2,66,2,12,0,68,0
Royal Family Heads to Christmas Church Service Without the Queen ,0,3,8,47,0,10,0,55,0
Cold Weather Stuns Sea Turtles Near Texas,0,3,7,28,0,6,0,35,0
"Fund NHS entirely with National Insurance, Labour MP Frank Field suggests",0,2,11,51,1,10,0,62,0
"US economic growth slowed in Q4, but there's hope ahead",0,3,3,40,2,9,1,43,0
America's oldest gorilla dies aged 60,0,3,1,28,1,5,2,29,0
Woolly mammoth demise may have been result of climate change and overhunting,0,1,1,64,0,11,0,65,0
Dalai Lama's visit to disputed Himalayan region irritates China,0,3,4,50,1,8,0,54,0
The American Experiment in Exile,0,2,4,24,0,4,0,28,0
The best of Don Rickles' iconic TV and film cameos ,0,3,5,35,1,10,0,40,0
The Next Consortium of ITRI launches 'RoboScooter',0,1,9,33,2,6,0,42,0
U.S. banks’ dismal first quarter may spell trouble for 2016,0,2,2,41,3,9,4,43,0
UK submarine hits rocks in Red Sea,0,1,4,24,0,6,0,28,0
MySpace to Cut Two-Thirds of Staff Outside U.S.,0,1,9,28,3,7,0,37,0
Our messed-up relationship with food has a long history. It started with butter.,0,3,2,63,3,12,0,65,0
"You're an adult, but your brain might not be, experts say",0,3,1,43,3,10,0,44,0
Arung Samudera refloated and under tow to Brisbane,0,1,3,40,0,7,0,43,0
Angela Rye Slams Former Rep. Joe Walsh: 'That's What Makes You A Bigot!',0,3,13,41,6,12,0,54,0
‘He’s baaaack!’: Trump’s visits to Mar-a-Lago are stretching Palm Beach’s budget and locals’ patience,0,3,6,72,10,13,0,78,0
Robert Gates: There’s value in Trump’s ‘disruptive approach’,0,3,4,44,5,7,0,48,0
Darrelle Revis Charged After Alleged Altercation in Pittsburgh,0,2,7,48,0,7,0,55,0
Northwestern MutualVoice: Take Your Finances To The Next Level With These Money Rules,0,3,14,58,1,12,0,72,0
Baby koala won't leave mom during her surgery,0,3,1,36,1,7,0,37,0
UFC Champ Joanna Jedrzejczyk KO's Denver Nuggets Mascot Rocky the Mountain Lion,0,3,14,53,1,11,0,67,0
Security Measures Increasing In Iraq,0,1,5,27,0,4,0,32,0
One-time DACA recipient deported as Homeland Security disputes status ,0,3,7,53,1,9,0,60,0
"With Smallest of Stables, Trainer Tom McCarthy Reaches Biggest Race",0,1,10,47,1,9,0,57,0
Fire Breaks Out at Ryan Seacrest's Beverly Hills Compound,0,3,8,40,1,8,0,48,0
Ann Coulter warns Donald Trump of voter backlash if he 'betrays' them on immigration,0,3,4,65,2,13,0,69,0
GOP Health Care Bill: A Visual Guide to Republican Opposition,0,3,11,40,1,9,0,51,0
"Competing for Food, Beetle Becomes a Killer",0,1,5,31,1,6,0,36,0
Obama to receive JFK foundation's 'Profile in Courage' award,0,3,6,43,3,8,0,49,0
"G.O.P. Lawmakers, Once Skeptical of Obama Plan to Hit Syria, Back Trump ",0,3,12,43,5,12,0,55,0
Elon Musk: Tesla will start taking orders for its solar roof in April,0,3,4,52,1,12,0,56,0
"164 Years Ago On This Day, India's First Train Ran From Mumbai To Thane",0,3,13,40,2,13,3,53,0
Power line to Japanese nuclear plant completed,0,1,2,38,0,6,0,40,0
White House Ignored Draft Holocaust Statement Mentioning Jews: Report,0,3,9,51,1,8,0,60,0
Stevie Nicks Strikes 'Gold' With Latest Solo Tour,0,3,8,32,2,7,0,40,0
"Australian rules football: Bairnsdale join Gippsland League, will play first game in Warragul",0,1,5,74,2,12,0,79,0
GFC: Moody's to pay $1.1 billion to settle claims it inflated ratings in lead-up to financial crisis,0,2,4,73,5,16,2,77,0
22 Puns That Went WAY Too Far,0,3,8,13,0,6,2,21,0
Blood Banks See Massive Response After Orlando Attack,0,2,8,38,0,7,0,46,0
Fortieth anniversary of first manned Moon landing,0,1,2,41,0,6,0,43,0
Apple’s cheap iPad is tailor-made for education,0,3,2,37,2,6,0,39,0
Oregon's Dillon Brooks Posterizes UCLA's Ike Anigbogu,0,3,10,35,2,6,0,45,0
Victims of Illegal Alien Crime on ’Sham’ Colorado Cruz Win: This Is ’Third World Tyranny’ - Breitbart,0,2,14,65,6,16,0,79,0
This Is How The World Celebrated 2017 (And The End Of Goddamn 2016),0,2,11,34,2,12,8,45,0
"Fitness takes hard work to gain, but how fast does it fade? Featured Stories Additional stories",0,3,4,74,2,15,0,78,0
Trump: We ‘Can Never Be Totally Confident’ Canadian Border Is Secure,0,3,11,44,3,10,0,55,0
Getting Around: How Urban Transportation And Planning Unlock The Future Of Accessibility,0,3,12,64,1,11,0,76,0
Trump says H&R Block will be unhappy with his tax plan,0,3,4,39,1,10,0,43,0
Robert Newman: ‘Scientists think we’re all stupid. It makes me angry…’,0,2,4,50,6,10,0,54,0
Chrisette Michele Tries To Rationalize Trump Inauguration Gig Again On 'The Breakfast Club',0,3,13,64,2,12,0,77,0
Wall Street Ends Week With Losses,0,1,6,22,0,5,0,28,0
"City To Pay $885,000 To Family Whose Dog Was Killed By Police",0,3,11,31,2,11,6,42,0
Coach's wife escorted out of arena after loudly cursing at NCAA tourney,0,2,5,54,1,11,0,59,0
Iran announces its building of a second nuclear power plant,0,1,1,49,0,9,0,50,0
Armed gunmen attack cruise ship off Somali coast,0,1,2,39,0,7,0,41,0
Liberty Falls to 0-3,0,1,2,12,1,3,2,14,0
Off-duty New York correction officer shot and killed while sitting in car ,0,3,3,58,1,12,0,61,0
Twitter's controversial head of China leaves after eight months,0,3,2,52,1,8,0,54,0
Walt Disney Plans to Lay Off Workers,0,1,6,24,0,6,0,30,0
Seven Business Leadership Lessons From Dwight Eisenhower,0,2,7,43,0,6,0,50,0
Nokia recalls 14 million phone chargers,0,1,1,31,0,5,2,32,0
Police officer dines with 4-year-old girl in adorable video - Yahoo,0,3,2,51,3,10,1,53,0
US army commander in Afghanistan asks for more troops in leaked report,0,1,3,56,0,11,0,59,0
"G.M. Notifying 1,100 Dealers That They Will Be Dropped",0,1,9,30,3,8,4,39,0
"Kushner, Bannon sit down to work out differences on Trump’s orders",0,3,3,51,2,10,0,54,0
"California fault capable of producing magnitude-7.4 earthquake, study says ",0,3,1,60,3,9,2,61,0
"NSA Tried PR Effort With Film “Enemy Of The State,” Was Massively Disappointed",0,2,16,47,3,12,0,63,0
We cannot possibly confirm Judge Gorsuch before the election,0,3,3,49,0,8,0,52,0
"The Fish Are Biting, and the Room Is Hopping",0,1,7,28,1,8,0,35,0
18 YA Books We Can’t Wait To Read In 2017,0,3,9,16,1,9,6,25,0
Home Refinancing Hobbled by Variety of Obstacles,0,1,5,37,0,6,0,42,0
Soros Lost Nearly $1 Billion in Weeks After Trump Election | Fox Business,0,3,10,48,2,12,1,58,0
French and British Submarines Collide,0,1,4,29,0,4,0,33,0
Twinkies ice cream has arrived on a planet that might not be ready for it,0,3,1,58,0,14,0,59,0
Trump Suggests Using Bedrock China Policy as Bargaining Chip ,0,2,8,44,0,9,0,52,0
Ex-Navy secretary: Facebook group scandal is inexcusable,0,3,3,45,2,6,0,48,0
Elton John Cancels Entire Caesars Palace Run Due to 'Unusual Bacterial Infection',0,3,11,57,2,11,0,68,0
Florida Man Accused Of Repeatedly Sexually Assaulting Pit Bull,0,3,9,45,0,8,0,54,0
Nearly One In Five LinkedIn Members Say Health Insurance Affected Job Choice,0,2,13,52,0,11,0,65,0
"Cheetahs, tigers and lions now illegal pets in the UAE",0,3,4,40,1,9,0,44,0
"Review: In ‘Get Out,’ Guess Who’s Coming to Dinner? (Bad Idea!) ",0,3,10,34,9,11,0,44,0
"Anthony Scaramucci Joining Trump Administration, Transition Team Confirms",0,2,8,57,1,7,0,65,0
Fox News security hole exposes 1.5 million users' personal information,0,1,2,55,2,9,2,57,0
Spies Keep Intelligence From Donald Trump on Leak Concerns,0,3,8,42,0,8,0,50,0
Israeli police and Palestinians clash in Jerusalem,0,1,3,41,0,6,0,44,0
Ohio State Buckeyes QB Cardale Jones living the dream this summer - Big Ten Blog- ESPN,0,3,14,55,2,15,0,69,0
Mitsubishi Heavy IndustriesVoice: Emergency Mobile Power: A Lifeline In Times Of Crises,0,3,13,61,2,11,0,74,0
"""Homeland's"" Rupert Friend reads WWI poem on gas attack",0,3,6,38,3,8,0,44,0
Theater Refuses To Be A Safe Space For Donald Trump,0,2,10,32,0,9,0,42,0
"Smoking causes one in 10 deaths worldwide, study shows",0,2,1,42,1,8,2,43,0
"Number of cholera deaths in Zimbabwe surpasses 4,000",0,1,2,38,1,7,4,40,0
Samsung unveils first new Galaxy 8 phone since Note 7 – video,0,3,3,44,1,11,2,47,0
"Actor and comedian Ricky Harris, who worked alongside the greats, dies at 54",0,3,3,57,2,12,2,60,0
Shinzo Abe's LDP suffers set-back in Japanese elections,0,1,6,40,2,7,0,46,0
Why Millennials Choose To Join Corporate America Over Becoming Entrepreneurs,0,2,10,57,0,9,0,67,0
"The Untold Story of Kobe Buffalomeat, CFB Recruit-Turned-Social Media Sensation",0,3,13,54,3,9,0,67,0
House Democrats Slam FBI Director James Comey After Closed-Door Briefing ,0,3,13,49,1,10,0,62,0
"Jimmy Wales' new project is like Wikipedia, but to 'fix' the news",0,3,3,47,4,11,0,50,0
Journalist shot dead in front of her 6-year-old son,0,2,1,39,2,8,1,40,0
GOP senators unveil measure on U.S. embassy move to Jerusalem,0,3,6,44,2,9,0,50,0
"Ranbir-Saif Impress Kareena & Karisma With Their Culinary Skills, Turn Chefs At A Family Dinner!",0,2,15,63,4,14,0,78,0
Cavaliers Agree to Sell Stake to Chinese Investment Group,0,1,7,42,0,8,0,49,0
Highlights and Analysis of the 2017 Oscars ,0,2,3,29,0,7,4,32,0
Husband accused of killing wife auctions off her furs and jewelry,0,2,1,54,0,10,0,55,0
Supreme Court Blocks Obama Climate Change Rule During Appeals,0,2,9,44,0,8,0,53,0
"Identifying the Bird, When Not Much Bird Is Left",0,1,8,31,1,8,0,39,0
"Erica Powell, Nkrumah's private secretary dies",0,1,3,36,2,5,0,39,0
"F.D.A. Is Lax on Oversight During Trials, Inquiry Finds",0,1,10,33,4,8,0,43,0
"Trump Aide Reassures Canada on Trade Talks, Isolating Mexico",0,2,8,43,1,8,0,51,0
Florida grand jury to hear 2013 police shooting of black man holding fake gun,0,2,1,59,0,13,4,60,0
Housing market grinds to a halt as number of homes on market hits record low,0,3,1,61,0,14,0,62,0
"Trump May Be Softening On Mexico And NAFTA, And That's Good For The U.S.",0,3,19,36,4,13,0,55,0
Dennis Hastert pleads not guilty on all counts,0,3,2,37,0,7,0,39,0
Court approves single largest dismissal of convictions in U.S. history,0,3,3,56,2,9,0,59,0
Authorities search home of owner of German Wikileaks domain,0,1,3,48,0,8,0,51,0
"McDonald's to launch ordering app, expand delivery",0,3,2,40,2,6,0,42,0
LG G6 ushers in a new era of smartphones with huge screens,0,3,3,43,0,11,1,46,0
The Co-operative Group purchases Somerfield supermarket chain for over £1.5 billion,0,1,4,64,3,10,2,68,0
BP: Plug for underwater oil leak in Gulf of Mexico fails,0,1,5,40,1,10,0,45,0
Uber’s Clash With Regulators Moves to Self-Driving Cars ,0,3,8,38,2,8,0,46,0
Tweak It or Junk It? Trump’s Shifting Signals on Nafta,0,3,8,35,2,9,0,43,0
Paul Nuttall's Stoke byelection papers gave address he had not moved into,0,3,3,58,1,11,0,61,0
"Trump’s Interests vs. America’s, Blind-Trust Edition",0,2,6,36,5,5,0,42,0
Trump said in 2014 that Russian hacking was a 'big problem',0,3,2,41,2,10,4,43,0
Wall Street: US stocks continue slow grind up,0,2,4,33,1,7,0,37,0
'He did nothing wrong': Florida principal ousted after defending Texas cop ,0,2,3,58,3,11,0,61,0
King v. Burwell: How one Supreme Court case could unravel Obamacare,0,2,6,49,2,10,0,55,0
Gastric bypass surgery performed by remote control,0,1,1,43,0,6,0,44,0
Oil rig count jumps by 17,0,3,1,17,0,5,2,18,0
Political Scandal Overshadows South Korea 2018 Olympic Prep,0,3,7,41,0,7,4,48,0
Rebuilding the Lions Is a Challenge for Martin Mayhew,0,1,6,39,0,8,0,45,0
E-sports to become a medal event in 2022 Asian Games,0,3,3,35,1,9,4,38,0
A daughter shows her mother the transformative power of travel (Paid Content by DoubleTree by Hilton),0,3,6,78,2,15,0,84,0
This is winter life on a cold Canadian island,0,2,2,35,0,8,0,37,0
New Wave of Anti-Semitic Threats Rattle U.S. ,0,2,8,27,3,7,0,35,0
Bank Mergers Spread in Mideast as Low Oil Signals Boom Days Over,0,3,10,43,0,11,0,53,0
Why President Trump Needs A Five-Year Defense Plan On Day One,0,3,12,38,1,10,0,50,0
Los Angeles Lakers need to win game six to tie NBA championship,0,1,6,46,0,11,0,52,0
Bernie Sanders hires Elizabeth Warren 'draft' director for progressive campaign,0,2,4,64,2,9,0,68,0
Watch Wisin and Ozuna Perform 'Escapate Conmigo' at the 2017 Billboard Latin Music Awards,0,2,10,60,2,13,4,70,0
Nurses charged with ignoring bleeding patient after he fell,0,2,1,50,0,8,0,51,0
Patriarchy is the sea in which Trump and his sharks gather,0,3,2,46,0,10,0,48,0
Samsung's Galaxy S8 Arrives at a Critical Time for Smartphones,0,2,7,44,1,9,1,51,0
Trump stands by unverified wiretap claim,0,3,1,34,0,5,0,35,0
Wall St. dips after Fed rate hike; tech slumps again,0,2,3,38,2,9,0,41,0
Super Tuesday 2012: 'Joe the Plumber' wins GOP congressional primary,0,1,7,45,3,9,4,52,0
"In Wyoming, Debate Rages Over Elk Feeding Program",0,1,8,33,1,7,0,41,0
The feds dawdle while patients die needlessly,0,2,1,38,0,6,0,39,0
Japan's economy sees biggest decline since 1974,0,1,1,35,1,6,4,36,0
The next phase of the on-demand economy: Haircuts by delivery,0,3,2,48,2,9,0,50,0
The soup business has grown cold. Inside Campbell’s plan to turn up the heat.,0,2,3,58,3,13,0,61,0
"Romeo Santos, Carlos Vives & More Latin Artists Who Broke Records on YouTube in 2016",0,3,12,52,2,14,4,64,0
Actor Robert Blake acquitted,0,1,3,22,0,3,0,25,0
Jeff Sessions Omits Decades Of Records For His AG Confirmation Hearing,0,2,12,48,0,10,0,60,0
Closing the Gap report: What is the Redfern Statement?,0,2,5,39,2,8,0,44,0
Nurturing the father-daughter relationship I didn’t have,0,2,2,46,2,6,0,48,0
Why Greece May Be Able to Wait Until Winter for a Third Bailout - Real Time Brussels,0,3,13,54,1,16,0,67,0
"Chris Grayling sent cyclist flying with his car door, video shows",0,3,2,52,1,10,0,54,0
They raise the world's happiest children - so is it time you went Dutch?,0,3,2,54,3,13,0,56,0
Higher Oil Prices Help Widen U.S. Trade Deficit,0,1,9,29,2,7,0,38,0
U.S. Army Corps Gives Eviction Notice to Dakota Access Protest Camp,0,3,11,44,2,10,0,55,0
15 Black Girls We Loved Watching On TV In The ’90s,0,3,10,25,1,10,4,35,0
WikiLeaks dump shows how CIA compromised iPhones and Macs,0,2,7,42,0,8,0,49,0
Singer Taina Asili Releases Bilingual Anti-Trump Music Video ‘No Es Mi Presidente’ (Video),0,3,14,59,5,12,0,73,0
Skyward: Fox buys film about family trying to escape over a wall,0,2,2,50,1,11,0,52,0
"Indiana kids dead after falling through ice on pond behind home, authorities say",0,2,1,66,1,12,0,67,0
Malala Yousafzai says Trump 'needs to go and visit the refugee camps',0,3,3,53,2,11,0,56,0
Yanks Lose Chance to Move Into First When Bullpen Falters,0,1,9,39,0,9,0,48,0
Fairy floss and Facebook: Millennials harness social media to build businesses,0,3,3,64,1,10,0,67,0
Leader Of GOP’s House Hardliners Shoots Down O’Care Replacement Draft,0,2,13,45,2,9,0,58,0
Premiering Tonight at 7pm ET: Martha MacCallum Hosts 'The First 100 Days'  Insider,0,3,12,50,3,13,4,62,0
Lashkar-e-Toiba implicated in Mumbai attacks,0,1,3,35,2,4,0,38,0
Nigel Farage 'knighted' by six-year-old girl who then asks if he hates foreigners,0,2,2,63,4,12,0,65,0
You Will Soon Be Able to Play as Ariana Grande in 'Final Fantasy: Brave Exvius',0,3,12,50,3,14,0,62,0
Trump Kicks off MLK Day Weekend by Trashing Civil Rights Leader John Lewis on Twitter,0,3,14,57,0,14,0,71,0
"Rick Ross to Host 2017 MTV Woodies, Talks Upcoming Ninth Album: Exclusive",0,2,12,44,2,11,4,56,0
"Europe migrants crisis: UN alarmed at asylum seekers dying of cold, 'dire' situation in Greece",0,2,4,72,4,14,0,76,0
Here's What Happens to Endowments When Colleges Close,0,2,7,38,1,7,0,45,0
These parts of the ACA could be eliminated in a GOP health-care deal,0,3,7,48,1,12,0,55,0
"Though Many Are Stalked, Few Report It",0,1,7,24,1,6,0,31,0
European Lawmakers Crack Down on Import of Conflict Minerals,0,2,7,45,0,8,0,52,0
Wikinews interviews Dr. Robert Kelly and Dr. Jim Gill regarding joint scientific venture in North Korea,0,1,9,77,2,15,0,86,0
Announcer at All-Star Saturday Awkwardly Introduced Kevin Durant as 'OKC's Own',0,2,12,53,4,10,0,65,0
"One dead after motorcycle and car collision in Guernsey, Channel Islands",0,1,4,57,1,10,0,61,0
Trump administration signals change in policy for transgender students,0,2,1,61,0,8,0,62,0
"Despite Getting Hit By A Six From Suresh Raina, This 6-Year-Old Boy Returned To Watch The Match - What A Fan!",0,3,21,62,5,20,1,83,0
France election: Fillon apologises over family payments,0,3,2,46,1,6,0,48,0
"More than 40 Somali refugees killed in helicopter attack off Yemen coast, official says",0,2,3,68,1,13,2,71,0
Notre Dame's Matt Farrell Has Emotional Surprise Reunion With Brother Back From Afghanistan,0,3,13,65,1,12,0,78,0
"Not What We Expected, Virender Sehwag And Randeep Hooda Join Trolls Against DU's Gurmehar Kaur",0,3,16,62,2,14,0,78,0
University mourns sorority sister who died after pancake-eating contest,0,2,1,61,1,8,0,62,0
A top ISIS official’s death could have major implications for the future of the group,0,2,5,65,1,14,0,70,0
'He could have stated his response more accurately': Trump stands with Sessions amid Russian chaos,0,3,4,77,3,14,0,81,0
3 reasons the economy boomed in 2015,0,2,0,25,0,6,5,25,0
Morehead State Gains Berth Against  Louisville,0,1,6,34,0,6,0,40,0
"In New York, Sotomayor Put Focus on the Poor",0,1,7,28,1,8,0,35,0
Thousands of Filipinos call for President Arroyo's resignation; former presidents join protest,0,1,4,77,2,11,0,81,0
"NASA Reddit: 'Brain farts', life in TRAPPIST-1 and getting humans there",0,3,14,41,5,10,1,55,0
"In Major Defeat for Trump, Push to Repeal Health Law Fails ",0,2,9,38,1,11,0,47,0
Google just passed Apple to become the most valuable company in the world,0,2,2,59,0,12,0,61,0
"Pope Francis Urges Peace, Comforts Terror Victims in Christmas Message",0,2,9,51,1,9,0,60,0
Tail from Air France jet recovered from Atlantic Ocean,0,1,5,41,0,8,0,46,0
Let a Shirtless Ryan Phillippe Brighten Your Day,0,3,7,34,0,7,0,41,0
"One dead after Mt Warning campers struck by lightning, rescue operation underway",0,3,3,65,1,11,0,68,0
Marc Anthony and Wife Shannon de Lima Officially Split,0,3,7,39,0,8,0,46,0
Look! Up in the sky! It's a new kind of cloud,0,3,3,29,3,10,0,32,0
7 Blasts Around Baghdad Kill at Least 24,0,1,5,25,0,7,3,30,0
Trump Voters Shrug Off Global Uproar Over Immigration Ban,0,3,9,40,0,8,0,49,0
From Bowie to Solange: Here are the top 10 albums of 2016,0,3,4,35,1,11,6,39,0
Is Apple thinking about nixing the headphone jack from laptops?,0,2,2,51,1,9,0,53,0
Here’s how Amex Platinum’s new perks compare to Chase Sapphire Reserve,0,3,6,52,2,10,0,58,0
"Hair, Sperm, Libido, Delhi Men Are Losing It The Most",0,2,10,31,3,9,0,41,0
Italy’s Padoan Says Le Pen Win Would Be a Risk After Brexit,0,3,11,36,1,11,0,47,0
Michael Flynn's son resigns from Trump transition team,0,2,3,43,1,7,0,46,0
Unify the Phone Numbers and All Else Follows,0,1,6,31,0,7,0,37,0
Marshawn Lynch visits Raiders; source says deal could happen,0,2,3,48,1,8,0,51,0
Elon Musk Touts Latest Dream: Underground Roadways ,0,3,7,36,1,7,0,43,0
Parents speak out about backlash over YouTube prank videos: 'We were going for shock value',0,3,4,70,3,14,0,74,0
"Consumers Hold Back, Companies Pick Up Slack in Mixed U.S. Data",0,2,11,39,3,10,0,50,0
Taiwan’s Blue Camp pays respects on the thirtieth anniversary of the passing of Chiang Kai-shek,0,1,5,74,2,14,0,79,0
Black Lives Matter activists occupy sidewalk in front of L.A. mayor’s house,0,2,5,56,3,11,0,61,0
Watch Live: Family of Baton Rouge Deputy Shot in Deadly Ambush Speaks,0,3,10,47,1,11,0,57,0
"Let students live alongside elderly in care homes to fight 'inter-generational apartheid', says report",0,3,1,84,4,13,0,85,0
How A Swiss Affiliate Led To Thursday's Federal Raid Of Caterpillar's Headquarters,0,3,12,57,2,11,0,69,0
"Geert Wilders, Dutch Far-Right Leader, Is Convicted of Inciting Discrimination ",0,2,10,56,3,10,0,66,0
Report from Royal International Air Tattoo 2009,0,1,5,32,0,6,4,37,0
Cyclone Debbie: Bull shark found washed up near Ayr,0,3,4,38,1,8,0,42,0
Speculation abounds on future pope,0,1,1,29,0,4,0,30,0
How Many Of These Top 100 Christmas Films Have You Seen?,0,3,10,32,1,10,3,42,0
"Clinton, Trump Aides Angrily Clash at Election Forum ",0,2,7,37,1,8,0,44,0
Trump’s Honeymoon Begins: Confidence in the Economy Is Booming ,0,3,7,45,2,9,0,52,0
"A Christmas Carol Service Accidentally Mistook 2Pac's ""Hail Mary"" For Iconic Catholic Prayer",0,3,13,63,3,12,1,76,0
Watch NBC TODAY Show Excerpt Free Online - Hospital Throws Gatsby-themed Prom for Teen Patient | Yahoo View,0,3,21,66,3,17,0,87,0
Middle-aged people should consider taking magnesium supplements to protect their bones,0,2,1,74,1,10,0,75,0
Deposed Mauritanian president Sidi Ould Cheikh Abdallahi is released,0,1,6,54,0,8,0,60,0
"Muay Thai Fighter Lands Flying Knee from Hell, Finishes Foe with Stiff Punch",0,2,11,52,1,12,0,63,0
Records reveal US Senator John Sununu had ties to convicted lobbyist,0,1,6,52,0,10,0,58,0
"Chinese police offer 300,000 yuan reward in double bus bombings",0,1,1,46,1,9,6,47,0
"Russia must be held accountable, says Mike Pence",0,2,3,37,1,7,0,40,0
Paris bans 'sexist' adverts from billboards following outcry over 'porno chic' fashion campaign ,0,3,1,78,4,13,0,79,0
Sean Spicer: Sessions Was '100 Percent Straight' With Senate Committee,0,3,9,46,3,9,3,55,0
Donald Trump raises 'conspiracy theory' after CIA concludes Russia intervened in election to help him win,0,3,6,82,2,15,0,88,0
College dispenses morning-after pill in vending machine,0,3,1,47,1,6,0,48,0
A $165 Billion Manager Says the Japanese Stock Gloom Is Overdone,0,3,9,41,1,10,3,50,0
Emmys 2015: John Stamos and Uzo Aduba to Announce This Year's Nominations,0,2,9,47,2,11,4,56,0
Porsche and VW Remain Far Apart in Deal Talks,0,1,8,29,0,8,0,37,0
Good news for people who love spicy food,0,3,1,32,0,7,0,33,0
"One converted to Islam, the other went to far-right rallies: a modern tale of two brothers",0,2,2,70,3,15,0,72,0
"Thursday NBA Roundup: Westbrook's MVP Chances Remain Strong, but Winning Matters",0,3,14,53,3,10,0,67,0
"World Cancer Day 2017: Effective cure will happen in five to 10 years, says leading expert",0,3,4,63,2,15,6,67,0
Film about Travis County DA's investigation of Texas election of 2002,0,1,6,48,1,10,4,54,0
"Estonian oil spill kills 5,000 birds",0,1,1,25,1,5,4,26,0
UConn's streak comes to an end in wild and controversial loss in Final Four,0,3,4,57,1,13,0,61,0
Sony may cut PS3 prices,0,1,3,15,0,4,1,18,0
Calvin-Hope rivalry gets new digs,0,1,2,26,1,4,0,28,0
Fernando Alonso wins 2007 Italian Grand Prix,0,1,5,29,0,6,4,34,0
OutFront: Entrepreneur Creates Inclusive Camp for LGBTQ Youth,0,3,12,41,1,7,0,53,0
Trump Changes Tactics on Tax After Health-Care Repeal Failure,0,3,9,43,1,8,0,52,0
Sending Money Overseas to Get Faster Once Banks Pick a Winner,0,2,9,42,0,10,0,51,0
Trump administration reverses transgender bathroom guidance ,0,2,1,53,0,6,0,54,0
The rise of 'modest' fashion,0,2,1,21,2,4,0,22,0
Chris Stamp Teases Another Stampd x Kith Collaboration,0,2,7,40,0,7,0,47,0
US Federal Reserve prepares to take over AIG,0,1,7,30,0,7,0,37,0
Eurovision 2017: Organising team quits en masse,0,3,2,34,1,6,4,36,0
Tiger kills handler in Shanghai zoo,0,1,2,28,0,5,0,30,0
Brazil's overcrowded prisons experience massacres 'almost daily',0,2,1,54,3,6,0,55,0
Man Posed as Justin Bieber Online to Extort Nude Photos,0,3,8,38,0,9,0,46,0
Greg Rutherford & Laura Muir win Oslo Diamond League,0,3,7,36,1,8,0,43,0
"#MarchForScience spreads to Antarctica, Arctic Circle",0,2,6,40,2,5,0,46,0
Lindsey Graham: Brokered Convention Not ’Fair’ to Donald Trump - Breitbart,0,2,9,51,4,10,0,60,0
Teen post officer hides 400 New Year cards in Japanese snow,0,1,4,42,0,10,3,46,0
International Court Begins First Trial,0,1,5,29,0,4,0,34,0
Another Court Defeat for Ohio’s Strict Voting Laws,0,2,7,35,1,7,0,42,0
"Offer of access to Trump and family at fundraiser is pulled back, but ties remain",0,3,2,64,1,14,0,66,0
Wages rising faster for union workers - Business Insider,0,3,3,44,1,8,0,47,0
Man dressed as gorilla completes London Marathon in six days,0,3,3,48,0,9,0,51,0
Canada to legalise marijuana 'by 2018',0,3,1,26,2,5,4,27,0
Charleston shooting survivors describe emotional pain Dylann Roof inflicted ,0,3,3,64,0,9,0,67,0
SUV Demand Helps Shield Maruti Suzuki From Worst of Cash Crunch,0,3,12,41,0,10,0,53,0
Why Tool Gets to Headline Governors Ball (To the Possible Shock of Lorde Fans),0,3,11,52,2,13,0,63,0
"The strange life of Q-tips, the most bizarre thing people buy",0,2,2,47,2,10,0,49,0
Inauguration Singer Jackie Evancho 'Disappointed' in Trump  Insider,0,2,7,50,2,8,0,57,0
Everyone Is Trying to Guess the Gender of Beyoncé’s Twins From Her Latest Instagram,0,2,11,58,1,13,0,69,0
Zuma Faces New Charges After Ruling,0,1,6,24,0,5,0,30,0
Celebrities Have a Lot to Say About Donald Trump’s Inauguration,0,3,8,45,1,9,0,53,0
People In Norway Are Trying To Give Finland A Mountain For Its Birthday,0,2,13,46,0,12,0,59,0
Apple has a secret team working on the holy grail for treating diabetes,0,2,1,58,0,12,0,59,0
Rime: could this indie adventure game with a big heart grow into a classic?,0,3,1,59,2,13,0,60,0
'American Horror Story' to Tackle the Most Recent American Horror: the 2016 Election,0,2,9,56,3,12,4,65,0
"As Trump Inquiries Flood Ethics Office, Director Looks To House For Action",0,2,12,50,1,11,0,62,0
Self-Defence party to stay on in the governing coalition of Poland,0,1,3,52,1,10,0,55,0
"For Likely No. 1 Pick Markelle Fultz, Will Missing NCAA Tourney Affect Career?",0,3,15,47,3,12,1,62,0
Spanish Leader Picks Fight With Catholic Church,0,1,7,34,0,6,0,41,0
Donald Trump Blasts Media and Intelligence Agencies,0,3,6,39,0,6,0,45,0
JPMORGAN: Wall Street is underestimating the next iPhone 'super cycle' (AAPL),0,3,15,47,5,10,0,62,0
"Trump Son-in-Law Poised to Quit as Family Firm CEO, Lawyer Says",0,3,12,38,3,10,0,50,0
Rick Ross Strikes Plea Deal in Felony Kidnapping & Assault Case: Report,0,2,10,48,2,11,0,58,0
"After Soldier's Suicide, Another Jawan Posts Video Complaining About Army's 'Sahayak' System",0,3,12,64,5,11,0,76,0
Video Shared By Pentagon to Tout Success of Deadly Yemen Raid Is Actually 10 Years Old,0,2,13,56,0,15,2,69,0
Carlos Santana suffers Beyhive wrath after 'out of context' quote about Beyonce's singing,0,3,4,70,3,12,0,74,0
"As Expected, Canada Cuts Key Rate to 1 Percent",0,1,7,29,1,8,1,36,0
Fatal Overdoses From Fentanyl Sold as Cocaine Detailed in Harrowing CDC Report ,0,2,12,55,0,12,0,67,0
"John Wetton, Asia and King Crimson Frontman, Dies at 67",0,3,7,35,2,9,2,42,0
Dublin travel agents occupy offices against closure,0,1,1,44,0,6,0,45,0
Keystone Pipeline Won’t Have to Use U.S. Steel Despite Trump Pledge,0,3,11,43,3,10,0,54,0
Single-engine plane crashes into home in Cyprus,0,1,2,38,1,6,0,40,0
Calif. man carrying Mace arrested on White House grounds after scaling fence,0,3,4,60,1,11,0,64,0
"Comic Relief funds allegedly invested in arms, alcohol and tobacco firms",0,1,2,59,1,10,0,61,0
San Francisco is taxing the rich to pay for free community college,0,2,2,53,0,11,0,55,0
Australian Thomas Keating charged over fatal jet ski collision in Thailand,0,3,4,60,0,10,0,64,0
"Samsung Rushed Galaxy S8 Despite Design Flaw, Says Analyst",0,2,9,39,1,8,1,48,0
Hear The Internet's Syd Float on 'Treading Water',0,3,7,32,3,7,0,39,0
Australian news network under investigation over pokie reform comments,0,1,1,61,0,8,0,62,0
Heroic MP Tobias Ellwood seen leaving Westminster before Pc Palmer's funeral,0,3,8,57,1,10,0,65,0
Canada's Best Employers 2017,0,2,3,17,1,3,4,20,0
Investor Peter Thiel Is Helping Mold Tech’s Ties to Donald Trump ,0,3,10,43,1,11,0,53,0
Tube strike 2017: Which services will be affected?,0,3,2,35,2,7,4,37,0
"It's time for some messy, democratic discussions about the future of AI",0,3,3,55,2,11,0,58,0
Atomic Agency Fails to Elect New Head,0,1,6,25,0,6,0,31,0
Indonesia suspends military cooperation with Australia after training material insult,0,3,2,74,0,9,0,76,0
"Russia Stirs Friction in Balkans, as NATO Keeps an Uneasy Peace ",0,3,11,41,1,11,0,52,0
Court Restores Qwest Insider Trading Conviction,0,1,6,36,0,5,0,42,0
Hepatitis scare at New Zealand McDonald's restaurant,0,1,5,40,1,6,0,45,0
Here's Rihanna's Next Puma Collaboration,0,3,5,29,2,4,0,34,0
30 Under 30 Spotlight: Derek Dolin Of Team Calvin Harris,0,2,8,34,1,9,4,42,0
Obama's last money shower for the UN: some $9.2 billion ,0,3,3,37,4,10,2,40,0
Premio Lo Nuestro 2017: See the Full Winners List,0,2,7,29,1,8,4,36,0
Afghan Response to Female Pilot’s U.S. Asylum Case: ‘I Am Sure She Lied’ - The New York Times,0,2,17,52,7,17,0,69,0
JPMorgan Pulled Cash Early From Madoff-Linked Funds,0,1,10,34,1,6,0,44,0
"British Food, Explained For Americans",0,3,5,27,1,4,0,32,0
American Airlines jet catches fire on takeoff at Chicago airport,0,2,3,52,0,9,0,55,0
De Blasio Administration Wants High-Sodium Warnings on Menus ,0,2,8,44,1,8,0,52,0
WiMAX Forum: WiMAX usage anticipated to increase significantly over next four years,0,1,9,62,1,11,0,71,0
More Gauges Tell Same Story: Lasting U.S. Wage Growth Remains Elusive,0,2,12,44,3,10,0,56,0
Paris Airport Attacker Said He Was Ready 'To Die For Allah' And Had Vowed To Kill Others,0,3,17,53,2,16,0,70,0
Manchester City’s 10 men sink Burnley thanks to Clichy and Agüero,0,2,5,47,1,10,2,52,0
Here come initial jobless claims...,0,3,1,27,3,4,0,28,0
Inside Mosul: What's life like under Islamic State?,0,3,5,36,3,7,0,41,0
Muted Response From Health Lobby as Affordable Care Act Faces Repeal ,0,3,10,48,0,11,0,58,0
"Pittsburgh Pirates defeat Philadelphia Phillies, 3-0",0,1,4,39,2,5,2,43,0
Two big California pension systems oppose nine Wells Fargo directors,0,2,4,55,0,9,0,59,0
Struggling to Rise in Suburbs Where Failing Means Fitting In,0,1,8,43,0,9,0,51,0
Online calculator aims to help people decide if private health insurance is worth the cost,0,3,1,75,0,14,0,76,0
"J Balvin Drops New Track & Video 'Si Tu Novio Te Deja Sola,' Feat. Bad Bunny",0,3,15,41,5,15,0,56,0
A Growth Area for Law Firms: Bankruptcy,0,1,6,26,1,6,0,32,0
Canadian military hosts first gay military wedding,0,1,1,43,0,6,0,44,0
Ex-Nike Employee Auctioning Original Jordans to Protest Trump,0,3,8,45,1,7,0,53,0
"U.S. women beat Australia, 3-1, in World Cup opener",0,2,5,31,5,8,2,36,0
Happy Bill Belichick Day: Hiring him 17 years ago changed Patriots forever,0,2,6,54,1,11,2,60,0
EU leaders will veto any attempt to make March 29 a 'cut off date' for free movement ,0,3,3,61,2,17,2,64,0
I sat in Peugeot's Instinct concept car and it told me to relax,0,2,3,47,1,12,0,50,0
Justice Department appeals judge's order temporarily blocking Trump's travel ban ,0,3,3,66,2,10,0,69,0
Chrissy Teigen Fires Back At Donald Trump's Inauguration Tweet,0,3,9,44,1,8,0,53,0
British Airways Reports $595 Million Annual Loss,0,1,6,32,1,6,3,38,0
Former Pennsylvania Governor George Leader dies aged 95,0,1,5,41,0,7,2,46,0
Hackers blamed for setting off 156 emergency sirens across Dallas,0,3,2,51,0,9,3,53,0
Pioneer chemist Albert Hofmann dies at age 102,0,1,3,33,0,7,3,36,0
"A lawmaker retweeted an offensive post about the Women’s March. Days later, he resigned.",0,3,4,67,4,13,0,71,0
Madeleine Albright: Trump's Immigration Ban Is 'Anti-American',0,3,8,43,5,6,0,51,0
Ranveer Singh And Akshay Kumar Jamming On 'Hookah Baar' Is Absolutely Entertaining And Unmissable!,0,2,14,68,3,13,0,82,0
"Boeing 787 ""Dreamliner"" makes maiden flight",0,1,2,31,2,5,3,33,0
Former Russian lawmaker's killing latest violence against Kremlin critics,0,3,3,61,1,8,0,64,0
Religious Groups Seek Swift Ban From Obama on Torture,0,1,8,37,0,8,0,45,0
Ex-Banking Chiefs Still Collect Perks or Paychecks,0,1,7,36,1,6,0,43,0
Trump's 'sanctuary' order sets up showdown between cities and states ,0,3,1,55,3,10,0,56,0
Change at Union May Re-energize Hollywood Talks,0,1,6,34,1,6,0,40,0
"Attack occurs in Stavropol, Russia; at least six dead",0,1,3,40,2,8,0,43,0
Germany selects squad for Euro 2008,0,1,2,24,0,5,4,26,0
Mariah Carey's Rep Says 'Rockin' Eve' Producers 'Set Her Up to Fail',0,2,11,40,6,11,0,51,0
Tokyo Tops Monocle’s Most Livable City Ranking - Japan Real Time,0,3,10,42,2,10,0,52,0
Jimmy Butler Rips Marcus Smart for 'Acting Tough' With Him: 'He's Not About That Life',0,2,14,52,6,14,0,66,0
French police ban public meetings and increase security measures in Paris,0,1,2,61,0,10,0,63,0
Ikea's New Leave Policy Offers Up to 4 Months Paid for New Mothers and Fathers - Yahoo,0,3,12,55,2,16,1,67,0
Blackstone to Spend $500 Million Remaking Chicago’s Willis Tower,0,2,7,44,2,8,3,51,0
I Went to My First Classical Music Concert. It Was in My Living Room. - The New York Times,0,2,16,53,3,18,0,69,0
"Brexit Brexit decision won't prevent UK from leaving EU, but it may put the brakes on",0,3,6,62,2,15,0,68,0
Video Leads London Police to Suspend Officer,0,1,6,32,0,6,0,38,0
Lawmaker who called pregnant women a ‘host’ pushes bill requiring fathers to approve abortion,0,2,1,77,2,13,0,78,0
"San Bernardino school shooting: 'I'm scared,' panicked 911 caller says ",0,2,3,50,5,10,3,53,0
Greek police investigates murder of actor,0,1,1,35,0,5,0,36,0
Pope Admits Online News Can Provide Infallible Aid,0,1,8,35,0,7,0,43,0
"Explosion in San Francisco injures one, cause unknown",0,1,3,42,1,7,0,45,0
Atlanta Zoo Names Cockroach After Tom Brady,0,3,7,30,0,6,0,37,0
BP: New cap on Gulf of Mexico oil well in place,0,1,5,31,1,10,0,36,0
Troubles envoy warns of damage from row about prosecuting UK troops,0,2,3,54,0,10,0,57,0
John Clarke's final curtain call as last Clarke and Dawe episode released,0,2,4,57,1,11,0,61,0
"On Separate Trips, Kerry and 2 U.S. Representatives Visit Gaza",0,1,9,40,3,9,1,49,0
Huge Search Operation Is Underway To Find Bodies Of Crashed Russian Military Plane Passengers,0,2,14,66,0,13,0,80,0
Orphan finds his own happiness after mission to make strangers smile,0,3,1,57,0,10,0,58,0
Trump’s Two Supreme Court Finalists Are Summoned for Announcement,0,3,8,48,1,8,0,56,0
Hofstra fraternity accused of sickening hazing rituals ,0,3,1,47,0,7,0,48,0
Obama: 'Vladimir Putin is not on our team',0,2,3,29,3,7,0,32,0
Arrival 'sucked' and Meryl Streep performed 'like a clown' – what one Oscars voter really thinks ,0,3,4,72,5,16,0,76,0
Pope Expected to Address Role of Church in Canadian Abuses,0,1,7,42,0,9,0,49,0
Chaffetz on Flynn's 'Story to Tell': Congress Should Not Give Immunity Amid FBI Probe  Insider,0,3,15,60,4,15,0,75,0
Biden attacks Donald Trump for 'mindless' dismissal of agencies' intelligence,0,3,3,62,3,9,0,65,0
"Five children found dead in Graham, Washington",0,1,3,36,1,6,0,39,0
"Nearly 25,000 Iraqi civilians killed in Iraq, watchdog group claims",0,1,3,48,2,9,5,51,0
De Blasio & Co. just can’t stop lying about schools,0,2,3,36,3,9,0,39,0
Kendrick Lamar Debunks Theory That Another Album Is Coming,0,3,9,41,0,8,0,50,0
Bus Accident Injures Passengers in Lincoln Tunnel,0,2,6,37,0,6,0,43,0
Trump Dismisses Arguments Against Travel Ban as ‘Disgraceful’ During Sheriffs Conference,0,3,10,66,2,10,0,76,0
Ed Sheeran's 'Shape of You' & 4 Other Songs That Added Writers After Release,0,3,11,47,4,13,1,58,0
Frog-killing fungus spreads across Panama Canal towards South America,0,1,5,55,1,8,0,60,0
Ex-Gitmo detainee connected to Turkey airport attack added to US list of terrorists,0,2,5,65,1,12,0,70,0
"Adam West, Burt Ward promise return to Batman and Robin",0,2,6,39,1,9,0,45,0
Ed Sheeran reaches deal to end $20m copyright infringement claim over 'Photograph',0,3,3,63,3,11,2,66,0
MV Rachel Corrie seized by Israeli Naval Forces,0,1,7,33,0,7,0,40,0
Qatar Airways Increases Its Order for Airbus Jetliners,0,1,7,40,0,7,0,47,0
Little Girl Adorably Blames Elf on the Shelf After Getting Caught Playing With Lipstick,0,3,12,62,0,13,0,74,0
Warriors' bid thwarted by Dion Waiters' heroics,0,3,3,36,2,6,0,39,0
'Body' of crashed Russian military jet found in search for black box,0,2,2,53,2,11,0,55,0
A Good Time to Remember Investment Fundamentals,0,1,6,35,0,6,0,41,0
Turkey's southern border is becoming a key hub for refugees fleeing Aleppo,0,3,2,60,1,11,0,62,0
"President of Peruvian Truth Commission reports death threats, anti-semitic hatemail",0,1,4,68,2,9,0,72,0
"'Queen' Director Vikas Bahl Accused Of Molesting A Co-Worker, Asked To Quit Phantom Films According To A Report",0,3,19,71,4,17,0,90,0
Pelé cries as his son admits to marijuana addiction,0,1,1,42,0,8,0,43,0
Dolphin dies during performance at theme park,0,1,1,38,0,6,0,39,0
Scotland's Dario Franchitti wins Indianapolis 500,0,1,4,36,1,5,3,40,0
Princeton Goes International for StarCraft E-Competition,0,1,7,43,1,5,0,50,0
Mexico may be using another cartel kingpin to gain leverage with Trump,0,3,2,57,0,11,0,59,0
Bloomberg Daybreak,0,3,2,15,0,1,0,17,0
Miami Marlins Claim To Have $1.6 Billion Handshake Agreement For Team,0,3,10,45,2,10,2,55,0
Netflix Film 'Barry' Offers Portrait of President Obama's College Days,0,2,9,49,3,9,0,58,0
Trump's 'Massive' Middle-Class Tax Cuts Are Tiny Compared To Those Promised To The Rich,0,3,15,55,4,13,0,70,0
"Mexico's Drug War Marks a Decade Amid Doubts, Changes ",0,3,8,35,2,9,0,43,0
No. 20 Louisville Wears Down No. 12 Notre Dame,0,1,7,25,2,8,4,32,0
Lady Gaga Had The Classiest Response After She Was Body-Shamed At The Super Bowl,0,2,15,51,1,13,0,66,0
Pornhub Wants To Make The First Ever Sex Tape In Space,0,3,11,33,0,10,0,44,0
'Tim Hortons' coffee shops to go 'Cold Stone',0,1,4,30,4,7,0,34,0
Thieves reportedly use smoke bombs to target shop in Venice,0,3,2,48,0,9,0,50,0
Nepali capital Kathmandu shut down after rebel strike,0,1,2,44,0,7,0,46,0
Chicago approves new handgun regulations,0,1,1,35,0,4,0,36,0
Turning the page? Trump dines with Mexican billionaire Slim,0,2,4,46,1,8,0,50,0
Treasury hits back at 'scaremongering' over business rate changes,0,2,1,54,2,8,0,55,0
Big Investor in Fortis Opposes Buyout by BNP,0,1,8,29,0,7,0,37,0
Sculptor of that widely mocked Ronaldo bust compares himself to Jesus,0,3,3,56,0,10,0,59,0
Re-INK-arnation! Thousands of Buddhists get their tattoos redrawn by monks at sacred spiritual festival ,0,3,6,81,3,14,0,87,0
Katy Brand: ‘Victoria Wood's Two Soups is the funniest sketch ever’,0,3,6,47,4,10,0,53,0
"In Innovation, U.S. Said to Be Losing Competitive Edge",0,1,9,34,3,8,0,43,0
US avoids Syria talks as deadly explosion rocks refugee camp,0,2,3,48,0,9,0,51,0
Facebook wants to get smarter about suicide prevention,0,3,1,46,0,7,0,47,0
Yorkshire Ripper questioned over 17 unsolved crimes - including hammer attack on 14-year-old girl,0,3,2,75,3,13,4,77,0
Panasonic GH1 Merges S.L.R. Photos With HD Video,0,1,12,25,3,7,1,37,0
Chile minister says sorry after receiving sex doll gift,0,3,1,46,0,8,0,47,0
Washington becomes first state to sue Donald Trump over ‘Muslim ban’,0,3,4,52,2,10,0,56,0
Korean-American in North Korea confesses to stealing secrets: media,0,2,4,53,2,8,0,57,0
Non-infectious diseases such as cancer rising sharply in Africa,0,2,2,52,1,8,0,54,0
"See Inside Newly Discovered 3,500-Year-Old Egyptian Tomb",0,3,8,35,3,6,4,43,0
Mom Outraged Over Video Showing Four-Year-Old Son Forced to Kiss Boy at Daycare,0,3,13,52,2,12,0,65,0
"FBI arrests nearly all of the top officials of Crystal City, Tex.",0,2,6,46,2,11,0,52,0
"At least 175 killed, 200 injured in northwestern Iraq",0,1,2,36,1,8,6,38,0
"""NJ Weedman"" raided by SWAT team while streaming on Facebook Live",0,3,9,44,2,10,0,53,0
2015 Women's World Cup Predictions | FiveThirtyEight,0,2,7,33,2,6,4,40,0
Watch Shawn Mendes & Camila Cabello Crush a Cover of Ed Sheeran's 'Kiss Me',0,2,11,47,4,13,0,58,0
British Union Trims Aid to Party,0,1,5,22,0,5,0,27,0
Damon Stays Hot and Powers Yanks,0,1,5,22,0,5,0,27,0
Bill Clinton’s Costly Assault Weapons Ban,0,2,6,29,1,5,0,35,0
Apple cancels NBC Fall TV lineup on iTunes,0,1,8,27,0,7,0,35,0
David Ahenakew removed from the Order of Canada,0,1,4,36,0,7,0,40,0
Perry Sees Low Scores From Wet Conditions,0,1,7,28,0,6,0,35,0
British snooker player Alex Higgins found dead at age 61,0,1,3,42,0,9,2,45,0
Trump and Clinton Aides Clash During Election Forum ,0,3,7,37,0,8,0,44,0
Oil Prices Meander as U.S. Production Rises and Holiday Approaches  ,0,3,9,46,2,11,0,55,0
Three Elderly Female Bystanders Hospitalised After Police Shooting,0,2,8,51,0,7,0,59,0
Moelis Rallies After Winning Role on Record Aramco IPO,0,3,10,36,0,8,0,46,0
TomTom Go 740 Live Has Cellphone Connectivity,0,1,7,29,0,6,3,36,0
"Colin Powell, in Hacked Emails, Shows Scorn for Trump and Irritation at Clinton - The New York Times",0,2,13,67,3,17,0,80,0
"What Is 5G, And Who's Leading The Way In Development?",0,2,10,30,3,9,1,40,0
"Demi Lovato Rocks Bikini Bod, Shares Inspiring Message",0,2,8,38,1,7,0,46,0
‘Mental Viagra’ could turn grown men into horny teens,0,2,2,41,2,8,0,43,0
Artists Record Joan Manuel Serrat's 'Mediterraneo' for Refugees: Watch,0,3,8,50,4,8,0,58,0
New Ad Campaigns Look Back at the 1930s,0,1,5,23,0,7,4,28,0
"Despite Early Optimism, German Companies Hire Few Refugees",0,2,8,42,1,7,0,50,0
Child virus outbreak reaches Beijing,0,1,2,30,0,4,0,32,0
"Roar and peace: Stunning proof that however fiercely they fight, brothers and sisters will ALWAYS make up ",0,3,8,79,2,17,0,87,0
Donald Trump to sign new travel ban expected to remove Iraq from list of barred Muslim-majority countries ,0,3,4,84,1,17,0,88,0
More Than 200 Arrested in D.C. Protests on Inauguration Day,0,3,8,37,2,9,3,45,0
Outgoing Australian Democrats leader predicts new party amidst double dissolution,0,1,3,69,0,9,0,72,0
Boy crushed to death at Atlanta revolving restaurant,0,3,2,43,0,7,0,45,0
Dutch Election: A Who’s Who Guide to the Candidates,0,2,7,34,2,8,0,41,0
Austria teenager builds his own mini ski resort,0,3,1,39,0,7,0,40,0
US scientists prepare to fight back against Trump's 'war on science',0,3,3,52,3,10,0,55,0
The CIA concluded that Russia worked to elect Trump. Republicans now face an impossible choice.,0,3,7,72,2,14,0,79,0
Justice Department Settles Antitrust Claim Against DirecTV ,0,3,9,43,0,7,0,52,0
5 ‘It’ Girl-Approved Outfits to Look Stylish When You’re Running Late,0,2,10,44,4,10,1,54,0
Momentum plans relaunch to end factional infighting,0,3,1,44,0,6,0,45,0
These Three Rare Metals Are Roaring,0,3,6,24,0,5,0,30,0
"Police: Boy Shot By Reno School Officer Cut Classmate, ‘Pursued’ Him",0,2,11,43,4,10,0,54,0
Birth Control Startups Are Offering Deals To Prep For Trump’s America,0,3,11,47,1,10,0,58,0
Kuwait parliament gives women the vote,0,1,1,32,0,5,0,33,0
Escaped circus elephant kills 65-year-old man in woods in Germany,0,3,2,50,2,9,2,52,0
Nate Dogg's College Football Playing Son Naijiel Arrested in Drug Sting,0,2,10,50,1,10,0,60,0
'Bee hotels' made from recycled TVs helping to attract native bees back to suburbs,0,3,3,64,2,13,0,67,0
De'Aaron Fox Will Declare for 2017 NBA Draft After 1 Year at Kentucky,0,2,12,39,1,12,5,51,0
Report Outlines a High Life for Advocates of Avocadoes,0,1,6,40,0,8,0,46,0
Wild Oats XI forced to quit Sydney to Hobart race,0,3,6,34,0,9,0,40,0
A government watchdog group is asking lawmakers to investigate Carl Icahn's role with Trump,0,3,4,73,1,13,0,77,0
Arkansas Carries Out Double-Execution Despite Claims First Death Was 'Inhumane',0,3,11,56,3,9,0,67,0
Ship fire kills nine Greek and Filipino sailors in Caribbean Sea,0,1,5,49,0,10,0,54,0
Chris Berman's New Role with ESPN Revealed,0,3,9,26,1,6,0,35,0
John Kerry's Military records and Yale transcript released,0,1,4,46,1,7,0,50,0
Arkansas Attorney General Works to Dismantle Roadblocks to Executions,0,3,7,54,0,8,0,61,0
Obama Leaves Office To Record Job Growth,0,2,7,27,0,6,0,34,0
Get Used To High Drug Prices As Big Pharma Emerges From Election Stronger Than Ever,0,2,15,54,0,14,0,69,0
Jackie Evancho's music sales boom after announcing inauguration performance ,0,2,2,64,1,9,0,66,0
Bomb threats are scary and costly to Jewish centers,0,3,2,41,0,8,0,43,0
"Kyle Busch, Joey Logano Involved in Fight at NASCAR at Las Vegas Race",0,3,15,41,1,12,0,56,0
Police Find Body Of 2-Year-Old Grabbed By Alligator At Disney Resort,0,2,12,43,2,10,1,55,0
France's Marine Le Pen to appear on 60 Minutes,0,3,5,30,1,8,2,35,0
"Republican Cancer Survivor Tells Paul Ryan He ""Would Be Dead"" Without Obama",0,2,12,50,2,11,0,62,0
Bill Maher Highlights Extent Of Opioid Abuse In Donald Trump-Voting States,0,2,12,51,1,10,0,63,0
South Prepares for Snow as 73 Million Nationwide Face Brutal Weather,0,3,8,48,0,10,2,56,0
Meet the parents who won’t let their children study literature,0,2,1,51,1,9,0,52,0
"To Rescue Captain, U.S. Snipers Held Steady Despite Many Moving Parts",0,1,12,44,3,10,0,56,0
"Trump budget plan could add $6tn to public debt in a decade, analysts say",0,3,1,56,2,13,1,57,0
Boy released as another is arrested over killing of Leeds teenager,0,3,2,54,0,10,0,56,0
Gold surges as tensions flare in the South China Sea,0,2,4,39,0,9,0,43,0
2 Men Die in Apparent Murder-Suicide During Barricade Situation in Philly,0,2,9,52,1,10,1,61,0
Obama declares tougher emission targets before Copenhagen summit,0,1,2,55,0,7,0,57,0
Second man charged in Lee Rigby murder case,0,1,3,33,0,7,0,36,0
Conservatives hope that Trump victory on Gorsuch will breed other successes,0,3,3,62,0,10,0,65,0
Taliban attack on NATO base repelled,0,1,5,26,0,5,0,31,0
Pope Francis says it is better to be an ATHEIST than a hypocritical Catholic,0,2,10,53,0,13,0,63,0
Meet The 2017 Class Of 30 Under 30,0,2,5,14,0,7,8,19,0
EpiPen alternative to hit market at more than seven times the price,0,2,2,54,0,11,0,56,0
John Legend Says Song for 7-Month-Old Daughter Moved Him to Tears,0,3,10,42,2,10,1,52,0
It’s Entirely Possible That Baze And Chirrut Were In Love In “Rogue One”,0,3,13,44,3,12,0,57,0
BBC begins trial program allowing legal TV and radio downloads,0,1,5,48,0,9,0,53,0
International Anti-Smoking Treaty to Take Effect Soon,0,1,7,39,1,6,0,46,0
Suicide bomber at Iraqi funeral kills at least six,0,1,2,40,0,8,0,42,0
Democrats target 'troublesome' Trump cabinet nominees,0,3,2,44,2,5,0,46,0
"Throw out homeopathic teething tablets with belladonna, FDA says",0,3,4,51,1,8,0,55,0
A Strong Week   Ends on Down Note,0,1,6,19,0,8,0,25,0
Two British Police Officers Used a Taser on Their Own Black Race Relations Advisor,0,2,12,57,0,13,0,69,0
"Left Out of D-Day Events, Queen Elizabeth Is Fuming",0,1,9,32,2,8,0,41,0
Pregnant mother of 12 accused of keeping kids in waste-filled home ,0,2,1,52,1,11,2,53,0
Dog recovering after being thrown out 3rd-floor window,0,2,1,44,1,7,1,45,0
Russian diplomats expelled in connection with cyber hacks depart US ,0,3,3,55,0,10,0,58,0
SpaceX cargo ship finally reaches space station,0,3,2,39,0,6,0,41,0
"China’s Jetliner Dream Built With U.S., European Parts",0,3,9,34,4,7,0,43,0
Street beggar flown from Scotland to Sweden by kind-hearted tourists for Christmas,0,3,4,66,1,11,0,70,0
"Mrs. John L. Strong, Luxury Stationer, Is Closing",0,1,8,30,4,7,0,38,0
"Savings, Longevity and the Year in Fitness ",0,3,4,31,1,7,0,35,0
"Building Trump's wall: For Texans, it's complicated",0,3,4,37,4,6,0,41,0
"ACC will move league championships out of North Carolina, following the lead of the NBA and NCAA",0,2,12,67,1,16,0,79,0
President Trump signs executive actions advancing Keystone XL and Dakota Access pipelines,0,2,7,71,0,11,0,78,0
Shia LaBeouf's Trump art project moves to Liverpool as 'America not safe enough',0,3,6,59,3,12,0,65,0
Watch President Trump Announce His Supreme Court Nominee Live,0,2,9,44,0,8,0,53,0
Kylie Jenner’s Lip Kits Are Causing More Drama [Video],0,3,9,34,3,8,0,43,0
"Amtrak Crash: No Sign Engineer Was Using Phone While Operating Train, NTSB Says",0,3,16,49,2,12,0,65,0
Tillerson meets with Putin amid U.S.-Russia disagreements on Syria ,0,3,6,49,3,9,0,55,0
DfE says £3bn savings for schools 'doable' without larger class sizes,0,2,2,53,3,10,1,55,0
"The Day Trump Came to Moscow: Oligarchs, Miss Universe and Nobu",0,2,9,42,2,10,0,51,0
Vermont man released from jury duty after arriving in prisoner costume ,0,2,1,59,0,11,0,60,0
Talks held to avert Nigerian oil production strike,0,1,2,41,0,7,0,43,0
Can Bill Cosby's accusers testify? Lawyers try to persuade judge,0,3,4,49,2,9,0,53,0
'No conspiracy' in deleted Facebook photo of Matthew Groom with cable car proponent,0,3,4,65,2,12,0,69,0
Volvo Ocean Race Comes to a Close,0,1,5,22,0,6,0,27,0
Marathon Petroleum to Accelerate Asset Drop-Down,0,3,6,36,1,5,0,42,0
Oil spilled after ships collide in Singapore,0,1,2,36,0,6,0,38,0
More Gauges Tell Same Story: Lasting U.S. Wage Growth Remains Elusive,0,3,12,44,3,10,0,56,0
"Oklahoma Sheriff’s Deputy Shot Dead, Suspect Captured After Manhunt",0,2,9,48,2,8,0,57,0
Rio’s Christ Statue Asking for Alms Amid Recession,0,3,7,35,1,7,0,42,0
"Jack Dorsey Returns to Twitter as Chief, to Shrugs and Quips ",0,2,7,42,1,11,0,49,0
Women Scientists Are Tweeting “Sexy” Photos Of Themselves At Work To Shut Down Sexism,0,2,14,56,2,13,0,70,0
Kim Jong Un says North Korea close to testing ICBM,0,3,9,32,0,9,0,41,0
Panasonic Commits To Solar Cell Production With Tesla At New York Plant,0,3,12,48,0,11,0,60,0
Moody's warns illiquid housing assets and high debt pose a serious risk for Australia,0,2,2,69,1,13,0,71,0
Apple Computer CEO Steve Jobs gives opening keynote to WWDC 2005,0,1,11,39,0,10,4,50,0
Trump Says Refugees Are Flooding U.S. in Misleading Allusion ,0,3,9,41,2,9,0,50,0
Sheriff: Baby Abducted from FL Hospital 18 Years Ago Found Alive in SC  Insider,0,3,13,49,1,14,2,62,0
"Brexit with no trade deal would cause 'significant damage' to service sector, say peers - Politics live",0,3,2,81,4,16,0,83,0
Donald Trump Poised To Become Misstater In Chief,0,3,8,33,0,7,0,41,0
"Ricky Harris, 'Everybody Hates Chris' Actor, Dead At 54",0,3,8,33,4,8,2,41,0
Where Old Airplanes Go to Die,0,1,5,19,0,5,0,24,0
Celebrities Speaking Out: Are They Helping or Hurting With Anti-Trump Antics?,0,3,11,53,3,10,0,64,0
Over 30 killed in a Baghdad restaurant bombing,0,1,2,35,0,7,2,37,0
"Joe Thornton Played with Torn ACL, MCL During Sharks' 1st-Round Series",0,3,14,42,3,10,1,56,0
Clerics Silent on a Turbulent Election,0,1,4,29,0,5,0,33,0
Dylann Roof's Lawyers Look to Have Death Penalty Tossed ,0,3,8,38,1,9,0,46,0
California gang member charged with killing police officer,0,3,1,50,0,7,0,51,0
"Yes, A 200 Buck Note Is Coming. No, This Isn't What It Looks Like!",0,3,13,32,5,13,3,45,0
"Drug OD deaths nearly tripled since 1999, CDC says",0,3,6,31,1,8,4,37,0
Judge delays exit exam decision until Friday,0,1,2,36,0,6,0,38,0
Red Velvet Earns Second No. 1 on World Albums With 'Rookie',0,2,9,36,3,10,1,45,0
Business confidence holds up even as conditions worsen: NAB survey,0,3,4,52,1,9,0,56,0
’The Travel Detective’ Explains How Airlines Became A ’Mafia’,0,2,9,40,4,8,0,49,0
President Obama bans oil drilling in large areas of Atlantic and Arctic oceans,0,2,4,62,0,12,0,66,0
"6-year-old orders $160 dollhouse, 4 pounds of cookies with Amazon's Echo Dot",0,3,3,52,5,11,5,55,0
Kenyan government and opposition agree on power sharing,0,1,1,47,0,7,0,48,0
"Betsey Johnson, fashion's free spirit",0,3,2,29,2,4,0,31,0
James Packer caught in middle of corruption inquiry into Israeli Prime Minister Benjamin Netanyahu,0,3,7,78,0,13,0,85,0
Police hunt $6m jewellery heist suspects,0,3,1,32,1,5,1,33,0
"Snowstorm pounds the Northeast, affecting flights, closing schools",0,2,2,55,2,7,0,57,0
McClatchy Plans to Cut 15% of Its Work Force,0,1,7,26,1,8,2,33,0
Taiwan President in the Spotlight After Telephone Call With Trump,0,2,8,48,0,9,0,56,0
"Sandy Gallin, Hollywood Agent and producer, Dies at 76",0,3,5,37,2,8,2,42,0
"Kerry: With One State, ‘Israel Can Either be Jewish or Democratic—It Cannot Be Both’",0,3,13,53,5,13,0,66,0
"Rare ""ring of fire"" solar eclipse to give sky gazers a special treat Sunday",0,3,2,58,2,13,0,60,0
"Embracing figures at Pompeii 'could have been gay lovers', after scan reveals they are both men",0,2,2,75,3,15,0,77,0
Rocket hits US consulate in Afghanistan,0,1,4,30,0,5,0,34,0
US says 75% of ISIS fighters killed,0,2,6,20,1,6,2,26,0
Emma Stone calls B.S. on Warren Beatty: 'I was holding my Best Actress envelope',0,3,9,53,5,13,0,62,0
'Bohemian Rhapsody' As A Live-Action Film Is A Frightening Crime Drama,0,3,12,45,3,10,0,57,0
German Football: Lahm signs contract with Bayern Munich until 2012,0,1,5,47,1,9,4,52,0
Millennials are totally mixed up about what they believe in,0,2,1,49,0,9,0,50,0
Sarandon Prefers Trump’s Wall to Clinton’s ’Moral Judgment’,0,2,7,41,4,7,0,48,0
"Nina Simone, Tupac and ELO all set to receive special honours",0,3,6,44,1,10,0,50,0
"If you're looking for a used car, now is the time to buy",0,2,1,41,2,12,0,42,0
Ranking the MLB teams ahead of the offseason,0,2,4,33,0,7,0,37,0
Sanctuary cities dig in after Trump executive order ,0,2,2,42,0,8,0,44,0
Seven die from H1N1 swine flu virus; total virus victims in Wales rises to 21,0,1,4,54,1,14,4,58,0
Church of England ministers could work beyond the age of 70 to ease recruitment crisis ,0,3,2,68,0,15,2,70,0
Congress would be insane to override New York’s gun laws,0,2,3,43,1,9,0,46,0
"'New York Times' jumps the gun, announces Pulitzer wins way before announcement",0,3,4,61,3,11,0,65,0
"49ers Head Coach Search: Latest News, Rumors, Speculation on Position",0,3,8,47,3,9,2,55,0
China Proposes Deal to Ease Tensions Over North Korean Missiles,0,3,9,45,0,9,0,54,0
The White House just told transgender students they’re on their own,0,2,3,53,1,10,0,56,0
"2008 Taipei International Book Exhibition: More events, more visitors in the weekend",0,1,5,62,2,11,4,67,0
"Shia LeBeouf, Rönkkö, and Turner Are Taking Their 'He Will Not Divide Us' Installation West",0,2,15,58,4,14,0,73,0
GPs told not to vouch for 'couch potatoes' with marathon hopes ,0,3,2,48,2,11,0,50,0
Derivatives Tug of War Takes Shape,0,1,5,24,0,5,0,29,0
Mathematician predicts the next decade will be awful,0,2,1,44,0,7,0,45,0
Meryl Streep Won’t Be Wearing Chanel to the Oscars,0,3,7,34,1,8,0,41,0
Blow-up dolls might be the answer to ending prison violence,0,2,1,48,1,9,0,49,0
2017 National Cherry Blossom Festival Some of DC Cherry Blossoms Suffer 'Widespread Damage' Due to Cold,0,3,14,68,2,15,4,82,0
Six Fighters Set to Start Showtime Tournament,0,1,6,33,0,6,0,39,0
Mass trial in PNG over brutal killing of people suspected of sorcery,0,2,4,53,0,11,0,57,0
Chrisette Michele responds to inauguration performance backlash: ‘I am willing to be a bridge’,0,3,3,75,3,13,0,78,0
New Year celebrations around the world ,0,3,2,31,0,6,0,33,0
"Media organisations including BBC, New York Times challenge 'unprecedented' White House briefing ban",0,2,9,76,3,12,0,85,0
Britain First invaded an Islamic Bookshop in Birmingham and of course it went terribly The list,0,3,6,74,0,15,0,80,0
Pakistani Taliban threaten revenge attack after bin Laden death; CIA says retaliation is likely,0,1,6,75,1,13,0,81,0
Man Held After London Knife Attack That Killed an American - The New York Times,0,2,13,51,1,14,0,64,0
A Belgian Playwright Tackles Muslim Radicalization With Comedy,0,2,8,47,0,7,0,55,0
"UnitedHealth Settles Suit, but Objection Raised",0,1,6,35,1,5,0,41,0
"Plans for seven-day GPs not thought out, says spending watchdog",0,3,3,49,2,9,0,52,0
J Scott Armstrong on Breitbart News Daily: ’No One Asks’ Researchers To Follow Scientific Method - Breitbart,0,2,15,73,4,16,0,88,0
Boxer Ricardo Williams Jr. Leaves Prison and Returns to the Ring,0,1,8,45,1,10,0,53,0
Bafta nominations: 'La La Land' up for 11 awards,0,2,4,31,3,8,2,35,0
Conviction of serial child molester at center of federal appeals case to set him free,0,3,1,70,0,14,0,71,0
"Denver teen trampled to death in music fest shooting, family says",0,2,1,53,1,10,0,54,0
"Tyrannosaurus rex was a sensitive lover, new dinosaur discovery suggests",0,3,1,61,1,9,0,62,0
NYPD Will Help Protect Shia LaBeouf's 'He Will Not Divide Us' Livestream From Hate Speech,0,2,19,53,3,14,0,72,0
"Ethics office director says proper vetting of ultrawealthy Cabinet nominees can take weeks, months",0,3,2,82,1,13,0,84,0
Watch 'SNL' Host Casey Affleck Get a Little Help From His Friends Alec Baldwin and John Goodman,0,3,17,60,2,16,0,77,0
Mike Posner Talks New Mansionz Project & Previews Poetry Book on 'Sway in the Morning',0,2,11,58,3,14,0,69,0
London Attack: Utah Dad Kurt Cochran’s Family Say They Bear No Ill Feelings,0,3,13,48,2,12,0,61,0
Johnny Depp Sues Ex-Managers Alleging Millions in Losses,0,3,8,40,1,7,0,48,0
"Two people die after contracting H1N1 virus, number of swine flu deaths in Scotland rises to 28",0,1,4,70,1,16,4,74,0
Telstra sale legislation passed by Australian Senate,0,1,3,43,0,6,0,46,0
"Mike Pence Told About Flynn Warning Two Weeks After Trump, White House",0,2,12,46,1,11,0,58,0
Grads of LifeVoice: How Out-of-School Enrichment Can Close The STEM Talent Gap,0,2,16,48,3,11,0,64,0
A startup that's developed an anti-aging supplement just raised $20 million,0,2,1,59,3,10,2,60,0
Fantasy Baseball Draft Kit for 2017,0,2,4,22,0,5,4,26,0
The Trumps Are Running The Secret Service Into The Ground,0,3,10,38,0,9,0,48,0
"Mohammed Shami, India cricketer, defends wife against Twitter trolls",0,2,4,54,2,8,0,58,0
Standing Rock Sioux File Challenge After Trump’s Action on Dakota Pipeline,0,2,10,53,1,10,0,63,0
"After 1,000 days, Flint is still without clean drinking water",0,2,2,44,2,9,4,46,0
"Kuwait could pay up to $60,000 for party at Trump Hotel in Washington",0,2,4,46,2,12,5,50,0
"US flexes muscle, tests ICBM off California coast",0,2,7,34,1,7,0,41,0
"'Nashville' Season 5, Ep. 1 Recap: Three Chords, the Truth & Concept Albums",0,3,9,45,7,12,2,54,0
"Mexican Man Admits Using Acid on Bodies, Army Says",0,1,8,33,1,8,0,41,0
American Air Said in Advanced Talks to Buy China Southern Stake,0,3,9,44,0,10,0,53,0
Don't Presume That Tillerson Will Be Soft On Russia,0,3,9,33,1,8,0,42,0
"Diana Douglas Webster, mother of Michael Douglas, dies",0,2,5,40,2,7,0,45,0
Radomski Testifies Before Clemens Grand Jury,0,1,6,33,0,5,0,39,0
"Immigrants advance Australian economy, but what happens if we 'close the door?'",0,2,2,62,4,11,0,64,0
Almond milk bottles and Halal Snack Pack: Six new lolly flavours Australia needs now,0,3,6,64,1,13,0,70,0
More Top Execs Fired at Financially Troubled Target Corp.,0,3,8,40,1,8,0,48,0
Americans are facing a $50 billion headwind,0,3,1,33,1,6,2,34,0
Brexit Brexit forces British Jews to seek German citizenship,0,3,5,47,0,8,0,52,0
Woman charged with murder of missing Mornington Peninsula mother Joanne Martell,0,3,5,64,0,10,0,69,0
Seattle's Headset Offers Big Data Analytics To The Cannabis Industry - 'Just Like Walmart',0,2,13,60,4,13,0,73,0
"Thirteen dead, several wounded in Fort Hood, Texas shooting",0,1,4,45,2,8,0,49,0
Ben Stein: Hollywood a 'Bunch of Bullies and Thugs Trying to Shut Down' Dissent  Insider,0,3,11,59,3,15,0,70,0
"India Falls To 136th, While Pakistan Climbs To 139th On Press Freedom Rankings, China Is 176th",0,3,13,55,2,15,9,68,0
Trump Ups the Drama for His Supreme Court Pick,0,2,7,31,0,8,0,38,0
"In Case Against Barry Bonds, One Count of Perjury Stands Out From Rest",0,1,12,45,1,12,0,57,0
A Sale to Benefit Charity and Thrifty Brides-to-Be,0,1,7,34,2,7,0,41,0
Australian 1976 Cabinet papers released,0,1,2,29,0,4,4,31,0
Singer-songwriter Peter Sarstedt dies aged 75,0,2,3,34,1,5,2,37,0
"Mick Jagger becomes a father again at 73, welcoming his eighth child",0,3,2,52,1,11,2,54,0
"Christina McHale, Ranked 374th, Is  Ready for Australian Open",0,1,8,39,2,9,3,47,0
Cam Newton sat out Panthers' 1st play due to dress code violation,0,2,3,49,1,11,1,52,0
Trump's other wall: Irish town is latest battleground,0,3,2,42,2,7,0,44,0
College Football Teams Are Risky and Expensive—and Schools Keep Adding Them,0,3,10,54,1,10,0,64,0
Key GOPer Wants To Repeal O’Care Once Replacement Is ’Available’,0,2,13,39,3,9,0,52,0
A New Fund From an M.I.T. Professor,0,1,8,18,3,6,0,26,0
"With Auburn Ahead, Rutgers Resists Urge to Reflect",0,1,7,35,1,7,0,42,0
Nationwide rallies against anti-terror laws held in Australia,0,1,2,51,1,7,0,53,0
2015 NBA playoffs: Andre Iguodala starts Game 4,0,3,6,28,1,7,5,34,0
Judge Who Blocked Use Of Execution Drug Blasted For Anti-Death Penalty Protest,0,3,13,53,1,11,0,66,0
"House GOP plans two days of debate, Friday showdown vote on Obama trade agenda ",0,3,6,58,1,14,0,64,0
"An Internal Union Dispute Turns Nasty, With a Local in the Balance",0,1,9,45,1,11,0,54,0
"Your Spring Home Buying Survival Kit, From Pre-Qualification To Close",0,3,11,47,2,9,0,58,0
"W2W4: Lightning vs. Blackhawks, Game 3 - Cross Checks Blog- ESPN",0,3,12,34,5,10,3,46,0
"4-year-old boy killed by dog in Liverpool, England",0,1,2,37,3,7,1,39,0
Oil exploration firm in 'largest undeveloped discovery' on the UK Continental Shelf,0,3,5,65,2,11,0,70,0
Iraq plans 'Baghdad Eye' to draw in tourists,0,1,3,32,2,7,0,35,0
The robot with a human touch: Optical sensors allow a machine hand to sense subtle shapes and textures,0,3,2,82,1,17,0,84,0
Executive Orders 101: What are they and how do Presidents use them?,0,3,4,47,2,11,3,51,0
At least ten dead after clashes in Nigeria,0,1,2,33,0,7,0,35,0
Virginia Tech marks decade since shooting that killed 32,0,3,2,44,0,8,2,46,0
Rohan Bopanna-Jeevan Nedunchezhiyan Secure Victory In Straight Sets To Clinch Chennai Open Doubles Title,0,2,15,75,1,13,0,90,0
Trump’s tough talk on leaks is one thing. His actions tell another tale.,0,3,2,55,3,12,0,57,0
Man who allegedly admitted to killing football star Joe McKnight released without charges,0,3,4,73,0,12,0,77,0
"Mari Luz, missing child from Huelva, Spain, found dead",0,1,4,39,3,8,0,43,0
"A Vietnam vet fled the Oroville Dam. While he was gone, burglars stole his war medals.",0,3,5,63,3,15,0,68,0
Tony Wilson dies,0,1,2,12,0,2,0,14,0
Joe Biden Tells Donald Trump To 'Grow Up' in New Video Interview,0,2,11,40,2,11,0,51,0
"Euro surges, yen dives as French election fears abate",0,2,2,42,1,8,0,44,0
New Band Aid music video is launched,0,1,3,27,0,6,0,30,0
"With One Swerving Free Kick, Brazil Darts Into Final Against U.S.",0,1,12,40,3,10,0,52,0
London MP Gave Mouth-To-Mouth To Save The Life Of A Stabbed Officer During London Terror Attack,0,2,19,59,2,15,0,78,0
Six thousand gather to celebrate birthday of Yugoslavian leader Josip Broz Tito,0,1,5,63,0,11,0,68,0
Chances for N.C.A.A. Tournament Midmajors to Slay Some Giants,0,1,10,39,4,8,0,49,0
"Snap Seeks IPO Valuation Of Up To $18.5 Billion, Pricing Shares At $14 To $16",0,3,14,37,5,14,7,51,0
Floyd Mayweather Would School Conor McGregor In the Ring,0,2,9,39,0,8,0,48,0
Michael Jackson doctor posts message on YouTube,0,1,4,37,0,6,0,41,0
Troy Ave Was Shot in Brooklyn (UPDATE),0,3,11,19,2,6,0,30,0
"Australian Manuka honey as powerful against superbugs as NZ variety, researchers say",0,3,4,68,1,11,0,72,0
Modern technology maps new sections of the Great Wall of China,0,1,4,48,0,10,0,52,0
'Crown Fire' forces residents in Southern California to evacuate homes,0,1,4,55,2,9,0,59,0
Tech Billionaires Create Fund to Prevent Robot Apocalypse - Breitbart,0,2,8,51,1,9,0,59,0
Attention Trump haters: Here's a wall you will want to build ,0,3,3,45,2,11,0,48,0
"Estonia Convicts Hermann Simm, Former Security Official, of Treason",0,1,8,49,2,8,0,57,0
WATCH: Watters Takes a Special Tour of Reagan's 'Western White House'  Insider,0,3,14,48,4,12,0,62,0
CBO report: 24 million fewer insured by 2026 under GOP health care bill,0,3,6,46,1,12,6,52,0
"With Deflategate Ruling, Roger Goodell Is Firmly in Control - The New York Times",0,2,12,53,2,13,0,65,0
Self-Ruled Region Remains Wary of Russian Backers,0,1,7,35,1,6,0,42,0
Beer Yoga Is Something That Exists And You Probably Wanna Try It,0,3,12,41,0,11,0,53,0
Fetus Found in Clogged Drain Pipe of Brooklyn Home: NYPD,0,3,11,35,1,9,0,46,0
"Pence tells North Korea not to test American resolve, offering Syria and Afghanistan strikes as examples",0,2,6,82,1,15,0,88,0
Cricket: India defeat England in fifth one-day international,0,1,3,48,2,7,0,51,0
NFL Europa ceases after 15 seasons,0,1,4,23,0,5,2,27,0
Los Angeles commuter train collides with freight train; over two dozen killed,0,1,2,63,1,11,0,65,0
Singer Joy Villa wears Trump dress to the Grammys ,0,3,5,36,0,9,0,41,0
Kyrie Irving believes the Earth is flat. It is not.,0,3,4,36,2,9,0,40,0
Australian senator sorry for 'flea' comment in asylum debate,0,3,1,49,2,8,0,50,0
LTTE strikes Sri Lanka capital,0,1,6,20,0,4,0,26,0
Swiss finish drilling world's longest overland tunnel,0,1,1,45,1,6,0,46,0
Stone Temple Pilots Remember Scott Weiland One Year After His Death,0,3,11,46,0,10,0,57,0
Building a Mind-Controlled Wheelchair,0,3,4,29,1,3,0,33,0
"New LHC Results Hint At New Physics, But Are We Crying Wolf?",0,3,14,33,2,11,0,47,0
Oregon Zoo staff infected by TB after exposure to elephants,0,2,4,46,0,9,0,50,0
Survey: Western Europe wary of supporting Russia’s NATO neighbors,0,2,8,47,2,8,0,55,0
"Rancagua, Chile Servicio Médico Legal boss, Juan Díaz, suspended on Juanita Carey case",0,1,9,62,3,12,0,71,0
Trump’s Vow to Repeal Health Law Revives Talk of High-Risk Pools ,0,2,10,42,2,11,0,52,0
Here’s A Wheelbarrow Of Rescued Baby Orangutans On Their Way To Orangutan School,0,2,13,54,1,12,0,67,0
Grading the rookie classes for every NFL team,0,3,4,34,0,7,0,38,0
Dutch Populist Wilders Feels Trump Burn With Slide in Polls,0,3,9,41,0,9,0,50,0
Adorable police pug will handcuff you with his cuteness,0,2,1,46,0,8,0,47,0
Amy Winehouse wax model unveiled,0,1,2,26,0,4,0,28,0
MMA Fighter Leaves Opponent Stiff on Canvas Floor Via Overhand Right at TKO37,0,2,15,48,0,12,2,63,0
Kremlin Says Syria Missile Strike Harms U.S.-Russia Relations,0,3,10,41,3,7,0,51,0
This $5 Million Desert Mansion Comes With Built-In Art,0,3,9,34,2,8,1,43,0
"""Star Wars"" Icon Carrie Fisher Dies",0,3,6,22,2,5,0,28,0
Here is what the abandoned venues of the Rio Olympics look like just 6 months after the Games,0,3,4,71,0,17,1,75,0
Storms and Fires Kill 8 in South and Southwest,0,1,5,32,0,8,1,37,0
Ranking the Top 25 Seniors Heading into the 2017 College Football Season,0,3,7,48,0,11,6,55,0
Philippines is culling 6500 hogs after Reston ebolavirus outbreak,0,1,2,51,0,8,4,53,0
"France high school shooting: Armed teen arrested, 10 hurt ",0,3,2,43,2,9,2,45,0
Mnuchin to Divest Stakes in 43 Investments to Avoid Conflict,0,2,6,43,0,9,2,49,0
Role Players Have Mended the Fraying Celtics,0,1,6,32,0,6,0,38,0
'Jeopardy!' celebrated the internet last night with meme-themed categories,0,2,1,61,4,8,0,62,0
Russian Court Bans Teacher For Six Years For Having Sex With Teenage Student,0,3,13,51,0,12,0,64,0
"Donald Trump’s Pick for Army Secretary, Vincent Viola, Withdraws",0,2,8,45,3,8,0,53,0
Towers Perrin and Watson Wyatt in Merger,0,1,5,29,0,6,0,34,0
"Queen Bee syndrome is a myth, women do help each other rise to top",0,2,2,50,1,13,0,52,0
"TSA, DHS Will Bar Electronic Devices On Some Overseas Flights",0,2,14,37,1,9,0,51,0
"As Incomes Rebound, Saving Hits Highest Rate in 15 Years",0,1,8,36,1,9,2,44,0
"Air Force faces pilot shortage, but training is a challenge ",0,2,2,47,1,10,0,49,0
Hurricane Richard makes landfall in Belize,0,1,3,34,0,5,0,37,0
"Golden Globes 2017: ‘La La Land’ Breaks Record, ‘Moonlight’ Wins Best Drama ",0,3,11,43,6,12,4,54,0
Sean Spicer Causes Uproar With Hitler Gaffe,0,3,7,30,0,6,0,37,0
Volleyball games appear to take place at North Korean nuclear test site,0,3,3,57,0,11,0,60,0
"Spurning Tiffany Trump, the fashion world proves its hypocrisy",0,2,3,50,1,8,0,53,0
Don Dale: Mother's search for answers over son's treatment in youth detention,0,3,3,60,3,11,0,63,0
Osama bin Laden almost sounds like a U.S. presidential candidate in this secret letter,0,2,4,67,2,13,0,71,0
Trump supporter cancels Airbnb guest's booking at last minute 'because of her race',0,3,2,66,3,12,0,68,0
3 Voices Resonate in the Age of Video,0,1,4,25,0,7,1,29,0
Marijuana Prices Fall In 2016 As Growers Flood The Market With Pot,0,3,11,40,0,11,4,51,0
Namibia votes in presidential election,0,1,1,33,0,4,0,34,0
‘Changing the Game Would Be the Sports Equivalent of New Coke’ ,0,2,8,42,2,11,0,50,0
The US Music Industry Crossed A Threshold In 2016,0,3,9,28,0,8,4,37,0
Thai police search controversial Dhammakaya temple for accused money-laundering former abbot,0,2,2,79,1,10,0,81,0
Zuckerberg: My Facebook manifesto to re-boot globalisation,0,3,3,47,2,6,0,50,0
British pilot dies in plane crash; nine passengers survive,0,1,1,48,1,8,0,49,0
Criss Angel Blames Poor Eating & Sleeping for Las Vegas Mishap,0,3,9,42,1,10,0,51,0
Google commits $11.5 million to racial justice efforts,0,3,1,41,2,7,3,42,0
Shohei Ohtani: The 'Best Baseball Player in the World' Isn't in MLB...Yet,0,3,12,43,7,11,0,55,0
"NBA Skills Challenge 2017: Complete Participant List, Comments and Reaction",0,3,10,50,2,9,4,60,0
"Grayson Allen Grabs Louisville Player's Arm, Gets Smacked in Face",0,3,9,45,2,9,0,54,0
Fresh Paint and Flowers at Iraqi House of Horrors,0,1,6,35,0,8,0,41,0
'Ms Dhu' inquest: Aboriginal woman's treatment 'inhumane',0,3,3,42,6,6,0,45,0
Danny Gokey Talks About the Move From Country to Christian Music & 'The Divide In Our Country',0,3,14,61,3,16,0,75,0
"Goldman Warns China Outflows Rising in Both Yuan Payments, Forex",0,2,9,45,1,9,0,54,0
Deshaun Watson Caps Off Clemson Career With Performance for the Ages Against Alabama in Title Game,0,3,13,70,0,15,0,83,0
Manchester by the Sea plotline 'inspired couple to kill son',0,2,2,47,2,9,0,49,0
Is the United Airlines man being smeared in the media even the right David Dao? It shouldn't matter,0,3,6,74,2,17,0,80,0
Eurovision 2017: X-Factor winner Isaiah Firebrace a risky choice to represent Australia in Kiev,0,2,7,69,2,13,4,76,0
Trump isn’t the first president ‘Saturday Night Live’ has skewered. But this feud stands out.,0,3,5,69,5,14,0,74,0
"File-Sharing Site Violated Copyright, Court Says",0,1,7,34,2,5,0,41,0
"Martinsville, Va., a Potential Racing Hub, Shifts Focus",0,1,7,37,4,7,0,44,0
Dateline with Lester Holt FRIDAY 10P/9C Obama: ‘Post-racial America after my election’ unrealistic,0,2,14,64,5,12,3,78,0
Zurich shooting: Swiss police say gunman is dead after mosque attack,0,2,2,55,1,10,0,57,0
"Google launches web browser, dubbed Chrome",0,1,2,34,1,5,0,36,0
Ontario investigators search for the body of Victoria Stafford,0,1,3,51,0,8,0,54,0
"Woman, 87, raped in her own home in UK",0,1,3,23,2,8,2,26,0
Interpol suspends $22M partnership with FIFA amid bribery allegations ,0,2,6,52,1,9,2,58,0
Ashleigh Watterson's lawyers accuse doctor of dismissing 5-month-old baby who died,0,2,2,66,3,10,1,68,0
Tour de France: Michael Rasmussen wins stage 16,0,1,4,33,1,7,2,37,0
5.1 earthquake hits north of Tokyo,0,1,1,25,1,5,2,26,0
Evidence That Robots Are Winning the Race for American Jobs ,0,3,8,42,0,10,0,50,0
Meals On Wheels wants to play a bigger role in health care,0,3,3,44,0,11,0,47,0
Filipino Food Is the Next Big Thing—Again,0,2,7,27,1,6,0,34,0
"Despite raves for style, Trump’s speech gives GOP little to chew on",0,2,5,49,2,11,0,54,0
Yoga you can do on a plane - CNN Video,0,3,5,23,1,9,0,28,0
Japanese fleet returns from Antarctic hunt with 333 whales ,0,3,2,45,0,9,3,47,0
No-fly zone demanded by Syrian protesters,0,1,2,33,1,5,0,35,0
Donald Trump hails 'new chapter in American greatness' in Congress speech,0,2,4,57,2,10,0,61,0
9 of the most popular jobs professional football players take after retiring from the NFL,0,2,3,71,0,14,1,74,0
Agriculture Department investigating possible U.S. case of mad cow disease,0,1,4,59,2,9,0,63,0
"Iraq torture claims lawyers Leigh Day had evidence clients were scheming insurgents, tribunal hears",0,3,3,82,1,13,0,85,0
Republicans prepare to leave Washington without resolving health care disputes ,0,3,2,67,0,10,0,69,0
McConnell demurs when asked if he believes Trump on Russia denials: 'I have no idea',0,2,5,62,3,14,0,67,0
Rivers considers Pro Bowl his 'last game as a San Diego Charger',0,3,6,45,2,11,0,51,0
Little Room to Maneuver on Budget for Britain,0,1,5,33,0,7,0,38,0
Krispy Kreme owner buys Panera for $7.5 billion,0,3,3,33,2,7,2,36,0
Some Tech Companies Are Trying Affirmative Action Hiring—But Don't Call It That,0,3,13,53,2,11,0,66,0
36 Backstage Photos From The 2017 Academy Awards,0,3,6,29,0,7,6,35,0
Ukip supporters: where should the party go from here?,0,2,1,42,2,8,0,43,0
Spain's new cabinet has more women than men,0,1,1,34,1,7,0,35,0
New Caledonia prepares for 2011 South Pacific Games,0,1,5,35,0,7,4,40,0
Mel B Celebrates Her Final 'Chicago' Broadway Show With a Spice Girls Shout-Out: Watch,0,2,14,55,4,13,0,69,0
What is the Mexico City Policy?,0,2,4,21,1,5,0,25,0
What is fueling fake hate crimes across the U.S.? ,0,3,3,35,3,9,0,38,0
New York police charge man in jogger's death,0,3,2,34,1,7,0,36,0
Runner Admits to Cheating in Half-Marathon After Investigator Uncovers Data,0,3,9,56,1,9,0,65,0
"Easy Bikes, No Spandex Required",0,3,5,21,1,4,0,26,0
Foundations Trim Staffs After Assets Slide Lower,0,1,7,35,0,6,0,42,0
Look out below! Terrifying moment a huge crane topples over in the middle of a road full of workmen ,0,2,2,78,1,19,0,80,0
Police Officers Overwhelmingly Agree That Bad Cops Aren’t Held Accountable,0,3,10,54,1,9,0,64,0
Donald Trump blasts recount as ’ridiculous’ and ’a scam’,0,2,2,42,4,8,0,44,0
Oil Industry Braces for U.S. Trial on Rights Abuses,0,1,8,33,2,8,0,41,0
This Photo Of Trump Striking A Pose Amid Chaos Is Now A Kind Of Depressing Meme,0,3,16,48,0,15,0,64,0
Europe’s far-right leaders speak on Trump at conference,0,2,2,44,2,7,0,46,0
Discovery of Dinosaur Tail Encased in Amber Sheds Light on Evolution of Feathers ,0,3,9,59,0,13,0,68,0
Hillary haunts Trump as he surprises first White House tour group,0,2,4,51,0,10,0,55,0
Delaware state trooper dies after being shot in convenience store parking lot ,0,3,1,65,0,12,0,66,0
Events take place across UK to mark Remembrance Sunday,0,1,5,41,0,8,0,46,0
The 70 times Trump has tweeted about repealing and replacing Obamacare,0,3,3,55,0,10,2,58,0
Trump's pick for Army secretary drops out,0,2,2,32,1,6,0,34,0
Sony to Install Digital Projectors in AMC Theaters,0,1,8,35,0,7,0,43,0
"Tech hipster augmented reality monocles are coming, this prank proves it",0,3,1,60,1,10,0,61,0
"Kim Jong Un 'ordered' half brother's killing, South Korean intelligence says",0,3,5,57,4,10,0,62,0
OutFront: HIV-Positive Counselor Shares His Story to Help Others,0,3,12,42,2,8,0,54,0
Toronto transit workers ordered back to work,0,1,1,37,0,6,0,38,0
'Pokémon Go' banned in China over public safety concerns,0,3,3,43,2,8,0,46,0
"As Election Looms in Japan, No Easy Answers for the Winner",0,1,8,39,1,10,0,47,0
"Facebook would 'love' to acquire Snap if shares drop to $14, says analyst",0,3,2,53,4,12,2,55,0
"Trump's Supreme Court pick marks end of one battle, starts new one",0,3,3,50,2,11,0,53,0
Lego launching Women of NASA toy set - Yahoo,0,3,7,28,1,8,0,35,0
Utah Governor Chosen as Ambassador to China,0,1,5,32,0,6,0,37,0
"ISIS Terrorists To Intensify Attacks On India, Declare Plan To Target Taj Mahal",0,3,16,50,1,12,0,66,0
"Ukip is Europe's laziest party, researchers reveal",0,2,2,40,2,6,0,42,0
Wall St: US markets ease on Donald Trump political concerns,0,3,6,43,1,9,0,49,0
It’s a Nice Night for Surfing. Beware of Sharks. ,0,3,6,31,3,9,0,37,0
Guard Mutiny in Bangladesh Ends,0,1,4,23,0,4,0,27,0
C.I.A. Had Evidence of Russian Effort to Help Trump Earlier Than Believed ,0,2,12,47,3,12,0,59,0
Trump's best and worst tweets as president,0,3,1,34,1,6,0,35,0
Ted Cruz: ‘The Democrats Are the Party of the Ku Klux Klan’,0,2,9,36,3,11,0,45,0
Mike Krzyzewski Sends Bitmojis to Duke Players and Personnel,0,2,7,45,0,8,0,52,0
Rihanna now has more top 10 Billboard singles than Michael Jackson,0,3,4,50,0,10,2,54,0
U.S. senators reach compromise on use of filibuster,0,1,2,40,2,7,0,42,0
Killen convicted of manslaughter for 1964 civil rights workers murders,0,1,1,56,0,9,4,57,0
Poll: 7 in 10 people say America is losing its identity,0,3,2,39,1,10,3,41,0
Is UN peacekeeping working in Africa?,0,3,4,27,1,5,0,31,0
Illinois high schools now required to buy insurance for athletes,0,1,1,54,0,9,0,55,0
Clinton Foundation Discloses $40 Million in Wall Street Donations - Breitbart,0,2,8,55,2,10,2,63,0
Trump Moving to Take Bids on Building the ’Wall’ - Breitbart,0,2,7,40,3,10,0,47,0
Baby joy for former X Factor judge Cheryl and One Direction star Liam Payne,0,2,8,54,0,13,0,62,0
Donald Trump Accuses Barack Obama of Wiretapping Trump Tower During the 2016 Election,0,3,10,59,0,12,4,69,0
She’s 59 and Fit to Jump From an Airplane,0,2,5,25,1,8,2,30,0
Donald Trump: London to hold 'biggest protest ever' against US President,0,3,6,53,3,10,0,59,0
Australian rules football: Leongatha upset Traralgon in round six of 2010 Gippsland Football League season,0,1,6,81,1,14,4,87,0
"UFC Fighter Jose Aldo Calls Conor McGregor a ""Piece of Sh*t""",0,3,12,35,3,10,0,47,0
Battle of the Bulge reenacted in Belgium,0,1,3,31,0,6,0,34,0
Once-conjoined twins going to rehab 9 weeks after separation ,0,2,1,49,1,9,1,50,0
Quebec ‘Terrorist Attack’: College Student Alexandre Bissonnette Charged,0,2,8,54,3,7,0,62,0
This hero cat bit its sleeping owner to alert family to house fire,0,3,1,53,0,12,0,54,0
Stephen Colbert: President Trump's Wall Is Starting To Sound More Like A Blanket Fort,0,2,14,56,2,13,0,70,0
Australian rules football: Traralgon get game back as ladder shakes around middle,0,1,2,67,1,11,0,69,0
Diego Costa to Real Madrid: Seven reasons why Chelsea have not offered their striker for a transfer,0,3,6,76,1,16,0,82,0
"Forbes Names Lil Yachty, Desiigner, and Others in 2017 ""30 Under 30"" List",0,3,8,41,4,12,8,49,0
Princess Beatrice's unlocked BMW stolen,0,1,5,29,1,4,0,34,0
CNN: Democrats Face Their Powerlessness - Breitbart,0,2,8,35,2,6,0,43,0
Berlusconi proposes January elections if government fails to gain parliamentary majority,0,1,2,76,0,10,0,78,0
Terrorism Alleged in Policeman Killing in Athens,0,1,5,37,0,6,0,42,0
Mija Drops Adventure-Filled 'Secrets' Video: Watch,0,3,7,34,4,5,0,41,0
US federal judge dismisses targeted killing lawsuit,0,1,2,43,0,6,0,45,0
Drugs are killing so many people in West Virginia that the state can’t keep up with the funerals,0,3,3,75,1,17,0,78,0
Taliban Releases Video of Hostage Couple With Their Two Children Born in Captivity,0,2,11,59,0,12,0,70,0
SolarCity’s Ties to Foreclosure Cases Raise Questions on Vetting Policies ,0,2,9,54,1,10,0,63,0
Rihanna shined bright like a diamond in her one of kind Coachella outfit,0,3,2,58,0,12,0,60,0
"Philippine fireworks factory explosion kills at least 8, injures 70 more",0,1,1,57,1,10,3,58,0
Palestinian Rival Says It Is Attacked by Hamas,0,1,7,32,0,7,0,39,0
"For Coach Rich Rodriguez, Rebuilding Effort at Michigan Continues",0,1,8,48,1,8,0,56,0
Tinder is About to Look a lot Like Snapchat,0,3,5,30,0,8,0,35,0
Tube strike: Government accuses union bosses of co-ordinating action to inflict 'maximum pain' on commuters,0,3,2,87,4,14,0,89,0
"Farruko, Messiah & Bad Bunny Explain the Origin of Their Names at the 2017 Billboard Latin Music Conference",0,3,12,72,2,17,4,84,0
54 stingrays die at Chicago zoo,0,2,1,23,0,5,2,24,0
"As UP's Rape Accused Minister Gayatri Prajapati Still Walks Free, Airports Put On Alert",0,3,15,57,2,13,0,72,0
"Falcons' Robert Alford Picks Off Tom Brady, Returns It for a Touchdown",0,3,10,47,2,11,0,57,0
"Chuck Berry Sales Explode By More Than 10,000% Following His Death",0,2,10,39,2,10,5,49,0
Bang & Olufsen's fancy Beoplay H9 headphones come with noise cancellation,0,2,4,56,2,10,1,60,0
"6 Olympians, Including 2 Medalists, Fail Doping Reanalysis",0,1,6,41,2,7,2,47,0
Ohio Carjacking Duo Stymied by Stick Shift: Police,0,3,7,35,1,7,0,42,0
Soccer game photo is proof co-parenting can work out just fine,0,3,1,50,1,10,0,51,0
AbitibiBowater Files for Bankruptcy Protection,0,1,5,37,0,4,0,42,0
Pakistan singer Atif Aslam stops show to rescue harassed girl,0,3,3,49,0,9,0,52,0
State of Oregon Sues OppenheimerFunds,0,1,5,28,0,4,0,33,0
How To Follow Up After A Job Interview,0,3,8,23,0,7,0,31,0
Pup Calls Adorable Ceasefire On These Two Dogs Stuck In Serious Gridlock,0,2,12,49,0,11,0,61,0
Lost dog found stuck in frozen lake saved in dramatic rescue ,0,3,1,49,0,11,0,50,0
Mississippi church member charged in 'Vote Trump' arson  ,0,3,3,43,2,9,0,46,0
Anti-feminist Tory MP Philip Davies elected to Parliament's women and equalities committee,0,3,7,70,2,11,0,77,0
Rolling Stones debut new music video starring Kristen Stewart,0,3,4,49,0,8,0,53,0
Large forest fire continues to burn into third day in southern Norway,0,1,2,56,0,11,0,58,0
Carlos Santana rocks the National Anthem during NBA Finals Game 2 ,0,2,9,45,0,11,1,54,0
SpaceX finally landed a rocket at sea — a huge step toward making spaceflight cheaper,0,2,2,68,1,14,0,70,0
Report: Miami officers fired for joking about target practice in black neighborhood,0,3,2,69,1,11,0,71,0
American singer and actor Al Martino dies at age 82,0,1,3,37,0,9,2,40,0
Little Mix Songs Remixed: Listen to 7 of the Best,0,2,6,32,1,9,1,38,0
"Meet Ashton Sanders, Star Of 'Moonlight' And 30 Under 30 Honoree",0,2,9,38,3,10,4,47,0
Security Net Wraps Capital for Inaugural,0,1,5,30,0,5,0,35,0
No breakthrough in the WTO trade talks,0,1,4,28,0,6,0,32,0
Yosemite Firefall: National Park optical illusion makes waterfall look like fire,0,2,4,65,1,10,0,69,0
Minnesota Department of Health says 'theatre nights' in bars are not exempt from Freedom to Breathe Act,0,1,6,79,2,16,0,85,0
Chapecó Fans Mourn Plane-Crash Victims at Stadium Memorial ,0,3,8,42,1,8,0,50,0
Shiseido Counts on Personal Touch in Hard Times,0,1,6,34,0,7,0,40,0
Sturm und Drang About Pint-Size Neighbors,0,1,6,29,1,5,0,35,0
French Open 2015: Tennis fashion has come a long way in the last century...,0,2,3,51,4,13,4,54,0
"Many Americans don't know Obamacare and the Affordable Care Act are the same, exact thing",0,2,6,67,2,14,0,73,0
"This Fishing Village Held A Tiny, Heartwarming Women’s March",0,3,9,41,2,8,0,50,0
Zlatan Ibrahimovic Reportedly out for Season with Knee Injury,0,3,6,47,0,8,0,53,0
Sarita Devi Announces Arrival On The Big Stage With A Victory On Her Professional Boxing Debut,0,2,16,63,0,15,0,79,0
Which foreign policy sacred cows will Donald Trump slaughter next?,0,3,3,53,1,9,0,56,0
Analysis reveals that New York City tunnels are susceptible to attacks,0,1,4,56,0,10,0,60,0
Serbian Parliament members accuse NGOs of anti-Serbian campaign,0,1,6,49,1,7,0,55,0
"Four Years After Sandy Hook, Barely Anyone Thinks We're Closer To Stopping Gun Violence",0,3,14,58,2,13,0,72,0
11 MPs ejected from Australian parliament,0,1,3,31,0,5,2,34,0
Protesters Endure Blizzard to Remain at Standing Rock,0,3,6,40,0,7,0,46,0
London terror attack: ISIS claims responsibility for deadly rampage outside Parliament building ,0,3,6,77,1,12,0,83,0
"MTV Movie & TV Awards Are 'Like a Millennial Golden Globes,' Exec Producer Says",0,2,15,47,4,13,0,62,0
Ben Franklin was the country’s first fame whore,0,2,2,37,1,7,0,39,0
Spanish police arrest 200 Chinese nationals in €16m fraud,0,2,2,41,1,8,5,43,0
Trump names Rudy Giuliani as cybersecurity adviser,0,3,3,41,0,6,0,44,0
"As Bullfighter Gains Honor, Peers Perceive a Grave Loss",0,1,8,38,1,8,0,46,0
Congress Warns Donald Trump: Stop Deleting Your Tweets,0,2,8,38,1,7,0,46,0
Secret UK tomb found to contain remains of 5 archbishops ,0,2,3,43,0,10,1,46,0
Church bombing north of Egypt's capital kills 26 ,0,3,2,36,1,8,2,38,0
Europe holds its breath as Italy heads to the polls for critical referendum,0,3,2,61,0,12,0,63,0
MLB Power Rankings at the Start of March,0,3,7,26,0,7,0,33,0
Zoo Sues Studio For Traumatizing Raccoon Used In 'Erotic' Ad,0,2,10,39,2,9,0,49,0
"Morsi forced out by Egyptian Military, chaos ensues",0,1,3,40,1,7,0,43,0
Iran Backs Taliban With Cash and Arms,0,3,6,25,0,6,0,31,0
ESPN Graphic Shows Two Louisville Players Listed Out From Citrus Bowl Due to 'Gunshot Wounds',0,3,17,60,2,14,0,77,0
Syrian civil war: Jabhat al-Nusra's massacre of Druze villagers shows they're just as nasty as Isis,0,2,5,75,4,15,0,80,0
Goalies Make Difference in Rangers-Capitals Series,0,1,6,38,1,5,0,44,0
"Walmart, Target, and Aldi are addressing a huge weakness — and it’s turning into Whole Foods’ worst nightmare",0,2,5,82,5,17,0,87,0
Orange County Sheriff's Office still investigating into Tigger hit,0,1,5,52,1,8,0,57,0
Obama's $400G Wall Street speech leaves liberal base stunned ,0,3,4,43,2,9,3,47,0
"US Nazi leader talks about Barack Obama, the economy and more",0,1,5,45,1,10,0,50,0
"For Can-Do U.S. Team, No Time for Complacency",0,1,9,25,4,7,0,34,0
"Apple releases iPhone SDK, announces upcoming update",0,1,5,40,1,6,0,45,0
Ab-Soul Breaks Down the Inspirations & Revelations Behind 'Do What Thou Wilt',0,3,11,51,4,11,0,62,0
"North Korea confirms receipt of funds, nuclear shutdown to proceed",0,1,2,54,1,9,0,56,0
Snow falls in Sahara for first time in 37 years,0,2,2,34,0,9,2,36,0
"Nokia issues BL-5C battery warning, offers replacement",0,1,4,41,2,6,1,45,0
Balancing Freedom and the Role of the State in Germany,0,1,5,40,0,9,0,45,0
Visa Ban Amended to Allow Iraqi Interpreters Into U.S. ,0,2,9,35,2,9,0,44,0
"MS-13 gang threatens the Arizona ""minutemen""",0,1,3,31,3,5,2,34,0
Ezekiel Elliott's Mom Responds to Tweet Questioning How He Afforded Car at OSU,0,3,13,52,1,12,0,65,0
How my daughter died from a simple case of flu,0,3,1,36,0,9,0,37,0
Mugabe Aides Said to Use Violence to Get Amnesty,0,1,7,33,0,8,0,40,0
Tesla's biggest moments of 2016,0,3,1,21,1,4,4,22,0
Presidential election held in Afghanistan,0,1,2,35,0,4,0,37,0
Caitlyn Jenner on what her life is like today | Watch the video - Yahoo Good Morning America,0,3,7,66,2,17,0,73,0
Atlantis lands at Kennedy Space Center,0,1,4,29,0,5,0,33,0
FOX Sports live games and streaming video | FOX Sports Go,0,2,9,37,1,10,0,46,0
"74 bodies wash up on Libyan coast, Red Crescent says",0,3,3,37,1,9,2,40,0
"Colbert Rides a Trump Wave, While Fallon Treads Water ",0,2,8,36,1,9,0,44,0
British Columbia avalanche death toll rises,0,1,2,36,0,5,0,38,0
CA Inc. Profit Beats Estimates,0,1,6,19,1,4,0,25,0
Millionaires can’t flee this European country fast enough,0,2,2,47,1,7,0,49,0
"Happy Birthday, Grace VanderWaal: Rewatch the Audition That Shot Her to Stardom",0,3,11,55,2,11,0,66,0
Watch this car effortlessly drift and move side-to-side,0,2,1,45,2,7,0,46,0
"Job Conditions Worsen in Areas of China, Experts Say",0,1,7,36,1,8,0,43,0
House Democrats petition for Trump's tax returns,0,3,3,38,1,6,0,41,0
Why ‘The Outsiders’ Lives On: A Teenage Novel Turns 50 ,0,3,9,31,3,10,2,40,0
Hash browns are being recalled in 9 states because they may contain golf ball materials,0,3,1,71,0,14,1,72,0
Global Finance Leaders Grapple With Globalization Fears | Fox Business,0,3,9,51,1,9,0,60,0
President Obama Says 'Obamacare' Will Survive Beyond His Presidency ,0,2,9,48,2,9,0,57,0
Microsoft invested 4 billion USD into Xbox division,0,1,5,38,0,7,1,43,0
Subpoena to a Lawmaker Is Reported,0,1,4,25,0,5,0,29,0
Grateful Dead Reissues: Archivist Shares Details on Next 22 Years,0,2,8,45,1,9,2,53,0
WATCH: Jesse Watters Confronts MA College Pres. Over Flag Removal  Insider,0,3,16,45,2,11,0,61,0
We visited J. Crew and witnessed why business is a disaster,0,2,3,45,1,10,0,48,0
Costly Gasoline Pushes Up Consumer Prices,0,1,6,30,0,5,0,36,0
Muslim woman spat on while eating in restaurant says female race hate victims must speak out,0,3,1,76,0,15,0,77,0
Canada eyes plan to legalize marijuana by 2018: 5 things to know,0,3,1,46,1,11,5,47,0
The Stream: South Carolina and Nevada Go To The Polls,0,2,9,34,1,9,0,43,0
Rodriguez Gives Yankees a Positive Sign,0,1,5,29,0,5,0,34,0
Iran's foreign minister mocks Donald Trump 'putting him on notice',0,2,3,51,3,9,0,54,0
'Terrorists' freed in Bahrain prison raid,0,3,2,32,2,5,0,34,0
Southwest Air to Begin Flying From Boston,0,1,6,29,0,6,0,35,0
The Chainsmokers' 'Closer' Ties Record for Most Weeks in Hot 100's Top 10,0,3,9,43,4,12,5,52,0
Boris Johnson to spend Christmas at Chevening after 'house-share' victory,0,3,4,57,3,9,0,61,0
Democrats Slam EPA's Pruitt for Carbon Dioxide Remarks  Insider,0,3,10,43,1,9,0,53,0
Ivory Coast's former first lady Simone Gbagbo acquitted,0,3,4,43,1,7,0,47,0
Lawyer: McKinney police officer ‘allowed his emotions to get the better of him’,0,2,3,61,3,12,0,64,0
Want to Run  New York City Marathon? Get Out Your Checkbook,0,1,10,37,1,11,0,47,0
Trump's still going wrong on Twitter,0,3,2,28,1,5,0,30,0
U.S. man murdered by wife in Hong Kong,0,1,4,25,2,7,0,29,0
"Attack On Syrian Bus Convoy Killed At Least 68 Children, Monitor Says",0,3,11,44,1,11,2,55,0
U.S. Supreme Court Grapples With Racial Gerrymandering Cases,0,3,9,42,2,7,0,51,0
Sarkozy ends French job ban for Eastern Europeans,0,1,4,38,0,7,0,42,0
Colombian rebel leader 'Karina' surrenders,0,1,2,34,2,4,0,36,0
"Volkswagen, Tata Motors Target Strategic Indian Car Alliance",0,2,8,44,1,7,0,52,0
A Slow Brew at Starbucks,0,3,4,16,0,4,0,20,0
A viewer's guide to the most (and least) entertaining bowls,0,3,1,46,3,9,0,47,0
Colin Kaepernick's Parents Finally Speak Out Supporting His Protest Against the National Anthem,0,3,12,70,1,12,0,82,0
The Fed Is Stuck in the Past With Its Forecasts of the Future ,0,3,9,40,0,13,0,49,0
Democrats Elect Tom Perez as Party Chairman,0,3,6,31,0,6,0,37,0
"Trump Signals 'America First,' Silicon Valley Second With Work Visa Reform",0,3,11,50,3,10,0,61,0
Barry Bonds guilty of obstruction,0,1,2,27,0,4,0,29,0
Trump's Tariffs Bring Peso and Loonie Bears Back to Life,0,3,8,38,1,9,0,46,0
Lack of Cash Sinks Memorial to Abba,0,1,5,24,0,6,0,29,0
China Internet Censorship: New York Times Apps Removed,0,3,8,38,1,7,0,46,0
Yellow taxis 'have lower accident rate than blue ones',0,2,1,43,2,8,0,44,0
Champagne corks pop in Moscow at Trump's inauguration,0,3,3,42,1,7,0,45,0
"Authorities: 1 Officer Killed, 1 Wounded; Shooter at Large ",0,3,6,39,3,9,2,45,0
"At Masters, First Groups Provide Early Contenders",0,1,7,35,1,6,0,42,0
South Korea corruption: Choi ordered to appear before hearing,0,3,3,49,1,8,0,52,0
Saudi Arabia to allow female-only gyms this month,0,3,2,39,1,7,0,41,0
"Beyoncé's Coachella performance will be pretty interesting, according to Twitter",0,3,3,66,2,9,0,69,0
Govt Tells Restaurants To Let The Customers Decide How Much Service Charge They Wish To Pay,0,3,16,60,0,15,0,76,0
Mother Nature Is Brought to You By ... ,0,2,6,22,3,8,0,28,0
Illinois mother dies in house fire after saving newborn baby's life,0,3,1,55,1,10,0,56,0
Iranian president Ahmadinejad in Zimbabwe for trade fair,0,1,3,46,0,7,0,49,0
McDonald's Worker Jumps Through Drive-Thru In Attempt To Save Woman's Life,0,3,13,48,3,10,0,61,0
"Socialite, Hollywood Glamour Queen Zsa Zsa Gabor Dies at 99",0,3,8,39,1,9,2,47,0
"ITV fined A$3000 for cruelty to rat on ""I'm A Celebrity...Get Me Out Of Here!""",0,1,12,40,8,14,4,52,0
The Soprano And The Scientist: A Conversation About Music And Medicine,0,2,11,48,1,10,0,59,0
"EBay, PayPal ‘Robocall’ Policy May Violate Federal Law",0,2,10,34,3,7,0,44,0
"I Went To Shia LaBeouf’s ""He Will Not Divide Us"" Art Installation And It Was Honestly A Blast",0,2,19,54,3,17,0,73,0
North Korea Is Said to Test-Fire 3 More Missiles,0,1,8,30,1,8,1,38,0
"Apple announces Mac OS X Lion, iOS 5, and iCloud",0,1,9,27,2,9,1,36,0
Dem State Rep Warns Illegal Immigrants About Upcoming ICE 'Raid'  Insider,0,3,13,47,2,11,0,60,0
Bill Simmons declares war on ESPN after it blocked employees from his podcast,0,2,6,59,0,12,0,65,0
Meet the woman who created a Google doc on how to tactical vote,0,3,2,49,0,12,0,51,0
Growing up poor makes it harder to succeed: Janet Yellen,0,3,3,43,1,9,0,46,0
"Trump national security adviser wants to avoid term 'radical Islamic terrorism', sources say",0,3,2,75,3,12,0,77,0
Deal Brings TV Shows and Movies to YouTube,0,1,8,27,0,7,0,35,0
"Collapse of N.C. anti-LGBT ""bathroom bill"" repeal sparks intense blame game",0,3,7,53,5,10,0,60,0
New cave opens to the public in Indiana,0,1,2,30,0,7,0,32,0
At least twenty dead after mudslides in Peru,0,1,2,35,0,7,0,37,0
Former Patriots football player Aaron Hernandez found dead in jail cell ,0,3,4,57,0,11,0,61,0
Huffington Post to Back Investigative Journalism Team,0,1,6,41,0,6,0,47,0
"Fifth Harmony, Nick Jonas & Carly Rae Jepsen to Perform at NHL All-Star Game",0,3,14,46,3,13,0,60,0
"AbRam & Dad SRK's Adorable Moments Have Made The Internet A Wonderful Place, Here's Proof!",0,3,17,54,5,14,0,71,0
Fireworks Erupt at Bill Cosby's Sexual Assault Hearing,0,3,7,39,1,7,0,46,0
"Australians missing out on full sports coverage, media outlets say",0,1,1,55,1,9,0,56,0
"Bill Marshall, Toronto International Film Festival Co-Founder, Dead At 77",0,3,10,49,3,9,2,59,0
The Internet Loved Those Political Super Bowl Ads,0,3,8,34,0,7,0,42,0
Justise Winslow Injury: Heat Wing Undergoes Shoulder Surgery on Torn Labrum,0,3,10,54,1,10,0,64,0
2015 NBA Playoffs: Shaun Livingston's difficult trek to the NBA Finals,0,3,10,44,2,10,4,54,0
Videos released by Syrian activists shows aftermath of alleged chemical attack in Syria ,0,3,3,72,0,13,0,75,0
Latest Sony Hack Targets Britney Spears  Insider,0,3,7,34,0,7,0,41,0
"Toll Brothers Sees Strong 2017, Powered by Millennial Buyers",0,3,7,40,1,8,4,47,0
"Leaving Israel, Pope Benedict Offers Stronger Holocaust Message",0,1,8,47,1,7,0,55,0
This Artist Has Created Comic Book Covers For “Black Mirror” And They Are Dope AF,0,3,16,49,2,14,0,65,0
Tom Hiddleston apologises for 'inelegant' Golden Globes speech,0,3,4,49,2,7,0,53,0
"On Inauguration Eve, Trumpsters Party In The 'Swamp' Of Washington",0,3,10,44,3,9,0,54,0
Corinne Olympios breaks silence on ‘Bachelor’ scandal,0,2,3,42,2,6,0,45,0
Trapped skiers rescued from cable cars in Italian Alps,0,3,3,43,0,8,0,46,0
This Trump Supporter Neta Says Hindu Men Living In US Should Wear A 'Tilak' For Their Security,0,3,18,58,2,16,0,76,0
"After the election of Donald Trump, we will not mourn. We will organize",0,2,4,53,2,12,0,57,0
US military helicopter crashes in Florida,0,1,3,33,0,5,0,36,0
Beyond the media bubble: Even Trump Country has mixed feelings about budget cuts ,0,3,4,63,1,13,0,67,0
Woman who found her exact doppelganger just found another one,0,3,1,51,0,9,0,52,0
Serena Williams wins the Wimbledon Women's Singles title after defeating Venus Williams,0,1,7,68,1,11,0,75,0
Caught on Camera: Car Becomes Tasty Treat for Bison,0,3,7,35,1,8,0,42,0
TSA Fails to ID 73 Airport Employees With Links to Terrorism,0,2,11,37,0,10,2,48,0
A Pair of Classic Rock Events Will Bring Fleetwood Mac and the Eagles to the Coasts ,0,2,11,57,0,16,0,68,0
Eagles Fan's Sign Thanks Vikings for Round 1 Pick Received in Sam Bradford Trade,0,3,11,54,1,13,1,65,0
'The Firing Just Went On & On': Eyewitness Describes Ft. Lauderdale Airport Shooting  Insider,0,3,13,61,5,14,0,74,0
House Freedom Caucus set to unveil Obamacare repeal and replace plan,0,2,4,54,0,10,0,58,0
"13 pilot whales returning to sea, off Western Australia",0,1,2,42,1,8,2,44,0
Mugabe Swears In His Rival as Prime Minister of Zimbabwe,0,1,8,39,0,9,0,47,0
Clemson Coach Brad Brownell Confronts Roy Williams in Handshake Line,0,3,9,50,0,9,0,59,0
"Rolf Harris writes song mocking his victims as money-grabbing 'wenches', report claims",0,3,2,69,4,11,0,71,0
Actor Freaks Out After Accidentally Spoiling Murder Mystery on Live TV [Video],0,3,12,53,2,11,0,65,0
Ted Cruz: 'Odds are very good' of Supreme Court vacancy this summer ,0,3,5,48,3,12,0,53,0
Will Serena Williams want to fight her way back to the top when she becomes a mother?,0,3,3,65,1,16,0,68,0
Foot-and-mouth confirmed at UK farm,0,1,3,26,2,4,0,29,0
FBI Arrests Volkswagen Executive in Emissions Scandal,0,3,8,39,0,6,0,47,0
Jay Cutler Photographed Naked on Instagram by Wife Kristin Cavallari,0,3,8,51,0,9,0,59,0
"Jack Herrick, wikiHow founder interviewed by Wikinews",0,1,4,42,1,6,0,46,0
"Trump names Lighthizer as trade representative, taps Pence adviser for West Wing",0,3,5,63,1,11,0,68,0
France ‘Right to Disconnect’ Law: Do We Need Rules To Reclaim Personal Time?,0,3,12,48,4,12,0,60,0
Police Find Suspect in Cold Case: One of Their Own,0,1,8,32,1,9,0,40,0
Heilemann: Trump’s Cabinet Shaping Up to Be Really a ’Group of Old White Men’ - Breitbart,0,2,12,57,5,15,0,69,0
Alan Thicke Dies at 69,0,2,3,13,0,4,2,16,0
Resources Minister Matt Canavan says states need to 'pull their finger out' on gas exploration,0,3,4,74,2,14,0,78,0
Remembering The Day Rahul Dravid Finally Walked Off Into The Sunset And Ended An Era In Indian Cricket,0,3,18,67,0,17,0,85,0
Arabtec Plans $408 Million Rights Offer as 2016 Loss Widens,0,3,7,35,1,9,7,42,0
Many nations offer material aid to hurricane victims; Bush refuses to accept,0,1,2,62,1,11,0,64,0
Boeing 737 crash-lands in Colombia; at least one killed,0,1,2,40,2,8,3,42,0
"Asian Nations Want U.S. Leadership, Australia Says",0,3,8,33,3,6,0,41,0
Ben Affleck Warns Fans Directing Solo Batman Movie Is 'Not a Set Thing',0,3,12,45,2,12,0,57,0
"Sri Lanka Presses Rebels, but at a Mounting Cost",0,1,6,33,1,8,0,39,0
Mark Hamill Still Upset by the 'Star Wars' Prequel Backlash,0,3,8,40,2,9,0,48,0
United Kingdom to introduce graphic images on cigarette packets,0,1,2,53,0,8,0,55,0
Álvaro Morata: ‘Footballers are more like singers or rock stars than sportsmen’,0,3,3,62,3,11,0,65,0
Poland announces Olympians for the 2008 Summer Olympics in Beijing,0,1,5,48,0,9,4,53,0
British Spies Tapped King Edward’s Phone to Eavesdrop on Wallis Simpson Calls,0,2,10,55,1,11,0,65,0
New Zealand’s Corey Anderson to miss rest of England tour with injury,0,3,5,52,1,11,0,57,0
"With New Pieces, Toronto Raptors Show Why They're East's Biggest Threat to Cavs",0,3,12,52,3,12,0,64,0
Gay marriage costs Irish politicians nothing – abortion is another matter,0,3,2,60,1,10,0,62,0
The Uvolt Watch Is A Solar-Powered Device That Can Charge Your Smartphone Wirelessly,0,3,14,57,1,12,0,71,0
"In a Coup in Honduras, Ghosts of Past U.S. Policies",0,1,8,31,3,9,0,39,0
"Australia 'running behind' in obesity prevention policy, health specialists say",0,2,1,66,3,9,0,67,0
"Tennis Star Stanislas Wawrinka Smashes Opponent's Balls, Says Sorry Afterwards!",0,2,10,57,3,9,0,67,0
Sacramento Kings DeMarcus Cousins Confronts Reporter over Column on Nightclub Incident,0,3,10,66,0,10,0,76,0
"Billups Is Back in Denver, and Has Fans Dreaming of an N.B.A. Title",0,1,11,40,4,12,0,51,0
Magic Johnson Wants Kobe Bryant to Return to Lakers in Player Relations Role,0,3,10,54,0,12,0,64,0
"Happy 38th Birthday, Aaliyah: A Look at Her Lasting Impression on Style",0,3,9,47,2,11,2,56,0
Cricket: England draw Test series opener with India,0,1,4,39,1,7,0,43,0
British soap opera Coronation Street postponed after Cumbria shooting,0,1,4,57,0,8,0,61,0
The Baylor women's basketball team won a game by 108 points leading to a crazy box score,0,3,2,66,1,16,3,68,0
"After A 40-Year Detour, ’Squidbillies’ Star Takes Home His Diploma",0,2,10,41,4,9,2,51,0
Will Democrats Filibuster to Try to Block Gorsuch From the Supreme Court? ,0,2,9,52,1,12,0,61,0
Will Gorsuch Join Justices in Time to Matter This Term? ,0,3,8,37,1,10,0,45,0
McNamee to Meet With Prosecutors in Clemens Case,0,1,7,34,0,7,0,41,0
"Middling Start by Wang, and a Losing Effort by the Yankees",0,1,6,41,1,10,0,47,0
Ben Carson: comparing gay rights to civil rights leaves him 'a bit irritated',0,2,2,60,3,12,0,62,0
Indigenous land rights key to stopping deforestation in Central America,0,3,3,59,0,9,0,62,0
TV Couple Sanaya And Mohit's Nach Baliye Photoshoot Is Giving Us New Relationship Goals,0,3,15,58,1,13,0,73,0
Seventeen arrested after party on London Underground,0,1,3,43,0,6,0,46,0
AZ Dem Blasts Sessions' 'Injustice Dept' for Illegal Immigration Crackdown  Insider,0,3,11,58,3,11,0,69,0
Susan Kiefel sworn in as Australia's first female Chief Justice of High Court,0,3,7,57,1,12,0,64,0
Iraqis accept constitution,0,1,1,23,0,2,0,24,0
Eden's quirky tradition during the Sydney to Hobart,0,3,3,40,1,7,0,43,0
Valfrejus avalanche: One dead and two missing in France,0,3,3,43,1,8,0,46,0
Unprecedented review to be held on Qantas after third emergency in two weeks,0,1,2,62,0,12,0,64,0
German MPs vote to legalise cannabis for medicinal purposes,0,3,3,48,0,8,0,51,0
Beef with police: Hilarious moment cow charges at officer trying to wrangle the runaway heifer,0,2,2,77,1,14,0,79,0
Four earthquakes hit the Philippines in quick succession,0,1,2,47,0,7,0,49,0
Trump names Carl Icahn special adviser on regulatory overhaul ,0,3,3,50,0,9,0,53,0
"Parents Say Their Children’s Hatchimals Are Mumbling ""Fuck Me"" In Their Sleep",0,3,12,51,3,11,0,63,0
North Korean military leader Jo Myong Rok dies at age 82,0,1,5,39,0,10,2,44,0
"Doctors missed 11 chances to treat boy, nine, before he died of asthma, coroner hears",0,3,1,65,3,14,2,66,0
First Snowfall In 25 Years Makes Life Of War Torn Syrians Even More Miserable,0,3,13,49,0,13,2,62,0
Republican John Kennedy Wins Louisiana Senate Race ,0,3,7,37,0,7,0,44,0
The 5 Best ABC Song Remixes,0,3,7,14,0,5,1,21,0
"Johnny Manziel, Sean Payton Reportedly Discussed QB's Return to Football",0,3,10,51,2,9,0,61,0
Will Democrats Filibuster to Try to Block Gorsuch From the Supreme Court? ,0,3,9,52,1,12,0,61,0
"School bus crash kills one student in Georgia, US",0,1,4,36,1,8,0,40,0
China Chases Silicon Valley Talent Who Are Worried About Trump Presidency,0,3,11,52,0,10,0,63,0
Survivor remembers Chapecoense plane crash,0,2,2,36,0,4,0,38,0
My Friend Cayla doll banned in Germany over surveillance concerns,0,3,4,52,0,9,0,56,0
England's historic Weston-super-Mare Grand Pier destroyed by fire,0,1,5,50,3,7,0,55,0
Brexit UK election: Customers and vendors at London's Borough Market voice their opinions,0,3,7,68,2,12,0,75,0
Now Sahara's 3 Hotels And Other Properties Abroad May Be Attached By Enforcement Directorate,0,3,13,64,1,13,1,77,0
Schwarzenegger's 'Apprentice' makes its debut,0,2,2,36,3,4,0,38,0
Two-and-a-half tonnes of marijuana destroyed in Afghan school,0,1,2,49,3,7,0,51,0
Homeowner charged with manslaughter for shooting at home invasion suspects ,0,3,1,64,0,10,0,65,0
A Strategy for Happy Dual-Career Couples,0,3,6,28,1,5,0,34,0
"Browns Fan Creates GoFundMe Page for 0-16 Parade, Far Surpasses Goal",0,3,11,42,2,10,3,53,0
US Doctor Invents 'Lipstick' That Glues Vagina During Periods And Internet Loses It,0,3,14,55,2,12,0,69,0
"Kansas left early from the Big 12 tournament, and that might or might not mean anything",0,2,2,67,1,15,2,69,0
Our Brains Are Guided More By Empathy Than Selfishness,0,3,9,37,0,8,0,46,0
Big Insurer Says It Will Quit Florida Property Market,0,1,9,36,0,8,0,45,0
'Guardians of the Galaxy Vol. 2' won't be the Guardians' only big adventure this summer,0,2,4,63,5,14,1,67,0
Netflix First Quarter Gains Fall Short Of Expectations,0,3,8,39,0,7,0,47,0
Donald Trump kicked One Direction out of his hotel for refusing to meet his daughter,0,3,4,66,0,14,0,70,0
Critics Assail British Police for Harsh Tactics During the G-20 Summit Meeting,0,1,10,54,1,11,2,64,0
Shahid Kapoor Slams Trolls Targeting Him And Calling Him 'Regressive' For Marrying Mira!,0,2,13,60,3,12,0,73,0
Donald Trump and Israeli PM Benjamin Netanyahu Bond During Transition,0,2,10,50,0,9,0,60,0
Army’s Public Website Hacked by Unknown Intruders,0,3,6,36,1,6,0,42,0
"Conservatives Wonder, Will The Real Donald Trump Please Stand Up?",0,2,10,44,2,9,0,54,0
S.E.C. Chief Tries to Stake Out Role in Overhaul,0,1,9,28,3,8,0,37,0
"Trees continue to die in Houston, Texas",0,1,3,29,1,6,0,32,0
Bertelsmann Posts $106 Million Loss in First Quarter,0,1,6,35,1,7,3,41,0
Fake News: CNN Shamed into Major Corrections on Ghana Election Story,0,3,11,46,1,10,0,57,0
Exxon Mobil Seeks U.S. Sanctions Waiver for Oil Project in Russia ,0,3,10,43,2,11,0,53,0
"Melanoma Rates Are on the Rise, New Data Shows",0,3,7,30,1,8,0,37,0
Battles Over Reform Plan Lie Ahead,0,1,6,23,0,5,0,29,0
How Young Voters Reluctantly Learned to Love Hillary Clinton,0,2,8,44,0,8,0,52,0
"Semi truck crashes into viaduct in Buffalo, New York",0,1,4,39,1,8,0,43,0
"Iraqi forces push deeper into western Mosul as civilians flee fighting, 'most dangerous phase' about to begin",0,3,2,88,3,16,0,90,0
Bernie Sanders: Carrier took Trump 'hostage and won',0,3,4,38,3,7,0,42,0
Scientists Discover Scores of Weird Species in Philippine Waters,0,2,7,49,0,8,0,56,0
Watch Juanes Perform 'Hotel California' at Annual Kennedy Center Honors,0,2,9,51,2,9,0,60,0
Egypt Central Bank Sees Pound's Real Exchange Rate Appreciating,0,3,9,45,1,8,0,54,0
Serena Williams Says She Revealed Pregnancy on Snapchat by Accident,0,2,8,50,0,9,0,58,0
Emily Blunt's First Photo as Magical Nanny in 'Mary Poppins Returns': Compare Her Look to Julie Andrews in '64,0,3,14,71,5,18,2,85,0
This ’straddling bus’ could be the future of China’s public transportation,0,2,2,59,3,10,0,61,0
Kygo & Selena Gomez Show Their Best Sides on 'It Ain't Me' Collab: Listen,0,3,12,43,5,13,0,55,0
An anesthesiologist explains the biggest misconceptions about going under the knife,0,3,1,72,0,10,0,73,0
Recriminations and Regrets Follow Suicide of South Korean,0,1,6,44,0,7,0,50,0
Kehlani Cancels European Tour to Undergo Emergency Surgery,0,3,7,44,0,7,0,51,0
Police Investigating After Black Student Burned With Hot Glue Gun,0,2,10,46,0,9,0,56,0
White House accuses media of playing down inauguration crowds,0,2,2,51,0,8,0,53,0
"'Sunless Sea' is a wild 350,000-word literary RPG, out for iPad",0,3,6,36,5,10,6,42,0
Academy Awards retains PricewaterhouseCoopers despite Best Picture mix-up ,0,3,6,59,1,8,0,65,0
Can We Talk About Rihanna And Prince Harry For A Moment?,0,2,11,34,1,10,0,45,0
Judge Approves Inquiry Into Barclays Deal to Buy Lehman Unit,0,1,9,42,0,9,0,51,0
25 Hilarious Tweets About Sending Nudes,0,2,5,27,0,5,2,32,0
First Nestorian search engine goes online,0,1,2,34,0,5,0,36,0
Signs of Life as Deals Pick Up on Madison Avenue,0,1,7,32,0,9,0,39,0
Soulja Boy Arrested After Violating Parole,0,3,6,31,0,5,0,37,0
Palestinian recipes for maftoul tabbouleh and za’atar chicken,0,3,1,52,1,7,0,53,0
"Gorka: Trump ’Incredibly Pragmatic’ About Relations with Russia, Iran",0,2,8,49,4,8,0,57,0
Sean Spicer Scolds Media for ‘Lack of Interest’ in Susan Rice Story,0,2,9,45,2,11,0,54,0
"At 6 P.M., Married. At 7:30 P.M., Onstage. ",0,2,8,14,9,8,4,22,0
Kennesaw State Football Team Channels 'Remember the Titans' with Song,0,3,8,50,2,9,0,58,0
How Many Hours Should A Salaried Employee Work?,0,3,8,31,1,7,0,39,0
Jimmy Kimmel tests the knowledge of Warriors fans -- with fake questions - SportsNation - ESPN,0,3,9,66,4,15,0,75,0
FIFA’s film about itself made $607 at theaters this weekend,0,2,4,41,2,9,3,45,0
Rupert Murdoch Reportedly Stepping Down As 21st Century Fox CEO,0,2,11,41,0,9,2,52,0
Mayor Aims to Add Spark to Flagging Sex Lives,0,1,7,30,0,8,0,37,0
Trey Songz Plans Forthcoming Project 'Tremaine' for 2017,0,2,6,37,2,7,4,43,0
Marc Maron talks standup: ’I think I am funnier than I have ever been’,0,2,5,49,3,13,0,54,0
Chaos at Calais as builders unearth two WWII RAF bombs and are forced to close port,0,2,9,59,0,15,0,68,0
Europe Said to Delay Decision on Airbus A400M,0,1,7,28,0,7,3,35,0
Scottish lawyer denies death of Lockerbie bomber Abdelbaset Ali al-Megrahi,0,1,5,59,1,9,0,64,0
‘There was a trail of blood’: Ari Fleischer was nearly caught in the Fort Lauderdale shooting,0,3,5,70,3,15,0,75,0
"Mohammed Shami, India cricketer, defends wife against Twitter trolls",0,3,4,54,2,8,0,58,0
Taizé ecumenical community founder Frère Roger assassinated,0,1,3,50,0,6,0,53,0
"Wife of Pulse Nightclub Gunman Omar Mateen Knew He Would Attack, US Attorney Says ",0,3,14,53,1,14,0,67,0
"White House warns North Korea not to test U.S. resolve, offering Syria and Afghanistan strikes as examples",0,3,8,79,3,16,0,87,0
Kenya peace talks put on hold,0,1,1,23,0,5,0,24,0
Romanian foreign minister breaks the ice between Bucharest and Chisinau,0,1,3,59,0,9,0,62,0
"LeBron James, Cavs fend off late Warriors rally to win Game 3 of NBA Finals ",0,2,10,49,1,15,1,59,0
Death toll rises to 254 as aid begins to arrive in disaster-struck Colombia ,0,3,2,57,1,13,3,59,0
Theresa May needs to focus on changing the attitudes of British businesses as much as she does on Brexit,0,3,4,82,0,18,0,86,0
These trucks are bringing super-sized art to the streets of Spain,0,3,2,52,1,10,0,54,0
"100 Women 2016: A weekend of street harassment, mapped",0,3,2,35,2,8,7,37,0
These 'Bouncy Bands' Are Helping Kids Focus In The Classroom,0,3,10,39,2,9,0,49,0
Trump Repeats Unsubstantiated Claim About Voter Fraud During Election ,0,3,9,52,0,9,0,61,0
Invoking a Presidential Revelatory Moment,0,1,4,33,0,4,0,37,0
The 12-Year-Old Freshman at Cornell,0,2,5,22,2,4,2,27,0
Britain Prepares to Deport 9 Terrorism Suspects to Pakistan,0,1,6,44,0,8,1,50,0
"Tornadoes damage homes, flood roads in Dallas area ",0,3,2,40,1,8,0,42,0
"2017 NBA management rankings, from top to bottom",0,2,3,33,1,7,4,36,0
When the Generals Become Democracy’s Guardians,0,2,5,35,1,5,0,40,0
"Sick of Brexit Limbo, Foreign Bankers Are Asking to Be Sent Home",0,3,10,42,1,11,0,52,0
Otto Warmbier dies days after release from North Korean detention,0,2,4,52,0,9,0,56,0
Family home should be in pension assets test: Tony Shepherd,0,3,3,46,1,9,0,49,0
Ed Sheeran Tops Pop Songs Chart With 'Shape of You',0,3,9,31,2,9,0,40,0
"Polls held for US state and local elections, with incomplete GOP success",0,1,6,54,1,11,0,60,0
"US navy strike group to move towards Korean peninsula, official says",0,2,3,54,1,10,0,57,0
Alt-right troll Milo Yiannopoulos got a big book deal and Twitter is furious,0,3,4,59,1,12,0,63,0
‘An orgasm left me paralyzed’,0,2,1,22,2,4,0,23,0
"Spicer checks WH staffers' phones for leaks, vows more searches coming ",0,3,3,55,2,11,0,58,0
"10 years after crash in Iraq, pilot to be laid to rest",0,3,1,39,1,11,2,40,0
Crime in New Orleans sharply increases after Hurricane Katrina,0,1,5,49,0,8,0,54,0
German Retailer Expected to Buy Download Firm,0,1,6,33,0,6,0,39,0
Detroit Faces Its Critics With Anger and Tears,0,1,7,32,0,7,0,39,0
The Race to Harness Hydrates,0,1,4,20,0,4,0,24,0
Cutting ‘liberty’ out of the history taught to America’s kids,0,2,2,47,3,9,0,49,0
'Rogue One: A Star Wars Story' Tops a Whopping $520 Million at Global Box Office,0,3,12,47,4,14,3,59,0
"BMW Unveils The Latest Rolling Sculpture ‘Art Car’, Will Race It On The Track In January 2017",0,3,18,52,3,16,4,70,0
50 Cent Mercilessly Trolls Soulja Boy Following Alleged Robbery,0,3,8,45,0,8,2,53,0
Vladimir Putin says Russia hopes to 'normalise' relations with the United States,0,2,5,62,2,11,0,67,0
The 24 Best Fiction Books Of 2016,0,3,5,16,0,6,6,21,0
Ranking the Most Overpaid Coaches in College Football Today,0,3,7,44,0,8,0,51,0
"He Took A Five Minute Break For Paani Puri, And Came Back To Find Rs 5 Lakh Stolen",0,3,17,46,1,17,1,63,0
Smokeless tobacco might be far less common among big league newcomers ,0,3,1,58,0,11,0,59,0
Maryland considers cracking down on drivers who linger in the left lane,0,2,1,59,0,11,0,60,0
"Trump Rides a Market Wave, but Business Looks for Results ",0,2,7,40,1,10,0,47,0
When Air Time Is Playtime,0,1,5,16,0,4,0,21,0
This 14-Year-Old Latina Is Leading Her Team To The World Robotics Championship,0,2,13,50,2,11,2,63,0
Israeli forces move in to boot Jewish settlers from illegal outpost,0,2,2,55,0,10,0,57,0
TiVo Posts Loss as Its Growth Slows,0,1,7,22,0,6,0,29,0
White House: Trump has not spoken to Comey on Obama wiretap claims ,0,3,5,49,1,12,0,54,0
A fashion-forward goat is riding around on public transport,0,2,1,49,1,8,0,50,0
Trump signs executive order to help remove 'job-killing regulations' ,0,3,1,56,3,9,0,57,0
New video shows the moments before police dragged a man off a United flight,0,2,2,60,0,13,0,62,0
Global Music Rights Likens Radio to a 'Cartel' Conspiring to Keep Songwriter Payments Low,0,2,11,63,2,13,0,74,0
"For A-Rod, a New Chapter Will Say Much More Than Words",0,1,11,31,2,10,0,42,0
A New Tool for the War on Fake Rolexes,0,3,6,24,0,8,0,30,0
Janet Jackson Shares First Photo of Baby Eissa,0,2,7,32,0,7,0,39,0
Federal Government pushes to ban unvaccinated children from childcare centres,0,2,2,66,0,9,0,68,0
Zack Wheeler can’t exhale — or get his past off his mind,0,2,2,41,2,11,0,43,0
Doomsday Clock moves 30 seconds closer to midnight as threat of global annihilation grows ,0,3,2,72,0,14,2,74,0
Johnny Manziel deleted his Twitter account after offering Trump advice on using social media,0,3,4,75,0,13,0,79,0
Fresno rampage suspect details each day of killing spree to police,0,3,1,55,0,10,0,56,0
"Chuck Berry's First Album in Decades Is 'Sensational,' Friend Says",0,3,9,44,4,9,0,53,0
"Blood-thinners Xarelto, Eliquis and Pradaxa marketed to doctors as drug companies splash cash",0,2,4,75,2,12,0,79,0
Young Japanese Raise Their Voices Over Economy,0,1,7,33,0,6,0,40,0
Russia and Cuba Sign Strategic Partnership,0,1,5,32,0,5,0,37,0
"Highway bridge in Minneapolis, Minnesota, collapses",0,1,3,41,2,5,0,44,0
"Aussies Scorched by Heat Wave, While the Northeast Bundles Up",0,2,8,43,1,9,0,51,0
"Watch E! News Now Season 2017 Excerpt Free Online - ""This Is Us"" Kids Recite Their Grown up Lines | Yahoo View",0,3,18,62,5,21,4,80,0
What Comes Next as May Prepares to Trigger Brexit: QuickTake Q&A,0,3,11,41,2,10,0,52,0
"Elvish, Klingon and Na'vi: Constructed languages gain foothold in film",0,1,4,54,3,9,0,58,0
Mammograms deserve more skepticism,0,2,1,30,0,3,0,31,0
Physicist John Wheeler dies at age 96,0,1,3,26,0,6,2,29,0
Millennials: Traditional Retirement Might Not Be In The Cards,0,3,9,43,1,8,0,52,0
We Found The Creator Of The Sad Kermit Meme And She’s Got A Vault Of Kermit Memes,0,3,17,47,1,16,0,64,0
"The top 50 video games of all time, ranked",0,3,1,30,1,8,2,31,0
How a young Steve Jobs hustled Atari into sending him to India for a spiritual quest,0,3,5,64,0,15,0,69,0
Paschi Seeks State Aid as Italy Sets $21 Billion for Banks,0,3,8,37,1,10,2,45,0
Anthrax Distances Itself from Global Music Right's Radio Fight in Open Letter,0,2,10,55,1,11,0,65,0
Two Children Shot Outside Chuck E. Cheese's in Fort Worth: Police,0,2,10,42,3,10,0,52,0
Robin Hood tree wins coveted Tree of the Year crown,0,3,4,38,0,9,0,42,0
"Conor McGregor Won't Be Stopped from Fighting Floyd Mayweather, Says Dana White",0,3,12,54,2,11,0,66,0
Jordan Peele’s Racism-Tackling ‘Get Out’ Earns $30.5 Million,0,2,8,36,6,7,3,44,0
China school flood claims 91 lives,0,1,1,26,0,5,2,27,0
"Corpus Christi, Texas, Issues Water Warning After Chemical Spill ",0,2,9,45,2,9,0,54,0
"Seth Rogen, Lonely Island Hint at Movie About Musical Fest That Goes 'Horribly Wrong'",0,3,13,56,3,13,0,69,0
Putin Quashes Japan’s Territorial Hopes,0,2,5,29,1,4,0,34,0
Ann Coulter: Let’s Make Russia Our Sister Country!,0,3,8,32,3,7,0,40,0
NPD Group Gives Perfume Makers a Whiff of Sales Data,0,1,10,33,0,9,0,43,0
"Vitamin D doesn’t prevent disease for most, study says",0,2,2,42,2,8,0,44,0
Executions Debated as Missouri Plans One,0,1,5,30,0,5,0,35,0
Iran election: President Rouhani registers to run again,0,3,3,44,1,7,0,47,0
"Banks Benefit From Demonetisation As Loans Worth Rs 80,000 Crore Have Been Repaid In Old Notes!",0,3,15,58,2,15,5,73,0
White House spokesperson discusses situation in Burma,0,1,3,44,0,6,0,47,0
Japan Parliament Gives Final Passage to Law Paving Way for First Casinos,0,2,10,51,0,11,0,61,0
How one man’s pause became a haunting symbol of Aleppo’s destruction,0,3,2,54,2,10,0,56,0
England’s Joe Marler: stepping away from Tests in 2016 helped me on field,0,3,4,51,2,12,4,55,0
2 Use Guard Uniforms Made at Prison to Flee,0,1,6,28,0,8,1,34,0
Yale University Group Seeks to Allow Women into All-Male Fraternities  Insider,0,2,10,56,1,11,0,66,0
Why Backstreet Boys' ACM Awards Performance With Florida Georgia Line Was Such a Home Run,0,3,16,58,1,14,0,74,0
China headmaster 'suspended' after 400 pupils sit exam outside during heavy smog,0,3,1,63,2,11,3,64,0
89% of Muslims Live in Countries Not Affected by President Trump’s Executive Order 13780,0,3,9,57,2,13,7,66,0
"'Rogue One' has the 2nd-best December opening weekend ever, with $155 million",0,2,3,54,5,11,4,57,0
This Adorable Three-Legged Lamb Loves Sweaters And Will Steal Your Heart,0,3,12,49,1,10,0,61,0
College Football's 2017 Final Four Dark Horses,0,3,6,29,1,6,4,35,0
Former Beauty Queen Laura Hunter Sues Fake News Site For Stealing Her Identity,0,3,13,53,0,12,0,66,0
Iran’s Ayatollah Khamenei: Donald Trump ‘Shows Real Face of America’,0,3,9,46,4,9,0,55,0
LeBron Authored Another DAMN. Masterpiece,0,3,9,27,1,4,0,36,0
Experts weigh in on impact of Trump's tax plan ,0,3,2,35,1,9,0,37,0
Canadian court clears Stephen Truscott of 1959 murder,0,1,3,39,0,7,4,42,0
Trump's America Donald Trump's SCOTUS pick: What chance does Neil Gorsuch have of being confirmed?,0,3,13,67,4,14,0,80,0
"Baker Mayfield Arrested for Public Intoxication, Disorderly Conduct",0,3,7,52,1,7,0,59,0
Business PR And Politics: How Will Trump's 'Endorsement' Affect L.L. Bean?,0,3,13,44,7,10,0,57,0
Illinois State Wins National Signing Day by Adding Kobe Buffalomeat to Program,0,2,10,57,0,11,0,67,0
"Kodak Black Released From Florida Jail, Extradited to South Carolina: Report",0,3,10,54,2,10,0,64,0
11-year-old raises money to help disabled friend learn how to ride a bike  ,0,3,0,57,2,14,2,57,0
New Jobless Claims Are Lowest Since January,0,1,7,30,0,6,0,37,0
The Chainsmokers' Manager Adam Alpert Talks Release Strategy & Evolution From DJ Duo to Arena Act,0,3,15,65,2,15,0,80,0
"NCAA Women's Basketball Bracket 2017: Results, Seeds, Reaction and Analysis",0,3,11,47,4,9,4,58,0
Woman Files Complaint Against Bernie Williams,0,1,6,34,0,5,0,40,0
"U.S., South Korean Warplanes Prepare for Action at 'Max Thunder' Drill",0,2,10,45,5,10,0,55,0
Great Economic Expectations Are the Bull Market's Next Test,0,2,8,42,1,8,0,50,0
"Pirate Bay case: Internet group attacks websites in ""Operation Baylout""",0,1,5,54,3,9,0,59,0
China's plan to reduce troop numbers to save money for high-tech weapons is on track,0,3,1,67,2,14,0,68,0
"Kristen Bell on why her daughters don't watch ""Frozen,"" holiday plans",0,3,3,52,4,10,0,55,0
One dead in Oakland residential building fire,0,2,2,37,0,6,0,39,0
Israeli forensic institute illegally harvested organs in the '90s,0,1,1,53,1,8,2,54,0
"G20 agrees to avoid currency war, also agrees to reduce trade imbalances",0,1,1,57,1,11,2,58,0
Donald Trump’s most chilling comment on the DNC hack had nothing to do with Russia,0,2,6,61,1,14,0,67,0
This Gay Man Responded To A Cruel Tweet About Him In The Best Way,0,2,14,38,0,13,0,52,0
Dems Accuse Gorsuch of Skirting Major Legal Questions at SCOTUS Confirmation,0,3,14,52,0,10,0,66,0
He Wanted Some Alone Time,0,3,5,16,0,4,0,21,0
Mike Flynn Is First Casualty of Turmoil in Trump Administration ,0,3,8,46,0,10,0,54,0
"China’s Ant Financial, Owned by Trump Ally Jack Ma, Makes U.S. Play     ",0,3,12,39,5,16,0,51,0
South Korea begins sending indictments via SMS,0,1,5,35,0,6,0,40,0
A Combative Trial in Colorado as a Controversial Ex-Professor Seeks to Win Back His Job,0,1,12,60,1,14,0,72,0
LeBron James' personal barber: 'There is no dye',0,3,4,33,4,7,0,37,0
"Fox News Poll: Voters trust Trump on economy, Clinton on foreign policy, nuclear weapons",0,2,6,66,3,13,0,72,0
People Are Photoshopping the Hell Out of the New 'Star Wars: The Last Jedi' Poster,0,2,12,53,3,14,0,65,0
Daffy Duck Walks Through The Valley Of The Shadow Of Death For This Mashup,0,3,14,47,0,13,0,61,0
Zombie Galaxy Note 7s reportedly have a release date,0,3,3,40,0,8,1,43,0
Renault F1 given suspended ban as boss barred after cheating,0,1,2,48,0,9,1,50,0
Jeremy Corbyn could welcome back seven Labour rebels who quit over Brexit vote ,0,3,4,62,0,13,0,66,0
"Trump, in speech to Congress, calls to ‘restart the engine’ of US economy ",0,3,4,53,4,13,0,57,0
"Enzo’s Kitchen, London SW1: ‘The rocket is so knackered, it's basically compost’ – restaurant review",0,3,6,71,8,14,1,77,0
Stimulus Plan Encounters Stiff Resistance in Senate,0,1,6,39,0,6,0,45,0
Obamacare Repeal Without 'Replace' Doubles Uninsured To 59 Million,0,3,8,46,2,8,2,54,0
Yanks Win as Mets Drop the Ball (Literally),0,1,6,28,2,7,0,34,0
Carnival Princess to pay record $40 million for pollution cover-up,0,3,2,51,2,9,2,53,0
Letting Marbury  Go to Celtics Could Backfire on Knicks,0,1,7,39,0,9,0,46,0
Tony Romo is Coming Out of Retirement to Join the Dallas Mavericks,0,2,8,47,0,11,0,55,0
The two-hour marathon: What will it take to break the elusive barrier?,0,3,2,54,3,11,0,56,0
Reddit cracking down on hundreds of toxic users,0,3,1,39,0,7,0,40,0
Changes Proposed to Election of Corporate Boards,0,1,5,37,0,6,0,42,0
East Aleppo residents flee for their lives as airstrikes continue to pound the city,0,3,2,68,0,13,0,70,0
The next Republican fights could be even worse than its one over healthcare,0,2,2,61,0,12,0,63,0
Everything We've Learned About Family Is From Vin Diesel in the 'Furious' Franchise,0,2,11,57,3,12,0,68,0
Venezuela's Maduro pelted by protesters leaving a rally,0,3,2,45,1,7,0,47,0
D.C. yoga instructor who disappeared on way to holiday party found dead,0,2,2,56,2,11,0,58,0
"In the Fight Against Zika, Insecticides Hit a ‘Dead End’",0,3,8,36,3,9,0,44,0
"Study says to clean your sponge, microwave it",0,1,1,36,1,7,0,37,0
U.N. Leads Evacuation From Sri Lanka,0,1,7,22,2,5,0,29,0
"From 'Maria' to 'Shake Your Bon-Bon,' Listen to Ricky Martin's Billboard Hot 100 Hits",0,3,12,50,7,13,3,62,0
A Cashless Future Is The Real Goal Of India's Demonetization Move,0,3,11,43,1,10,0,54,0
Snapchat Snaps Back at Ex-Employee's Lawsuit,0,3,6,31,2,5,0,37,0
We Need To Talk About 2017 Justin Bieber,0,3,7,22,0,7,4,29,0
Jimmy Kimmel Wil Host This Year's Academy Awards Ceremony,0,2,9,39,1,8,0,48,0
John Key's pick for New Zealand's next prime minister faces party challengers,0,3,4,60,2,11,0,64,0
Leicester City 2-4 Chelsea: EFL Cup – as it happened,0,2,7,31,3,9,2,38,0
BOM issues severe thunderstorm warning for NSW northern and central parts,0,3,6,57,0,10,0,63,0
Man Pretending To Be Justin Bieber Allegedly Extorted A Child Into Sending Him Nude Photos,0,2,15,61,0,14,0,76,0
"Rush Limbaugh says he is 'very, very troubled' to see Trump possibly caving on the border wall",0,3,3,72,3,16,0,75,0
Trump Administration Gives Final Approval for Dakota Access Pipeline ,0,3,8,52,0,9,0,60,0
She’s 17 and Needs Birth Control. Do We Turn Our Backs? ,0,3,9,31,3,11,2,40,0
Ella Fitzgerald's flirtation with jazz's historical drug culture,0,3,2,53,2,7,0,55,0
"Internet, meet Finland's adorable first dog, Lennu",0,3,3,38,3,6,0,41,0
Here's what life is like in the world's most crowded cities,0,3,1,46,2,10,0,47,0
"Zoe Saldana says Trump opponents “became bullies,” helping him win",0,3,3,51,3,9,0,54,0
Report: Rick Perry on Trump’s Energy Secretary Short List - Breitbart,0,2,9,47,3,10,0,56,0
Lahore protest blast: 10 killed at Pakistan city rally,0,2,2,41,1,8,2,43,0
"Plan Magazine sold for €300,000 to Commercial Media Group",0,1,5,36,2,8,6,41,0
"Russia Stirs Friction in Balkans, as NATO Keeps an Uneasy Peace ",0,2,11,41,1,11,0,52,0
Hearing Highlights: Sessions Questioned on Links to Xenophobia ,0,2,6,48,1,8,0,54,0
Bill O’Reilly becomes spokesman for white America,0,3,4,38,1,6,0,42,0
So you want to preserve the liberal international order …,0,3,1,46,1,9,0,47,0
What Is Hawaii? ,0,3,3,9,1,3,0,12,0
Confederate Flag Won't Return to South Carolina Courtroom ,0,3,7,42,1,8,0,49,0
YouTube Twins Embrace Natural Beauty,0,3,6,26,0,4,0,32,0
PIA plane crash: All 47 on board killed; Pakistani pop star among victims,0,3,5,52,2,12,2,57,0
Apple is taking on chipmaker Qualcomm in US and Chinese courts,0,3,5,47,0,10,0,52,0
"Duke and Duchess of Cambridge to move into Kensington Palace, London",0,1,6,51,1,10,0,57,0
U.S. Postal rate increase proposed,0,1,3,25,2,4,0,28,0
"How ""La La Land"" was a ""dream project"" for director Damien Chazelle",0,3,6,46,4,11,0,52,0
Trump wants a $1 trillion investment in roads and bridges. Will more drilling help?,0,3,2,64,3,13,1,66,0
Istanbul attack: Turkish police detain two foreigners at city's airport after nightclub shooting,0,3,2,80,2,12,0,82,0
"Cavs' Kevin Love has surgery on left knee, out 6 weeks",0,3,3,38,2,10,1,41,0
"Korea Comes Through, Joining Semifinal",0,1,5,28,1,4,0,33,0
Qatar Air Plans to Establish Indian Carrier With 100 Planes,0,3,8,39,0,9,3,47,0
Why Turkish opposition parties are contesting the referendum results,0,3,2,58,0,8,0,60,0
Number of Americans Enrolling on Health-Care Website Jumps ,0,3,7,43,1,8,0,50,0
'Screw Our President!': Anti-Trump Protests Erupt in DC  Insider,0,2,10,40,5,9,0,50,0
Wikileaks says it wants to help tech companies thwart CIA hacking,0,3,4,51,0,10,0,55,0
Rebellion on the Range Over a Cattle ID Plan,0,1,7,29,0,8,0,36,0
South Korea Sewol ferry disaster: Human remains found,0,2,4,41,1,7,0,45,0
Rugby union: Noosa thrash Caloundra in Caloundra,0,1,4,37,1,6,0,41,0
Obamacare's Popularity Rises Just as GOP Moves to Repeal the Law,0,3,10,43,1,10,0,53,0
John Cummings obituary,0,2,2,18,0,2,0,20,0
U.S. team unveils plans for F1 entry in 2010,0,1,3,26,2,8,5,29,0
US officials flood Grand Canyon to restore ecosystem,0,1,4,41,0,7,0,45,0
Suspect in Murder 'Witnessed' By Family Parrot Appears in Court,0,3,8,44,2,9,0,52,0
U.S. Treasury chief tells IMF he expects ’frank and candid’ forex analysis,0,2,6,53,4,11,0,59,0
Yes Drummer Alan White on Rock and Roll Hall of Fame Induction: 'The Music Is Priceless & It's Ageless',0,2,15,65,5,18,0,80,0
Apple users criticize lack of FireWire port on MacBook,0,1,5,41,0,8,0,46,0
"Chrysler files for bankruptcy, Fiat Group SpA to run company",0,1,5,45,1,9,0,50,0
Cathay to Squeeze More Seats on B777-300 Plane,0,3,6,26,1,7,6,32,0
Poll: 36 Percent Approve Of Trump’s Performance In Office Thus Far,0,2,10,42,2,10,2,52,0
Mosul: Iraqi military recovers 61 bodies from debris as airstrikes probed,0,3,2,58,1,10,2,60,0
"MLB owners, players' union agree to 5-year labor contract",0,3,3,42,3,8,1,45,0
Elon Musk's new company said to seek brain-computer link,0,3,2,44,2,8,0,46,0
Selena Gomez on the Dark Side of Social Media and Growing Up Disney,0,3,9,46,0,12,0,55,0
North Korea says it can test launch intercontinental ballistic missile 'anytime and anywhere',0,2,2,77,2,12,0,79,0
Trump administration sends mixed signals on Syria ahead of G7 meeting,0,2,3,55,0,10,1,58,0
Just a load of animals with pancakes because humans are weird,0,2,1,50,0,10,0,51,0
Syria air strikes: Russian warship armed with cruise missiles heading for Syria as tensions rise with US,0,3,5,82,1,16,0,87,0
North Carolina Teen Charged With Murder After Allegedly Decapitating Mother,0,3,10,56,0,9,0,66,0
Jimmy Kimmel will host 2017 Oscars,0,2,3,22,0,5,4,25,0
Military Stocks Rally as Trump Prepares to Hike Budget | Fox Business,0,3,9,48,1,11,0,57,0
John Glenn's Ohio birthplace considered for historic status ,0,3,3,48,1,8,0,51,0
Severe heat wave blankets northeastern US,0,1,3,33,0,5,0,36,0
"Hershey's bitter news: Cutting more than 2,000 jobs",0,3,2,35,3,7,4,37,0
Naoto Kan elected new Prime Minister of Japan,0,1,5,33,0,7,0,38,0
Ed Sheeran Just Revealed He’s Releasing New Music This Week,0,2,10,39,1,9,0,49,0
"Trump Doesn't Read, So Protesters Are Flooding His Office With Books",0,2,11,45,2,10,0,56,0
House Dems: Flynn Didn’t Report Saudi Trip To Work On US-Russia Nuclear Deal,0,2,15,46,3,12,0,61,0
14 of the best photos of US military life during 2016,0,3,2,35,0,10,6,37,0
Romanian coalition government collapses,0,1,1,35,0,3,0,36,0
Fleetwood Mac: Tango in the Night review – timely reissue coasts from gloss to gloom,0,3,4,64,2,14,0,68,0
"Report: Orlando killer grew up in unstable, violent home",0,2,2,44,2,8,0,46,0
Ford Reports a Record $14.6 Billion Loss for 2008,0,1,5,27,2,8,7,32,0
Sailor Finishes Ocean Race After 121 Days at Sea,0,1,7,30,0,8,3,37,0
I.R.S. Study Tries to Assess if Hospitals Earn Tax Breaks,0,1,10,35,3,9,0,45,0
Ta-Nehisi Coates Perfectly Explains How Racism Helped Donald Trump Win,0,3,11,49,1,9,0,60,0
20th Century Fox Apologizes For Using Fake News To Promote A Film,0,2,11,41,0,11,2,52,0
NASA Shows What Landing on Pluto Would Look Like,0,3,11,29,0,8,0,40,0
There’s a Surprise Leader in Canada’s Race for Smart Global Jobs,0,3,8,44,2,10,0,52,0
Iraq banned from participating in Beijing Olympics,0,1,3,41,0,6,0,44,0
The GOP’s Obamacare replacement is the bill nobody loves or is begging for,0,3,5,56,1,12,0,61,0
Politics Tracker,0,3,2,13,0,1,0,15,0
Penalty rates protester at Bill Shorten press conference will not lose a cent from cuts,0,3,3,70,0,14,0,73,0
Space Shuttle Endeavour to return to Earth on Tuesday,0,1,5,40,0,8,0,45,0
Gold Traders Most Bullish in a Year After Dire End to 2016,0,3,8,35,0,11,4,43,0
Maryland Hands No. 2 North Carolina Its Third Loss in a Row,0,1,9,37,1,11,1,46,0
Fox Rejects Super Bowl Ad Depicting Border Wall,0,3,8,32,0,7,0,40,0
Emma Watson: the feminist and the fairytale,0,3,2,34,1,6,0,36,0
Sources: Dogs may have picked up escaped convicts' scent  - CNN Video,0,2,6,48,3,12,0,54,0
Report: Trump Signs Repeal of Obama’s Social Security Gun Ban - Breitbart,0,2,10,49,3,11,0,59,0
Lordi release music video for Finnish chart-topper 'Bite It Like a Bulldog',0,1,6,55,3,11,0,61,0
Dolly Parton Starts Fund to Help Victims of Tennessee Wildfire,0,3,8,45,0,9,0,53,0
Robert Xie found guilty of murdering five members of extended family,0,2,2,56,0,10,0,58,0
We Don’t Always End Up With The Loves Of Our Lives (And That’s Okay),0,3,14,37,4,13,0,51,0
"After Coyote Attacks, a Denver Suburb Turns to a Gun-Wielding Trapper",0,1,9,48,2,10,0,57,0
India's First AC Ambulance On Rails Will Rush To Action During Disasters!,0,2,13,47,2,11,0,60,0
2007/08 Bundesliga: Nürnberg vs. Bayern Munich,0,1,4,28,3,5,6,32,0
Gen. Barry McCaffrey: Michael Flynn’s Tweets ‘Border on Demented’,0,2,9,43,5,8,0,52,0
Investigations Into Senator Burris of Illinois Are Begun,0,1,7,42,0,7,0,49,0
British policewoman shot dead,0,1,1,25,0,3,0,26,0
Trump Is Set To Violate His D.C. Hotel Lease And The Agency Holding It Has No Plan,0,2,18,46,2,16,0,64,0
"Suspect charged in killings of NY imam, assistant",0,2,3,38,1,7,0,41,0
The Guys Who Founded Snapchat - Now Snap - Are Worth $4 Billion Each,0,3,11,40,3,13,1,51,0
Court Ruling Clears Hurdle for AT&T in New Public Safety Network,0,2,11,42,1,10,0,53,0
Trump and Brexit left progressives aghast – they should be emboldened,0,3,2,56,1,10,0,58,0
Scottish Radio Holdings set to buy Highland Radio for €7m,0,1,5,41,1,9,1,46,0
"Aside from Semicon Taiwan 2007 - An attraction of ""exiderdome"" by Siemens",0,1,5,50,3,11,4,55,0
"Tsunami deaths mount to more than 120,000",0,1,1,27,1,6,6,28,0
Standoff at Islamabad mosque claims at least 9 lives in Pakistan,0,1,3,50,0,10,1,53,0
Six-year-olds trigger emergency response with toy nuclear reactor in Germany,0,1,2,63,2,9,0,65,0
Now Donald Trump Must Fight The War He Isn't Ready For,0,2,11,32,1,10,0,43,0
"Hadoop, Analytical Software, Finds Uses Beyond Search",0,1,7,38,2,6,0,45,0
Higher Prices for Popular Comic Books,0,1,5,27,0,5,0,32,0
"Wikinews interviews Steve Kissing, independent candidate for US President",0,1,6,58,1,8,0,64,0
Rajon Rondo Sends Huge Shade at Dwyane Wade and Jimmy Butler in Instagram Post,0,2,11,54,0,13,0,65,0
High school kid becomes viral sensation after refusing to run from hail storm,0,3,1,64,0,12,0,65,0
MOAB strike: US military defend use of massive bomb in Afghanistan,0,3,7,48,1,10,0,55,0
The eco guide to female-friendly shopping,0,2,1,34,1,5,0,35,0
"The Dog of the Day Site? I’m Obsessed, and Here’s Why ",0,3,8,31,4,11,0,39,0
"Arsène Wenger: I could never manage in non-league, it is too difficult",0,3,3,53,3,11,0,56,0
Bids for London Stock Exchange must be blocked until after Brexit,0,3,5,50,0,10,0,55,0
Someone From Kerala Just Started A Petition To Make Shashi Tharoor India's PM In 2019!,0,3,15,51,2,14,4,66,0
Dozens pay tribute to British chef who died fighting Isil in Syria as his body is returned to the UK,0,3,6,75,0,19,0,81,0
Land Swaps Let Permian Drillers Expand Shale Wells on the Cheap,0,3,9,44,0,10,0,53,0
Texas lawmaker: 'Don't use Chile flag emoji when you mean Texas!',0,3,4,46,5,10,0,50,0
E.U. Monitors Report Georgians Forced from Abkhazia,0,1,7,36,2,6,0,43,0
Topshop’s Clear Plastic Jeans Are Here,0,3,6,26,1,5,0,32,0
"Sergio Garcia, Justin Rose Share Lead Following 3rd Round of 2017 Masters",0,2,9,47,1,11,5,56,0
NBA Lakers to Erect Shaquille O'Neal Statue 10 Feet off Ground at Staples Center,0,2,13,51,1,13,2,64,0
"Myanmar Ethnic Groups Hope for Peace, but Prepare for Battle",0,1,7,43,1,9,0,50,0
Rue21 Said to Ready Bankruptcy Filing as Soon as This Month,0,3,8,39,0,10,2,47,0
NSW floods: Murwillumbah family brave deep water to save horse,0,3,4,48,1,9,0,52,0
Robbie Williams caught using hand sanitiser after greeting fans on New Year's Eve,0,3,5,63,1,12,0,68,0
BCMMA Fighter Joe Harding Gets Knocked Out with Kick to Head While Taunting,0,3,15,48,0,12,0,63,0
Early Christmas Gift: Baby Delivered Roadside by State Trooper ,0,3,8,45,1,9,0,53,0
Artsy-Craftsy Booze Is Giving Kentucky Rabbis a Headache,0,2,8,40,1,7,0,48,0
999 call handling system crash left dispatchers scrawling down details of 2.5k emergencies,0,3,0,72,1,12,5,72,0
"Yup, Beyonce's 'Lemonade' just got an Album of the Year Grammy nom",0,3,6,45,4,11,0,51,0
8 Things You Must Do Right Now To Retire As A Billionaire,0,3,11,34,0,11,1,45,0
Kellyanne Conway mocked for 'spy microwaves' claims during interview about Obama 'wire-tapping',0,3,3,76,5,11,0,79,0
Federal appeals court refuses to reinstate Trump travel ban,0,3,2,49,0,8,0,51,0
U.S. ISPs to test restricting heavy Internet users,0,1,6,35,2,7,0,41,0
Rhode Island District Court freezes Palestinian Authority assets in the US,0,1,8,56,0,10,0,64,0
Why It’s Not Wrong to Wish Muslims Merry Christmas ,0,3,8,33,1,9,0,41,0
The Source Quits Accepting Lewd Advertising,0,1,6,32,0,5,0,38,0
28 Ways to Take Better Vacation Photos,0,3,5,25,0,6,2,30,0
SJWs Force Canadian Oil Group To Apologize For Saudi-Mocking ’Hot Lesbians’ Ad - Breitbart,0,2,16,57,4,13,0,73,0
Kenya Wants to Double U.S. Coffee Shipments,0,3,7,28,2,6,0,35,0
Behind the mysterious stock dump ahead of Trump's Lockheed Martin tweet,0,2,4,56,1,10,0,60,0
Article 50: What will happen to the economy now Theresa May has started Brexit?,0,3,5,57,2,13,2,62,0
Full text: Read the 9th Circuit Court's ruling on Trump travel ban,0,3,5,47,2,11,1,52,0
Here’s A Wheelbarrow Of Rescued Baby Orangutans On Their Way To Orangutan School,0,3,13,54,1,12,0,67,0
Abortion Industry: Gorsuch Confirmation ‘Dark Day for Women’,0,2,7,43,3,7,0,50,0
Jimmy Garoppolo Trade Rumors: Browns Reportedly Pursuing Patriots QB,0,3,10,49,1,8,0,59,0
Fireworks black market: Experts struggle to halt sale of illegal crackers,0,2,2,60,1,10,0,62,0
David Sullivan hits out at Dimitri Payet after he completes Marseille move,0,3,5,58,0,11,0,63,0
Google sued by thousands of authors over Google Print,0,1,3,42,0,8,0,45,0
Barack Obama and Malia had an awesome night out in NYC and looked awesome doing it,0,3,6,61,0,15,0,67,0
Puerto Rico's World Baseball Classic Run Has Caused Blond Dye Shortage,0,2,11,48,1,10,0,59,0
"‘Bro, I’m Going Rogue’: The Wall Street Informant Who Double-Crossed the FBI",0,3,14,45,6,11,0,59,0
Where are the world's happiest countries?,0,3,1,33,2,5,0,34,0
"Wall St: Dow Jones share index climbs within a whisker of 20,000 points",0,3,4,48,2,12,5,52,0
Democrats Hold ‘American Idol’ Events to Take on Trump,0,3,7,37,2,8,0,44,0
Thief steals over €6 million worth of jewels from Paris store,0,1,2,47,1,10,1,49,0
An Establishment Conservative’s Guide to MILO,0,2,8,31,1,5,0,39,0
Raheem Sterling completes Manchester City turnaround against Arsenal,0,3,5,56,0,7,0,61,0
RNC clarifies part of Christmas message after social media criticism ,0,3,4,55,0,10,0,59,0
"Bill Gates Praises Narendra Modi, Says He Loves The Government's 'Swachh Bharat' Initiative",0,3,13,62,4,12,0,75,0
"McCain makes secret trip to Syria to meet US military, Kurds ",0,3,6,43,1,11,0,49,0
Hillary Clinton Said Putin’s “Personal Beef” Against Her Contributed To Election Loss,0,2,12,59,3,11,0,71,0
"X Factor Final 2016: Louis Tomlinson Performs Emotional Tribute To His Late Mum, Johanna Deakin",0,2,14,61,2,14,4,75,0
American Express Bests Earnings Estimates,0,1,5,32,0,4,0,37,0
"After 60 years, is nuclear fusion finally poised to deliver?",0,3,1,46,2,9,2,47,0
The Best Cure for a Cough May Actually Be Chocolate,0,3,8,34,0,9,0,42,0
"Gun scare at Concordia University, Montreal",0,1,4,33,1,5,0,37,0
Ikea Is Giving Its Employees Up To Four Months Of Paid Parental Leave,0,3,13,44,0,12,0,57,0
Foreign Robots Invade American Factory Floors,0,3,6,34,0,5,0,40,0
Music Companies Agree to Settle Piracy Suit,0,1,6,31,0,6,0,37,0
Consumer Sentiment in U.S. Was Little Changed in April,0,2,8,36,2,8,0,44,0
Young Thug Avoids Battery Charges After Allegedly Slapping a Woman,0,2,9,48,0,9,0,57,0
Latvia Races to Cut Deficit to Keep to Its Bailout Deal,0,1,8,37,0,10,0,45,0
How wiretaps actually work — and what’s really going on here,0,2,1,47,2,10,0,48,0
The far right turned this Muslim woman into a ‘monster’ online. That’s despicable.,0,3,3,62,5,12,0,65,0
Alphabet Scraps Plan to Blanket Globe With Internet Balloons,0,2,8,44,0,8,0,52,0
"Grammy-winning jazz, pop and r'n'b singer Al Jarreau dead at 76 ",0,2,3,44,4,11,2,47,0
How Michigan became the feel-good story of the NCAA tournament,0,2,6,46,1,9,0,52,0
Donald Trump uses Black History Month speech to attack CNN and boast about his popularity,0,2,8,67,0,14,0,75,0
Watch Jay Z Tell Jay Electronica: 'Let's Put This Album Out',0,3,11,35,4,10,0,46,0
Desus Explains Why New York is Wack Now,0,3,7,25,0,7,0,32,0
Kanye West Met With Donald Trump and Twitter Exploded,0,3,8,37,0,8,0,45,0
72 hour Australia wide ban on horse movements,0,1,1,35,0,7,2,36,0
WSJ: George Soros Lost $1 Billion After Trump Won,0,3,10,28,2,8,1,38,0
Norway: Police detonate explosive device found in busy Oslo city centre street,0,3,3,63,1,11,0,66,0
‘Jurassic World’ Bites Off Biggest Global Debut of All Time With $511.8 Million,0,3,11,48,4,12,4,59,0
Big Mac Makeover Helps McDonald's Overcome Restaurant Slump,0,2,9,42,1,7,0,51,0
Riddle of Why Hitler Didn’t Use Sarin Gas Remains Unsolved ,0,3,9,39,1,10,0,48,0
McDonald's shuts branches across US during 'Day Without Immigrants' protest against Donald Trump,0,3,9,72,3,12,0,81,0
Weekend violence in Darfur complicates peace talks,0,1,2,42,0,6,0,44,0
Congress’s Zika Compromise Is a Minor Victory for Pro-Lifers,0,2,8,42,2,8,0,50,0
Families of Westminster attack victims found out fate through pictures online,0,3,2,65,0,10,0,67,0
Amazon Home Assistant Wants You to Know It Doesn’t Work for the CIA,0,3,12,42,1,12,0,54,0
Laura Muir praises ‘brilliant’ London marathon run of Joshua Griffiths,0,3,5,54,2,9,0,59,0
Fat people now have a plane specifically designed for them,0,2,1,48,0,9,0,49,0
"Report: ""Big Bang Theory"" stars take pay cut to raise female co-stars' pay",0,2,4,53,5,12,0,57,0
Survey Reveals Broad Support for President,0,1,5,32,0,5,0,37,0
Bama defensive star provides new No. 1 for CFB top 50 players,0,3,5,41,1,11,3,46,0
"Pharmaceutical giant 'plotted to destroy cancer drugs to drive prices up 4,000%'",0,3,1,60,4,11,4,61,0
Al Qaeda leader mocks 'the new fool of the White House' after Yemen raid,0,3,5,52,2,13,0,57,0
Tim Tebow Singles Against Marlins for 1st Spring Training Hit,0,3,8,43,0,9,1,51,0
Modern Dance and Art Bring a Burst of Color to a Gray City,0,1,8,38,0,12,0,46,0
UK terror suspects win appeal,0,1,2,23,0,4,0,25,0
Alanis Morissette Manager Admits to Stealing Nearly $5M From Singer,0,3,9,47,1,9,1,56,0
CIA Concludes Russia Mounted Operation to Help Trump Win: Source,0,3,11,43,1,9,0,54,0
FLYNN: Obama Would Not Be First President to Spy on Political Enemies - Breitbart,0,2,15,51,2,13,0,66,0
Man lives for Over a Year With His Heart In a Backpack - Breitbart,0,2,9,43,1,13,0,52,0
Dozens left dead in Caribbean as Hurricane Dennis moves toward U.S.,0,1,6,49,2,10,0,55,0
"Mom Being Booked for Leaving Kids in Hot Car Leaves Kids in Hot Car, Again: Police",0,2,13,52,2,15,0,65,0
Terrence Jones Burns Brooklyn Nets with Fake Behind-the-Back Move,0,3,9,46,2,8,0,55,0
Wikinews switches to Creative Commons license,0,1,3,37,0,5,0,40,0
"WATCH LIVE: Donald Trump To Address Rally In Melbourne, Florida At 5 PM ET",0,2,22,36,2,13,1,58,0
Osama bin Laden warns European Union in new audio tape,0,1,4,41,0,9,0,45,0
Biden to Trump: 'Time to be an adult',0,3,3,24,3,7,0,27,0
Bafta Awards 2017 - Why the Baftas wouldn’t be as British without Stephen Fry as host,0,3,7,57,2,15,4,64,0
Canada unveils plans to legalise recreational marijuana,0,2,1,48,0,6,0,49,0
There's not much room under this mushroom: Mantis prays for the weather to change as it shelters from the rain ,0,3,2,87,2,20,0,89,0
Charles Barkley says Michael Jordan used to wager 'hundreds of thousands of dollars' on rounds of golf,0,2,4,80,2,16,0,84,0
91 Great Colleges That Give Every Freshman a Scholarship,0,2,7,39,0,8,2,46,0
"Fangs: the lightning rise of Facebook, Amazon, Netflix and Google",0,3,5,48,3,9,0,53,0
"Watch Travis Scott's ""beibs in the trap"" Video f/ NAV",0,2,7,33,4,9,0,40,0
"Gary Sinise Awarded Walk of Fame Star For Acting, Pro-Military Activism  Insider",0,2,12,54,2,12,0,66,0
"In the Financial Crisis, Ordinary People vs. Extraordinary Problems",0,1,7,50,2,8,0,57,0
Turkey's deputy prime minister says the country's 'two-headed' democracy is unsustainable,0,2,1,73,5,10,0,74,0
Mrs. Obama Speaks Out About Her Household,0,1,7,27,1,6,0,34,0
2017 NFL Offseason Could Be a Uniquely Epic Year for the QB Carousel,0,3,12,40,0,12,4,52,0
Upbeat but Sympathetic: A Fine Line for Super Bowl Ads,0,1,8,36,1,9,0,44,0
Fortescue Metals founder Andrew Forrest's luck turns again as iron ore price jumps,0,2,4,65,1,12,0,69,0
Racer Ashwin Sundar And His Wife Killed After Their BMW Catches Fire In Chennai,0,3,16,50,0,13,0,66,0
Goldman Sachs Powers Dow to 20000 Milestone ,0,3,5,27,0,7,5,32,0
"In remembering George Michael, don’t forget the decades we spent shaming him",0,2,3,60,2,11,0,63,0
Michael Phelps Teaches 7-Month-Old Son Boomer To Swim Underwater,0,3,10,43,2,8,1,53,0
President Obama finally admitted he didn’t pay enough attention to the Democratic Party,0,3,4,70,1,12,0,74,0
"Roles for Ivanka Trump, Jared Kushner come into focus",0,2,5,39,1,8,0,44,0
Donald Trump on Vicente Fox: ’I Accept His Apology’ - Breitbart,0,2,9,40,4,10,0,49,0
British Court Finds 3 Not Guilty of Aiding London Bombers,0,1,8,39,0,9,1,47,0
Iraq's PM says ISIS could be defeated 'within 3 months',0,3,7,35,3,9,1,42,0
Michael Flynn is the latest member of Team Trump to learn that bad press actually does matter,0,3,4,73,0,16,0,77,0
Here's what you need to know about Snapchat's IPO,0,3,5,34,2,8,0,39,0
Cher's First Acting Role In 7 Years Will Be A Lifetime Movie About The Flint Water Crisis,0,3,16,55,1,16,1,71,0
North Korea Could Face New Round of Sanctions,0,1,7,31,0,7,0,38,0
Man Gets Life Sentence in Death of Pregnant Ex-Girlfriend in Hawaii,0,3,9,47,1,10,0,56,0
U.S. military covertly pays to run stories in Iraqi press,0,1,3,43,2,9,0,46,0
What a world without Carrie Fisher means for the Star Wars universe,0,2,5,51,0,11,0,56,0
Politics Live - readers' edition: Friday 7 April,0,3,4,33,3,7,1,37,0
"Celtics, LeBron and the trade deadline winners and losers",0,3,3,45,1,8,0,48,0
Top U.S. Diplomat’s First Asia Trip Comes Amid Tensions Over North Korea,0,3,13,45,3,11,0,58,0
Pipe Made in India Incenses an Illinois Steel Town,0,1,7,35,0,8,0,42,0
Suicide attack at Yemen shrine leaves nine dead,0,1,2,38,0,7,0,40,0
"Calais Migrant Camp Will Be Demolished Soon, French Minister Says",0,2,10,45,1,9,0,55,0
"Russell Simmons Hopes ‘The Scenario,’ a Hip-Hop Musical, Has Mass Appeal - The New York Times",0,2,15,57,6,15,0,72,0
Woman Tries to Solve Her Own Kidnapping 34 Years Later,0,3,8,35,0,9,2,43,0
Toll Rises to 57 in Suicide Bombings in Northeast Nigeria,0,3,6,40,0,9,2,46,0
Penn State frat shut down after pledge's fatal fall,0,3,2,40,1,8,0,42,0
"Before Crash, Germanwings Pilot Searched Web for Ways to Die ",0,3,8,42,1,10,0,50,0
Here's what NASA saw when it landed on Saturn's largest moon,0,3,6,42,2,10,0,48,0
Yankees Give Weary Rodriguez Two Games Off,0,1,7,29,0,6,0,36,0
"8 dead following road collision in New Brunswick, Canada",0,1,3,43,1,8,1,46,0
Justin Bieber Makes His Instagram Return Official With Flood of New Photos,0,3,11,52,0,11,0,63,0
Cat learns to hop around 'like kangaroo' after tragic accident,0,3,1,50,2,9,0,51,0
Dow Chemical to buy Rohm and Haas,0,1,4,23,0,6,0,27,0
"One-China Policy Can’t Be Bargaining Chip, Beijing Warns Trump",0,3,10,41,3,8,0,51,0
St Petersburg Metro explosion: CCTV image of suspect emerges after at least 10 killed by 'briefcase' bomb,0,2,7,77,3,16,2,84,0
"Customs arrest in courthouse sends “horrible” message, official says",0,3,1,56,3,8,0,57,0
Kendall Jenner Is Red Hot In The Latest Estée Lauder Campaign,0,2,11,40,0,10,0,51,0
Carrie Fisher and Debbie Reynolds to be buried together,0,3,4,43,0,8,0,47,0
A BBC presenter had to point out she never ran a torture black site for the CIA The list,0,2,8,62,0,18,0,70,0
"Gilbert Baker, creator of iconic LGBT rainbow flag, dies at 65 ",0,3,6,42,2,11,2,48,0
Wilbur Ross failed to disclose he’s being sued by former business partner,0,2,2,59,1,11,0,61,0
People Are Shook Over How Hot Young Justin Trudeau Was,0,2,10,35,0,9,0,45,0
The Most Popular NFL Teams In States That Don't Have One,0,2,13,32,1,10,0,45,0
Arrest Said to Be Near in Killing of Chandra Levy,0,1,7,33,0,9,0,40,0
The Matrix reboot writer thinks rebooting The Matrix is a bad idea,0,3,4,51,0,11,0,55,0
"John Kerry criticizes news media, joins call for inquiry on Downing Street Memo",0,1,5,61,1,12,0,66,0
A Note to Readers,0,1,3,11,0,3,0,14,0
"Anzac Day: Large crowds, boosted police presence expected at Queensland services",0,2,4,64,2,10,0,68,0
Syrian fighters cut main road linking IS-held areas ,0,3,3,40,1,8,0,43,0
Parliamentary entitlements system to change after Sussan Ley apartment controversy,0,3,3,70,0,9,0,73,0
Republicans have questions about Trump and wiretapping,0,3,2,46,0,6,0,48,0
Oxford to use online voting for Professor of Poetry election,0,1,3,48,0,9,0,51,0
Parliamentary Budget Office costs plan to abolish stamp duty in favour of broad-based land tax,0,3,3,76,1,14,0,79,0
"Victoria, Australia Police investigate suspicious fire near rural town",0,1,3,58,1,8,0,61,0
Disturbing images show a rabbit attached to the back of a car as it travels through a busy Chinese city ,0,3,2,82,0,20,0,84,0
Rice and Straw arrive unannounced in Baghdad,0,1,3,35,0,6,0,38,0
"To Save Obamacare, Democrats are Looking for a Few Good Stories",0,3,8,44,1,10,0,52,0
We tried Dyson's $400 supersonic hair dryer â here's the verdict,0,3,2,46,5,10,3,48,0
Orlando Manhunt: Two Officers Die in Pursuit of Murder Suspect,0,3,8,44,1,9,0,52,0
From the archives: What a sarin gas attack looks like,0,3,2,41,1,9,0,43,0
Live Berlin terror attack: Islamic State claim responsibility as police launch new manhunt for armed gunman,0,2,4,87,1,15,0,91,0
Too many women are leaving hospital after childbirth with PTSD because of bad care,0,2,5,64,0,13,0,69,0
"Behind the scenes of the new badass, blockbuster 'Wonder Woman'",0,3,3,48,3,9,0,51,0
A&E crisis deepens despite drop in numbers attending casualty units ,0,2,2,55,1,10,0,57,0
Beci Orpin: Behind the scenes of her Instagrammable life,0,2,4,43,1,8,0,47,0
Theresa May’s article 50 letter annotated,0,2,2,31,1,5,2,33,0
"Hirakhand Express Train Derails in Southern India, Killing Dozens ",0,3,8,48,1,9,0,56,0
CPAC sells young conservatives with 'hip and cool' swag,0,3,4,41,2,8,0,45,0
"Egypt Likely to See More ISIS Attacks, Needs to Change How it Fights Terror, Analysts Say ",0,3,16,56,2,16,0,72,0
"Plane carrying Brazilian soccer team crashes in Colombia, killing 71",0,2,3,53,1,9,2,56,0
Crossword-Solving: A Search for Connections and Answers ,0,3,6,41,2,7,0,47,0
'Trump's policies towards NAFTA and Mexico will have a negative impact in the borderland',0,3,7,66,3,13,0,73,0
2 Navy Vessels Collide in Strait of Hormuz,0,1,5,29,0,7,1,34,0
Murderer of Dutch filmmaker van Gogh gets life term,0,1,3,40,0,8,0,43,0
"In U.S., British Libel Rulings Raise Concern",0,1,8,27,3,6,0,35,0
Eric Shawn reports: 'Do not trust Iran'| Latest News Videos ,0,2,7,39,4,10,0,46,0
"Daimler to recall 75,000 Mercedes-Benz cars in the UK due to fire risk",0,3,5,46,2,12,5,51,0
Vote: Who will win Super Bowl LI?,0,3,6,19,2,6,0,25,0
Top Trump Advisor in 2014: World Must Confront Radical Islam Now  Insider,0,3,10,46,1,12,4,56,0
Gordon Brown's troubled first year,0,1,2,27,1,4,0,29,0
ETA places explosives on Tour de France route in Spain,0,1,6,39,0,9,0,45,0
Arkansas execution: Judge orders post-mortem,0,3,2,36,2,4,0,38,0
George W. Bush and wife Laura will attend Donald Trump's inauguration,0,2,6,51,2,10,0,57,0
"Ugo Ehiogu dead: Tottenham confirm former England footballer has died after heart attack, aged 44",0,3,4,75,2,14,2,79,0
US sanctions 271 Syrian government workers after chemical attack ,0,2,3,50,0,9,3,53,0
Chris Hughton appointed permanent manager of Newcastle United,0,1,4,50,0,7,0,54,0
FDA report criticizes conditions in factory that produced recalled medications,0,1,3,66,0,9,0,69,0
Public policy expert: Trump’s claim that drugs are cheaper than candy bars isn’t ’entirely untrue’,0,2,2,77,5,14,0,79,0
Brendan Cox: 'What the terrorist would like to happen is for us to fall apart' The list,0,3,4,64,3,16,0,68,0
Junior Hockey Champions Seek PM Modi’s Help To Get Jobs For A 'Secure Future',0,2,15,46,3,13,0,61,0
Cruz Campaign Sends SC Mailer Morphing Rubio’s And Obama’s Faces (PHOTO),0,2,16,42,4,10,0,58,0
Gallup: Trump Net Approval Rating Drops 8 Points In First Week In Office,0,2,12,46,1,12,1,58,0
Russian Treason Bill to Be Revised,0,1,5,24,0,5,0,29,0
Former Soviet Gymnast Olga Korbut Says Goodbye to Her Medals,0,2,9,42,0,9,0,51,0
U.S. retains control of Internet root servers,0,1,3,34,2,6,0,37,0
"Aaron Diehl Seeks Common Thread on ‘Space, Time, Continuum’ (Exclusive Album) - Speakeasy",0,3,11,59,7,12,0,70,0
Disgraced Journalist Pleads Not Guilty To Cyberstalking In Connection With Jewish Bomb Threats,0,2,13,69,0,12,0,82,0
Renzi’s Italian Fate Also Overshadows Draghi’s Route for QE,0,3,9,40,2,8,0,49,0
‘In Cold Blood’ Killer’s Never-Published Memoir Raises Questions About His Motive,0,3,12,55,4,10,0,67,0
Colombia's ELN loses kidnap victim in jungle escape,0,3,4,39,1,7,0,43,0
"Priyanka Chopra on love, hip-hop and conquering Hollywood",0,2,3,45,2,7,0,48,0
What the G-20 Didn’t Say on Trade Should Chill Investors,0,3,8,35,2,9,2,43,0
Polish President Lech Kaczyński dies as his plane crashes in Russia,0,1,5,52,0,10,0,57,0
The awesome life and career of 'Star Wars' icon Carrie Fisher,0,3,5,44,2,10,0,49,0
Israel begins ground assault on Gaza Strip,0,1,3,33,0,6,0,36,0
Torrent of water floods shops and leaves thousands without water in Blackheath after pipe bursts,0,3,2,80,0,14,0,82,0
Aid starts to reach Myanmar,0,1,2,21,0,4,0,23,0
"Big Sean Shares New Song ""Halfway Off The Balcony""",0,3,9,31,2,8,0,40,0
Beehives stolen as New Zealand honey prices soar; crime ring blamed ,0,3,3,53,1,11,0,56,0
Malia Obama is going to intern with hotshot Hollywood producer Harvey Weinstein,0,2,5,63,0,11,0,68,0
"Floodwaters swamp Cedar Rapids, Iowa",0,1,4,27,1,4,0,31,0
Accused bomber Ahmad Rahimi pleads not guilty in New Jersey case,0,2,5,49,0,10,0,54,0
"As ‘The Walking Dead’ Stumbles, AMC Looks to the Future",0,3,10,33,3,9,0,43,0
"Copiapó, Chile mining accident: in depth",0,1,2,31,2,5,0,33,0
Americans Renouncing Citizenship at Record High,0,3,5,37,0,5,0,42,0
"Bernie Sanders Has a Podcast Now, So You Can Feel the Bern All Year Long",0,3,13,44,1,14,0,57,0
NASCAR: Tony Stewart wins 2010 Pepsi Max 400,0,1,10,19,1,7,7,29,0
A.I.G. Chief Owns Goldman Stake Worth More Than $3 Million,0,1,11,33,4,9,1,44,0
Search and rescue beacons soon to make the digital jump,0,1,1,45,0,9,0,46,0
"Steelers vs. Chiefs Delayed Due to Ice Storm: Latest Comments, Reaction",0,3,9,49,3,10,0,58,0
Steelers Star Antonio Brown's Facebook Live Lapse May Cost Him | Fox Business,0,2,12,51,2,12,0,63,0
"For Fine Recession Wear, $7,000 Suits From Saks",0,1,7,26,3,7,4,33,0
Executions and death sentences plummeted this year as capital punishment declined nationwide,0,3,1,80,0,11,0,81,0
How to Talk to Your Teen About Marijuana [Video],0,3,7,31,2,8,0,38,0
Drugs are killing so many people in West Virginia that the state can’t keep up with the funerals,0,2,3,75,1,17,0,78,0
"Chance the Rapper Releases ‘Coloring Book,’ With Spirit ",0,3,7,38,3,8,0,45,0
"Amazon server outage affects Reddit, other websites",0,1,2,42,1,6,0,44,0
"'SNL' mocks Trump, Putin and ties with Exxon CEO",0,2,9,28,3,8,0,37,0
I Am Ashamed to Be Australian ,0,3,5,19,0,6,0,24,0
"Indiana Town's Entire Police Force Resigns, Citing Unfair Treatment  Insider",0,2,10,54,2,10,0,64,0
Kata Air An-32 crashes - all presumed dead,0,1,3,28,2,7,2,31,0
Millennials blamed for drop in fabric softener sales,0,3,1,44,0,7,0,45,0
Icelandic Landsbanki Íslands earnings on the increase,0,1,3,44,0,6,0,47,0
"Tom Brady Wore A Massive Coat, And The Internet Loved It",0,2,11,34,1,10,0,45,0
Miss California USA Is Fired,0,1,7,17,0,4,0,24,0
Daniel Radcliffe would 'think about' starring as adult Harry Potter in Cursed Child film,0,3,6,67,2,13,0,73,0
Man Convicted of Murder in Hot Car Death to Be Sentenced ,0,3,8,38,0,11,0,46,0
"Didi Gregorius leaves WBC, returns to Yankees with shoulder injury",0,3,6,50,1,9,0,56,0
Donald Trump forgets Paul Ryan's name and calls him Ron twice,0,2,5,45,1,10,0,50,0
We Barely Even Noticed Kim Kardashian’s Subtle New Wedding Ring,0,3,10,43,1,9,0,53,0
Hail Trump? White nationalists already losing faith in President-elect,0,2,4,56,2,8,0,60,0
U.S. Senate defeats bill banning gay marriage,0,1,3,34,2,6,0,37,0
German taxman gives sex workers a break by slashing VAT for people who hire hotel rooms by the half hour ,0,2,4,81,0,20,0,85,0
Light stopped for over a second,0,1,1,25,0,5,0,26,0
11-year-old raises money to help disabled friend learn how to ride a bike  ,0,2,0,57,2,14,2,57,0
This Bacon Ice Cream Sandwich Just Might Be The One,0,3,10,32,0,9,0,42,0
"After Many Firsts, Judge Has Talent for Persuasion",0,1,7,35,1,7,0,42,0
Indian police 'raped dozens of women and looted homes during anti-communist operation',0,2,1,71,3,11,0,72,0
NAACP Chapter President Rachel Dolezal Plans to Address Race Controversy Monday,0,2,14,55,0,10,0,69,0
2015: Looking Back On A Year At The Tiny Desk,0,2,9,22,1,9,4,31,0
Disputed Irish loughs present Brexit conundrum for fishermen,0,3,3,50,0,7,0,53,0
Trump cabinet: Rex Tillerson sworn in as top US diplomat,0,3,5,41,1,9,0,46,0
Park Geun-hye: South Korean leader's friend Choi Soon-sil charged with bribery,0,3,6,58,4,10,0,64,0
Planned Rollback of Climate Rules Unlikely to Achieve All Trump’s Goals ,0,3,9,51,1,11,0,60,0
Secret UK tomb found to contain remains of 5 archbishops ,0,3,3,43,0,10,1,46,0
Police Investigate Possible Hate Crime After Sikh Man Shot,0,3,9,41,0,8,0,50,0
Oil spill spotted along Mississippi River,0,1,3,33,0,5,0,36,0
James Comey to Brief Donald Trump on Russian Hacking Friday ,0,2,8,42,0,10,0,50,0
Russian Navy Ship Sinks In Black Sea After Collision With Freighter,0,3,11,46,0,10,0,57,0
Drought conditions and high winds lead to wildfires in Texas,0,1,2,49,0,9,0,51,0
"Grief, anguish as loved ones recall victims of Dylann Roof at sentencing ",0,3,3,57,1,12,0,60,0
Cyclone Barrels Toward Northeastern Coast of Australia ,0,3,6,42,0,7,0,48,0
Islamophobia in China on the rise fuelled by online hate speech,0,2,2,51,0,10,0,53,0
Israeli Companies Seek a Worldwide Profile,0,1,5,32,0,5,0,37,0
Oakland Warehouse Fire Survivors Describe Escape From Blaze as Confirmed Death Toll Rises to 33,0,3,12,67,0,14,2,79,0
Federal Government announces review into retail electricity prices,0,2,2,57,0,7,0,59,0
France to Pay Nuclear Test Victims,0,1,5,24,0,5,0,29,0
BBC: Even Liberals Are Buying Guns Under Trump,0,3,10,28,1,7,0,38,0
Mitsubishi Heavy IndustriesVoice: The Evolution And Impact Of Online Shopping,0,3,11,56,1,9,0,67,0
George W. Bush Gave Us Donald Trump. Now He Wants To Be Forgiven.,0,3,13,37,3,12,0,50,0
Guantanamo detainee David Hicks seeks UK passport,0,1,5,38,0,6,0,43,0
Duisburg hostage crisis: Two arrested as police say threat over,0,2,2,51,1,9,0,53,0
Four Romanian ambassadors recalled,0,1,2,29,0,3,0,31,0
Brazilian police say Greek ambassador was killed by his wife's lover,0,3,2,55,1,10,0,57,0
2017 NFL Free Agents: Best Players Available for Week 3,0,3,9,31,1,9,5,40,0
Hurricane Adrian strikes Central America Thursday night,0,1,5,44,0,6,0,49,0
Taiwan Voters Move Away From Chen's Agenda,0,1,7,28,1,6,0,35,0
Full size Titanic replica built in China will stage ‘simulation’ of iceberg collision,0,3,3,68,2,12,0,71,0
UK Vinyl Sales in 2016 Hit Highest Level Since 1991,0,2,8,26,0,9,8,34,0
North and South Korea to meet next week,0,1,3,29,0,7,0,32,0
Deal Is Reached to Keep Boston Sailing Show Afloat,0,1,8,34,0,8,0,42,0
"Widespread looting blamed for disrupted rescue efforts in New Orleans, Louisiana",0,1,4,65,1,10,0,69,0
IBMVoice: Paving The Path Toward Universal Quantum Computing,0,3,11,41,1,7,0,52,0
Trump called the press ‘the enemy.’ Reince Priebus says he meant it.,0,3,3,50,4,11,0,53,0
"Anti-Semitic jokes cause YouTube, Disney to distance themselves from PewDiePie",0,3,8,59,2,9,0,67,0
Earnings Decline 35% at Halliburton,0,1,3,25,1,4,2,28,0
Northern Ireland's power-sharing agreement on the brink of collapse as Martin McGuinness quits,0,3,5,75,2,12,0,80,0
"Meet RBI's New Deputy Governor, Viral Acharya, Who Also Has A Music Album To His Credit!",0,2,18,51,4,15,0,69,0
Media round-up: April Fools' Day 2008,0,1,4,21,3,5,4,25,0
"Young Thug And Lil Durk Target Cyber Trolls On ""Internet""",0,3,10,36,2,9,0,46,0
"Cuba Gooding Sr., 'Everybody Plays the Fool' Singer & Dad to Oscar-Winning Actor, Dies at 72",0,2,12,56,7,15,2,68,0
I.B.M. Looks to Sell Big Business on Cloud Computing,0,1,9,32,3,8,0,41,0
Is That Plate Speaking for the Driver or the State?,0,1,6,35,1,9,0,41,0
Malaysia's Ringgit Crackdown Spooks Overseas Investors,0,3,6,42,1,5,0,48,0
Trump Reportedly Nixed the Interior Department’s Twitter Feed After Criticism,0,3,9,58,1,9,0,67,0
US researchers discover new way to procure water from thin air,0,2,2,50,0,10,0,52,0
‘They want to prove they’re “real men”’: Princeton suspends swimmers for ‘misogynistic’ messages,0,3,2,74,8,12,0,76,0
Modest Start to Fed Plan to Revive the Securities Market,0,1,7,40,0,9,0,47,0
17 Times Jack & Karen From “Will & Grace” Were Friendship Goals AF,0,3,11,37,4,12,2,48,0
"With First Fan in Attendance, Wizards Top Bulls",0,1,7,32,1,7,0,39,0
PROMO: Check Out the Video for the New Song “Man” From Last Night’s Episode of 'Star'!,0,3,16,48,7,15,0,64,0
My dad is cross-dressing and Mum is bitter. What can I do to help?,0,3,4,46,3,13,0,50,0
"Former President George HW Bush Admitted to ICU, Barbara Bush Hospitalized ",0,2,13,50,1,11,0,63,0
Future Scores a Fourth No. 1 Album With 'FUTURE',0,3,12,24,3,8,1,36,0
India frustrated against Bangladesh as Ajinkya Rahane makes 98,0,3,4,48,0,8,2,52,0
Lawmakers say Trump’s words matter — and hurt the country’s standing abroad,0,2,2,59,3,11,0,61,0
Debate on Clean Energy Leads to Regional Divide,0,1,6,34,0,7,0,40,0
"Trump's Labor Nominee Is Ready For His Hearing, Spokesman Says (UPDATE)",0,3,16,41,4,10,0,57,0
"'Orange Is the New Black' Season 3, Episode 1: Mother's Day blues",0,2,8,39,5,11,2,47,0
Indulge your fear of heights with China's latest glass bridge,0,3,2,49,1,9,0,51,0
ESPN expert predictions: Another MVP honor for Trout?,0,3,9,35,2,7,0,44,0
Nearly 200 nations agree binding deal to cut greenhouse gases,0,2,1,48,0,9,3,49,0
"Detained Dreamer could be deported, attorney says ",0,3,2,40,1,7,0,42,0
"Let’s Cut The Shit, Ryan Gosling Is 1,000,000 Times Better Than Ryan Reynolds",0,2,12,42,4,12,7,54,0
"Beyonce reveals she’s having twins, and the internet may never be the same",0,3,1,59,2,12,0,60,0
Clemson earns a rematch against Alabama for the NCAA football national championship,0,3,6,66,0,11,0,72,0
Twitter’s 140-Character Limit Wont Include Usernames Anymore,0,3,7,42,2,6,3,49,0
Christie pardons NJ man whose legally owned gun made him convicted felon ,0,3,3,58,0,12,0,61,0
Taya Kyle: Backlash to Trump's SEAL Widow Tribute 'Makes Me Sick to My Stomach'  Insider,0,3,16,53,4,15,0,69,0
Disney Channel Has Aired Its First Ever Same-Sex Smooch,0,2,10,36,1,8,0,46,0
New Data Suggest U.K. Government Figures Are Getting Released Early,0,3,11,45,2,9,0,56,0
Watch Live: Golden Globes Nominees Revealed,0,3,6,31,1,5,0,37,0
Sydney's newest motorway to open today,0,1,1,31,1,5,0,32,0
Crush the saboteurs! How hard-Brexit rhetoric turned Leninist,0,3,4,48,2,7,0,52,0
"Foreign Payments to Trump Firms Violate Constitution, Suit Will Claim ",0,3,9,50,1,10,0,59,0
Strictly Come Dancing: the semi-final – as it happened,0,3,3,40,3,8,0,43,0
Convicted murderer Leonard Peltier again denied parole,0,1,3,45,0,6,0,48,0
Thabo Sefolosha Settles Lawsuit with NYPD over Nightclub Arrest,0,3,10,45,0,8,0,55,0
Miley Cyrus married? Billy Ray's post has people talking,0,3,4,42,2,8,0,46,0
"As Workers Die at Work in Italy, a Call for Change",0,1,7,32,1,10,0,39,0
Bush nominates Harriet Ellan Miers for U.S. Supreme Court,0,1,8,39,2,8,0,47,0
Bird flu resistant to anti-viral drug,0,1,1,30,1,5,0,31,0
MICHAEL LEWIS: How behavioral psychology explains Trump's surprise victory,0,3,14,50,2,8,0,64,0
Emma Stone Hilariously Fails Jimmy Fallon's 'Singing Whisper Challenge',0,3,9,51,3,8,0,60,0
Utah police investigate polygamist family from reality show 'Sister Wives',0,1,3,60,2,9,0,63,0
Discounts and the Internet Cut Telephone Costs,0,1,5,35,0,6,0,40,0
"The Trump Administration Banned Laptops, So One Airline Is Passing Them Out",0,2,12,51,1,11,0,63,0
'Last Tango in Paris' Director Admits Infamous Rape Scene Was Non-Consensual: 'We Didn't Tell Her',0,3,15,62,7,14,0,77,0
American Airlines plane overshoots runway in Jamaica; injuries reported,0,1,3,59,1,8,0,62,0
Reflections From Dom DiMaggio on His Often-Overlooked Hitting Streak,0,1,10,49,1,8,0,59,0
Reggie Jackson's Trade Value for Pistons Reportedly Revealed,0,2,7,45,1,7,0,52,0
2 arrested after a gun went off during a wedding at a fancy New York City hotel - Business Insider,0,3,5,72,1,19,1,77,0
How The Long-Lash Look Went From The Red Carpet To Everyday Life,0,2,13,39,1,11,0,52,0
New British books prize for BAME authors unveils inaugural longlist,0,3,6,52,0,9,0,58,0
The World’s Most Radical Experiment in Monetary Policy Isn’t Working,0,2,9,48,2,9,0,57,0
This video shows all of the US presidents in order of height,0,3,3,46,0,11,0,49,0
J.R. Smith Injury: Cavaliers SG to Undergo Surgery on Injured Thumb,0,3,11,43,3,10,0,54,0
Sounders Reserve Player Gets Red Card for Kicking Opponent in Groin,0,3,9,48,0,10,0,57,0
Duterte’s War on Drugs Stumbles in Rehabilitation Effort  ,0,2,6,42,1,9,0,48,0
National roaming Anywhere Sim card to tackle UK notspots,0,3,5,43,0,8,0,48,0
"Get set for December supermoon, Geminid meteor shower ",0,2,3,42,1,8,0,45,0
Trump's Global Web Of Partners,0,2,5,20,1,4,0,25,0
Five kidnapped from Nigerian oil rig,0,1,2,29,0,5,0,31,0
St. Michael and Rice Win Class AA Titles,0,1,8,24,1,7,0,32,0
Tropical Storm Cindy threatens U.S. Gulf Coast,0,1,7,31,2,6,0,38,0
Here’s who Donald Trump follows on Twitter — and who he has unfollowed,0,3,4,52,2,12,0,56,0
Egyptian president moves to boost security after attack on ancient temple ,0,2,1,62,0,11,0,63,0
Alleged war criminal Radovan Karadžić caught in Serbia,0,1,4,43,0,7,0,47,0
Trump's choice for education secretary raises questions,0,3,1,47,1,6,0,48,0
Police may have killed some of the eight tourist victims in Philippines hostage crisis,0,1,2,71,0,13,0,73,0
Aboriginal cultural tours on Mount Majura help people see Canberra through new eyes,0,3,4,67,0,12,0,71,0
ASEAN basketball league moves closer to reality,0,1,5,36,0,6,0,41,0
"David Warner Is The New No. 1 ODI Batsman, Is He Even Better Than Virat Kohli And AB de Villiers?",0,3,21,53,3,19,1,74,0
Post Office Acting to Reduce Losses,0,1,5,25,0,5,0,30,0
"Dude Gets Blazed With His Grandma for the First Time, Ends Up Talking About Porn",0,2,13,52,1,14,0,65,0
Travel Ban Heads Toward Supreme Court in Transition ,0,3,7,37,0,8,0,44,0
President Bush claims critics are rewriting Iraq war history,0,1,3,49,0,8,0,52,0
Senate Confirms Dr. Ben Carson 58-41 to Lead Housing and Urban Development Department - Breitbart,0,2,11,65,3,14,4,76,0
Swedish Parliament passes electronic surveillance law,0,1,2,46,0,5,0,48,0
LINEUP: Watch Reaction to Trump's Address to Congress on Fox News  Insider,0,2,14,46,2,12,0,60,0
Theresa May holding talks at White House with Donald Trump,0,3,6,43,0,9,0,49,0
Apple Said to Be in Talks to Sell IPhone for Verizon,0,1,8,34,0,10,0,42,0
"Here's How Popular Shows Like 'Duck Dynasty,' 'Love & Hip Hop,' and 'NCIS' Are Based on Where You Live",0,3,19,55,10,18,0,74,0
Jeb Bush Tweets Out 'Jeb!' Logo Ahead Of 2016 Campaign Launch,0,3,10,34,3,10,4,44,0
Nestle Sued Over Raisinets,0,3,4,19,0,3,0,23,0
"Memorial unveiled to mark 50th anniversary of deaths of 47 miners in Lanarkshire, Scotland",0,1,3,69,1,13,4,72,0
Classifying humans into races the biggest mistake in history of science,0,3,1,60,0,10,0,61,0
British Columbia helicopter crash kills 4,0,1,2,33,0,5,1,35,0
Grammy Awards 2017: Katy Perry sparks backlash over Britney Spears mental health jibes,0,3,6,63,1,12,4,69,0
"Donald Glover Wins Best Performance by an Actor in a TV Series, Comedy or Musical at 2017 Golden Globes",0,3,13,67,1,18,4,80,0
Bill O'Reilly: Media's treatment of Maryland high school rape 'beyond anything I have ever seen' ,0,3,6,71,5,15,0,77,0
Fox News viewership drops by half in 6 months,0,1,2,34,0,8,1,36,0
"Actually, Bernie Should Have Shushed Hillary More Often During the Debate",0,2,10,52,1,10,0,62,0
Chinese city using drones to nab cheaters on all-important exam,0,3,1,52,1,9,0,53,0
Class action launched by Australian bushfire survivors against SP AusNet,0,1,6,57,0,9,0,63,0
Christen Press Went Abroad and Found a Place on the U.S. Team ,0,2,9,39,2,12,0,48,0
Watching My Surgeon Cut Into My Knee - The New York Times,0,2,11,34,1,11,0,45,0
Jackson family seeking second autopsy,0,1,1,32,0,4,0,33,0
S.E.C. Seeks Ruling in Reserve Primary Fund Case,0,1,9,29,3,7,0,38,0
"Run-DMC Sues Wal-Mart, Amazon for $50M",0,3,9,18,4,5,2,27,0
Dave Grohl Broke His Leg During A Show And Continued Playing Like A Total Badass,0,3,15,51,0,14,0,66,0
Cambodian woman found after 19 years of jungle life,0,1,1,40,0,8,2,41,0
South Dakota State scores touchdown on fantastic trick play where they hide the runner with the ball,0,3,3,81,0,16,0,84,0
Stephen Colbert Tops Jimmy Fallon In Ratings Again With Sharp Political Commentary,0,3,12,59,0,11,0,71,0
"Sydney high school students ‘show up’ Martin Shkreli, recreating price-hiked pill for $2",0,3,3,67,5,12,1,70,0
Roger Federer wins Australian Open,0,1,4,26,0,4,0,30,0
"EU Will Need London Financial Services, Merkel Lawmaker Says",0,3,10,41,1,8,0,51,0
Joy Villa: 'I Lost Friends' After Wearing Pro-Trump Gown to Grammys  Insider,0,3,12,48,4,12,0,60,0
Canadian MP crosses from Conservative to Liberal party,0,1,5,42,0,7,0,47,0
Ariane 5 rocket launches Superbird 7 and AMC-21 satellites,0,1,5,40,1,8,4,45,0
Economists Fear Trump’s Tax Plan Only Heightens a ‘Mountain of Debt’ ,0,2,9,46,3,11,0,55,0
World's longest non-stop commercial flight lands in New Zealand,0,3,3,50,2,8,0,53,0
Big Island residents prepare for arrival of Flossie,0,1,3,41,0,7,0,44,0
Some San Bernardino massacre victims struggling to recover 1 year later ,0,3,3,57,0,11,1,60,0
Six killed in UK car crash,0,1,3,18,0,5,0,21,0
Manitoba residents receive evacuation flood alerts,0,1,1,44,0,5,0,45,0
F.B.I. Arrests Volkswagen Executive on Conspiracy Charge in Emissions Scandal ,0,2,10,55,3,10,0,65,0
House race in heavily GOP Kansas surprisingly competitive,0,3,5,45,0,7,0,50,0
Uber says there will be 'no surprises' with fares on New Year's Eve,0,2,4,48,3,12,0,52,0
Rangers need to trust youth and find some Type-A personalities,0,2,3,49,1,9,0,52,0
There was a big difference in the way Trump signed his new travel ban,0,2,2,54,0,13,0,56,0
A Man Dressed as Spider-Man Is on a Robbery Spree in NYC,0,3,11,33,1,11,0,44,0
Former Celtics Center Fab Melo Has Reportedly Died,0,3,8,35,0,7,0,43,0
Teen inspires first transgender doll,0,2,1,31,0,4,0,32,0
Snub-way: DC drops Trump from inauguration Metro cards ,0,2,5,40,2,8,0,45,0
Dozens dead after bus accident in Philippines,0,1,2,37,0,6,0,39,0
No Freebies? No Problem! 85 Per Cent Of Jio Users Will Retain Service Even After Offers End!,0,3,16,55,3,16,2,71,0
Before the Wall: Life Along the U.S.-Mexico Border ,0,2,8,31,4,8,0,39,0
Envoy Arrives in Sri Lanka for Cease-Fire Talks,0,1,7,32,1,7,0,39,0
Theresa May is attacking the idea of a Labour-Lib Dem progressive alliance against her – she needn't worry,0,3,5,81,3,17,0,86,0
"Emirates airline had to change pilots, crew, and passenger roster after Trump's order",0,2,2,68,3,12,0,70,0
Women’s March Highlights: Viewer Questions ,0,2,5,31,2,5,0,36,0
"Biden Talks Trump, Faith And Fate In Front Of A Live ’Fresh Air’ Audience",0,2,14,43,3,13,0,57,0
Taco Bell pulls green onions from all U.S. and Canadian stores,0,1,5,45,2,10,0,50,0
Dana Boente: Who Is the New Acting Attorney General? ,0,2,8,34,2,9,0,42,0
DNC chair candidates explain why they're the right pick,0,3,3,43,1,8,0,46,0
"Manus Island asylum seekers bashed on New Year's Eve, refugee advocates say",0,3,5,57,2,11,0,62,0
Tensions Stoked Between Iraqi Kurds and Sunnis,0,1,6,34,0,6,0,40,0
Publishers who never wanted to publish Milo Yiannopoulos’ 'Dangerous' book are having a field day right now,0,3,4,84,3,16,0,88,0
"Beaver walks into Md. store, finds only artificial Christmas trees, and proceeds to trash it",0,3,3,72,3,14,0,75,0
"Debbie Reynolds, a gutsy Hollywood aristocrat with a never-say-die spirit",0,3,3,58,3,9,0,61,0
Hasegawa retains Bantamweight title,0,1,2,30,0,3,0,32,0
Woman Claims Popeyes Served Her Flesh-Eating Worms in $1 Million Lawsuit,0,3,10,49,2,10,1,59,0
Tom Brady Impersonated The Rock To Let Him Know That He Sent Him Pajamas,0,3,14,45,0,13,0,59,0
Leaked poll finds 45% of Iraqis support suicide bombers who attack allied forces,0,1,2,63,1,12,2,65,0
"Richard Simmons is 'perfectly fine' and 'there is nothing wrong with him,' says LAPD detective ",0,3,6,69,5,15,0,75,0
Minor league baseball players fight for right to OT pay,0,2,3,43,0,9,0,46,0
Uzbekistan is about to get its first new president in more than a quarter-century,0,3,1,66,1,13,0,67,0
Tillerson meets with Putin amid US-Russia disagreements on Syria ,0,3,6,49,1,9,0,55,0
Trump Says Michelle Obama's 'No Hope' Comment About the Past ,0,3,9,39,3,10,0,48,0
Oscar Pistorius Will Likely Leave Prison on August 21: Officials,0,3,8,44,1,9,2,52,0
Stella McCartney apologises for failing to give details to cab driver after hitting his car,0,3,3,74,0,14,0,77,0
"In Marshall, Va., Support for Donald Trump Hasn’t Wavered ",0,2,8,37,4,9,0,45,0
Ten things to know about Africa Cup of Nations hosts Gabon,0,2,5,43,0,10,0,48,0
Baptist Figure Faces Backlash Over His Criticism of Donald Trump,0,2,9,46,0,9,0,55,0
"California Today: In Persian Square, Anxious Over the Travel Ban ",0,2,9,44,2,10,0,53,0
"Eurovision '82 winner Nicole talks about 'Ein bißchen Frieden', her success and the Contest today",0,1,5,72,4,14,2,77,0
New entrance discovered to world's longest cave,0,1,1,39,1,6,0,40,0
'This is an awakening': Native Americans find new hope after Standing Rock,0,3,5,55,3,11,0,60,0
QB Derek Carr carted off in air cast after suffering broken right fibula,0,3,4,56,0,12,0,60,0
Google’s legal war with Oracle could undermine a core pillar of the software industry,0,2,2,69,1,13,0,71,0
Yoenis Cespedes Hits 3 Home Runs vs. Philadelphia Phillies,0,3,7,41,1,8,1,48,0
Week in pictures: 10-16 December 2016,0,3,2,20,2,5,8,22,0
ICE CEO Says Trump to Bring ‘Fundamental Change’ to Regulation ,0,3,12,39,2,10,0,51,0
Ray Lewis Is a Special Guest at Pre-Inauguration Party for Donald Trump Hosted by Jim Brown,0,3,13,62,1,15,0,75,0
Lakers place Magic Johnson in charge of basketball operations in major shake-up,0,2,3,64,1,11,0,67,0
Trump Administration Launches National-Security Probe on Steel Imports,0,2,8,54,1,7,0,62,0
"Chilly chickens wear sweaters, egg production skyrockets",0,3,1,48,1,6,0,49,0
VMwareVoice: The Impact Of 5G On Major Events Around The World,0,3,13,37,1,10,1,50,0
Hear Metallica's Lars Ulrich Read 'The Dinosaur That Pooped Christmas',0,3,10,48,3,9,0,58,0
Celebs to Host Progressive ‘Love-a-Thon’ During Trump Inauguration,0,3,8,47,4,7,0,55,0
FedEx just launched a new service that takes on Amazon's super popular fulfillment program,0,3,3,73,1,13,0,76,0
"For the Honda Brand, a Cinematic Stroke",0,1,5,27,1,6,0,32,0
Pope opens free laundromat for Rome's poor,0,2,2,33,1,6,0,35,0
FBI Director Comey Is Wrong: The Case for Prosecuting Hillary Clinton Is Strong,0,2,14,52,1,12,0,66,0
Photo of Ivanka Trump sitting in president's chair raises eyebrows,0,3,3,53,1,9,0,56,0
Breitbart News’ John Carney vs CNN’s Brian Stelter: Should Americans Panic over Donald Trump?,0,3,14,62,4,13,0,76,0
Watters: Media's Anti-Trump Bias 'Exposed' After Latest Paris Attack  Insider,0,3,11,51,5,10,0,62,0
Fußball-Bundesliga 2007–08: Matchday 1 roundup,0,1,3,29,3,4,7,32,0
Tomb discovered in Valley of the Kings,0,1,3,29,0,6,0,32,0
"In Lawsuit, a Dispute Over Whether Roberto Alomar Has H.I.V.",0,1,11,36,4,9,0,47,0
"Matt Miller's Scouting Notebook: Jamal Adams Rising, Updated 2-Round Mock Draft",0,3,11,53,4,10,1,64,0
"Denied under Nazis, 102-year-old Jewish woman finally gets doctorate  ",0,2,3,51,3,10,3,54,0
Dallas police end search for suspicious person,0,2,1,39,0,6,0,40,0
US and Mexico to revise counter-drug strategy,0,1,3,35,1,6,0,38,0
"Second Darwin's sandwich shop opens in Cambridge, Massachusetts, USA",0,1,7,50,3,8,0,57,0
Sight of plane circling Manhattan causes stir on social media,0,2,2,50,0,9,0,52,0
Teenager on Westminster Bridge during London terror attack describes moment he was hit,0,3,4,70,0,12,0,74,0
Man who attempted to grab gun at rally wanted ’to kill Trump’,0,2,2,46,2,11,0,48,0
Arrest of young black suspects in brutal Chicago attack sparks hate crime debate [Video],0,2,3,70,2,13,0,73,0
Bernard Shaw Fast Facts,0,2,4,16,0,3,0,20,0
"Following Earnings Miss, Costco Plans To Hike Membership Fees",0,3,9,43,1,8,0,52,0
North Korea Revs the Engine of Its New High-Thrust Missile ,0,3,9,39,1,10,0,48,0
BMX Rider Shreds Through Silverdome in Tribute to Abandoned Stadium,0,3,10,48,0,9,0,58,0
Orange-Tinted Alligator Dubbed 'Trumpagator',0,3,5,33,3,3,0,38,0
The new £1 coin is here and still causing problems,0,2,1,38,1,9,1,39,0
U.K. Joins U.S. Ban on Laptops in Cabins on Some Mideast Flights,0,3,11,38,4,11,0,49,0
Some Chicagoans Lament Willis Name on Sears Tower,0,1,7,35,0,7,0,42,0
Native American Art Gets Its Rightful Place In The Metropolitan Museum Of Art,0,3,13,52,0,12,0,65,0
U.N. Warns of Refugee Crisis in Gaza Strip,0,1,7,26,2,7,0,33,0
"Two Buffalo, New York police officers shot while on duty",0,1,4,42,1,9,0,46,0
Nadal Criticizes the Prying of the Testing Program,0,1,5,38,0,7,0,43,0
US Senate passes housing aid bill,0,1,3,25,0,5,0,28,0
"Muslim NYPD officer threatened, told 'go back to your country'",0,3,5,45,3,9,0,50,0
Emir of Qatar abdicates throne,0,1,2,24,0,4,0,26,0
ESPN's NFL MVP Poll: Brady unseats Carr as No. 1,0,3,14,21,3,9,1,35,0
Warren Buffet could be about to buy an entire airline,0,3,2,42,0,9,0,44,0
Turkey claims followers of US-exiled cleric killed Russian ambassador,0,3,4,56,1,8,0,60,0
"Someone lost a pair of Snuggie-clad goats, but it's OK because they were found",0,2,4,58,3,13,0,62,0
"An Israeli Playground Opens, Hardened Against Rockets",0,1,7,39,1,6,0,46,0
Prices of Crops Continue to Fall,0,1,4,23,0,5,0,27,0
Queen Elizabeth Releases Christmas Remarks,0,2,5,33,0,4,0,38,0
Sanders still hopeful despite South Carolina loss,0,2,3,40,0,6,0,43,0
American actress Brittany Murphy dies at age 32,0,1,3,35,0,7,2,38,0
Rogue One falls well short of Force Awakens opening in China,0,3,5,45,0,10,0,50,0
"Dave Grohl breaks leg during Foo Fighters concert, gets a cast, returns to finish onstage",0,2,4,69,2,14,0,73,0
'Butcher of Kabul' shows his face after 20 years in exile ,0,2,2,41,2,11,2,43,0
"Fanime convention winds down in San Jose, California",0,1,4,40,1,7,0,44,0
"The 100-year-old couple – still married, still going strong",0,2,1,43,4,8,3,44,0
New 'clean water' funding for Djibouti's drought-stricken rural areas,0,1,2,55,4,8,0,57,0
Trump Met with CEOs of America’s Largest Companies to Push Pro-Jobs Agenda,0,3,12,49,2,11,0,61,0
Family of Aaron Hernandez victim issues ‘friendly challenge’ to Patriots: Pay up,0,2,5,61,3,11,0,66,0
WATCH - NY Assemblyman to Linda Sarsour: Explain Your ’Support for Terrorism’,0,2,14,48,4,11,0,62,0
"'Unofficial strikes' contributing to Southern Rail chaos, HR boss claims as passengers warned of major delays ",0,3,5,86,3,16,0,91,0
Rebuilding Begins Upon a Wobbly Truce,0,1,5,27,0,5,0,32,0
This Cleveland weatherman is not happy about the no-calls on LeBron James,0,3,5,56,1,11,0,61,0
Epic Navy bribery scandal shows how easy it can be to steal military secrets,0,2,2,61,0,13,0,63,0
"Grammys: Adele pays tribute to Beyonce, Flume the only Aussie winner",0,2,5,51,2,10,0,56,0
Cancer trial patient dies after hospital computer system error,0,1,1,53,0,8,0,54,0
The Breakdown in Biomedical Research,0,3,4,28,0,4,0,32,0
Horrifying moment a glass door shatters on a young boy as he enters a store in China,0,3,2,66,0,16,0,68,0
North Carolina okays opt-out for officials who oppose same-sex marriage,0,2,2,58,2,9,0,60,0
Red Bulls Stop Slide With Tie Against Sounders,0,1,8,31,0,7,0,39,0
Yemen SEAL Raid Has Yielded No Significant Intelligence: Officials,0,2,12,45,1,8,0,57,0
Celtics Rebuff a Challenger to Their Throne,0,1,5,32,0,6,0,37,0
News Corp. acquires Dow Jones & Co.,0,1,5,21,3,6,0,26,0
Donald Trump's photo op presidency,0,2,2,27,1,4,0,29,0
The refugee ban: Why does it matter?,0,3,2,26,2,6,0,28,0
Duterte vows to execute ‘five or six’ people a day when the death penalty is reintroduced to the Philippines ,0,3,2,86,2,19,0,88,0
"Armed With Little but Resolve, and Defending a Hollowed Village",0,1,7,46,1,9,0,53,0
Many Japanese Look for a Shift to Female Heirs to the Throne ,0,3,7,42,0,12,0,49,0
Anonymous people reveal animal cruelty at Australian Inghams poultry producer factory using CCTV footage,0,1,7,84,0,13,0,91,0
Trump’s People Told A Bakery To Completely Re-Create Obama’s Inauguration Cake,0,2,12,53,3,10,0,65,0
Morning brief: GOP retains vacated seat in Kansas special House election ,0,3,6,55,1,11,0,61,0
"Tamil Nadu Elections: DMK, AIADMK promise freebies",0,1,12,30,2,6,0,42,0
John Glenn wrote Jeff Bezos a beautiful letter that he read for the first time the day the astronaut died,0,3,4,82,0,19,0,86,0
What Should You Do When Customers Make Racist Remarks? ,0,3,9,36,1,9,0,45,0
Blackwater mercenaries used in New Orleans,0,1,3,34,0,5,0,37,0
'The Silence of the Lambs' oddly works as a romantic comedy,0,3,3,44,2,10,0,47,0
"U.S. Stocks Pare Yearly Gain as Dollar, Oil Slip: Markets Wrap",0,3,11,37,4,10,0,48,0
"As Amazon's 'Alexa' Shines At CES, Jeff Bezos Gets $1.3 Billion Richer In A Day",0,3,16,41,6,14,2,57,0
Twitter briefly suspends David Duke,0,3,3,28,0,4,0,31,0
Police detain Tsvangirai in Zimbabwe,0,1,3,29,0,4,0,32,0
Goodes Earns First Pro Title With Champions Win,0,1,8,32,0,7,0,40,0
How the Trolls Stole Washington ,0,3,4,23,0,5,0,27,0
Mia Tindall brings pet dog to support her mother Zara at horse trials ,0,3,3,54,0,13,0,57,0
"California snowpack measures low, but big storms coming ",0,3,1,46,1,8,0,47,0
The World's Most Powerful People 2016,0,3,5,22,1,5,4,27,0
Whalers upset Spirit in opening game for Ontario Hockey League,0,1,5,48,0,9,0,53,0
"Before the Tea Party, Thank Your Lucky Stars",0,1,7,29,1,7,0,36,0
George Michael: 'I'm surprised I've survived my own dysfunction',0,2,4,47,5,8,0,51,0
'Hamilton' Cast Members to Perform at Super Bowl Pregame Show,0,3,8,42,2,9,0,50,0
Russian novelist Aleksandr Solzhenitsyn dies aged 89,0,1,3,41,0,6,2,44,0
Exclusive: Female Viagra contender Palatin Technologies explores potential sale - source,0,2,5,71,2,10,0,76,0
"President Trump Declared His Inauguration A ""National Day Of Patriotic Devotion""",0,2,11,57,2,10,0,68,0
Church bombings kill dozens in Egypt on Palm Sunday,0,3,4,39,0,8,0,43,0
Third-party candidates excluded from presidential debates: a snub too many,0,2,1,62,2,9,0,63,0
"Engulfed in Battle, Mosul Civilians Run for Their Lives - The New York Times",0,2,11,50,2,13,0,61,0
Hotel fire in China kills at least 10 people,0,3,2,32,0,8,2,34,0
"Antonio Brown Facebook Live Video Being Investigated by NFL, Says Roger Goodell",0,3,13,54,1,11,0,67,0
"Tony Romo Literally Just Retired, and There Are Already More Comeback Rumors Than We Can Count",0,3,15,63,1,15,0,78,0
"Making Financial Goals Reality, With The Help Of Trusted Partners",0,3,10,45,1,9,0,55,0
Investors Watch for Dollar-Yen Clues,0,3,5,26,1,4,0,31,0
"Initial jobless claims hold below 300,000 for a 93rd straight week",0,2,1,46,1,10,8,47,0
Jewish Human Rights Group Calls For Special Probe Into Anti-Semitic Bomb Threats,0,3,13,55,1,11,0,68,0
Signs of Possible Deal in Pakistan Turmoil,0,1,5,31,0,6,0,36,0
NFL1000: Is Colin Kaepernick Still Starting Quarterback Material in the NFL?,0,3,13,47,2,10,4,60,0
Cindy Sheehan arrested inside Rayburn Building in Washington DC,0,1,7,48,0,8,0,55,0
New York on verge of tuition-free college for middle class,0,3,2,46,1,9,0,48,0
President Trump to sign executive order targeting foreign work visas ,0,3,2,57,0,10,0,59,0
Missing cat from California ends up in Canada years later ,0,3,3,45,0,10,0,48,0
Homeland Sec. Kelly: N. Korea Cyber Attack Could Threaten U.S.,0,2,11,37,5,9,0,48,0
Turkey charges seven military officers over coup plot,0,1,1,45,0,7,0,46,0
Norwegian museum claims Adolf Hitler drew Disney cartoons on painting,0,1,4,56,0,9,0,60,0
"China flies nuclear-capable bomber in South China Sea after Trump Taiwan call, US officials say ",0,3,8,71,2,15,0,79,0
"Two Sides of a Border: One Violent, One Peaceful",0,1,7,31,2,8,0,38,0
Here’s where Republicans stand on the nuclear option,0,2,2,42,1,7,0,44,0
EE balloons and drones to help fix mobile blackspots,0,2,2,42,0,8,0,44,0
Thousands bused out in mass evacuation of 4 besieged Syrian towns ,0,3,2,52,0,11,1,54,0
"EU bans all Indonesian airlines as well as several from Russia, Ukraine and Angola",0,1,6,62,1,13,0,68,0
Video shows officers kill Boston terror suspect,0,3,2,39,0,6,0,41,0
Army Ends Delay on Lightweight Armor,0,1,5,26,0,5,0,31,0
Russian plane crash: Experts begin examining flight recorder,0,2,2,50,1,7,0,52,0
South Korea: President Park Geun-hye leaves Blue House following corruption scandal,0,3,7,64,2,10,0,71,0
US woman sentenced to jail for faking son’s cancer,0,1,2,39,1,8,0,41,0
Iran unveils part of its nuclear program,0,1,1,33,0,6,0,34,0
Alan Thicke’s Dr. Seaver Didn’t Know Best. That Was His Charm. ,0,3,11,36,5,11,0,47,0
"Drugmakers promote profitable, but unproven, opioid solution",0,3,1,51,2,6,0,52,0
"John Glenn, first American to orbit the Earth, dies at 95",0,2,4,39,2,10,2,43,0
U.S.: Only half of Baiji in Iraqi hands,0,2,5,24,3,7,0,29,0
"Al Qaeda leaders say group near collapse amid rise of ISIS, report claims ",0,3,6,54,1,13,0,60,0
What It Was Like to Cover the Menendez Murder Trial: Reporter's Notebook ,0,3,10,49,2,12,0,59,0
"Sanders, Clinton (and guest) speak at same Las Vegas church",0,2,4,43,3,9,0,47,0
Man Charged With Cyberstalking After Sending Tweet to Epileptic Reporter,0,3,9,54,0,9,0,63,0
These Charts Show the Change in Scope of Trump’s Immigration Order,0,2,8,47,1,10,0,55,0
The Fittest Couple In The World Proves That Couples Who Sweat Together Stay Together,0,3,14,57,0,13,0,71,0
Islamophobia in China on the rise fuelled by online hate speech,0,3,2,51,0,10,0,53,0
Finder of Oldest Baseball Card Scores One for Mothers,0,1,7,38,0,8,0,45,0
Migration Watch report criticised for 'risking British livelihoods',0,3,3,55,2,7,0,58,0
Judge blocks Texas from defunding Planned Parenthood,0,3,4,42,0,6,0,46,0
Senior Labour female MPs will boycott if Donald Trump addresses Houses of Parliament,0,2,8,64,0,12,0,72,0
NFL Draft 400: Ranking the Draft's Top Edge-Rushers,0,3,9,29,3,7,3,38,0
Google Combats Holocaust-Denying Search Results With Algorithm Update,0,3,9,52,1,7,0,61,0
"When the Generals Lose to the Globetrotters, Everyone Wins",0,1,6,43,1,8,0,49,0
"Officials: Seventeen insurgents killed in Orakzai, Pakistan",0,1,4,47,2,6,0,51,0
Insurers paid out $50bn for natural disaster claims in 2016,0,3,1,42,1,9,6,43,0
Milo Ventimiglia Recreates Memorable ‘This Is Us’ Push-Ups Scene on ‘Ellen’ [Video],0,2,12,53,7,11,0,65,0
"Brexit: No talks with the UK before clear withdrawal terms, says France",0,3,5,53,2,11,0,58,0
65th human bird flu case reported In Egypt,0,1,2,31,0,7,2,33,0
"Eight dead and two missing after cargo ship fire in Kaliningrad, Russia",0,1,3,56,1,11,0,59,0
The Fully Self-Driving Car Is Still Years Away - The New York Times,0,2,13,40,2,12,0,53,0
Fiji's President abrogates constitution,0,1,2,33,1,3,0,35,0
Sindarius Thornwell Destroyed Duke — and Shook Up March Madness,0,3,8,45,1,9,0,53,0
Consumer Confidence Rose Sharply in May,0,1,5,29,0,5,0,34,0
"Universities speak out against Trump travel ban, commit to defending international students [Video]",0,3,3,81,3,12,0,84,0
Trump's America Electronics to be banned in carry-on luggage on certain flights into the United States,0,3,5,80,2,15,0,85,0
"After a Memorable Shot, a Final One for Two Maryland Seniors",0,1,8,41,1,10,0,49,0
World's first custom-built floating city to rise off French Polynesian waters,0,3,3,62,2,10,0,65,0
"Turkey referendum: President Recep Erdogan celebrates victory, opponents pledge to contest",0,3,4,74,2,10,0,78,0
Steve Ballmer wants you to know how the government really spends its money,0,2,2,60,0,12,0,62,0
Report: Chuck Berry Died of Natural Causes,0,3,6,29,1,6,0,35,0
California Governor: Driver's License Penalty Harms the Poor ,0,3,7,44,2,8,0,51,0
The Forgotten Part of Basketball That’s Changing the NBA Playoffs,0,2,10,45,1,9,0,55,0
"After Padmavati, Badrinath Ki Dulhania Faces Trouble Over Its Title By A Hindu Group!",0,3,14,56,2,13,0,70,0
Chelsea Clinton joins Expedia board of directors ,0,3,3,39,0,7,0,42,0
EU Leaders Pledge Unity as Trump Wavers on Bloc,0,3,8,31,0,8,0,39,0
Crowdsourced coral: Scientists get creative in order to find reef 'hope spots',0,3,2,62,3,11,0,64,0
"Ex-Google self-driving engineer secretly collaborated with competitors, suit says",0,3,2,68,3,8,0,70,0
"New Zealand vows to kill every weasel, rat and feral cat on its soil",0,2,2,52,1,13,0,54,0
"In St. Louis, Glorious Stadium Honors Glorious Past",0,1,8,34,2,7,0,42,0
Man arrested by FBI after threatening 'Dylann Roof-style attack' ,0,3,6,47,3,9,0,53,0
"NASA's Probe Cassini Flirts With Saturn's Rings, Flies Across Them For The First Time",0,3,17,52,3,13,0,69,0
Three of Serbia's neighbours recognize Kosovo,0,1,3,36,1,5,0,39,0
Watch Live: Interest Rate Announcement,0,3,5,28,1,4,0,33,0
Nigel Farage’s top aide sentenced for wire fraud,0,3,2,38,1,7,0,40,0
Malia Obama is going to intern with hotshot Hollywood producer Harvey Weinstein,0,3,5,63,0,11,0,68,0
Only 1 Republican In New Jersey Is Holding Town Halls. Constituents Aren't Wasting The Opportunity.,0,3,14,67,3,14,1,81,0
UN Secretary General releases new statement as UN aid starts to reach Myanmar,0,1,7,58,0,12,0,65,0
Super Mario's creator explains how 'Super Mario Run' will reach a new generation,0,2,5,60,3,12,0,65,0
Scouting Reports for Riley Curry and the All-NBA Kid Team,0,2,10,37,1,9,0,47,0
NFL NFL Survey: Which Young QB Is the Top Pick to Start a Franchise with Today?,0,3,17,45,2,15,0,62,0
Trump weighs in on Jeff Sessions,0,2,3,24,0,5,0,27,0
"Patrick Leonard, condemned Ohio man, kills himself on death row",0,2,3,49,2,9,0,52,0
About Those Trump Conflict-of-Interest Worries...,0,3,6,34,5,4,0,40,0
These states’ prisons are so full that they have to ship inmates thousands of miles away,0,3,1,71,1,15,0,72,0
Portrait of German Gunman Emerges,0,1,4,25,0,4,0,29,0
Baseball’s Matt Kemp Lists His California ‘Dream House’  ,0,3,8,37,3,9,0,45,0
FDR issued an executive order sending Japanese Americans to internment camps — 75 years ago,0,3,5,69,1,14,2,74,0
HHS Secretary says passing health care bill through House and Senate 'a fine needle' to be thread ,0,2,6,73,2,17,0,79,0
"Video Shows Cop Slam, Beat Black Pedestrian After Alleged Jaywalking",0,3,10,48,1,9,0,58,0
"Monks had their flesh RIPPED off before burial: 1,000-year-old monastery in Sudan reveals the grisly ritual",0,3,8,76,4,15,4,84,0
"In ultimate insult, Trump rolls back EPA's climate policies from within the EPA",0,3,8,57,2,12,0,65,0
Lahore protest blast: 10 killed at Pakistan city rally,0,3,2,41,1,8,2,43,0
Australian rules football: 2010 Gippsland Football League round 11 - Wonthaggi v Traralgon,0,1,6,64,2,12,6,70,0
Donald Trump to Play Golf with Tiger Woods - Breitbart,0,2,7,37,1,9,0,44,0
Gynaecologist Rob Jones: Hundreds of women in legal claim,0,2,4,44,1,8,0,48,0
The ultimate luxury? Why 2016 was the year of the colored diamond,0,3,2,47,1,11,4,49,0
"Report: Putin, Russia Tried to Help Trump By ‘Discrediting’ Clinton",0,2,9,45,4,9,0,54,0
U.K. MPs' expenses to be investigated by police,0,1,4,33,3,7,0,37,0
"Security Guards at Church Services As ‘New Clientele’ Defecate, Masturbate in Pews",0,2,10,58,3,11,0,68,0
Trump Seen Paying Off for Putin With Sanctions Relief Coming,0,3,9,42,0,9,0,51,0
Five injured after gun fires accidentally during wedding at Waldorf Astoria,0,2,3,62,0,10,0,65,0
"Now, Netflix Users Can Watch Movies Offline on Their Mobile Devices ",0,2,10,46,1,11,0,56,0
Pat Summitt Makes Tennessee a Cradle of Coaches,0,1,6,34,0,7,0,40,0
Archbishop and Tory MPs criticise closure of child refugee scheme,0,3,4,52,0,9,0,56,0
AARP isn’t expanding staff — they’re just ‘reorganizing’,0,2,4,40,5,7,0,44,0
The UK has voted for this guy to be its national bird,0,2,3,39,0,11,0,42,0
Man Who Fired Shots in DC Pizzeria to Face Federal Charges ,0,3,10,38,0,11,0,48,0
Denmark blames al-Qaeda for embassy bombing,0,1,2,35,1,5,0,37,0
Police Investigating Photos Of Officers “Laughing After A Muslim Mother’s Hijab Was Ripped Off”,0,3,14,65,3,13,0,79,0
Eleanor Hawkins' father relieved after Malaysian court frees tourist,0,2,3,56,1,8,0,59,0
Julian Assange: US set to 'seek arrest of Wikileaks founder',0,3,5,43,3,9,0,48,0
Knicks' Derrick Rose for Ricky Rubio Trade Reportedly Rejected by Timberwolves,0,2,9,58,1,10,0,67,0
"‘My Life as a Zucchini’ Review: Magical, Youthful Resilience ",0,3,7,41,4,9,0,48,0
Government backs driverless car trials in London,0,2,2,40,0,6,0,42,0
"Fire kills six in Baltimore, United States",0,1,4,31,1,6,0,35,0
"Big Sean Shares New Song ""Halfway Off The Balcony""",0,2,9,31,2,8,0,40,0
Heat gets worse in Canada,0,1,2,19,0,4,0,21,0
Selgros Cash and Carry to open two new stores in Transylvania,0,1,4,47,0,10,0,51,0
Full 911 Transcript Released After Lawmakers Criticize Redactions,0,2,7,48,0,7,3,55,0
Steve Bannon: I Warned Ailes About Megyn Kelly — ’She’s the Devil’ - Breitbart,0,2,11,48,6,13,0,59,0
Singapore Eases on Property After Home Price Drop: QuickTake Q&A,0,3,11,42,2,9,0,53,0
Kucinich to run for U.S. president,0,1,3,24,2,5,0,27,0
Watch Lyric Video for Linkin Park's 'Battle Symphony',0,2,7,36,3,7,0,43,0
19 Burmese political prisoners released; more to come,0,1,1,42,1,7,2,43,0
"The Playlist: Mariah Carey Shakes It Off, and Depeche Mode Looks for Revolution ",0,3,11,54,2,13,0,65,0
Polls: Donald Trump Holds Edge in Indiana - Breitbart,0,2,7,36,2,8,0,43,0
Thousands of Indonesians protest against corruption,0,1,2,44,0,5,0,46,0
"Melania Trump will move into the White House this summer, says senior aide",0,2,4,57,1,12,0,61,0
Warren Buffett praises ‘talented and ambitious immigrants’ in shareholder letter,0,3,2,67,2,9,0,69,0
"Kerry Rebukes Israel, Calling Settlements a Threat to Peace ",0,3,7,43,1,9,0,50,0
"Facebook is really, seriously working on its fake news problem, Sheryl Sandberg says",0,3,3,67,2,12,0,70,0
Luke Cage season 2: Marvel series gets renewed by Netflix,0,3,4,42,1,9,1,46,0
"Mexican man accused of rape had 19 deportations, removals ",0,3,1,45,1,9,2,46,0
"Barred from China and silenced in the US, this beauty queen isn’t backing down",0,2,4,59,2,13,0,63,0
"Myanmar: UN rights office says it gets daily reports of killings, rapes of Rohingya minority Muslims",0,3,5,78,2,15,0,83,0
Undocumented Man Whose Wife Voted For Trump Has Been Deported,0,3,10,42,0,9,0,52,0
"Tropical Storm Irene to intensify, may hit U.S. coast",0,1,5,37,3,8,0,42,0
Coming to America: One translator's harrowing journey,0,3,3,42,2,6,0,45,0
Trump’s go-to man Bannon takes hardline view on immigration,0,2,2,47,2,8,0,49,0
"Dr. Luke Out As Kemosabe CEO, But Remains At Sony Music",0,3,13,30,2,10,0,43,0
Stock Investors Ask:  Is It a Bear or a Bull?,0,1,7,26,2,10,0,33,0
Think different: can advertising defeat ‘alt-right’ propaganda?,0,3,1,51,5,6,0,52,0
The Socialist Left Party’s election initiative starts in Norway,0,1,5,49,1,8,0,54,0
Record number of electoral college voters defect as Donald Trump is officially confirmed as 45th president,0,2,3,86,0,15,2,89,0
"Australian anti-drug police seize 1,100kg of cocaine worth £212m in country's 'biggest ever' bust",0,3,1,70,6,13,7,71,0
Loose bulls charging through Arizona neighborhood caught on video ,0,3,2,55,0,9,0,57,0
Earth Day 2009 celebrated around the globe,0,1,2,30,0,6,4,32,0
Meet Alden Ehrenreich â the 27-year-old actor who will play Han Solo in the next 'Star Wars' spin-off,0,3,7,70,7,17,2,77,0
Penthouse Offers $1 Million For Compromising Trump Tapes,0,3,7,40,1,7,1,47,0
Elle King Covered the 'Golden Girls' Theme Song & All of Her Fangirl Dreams Came True,0,3,13,54,3,15,0,67,0
"Government Reassures IT Industry On H-1B Visa Curbs, Says No Reason To Worry As Of Now",0,2,18,50,2,15,1,68,0
Palestinian protester killed by Israeli soldiers,0,1,2,41,0,5,0,43,0
Meddling or Good Business?,0,1,3,19,1,3,0,22,0
"Mitt Romney Used A PowerPoint Presentation To Criticize Barack Obama, Because Of Course He Did",0,2,16,63,1,14,0,79,0
Scientists shocked at Great Barrier Reef bleaching,0,1,4,40,0,6,0,44,0
The Guardian view on the RBS sell-off: a bad deal all round,0,3,5,41,2,11,0,46,0
White House Changes the Terms of a Campaign Pledge About Posting Bills Online,0,1,10,55,0,12,0,65,0
"Yanks Laud Attendance, but Some Seats Sit Empty",0,1,7,32,1,7,0,39,0
Ants Adjust Foraging So the Colony Eats Right,0,1,7,31,0,7,0,38,0
U.S. government hiring more hackers,0,1,2,27,2,4,0,29,0
'Sad Taylor Swift' Is The Meme Gift That Keeps On Giving,0,3,11,33,2,10,0,44,0
French police detain six-year-old girl for three days over passport mistake,0,2,1,62,2,10,0,63,0
"Rolf Harris was as 'degrading as it gets' with blind, disabled victim, court told",0,3,2,62,4,13,0,64,0
"No Nighttime, No Rules: Summertime Above the Arctic Circle ",0,3,8,40,2,9,0,48,0
Number of breaches during New Zealand's end of year exams,0,1,3,44,1,9,0,47,0
Atlanta Black History Month: Rare video of Martin Luther King Jr.  | WSB-TV,0,3,14,44,4,13,0,58,0
House Passes Stimulus Plan With No G.O.P. Votes,0,1,10,27,3,7,0,37,0
Nebraska teacher sentenced to 6 years for sex with student,0,1,1,47,0,9,1,48,0
Polish leaders discuss the anti-missile shield negotiations,0,1,1,51,1,6,0,52,0
"Napping in Public? In Japan, That’s a Sign of Diligence ",0,3,7,36,3,10,0,43,0
Jennifer Lawrence Prays For 'Compassion To Return To The White House' Amid Trump's Immigration Ban,0,3,15,66,3,14,0,81,0
Puppy shot 18 times with BB gun makes incredible recovery,0,2,3,43,0,9,2,46,0
"Facebook, Google to help fight fake news ahead of French elections",0,3,3,52,1,10,0,55,0
U.S. Is Poised to Put Heavy Weaponry in Eastern Europe ,0,2,9,34,2,10,0,43,0
Even in the tough times Fidel Castro’s Cuba placed great value on sport,0,2,4,54,1,12,0,58,0
Trump: Protesters and supporters on their messages to each other,0,2,2,52,1,9,0,54,0
MPs vote to give May power to trigger article 50 – as it happened,0,3,3,46,1,13,2,49,0
Pharrell Williams' early life to be made into movie musical,0,2,2,47,1,9,0,49,0
'Mastermind' of Bangladesh cafe siege shot dead by police in pre-dawn raid,0,3,2,58,3,11,0,60,0
Trump Administration Seeks Delay in Lawsuit Over Health-Law Subsidies   ,0,3,9,51,1,11,0,60,0
Americans’ Net Worth Reaches High of $84.9 Trillion,0,3,6,32,3,7,3,38,0
Obama: Would be ’personal insult’ to legacy if black voters don’t back Clinton,0,2,3,59,4,12,0,62,0
'We haven't told anyone the sex of our baby': Kim Kardashian keeps mum on rumours she's having a BOY ,0,3,6,71,5,19,0,77,0
Cassini space probe to flyby Saturn's moon Iapetus,0,1,3,39,1,7,0,42,0
"With Top Pick, Islanders Choose Goal Scorer in Tavares",0,1,8,37,1,8,0,45,0
‘Super lice’ outbreak hits 25 states,0,2,1,26,2,5,2,27,0
Sports World Celebrates National Puppy Day on Social Media,0,2,8,42,0,8,0,50,0
"The fad may be over, but PokÃ©mon Go still has 65 million monthly active players",0,2,4,58,2,14,2,62,0
Southampton City Council votes against water fluoridation,0,1,3,48,0,6,0,51,0
Jennifer Aniston Has Been Laughing at Jason Bateman for 22 Years: Inside Their Friendship,0,3,11,62,1,13,2,73,0
North Korea tests newly developed high-thrust rocket engine ,0,3,2,49,1,8,0,51,0
Dear. Mr. Thief: Cops leave epic note to shoplifter,0,3,4,36,3,8,0,40,0
'Hitler's personal telephone' gifted by Red Army to British officer goes up for auction,0,3,4,67,3,13,0,71,0
"Cop Killed, 30 People Injured in Blast Near Colombia Bullfighting Ring",0,2,9,48,1,10,2,57,0
Earthquake strikes southern California,0,1,2,33,0,3,0,35,0
Remaining Expedition 25 crew to launch to International Space Station,0,1,5,53,0,9,2,58,0
The terrifying 'It' trailer people are obsessed with just broke a viewing record,0,3,2,64,2,12,0,66,0
The Unmaking of Europe ,0,3,3,16,0,4,0,19,0
Ivanka Trump Said Her Dad Cared About Child Care. His Budget Says Otherwise.,0,3,13,49,2,12,0,62,0
"Whatever you do, don’t pee on the walls in Pamplona",0,2,2,38,2,9,0,40,0
United Airlines flight makes emergency landing at Newark Airport,0,1,4,52,0,8,0,56,0
LGBTQ activists held dance party protest outside Ivanka Trump's D.C. home ,0,2,9,51,3,11,0,60,0
Burglar has 70-year sentence increased after swearing at judge,0,2,1,50,1,8,2,51,0
Berlin Market Attack Mars Square Where Three Eras Coexist ,0,2,9,40,0,9,0,49,0
Child labour is keeping North Korea's elite ski resort open The list,0,3,4,52,1,11,0,56,0
Tom Brady Spent April Fools' Trolling a 'Fake News' Headline Claiming He Lost the Super Bowl,0,3,14,60,3,15,0,74,0
Bryce Dallas Howard Cries On Command While Talking Home Depot With Conan,0,2,12,49,0,11,0,61,0
German carnival mocks Donald Trump and Theresa May with controversial floats,0,2,5,61,0,10,0,66,0
Ford is starting to sell supersize pickup trucks in China. Will anyone buy them?,0,2,3,62,2,13,0,65,0
"After United Airlines incident, women share stories of being shamed for their clothing",0,3,3,70,1,12,0,73,0
Theo 'rape' case fuels clashes with police in Paris area,0,2,2,43,2,9,0,45,0
"Joe Hockey criticises US for reneging on TPP, touts benefits of free trade",0,3,7,54,1,12,0,61,0
Watch How Far Alessia Cara Did Go on 'Saturday Night Live',0,3,10,36,2,10,0,46,0
Senate Dems continue fight to see Trump's tax returns after House setbacks ,0,3,4,58,1,12,0,62,0
Bull shark steals a fish right off a fisherman's line,0,3,1,42,1,9,0,43,0
Oceanographer elephant seals collect crucial data as they dive,0,3,1,53,0,8,0,54,0
Parents of Accused Teen Stabber in 'Slender Man' Case Speak Out for the 1st Time ,0,3,10,53,2,15,1,63,0
Justin Bieber Goes on a Hugging Spree in Australia,0,3,6,36,0,8,0,42,0
Trump on Snapchat? President’s Expanded Social Media Presence Offers Pitfalls,0,3,9,57,2,9,0,66,0
"Michael Flynn Initially Failed to Disclose Payments from Russia-Linked Firms, Docs Show",0,2,11,63,2,11,0,74,0
Must See: The World's Wonders from Space,0,2,6,26,2,6,0,32,0
The Democratic whip made an app,0,2,2,24,0,5,0,26,0
US charges homeless man after plane stolen and crashed in Maryland,0,1,3,53,0,10,0,56,0
2008 Leisure Taiwan: Safety first before sporting,0,1,3,35,1,6,4,38,0
Fatal airstrike hits Syrian town days after deadly chemical attack on citizens ,0,3,2,65,0,12,0,67,0
Rumours suggest Alonso and Schumacher could move to Ferrari,0,1,4,47,0,8,0,51,0
Faulty electronic tags could have seen offenders wrongly sent back to jail ,0,3,1,62,0,12,0,63,0
Draymond Green and Klay Thompson Judge Kevin Hart's Heckling Following Warriors/76ers Game,0,3,11,64,2,11,2,75,0
Trump’s pick for attorney general is shadowed by race and history,0,2,1,53,1,10,0,54,0
Power Rankings: How high can streaking Rockets soar?,0,3,4,39,2,7,0,43,0
More than one million Google accounts hit by malware,0,3,2,42,0,8,0,44,0
A foreign policy expert explains why Marine Le Pen could win the French election,0,3,5,62,0,13,0,67,0
This Muslim Teen Flawlessly Played Basketball And People Are Obsessed,0,3,10,50,0,9,0,60,0
Forest Officials Watch As 'Fox Jallikattu' Is Organised In Tamil Nadu,0,2,11,46,2,10,0,57,0
Egypt Coptic church blast 'kills at least 13' in Nile Delta,0,3,4,41,2,10,2,45,0
‘We’re not scared’: Alex Morgan threatens US women’s soccer strike,0,2,5,47,5,9,0,52,0
New professional Open documentary project,0,1,2,35,0,4,0,37,0
"Schwarzenegger heads back to work after feeling ill, being hospitalized",0,1,1,60,1,9,0,61,0
Danish Man who Set Fire to Quran Charged with Blasphemy,0,3,7,39,0,9,0,46,0
Paris rail terminus temporarily shut down by unplanned strike,0,1,1,52,0,8,0,53,0
Wimbledon Fast Facts,0,2,3,15,0,2,0,18,0
Uber CEO Travis Kalanick has quit Trump’s business council,0,2,7,42,1,8,0,49,0
"Alex Rodriguez Passes 2,000 RBI With Home Run vs. Orioles",0,2,10,32,2,9,4,42,0
"New Zealand general election: National, Labour TV debate",0,1,6,41,2,7,0,47,0
"The Elf on the Shelf is preparing your child to live in a future police state, professor warns",0,3,3,73,1,17,0,76,0
Turkish cabin crew deliver mid-air baby,0,3,1,32,1,5,0,33,0
Simone Biles is too busy shining to worry about body-shaming trolls,0,3,2,54,1,10,0,56,0
"Stocks Fall, Rattled by Trump Saying Dollar Getting ‘Too Strong’",0,2,9,43,3,9,0,52,0
Meryl Streep says Trump provokes ’brownshirts and bots and worse’,0,2,3,51,2,9,0,54,0
Charlie Sheen tweets 'Trump next please' after death of Debbie Reynolds,0,2,5,54,2,10,0,59,0
"What makes Trea Turner go? Gummy bears, Sour Patch Kids and Skittles",0,3,8,47,2,11,0,55,0
"FBI director Comey: 'We're not on anybody's side, ever.' ",0,2,5,36,7,9,0,41,0
Wife and child look on in horror as tiger drags husband into enclosure and mauls him to death in Chinese zoo ,0,3,2,86,0,21,0,88,0
Here's how much millionaires would save under GOP Obamacare repeal bill,0,2,5,55,1,10,0,60,0
What's the minimum wage in your state?,0,3,1,29,2,6,0,30,0
Cliven Bundy’s Wife To Reid: Tell Me To My Face We’re ’Domestic Terrorists’,0,2,13,45,5,12,0,58,0
'Outraged' LaHood unveils plans to tackle fatigued U.S. air traffic controllers,0,1,5,60,4,10,0,65,0
This light-up bike helmet has built-in turn signals,0,3,1,41,2,7,0,42,0
Venezuelans on Twitter are preparing for disaster,0,2,2,41,0,6,0,43,0
This Missy Elliott Lyric From 2002 Shakes The Internet,0,3,8,34,0,8,4,42,0
Detainee Who Claims Abuse to Return to Britain,0,1,6,33,0,7,0,39,0
Queen Elizabeth: 90-year-old monarch to step back from some charity work,0,2,2,55,3,10,2,57,0
Zimbabwe cancels education year for 4.5 million after political and economic troubles,0,1,1,70,1,11,2,71,0
"'Putting it bluntly madam, you are sex mad,' judge tells woman jailed for group sex with underage boys",0,3,1,80,4,17,0,81,0
'A Distinction Without a Difference': Paul Rips House GOP's ObamaCare Plan  Insider,0,3,14,53,4,12,0,67,0
Nicola Sturgeon says Tony Blair is right to say Brexit strengthens case for independence,0,3,5,70,0,13,0,75,0
Israeli website reports speculation over U.S. attack on Iran in April,0,1,5,52,2,10,0,57,0
Raiders' Move to Las Vegas from Oakland Approved by NFL Owners,0,3,10,41,1,10,0,51,0
A Desi Wrestling Akhada In Kolhapur Sends An Invitation To Dangal's Aamir Khan To Honour Him,0,3,16,60,1,15,0,76,0
"Azealia Banks Criticizes The Women's March, Warns Women About Mainstream Feminism",0,3,11,58,2,10,0,69,0
John Maine Is Latest Mets Starter to Have a Shaky Outing,0,1,9,37,0,10,0,46,0
"Milo Yiannopoulos attacks Lena Dunham, Leslie Jones and Amy Schumer during controversial TV appearance ",0,3,10,78,1,14,0,88,0
Alaskans dive into 32-degree water in annual polar plunge event ,0,2,1,50,1,10,2,51,0
Russia 'determined to fight terror' after envoy's assassination,0,3,1,52,3,7,0,53,0
"Fidel Castro, Antonin Scalia, John Gutfreund: The Year in Deaths",0,3,9,43,3,9,0,52,0
"New documents show Trump aide laundered payments from party with Moscow ties, lawmaker alleges",0,3,3,77,1,13,0,80,0
Curfew imposed in parts of Thailand,0,1,2,28,0,5,0,30,0
"Farewell, A-Rod. It wasn’t supposed to end like this",0,2,4,36,4,8,0,40,0
Wall St snaps winning run as traders turn cautious ahead of Donald Trump's speech to Congress,0,3,5,72,1,15,0,77,0
Pavarotti receives standing ovation at funeral,0,1,1,40,0,5,0,41,0
"Watson, Clemson stun Alabama to win college football title on last-second pass ",0,2,3,62,2,12,0,65,0
Lenin Moreno Slightly Ahead in Ecuador’s Presidential Vote ,0,3,7,43,1,8,0,50,0
Mars Opportunity rover passes distance milestone,0,1,2,41,0,5,0,43,0
How to Make a Movie Musical Like ‘La La Land’: Very Carefully,0,3,10,37,3,11,0,47,0
How well do you know your fast-food fries?,0,2,1,32,2,7,0,33,0
Amber Peat inquest: Hanging 'most likely' cause of death,0,2,3,42,3,8,0,45,0
Democrats in Congress Are Ready to Pare Budget,0,1,6,33,0,7,0,39,0
"Truck bomb kills at least 60, including army troops, in northern Mali",0,3,2,52,2,11,2,54,0
Fighter Plane F-16 To Be Made In India? US & India Are Discussing The Possibility,0,3,15,47,3,14,2,62,0
Seven charged with attempted murder of Berlin homeless man,0,3,2,48,0,8,0,50,0
End of an era: Space Shuttle Atlantis launches on final mission in program,0,1,4,57,1,12,0,61,0
Homeland Security suspends travel ban,0,3,2,31,0,4,0,33,0
World Cup qualifier may be affected by London Underground strike,0,1,4,51,0,9,0,55,0
"Ashish Nehra Not Taking Any Risks Ahead Of IPL, Pulls Out Of Delhi Team Fearing Injury",0,3,18,52,1,15,0,70,0
Just a load of animals with pancakes because humans are weird,0,3,1,50,0,10,0,51,0
Murder investigation into mysterious family disappearance in France,0,3,2,58,0,7,0,60,0
"Go inside ""A Monster Calls""",0,3,4,17,2,4,0,21,0
A Look at Trump's Cabinet Picks ,0,3,5,20,1,6,0,25,0
Brexit: Theresa May promises White Paper on EU exit plan,0,2,7,39,1,9,0,46,0
El Chapo Complains About Conditions at Manhattan Jail ,0,3,7,39,0,8,0,46,0
Wall Street Journal Is Told to Supply Dow Jones Newswires,0,1,9,39,0,9,0,48,0
Hole in fuselage causes Qantas flight to make emergency landing,0,1,2,52,0,9,0,54,0
Upscale restaurant owner pledges $1 million worth of steak dinners if NKU upsets Kentucky,0,2,5,69,1,13,1,74,0
"Facing criticism, Gabbard to personally pay for Syria trip",0,2,3,46,1,8,0,49,0
Adrien Broner Arrested After Police Spot Him Driving in SUV Riddled With Bullet Holes,0,3,15,57,0,13,0,72,0
"It's plausible Trump incited violence, federal judge rules in OK'ing lawsuit",0,3,4,59,3,10,0,63,0
Mystery Philanthropist Donates Cooler Full of Weed to Local Goodwill,0,3,8,51,0,9,0,59,0
Business Insider is hosting an Instagram photo contest - Business Insider,0,2,5,57,1,10,0,62,0
Justin Trudeau: Promoting Women Is The 'Smartest Possible Thing To Do',0,3,11,46,3,10,0,57,0
Aerial footage shows avalanche of mud in deadly Colombia floods,0,3,2,52,0,9,0,54,0
Watch the Obamas Deliver Their Final Holiday Message as President and First Lady,0,3,10,58,0,12,0,68,0
Yelp Is Now Helping Users Find Gender-Neutral Bathrooms,0,2,9,38,1,7,0,47,0
Water cuts and rising food prices leave Mosul facing crisis,0,2,2,48,0,9,0,50,0
The 'Best' Debt Payoff Strategy May Be Costing You,0,3,9,31,2,8,0,40,0
Chief Keef Has Been Arrested For Robbery And Assault,0,3,9,35,0,8,0,44,0
"From Obama, a Final Christmas Tribute to the Troops He's Led",0,3,8,40,2,10,0,48,0
Fully repealing Obamacare will cost $350 billion,0,3,2,36,1,6,3,38,0
Jindal signs Intelligent Design law,0,1,3,28,0,4,0,31,0
Krauthammer Reacts to 'Radical Departure' in Trump's Foreign Policy  Insider,0,3,8,55,3,10,0,63,0
Interscope Blankets L.A. Bus Stops With Ads Celebrating Steve Berman's 25th Year at Label,0,2,13,58,3,13,2,71,0
Husband Claims 'Bad Dream' About Wife Cheating Led To Fierce Assault,0,3,11,45,2,10,0,56,0
"Australian Senate sits for extra day, passes industrial relations legislation",0,1,2,65,1,9,0,67,0
"Trump's Granddaughter, 5, Sings in Mandarin and Goes Viral on Social Media",0,3,8,51,3,11,1,59,0
Kyrie Irving Shows Off 'Friends' Tattoo While Speaking to the Media,0,3,9,46,2,10,0,55,0
Thai Prime Minister dissolves parliament and calls elections,0,1,3,50,0,7,0,53,0
Senators Too Tough for Rangers,0,1,4,22,0,4,0,26,0
"No Fire Inspections of Warehouse Where 36 Died, Oakland Fire Chief Says ",0,2,10,47,1,12,2,57,0
Plan to Fight Illegal Downloads Faces Opposition,0,1,6,36,0,6,0,42,0
Israel to install missile defense systems on airliners,0,1,1,46,0,7,0,47,0
'The Lego Batman Movie' tops the first strong weekend box office of the year,0,3,4,57,2,13,0,61,0
"Air France, pilots union, victims group criticise transatlantic disaster probe",0,1,2,65,2,9,0,67,0
"Sushma Swaraj Seeks Report From Embassy In Dubai To Help Indian Who Walked 1,000 Km For Justice",0,3,16,58,1,16,4,74,0
Egyptian military appoints committee to amend constitution,0,1,1,51,0,6,0,52,0
This Day In Pictures,0,3,4,13,0,3,0,17,0
Gay Talese's sense of wonder,0,2,2,21,1,4,0,23,0
This Hedge Fund Manager Bets He Can Dull Your Sweet Tooth,0,3,11,36,0,10,0,47,0
lslamic State claims responsibility for Istanbul nightclub attack,0,3,2,56,0,7,0,58,0
Three airlines change policies in wake of United's passenger dragging incident,0,2,2,65,1,10,0,67,0
Ryan Gosling on La La Land: 'The world is quick to shame you for trying' – video interview,0,3,6,63,4,17,0,69,0
John Green hopes to 'amplify the voices of people who are not traditionally heard' through YouTube,0,3,4,77,2,15,0,81,0
Eurovision wants barred Russian singer to compete via satellite in Ukraine,0,2,3,61,0,10,0,64,0
Loretta Lynn to Be Subject of New Country Music Hall of Fame and Museum Exhibit,0,3,11,54,0,14,0,65,0
Al Qaeda: 'Blair brought destruction to the heart of London',0,1,4,44,3,9,0,48,0
London Terrorist Attack: Why Most U.K. Police Don’t Carry Guns,0,2,11,38,4,9,0,49,0
EPA proposes using Clean Air Act to fight global warming,0,1,6,41,0,9,0,47,0
Pope condemns Myanmar's treatment of 'peaceful' Rohingya refugees,0,2,3,52,3,7,0,55,0
‘Politics is divisive. Beer is not’: Is home-brewing the key to harmony on the Hill?,0,2,4,60,6,14,0,64,0
House votes to repeal country of origin label requirement for meat ,0,2,1,55,0,11,0,56,0
"Russia to 'Sex And The City' star: Ambassador would be happy to meet you, too",0,3,6,53,4,14,0,59,0
Jimmy Kimmel Will Host the Oscars in 2017 ,0,3,5,25,0,8,4,30,0
Meet the sensors that could be watching while you work,0,2,1,44,0,9,0,45,0
Hungary education law: Orban 'to meet EU demands',0,3,4,35,3,7,0,39,0
‘It’s Not Your Fault’: Researchers Confirm Cancer Is Often Random,0,3,10,42,4,9,0,52,0
High school orders shot glasses as prom favors,0,1,1,38,0,7,0,39,0
A Guitar Magazine Tests the Luxury Waters,0,1,6,29,0,6,0,35,0
Health officials tracing path of woman with rare TB ,0,3,3,40,0,9,0,43,0
"Cat Finds Its Way Onto Marlins Park Field, Evades Security, Climbs Outfield Wall",0,3,13,53,2,12,0,66,0
"Billboard Dance Chart Upstarts: Kris Kross Amsterdam, Rain Man & a Remixed Summer/Streisand Classic",0,2,13,69,4,13,0,82,0
HSBC Says AIA CEO Mark Tucker Will Be Next Chairman,0,3,17,25,0,9,0,42,0
Six aid groups suspend work in Chad after killing,0,1,2,39,0,8,0,41,0
Lycos launches screensaver to increase spammers' bills,0,1,1,46,1,6,0,47,0
"Police officer killed as car bomb explodes in Omagh, Northern Ireland",0,1,4,54,1,10,0,58,0
Hundreds of veterans gathering at Dakota pipeline protest,0,2,2,48,0,7,0,50,0
Panera Spikes 10% On Rumors That It's Exploring A Sale,0,3,9,32,2,9,2,41,0
Analysts Fault Europe for a Too-Tepid Stimulus Plan,0,1,7,36,1,7,0,43,0
Spanish football captain dies at 26,0,1,1,27,0,5,2,28,0
"Carolina Panthers Cam Newton Dresses as Santa Claus, Donates $30,000 to Academic Center",0,3,10,57,3,12,5,67,0
Cohen Shifts Into Damage Control,0,2,5,23,0,4,0,28,0
Female Founders: Why We're Joining The Women's March,0,3,8,34,3,7,0,42,0
"Steve King, Hurling Insults at Immigrants, Is Rebuked by His Own Party ",0,2,10,47,2,12,0,57,0
In One Ear and Out the Other,0,1,5,17,0,6,0,22,0
Obama makes first public remarks since leaving office,0,2,1,45,0,7,0,46,0
"$100,000 in cash found stashed in old TV at Canadian recycling plant ",0,3,3,46,2,12,6,49,0
"Muslim woman pushed down NYC stairs, called ""terrorist""",0,2,4,41,3,7,0,45,0
Tropical Storm Blanca forms in the Pacific,0,1,4,32,0,6,0,36,0
"After deadly Italian avalanche, a glint of ‘hope’ — 3 puppies rescued from the rubble",0,2,2,64,4,14,1,66,0
"In A Selfless Act, This 22-YO Woman Donated A Part Of Her Liver To A Girl She Babysits!",0,3,19,46,3,17,2,65,0
Gabi Garcia Pummels 49-Year-Old Pro Wrestler in Sideshow at Rizin FF 4,0,2,11,43,2,11,3,54,0
A Beaver Was Just Minding His Own Dam Business When He Walked Into A Dollar Store,0,2,16,50,0,15,0,66,0
IT’S OFFICIAL: The Electoral College makes Trump the president-elect,0,2,15,42,3,8,0,57,0
MDC may pull out of Zimbabwe election,0,1,4,27,0,6,0,31,0
North Carolina Approves Ban on Smoking,0,1,5,28,0,5,0,33,0
Steve Smith Sr. Retires: Latest Comments and Reaction,0,3,7,37,2,7,0,44,0
Banned Substances Found on Materials Linked to Clemens,0,1,6,41,0,7,0,47,0
"Airport Shooting Suspect Checked Gun, Despite Mental Health Issues",0,3,9,48,1,8,0,57,0
How Obama’s Jobs Record Stacks Up ,0,3,6,21,1,6,0,27,0
"TRUMP THREATENS HOUSE GOP: If you vote against the healthcare bill, 'many of you will lose your seats in 2018'",0,3,23,60,4,19,4,83,0
J.C. Penney lists the 138 stores it is planning to shutter ,0,2,3,40,2,11,3,43,0
Protests in Greece over proposed budget cuts,0,1,2,36,0,6,0,38,0
Pastor discovers huge 706-carat uncut diamond in Sierra Leone,0,3,3,46,1,8,3,49,0
"386 gymnasts allege sexual abuse over 20 years, report says",0,3,0,44,1,9,5,44,0
"Remembering One of the NBA’s Biggest Failed Experiments: The ""New Ball""",0,3,11,46,4,10,0,57,0
L.S.U. Rallies to Win Game 1 of College World Series Finals,0,1,10,35,3,10,1,45,0
Everything You Need to Know Before Final Night of 2016-17 NBA Season,0,3,11,39,1,11,6,50,0
UK court jails man for trolling online tribute pages,0,1,2,42,0,8,0,44,0
Adler shotgun: New South Wales Government prepared to agree on category D reclassification,0,3,6,71,1,12,0,77,0
The CIO of a $490 billion fund on the one 'guaranteed losing approach' to investing,0,3,4,59,3,14,3,63,0
Thirteen dead after ethnic clashes in Nigeria,0,1,2,37,0,6,0,39,0
"This Guy Offered A Quirky Valentine's Day Date On Facebook And Got 2,000 Applications For It!",0,3,15,56,3,15,4,71,0
Congo disappearances raise alarm as political tensions grow ,0,3,1,51,0,8,0,52,0
Samsung Heir Lee Arrives Shackled at Special Prosecutors Office,0,3,8,47,0,8,0,55,0
Hate Crimes Are Reportedly Up 115 Percent in New York City Since Election Day,0,3,12,49,0,13,3,61,0
"Trump's America Donald Trump: Reince Priebus asked FBI to dispute Russia reports, White House official says",0,2,12,77,3,15,0,89,0
"At G7 summit, Obama finds support, unity for trade deals, Russian sanctions ",0,2,4,56,3,12,1,60,0
Cavs' Kyrie Irving believes 'they lie to us' and 'Earth is flat',0,2,4,44,5,11,0,48,0
US military to buy anthrax and bioweapons production systems,0,1,2,50,0,8,0,52,0
Video Shows Justin Bieber Getting Smashed Into the Glass at the NHL All-Star Celebrity Shootout,0,2,15,65,1,14,0,80,0
Cat Sneaks Out Of Christmas Gift Box At Exact Right Moment,0,2,11,37,0,10,0,48,0
Clear Channel Faces a Crisis in Cash Flow,0,1,6,28,0,7,0,34,0
"Melania just added another $100,000 to Donald Trump's massive travel tab The list",0,3,4,56,3,12,6,60,0
Pentagon's Quadrennial Defense Review released,0,1,4,37,1,4,0,41,0
Dinosaur tracks found in Arabian Peninsula,0,1,3,34,0,5,0,37,0
Bali Nine refused access to federal police files,0,1,2,39,0,7,0,41,0
Trump is reckless – but he knows he can't afford to antagonise China,0,2,2,52,2,12,0,54,0
Madison Square Garden Co: Rockettes ‘Never Told’ They Must Perform at Inauguration,0,3,11,57,3,11,0,68,0
Sony Goes to the Movies to Pitch Its Brand,0,1,6,28,0,8,0,34,0
Carl Edwards expected to retire immediately from NASCAR,0,3,8,40,0,7,0,48,0
Homeland Security Chief Admits Travel Ban Was Rushed ,0,3,8,37,0,8,0,45,0
Elizabeth Warren: The Left’s Progressive Political Flip-Flopper - Breitbart,0,2,9,54,4,8,0,63,0
Can Apple Fill the Void?,0,1,4,15,1,4,0,19,0
Trial Puts Spotlight on Merck,0,1,4,21,0,4,0,25,0
Hackers could wipe out the internet with Ikea’s latest lightbulbs,0,2,2,53,1,9,0,55,0
Ivory Coast trade embargo backed by US,0,1,4,28,0,6,0,32,0
"In Lawsuit After Lawsuit, It’s Everyday People v. Trump ",0,2,8,36,3,9,0,44,0
O'Reilly: Dems' Blind Opposition to Trump Is 'Harmful to America'  Insider,0,2,10,48,5,11,0,58,0
32 Gorgeous Ways To Say “I Love You” From Around The World,0,3,11,32,2,11,2,43,0
Turner Said to Win Champions League TV Rights for $180 Million,0,3,9,39,1,10,3,48,0
The Cavs reportedly shot down a potential trade with the Knicks involving Kevin Love and Carmelo Anthony,0,3,7,81,0,16,0,88,0
Brexit: Theresa May promises White Paper on EU exit plan,0,3,7,39,1,9,0,46,0
Sir Christopher Lee dies at 93 - latest reaction and tributes,0,2,3,45,1,10,2,48,0
State Department drops human rights as condition for fighter jet sale to Bahrain,0,3,3,65,0,12,0,68,0
Facebook artificial intelligence spots suicidal users,0,3,1,47,0,5,0,48,0
31 Somali refugees killed in helicopter attack off the coast of Yemen,0,3,2,54,0,11,2,56,0
Bad Times Spur a Flight to Jobs Viewed as Safe,0,1,7,30,0,9,0,37,0
"Butch Trucks, founding drummer of the Allman Brothers Band, dies at 69",0,3,5,50,2,11,2,55,0
James Corden Lays Down Some Raps in 2017 Grammys Opening Monologue: Watch,0,3,10,47,1,11,4,57,0
Uber’s Autonomous Cars Heading Back to California,0,3,6,36,1,6,0,42,0
"House will not vote on Affordable Care Act rewrite, smoothing way for government to stay open",0,2,4,73,1,15,0,77,0
"President Trump Signs 3 Presidential Memorandums, Pulls US From TPP ",0,2,12,44,1,10,1,56,0
"Kelly Osbourne dishes on holiday plans, family traditions and more",0,2,2,54,1,9,0,56,0
Halifax bank: UK house prices rose 0.6% during July,0,1,4,34,3,8,2,38,0
Paris police are given powers to search Metro passengers' bags after St Petersburg train massacre killed 14,0,3,4,84,1,16,2,88,0
"Lee Daniels, Queen Latifah bring ‘Star’ power to Fox drama",0,2,6,40,3,9,0,46,0
Saudi Arabia executed more than 150 prisoners in 2016 for breaking kingdom's strict Islamic laws ,0,3,3,71,1,15,7,74,0
Sotomayor Leaves Passion Behind,0,1,4,24,0,3,0,28,0
Escaped South Carolina Inmate Captured by Police After Officer Stabbing ,0,2,9,53,0,10,0,62,0
Trudeau to be questioned by ethics watchdog over reports of cash for access,0,3,1,62,0,12,0,63,0
Medicinal marijuana sale approved by Federal Government,0,3,3,46,0,6,0,49,0
The Case for More Government and Higher Taxes - The New York Times,0,2,10,43,1,12,0,53,0
Trump's First 100 Days ,0,3,3,12,1,4,3,15,0
Florida Governor Jeb Bush gives speech on Hurricane Wilma,0,1,6,43,0,8,0,49,0
Wedding photo becomes symbol of S. Korea MERS scare - Business Insider,0,2,9,48,2,11,0,57,0
Salt art time lapse - ESPN Video,0,3,6,19,1,6,0,25,0
"Before Elections, Dutch Fear Russian Meddling, but Also U.S. Cash - The New York Times",0,2,14,53,5,14,0,67,0
Saudi Arabia's Stock Market Opens.com,0,2,5,26,2,4,0,31,0
North Korea Claims Border Marker Was Moved,0,1,7,29,0,6,0,36,0
The startup trying to become the Tesla of trucking is about to reveal its hydrogen-electric semitruck,0,3,2,83,1,15,0,85,0
Rupert Murdoch preparing to step down as CEO from 21st Century Fox,0,3,7,46,0,11,2,53,0
North Carolina votes to replace one anti-trans law with another and everyone is obviously outraged,0,3,2,81,1,14,0,83,0
Live Streaming News Video  ,0,3,4,18,0,5,0,22,0
"Just Spending Money Won't Clean Ganga, Experts Say No Major Improvement Has Come In Water Quality",0,2,16,64,2,15,0,80,0
Pope in medical crisis,0,1,1,18,0,3,0,19,0
Watch Live: Pence Speaks After Senate Policy Luncheon,0,3,8,37,1,7,0,45,0
Prosecutors Plan an Attack on Financial Fraud,0,1,5,34,0,6,0,39,0
"Leon Panetta: White House ""paying a price"" for lack of discipline",0,3,4,48,3,10,0,52,0
Congressman Who Lost Seat Over Anti-Gay Remarks Tapped By Trump For Big Agency Job,0,2,15,53,1,13,0,68,0
Tweeting Becomes a Summer Job Option,0,1,5,26,0,5,0,31,0
Giants Allegedly Trashed Team Plane on Flight Back From Green Bay,0,2,10,45,0,10,0,55,0
Landless Workers Movement marches to Brasilia in protest,0,1,4,45,0,7,0,49,0
Unusual Strain of Swine Flu Is Found in People in 2 States,0,1,8,38,0,11,1,46,0
Kim Jong-nam killing: Suspect 'was paid $90 for baby oil prank',0,3,3,43,5,10,2,46,0
Obama under fire for saying no ‘complete strategy’ yet for training Iraqis ,0,3,2,59,2,12,0,61,0
The Jobs Programs Trump’s Budget Would Cut,0,2,7,28,1,6,0,35,0
"Idlib Attack Aimed at Disrupting Talks, U.N. Envoy Says",0,3,9,35,3,8,0,44,0
"Domino's customer gets an unexpected offer of MDMA, cocaine and more with their delivery",0,3,5,68,2,13,0,73,0
President Obama Writes Note Praising The 'Diverse Tales' Honored At Sunday's Golden Globes,0,2,13,62,3,12,0,75,0
The GMO-Labeling Lobby Takes Its Fight to the U.S. Senate,0,2,12,33,3,9,0,45,0
Manchester City’s 10 men sink Burnley thanks to Clichy and Agüero,0,3,5,47,1,10,2,52,0
Usain Bolt: Sprinter loses one Olympic gold over teammate's failed dope test,0,3,4,59,2,11,0,63,0
Bettor Puts $1.1 Million on the Falcons to Win the Super Bowl,0,2,7,39,2,11,2,46,0
Former Pope Benedict struggled with Vatican’s ‘gay lobby’ power,0,2,4,48,3,8,0,52,0
FSU assistant says push by Duke's Grayson Allen 'not a dirty play',0,3,6,46,3,11,0,52,0
"SXM Festival Releases Full Lineup, Adds Jamie Jones, The Martinez Brothers & More",0,3,14,52,3,12,0,66,0
Round 1 Ticket Holders to Get Rain Checks or Refunds,0,1,7,35,0,9,1,42,0
Sumner Redstone Leaving Viacom Board After February Meeting ,0,3,8,44,0,8,0,52,0
How Donald Trump's rhetoric translates to government paper,0,3,3,47,1,7,0,50,0
North Korea warns joint US-South Korea military exercises are pushing region to 'nuclear disaster',0,3,6,76,3,13,0,82,0
"Oklahoma Sheriff’s Deputy Shot Dead, Suspect Captured After Manhunt",0,3,9,48,2,8,0,57,0
Dr Xavier is applying for US citizenship to ‘fight Trump’ The list,0,3,6,47,2,11,0,53,0
"Boycott won’t heal our divide, Israeli star tells fellow artists",0,3,2,51,2,9,0,53,0
"Burger sells for $10,000 in Dubai",0,3,2,19,2,5,5,21,0
Fake US embassy in Ghana shut down after a decade,0,2,4,36,0,9,0,40,0
GOP Health Plan Risks Backlash From Seniors,0,2,9,28,0,6,0,37,0
'She believed in helping people': Remembering Master Sgt. Debra Clayton,0,2,6,52,4,9,0,58,0
Sydney FC to lose competition points,0,1,3,28,0,5,0,31,0
"Jabrill Peppers Will Have Role in Browns Offense, According to Hue Jackson",0,3,10,52,1,11,0,62,0
Star Lobbyist Closes Shop Amid F.B.I. Inquiry,0,1,9,27,3,6,0,36,0
This Mom Won't Stop Until She Finds Help For Son Whose Body Rejects Food,0,3,14,44,1,13,0,58,0
Theresa May stands firm on Donald Trump state visit as thousands protest,0,3,4,57,0,11,0,61,0
Credit Suisse will pay a $5.3 billion settlement over pre-crisis mortgage-backed securities,0,3,2,72,4,11,2,74,0
Convicted murderer escapes from prison after 'armed gang' helped him get away after a hospital visit ,0,3,1,82,2,16,0,83,0
Results to be announced in the New Zealand 2005 General Election,0,1,5,45,0,10,4,50,0
"New Retirement Rule Is Delayed, but Not Its Impact",0,3,8,33,1,8,0,41,0
"Soon, Cars May Take Away the Keys of a Drunken Driver ",0,3,8,34,1,11,0,42,0
Croydon 'hate crime': Police release images of three suspects after brutal attack on teen refugee,0,3,2,78,3,14,0,80,0
Iraq Resists Pleas by U.S. to Placate Baath Party,0,1,8,31,2,8,0,39,0
Tillerson approved by Senate panel as secretary of state,0,2,2,46,0,8,0,48,0
Justin Trudeau under investigation for possible ethics violation over Bahamas trip,0,3,3,69,0,10,0,72,0
"Leon Panetta: White House ""paying a price"" for lack of discipline",0,2,4,48,3,10,0,52,0
Tepco Struggles to Communicate Radiation Spike That Wasn’t,0,3,7,43,1,7,0,50,0
New polls show third party U.S. presidential candidates varying radically in popularity,0,1,3,71,2,11,0,74,0
Racist headteacher who called parents 'b-----s' banned from the classroom,0,2,1,56,7,9,0,57,0
U.S. Strike on Syria Shakes Up ISIS Fight,0,2,11,21,2,7,0,32,0
"Steve Sarkisian Named Falcons OC: Latest Contract Details, Comments, Reaction",0,3,11,54,3,9,0,65,0
Bob Weir & Trey Anastasio Team Up to Cover Lady Gaga's 'Million Reasons': Watch,0,3,12,49,5,13,0,61,0
Former Japanese prime minister Hashimoto indicated his retirement,0,1,3,55,0,7,0,58,0
Trump is closing in on a pick to run the FDA â here's what that could mean for the agency,0,3,4,65,3,19,0,69,0
Surge in Surfers for Online Classified Ads,0,1,5,31,0,6,0,36,0
Marine Le Pen 'hates faces that don't look like hers',0,3,3,38,3,9,0,41,0
The Fall and Rise of the Right Whale,0,1,5,24,0,7,0,29,0
Drift Analysis Says MH370 Likely Crashed North of Search,0,3,9,36,0,8,3,45,0
"Japan Airlines Plans to Cut 1,200 Jobs",0,1,5,22,1,6,4,27,0
Laura Bush visits Middle East in goodwill tour,0,1,4,35,0,7,0,39,0
Arkansas Rushes to Execute 8 Men in the Space of 10 Days - The New York Times,0,2,10,47,1,16,3,57,0
Arkansas' set to conclude executions with 4th on Thursday ,0,2,2,45,1,9,1,47,0
Bangladesh mutiny leaves scores of officers dead,0,1,1,41,0,6,0,42,0
Wirral explosion: two people seriously injured in suspected gas blast,0,3,1,58,1,9,0,59,0
"At Colonial, Greens Are Soft and Scores Are Low",0,1,8,30,1,8,0,38,0
Russia wins Junior Eurovision Song Contest 2006,0,1,5,32,0,6,4,37,0
"5 Mega Tuesday Takeaways: Trump, Clinton Both Building Broad Party Coalitions",0,2,10,54,2,10,1,64,0
African Union considers proposal to resettle Haitians,0,1,3,44,0,6,0,47,0
"Humbled by Collapse, London Ponders Its Identity",0,1,6,35,1,6,0,41,0
Roadside Bomb Kills 2 Marines in Southern Afghanistan,0,1,6,39,0,7,1,45,0
Trump’s Promises to Corporate Leaders: Lower Taxes and Fewer Regulations,0,2,8,53,2,9,0,61,0
Super PACs explained,0,2,4,14,0,2,0,18,0
West Is Told to Expect Water Shortfalls,0,1,6,27,0,6,0,33,0
Business Travelers Will Pay Less To Fly In 2017 Despite Airlines' Efforts To Limit Capacity Growth,0,2,15,63,1,15,4,78,0
Santa Claus Sightings From Around The World Photos ,0,3,8,35,0,8,0,43,0
Lego copycats fool China boss,0,3,2,23,0,4,0,25,0
"Sorry, this president is way less ‘authoritarian’ than the last one",0,2,1,53,3,10,0,54,0
Google Home Is Beating Alexa In Some Very Important Ways,0,2,10,37,0,9,0,47,0
Bob Costas slams ESPN over Caitlyn Jenner ESPY courage award ,0,3,12,39,0,10,0,51,0
NCAA Tournament 2017: Winners and Losers from Friday's Round of 64,0,3,9,39,2,10,6,48,0
Nicki Minaj Reunited With Drake And Twitter Lost It,0,3,9,34,0,8,0,43,0
Nazi Guard Deported to Austria,0,1,4,22,0,4,0,26,0
Learning The Lessons Of TV Fatherhood,0,2,7,25,0,5,0,32,0
US intel report: Putin ordered cyberattacks to sway election,0,2,3,48,1,8,0,51,0
Istanbul nightclub attack: Suspected gunman caught by police after two-week nationwide manhunt,0,3,2,79,2,11,0,81,0
Race to save Chilean miners trapped underground from spiralling into depression continues,0,1,2,76,0,11,0,78,0
"The Cost Can Be Debated, but Meals on Wheels Gets Results ",0,3,9,37,1,11,0,46,0
Sessions directs federal prosecutors to target the nation’s most violent offenders,0,2,1,70,1,10,0,71,0
David Bowie's Most Popular Releases in the U.K. Since His Death,0,3,10,40,3,10,0,50,0
Taiwan Fears Becoming a Pawn in Donald Trump’s Game,0,3,7,35,1,8,0,42,0
"Utah School District Pays $100,000 for ""Drunk Goggles"" Injury",0,3,7,36,4,8,6,43,0
"Nigeria Church Collapses, Killing Dozens",0,3,5,30,1,4,0,35,0
"Australian football: Adelaide United defeat Queensland Roar, through to A-League Grand Final",0,1,9,69,3,11,0,78,0
Filipino troops kill notorious Abu Sayyaf kidnapper in clash ,0,2,3,49,0,9,0,52,0
Donald Trump administration is 'preparing to renew Iran sanctions',0,3,3,53,2,8,0,56,0
N.C. man told police he went to D.C. pizzeria with gun to investigate conspiracy theory,0,3,4,65,4,14,0,69,0
Witnesses of fire in Vladivostok under investigation,0,1,2,44,0,6,0,46,0
Journalist forbidden to leave Belarus,0,1,2,31,0,4,0,33,0
Sen. Mike Lee: GOP Health Care Bill 'Is Going to Fail'  Insider,0,3,13,34,4,12,0,47,0
"YouTube adverts blocked on videos from channels with under 10,000 views",0,3,2,53,1,10,5,55,0
Two Books Argue the Case for Police Reform From Within - The New York Times,0,2,12,48,1,14,0,60,0
Uber will totally narc on teens,0,2,1,25,0,5,0,26,0
"Australia 'running behind' in obesity prevention policy, health specialists say",0,3,1,66,3,9,0,67,0
"Bomber Hits Checkpoint in Pakistan, Killing 20",0,1,5,32,1,6,2,37,0
Turkey referendum: Erdogan camp set to win after most votes counted,0,3,2,54,1,10,0,56,0
Oil leaking container ship might cause environmental catastrophe,0,1,1,56,0,7,0,57,0
France’s Choice: Le Divorce?,0,3,4,18,3,3,0,22,0
Seven face deportation after UK dawn raids,0,1,3,33,0,6,0,36,0
"Climate change could threaten entire financial system, APRA warns",0,3,5,51,1,8,0,56,0
Families appeal to Spain's government to negotiate with Somali pirates,0,1,3,57,1,9,0,60,0
NFL Draft 2017: Top Players Who Could Fall Down the Board,0,3,11,31,1,10,4,42,0
Forces loyal to Ouattara plan to seal Ivory Coast border,0,1,4,43,0,9,0,47,0
NFL1000's All-Overpaid Free Agency Team,0,3,8,21,2,4,4,29,0
Newell Brands Steps Up Online Efforts as Mall Traffic Slumps,0,3,9,42,0,9,0,51,0
Boy arrested for murder after seventeen-year-old run over by bus,0,1,1,52,2,9,0,53,0
"To Pay for Health Care, Obama Looks to Taxes on Affluent",0,1,8,37,1,10,0,45,0
Swap Meet Continues as Jets Maneuver for Greene,0,1,6,34,0,7,0,40,0
"Jedward return to the Celebrity Big Brother house, and fall over twice in the process",0,3,4,66,1,14,0,70,0
This State Just Dug Deep Into Voting Irregularities. It Found Nothing Close To Widespread Voter Fraud.,0,3,16,69,2,15,0,85,0
Submit your product for Mashable's 'Top Picks of CES 2017',0,3,7,35,3,9,4,42,0
Protesters Defy Iranian Efforts to Cloak Unrest,0,1,6,35,0,6,0,41,0
"With 'The Grand Tour,' Amazon Bets Millions On Jeremy Clarkson's Car Show",0,3,12,46,4,11,0,58,0
Mass delivery of anti-Islamic DVDs in swing voting states,0,1,5,43,1,8,0,48,0
"Shannon Matthews timeline in pictures: the search, the trial and the evidence",0,2,2,62,2,11,0,64,0
Big Mac Makeover Helps McDonald's Overcome Restaurant Slump,0,3,9,42,1,7,0,51,0
New eclipse Forever stamp will magically transform into the moon,0,3,2,53,0,9,0,55,0
Donald Trump Dogs Dow Strategy ,0,2,5,21,0,5,0,26,0
"Jolted by Deaths, Obama Found His Voice on Race ",0,3,7,31,1,9,0,38,0
"Debbie Reynolds, Carrie Fisher to Have Joint Funeral",0,3,7,37,1,7,0,44,0
"NBA 3-Point Contest 2017: Complete Participant List, Comments and Reaction",0,3,10,47,3,9,5,57,0
"Man Charged in Theft of John Legend's Bag, $25K Cufflinks at JFK",0,3,11,37,3,11,2,48,0
Massive winter storm wreaks havoc on travelers,0,3,1,39,0,6,0,40,0
Multivitamins a waste of money and just create 'very expensive urine',0,3,1,56,2,10,0,57,0
Le Pen aides have been taken into French police custody,0,3,3,43,0,9,0,46,0
Sofia Richie Speaks on Haters in the Fashion Industry,0,3,6,39,0,8,0,45,0
Ford pulls ads from gay media facing AFA boycott,0,1,4,36,0,8,0,40,0
"In YouTube videos, Chicago woman takes blame for mom's murder in Bali",0,3,5,51,2,11,0,56,0
Israel-China construction deal reportedly bans settlements ,0,3,2,50,1,6,0,52,0
"Cuba Gooding Sr., 'Everybody Plays the Fool' Singer & Dad to Oscar-Winning Actor, Dies at 72",0,3,12,56,7,15,2,68,0
Police charge Australian man over laser incident,0,1,2,40,0,6,0,42,0
Oil-Producing Countries Agree to Cut Output Along With OPEC,0,2,12,38,1,8,0,50,0
"Twitter’s C.E.O., Dick Costolo, Is Set to Exit, Feeling Heat of Criticism ",0,3,12,43,7,12,0,55,0
Originalists Put Politics Over Principle,0,3,5,31,0,4,0,36,0
Afghan Presidential Election Delayed,0,1,4,29,0,3,0,33,0
Kansas City Chiefs Chiefs WR Tyreek Hill Rushes for 68-Yard Touchdown vs. Titans,0,3,12,52,2,12,2,64,0
Putin owns a Super Bowl ring thanks to a misunderstanding with Patriots owner Robert Kraft,0,2,6,70,0,14,0,76,0
Dutch election: European relief as mainstream triumphs,0,3,2,45,1,6,0,47,0
Serena Williams and Dementieva Advance to Third Round in Melbourne,0,1,7,50,0,9,0,57,0
"Exercise can help offset effects of 'fat gene,' study finds ",0,2,1,46,3,10,0,47,0
Mead Johnson accused of selling baby formula containing bugs,0,2,2,50,0,8,0,52,0
Member of Congregation Arrested for 'Vote Trump' Arson at Black MS Church  Insider,0,2,11,56,2,13,0,67,0
"4,000 soldiers prepared to drive rail replacement buses if needed during Southern rail strikes",0,3,1,75,1,13,4,76,0
Over 100 people protest exclusion of gender identity protection in ENDA outside HRC dinner,0,1,8,66,0,13,3,74,0
Hillary Clinton Embraces Her Mother’s Emotional Tale ,0,3,7,38,1,7,0,45,0
Trial to Begin for Charleston Church Shooting Suspect Dylann Roof ,0,3,8,48,0,10,0,56,0
Iran will continue work on nuclear fuel cycle,0,1,1,37,0,7,0,38,0
Shares Down on a Day of Choppy Trading,0,1,5,26,0,7,0,31,0
Who Should Perform at the Inaugural Ball? Vote!,0,3,6,32,2,7,0,38,0
Deflating ‘Deflategate’ ,0,3,2,18,2,2,0,20,0
Miami's Little Havana declared a 'national treasure',0,3,3,40,3,6,0,43,0
Ethiopia rejects UN investigation over protest deaths,0,3,3,44,0,6,0,47,0
"Vyacheslav Tikhonov, Russian actor most famous for Stirlitz, dies at 81",0,1,4,53,2,10,2,57,0
Poland Investigates Deadly Shelter Fire,0,1,5,30,0,4,0,35,0
Yankees Will Have a While to Think About Latest Loss to Red Sox,0,1,10,41,0,12,0,51,0
Derby Winner Mine That Bird Works Out,0,1,7,24,0,6,0,31,0
"Man remanded in custody after allegedly spraying urine on goods in Gloucestershire, UK",0,1,4,69,1,12,0,73,0
Fireball Rips Through Siberian Sky In Brilliant Display Of Light,0,2,10,45,0,9,0,55,0
"Frank Ocean Premieres New Version of ""Slide on Me"" f/ Young Thug",0,3,9,41,3,11,0,50,0
"Two dead, seven others wounded in church by gunfire in Tennessee, United States",0,1,4,61,2,12,0,65,0
Seattle Mariners Unveil Ken Griffey Jr. Statue Outside Safeco Field,0,3,10,47,1,9,0,57,0
Texas 'affluenza' teen's lawyers seek his release from jail ,0,2,1,47,3,9,0,48,0
Gang Members Told to Steal $5000 and a Gun Per Day - Breitbart,0,2,8,36,2,12,4,44,0
Cuba releases leading dissident from prison,0,1,1,37,0,5,0,38,0
"Mexican police official, bodyguard shot dead at restaurant",0,1,1,49,1,7,0,50,0
Starbucks Pledges to Hire More U.S. Military Veterans ,0,3,8,36,2,8,0,44,0
BMW Cuts Jobs at Plant That Makes the Mini,0,1,9,25,0,8,0,34,0
Gangster-killing Philippines president Duterte claims some of his cousins may be in ISIS ,0,3,7,68,1,13,0,75,0
"After the Richmond by-election, shouldn't all Brexit MPs in Remain constituencies resign?",0,2,6,68,4,11,0,74,0
Frank Mason III Wins 2016-17 Naismith Trophy,0,3,8,23,1,6,6,31,0
Yankees Lose Their Way on Bridge to Rivera,0,1,6,29,0,7,0,35,0
Major 7.3 magnitude earthquake hits Honduras,0,1,2,34,1,5,2,36,0
Does Hewlett-Packard Need a Dose of Anarchy?,0,1,6,30,2,6,0,36,0
Dow’s Rise Puts It Near 20000 Milestone ,0,3,6,21,1,7,5,27,0
Decision looms on Assange extradition to Sweden ,0,3,3,38,0,7,0,41,0
Obama says he's fine with changing 'ObamaCare' to 'TrumpCare' ,0,3,5,43,5,9,0,48,0
Keep or Replace Obamacare? It Might Be Up to the States. ,0,3,8,36,2,11,0,44,0
French election: Latest updates,0,3,2,25,1,3,0,27,0
Alex Sanchez suspended for drugs,0,1,2,26,0,4,0,28,0
Remaining 27 EU countries agree Brexit guidelines as Hollande says UK must 'pay price',0,3,7,62,2,13,2,69,0
"Housing affordability issues could be helped by allowing renters to buy without a deposit, Federal MP says",0,3,4,85,1,16,0,89,0
"ABN Amro to Sell $20 Billion of Asia, Middle East Banking Assets",0,3,11,38,2,11,2,49,0
New York Observer Ending Print Edition - The New York Times,0,2,10,38,1,10,0,48,0
BMW and VW Reflect  Difficulties Facing Carmakers,0,1,9,33,0,7,0,42,0
'Mean Girls' Musical on Track for Fall 2017 World Premiere,0,3,7,36,2,9,4,43,0
Sparks flew the night Oarhe Akhigbe and Nicole Battle met. Literally.,0,3,6,51,2,10,0,57,0
Manhunt Underway After Nurse Brutally Stabbed to Death,0,3,7,40,0,7,0,47,0
Uncertainty Over US Plans And Greed To Establish Global Dominance Fuel China's Navy Expansion,0,3,15,64,1,13,0,79,0
British TV presenter Rico Daniels tells Wikinews about being 'The Salvager',0,1,8,55,2,10,0,63,0
Azealia Banks Reportedly Slashed Her Sister's Neck With a Box Cutter in 2009,0,2,10,49,1,12,4,59,0
A Porn Site Wants a Trump Look-Alike With Small Hands for New Movie,0,3,12,42,1,12,0,54,0
Tropical Storm Ike upgraded to hurricane status,0,1,3,38,0,6,0,41,0
Elon Musk wants to start boring company to address traffic congestion ,0,3,2,57,0,11,0,59,0
David Cameron elected new UK Conservative Leader,0,1,6,36,0,6,0,42,0
alt-J Talk Chasing Excitement And Magic On A Confident New Album,0,2,11,42,1,10,0,53,0
"For Poodles, Maintenance of the Highest Order",0,1,5,33,1,6,0,38,0
40th Ariane 5 rocket launches ProtoStar-1 and Badr-6 satellites,0,1,4,44,2,8,5,48,0
"Vesna Vulovic, Survivor Of Mid-Air Plane Explosion And 33,000-Foot Fall, Dies At Age 66",0,2,14,48,5,13,7,62,0
There's No Slowing Down Kansas: Elite Speed Has KU Looking Like Title Favorites,0,3,14,51,2,12,0,65,0
U.S. Airlines Unlikely to Face Antitrust Case on Capacity,0,3,8,39,2,8,0,47,0
Thanks for Giving Me Your Tax Money,0,3,6,23,0,6,0,29,0
"Ivanka Trump Gets an Office in the White House, But We Don't Know What the Hell She's Doing",0,3,14,57,3,17,0,71,0
Jamie Oliver to close six restaurants in 'tough market' after Brexit vote,0,3,3,57,2,11,0,60,0
The end of an era for Winfrey,0,1,2,21,0,6,0,23,0
FAKE NEWS: NBC News Issues Correction After Falsely Branding MILO as ‘White Nationalist’ - Breitbart,0,2,24,58,4,14,0,82,0
"Democrats act to save ObamaCare from GOP repeal, Obama to Hill, 'Day of Action' ",0,3,10,52,4,14,0,62,0
Van Halen singer impersonated in Canadian medical scare,0,1,3,45,0,7,0,48,0
"Watch The Weeknd's New Video for ""I Feel It Coming""",0,3,9,30,3,9,0,39,0
I'll Have Another wins 2012 Preakness Stakes,0,1,5,28,1,6,4,33,0
Mexico Eliminates Infectious Disease Which Is Leading Cause of Blindness,0,3,9,54,0,9,0,63,0
Kremlin reportedly ordered state media to tone down Trump coverage ,0,3,2,55,0,10,0,57,0
Microsoft's Record Stock Price Stumbles After Failing To Beat Revenue Estimates In Q3,0,3,13,58,1,12,1,71,0
Should McDonald's workers get $50G reward in Facebook murder case? ,0,3,5,47,3,10,2,52,0
Stars and Stripes No Longer Waves Over Baseball,0,1,7,33,0,7,0,40,0
"Progressives Hit Trump Ed Sec with Death Threats, Security Costs $7.8 Million - Breitbart",0,2,11,59,4,13,2,70,0
"Author, Author: Did A.W. Tillinghast Really Design Bethpage Black?",0,1,10,43,5,8,0,53,0
5 Key Moments From the Appeals Court Hearing on Trump's Travel Ban ,0,3,9,44,1,12,1,53,0
UK study claims men have higher average I.Q. than women,0,1,4,40,2,9,0,44,0
Governor of Tokyo is sued for insulting French language,0,1,3,44,0,8,0,47,0
The Speaker should consider his position,0,3,2,33,0,5,0,35,0
‘Beauty’ Is a Beast: Live-Action Remake Roars at the Box Office,0,3,9,40,4,10,0,49,0
"'Can I have my biscuits, please?' asks six-year-old Italian girl pulled from avalanche rubble after 48 hours ",0,3,3,81,6,17,2,84,0
Ireland is compensating a woman who was forced to travel for an abortion,0,3,1,59,0,12,0,60,0
Philadelphia Archdiocese suspends 21 priests for alleged sexual abuse,0,1,2,57,0,8,2,59,0
Swingers campsite opens in France complete with 'cuddle corners' and Eyes Wide Shut-themed parties,0,2,5,77,3,13,0,82,0
Gujarat Police On High Alert After Pakistani Infiltrator Crosses Border Through Kutch,0,3,12,62,0,11,0,74,0
"Dems so far making few changes to playbook, leadership after crushing defeat",0,2,1,63,1,11,0,64,0
Bill Gates releases mosquitoes during conference for malaria awareness,0,1,2,60,0,8,0,62,0
What Workplaces Gain When They Send Their Employees Back to School,0,2,10,46,0,10,0,56,0
Togo opposition wants election delayed,0,1,1,33,0,4,0,34,0
Turmoil at Politico after staff shakeup,0,2,2,32,0,5,0,34,0
Businesses Warm to LED Lighting,0,1,6,21,0,4,0,27,0
DMX Cancels Several Shows Due to Medical Issue: Report,0,3,10,35,1,8,0,45,0
Europe calls for mandatory 'kill switches' on robots,0,3,1,42,2,7,0,43,0
Report: U.N. Pressing for ‘Alternative’ Ways to Admit More Syrian Refugees to U.S. - Breitbart,0,2,13,59,8,14,0,72,0
English hard rock band The Darkness reunites,0,1,3,35,0,6,0,38,0
Fidelity Contrafund and Low-Priced Stock Reopen,0,1,6,35,1,5,0,41,0
‘In Cold Blood’ Killer’s Never-Published Memoir Raises Questions About His Motive,0,2,12,55,4,10,0,67,0
"Bond Buying Surges, Tightening U.S. Corporate Spreads",0,3,8,36,3,6,0,44,0
News of the World: New document suggests cover-up,0,1,3,37,2,7,0,40,0
Scientist detained after bomb scare closes Miami airport,0,1,2,47,0,7,0,49,0
SUV Plummets Into River After Road Washes Away,0,2,10,29,0,7,0,39,0
"Secure Enough to Sin, Baghdad Revisits Old Ways",0,1,7,32,1,7,0,39,0
Growth of Eco-Tourism Raises Concerns,0,1,5,27,1,4,0,32,0
"Here's the best piece of advice Khan Academy founder, Sal Khan, received from billionaire Bill Gates",0,3,7,75,3,15,0,82,0
"It's no dislike button, but we might get dislike reactions on Facebook Messenger",0,3,3,63,2,12,0,66,0
The Jats Who Owned Lutyens' Delhi And A 104 Year Old Wait For Compensation,0,3,13,44,1,13,3,57,0
Politico: ‘States Unprepared for Election Day Cyber Attack’,0,2,7,42,3,7,0,49,0
One Direction's Louis Tomlinson arrested over airport altercation,0,3,4,53,1,7,0,57,0
"Republicans Look to Reince Priebus, Trump’s Chief of Staff, to Bring Stability ",0,3,9,55,3,12,0,64,0
Watch Live: Trump Attends White House Senior Staff Swearing-In,0,3,10,42,2,8,0,52,0
Britain makes final World War II debt payments,0,1,5,34,0,7,0,39,0
"People Are Using ""Nevertheless, She Persisted"" To Share Examples Of Badass Women",0,3,12,54,3,11,0,66,0
East Aleppo residents flee for their lives as airstrikes continue to pound the city,0,2,2,68,0,13,0,70,0
Wholesale Inventories Decline for a Fifth Month,0,1,5,36,0,6,0,41,0
The Rikers Island bus: A journey like no other,0,3,4,33,1,8,0,37,0
Los Angeles Mayor Declares Today 'La La Land' Day,0,2,9,30,2,8,0,39,0
Anzac Day marked by Australian Antarctic expeditioners in below-freezing temperatures,0,3,4,71,1,9,0,75,0
Anti-racism rally in Sydney,0,1,2,21,1,3,0,23,0
Jenna Bush Hager Shared Some Photos Of The Obama Girls’ First White House Visit,0,3,14,51,1,13,0,65,0
JPMorgan Quant Frets Stock Complacency Too High After Dutch Vote,0,2,12,43,0,9,0,55,0
"Baltimore Rising: Two Years After Freddie Gray’s Death, Shaken City Mends",0,3,11,49,3,10,0,60,0
Chris Hemsworth is joining the 'Ghostbusters' cast,0,2,3,39,2,6,0,42,0
Hungarian camerawoman gets probation for kicking and tripping migrants,0,3,1,61,0,8,0,62,0
T-Mobile Customer Growth Slows Ahead of Expected Merger Frenzy,0,3,9,44,1,8,0,53,0
"The weird, lonely life of an auto-show model",0,2,1,34,2,7,0,35,0
Second man arrested over death of ex-navy officer Mike Samwell,0,3,3,49,1,9,0,52,0
GOP proposal would trigger fines for unapproved video in House chamber in wake of sit-in ,0,3,4,69,1,15,0,73,0
Paraguay president backs off re-election bid,0,3,1,37,1,5,0,38,0
High Court Backs President in Use of Jerusalem on U.S. Passports,0,3,9,43,2,10,0,52,0
Not as good as P&P: Jane Austen mother's verdict on Mansfield Park,0,3,7,45,3,11,0,52,0
"New LHC Results Hint At New Physics, But Are We Crying Wolf?",0,2,14,33,2,11,0,47,0
Obama defends a cornerstone of his legacy in Asia as it keeps getting shredded at home,0,2,2,69,0,15,0,71,0
"Trump Immigration Ban Still In Place Despite Court Ruling, Says DHS",0,3,13,43,1,10,0,56,0
San Antonio Spurs Gregg Popovich Received 25 Write-In Votes for President in San Antonio,0,3,12,60,1,13,2,72,0
Iran continues to lash out at film industry,0,1,1,35,0,7,0,36,0
Wikinews interviews on contributions to open-source: Opera,0,1,2,48,2,6,0,50,0
Galaxy S8 Has Some Embarrassing New Problems,0,2,7,30,0,6,1,37,0
$100 BILLION FUND: There's more to investing in the US than betting on Trump,0,3,15,42,3,13,3,57,0
Election Commission Claims That Even Manufacturers Can't Manipulate EVMs,0,3,11,52,1,8,0,63,0
OracleVoice: Behold! The IoT-Enabled Electric Scooter,0,2,9,36,3,5,0,45,0
Judge Allows Katrina Lawsuit Against Corps of Engineers,0,1,7,41,0,7,0,48,0
Japanese court plans to seize control of 2channel,0,1,1,40,0,7,1,41,0
Macron Struggles in French Media Spotlight as Presidency Beckons,0,2,7,49,0,8,0,56,0
New L Alert: Tyga Sued for Allegedly Ordering Crew to Beat up Process Server,0,3,11,51,1,13,0,62,0
People are freaking out over a pic of Drake and Jennifer Lopez,0,3,4,47,0,11,0,51,0
"With $10 Million In Funding, Ariel Kaye's Parachute Is Aiming To Shake Up The Home Essentials Market",0,3,16,63,3,16,2,79,0
Scottish Premier League: Celtic thump Hearts 5-0,0,1,5,33,2,6,2,38,0
"Large magnitude 7.8 earthquake, aftershock strikes Vanuatu region",0,1,2,52,2,7,2,54,0
How the Grammy Awards Are Made: 4 Craftsmen and ‘Grammium’ ,0,3,7,38,3,10,1,45,0
Serial child imposter held by French police,0,1,2,35,0,6,0,37,0
"Starbucks pledges to hire 10,000 refugees",0,3,1,29,1,5,5,30,0
Wanda's $1 Billion Bid for Dick Clark Faces Hurdles,0,2,7,33,2,8,1,40,0
U.K.’s Brexit Walkout Threat Leaves EU Unmoved ,0,3,9,28,3,7,0,37,0
"InfoWars’ Alex Jones Is a ‘Performance Artist,’ His Lawyer Says in Divorce Hearing",0,2,12,54,4,12,0,66,0
PSA David From “Lilo & Stitch” Is Better Than All The Other Disney Princes,0,3,15,43,3,13,0,58,0
30 Under 30 2017: Education,0,3,2,12,1,4,8,14,0
NFL Star Tony Gonzalez Grooves to the 'Humpty Dance' on 'Lip Sync Battle': Watch,0,3,13,49,5,13,0,62,0
Let's Blaze: How stoners found a dope livestreaming home,0,2,3,43,2,8,0,46,0
6 LGBTQ Events Worth Traveling for in 2017,0,3,8,22,0,7,5,30,0
Vizio Settles FTC Lawsuit For Snooping On TV Viewers,0,3,12,32,0,8,0,44,0
Stephen Colbert hilariously spoofs Rachel Maddow's Trump tax-form tease,0,3,5,56,2,8,0,61,0
A.I.G. Planning Huge Bonuses After $170 Billion Bailout,0,1,9,32,4,7,3,41,0
Hanjin Shares Surge on Report Asset Sale to Close Next Week,0,2,9,40,0,10,0,49,0
Politics Live - PMQs and Osborne,0,2,6,20,1,5,0,26,0
"Orlando Nightclub Shooter's Widow Arrested, US Official Says",0,3,9,42,2,7,0,51,0
Trump to nominate former Sen. Coats for national intelligence director ,0,2,3,57,1,10,0,60,0
Missouri Steps Forward as Marquette Crosses the Line,0,1,6,39,0,7,0,45,0
Audi and VW sites raided in emissions probe,0,3,3,33,0,7,0,36,0
Watch Live: Confirmation Hearing for SCOTUS Nominee Neil Gorsuch,0,3,13,42,1,8,0,55,0
"No, Bill Gates didn't tweet Donald Trump will be 'one of the greatest presidents' ",0,2,5,59,4,14,0,64,0
#Strike4Repeal: Ireland protests abortion ban on International Women's Day,0,2,6,56,3,8,1,62,0
North Korea State Media Warns of Nuclear Strike if Provoked,0,3,8,42,0,9,0,50,0
Muzak Files  Chapter 11 to Refinance Debt,0,1,5,27,0,7,2,32,0
"Growth will pay for a ""majority"" of tax reform, treasury secretary says",0,3,1,56,3,11,0,57,0
Government Study Warns of Climate Change Effects,0,1,6,36,0,6,0,42,0
"Rick Ross Drops His 'Rather You Than Me' Album, f/ Future, Gucci Mane, Nas, and More",0,2,14,48,7,15,0,62,0
"In England, a Royal Taste That Alters the Landscape",0,1,7,35,1,8,0,42,0
Congress proposed 82 tax bills in January. Here are the highlights,0,2,3,50,1,10,2,53,0
Fictional documentary about Flemish independence causes consternation in Belgium,0,1,3,69,0,8,0,72,0
50-Year Streak Ends as Cuba Fails to Reach Final,0,1,7,30,1,8,2,37,0
Time Does Not Heal All Wounds for Ailing Mets,0,1,8,29,0,8,0,37,0
Venus Williams: Trailblazing On The Court And In The Boardroom,0,3,10,42,1,9,0,52,0
SeaWorld San Diego hosts final One Ocean orca show on Sunday,0,3,7,43,0,10,0,50,0
Steve Miller Announces Summer Tour With Peter Frampton,0,3,8,39,0,7,0,47,0
"Colombia: 193 dead after rivers overflow, toppling homes ",0,3,1,43,2,8,3,44,0
13 Big Equity Firms Pledge to Invest Responsibly,0,1,6,33,0,7,2,39,0
"Gunmen kill seventeen at drug rehab centre in Ciudad Juarez, Mexico",0,1,4,52,1,10,0,56,0
Cleveland 'Delly' Stops Selling Curry During 2015 NBA Finals,0,2,10,36,2,8,4,46,0
Bengals' Adam Jones Arrested Following Alleged Outburst Outside Cincinnati Hotel,0,3,10,60,1,9,0,70,0
Regis Philbin: Trump Doing ‘Quite Well’ and Getting ‘Things Done’,0,3,9,42,5,9,0,51,0
Dealing with the zombies that haunt the Coalition's budget bottom line,0,3,2,57,1,10,0,59,0
"Soulja Boy Takes Shots At Quavo On New Diss Track ""Beef""",0,2,11,33,2,10,0,44,0
Buying High and Selling Low,0,1,4,19,0,4,0,23,0
"How to Hack Room Service, and Other Travel Tips From Curtis Stone",0,3,10,43,1,11,0,53,0
Russia begins military withdrawal from Syria,0,3,2,37,0,5,0,39,0
Teen used cell phone to capture chilling audio of her killer: Police ,0,3,2,54,1,12,0,56,0
US immigration order: Families split as Trump ban enforced,0,2,4,45,1,8,0,49,0
Clinton Pledges Tough Diplomacy and a Fast Start,0,1,6,35,0,7,0,41,0
Duke upset by FSU,0,1,4,10,0,3,0,14,0
Rodrigo Duterte: Philippines leader 'not ready' to talk to rebels,0,3,3,50,3,9,0,53,0
"With Trump Defeats, Muni Bonds See Record-Setting Winning Streak",0,3,10,44,2,8,0,54,0
Iraqi Goalie Killed in Victory Shooting,0,1,5,29,0,5,0,34,0
US Food and Drug Administration proposes new regulations on sunscreen labeling,0,1,5,63,0,10,0,68,0
Fifth Harmony to Perform at 2017 People's Choice Awards,0,3,6,36,1,8,4,42,0
Hong Kong's 50 Richest 2017: Gambling Tycoons See Their Luck Turn,0,3,9,38,2,10,6,47,0
UK breaks solar energy record on sunny March weekend,0,3,3,41,0,8,0,44,0
Sarkisian wins Armenian presidential elections,0,1,2,40,0,4,0,42,0
"Berkshire, Buffett More Than Double Stake in Apple",0,2,7,35,1,7,0,42,0
"In Davos, Anthony Scaramucci Translates Trump Message to Global Elite",0,3,9,50,1,9,0,59,0
Justices Retain Oversight by U.S. on Voting,0,1,6,29,2,6,0,35,0
"Colombia’s FARC Rebels Put Down Guns, Pick up Baby Bottles",0,3,12,35,2,9,0,47,0
Snap IPO: a 21st-century firm with a 19th-century structure,0,2,4,40,3,8,4,44,0
Dem reps want senator statue removed from Capitol over 'xenophobia' claims ,0,3,2,60,2,11,0,62,0
Queen Elizabeth Releases Christmas Remarks,0,3,5,33,0,4,0,38,0
Barack Obama 'rolled his eyes' at Donald Trump's wiretapping accusations,0,3,4,56,3,9,0,60,0
Carl Bernstein: Donald Trump has 'disdain for the truth',0,2,4,41,3,8,0,45,0
Magic GM Rob Hennigan Responds to Trade and Free-Agency Big-Board Leak,0,2,12,46,2,10,0,58,0
The Dangal Effect! How Phogat Sisters Are Inspiring Schoolgirls To Take Up Amateur Wrestling In Kerala,0,3,16,70,1,15,0,86,0
I Ignored Trump News for a Week. Here’s What I Learned. ,0,2,9,33,3,11,0,42,0
Oklahoma lawmaker wants to protect people who destroy drones flying on their property ,0,3,1,72,0,13,0,73,0
9/11 health care bill passed in US House of Representatives,0,1,4,42,1,9,3,46,0
This Heroic Pup Jumped In Front Of A Bus To Save His Blind Owner,0,2,14,37,0,13,0,51,0
Ryan Adams Cancels ACL Live Performance at SXSW Due to Illness,0,3,14,38,0,10,0,52,0
Florida airport shooting: Suspect Esteban Santiago had confiscated gun returned after FBI visit,0,3,7,75,1,12,0,82,0
"‘Vigilante’ phone app alerts New York users to crime, but police not thrilled",0,2,3,59,3,12,0,62,0
So you want to preserve the liberal international order …,0,2,1,46,1,9,0,47,0
Florida Medical Marijuana Sales Could Rival Colorado By 2020,0,2,8,40,0,8,4,48,0
"Helicopter Carrying Injured Skier Crashes in Italy, Killing 6 ",0,3,7,44,1,9,1,51,0
Henry A. Waxman,0,1,3,9,1,2,0,12,0
UK car crash in Leicestershire kills six,0,1,3,31,0,6,0,34,0
Madonna confirms adoption of twins with heartwarming Instagram post,0,3,2,57,0,8,0,59,0
4 Bodies Found in Maryland Hotel,0,1,4,22,0,5,1,26,0
Power Rankings: Warriors own the weekend; Heat rise into the top 10,0,3,4,48,2,11,2,52,0
13 Survivors Share Their Memories Of Sexual Assault & No Words Can Describe How It Feels,0,3,14,56,1,15,2,70,0
Trump Team Considering Another Goldman Executive for Key Treasury Post,0,3,9,52,0,9,0,61,0
Mathematics summer school in Turkey threatened by authorities,0,1,2,52,0,7,0,54,0
"As Jobs Vanish, Motel Rooms Become Home",0,1,7,25,1,6,0,32,0
Cricketers Are Dropping Like Dominoes When It Comes To Marriage & It's All Starting On Twitter!,0,2,15,62,3,15,0,77,0
University of Calgary scientist Keith cracks carbon capture conundrum,0,1,3,58,0,8,0,61,0
State Department ups reward for ISIS leader to $25 million,0,3,6,40,1,9,2,46,0
Tibetan Monks Tell Tale of Escape From China,0,1,7,30,0,7,0,37,0
Tom Brady Leads the Patriots to Historic Victory,0,2,6,35,0,7,0,41,0
Microsoft Windows metafiles are a vector for computer viruses,0,1,2,51,0,8,0,53,0
Gift of footballs from United States offends Afghans inadvertently,0,1,4,54,0,8,0,58,0
Merck just leapt ahead of its rivals in the lung cancer drug race,0,2,1,52,0,12,0,53,0
Super Bowl Glare Fixes Attention on Texas ‘Bathroom Bill’,0,3,8,39,2,8,0,47,0
Suicide bomber kills 24 children in Iraq,0,1,2,30,0,6,2,32,0
"3 reasons to treat Dow 21,000 with caution",0,2,1,27,1,7,6,28,0
Oscars mistake puts consulting firm's reputation in jeopardy,0,3,1,51,1,7,0,52,0
"He had a ‘bad dream’ that his wife was cheating. Then he violently beat her, police say.",0,3,2,65,5,16,0,67,0
"Donald Trump Won’t Release Tax Returns, Aide Says",0,3,8,32,2,7,0,40,0
United Has Changed Its Policy for Overbooking Flights and Removing Passengers,0,2,9,58,0,10,0,67,0
Apple Wants Original Programming to Expand Its Music Service,0,3,8,44,0,8,0,52,0
Powerful Beauty Ad in India Sends Message About Domestic Violence,0,2,9,47,0,9,0,56,0
"LeBron James Thriving Without Other Stars, and We Should No Longer Be Surprised",0,3,13,53,1,12,0,66,0
College Basketball Wright State's Steven Davis Throws Down Poster Dunk All Over Urbana Defender,0,2,14,67,1,13,0,81,0
Tartan Day festivities April 6 in New York,0,1,5,29,0,7,1,34,0
Secret Service officers reportedly posted at White House without proper clearance ,0,3,4,67,0,11,0,71,0
A Christmas homecoming,0,3,2,18,0,2,0,20,0
Bomb Blast Kills Tourist in Cairo,0,1,5,23,0,5,0,28,0
"Clean energy subsidies could be used to build new coal power plants, Scott Morrison says",0,3,3,70,1,14,0,73,0
U.S. Embracing a New Approach on Battling ISIS in Iraq ,0,3,11,32,2,10,0,43,0
Art From Banned Countries Takes Center Stage At The MoMa,0,2,11,36,0,9,0,47,0
Chaos and panic: Deadly floods bring fear over escaped zoo animals   ,0,3,2,53,1,13,0,55,0
Kareena & Sonam Kapoor Bring The House Down With Their Sassiness In This 'Koffee' Teaser!,0,3,14,57,4,14,0,71,0
Google Earth gets a mobile-friendly makeover,0,2,2,36,1,5,0,38,0
Stop oppressing Cornwall – Council of Europe's warning to Britain,0,3,5,49,2,9,0,54,0
Putin’s Sassy Trolling Was Sending Message to Trump: Experts,0,2,8,42,2,8,0,50,0
"Great little ski resorts: Val d’Arly, France",0,2,4,31,3,6,0,35,0
Senate Scraps Automatic Raise,0,1,4,22,0,3,0,26,0
Donald Trump Claims 100 Percent Of His Foundation's Money Goes To Charity. That's A Lie.,0,3,14,53,4,14,3,67,0
"In a First, U.S. Provides Pakistan With Drone Data",0,1,9,30,3,8,0,39,0
Woman Catches Her Husband Cheating Using the 'Find My iPhone' App,0,3,10,43,2,10,0,53,0
Donald Trump doubles down on 'enemies of the people' attack on media,0,3,2,53,2,11,0,55,0
White House blasts Trump team for secrecy that 'only serves to sow public doubt',0,3,3,62,2,13,0,65,0
"The Good Friday sacrifice shows us what we, too, are capable of",0,3,3,47,2,11,0,50,0
One in ten teachers taking antidepressants to cope with work stresses,0,3,1,58,0,10,0,59,0
"It’s not just Donald Trump feuding with the courts. States are doing it, too.",0,2,4,56,4,13,0,60,0
The Vice  and the  Virtue of Marketing,0,1,4,26,0,8,0,30,0
Can prefab homes solve UK's housing crisis?,0,3,3,32,2,6,0,35,0
"Britain to trigger Brexit process on March 29, gov't says ",0,2,3,41,2,10,2,44,0
Unilever-Colgate? Unilever-Nestle?,0,3,4,25,4,1,0,29,0
Charlie Murphy has died at 57,0,3,2,20,0,5,2,22,0
Barely Half of 30-Year-Olds Earn More Than Their Parents,0,2,9,35,2,8,2,44,0
"Stun gun found on JetBlue flight in Newark, New Jersey",0,1,6,38,1,9,0,44,0
Facebook Once Again Blames Controversial Takedown On Technical Issues,0,2,9,52,0,8,0,61,0
"Nat Hentoff, Columnist and Jazz Critic, Dies at 91",0,3,6,32,2,8,2,38,0
Preparing for a Flood of Energy Efficiency Spending,0,1,5,39,0,7,0,44,0
Watch John Legend Make Shopping at Costco and Doing Laundry Sound Super Sexy,0,2,11,53,0,12,0,64,0
Sources: Enes Kanter could miss up to 2 months after X-rays reveal fractured forearm,0,2,4,64,2,13,1,68,0
A new law in Turkey offers citizenship to foreign investors who buy property there,0,2,2,67,0,13,0,69,0
J.J. Watt Impresses Arnold Schwarzenegger with Spot-on Governator Impression,0,2,9,56,3,8,0,65,0
Wendy’s Tweeted (And Quickly Deleted) A Pepe Meme,0,3,8,31,3,7,0,39,0
"In a Twitter rant, billionaire Mark Cuban tells Clinton how to become more likeable",0,2,5,64,1,13,0,69,0
Juelz Santana & Dave East Hit the Streets in 'Time Ticking' Feat. Bobby Shmurda & Rowdy Rebel: Watch,0,3,14,63,6,17,0,77,0
"Adani: Prime Minister Malcolm Turnbull meets with chairman, reiterates support for mine",0,2,5,69,2,11,0,74,0
‘Weed Nuns’ Are Holy Rollers on Mission to Empower Women With Marijuana Products,0,3,11,55,2,12,0,66,0
U.S. Proposal Considers Prosecuting Parents Helping Children Entering Country Illegally ,0,3,11,65,2,10,0,76,0
Bus Accident Injures Passengers in Lincoln Tunnel,0,3,6,37,0,6,0,43,0
United Nations: More people with access to cell phones than toilets in India,0,1,4,59,1,12,0,63,0
Jack Dorsey: Twitter Lacked 'Focus And Discipline' For Growth,0,3,9,41,3,8,0,50,0
"George H.W. Bush, 92, Returns Home After Being Hospitalized for Pneumonia",0,2,10,47,4,10,2,57,0
2007/08 UEFA Women's Cup: FFC Frankfurt vs. Umeå IK,0,1,13,20,4,8,6,33,0
France warns of war with Iran,0,1,2,22,0,5,0,24,0
Little Debbie Crackers Join List of Peanut Butter Recalls,0,1,8,41,0,8,0,49,0
"Turkey, Russia and an Assassination: The Swirling Crises, Explained ",0,3,7,49,3,9,0,56,0
Flexible displays soon to be in production,0,1,1,35,0,6,0,36,0
Paris police revive woman declared dead for an hour by paramedics,0,2,1,54,0,10,0,55,0
"Russia-Australia relations in state of frozen disagreement over Crimea, MH17",0,2,5,58,2,9,2,63,0
"Sammy Hagar Talks SXSW, a Van Halen Reunion and Making Tequila With Adam Levine",0,3,15,50,1,13,0,65,0
"Treasuries Fall, Stocks Mixed as Commodities Gain: Markets Wrap",0,2,8,45,2,8,0,53,0
Report blames New Zealand skydive plane crash that killed nine on overloading,0,1,3,63,0,11,0,66,0
Chartbreaker: Judah & the Lion Talk Their Surprise Chart Hit & Opening for Twenty One Pilots,0,2,12,62,3,15,0,74,0
"Be Willing To Dismantle Stereotypes, Urges IBM Exec",0,3,10,33,1,7,0,43,0
Why Trump’s Poor Start Matters,0,3,5,20,1,4,0,25,0
Trump voters taking hit? Health bill estimates show seniors facing high costs ,0,3,2,63,1,12,0,65,0
Don’t worry about Brexit – worry about the Great Repeal Bill that comes after it,0,2,5,59,2,14,0,64,0
C.J. McCollum Reportedly Cut Off Festus Ezeli in the Middle of His Inspirational Speech,0,3,13,59,2,13,0,72,0
Japan announces moon program,0,1,1,24,0,3,0,25,0
Experts fear for the health of London whale,0,1,2,34,0,7,0,36,0
Catalan ex-leader Artur Mas banned from office over illegal referendum,0,3,3,57,1,9,0,60,0
"Amid New Faces, Alissa Czisny Is First in Short Program",0,1,9,36,1,9,0,45,0
"Samsung Is Planning To Sell Refurbished Galaxy Note 7 Phones, Swears They Are Safe This Time",0,3,15,60,1,15,1,75,0
"Ethics office director says proper vetting of ultrawealthy Cabinet nominees can take weeks, months",0,2,2,82,1,13,0,84,0
Bite the dust: Meek dinosaur lost its teeth as it hit adulthood,0,3,2,49,1,11,0,51,0
"20 Years Later, Dateline’s Keith Morrison Reflects on Covering Gianni Versace’s Murder",0,3,10,60,3,11,2,70,0
Headed to New York for the holiday window displays? Follow this insider advice.,0,3,4,61,2,12,0,65,0
"Americans Need To Know Trump's Endgame For Syria, Duckworth Tells Constituents",0,2,11,55,2,10,0,66,0
"EU 'leaving migrants to drown' say rescuers who saved 2,000 from Mediterranean in single day",0,3,3,68,3,14,4,71,0
Shooting in Finnish mall leaves four dead,0,1,2,33,0,6,0,35,0
Fresh floods in India claims sixteen lives,0,1,2,34,0,6,0,36,0
I.M.F. Puts Bank Losses From Global Financial Crisis at $4.1 Trillion,0,1,11,41,5,10,2,52,0
Don Lemon On Sean Spicer: Everyone 'Is Dumber For Having Listened To That',0,3,13,46,3,12,0,59,0
How to ditch your ugly parka and still stay toasty this winter,0,2,1,50,0,11,0,51,0
"Caterpillar Turns Corner, Boosts Outlook",0,2,5,30,1,4,0,35,0
"PM Modi Calls UP Victory The Emergence Of A New India, Launches #IAmNewIndia Pledge On NaMo App",0,3,23,54,2,16,0,77,0
Swimmers defy wetsuit warning ahead of hottest day of the year ,0,3,1,51,0,11,0,52,0
Prince George to attend private day school where best friends are 'banned',0,3,2,59,2,11,0,61,0
"Supercross: Stewart wins 4th consecutive Monster Energy event in San Francisco, California",0,1,7,69,2,11,1,76,0
U.S. Official’s Diplomatic Line in Mexico Differs From Trump’s,0,3,9,41,4,8,0,50,0
"In Security Shuffle, White House Merges Staffs",0,1,7,32,1,6,0,39,0
"As Isiah Thomas Resurfaces, Knicks Rebuild a Franchise",0,1,7,39,1,7,0,46,0
Health Care Is Front and Center in Democrats’ Response to Trump Address ,0,3,9,50,1,12,0,59,0
"Climate change is NOT to blame for polar bears breeding with grizzly bears, study claims",0,3,4,69,1,14,0,73,0
Stocks Retreat as Risk Appetite Wanes,0,2,5,27,0,5,0,32,0
Israeli airstrikes damage more offices housing international journalists in Gaza City,0,1,3,72,0,10,0,75,0
APEC closes in Sydney,0,1,5,13,0,3,0,18,0
"Hincapie Jumps to Second, but It Was Nearly First",0,1,7,33,1,8,0,40,0
Malcolm Turnbull to take lead on economy from Scott Morrison; Cabinet reshuffle looming,0,3,5,69,1,12,0,74,0
"Donald Trump, After Dismissing Hacking, Agrees to an Intelligence Briefing ",0,3,8,55,2,10,0,63,0
"Putin critic says he's one of the lucky ones: ""I'm still here""",0,3,2,44,5,11,0,46,0
Has South Korea really hired an official to monitor Donald Trump's tweets?,0,3,5,56,2,11,0,61,0
Goldman Sachs Introduces Real-Time Employee Performance Reviews,0,3,8,48,1,6,0,56,0
Appy New Year: the best apps to help you achieve your resolutions for 2017,0,2,3,53,1,13,4,56,0
"Republicans divided on Russia probe, calls for special prosecutor over AG Sessions ",0,2,5,65,1,12,0,70,0
Cyclone Debbie: What to do in the storm's aftermath,0,3,3,38,2,8,0,41,0
Barack Obama to visit Scotland for charity fundraiser,0,3,3,43,0,7,0,46,0
George Osborne to start selling off Royal Bank of Scotland,0,2,5,44,0,9,0,49,0
Spotify Hires a Group of Blockchain Developers,0,2,5,35,0,6,0,40,0
Trump's America Donald Trump: What will the President's new executive order look like?,0,3,6,64,4,12,0,70,0
Number of EU care workers in UK surges,0,3,5,26,0,7,0,31,0
"Bomb blast kills 5 policemen in Islamabad, Pakistan",0,1,3,39,1,7,1,42,0
Clinton’s former CIA chief defends Trump on intel briefings,0,2,5,45,1,8,0,50,0
The Most Powerful Brands In 2017,0,3,5,18,0,5,4,23,0
Iraq election commission refuses recount of votes from parliamentary election,0,1,1,67,0,9,0,68,0
Volleyball games appear to take place at North Korean nuclear test site,0,2,3,57,0,11,0,60,0
"Trump Defends His Immigration Ban Amid Uncertainty, Public Outcry",0,2,9,47,1,8,0,56,0
Ally Brooke Hernandez Drops Hints About Fifth Harmony's New Album,0,3,10,45,1,9,0,55,0
These students are pedaling their way to success,0,3,1,40,0,7,0,41,0
See SpaceX's Falcon 9 Rocket Launch,0,2,6,22,1,5,1,28,0
U.S. Soccer Team Prizes Cohesion in Quest for World Cup,0,1,9,35,2,9,0,44,0
"Iraqi forces in Mosul performing 'at their peak', says US commander",0,3,4,50,3,10,0,54,0
Blooming cherry blossoms help Tokyo shake off winter blues,0,3,2,48,0,8,0,50,0
Pakistani Offensive Puts Truce on Shakier Ground,0,1,6,36,0,6,0,42,0
Lance Armstrong shares criticisms of Tour de France director,0,1,4,48,0,8,0,52,0
Castro's Death Celebrations Collide With Art Basel Miami ,0,3,8,40,1,8,0,48,0
Help for Middle-of-the Night Insomnia,0,3,4,27,2,4,0,31,0
Necessary: ’Can’t Stump the Trump’ Takes a Victory Lap - Breitbart,0,2,8,43,5,10,0,51,0
"Seven-year-old girl killed in Detroit, Michigan police raid",0,1,3,46,3,7,0,49,0
Oysters grown on old toilets being used to clean city waters,0,2,1,49,0,10,0,50,0
Why Obamacare could be the messiest battle of 2017,0,3,2,36,0,8,4,38,0
How Perfectionism Is Sabotaging Your Career,0,3,6,32,0,5,0,38,0
Huge 'Logan' opening might not beat 'X-Men Origins: Wolverine',0,3,6,42,6,8,0,48,0
Trump Is Already Taking Credit For The Economy. Here's Why It Could Backfire.,0,2,13,49,3,12,0,62,0
Debate breaks out over North Carolina billboard,0,2,3,38,0,6,0,41,0
Florida Sen. Marco Rubio Grilled Over Absence From Town Halls,0,3,10,41,1,9,0,51,0
Automobile manufacturer Ford posts unexpected profits,0,1,2,46,0,5,0,48,0
Fiat Gives Detroit a Lesson on Small Cars,0,1,6,28,0,7,0,34,0
Rapper T.I.: Trump a ’Poster Child For White Supremacy’,0,2,9,33,5,8,0,42,0
Here's what that 'No. 2' on your pencil actually means,0,3,2,38,4,9,1,40,0
Pentagon Seeks to Avert Low-Ball Bids on Development Contracts,0,2,8,45,1,8,0,53,0
Tropical Storm Danielle forms in Atlantic Ocean,0,1,5,36,0,6,0,41,0
Belgium's Queen Fabiola seriously ill,0,1,3,29,1,4,0,32,0
Interview with US political activist and philosopher Noam Chomsky,0,1,5,52,0,8,0,57,0
"Amid calls for recusal, House Intel chairman Devin Nunes digs in",0,3,5,48,1,10,0,53,0
"School on Australia's Sunshine Coast makes staff redundant, requests they apply for 'new' jobs",0,1,4,73,4,13,0,77,0
"‘Star Wars’ Actress Carrie Fisher Suffers Heart Attack on a Plane, Sources Say",0,3,11,52,3,12,0,63,0
Religious Liberty Must Be Respected and Protected,0,2,6,37,0,6,0,43,0
"Survey: 69% Of Americans Have Less Than $1,000 In Savings [Infographic]",0,3,9,40,6,10,6,49,0
Afghan presidential candidate Karzai wins majority of votes,0,1,2,50,0,7,0,52,0
Worst humanitarian crisis hits as Trump slashes foreign aid,0,2,2,49,0,8,0,51,0
U.N. Official Accuses Syria of Blocking Aid Deliveries During Cease-Fire,0,2,11,49,3,9,0,60,0
The New Cover For Marvel’s Queer Latina Superhero Comic Is Dope As Hell,0,3,13,45,1,12,0,58,0
See Beyonce's Fierce & Flashy Video Christmas Card,0,3,7,34,2,7,0,41,0
Inside Kirk Cousins' Season of Uncertainty,0,3,5,31,1,5,0,36,0
Georgia student in police beating video says he feared for his life,0,2,1,55,0,11,0,56,0
"Colegio Preciosa Sangre, Pichilemu, amidst other Chilean schools celebrate Student's Day",0,1,7,68,3,10,0,75,0
"The best countries in the world? Switzerland, Canada and UK top 2017 list",0,3,5,50,2,12,4,55,0
Senator Arlen Specter challenges President Bush,0,1,5,37,0,5,0,42,0
Quebec's Liberal premier Jean Charest wins third term,0,1,4,41,1,7,0,45,0
"At M.I.T., Large Lectures Are Going the Way of the Blackboard",0,1,10,37,4,10,0,47,0
The Dissonant Undertones of M.I.A.,0,1,6,21,3,4,0,27,0
Hawaii's Attorney General: Religious hostility 'violates constitution',0,3,4,56,4,6,0,60,0
Gentle Questioning for U.N. Nominee,0,1,5,24,2,4,0,29,0
Who Won the Battle for Cheapest Tax Prep in 2017?,0,3,6,29,1,9,4,35,0
U.S. Agencies Advised to Release Information to Public,0,1,7,38,2,7,0,45,0
Judge Orders Michigan Recount to Begin at Noon Monday ,0,3,7,38,0,9,0,45,0
"Obama And Putin Still Can’t Agree On Syria And, Boy, Do They Hate Each Other",0,2,15,44,3,14,0,59,0
Roddick Sculptures Another Win in Paris,0,1,5,29,0,5,0,34,0
Serena Williams Is 20 Weeks Pregnant,0,3,5,24,0,5,2,29,0
Obama questions why Supreme Court took up Obamacare challenge,0,2,4,49,0,8,0,53,0
"Robin Williams' Widow Shares His Struggles, Talks Brain Diseases With Biotech CEOs",0,3,14,55,2,11,0,69,0
Eight Years Later: The Economy and President Obama’s Legacy,0,2,8,41,2,8,0,49,0
Woodside Petroleum waiting on Australia-East Timor maritime deal to develop Greater Sunrise,0,3,7,72,1,11,0,79,0
Stewart Wins a Nascar All-Star Race for the First Time,0,1,8,36,1,9,0,44,0
Israeli army reoccupies Tulkarem in West Bank,0,1,4,35,0,6,0,39,0
Trump Says New Vetting Will Keep ‘Radical Islamic Terrorists’ Out Of U.S.,0,3,13,45,4,11,0,58,0
Savings Plan: 5 Smart Steps,0,1,4,17,1,4,1,21,0
New 'Fargo' trailer gives us double the Ewan McGregor,0,2,5,38,2,8,0,43,0
American Keith Broomfield Killed Fighting Against ISIS in Syria,0,3,11,44,0,8,0,55,0
37-year-old who says she can’t get a lawyer job after applying to 150 firms loses her lawsuit against her school,0,2,0,85,3,19,5,85,0
"Disabled, Shunned and Silenced in Trump’s America ",0,2,5,36,2,7,0,41,0
Fantasy baseball: Top 300 rankings for rotisserie leagues,0,3,2,44,1,7,3,46,0
Paul Ryan had the Worst Week in Washington,0,2,5,30,0,7,0,35,0
That's How White House Staff Played A Scary Christmas Prank On US President Barack Obama,0,3,16,57,1,14,0,73,0
"Washington, D.C. sniper John Allen Muhammad executed by lethal injection",0,1,6,54,3,9,0,60,0
"Fans boo Chargers' logo, Jeff Cumberland at Lakers-Clippers game",0,2,6,47,3,8,0,53,0
"Just A Reminder That Women Dominate Pop Music, But Still Rarely Produce It",0,3,13,48,1,12,0,61,0
Chapecoense crash: Grieving Brazilian town of Chapeco receives bodies from soccer plane crash,0,2,4,76,1,12,0,80,0
"When Stars Twitter, a Ghost May Be Lurking",0,1,7,27,1,7,0,34,0
Trump Team Leery of Having Too Many ‘Goldman Guys’ in Top Posts,0,3,10,40,2,11,0,50,0
"With Tour De France, Gallic Pride Fades in the Saddle",0,1,8,35,1,9,0,43,0
Theresa May wins Commons backing for 8 June general election,0,3,4,46,0,9,1,50,0
Security stepped up on Los Angeles rail system after reported threat ,0,3,3,55,0,11,0,58,0
Trump Campaign on Clinton Speech: What You Expect from Someone ’Losing the Election’ - Breitbart,0,2,11,67,4,14,0,78,0
British spies removed from operations after Russia and China crack codes to leaked Snowden files,0,3,4,78,0,14,0,82,0
Democratic Aides See Possibility for Compromise With GOP on Modest Changes to Financial Laws,0,2,13,66,0,13,0,79,0
Elon Musk says he's 'doing good' on Trump's advisory council,0,3,3,44,4,9,0,47,0
This Dog Who Lost Her Puppies Is So Excited To Be Caring For These Orphaned Puppies,0,3,16,52,0,15,0,68,0
Dead gator in Florida dorm room means warning for students ,0,3,2,47,0,10,0,49,0
People Are Dragging Paul Ryan After He Dabbed At A Town Hall On Repealing The Affordable Care Act,0,2,18,62,0,17,0,80,0
"Volcanic eruption starts on top of Eyjafjallajökull, Iceland",0,1,3,49,1,7,0,52,0
Hundreds of whales dead after mass stranding in New Zealand,0,2,3,47,0,9,0,50,0
"Starting In 2017, French Workers Will Be Legally Protected From Off-Hours Work Email",0,3,13,53,2,12,4,66,0
"Mário Soares, Central Player in Portugal’s Transition to Democracy, Dies at 92",0,3,8,54,3,11,2,62,0
Well It Happened Again: People Tried To Criticize Chrissy Teigen For Her Parenting,0,3,13,56,1,12,0,69,0
When 69-year-old Gordie Howe suited up and gave fans a last show,0,2,3,46,2,11,2,49,0
Biden Questions Vote but Sticks to Policy on Iran,0,1,6,35,0,8,0,41,0
Gunman on the loose in Melbourne,0,1,2,25,0,5,0,27,0
Four Ways NOAA Benefits Your Life Today,0,3,10,23,0,6,0,33,0
Over 30 killed in Mexico dynamite truck explosion,0,1,2,38,0,7,2,40,0
"Jayalalithaa Suffers A Heart Attack, Health Critical. Tamil Nadu On The Edge, Riot Police On Standby",0,3,16,66,3,15,0,82,0
British people are losing their minds over 2016's final insult,0,3,1,47,1,9,4,48,0
Orioles' Palmeiro gets mixed baseball fan greeting,0,1,2,41,1,6,0,43,0
Trump-Lewis feud could be harbinger of new round of hyper-partisanship,0,3,2,57,2,9,0,59,0
China launches its first private airline,0,1,1,34,0,5,0,35,0
Donald Trump's Inauguration Singer Speaks Out Against Transgender Bathroom Bills,0,3,10,60,1,9,0,70,0
Lawmakers push to revive oil drilling in Alaska wildlife refuge,0,3,2,52,0,9,0,54,0
Tear gas fired over Peru toll booths,0,3,2,28,0,6,0,30,0
Screen Actors Guild to Take Strike Vote,0,1,6,27,0,6,0,33,0
"Palestinian election ends, exit polls give Abbas lead",0,1,2,43,1,7,0,45,0
CEOs Face Uneasy Test of Doing Business Under Trump,0,2,10,33,0,8,0,43,0
"Norma McCorvey, ‘Roe’ in Roe v. Wade, Is Dead at 69 ",0,2,8,26,5,11,2,34,0
Do Blobs on Phoenix Lander Indicate Water on Mars?,0,1,7,34,1,8,0,41,0
"In Britain, Web Has Media Law Playing Catch-Up",0,1,9,28,2,7,0,37,0
7.0 magnitude earthquake strikes off Haitian coast,0,1,1,40,1,6,2,41,0
The Art of Managing to Preserve Your Job,0,1,6,27,0,7,0,33,0
Men in 3 Florida counties warned not to donate sperm,0,3,2,40,0,9,1,42,0
Bernie Sanders Is Still Raising Too Much Money,0,2,8,31,0,7,0,39,0
What it’s like to live in a monastery,0,2,1,28,1,7,0,29,0
"In Tehran, a Mood of Melancholy Descends",0,1,5,28,1,6,0,33,0
Wikinews interviews U.S. Libertarian presidential candidate Bob Jackson,0,1,6,56,2,7,0,62,0
Win in Finale Helps Devils Forget Losing Streak,0,1,7,33,0,7,0,40,0
Paul Manafort Is Back,0,2,4,14,0,3,0,18,0
The Guardian view on social change: seeing what’s in front of us,0,3,2,49,2,11,0,51,0
Where Is The 'Phenomenal' Tax Plan President Trump Promised?,0,2,9,40,3,8,0,49,0
Four Americans Killed as Plane Crashes Into Australian Shopping Mall,0,3,9,50,0,9,0,59,0
Iraqi Shoe Thrower Gets Three Years,0,1,6,24,0,5,0,30,0
Kanye West Vibes Out to deadmau5's 'Snowcone' in Pete Rock's Studio: Watch,0,3,9,48,5,11,1,57,0
UK transport firm Metronet facing administration,0,1,3,40,0,5,0,43,0
"Man killed in harbour car crash in Cornwall, England",0,1,3,40,1,8,0,43,0
Brexit Isn’t First Fight for Gina Miller and ‘Mr. Hedge Fund’,0,3,9,38,4,10,0,47,0
Baghdad car bomb kills at least 48,0,2,1,25,0,6,2,26,0
Tory MP in 90-minute attempt to talk out domestic violence bill,0,3,3,47,1,10,2,50,0
Bush crashes his bike into Scottish police officer,0,1,2,41,0,7,0,43,0
World's Saddest Trump Rally Draws Just 8 Supporters,0,3,7,35,1,7,1,42,0
Viewed wins the 2008 Melbourne Cup,0,1,3,22,0,5,4,25,0
"A Year After Storm, Subtle Changes in Myanmar",0,1,7,30,1,7,0,37,0
US military launches investigation of strike near mosque in Syria,0,3,3,53,0,9,0,56,0
"Watch Prince Royce Give Sneak Peek of New Album 'Five,' Featuring Zendaya, Chris Brown & More",0,3,14,59,5,15,0,73,0
Tourists Gone Wild ,0,3,3,13,0,3,0,16,0
Trump to hold campaign-style rally in Florida,0,3,2,36,1,6,0,38,0
Trump Inauguration Security Planners Brace for Wave of Protesters ,0,3,7,50,0,9,0,57,0
Judge Backs Charges Against Cleveland Officers in Killing of Tamir Rice,0,2,9,52,0,10,0,61,0
'La La Land': 5 Echoes of Classic Hollywood Musicals,0,2,7,33,3,8,1,40,0
Airbnb: NSW Government gives qualified support to lifting bans on short-term rentals,0,3,5,66,2,11,0,71,0
United Takes Added Steps to Win Back Customers and Avoid More Ugly Events ,0,3,11,50,0,13,0,61,0
"Four-storey building collapses in Lagos, Nigeria; two dead",0,1,3,45,3,7,0,48,0
"One dead after Mt Warning campers struck by lightning, rescue operation underway",0,2,3,65,1,11,0,68,0
Southern Hemisphere Rugby Trounces North Yet Again,0,1,7,37,0,6,0,44,0
Swimmers defy wetsuit warning ahead of hottest day of the year ,0,2,1,51,0,11,0,52,0
High school teacher's Facebook page 'urged people to vote for Donald Trump so Muslims could be butchered',0,3,5,81,3,16,0,86,0
Sistagirls do Mardi Gras: Indigenous trans community crowdfunds for pride parade,0,2,4,65,1,10,0,69,0
Air China suspends flights to Pyongyang,0,3,3,31,0,5,0,34,0
Building a Mind-Controlled Wheelchair,0,2,4,29,1,3,0,33,0
NASA Satellite Fails to Reach Orbit,0,1,8,22,0,5,0,30,0
"Man suspected in Amber Alert had been previously deported, immigration officials say ",0,2,3,69,1,12,0,72,0
Kylie Jenner Getting Her Own Spin-Off 'Life of Kylie',0,3,9,33,3,8,0,42,0
UFC's Dana White: I think Mayweather-McGregor will happen,0,2,9,38,3,7,0,47,0
Obama sends more Special Forces to Syria in fight against IS,0,2,6,44,0,10,0,50,0
US officials accused of covering up human deaths from BSE and discouraging testing of suspected animals,0,1,5,83,0,15,0,88,0
Kate Winslet calls out body shamers in talk,0,3,2,34,0,7,0,36,0
"Battle for Mosul: Iraqi forces reach second bridge, storm strategic university complex, military chief says",0,2,3,87,3,14,0,90,0
"Right On Cue, Soros-Financed MoveOn.Org Holds DC Protest Demanding Sessions’ Resignation",0,2,15,59,4,10,0,74,0
"Guy Philippe, Haiti's former rebel leader, arrested after radio show",0,3,3,53,3,9,0,56,0
Patricia Smith: Hillary Clinton ‘Treats Me Like Dirt’ Because ‘I’m a Nobody’ -- ‘Why Doesn’t She Just Tell Me the Truth?’,0,2,18,71,12,20,0,89,0
American television producer Sherwood Schwartz dies aged 94,0,1,3,47,0,7,2,50,0
Dutrow Nurtures a Dream to Return to the Kentucky Derby,0,1,6,40,0,9,0,46,0
UK animal welfare group prosecutes woman who threw cat into bin,0,1,2,51,0,10,0,53,0
Shaquille O'Neal To Pay For Funeral Of Boy Who Accidentally Shot Himself On Instagram,0,3,15,56,1,13,0,71,0
'Completely irresponsible' woman called emergency services to report theft of snowman,0,1,1,72,2,10,0,73,0
FDA Warns on Abbott’s St. Jude Pacemakers and Defibrillators   ,0,2,9,41,2,11,0,50,0
Snapchat Snaps Back at Ex-Employee's Lawsuit,0,2,6,31,2,5,0,37,0
Red panda cubs frolic in the snow,0,3,1,26,0,6,0,27,0
Missouri governor-elect says wife robbed at gunpoint near home,0,3,1,52,1,8,0,53,0
What the UN vote says about how Trump will treat Israel,0,3,5,40,0,10,0,45,0
"Canada Welcomes Refugees Yet Again, Provides Them Temporary Housing Permits Amid US Travel Ban",0,2,15,65,1,13,0,80,0
Capturing the swarm,0,2,1,16,0,2,0,17,0
Gordon Brown makes speech as part of Labour Party conference,0,1,4,47,0,9,0,51,0
Half the world's species failing to cope with global warming as Earth races towards its sixth mass extinction,0,2,2,89,1,17,0,91,0
"As Mexican Killings Rise, Groups Take Envoy to Task",0,1,8,34,1,8,0,42,0
Credit Crisis Is Leaving Charities Low on Cash,0,1,7,32,0,7,0,39,0
Everything but football: the best ads from Super Bowl Sunday and Lady Gaga – as it happened,0,3,6,67,2,16,0,73,0
"Former Cowboy Tony Romo: Now Lining Up Behind the Golf Ball, Fails in US Open Bid - Breitbart",0,2,16,57,3,17,0,73,0
Plan to Kill Lions to Protect Deer,0,1,5,23,0,6,0,28,0
Govt Says That Pollution Is Not The Only Reason Behind As Many Deaths As Global Report Suggests,0,3,17,62,0,16,0,79,0
F.D.A. Approves a Stem Cell Trial,0,1,7,18,3,5,0,25,0
"Hill Republicans want answers. On Wednesday, Trump gave them only more questions — and fresh headaches.",0,3,5,79,4,15,0,84,0
Watch the First Trailer for the New Non-Disney Live-Action 'Little Mermaid' Film,0,2,11,54,4,11,0,65,0
The European Winter Is So Harsh That A Fox Got Frozen After Falling Into A River In Germany,0,2,18,56,0,17,0,74,0
"Protesters Shut Down UC-Davis Event Featuring Milo Yiannopoulos, 'Pharma Bro'",0,3,12,52,4,9,0,64,0
The Atlantic Politics & Policy Daily: The Boys are CPAC in Town,0,2,12,38,2,11,0,50,0
Sabathia Returns to Cleveland With His Best Stuff,0,1,7,35,0,7,0,42,0
Bus carrying 21 passengers is nearly swallowed by a giant sinkhole in China as a busy road suddenly collapses,0,3,2,87,0,18,2,89,0
Over 200 skiers trapped as lift breaks at Maine resort,0,1,2,40,0,9,3,42,0
Albanian girl murdered in tangle of crime,0,1,1,34,0,6,0,35,0
Journal Articles Question Plan for Digital Health Records,0,1,7,43,0,7,0,50,0
Gawker’s bankruptcy sale down to the wire,0,2,1,33,1,6,0,34,0
New Insights Into Prince Charles ,0,2,5,23,0,5,0,28,0
Iran 'will not instigate hostilities' - foreign minister,0,3,1,45,3,7,0,46,0
Neil Gorsuch regrets to inform the Senate that he is not God,0,3,4,45,0,11,0,49,0
"Jews, Muslims And Indian Americans Unite Against Hate Crimes In The US",0,3,13,45,1,11,0,58,0
Sia Files for Divorce From Filmmaker Erik Anders Lang,0,3,8,37,0,8,0,45,0
Metrics 101: Ranking the Best Benches in the NBA,0,2,7,29,1,8,3,36,0
Shimla Is Covered In A Thick Blanket Of Snow And We Want Nothing More Than To Be There!,0,2,18,51,1,17,0,69,0
41 killed by suicide bombing near Pakistan's Swat valley,0,1,2,43,1,8,2,45,0
Sudan and Darfur Rebel Group Agree to Peace Talks,0,1,7,34,0,8,0,41,0
Factory Production in U.S. Falls Most Since August on Autos,0,2,9,39,2,9,0,48,0
"""Real Housewives of Beverly Hills"" star Kim Richards says she dated Donald Trump",0,3,8,58,2,12,0,66,0
Crazy boxing champ: Wladimir Klitschko ‘is bisexual’,0,2,3,40,3,6,0,43,0
"Microbes in glittering cave revived after 10,000 years, scientists say",0,2,1,53,2,9,5,54,0
Eight Afghan policemen from one family killed by colleague,0,2,2,48,0,8,0,50,0
"Poll shows American youth more politically active, socially liberal",0,1,2,56,1,8,0,58,0
Jay Z Becomes First Rapper Chosen for Songwriters Hall of Fame,0,3,9,43,0,10,0,52,0
Fisherman survives six-hour ordeal in remote waters off Australia,0,3,2,54,1,8,0,56,0
Report: Corey Lewandowski Lands CNN Gig - Breitbart,0,2,9,33,2,7,0,42,0
This Is the Best Trench Coat for Men,0,3,6,23,0,7,0,29,0
Was Penn State's explosive comeback enough for playoff bid?,0,2,3,46,2,8,0,49,0
Maryland Pulls Away From Duke in 2nd Half,0,1,6,27,0,7,1,33,0
Shawn Mendes Performs 'Mercy' & 'Treat You Better' on 'Saturday Night Live',0,2,10,47,7,11,0,57,0
President Barack Obama Says The Press Is Needed For Democracy To Work,0,2,12,46,0,11,0,58,0
Las Vegas airport appears to be using a picture of Nick Clegg on its maintenance posters The list,0,3,5,75,0,17,0,80,0
Flesh eating bacteria: Two adults in western Sydney hospital battling rare and painful infection,0,3,3,79,1,13,0,82,0
West Indies Did Not Offer English a Serious Test,0,1,8,32,0,8,0,40,0
Wall Street Stumbles as the Day Nears an End,0,1,6,30,0,8,0,36,0
Berlin 'attack': 'Several killed' after lorry ploughs into Christmas market,0,2,3,58,5,9,0,61,0
The Philippines seized $120 million worth of 'shabu' in a record drugs haul,0,3,2,55,3,12,3,57,0
"NCAA Tournament 2017: B/R Expert Predictions, Updated Results for Sweet 16",0,3,12,43,3,10,6,55,0
"On a Hike, Blazing Trails With Phone Software",0,1,7,30,1,7,0,37,0
A Brief Timeline of Carmelo and La La Anthony's Strained Marriage,0,3,9,45,1,10,0,54,0
North Korean delegation arrives in Malaysia as murder charges expected in Kim Jong Nam assassination ,0,2,6,80,0,15,0,86,0
Exxon Mobil denied permission to resume Russian oil work,0,2,3,45,0,8,0,48,0
Federal Workers Union Slams Trump Climate Order As 'Assault' On Public Health,0,2,12,52,2,11,0,64,0
"Raiders’ Exit Is a Loss for Oakland Workers, Touchdown for Taxpayers",0,2,8,48,2,10,0,56,0
"Justin Bieber Gets Hit, Bounces Back in Celeb Hockey Game",0,3,9,38,1,9,0,47,0
Congresswomen meet to discuss missing women of color ,0,3,1,44,0,8,0,45,0
Toronto Wolfpack take leap into the muddy unknown in rural Yorkshire,0,3,3,55,0,10,0,58,0
Zoo Knoxville investigates how 33 of its animals turned up dead ,0,3,2,49,0,11,2,51,0
Iconic Hollywood Sign Vandalized in Apparent New Year's Prank ,0,3,8,44,1,9,0,52,0
Pepsi beats as revenue from 'guilt-free' products explodes 45%,0,3,1,47,4,8,2,48,0
Whom to trust when it comes to health-care reform? Trump supporters put their faith in him.,0,3,2,71,3,15,0,73,0
Austin Area Becomes Immigrant 'Sanctuary' As Trump Inaugurated,0,2,8,45,2,7,0,53,0
Three Big Questions on the NFL and Las Vegas,0,3,8,28,0,8,0,36,0
Report: Florida VA hospital left deceased veteran in shower room for 9 hours,0,3,4,58,1,12,1,62,0
Hopes rise for breakthrough in Northern Ireland Peace Process,0,1,5,48,0,8,0,53,0
Mexico City cabbies are getting physical with Uber,0,3,3,40,0,7,0,43,0
Stopping the Dubs scheme for child refugees is shameful and heartless,0,3,2,57,0,10,0,59,0
Hong Kong protesters pop champagne after leader says he'll step down,0,3,2,55,1,10,0,57,0
Dunkirk: New Christopher Nolan film stuns audience at CinemaCon,0,3,6,48,1,8,0,54,0
Nottingham Express Transit extensions get Government approval,0,1,4,51,0,6,0,55,0
These images show the spectacular results of a star being born,0,3,1,51,0,10,0,52,0
"""God made me bulletproof,"" oft-shot rapper Yung Mazi tweets after he's shot again",0,3,3,61,5,12,0,64,0
Bar explains why female bartenders are being nice to you,0,2,1,46,0,9,0,47,0
Christmas Light Wars Are a Big Business,0,2,6,27,0,6,0,33,0
Tee Times May Keep Some Players Under Rain Clouds,0,1,9,32,0,8,0,41,0
News Limits put in place to stop tourists ruining Angkor sunsets,0,3,3,51,0,10,0,54,0
Diehard Drake Fans Will Love His New Tattoo,0,3,8,28,0,7,0,36,0
Germany is showing Donald Trump how to America The list,0,3,5,41,0,9,0,46,0
Robert Durst Case: Hollywood Producer Lynda Obst’s Memory Questioned,0,3,9,49,2,8,0,58,0
"Wikipedia and sister projects prepare new, easier interface",0,1,1,50,1,7,0,51,0
Our Favorite Naani And Jiya To Return On Small Screen As Shruti Seth Confirms Shararat Sequel!,0,3,16,62,1,15,0,78,0
Azealia Banks to take anger management classes after New York nightclub incident,0,2,4,65,0,11,0,69,0
Army warns of new threat: Energy drinks,0,3,2,30,1,6,0,32,0
Supreme Court refuses to take up challenge to San Francisco gun law,0,3,4,52,0,11,0,56,0
Theresa May heads for battle with Tory MPs over Brexit bill,0,3,6,43,0,10,0,49,0
There was a big difference in the way Trump signed his new travel ban,0,3,2,54,0,13,0,56,0
A black man accused French police of raping him. Police claim it was an accident.,0,3,3,62,2,14,0,65,0
Philippine Anti-Drug Operations Halted Over Police Scandal,0,3,8,43,1,6,0,51,0
"Diamond Sales, and Prices, Plunge in Downturn",0,1,5,32,2,6,0,37,0
"O’Reilly’s Troubles Give Viewers Pause, but They Still Watch ",0,2,9,40,3,9,0,49,0
Military storehouse explodes near Sofia,0,1,2,33,0,4,0,35,0
'Slaughter the pigs': Berlin terrorist's chilling video is released by ISIS as he vowed to punish 'crusaders',0,3,6,81,6,16,0,87,0
New warnings on e-cigs: How spotting someone vaping triggers the same cravings as real tobacco ,0,3,2,76,2,15,0,78,0
Trump takes aim at Sen. Schumer’s ‘fake tears’ in new defense of immigration restrictions ,0,3,3,69,4,14,0,72,0
Suicide bomber kills at least twenty in Pakistan town,0,1,2,43,0,8,0,45,0
Don't Sell Your Coachella Tickets Yet; Beyoncé's Show Is Reportedly Still On,0,3,12,50,3,11,0,62,0
Regulars Lift McDonald’s Sales,0,3,5,21,1,3,0,26,0
UK denies pressuring Scotland into Lockerbie release,0,1,4,42,0,6,0,46,0
These photos show what life is like in Iran,0,2,2,33,0,8,0,35,0
"European Commission praises ""flexicurity"" employment policy",0,1,2,50,2,5,0,52,0
Tense Turkey votes in crunch referendum on Erdogan powers,0,3,3,46,0,8,0,49,0
If Only The Rest Of America Got Concussion Care Like NFL Players,0,3,14,39,0,11,0,53,0
Classified U.S. intel report: Russia gathered compromising info on Trump,0,3,5,55,3,9,0,60,0
Mugabe is 'prepared to fight' if Zimbabwe elects opposition,0,1,2,47,2,8,0,49,0
Illegal Border Crossings Appear to Drop Under Trump ,0,3,7,37,0,8,0,44,0
Canada considers trade retaliation against the U.S.,0,1,3,40,2,6,0,43,0
GOP Health Insurance Fix Could Raise Premiums For Older Patients,0,2,12,43,0,9,0,55,0
Republican Politician Dressed In Blackface For 'Good Night At Church',0,2,10,48,2,9,0,58,0
The agony of Earth's hottest year: 'I miss that cold-cold weather',0,3,3,48,5,10,0,51,0
Kosmos-3M rocket launches six Orbcomm satellites,0,1,3,38,1,5,1,41,0
UK PM pledges aid for Myanmar,0,1,5,19,0,5,0,24,0
Germany Arrests Teens Plotting 'Islamist-Motivated Attack': Cops,0,3,8,46,4,6,0,54,0
"The Cast Of ""Superbad"" Look Super Badass 10 Years Later",0,3,9,33,2,9,2,42,0
EU Antitrust Chief Says Companies May Have Misled Regulator for Merger Clearance,0,3,12,57,0,11,0,69,0
Baby on board: woman gives birth on Turkish Airlines flight,0,2,3,46,1,9,0,49,0
Madison Bumgarner says dirt bike ride 'not the most responsible decision',0,3,2,59,2,10,0,61,0
Paul Ryan Rejects Call for Devin Nunes to Step Aside From Probe,0,3,10,42,0,11,0,52,0
Dozens dead after school collapses in Haiti,0,1,2,35,0,6,0,37,0
Sacramento Kings Ty Lawson Releasing Sneaker-Slippers in Time for Christmas,0,2,9,56,1,9,0,65,0
Steve McClaren: Newcastle appoint ex-England manager,0,2,5,40,2,5,0,45,0
Depression Treatment Often Doesn’t Go To Those Most In Need,0,2,10,39,1,9,0,49,0
Chickens Come Home to Roost: Massive Layoffs Predicted for ESPN Broadcasters,0,3,12,53,1,10,0,65,0
"When using headphones to listen to music, how loud is too loud for kids?",0,3,1,56,2,13,0,57,0
Boeing's new 787 Dreamliner lifts off in near-vertical ascent,0,3,2,46,2,8,3,48,0
"As China Pivots, Donald Trump Risks Fighting an Old War",0,3,9,36,1,9,0,45,0
"In Zimbabwe, Deal Likely to Fly or Fail This Week",0,1,8,31,1,9,0,39,0
Reported Zimbabwe Deal Is Disputed,0,1,5,25,0,4,0,30,0
"US, North Korea form agreement to search for war dead",0,1,4,39,1,9,0,43,0
Zegna Explores New Markets in Face of Downturn,0,1,6,33,0,7,0,39,0
Chipotle Makes Founder Steve Ells Its Sole CEO As Monty Moran Steps Down,0,3,15,45,0,12,0,60,0
Civilian fighters kill three Boko Haram girl suicide bombers targeting a bustling market in Nigeria ,0,3,4,81,0,15,0,85,0
One Of India's Oldest Social Groups Includes Everyone And Keeps Mizoram United,0,3,12,54,1,11,0,66,0
The Evolution of GFriend's Uniform Style: From Gym Clothes to Military Chic,0,2,11,51,2,11,0,62,0
Texas Officer Placed on Leave After Video Shows Teenage Girl Wrestled to Ground,0,3,11,56,0,12,0,67,0
Woman Shouts Down Florida Gov. Rick Scott In Starbucks: ’You’re An A*shole!’ (VIDEO),0,2,17,46,9,12,0,63,0
Trump Names H.R. McMaster as New National Security Adviser,0,3,10,38,2,8,0,48,0
"STS9 on Their Post-Election Outlook: 'As Scary As It Is, Hopefully We Can Grow From It'",0,3,18,48,5,15,1,66,0
Producer Who Is Very Much Alive Mistakenly Included in Oscars 'In Memoriam' Tribute,0,2,12,57,2,12,0,69,0
Who's the richest entertainer in Australia? The Wiggles of course!,0,1,4,50,3,9,0,54,0
New Zealand study finds correlation between church attendance and adolescent obesity,0,1,2,72,0,10,0,74,0
"With his presidency in turmoil, Trump keeps returning to past victories — and old foes",0,3,2,68,2,14,0,70,0
Ciccotta: Guest Speaker’s Call to Violence Reveals Bucknell’s Radicalism - Breitbart,0,2,9,61,4,10,0,70,0
"Suspects in Death of Lebanese Ex-Premier, Hariri, Are Freed",0,1,8,40,3,8,0,48,0
How Samsung And Qualcomm Are Driving Towards Connected Cars,0,3,9,42,0,8,0,51,0
Number of unemployed in the UK climbs to 2.4 million,0,1,3,37,1,9,2,40,0
13 Inspirational Quotes From Ashley Graham,0,3,5,30,0,5,2,35,0
"Billboard Dance Chart Upstarts: Mura Masa & Charli XCX, Rasmus Faber & Adult.",0,3,13,47,5,12,0,60,0
U.S. Men Manage a Tie With Haiti in the Gold Cup,0,1,9,27,2,10,0,36,0
"15 People Shot, One Dead in ‘Horrific’ Cincinnati Nightclub Shooting: Police",0,3,9,51,4,10,2,60,0
Buzz Aldrin launches VR plan to get humans to Mars,0,3,5,36,0,9,0,41,0
Pink and husband Carey Hart welcome a son,0,3,3,31,0,7,0,34,0
States and Cities Angle for Stimulus Cash,0,1,5,30,0,6,0,35,0
Mr. Sanders needs to come clean about the funding for his health-care plan,0,2,2,58,2,12,0,60,0
Frito-Lay Drops Doritos Super Bowl TV Advertisements - Yahoo,0,3,10,40,2,8,0,50,0
Porn Website xHamster Calls Trump Lookalikes To Audition For X-Rated Parody Movies!,0,3,13,57,2,11,0,70,0
Brazil to invest US $3.6bn on slums,0,1,3,22,2,6,2,25,0
DETAILS: Utah Man Killed in London Attack While on 'Dream Vacation' With Wife  Insider,0,3,18,51,3,14,0,69,0
Pope Reinstates Four Excommunicated Bishops,0,1,5,34,0,4,0,39,0
"A letter to … My mother, who hit me when I was a child",0,2,3,36,2,13,0,39,0
That One Small Step Is Still Hard to Measure,0,1,8,28,0,8,0,36,0
Service Warranties and the Cost of Fun,0,1,4,28,0,6,0,32,0
Somalia Fighting Kills at Least 15,0,1,4,23,0,5,2,27,0
"Amid historically low approval ratings, Trump now has to turn vision into policy",0,2,2,65,1,12,0,67,0
Proton rocket fails to launch AMC-14 satellite,0,1,4,33,1,6,2,37,0
"As an Iranian Briton, Theresa May's support for Trump makes me ask who will stand up for me",0,3,6,66,2,17,0,72,0
Draymond Green Rips Raiders for Leaving Oakland for Las Vegas: 'You Just Don't Do That',0,2,13,56,4,14,0,69,0
Football: Ronaldinho signs for Barcelona until 2010,0,1,3,37,1,6,4,40,0
Elizabeth Warren Persists ,0,3,3,20,0,3,0,23,0
SpaceX aborts space station docking,0,3,2,29,0,4,0,31,0
Everything we know (and all that we don't know) about the snap general election The list,0,3,2,68,3,15,0,70,0
WATCH! This week's episode of The Bottom Line with Henry Blodget,0,3,11,41,2,10,0,52,0
Stocks Climb in Volatile Session,0,3,4,24,0,4,0,28,0
Trump Moves to Stabilize the Obamacare Exchanges - Breitbart,0,2,6,45,1,8,0,51,0
Businesses shy to adopt Windows XP SP2,0,1,6,25,0,6,1,31,0
Research focuses on orchids mimicking female wasps,0,1,1,43,0,6,0,44,0
"With or without a fifth Super Bowl ring, Tom Brady is already the greatest quarterback ever",0,3,5,70,1,15,0,75,0
"U.S. targets more than 200 Indians for deportation, says India’s top diplomat",0,3,4,55,4,11,3,59,0
"Bacon, Eggs, Cheese — And Spaghetti? The Italian Twist On A Hangover Cure",0,2,12,45,4,12,0,57,0
Air France and Delta Seal Trans-Atlantic Joint Venture,0,1,8,38,1,7,0,46,0
Top Emerging-Market Bond Sellers See Little Impact From the Fed in 2017,0,3,10,45,1,11,4,55,0
British PM condemns walkouts,0,1,3,22,0,3,0,25,0
South Australian educational blog shut down,0,1,2,36,0,5,0,38,0
Nordstrom has officially cut ties with Ivanka Trump's brand,0,3,3,47,1,8,0,50,0
US pool player Wade Crane dies in car accident age 66,0,1,4,37,0,10,2,41,0
New York Rent Rules Face Court Test ,0,3,7,22,0,7,0,29,0
Representative for ACLU tells Wikinews their opinion on lifting of Wikileaks court injunction,0,1,7,74,0,12,0,81,0
Baylor Strength Coach Brandon Washington Fired After Prostitution Charge Arrest,0,3,10,60,0,9,0,70,0
Call from Trump Interrupts Israeli Police Questioning Prime Minister Netanyahu,0,3,9,60,0,9,0,69,0
Former Sex Pistols Frontman Johnny Rotten Supports Donald Trump & Brexit Vote,0,2,11,54,1,11,0,65,0
Rubio wants to let guns onto D.C. streets. Why not let them into the Capitol?,0,2,5,54,4,14,0,59,0
Rouhani Says Iran Won’t Be ‘Bullied’ as Rallies Criticise Trump,0,3,9,42,3,9,0,51,0
Trump loves Harley-Davidson. Do Harley riders love him back?,0,2,5,44,3,8,0,49,0
"In New Special, Louis C.K. Says We're Heading For Hellish Dystopia",0,2,12,40,4,10,0,52,0
Elderly couple burn house down after Christmas tree bursts into ball of flames ,0,3,2,64,0,13,0,66,0
Trump Raises Millions for 2020 Re-election Bid ,0,3,5,30,1,7,4,35,0
"Hrithik's Subtle Hint About ZNMD's Sequel, Salman-Akshay-KJo's Collaboration & More From Ent!",0,3,17,57,8,11,0,74,0
Benedict Cumberbatch Is A Bit Frazzled In This Deleted 'Doctor Strange' Scene,0,2,12,52,2,11,0,64,0
Cricket: India beats the West Indies by 16 runs,0,1,4,32,1,8,2,36,0
Israeli settlements: UN Security Council calls for an end,0,3,5,43,1,8,0,48,0
House Democrats Are Inviting Trump To Expand Social Security,0,3,9,43,0,8,0,52,0
Rohrabacher on CIA WikiLeaks Revelations: ’We Are Not Immune to Authoritarian Government’,0,2,13,62,3,11,0,75,0
Federal judge declines to immediately apply freeze of first Trump travel ban to new order,0,3,2,73,0,14,0,75,0
Orlando Shooter's Widow Seeks Jail Release Pending Trial ,0,3,8,40,1,8,0,48,0
Why the Women’s March may be the start of a serious social movement,0,2,3,51,1,12,0,54,0
"WikiLeaks proposes tracking verified Twitter users’ homes, families and finances",0,3,3,66,2,9,0,69,0
The Idiot's Guide To Electronic Music And Its Sub Genres,0,3,10,36,1,9,0,46,0
Donald Trump ice sculpture unveiled at Japan's Sapporo snow festival,0,3,4,54,1,9,0,58,0
"For all of the motion, Trump is falling behind on his ‘100-day’ promise list",0,3,2,54,4,13,3,56,0
U.S. Productivity Advanced for Second Straight Quarter,0,3,7,39,2,6,0,46,0
'Very Fake News': Pres. Trump Questioned on Intel Leaks by CNN's Acosta  Insider,0,2,13,49,5,13,0,62,0
Nebraska cyclist killed during Ironman Boulder race,0,2,3,42,0,6,0,45,0
Media escalate Trump-Russia reporting as he rips 'fake news' conspiracies ,0,3,3,58,3,10,0,61,0
California Must Pay Nearly $1 Million to Company for Destroying Evidence,0,3,8,52,1,10,1,60,0
"Finding America, Both Red and Blue, in the ‘Little House’ Books ",0,3,8,41,4,11,0,49,0
Tree falls on CA wedding party; 1 dead,0,3,3,26,1,7,1,29,0
Sacramento Kings DeMarcus Cousins Confronts Reporter over Column on Nightclub Incident,0,2,10,66,0,10,0,76,0
16 Of The World's Best Photographs Prove That Drone Photography Is The Next Big Thing!,0,2,14,54,2,14,2,68,0
"A Swim Team ""Practiced"" In The Snow In Nothing But Speedos After Their Meet Was Canceled",0,3,16,55,2,15,0,71,0
"TSA, DHS Will Bar Electronic Devices On Some Overseas Flights",0,3,14,37,1,9,0,51,0
Yorkshire Building Society launches record low UK mortgage rate,0,3,5,50,0,8,0,55,0
Detroit Police find bodies of two children in freezer,0,2,2,43,0,8,0,45,0
Colorado Woman’s Remains Found Under Grave of WWII Veteran,0,3,11,38,1,8,0,49,0
Water park under fire for Muslim-friendly event,0,2,2,38,1,6,0,40,0
"Bruno Mars tells James Corden how to seduce women, sing along to Uptown Funk in Carpool Karaoke",0,3,8,70,1,16,0,78,0
Twenty One Pilots Drop 'Heavydirtysoul' Music Video: Watch,0,3,8,40,3,7,0,48,0
Federer Focuses on Reclaiming Wimbledon,0,1,4,31,0,4,0,35,0
Taxstone Reportedly Indicted on Weapons Charges From Irving Plaza Shooting,0,2,9,56,0,9,0,65,0
WA election: New era for Labor as Mark McGowan elected Premier in landslide,0,3,8,54,1,12,0,62,0
"AMD Acquires IP And Acquihires Nitero Team, Maker Of 60 Ghz Wireless Chips For VR/AR",0,3,20,46,2,14,2,66,0
Tony Romo Rumors: Rams Reportedly Not Interested in Acquiring QB,0,2,10,44,1,9,0,54,0
Denzel Washington on the 20-Year Journey 'Fences' Took to the Big Screen [Video],0,3,9,52,5,12,2,61,0
Fidel Castro Laid to Rest in Private Ceremony in East Cuba,0,3,8,40,0,10,0,48,0
At least thirty-three more dead in Ethiopia election clashes,0,1,2,49,1,8,0,51,0
"Kings, Pelicans agree to DeMarcus Cousins trade, sources say",0,3,5,45,2,8,0,50,0
Rivals Accuse I.B.M. of Stifling Competition to Mainframes,0,1,8,40,3,7,0,48,0
Race to be Hong Kong's next leader kicks off,0,3,3,32,1,8,0,35,0
US missile system en route to Korean peninsula ,0,3,3,36,0,8,0,39,0
Sports community shows support for Isaiah Thomas following Game 1 loss to Bulls,0,2,5,61,0,12,1,66,0
Obama spends Christmas with the Marines,0,3,3,31,0,5,0,34,0
Euro reaches one-year low against US dollar,0,1,3,33,1,6,0,36,0
First lady's Jackie-esque style works hard to set gracious tone for Trump,0,3,3,57,2,11,0,60,0
"Matthew Edwards, honored Michigan police officer, shot and killed",0,1,3,52,2,8,0,55,0
Mobile phones to help fight AIDS in Africa,0,1,6,29,0,7,0,35,0
Britain First tried to take down Gary Lineker and he had an incredible response The list,0,3,5,68,0,15,0,73,0
Actor Judge Reinhold Arrested After Airport Incident With TSA,0,2,11,42,0,8,0,53,0
"‘Humble, spiritual’ armed motorist saved trooper from attack on Arizona highway",0,3,2,64,3,10,0,66,0
Ask Ethan: Why Must Time Be A Dimension?,0,3,8,23,2,7,0,31,0
NBA Player Power Rankings: B/R's Top 30 Small Forwards at the Halfway Point,0,3,13,45,3,12,2,58,0
Indian woman held for acid attack on ex-lover,0,3,1,36,1,7,0,37,0
Pence's sphere of influence questioned in wake of Flynn fallout,0,3,2,51,1,9,0,53,0
"Boston Red Sox Move All-In, Trade for Ace Chris Sale",0,3,10,31,2,9,0,41,0
"Nigerian girl, 10, used in suicide bomb attack on New Year's Eve",0,3,4,44,3,11,2,48,0
How have you been affected by flooding and snow in the UK?,0,3,3,43,1,11,0,46,0
Tape of Beating Leads to Firing of 5 Birmingham Officers,0,1,6,40,0,9,1,46,0
Cyclone Laila lashes across India's Eastern coastline,0,1,4,42,1,6,0,46,0
"Drunk perv got trashed, then molested my husband mid-flight",0,2,1,48,2,8,0,49,0
Snapchat slashes valuation by billions ahead of stock market flotation,0,2,1,60,0,9,0,61,0
"In Trump's Visa Crackdown, Indian Students Weigh Canada, Ireland",0,3,9,44,3,8,0,53,0
Democracy requires trust. But Trump is making us all into conspiracy theorists.,0,2,3,63,2,11,0,66,0
"Airport Shutdown, Brigands Leave Nigerian Capital Isolated",0,3,7,44,1,6,0,51,0
At least 728 rescued from burning Indonesian ferry,0,1,2,38,0,7,3,40,0
Ferries collide between Hong Kong and Macau in fog,0,1,4,38,0,8,0,42,0
Pennsylvania man admits to June 25 beating of elderly woman,0,1,2,46,0,9,2,48,0
Too Grimm? Mother Goose cartoonist sued by Colombian coffee growers,0,1,5,52,1,9,0,57,0
Stripe Founders Are Youngest Irish Billionaires With Funding,0,3,8,45,0,7,0,53,0
Prince Reigns Over Adele And All Other Artists For Top Music Sales,0,3,12,43,0,11,0,55,0
Doris Day and 7 other celebrities in their 90s - Yahoo,0,3,3,37,1,10,3,40,0
NY Times: Trump’s Deportation Efforts ‘Not So Unusual’,0,3,9,34,4,7,0,43,0
Cavaliers' owner Dan Gilbert called out Andre Iguodala and Draymond Green on Twitter,0,2,8,63,1,12,0,71,0
3 Bodies Found in Military Crash,0,1,4,22,0,5,1,26,0
Blast at Egyptian Coptic cathedral kills at least 25,0,3,3,39,0,8,2,42,0
Report: Illegals Rushing to Get into U.S. Before Trump Wall - Breitbart,0,2,10,46,4,11,0,56,0
Administration Seeks Increase in Oversight of Executive Pay,0,1,6,46,0,7,0,52,0
BBC looks to curb pay of news stars in £80m cuts,0,3,3,32,1,10,2,35,0
English Sweep Across Europe Once Again,0,1,6,27,0,5,0,33,0
No Post-High School Plans? Chicago Doesn't Think You Should Graduate,0,3,11,45,3,9,0,56,0
'Game of Thrones' Is Once Again the Most Pirated TV Show of the Year,0,3,11,42,2,13,0,53,0
Journalist: Trump brought Electoral map handouts of his wins to interview,0,3,3,59,1,10,0,62,0
Trump’s bogus claim that intelligence report says Russia didn’t impact the 2016 election outcome,0,2,2,75,2,13,4,77,0
"Put One Up For The Phifer: How A Tribe Called Quest’s Phife Dawg Changed My Life And Probably Yours, Too",0,3,20,62,3,19,0,82,0
"Driven underground by Saddam, ’Iraq’s greatest photographer’ Latif Al Ani is honored at last",0,2,6,69,4,13,0,75,0
Neighbor pleads guilty to killing N.C. guidance counselor,0,2,3,45,2,7,0,48,0
'Trump doesn't care about culture': how will his presidency affect the arts?,0,3,1,59,5,11,0,60,0
The Muslim world failed Syria long before anyone else did,0,2,3,45,0,9,0,48,0
"Venezuela Muzzles Legislature, Moving Closer to One-Man Rule ",0,3,8,43,2,8,0,51,0
Delhi mascots to blow the whistle on public defecation,0,3,1,45,0,8,0,46,0
"Meet Linda Sarsour, the Activist Suing Trump Over His Muslim Ban",0,3,10,43,1,10,0,53,0
AMA Says Trumpcare Is 'Critically Flawed',0,3,8,26,2,5,0,34,0
Olympics exec arrested in nude for scalping $3M in tickets,0,2,2,45,1,9,1,47,0
"Challenge for Super Bowl Commercials: Not Taking Sides, Politically ",0,2,8,49,2,9,0,57,0
Finding Shelter From Trump's Tweet Storm,0,3,6,28,1,5,0,34,0
You can now apply and interview for a job entirely within Facebook,0,3,2,53,0,11,0,55,0
Pope likens migrant holding centers to ’concentration camps’,0,2,1,50,2,7,0,51,0
"Blood Profiling System Flags 5 Cyclists, U.C.I Says",0,1,9,31,3,7,1,40,0
SpaceX sticks daytime rocket landing back on Earth after launch to space,0,2,3,58,0,11,0,61,0
Adam Air hits severe financial problems; may be shut down in three weeks,0,1,2,57,1,12,0,59,0
Sex offender pretends to be 12 years old; enrolls into seventh grade,0,1,1,53,1,11,2,54,0
Topshop Mannequin Criticized for Being Too Thin [Video],0,3,7,39,2,7,0,46,0
NSW hospital parking fees to be cut following 14yo's petition,0,3,3,46,1,9,2,49,0
Shares Begin to Move Lower as Day Nears End,0,1,7,28,0,8,0,35,0
Cheaper Epinephrine: Spend Way Less With This EpiPen Alternative,0,2,10,45,1,8,0,55,0
Everything you need to know about a Senate filibuster ,0,3,2,43,0,9,0,45,0
Here’s What It Was Like Inside The Deadly Oakland Warehouse Party Fire,0,3,12,46,1,11,0,58,0
Somali pirates suspected of first ship hijacking since 2012,0,3,1,46,0,8,4,47,0
"Laramie, Wyoming passes LGBT anti-discrimination bill",0,2,6,40,2,5,0,46,0
"Punjab Has Its Own 'Taj Mahal' Called 'Pul Moran', A Memorial Of Maharaja Ranjit Singh's Love For Moran, A Dancer",0,3,20,67,7,19,0,87,0
‘Hamilton’ Duel: Addressing the President-Elect on His Own Blunt Terms - The New York Times,0,2,13,59,5,14,0,72,0
Queen's University agree to cut 103 members of staff,0,1,2,38,1,8,3,40,0
The “Game Of Thrones” Father’s Day Cards You Deserve,0,3,9,32,3,8,0,41,0
N.F.L. Stars Who Took the Pitch and Ran With It,0,1,10,25,3,9,0,35,0
Several Blasts in Pakistan After Taliban Warning,0,1,6,36,0,6,0,42,0
Professor tweets 'trying not to vomit' when person gives seat to soldier,0,3,1,58,2,11,0,59,0
Hugo Barra to Lead Facebook's Virtual Reality Efforts After Leaving China's Xiaomi,0,2,11,58,2,11,0,69,0
"Oklahoma Lawmaker Wants Men To Approve Abortion, Calls Women 'Hosts'",0,2,10,46,3,9,0,56,0
Iman Shumpert Reportedly a Trade Target for Rockets Ahead of 2017 Deadline,0,2,8,51,0,11,4,59,0
#ThanksForTyping Shows Once Again That Women Do The Dirty Work,0,3,12,40,1,9,0,52,0
Every country surveyed would now vote Remain in an EU referendum... Including Britain The list,0,3,7,70,3,14,0,77,0
Steve Harvey says Trump is 'keeping his word' ,0,3,3,33,2,8,0,36,0
Spain launches €11 billion stimulus package,0,1,1,34,1,5,2,35,0
Trumps Attend Church Services in Palm Beach on Christmas Eve ,0,3,8,43,0,10,0,51,0
What the law says about the perjury allegations against Jeff Sessions ,0,3,3,56,0,11,0,59,0
New Poll Shows Half Of Divorcés Had Pre-Wedding Jitters,0,3,10,36,1,8,0,46,0
Trump to meet China's Xi in Florida next week,0,3,4,32,1,8,0,36,0
"Trump Oil Policies Are Bad for Planet, French Minister Says",0,2,9,40,1,9,0,49,0
Premier League set to announce £312m pre-tax loss in the light of Brexit and new UK accounting rules,0,3,5,73,2,17,3,78,0
"Turkey Inflation Accelerates More Than Expected on Food, Alcohol",0,3,8,47,1,8,0,55,0
Witnesses testify in former Iraqi leader Saddam Hussein's trial,0,1,4,50,1,8,0,54,0
Protesters Gather at Airports to Denounce Refugee Ban,0,3,6,40,0,7,0,46,0
India struggles with encephalitis outbreak,0,1,1,37,0,4,0,38,0
Dan Savage wins Webby Award for It Gets Better Project,0,1,8,37,0,9,0,45,0
Osmani Garcia Enters Rehab Due to Physical & Emotional Exhaustion,0,3,8,47,1,9,0,55,0
Crohn's disease illustration wins science Wellcome Image Awards,0,2,4,51,1,7,0,55,0
"Andre Branch, Dolphins Reportedly Agree to 3-Year Contract",0,3,7,41,2,7,1,48,0
"Charleston church shooter Dylann Roof 'is not all bad,' grandfather says ",0,3,3,56,3,11,0,59,0
"So, Um, How Do You, Like, Stop Using Filler Words? ",0,3,10,26,5,10,0,36,0
How the Government Strives to Tell if a Refugee Applicant Is Lying About Being a Christian ,0,3,11,64,0,16,0,75,0
Humans Intrude on an Indonesian Park,0,1,4,27,0,5,0,31,0
'Heartbroken' RuPaul On Trump Win: 'It Feels Like The Death Of America',0,3,13,42,5,11,0,55,0
White House Is Said to Draft Plan for U.S. Break From Nafta ,0,3,11,35,2,12,0,46,0
Kings Reportedly Trade DeMarcus Cousins to Pelicans,0,3,7,38,0,6,0,45,0
"Tesla recalls 53,000 Model X and Model S cars over parking brakes",0,3,5,43,1,11,5,48,0
The Popular Newsweekly Becomes a Lonely Category,0,1,6,36,0,6,0,42,0
Geithner Is Pressed for Bailout Details,0,1,5,29,0,5,0,34,0
US says Zimbabwe government has “a long way to go” before sanctions are lifted,0,1,3,60,2,13,0,63,0
All executions suspended in Florida after error,0,1,2,39,0,6,0,41,0
$200 Million! That Is How Much Google Paid As Salary To CEO Sundar Pichai Last Year,0,3,17,46,2,15,3,63,0
20-year-old captures abusive police officer on tape,0,1,0,41,2,6,2,41,0
Want To Be Wicket Smart? Now There’s An App For Cricket’s Many Rules,0,2,13,40,3,12,0,53,0
Build A Teen Show And We’ll Reveal A Secret Truth About You,0,2,12,35,1,11,0,47,0
The Common High-School Tool That’s Banned in College,0,2,8,35,2,7,0,43,0
A new law in Turkey offers citizenship to foreign investors who buy property there,0,3,2,67,0,13,0,69,0
Fantasy baseball: Top 300 rankings for rotisserie leagues,0,2,2,44,1,7,3,46,0
Report: Denver Broncos are in ‘driver’s seat’ to land Tony Romo,0,3,5,44,4,10,0,49,0
Kevin Spacey to Host 2017 Tony Awards,0,3,5,22,0,6,4,27,0
"Sharing the Teixeira Name, but Little Else",0,1,5,30,1,6,0,35,0
Jobs Data Gives Shares a Lift,0,1,5,19,0,5,0,24,0
Next week’s Arctic blast could mean two bouts of wintry precipitation in Washington,0,2,3,67,1,12,0,70,0
Tito's ARK: Bosnian nuclear bunker transformed into a contemporary art space,0,3,5,59,2,10,0,64,0
You're twice as likely to live the American Dream in Canada,0,3,4,44,1,10,0,48,0
Google’s DeepMind makes AI program that can learn like a human,0,2,5,46,1,10,0,51,0
"Jordan, Sports Mecca? Give It Time",0,1,6,21,2,5,0,27,0
"Wildfires still burn in Oklahoma, Texas",0,1,3,30,1,5,0,33,0
"Florida Senator Apologizes for Using Racial Slurs to Colleagues, Removed as Committee Chair",0,2,10,68,1,12,0,78,0
Aldon Smith's Involvement in Domestic Violence Incident Under Investigation,0,3,8,58,1,8,0,66,0
Juventus Looks for Early Goals Against Chelsea,0,1,6,34,0,6,0,40,0
Ricky Williams Was Stopped and Handcuffed by Police After Taking a Walk in Texas,0,3,10,57,0,13,0,67,0
"Italy Upsets Canada, 6-2, at World Baseball Classic",0,1,6,33,3,7,2,39,0
"Storms Cut Through Midwest, Killing 5",0,1,5,25,1,5,1,30,0
Dangerous Game: can a Calum Best vehicle with Darren Day as a Russian mob boss really exist?,0,3,7,67,2,16,0,74,0
Twitter Wants To Stream Live Video Programming 24/7 First And Goal,0,3,10,42,1,10,3,52,0
Can pop-up 'repair cafes' save broken gadgets and solve growing waste levels?,0,3,1,61,4,11,0,62,0
"Humane Society Sees Vick as Ally, Not Pariah",0,1,7,29,1,7,0,36,0
Formula One Is Running Its Final Race at the Legendary Silverstone Track,0,1,10,51,0,11,0,61,0
Lawmakers Push Interrogation Inquiries,0,1,4,31,0,3,0,35,0
"Carrie Fisher's urn is shaped like a giant Prozac pill, like she would've wanted",0,2,3,61,3,13,0,64,0
"This 5-Year-Old Geography Whiz Expertly Burned Trump On ""The Ellen Show""",0,2,12,45,4,10,1,57,0
'Immigrants are America': protesters mass at US airports – in pictures,0,3,4,52,4,10,0,56,0
Federal Judge Clears Way to End Michigan Recount ,0,2,7,34,0,8,0,41,0
Attorney For Will Smith’s Family: 'Verdict Will Bring a Little Peace',0,2,10,45,4,10,0,55,0
New York City Welcomes Drake's Third OVO Flagship Store,0,3,11,35,1,8,0,46,0
"Hold the Eulogies, Kennedy Says",0,1,4,22,1,4,0,26,0
"Oscars 2017: Hollywood talent agency cancels party, hosts pro-refugee rally instead",0,2,2,64,3,10,4,66,0
Supreme Court strikes down law in Jerusalem passport case,0,3,3,46,0,8,0,49,0
UK retailers MFI and Woolworths collapse,0,1,6,29,0,5,0,35,0
The “Baywatch” Trailer Is Here/Let’s Just Look At Zac Efron’s Abs,0,3,12,38,5,10,0,50,0
"60 Shot, 11 Fatally, in Christmas Weekend Shootings Across Chicago",0,3,7,44,2,9,4,51,0
How to Get Lady Gaga's Mesmerizing Eyes From Coachella,0,3,8,37,1,8,0,45,0
Democratic Party Elections Reveal Growing Populist Energy,0,3,7,44,0,6,0,51,0
Gold Is Holding Up in a Tough Season,0,1,6,23,0,7,0,29,0
Looking for a Trump Doctrine in the White House Kitchen ,0,3,6,40,0,10,0,46,0
8 Women You Had No Idea Saved Your Ass,0,2,8,21,0,8,1,29,0
Trump attacks 'dishonest media' while making false claims at Florida rally,0,3,2,60,2,10,0,62,0
Lady Gaga Opens Up About Struggling With PTSD In Emotional Letter,0,3,14,41,0,10,0,55,0
Best Buy Cities: Where To Invest In Housing In 2017,0,3,9,28,1,9,4,37,0
Rick Derringer Charged With Bringing Loaded Gun on an Airplane,0,3,8,45,0,9,0,53,0
Peace activists propose 'Fast for Freedom',0,1,3,32,2,5,0,35,0
"CSIRO, Energy Networks Australia lay out roadmap for emissions-free future",0,3,8,55,2,9,0,63,0
Breakthrough offers hope for Tasmanian devil cancer cure,0,2,2,47,0,7,0,49,0
"Trump stands by wiretap claim, jokes he has 'something in common' with Merkel ",0,3,2,60,3,13,0,62,0
Reckitt CEO Rakesh Kapoor Goes From Low Key to a Big Deal,0,3,12,34,0,11,0,46,0
London's newest chicken takeaway is 100 per cent vegan,0,3,1,41,1,8,3,42,0
"Have fun in your 50s: it’s the key to living longer, science says",0,3,1,47,3,12,2,48,0
"Arctic 'doomsday' seed vault receives 50,000 new deposits",0,3,1,41,3,7,5,42,0
Man breaches security at London's Heathrow Airport,0,1,4,39,1,6,0,43,0
"UK Chancellor of the Exchequer, Alistair Darling releases 2008 budget",0,1,6,49,1,9,4,55,0
Tributes paid to the victims of the July 7 2005 London bombings,0,1,3,44,0,11,5,47,0
O’Reilly: ’Registration Is Not Going to Solve the Gun Murder Problem’ - Breitbart,0,2,11,53,5,12,0,64,0
Woman attacked by shark in British territory St Helena,0,3,4,42,0,8,0,46,0
Australia celebrates Australia Day 2009,0,1,3,28,0,4,4,31,0
105-Year-Old Cyclist Sets New World Record,0,2,7,25,2,5,3,32,0
"Grammar schools are now giving priority to disadvantaged pupils, new study shows",0,3,1,67,1,11,0,68,0
"Ten-year-old computer glitch prevents delivery of 1,380 Canadian health results",0,1,2,61,3,9,4,63,0
Ben Affleck shares he's completed treatment for 'alcohol addiction',0,2,2,54,3,8,0,56,0
Good Luck Killing the EPA,0,3,6,15,0,4,0,21,0
"Equatorial Guinea coup plotters pardoned, released from jail",0,1,2,50,1,7,0,52,0
Former Bush attorney general says he believes there was surveillance on Trump Tower,0,2,4,67,0,12,0,71,0
Body Cam Footage Captures Moment Cop Saved Woman From Burning Car,0,3,11,44,0,10,0,55,0
College hoops' royalty leads Way-Too-Early Top 25 for 2017-18,0,3,5,36,4,8,8,41,0
Martin Luther King Jr. Impersonator Discovers Life's Calling Through Famous Speeches ,0,2,11,61,2,11,0,72,0
"On Twitter, Ad for Habitat Furniture Exploits Iran Frenzy",0,1,8,40,1,8,0,48,0
Intruder Arrested After Scaling White House Fence,0,3,7,36,0,6,0,43,0
Apple has a secret team working on the holy grail for treating diabetes,0,3,1,58,0,12,0,59,0
Fury at eurozone chief Dijsselbloem's 'racist' remarks,0,3,2,43,3,6,0,45,0
FBI agrees with CIA assessment that Russia meddled in the US election to help Trump win,0,2,10,62,0,15,0,72,0
National Guard mobilized in Kentucky ice storm aftermath,0,1,3,46,0,7,0,49,0
"Rick Ross to Host 2017 MTV Woodies, Talks Upcoming Ninth Album: Exclusive",0,3,12,44,2,11,4,56,0
Philippine shipwreck kills man; rescue boat also rescued,0,1,1,47,1,7,0,48,0
Sean Spicer Steps in It by Comparing Assad to Hitler,0,3,7,36,0,9,0,43,0
Dow 20000: Nike Is Missing Out ,0,3,5,14,1,6,5,19,0
Nearly one million Android phones infected by hackers,0,3,2,44,0,7,0,46,0
‘We’ll do better’: Trump’s White House tries to gain a sense of order amid missteps,0,3,4,60,5,14,0,64,0
"Today in Trump: January 30, 2017",0,3,3,16,2,5,6,19,0
Motherhood in the time of Zika,0,3,2,23,0,5,0,25,0
Raekwon Taps Lil Wayne for Grimy Track 'My Corner': Listen,0,2,9,37,3,9,0,46,0
Colombia landslide: Farc rebels offer to help rebuild town,0,2,2,47,1,8,0,49,0
Man who saved children from house fire faces deportation from the UK,0,3,3,54,0,11,0,57,0
Trump should let Syrian refugees in. But not because he feels sorry for them.,0,2,3,59,2,13,0,62,0
"Joost van der Westhuizen, tennis defaults and Graham Taylor's comic turn",0,3,4,56,2,10,0,60,0
Persistent rain storm in Northeast USA comes to an end,0,1,5,40,0,9,0,45,0
"DeMarcus Ware, 8th all time in sacks, announces retirement",0,3,3,44,2,8,1,47,0
How “Superstore” Turned Itself Into One Of America’s Most Relevant Shows,0,3,11,48,3,10,0,59,0
Future Politics: Austra review – glossy sounds and soaring vocals,0,3,3,51,2,9,0,54,0
"""Full Frontal With Samantha Bee"" apologizes for “Nazi hair” joke",0,3,6,45,4,9,0,51,0
‘Please don’t get it’: Starbucks baristas are flipping out over the Unicorn Frappuccino,0,3,4,67,4,12,0,71,0
"Amitabh Bachchan Remembers His Grandmother While Donning A Sikh Look, Gets Emotional",0,3,12,60,1,11,0,72,0
"British sailors detained, released after yacht accidentally crosses into Iranian waters",0,1,2,74,1,10,0,76,0
"Charges filed against suspected ""Pizzagate"" gunman",0,3,2,41,2,5,0,43,0
"21 Breathtaking Photos Of Dogs, But From Underneath",0,2,7,34,1,7,2,41,0
"Markets Tread Water, Waiting on Washington",0,1,5,31,1,5,0,36,0
"The Trump Administration Banned Laptops, So One Airline Is Passing Them Out",0,3,12,51,1,11,0,63,0
Atlantic’s Goldberg: Dems Feel Like They Are on ’the Bataan Death March’ to the Nomination - Breitbart,0,2,12,69,5,16,0,81,0
River turns bright green to the horror of residents ,0,2,1,42,0,9,0,43,0
China official says Trump's Taiwan comments cause 'serious concern' ,0,2,3,53,3,9,0,56,0
LGBTQ Advocates Seek to Label Conservative Opponents as Hate Groups,0,3,12,46,0,9,0,58,0
NATO summit in Bucharest enters second day,0,1,5,31,0,6,0,36,0
3 Officers Are Dead After Shootings in Oakland,0,1,6,32,0,7,1,38,0
Knicks Beat Hawks for Fifth Straight Win at Home,0,1,7,33,0,8,0,40,0
The most fashionable Englishwoman in Paris,0,2,3,34,0,5,0,37,0
Trump vows 35% tax for US firms that move jobs overseas,0,3,3,39,1,10,2,42,0
Brexit bill set to pass without amendment as Tory rebels back off,0,3,2,52,0,11,0,54,0
Kim Kardashian Robbery Crime Scene Photos Emerge,0,3,7,35,0,6,0,42,0
Biotech Firm to Liquidate Under Investor Pressure,0,1,6,37,0,6,0,43,0
"Former Al Jazeera Reporter on Twitter: France ’An Islamophobic Nation’, Attack Was ’Blowback’ - Breitbart",0,2,13,71,7,14,0,84,0
"Second ""Red Bull Flugtag London"" lands in Hyde Park",0,1,7,34,2,8,0,41,0
"Trump's America Donald Trump winning US presidential race rated unlikely, Government documents show",0,3,7,78,2,12,0,85,0
Trump nominates Judge Gorsuch to Supreme Court ,0,3,5,35,0,7,0,40,0
"Lin-Manuel Miranda Beats Out Beyonce, Adele as AP's Entertainer of the Year",0,2,11,50,3,11,0,61,0
"Trump Says Sprint Bringing 5,000 Jobs Back to U.S.",0,3,8,27,3,8,4,35,0
Liked ‘Serial’? Here’s Why the True-Crime Podcast ‘S-Town’ Is Better ,0,3,11,40,8,10,0,51,0
Dave Chappelle and John Mayer Pay Tribute to Charlie Murphy,0,2,8,42,0,9,0,50,0
"Hong Kong Mall Escalator Snaps Into Reverse, Pile-up Leaves 18 People Injured",0,3,11,51,2,11,2,62,0
"Texas police officer faked his death and fled to Mexico, say officials",0,3,2,56,1,11,0,58,0
"Trump Tweeted About ""Easy D"" And Everyone Is Confused",0,3,9,34,2,8,0,43,0
"Counterfeit condoms allegedly from China seized in Puerto Rico, feds say",0,3,4,57,1,10,0,61,0
Intel Facing a Large Fine in European Antitrust Case,0,1,7,37,0,8,0,44,0
Watch James Corden's Crosswalk 'Beauty and the Beast',0,2,6,37,3,7,0,43,0
Grammy Awards 2017: James Corden Won't Sing as Host,0,2,7,30,2,8,4,37,0
Is Supreme's Nike Uptempo Collaboration a Disappointment or a Slam Dunk?,0,3,8,52,2,10,0,60,0
Saudi Arabia sentences 15 people to death over Iranian spy case,0,2,3,48,0,10,2,51,0
No. 5 Maryland Shares A.C.C. Lead,0,1,7,16,4,5,1,23,0
Bull shark steals a fish right off a fisherman's line,0,2,1,42,1,9,0,43,0
Judge Dannii Minogue exits UK X Factor over 'Australia's Got Talent' scheduling clash,0,1,10,60,3,12,0,70,0
Man decapitated on Greyhound bus in Manitoba,0,1,3,35,0,6,0,38,0
South Korean man dies after eating toads,0,2,2,32,0,6,0,34,0
Larry Ellison,0,3,2,10,0,1,0,12,0
Start your engines for this possible RuPaul's Drag Race-inspired LEGO set,0,3,9,52,2,10,0,61,0
Australia's million-dollar-a-month Nauru detention centre for two refugees,0,1,2,61,4,7,0,63,0
At least five dead in shooting at BPM festival in Mexico,0,2,5,41,0,10,0,46,0
Spike Lee Vows to Never Use Chrisette Michele's Music Over Inauguration Performance,0,2,11,60,1,11,0,71,0
"Snapchat Video Appears to Show Ian Kahaloa Drug Use, Reds Release Statement",0,2,11,52,1,11,0,63,0
Philly Fed manufacturing crushes expectations,0,2,2,39,0,4,0,41,0
Businesses Ramp Up Investment Despite Rising Rates,0,3,7,37,0,6,0,44,0
New Zealand airlines relax knife regulations,0,1,2,37,0,5,0,39,0
Samsung’s latest invention: a fireproof box for Note 7 returns,0,2,2,48,2,9,1,50,0
Four-day Corpus Christi water ban lifted after tests,0,3,3,41,1,7,0,44,0
Dalai Lama's rapturous welcome at Buddhist monastery,0,3,3,42,1,6,0,45,0
Exclusive look at Bebo,0,1,2,17,0,3,0,19,0
Lists What we love about Milton Keynes,0,2,4,28,0,6,0,32,0
"On a Map of Georgia, Old Words Start a New Rush for Tourists",0,1,9,38,1,12,0,47,0
Europe's Auto Rebound Sputters Short of Pre-Crisis Peak: Chart,0,3,9,42,3,8,0,51,0
Muslim students 'praying in corridors' at Queen's University Belfast,0,2,4,53,3,8,0,57,0
World Baseball Classic  Ticket Sales Show Where Rooting Interests Lie,0,1,10,49,0,10,0,59,0
Conor McGregor Discusses Floyd Mayweather Fight at Michael Conlan vs. Tim Ibarra,0,2,11,57,1,11,0,68,0
"As scientists erupt in protest, a volcanologist runs for Congress",0,3,2,53,1,9,0,55,0
Aging gracefully: The story of my 103-year-old dad ,0,3,2,35,3,8,3,37,0
Alarm bells ring for charities as Trump pledges to ax foreign aid budget,0,3,2,58,0,12,0,60,0
Claremont serial killings: Man arrested over women's murders still in custody 24 hours later,0,3,2,73,2,13,2,75,0
"House GOP Response To Gun Sit-In Is ‘Putin-Like,’ Democrat Says",0,2,14,35,5,9,0,49,0
"With arrival of rainy season, perennial scramble in Zimbabwe for seed, fertilizer",0,1,2,66,2,11,0,68,0
Amnesty report's criticisms rejected by Bush administration,0,1,2,50,1,6,0,52,0
More Legal Woes For Sanjay Dutt! Warrant Issued Against Him For Threatening A Filmmaker,0,3,14,59,1,13,0,73,0
News Athlete forcibly removed from plane – for being too tall,0,3,2,48,1,10,0,50,0
Emmitt Smith: RB Ezekiel Elliott 'poised to do great things' in NFL,0,2,9,44,3,11,0,53,0
Birds Can Take Cues From Eyes of Humans,0,1,7,25,0,7,0,32,0
Brendon McCullum facing suspension after Brisbane Heat lose to Perth Scorchers at Gabba,0,3,8,67,0,12,0,75,0
US senators say food aid constraints delay help amid famine ,0,3,2,48,0,10,0,50,0
"Derrick Rose misses Knicks game, said to have Chicago family issue",0,3,4,51,1,10,0,55,0
Inside John Calipari’s Media Empire ,0,3,5,25,1,5,0,30,0
Steve Stricker Jumps Into Contention With a Personal Best,0,1,8,41,0,8,0,49,0
A Profit for Medco and a Loss for Tenet,0,1,5,26,0,8,0,31,0
"With ROOT Sports RSNs And NESN Added, All But Three MLB Teams Will See In-Market Streaming",0,3,27,46,2,15,0,73,0
Stephen Colbert Says Moby Is Just As Credible As Kellyanne Conway,0,3,11,44,0,10,0,55,0
"Comcast ‎Xfinity Truck Blocks Traffic, Sends Cars Careening Off Icy Road",0,3,11,49,2,10,0,60,0
"Obama Is Nudging Views on Race, a Survey Finds",0,1,7,30,1,8,0,37,0
White House officials played role in surfacing documents Nunes viewed ,0,3,3,57,0,10,0,60,0
Supermarkets ration lettuces after poor weather hits growers,0,3,1,52,0,7,0,53,0
What led to the freeing of 226 Christians from ISIS,0,3,6,33,0,9,3,39,0
Unanimous U.S. Supreme Court rules against file swapping companies,0,1,5,51,2,8,0,56,0
Clinton Goes After Trump,0,2,4,17,0,3,0,21,0
Religious Leaders Walk a Careful Line on Politics at the Pulpit,0,2,7,46,0,10,0,53,0
Charles Schwab AdvisorVoice: How To Find The Type Of Money Advisor You Need,0,3,14,48,1,12,0,62,0
2 Chainz Is Selling the World's Most Expensive Ugly Christmas Sweater,0,2,9,48,1,10,1,57,0
Trump: ’NOT’ a smooth transition after Obama ’roadblocks’,0,2,5,40,5,7,0,45,0
Three men arrested under suspicion of organising dog fights in southern Finland,0,1,2,66,0,11,0,68,0
Spicer: Stories Of A Bannon-Kushner Rift Are ’Overblown’,0,2,9,36,4,7,0,45,0
Trump on ‘Saturday Night Live’? Nope. It’s Putin and Ansari. ,0,2,8,37,6,10,0,45,0
"Jeff Sessions, a Lifelong Outsider, Finds the Inside Track ",0,3,7,41,2,9,0,48,0
EU Sanctions Hawk Says Russia Stance Wouldn’t Budge on U.S. Thaw,0,3,12,39,3,10,0,51,0
Anthony Rizzo Inspired Cubs Before Game 7 of World Series with Naked Speech,0,3,10,52,0,12,1,62,0
Setbacks in Bay Area Add to Pain for The Chronicle,0,1,7,34,0,9,0,41,0
Malawian president inaugurated after reelection,0,1,1,42,0,4,0,43,0
"US offers to eliminate duties on Cotton, Africa says it's not enough",0,1,4,51,2,11,0,55,0
Bodies of Chapecoense players killed in plane crash returned to Brazil,0,2,3,57,0,10,0,60,0
Freddie Flintoff and Professor Green discuss their battles with mental illness,0,3,4,64,0,10,0,68,0
Delicious Irony: BuzzFeed’s Old-School Cookbook Is Bestseller,0,2,9,43,3,6,0,52,0
Delhi Man Arrested For Hiring A Hitman To Kill Ex-Lover's Husband By Injecting Cocktail Of Drugs,0,3,17,62,2,15,0,79,0
Haley: UN Has Been Constantly Bias Against Israel,0,3,9,32,1,7,0,41,0
Student makes ridiculous Twitter bet for free Wendy’s chicken nuggets ,0,3,3,56,1,10,0,59,0
Yemenis protest on war's second anniversary,0,3,1,36,1,5,0,37,0
Russia-US row: Trump praises Putin amid hacking expulsions,0,3,5,44,2,7,0,49,0
ELF Cup kicks off in Turkish Republic of Northern Cyprus,0,1,8,39,0,9,0,47,0
Bill Moyers: It’s Time For These Two Democrats To Go,0,2,10,31,2,9,0,41,0
John Lewis Blasts Steve King's 'Bigoted And Racist' Comments,0,2,9,40,3,8,0,49,0
Tomahawk missiles: Explaining the weapons the US used to strike Syria,0,2,5,53,1,10,0,58,0
"Now, Navjot Singh Sidhu Says He's 'A Born Congressman', This Is His 'Ghar Wapsi'",0,2,14,46,7,13,0,60,0
GOP Congressman Says the Poor ‘Just Don’t Want Health Care’,0,3,11,36,3,9,0,47,0
Whooping cough outbreak kills ten infants in California,0,1,2,46,0,7,0,48,0
Melissa Etheridge: ‘I’d Much Rather Have a Smoke With My Grown Kids Than a Drink’ [Video],0,2,14,54,6,15,0,68,0
Five injured after gun fires accidentally during wedding at Waldorf Astoria,0,3,3,62,0,10,0,65,0
Nightclub Massacre in Istanbul Exposes Turkey’s Deepening Fault Lines ,0,2,8,52,1,9,0,60,0
"As Brexit Nears, Support for Leaving the EU Falls in This Member",0,3,10,42,1,11,0,52,0
Clever Anti-Hillary Ad Slays by Making Viewers Think It’s Pro-Clinton,0,2,11,46,3,9,0,57,0
Somalia: 110 dead from hunger in past 48 hours in drought ,0,3,1,40,1,11,5,41,0
"For Golfer, Wrong Ball Turns Into Right Move",0,1,8,28,1,7,0,36,0
Canada keeping eye on Deepwater Horizon spill,0,1,3,36,0,6,0,39,0
Gunman kills self and hostage in Texas NASA building,0,1,6,38,0,8,0,44,0
From faded Ferris wheels to rusting roller-coasters: Inside Japan's eerie abandoned amusement parks,0,3,4,80,3,12,0,84,0
Jahlil Okafor Reportedly a Trade Target for Indiana Pacers Before 2017 Deadline,0,3,9,55,0,11,4,64,0
Faith Hill & Tim McGraw Preach Respect Toward Women With New Song 'Speak to a Girl',0,3,14,51,3,15,0,65,0
Another Jewish Cemetery Was the Target of an Alleged Anti-Semitic Attack  Insider,0,2,10,58,1,12,0,68,0
"Live updates: Decision day for health care, Trump and Russia",0,3,4,45,2,9,0,49,0
"The Grand Tour episode 5 review: Moroccan Roll gave us generic, grumpy fun - and was all the better for it",0,3,5,77,3,20,1,82,0
Adidas to Release Limited-Edition Collection of Marvel's Avengers Shoes,0,2,8,53,2,8,0,61,0
Lords vote against second Brexit referendum,0,3,2,36,0,5,0,38,0
SpaceX to fly two space tourists around the moon in 2018,0,2,2,40,0,10,4,42,0
House Republicans seek Department of Justice investigation into potentially illegal leaks ,0,3,4,75,0,11,0,79,0
Vaughan Gething: ‘You can go to A&E and be there five hours but have a good experience’,0,3,5,62,4,16,0,67,0
Federal Workers Union Slams Trump Climate Order As 'Assault' On Public Health,0,3,12,52,2,11,0,64,0
Snapchat Spectacles are now being used in professional sports too,0,3,2,54,0,9,0,56,0
World War II vet gets Purple Heart after waiting more than seven decades ,0,3,6,54,0,13,0,60,0
Rescue efforts underway after China earthquake,0,1,2,39,0,5,0,41,0
Missing mother and two young sons found safe more than a week after vanishing,0,2,1,63,0,13,0,64,0
"U.S. ‘Probably Had a Role’ in Mosul Deaths, Commander Says ",0,3,9,35,5,10,0,44,0
ABC News anchorman Peter Jennings diagnosed with lung cancer,0,1,6,46,0,8,0,52,0
"Israel warms to Sunni powers, questions US’ Palestinian focus",0,2,5,46,2,8,0,51,0
Russian Businessman Viktor Bout Accuses D.E.A. Agents in Extradition Fight,0,1,11,51,3,9,0,62,0
Canadian provinces brace for more flooding,0,1,1,36,0,5,0,37,0
Eye Opener: Bitter cold breaks records across U.S.,0,2,5,35,3,7,0,40,0
K.J. Lawson apologizes for profane comment directed at ex-coach Tubby Smith,0,3,5,57,3,10,0,62,0
National Debate About G.O.P. Hits Home in Utah,0,1,9,27,3,7,0,36,0
A former Oxford English Dictionary editor explains the word 'pom',0,3,4,50,2,9,0,54,0
Probe: Brussels Airport Bombers ‘Wanted to Kill Jews and Americans’,0,3,8,47,3,9,0,55,0
"WWE Superstar Kane Announces He's Running for Mayor of Knox County, Tennessee",0,2,12,52,2,11,0,64,0
Haitian migrants drown and many more still missing,0,1,1,42,0,7,0,43,0
Steve Perry Says First Solo Album in 23 Years Inspired by Personal Tragedy,0,3,10,50,0,12,2,60,0
"Facebook Annual Meeting ‘Very Staid,’ Needs More Fun, Investor Says - Digits",0,2,11,49,5,11,0,60,0
A Border Adjustment Tax Threatens Disruption For U.S. And Its Neighbors,0,2,12,47,2,10,0,59,0
Thief force-fed fifty bananas to retrieve necklace,0,1,1,42,1,6,0,43,0
Trump admin ordered to produce list of travelers detained under ban ,0,3,1,56,0,11,0,57,0
The Mark Zuckerberg Manifesto Is a Blueprint for Destroying Journalism,0,2,8,53,0,9,0,61,0
Philippines prepares for new typhoon,0,1,1,31,0,4,0,32,0
Presidential,0,2,1,11,0,0,0,12,0
First same-sex couple wed in south of France,0,1,2,34,1,7,0,36,0
Warren Buffett in New HBO Documentary: ‘I’m Getting Down to Salvage Value’  ,0,3,12,47,4,13,0,59,0
Murray Ball: Fans pay tribute to late Footrot Flats New Zealand cartoonist,0,3,7,55,1,11,0,62,0
Sailors freed after being captured in Nigeria,0,1,2,37,0,6,0,39,0
"Obama Attacks Trump Over His Anti-Immigration Executive Order, Supports Anti-Trump Protests Across America",0,2,15,76,3,12,0,91,0
Former Labor Secretary Tom Perez elected DNC chair ,0,3,8,35,0,8,0,43,0
Live Conversation: USWNT vs. Sweden,0,3,8,21,2,4,0,29,0
Illinois hiring Oklahoma State's Brad Underwood,0,3,5,36,1,5,0,41,0
DUTCH POLICE: Berlin market attack suspect may have passed through Netherlands,0,3,13,54,1,10,0,67,0
Trump's 'Tiny Hands' Are at the Center of Latest Amazing Photoshop War,0,3,9,47,3,11,0,56,0
Roommates Divide and Conquer With Temporary Walls ,0,3,6,37,0,7,0,43,0
IRA assets worth 30 million pounds investigated,0,1,3,36,0,6,2,39,0
Missile Strike Kills 4 in Pakistan,0,1,4,24,0,5,1,28,0
"Letters From Einstein About God (and Toys) Sell for $420,625",0,2,7,34,4,9,6,41,0
Double-amputee military veteran graduates from police academy ,0,3,1,53,1,7,0,54,0
"Donald Trump is a pathological liar working to undermine US democracy, says Bernie Sanders",0,3,6,70,1,13,0,76,0
Hurricane Fred churns the Atlantic,0,1,3,27,0,4,0,30,0
"Austria election: Van der Bellen promises to be ""pro-European"" president",0,3,4,55,4,9,0,59,0
Drinking habits tied to genes,0,1,1,24,0,4,0,25,0
Fallout From Supreme Court Ruling Against Texas Law’s Abortion Restrictions,0,2,10,55,1,9,0,65,0
Former President Obama Beats Richard Branson in Surf Contest [Video],0,3,9,48,2,9,0,57,0
Darrelle Revis turns himself in,0,3,2,25,0,4,0,27,0
Donkey bloggers facing jail sentence in Azerbaijan,0,1,2,42,0,6,0,44,0
10 Athletes That Should Have Signature Sneakers,0,2,6,33,0,6,2,39,0
Theresa May's new economic adviser supported tax increases to pay down deficit,0,3,2,64,1,11,0,66,0
You’re Hired: Donald Trump Picks Gov. Nikki Haley as Ambassador to the United Nations - Breitbart,0,2,12,66,4,15,0,78,0
How ABC Interview Shaped a Torture Debate,0,1,8,27,0,6,0,35,0
"18 million would lose insurance in first year of Obamacare repeal without replacement, CBO report says",0,3,4,80,1,15,2,84,0
White House Takes Aim at Obama Era Climate Policy in New Executive Order,0,2,11,49,0,12,0,60,0
DHS Draft Report Casts Doubt on Extra Threat From ‘Travel Ban’ Nationals in U.S.,0,2,15,48,4,13,0,63,0
Filipino troops kill notorious Abu Sayyaf kidnapper in clash ,0,3,3,49,0,9,0,52,0
Supreme Court Nominee Calls Trump’s Attacks on Judiciary ‘Demoralizing’ ,0,2,8,52,3,9,0,60,0
"Waiting for Mugabe’s Exit, Zimbabweans Endure Shattered Economy",0,3,7,47,2,7,0,54,0
Bangkok Was The World's Most Visited City In 2016 [Infographic],0,2,9,38,3,9,4,47,0
"Motorcycle racer struck by lightning during event, finishes anyway ",0,3,1,56,1,9,0,57,0
Suspect in Road Rage Killing of 3-Year-Old Boy Said Car Was Following Too Close ,0,3,13,50,2,14,1,63,0
Australia: You can now go live on Instagram along with everybody else,0,3,3,54,1,11,0,57,0
"Watch Mike Will Made-It, 21 Savage, YG & Migos Floss in 'Gucci On My' Video",0,3,14,39,6,14,2,53,0
"Posting Loss, BT Group to Trim 15,000 Jobs",0,1,7,21,2,7,5,28,0
These tiny diapers fit babies less than 2 pounds,0,3,1,38,0,8,1,39,0
Oslo on terror alert after ‘bomb-like’ device found by police,0,3,1,48,3,9,0,49,0
Snapchat slashes valuation by billions ahead of stock market flotation,0,3,1,60,0,9,0,61,0
20 Likeliest NBA Players to Be Dealt This Offseason,0,2,9,32,0,8,2,41,0
Katty Kay: Spicer had choice - apologise or dig,0,3,3,34,2,8,0,37,0
Here comes GDP ...,0,3,4,8,3,3,0,12,0
"Here’s How Apple Music Compares With Spotify, Pandora, and Tidal",0,2,9,43,3,9,0,52,0
Issue of Execution and the Retarded Returns to Supreme Court,0,1,6,45,0,9,0,51,0
Google Apologizes After Major Brands Yank YouTube Ads Over Racist Content,0,3,12,51,0,10,0,63,0
"Meet Troye Sivan, 30 Under 30 Musician And YouTube Star",0,3,9,32,1,9,4,41,0
St. Louis Batters Hernandez to Complete Sweep,0,1,6,32,1,6,0,38,0
A Big Wall Falls in China to Make Room for Mickey,0,1,8,31,0,10,0,39,0
"Joni Sledge, Member of Sister Sledge, Dies at 60",0,2,6,30,2,8,2,36,0
Rick Derringer Pleads Guilty to Bringing a Loaded Gun on an Airplane,0,3,8,49,0,11,0,57,0
Nearly 100 Tech Companies Oppose Trump's Muslim Ban,0,3,7,33,1,7,3,40,0
China's new topsy-turvy bridge actually has three bridges woven into one,0,2,1,59,2,10,0,60,0
"Like a Virgin, in Space for the Very First Time",0,3,6,31,1,9,0,37,0
Judge blocks release of Orlando nightclub gunman's widow ,0,3,2,46,1,8,0,48,0
Where Did Big Sean And Kendrick Lamar Go Wrong?,0,2,9,29,1,8,0,38,0
UK children's charities announce merger,0,1,2,32,1,4,0,34,0
Twitter Roasts Golden State Warriors for All-Star Photo Shoot,0,3,9,43,1,8,0,52,0
Tyson Launches $150 Million VC Fund That Could Help Hedge Against A Meatless Future,0,2,14,52,1,13,3,66,0
A master networker explains how to single out the most interesting people at any event,0,2,1,71,0,14,0,72,0
"President Trump, Italian Prime Minister Paolo Gentiloni hold news conference -- watch live ",0,2,7,68,3,13,0,75,0
"Man in Custody in Turkey After Firing Gun in Front of US Embassy, No One Harmed ",0,3,13,50,1,16,0,63,0
Italy migrant crisis: Charities 'colluding' with smugglers,0,3,2,47,3,6,0,49,0
"A Fox panelist made NSFW comments to a female host, less than a day after a sex scandal The list",0,3,7,69,1,19,0,76,0
"Google, Facebook and Twitter Yield to Government Demand to Censor ’Hate Speech’",0,2,9,56,3,11,0,65,0
102-Year-Old Ingeborg Syllm-Rapoport Completes Thesis Blocked by Nazis,0,3,9,48,3,7,3,57,0
Theresa May set to attend House of Lords Article 50 debate in person ,0,3,5,49,0,13,2,54,0
China issues first-ever red alert for fog,0,3,1,33,1,6,0,34,0
The life of Martin Luther King Jr: Telegraph time tunnel,0,3,6,40,1,9,0,46,0
CBO: 14M more Americans won't have health insurance next year if GOP plan adopted ,0,3,8,56,2,14,2,64,0
United Nations requests US$700 million in aid for East Africa to avoid famine,0,1,6,55,1,12,3,61,0
"Tonight During Earth Hour, Here's How You Can Help Save 7,618 Tonnes Of Coal In Just 1 Hour",0,2,16,50,3,17,5,66,0
Cordarrelle Patterson Pays Tribute to Vikings Legend Randy Moss with Cool Socks,0,2,10,58,0,11,0,68,0
Mets Show More Reasons for Their Optimism,0,1,6,29,0,6,0,35,0
Bus crash in Spain leaves 9 Finnish tourists dead,0,1,3,37,0,8,1,40,0
On-The-Field Report: Lady Gaga Leaves Her Heart on the Dance Floor at Super Bowl 2017,0,2,13,51,3,14,4,64,0
North Korean leader Kim Jong-il 'has cancer',0,1,4,31,3,6,0,35,0
Pope wishes Christmas peace to those scarred by war ,0,3,2,41,0,9,0,43,0
Mistrial declared in North Charleston police shooting case ,0,3,3,48,0,8,0,51,0
"Indian activist begins ""fast-unto-death"" hunger strike to end corruption",0,1,1,59,4,8,0,60,0
Americans Are Setting Pace at Nordic World Championships,0,1,7,42,0,7,0,49,0
"After 1,000 Year Slumber, China Vows to Invent Again",0,2,7,31,2,8,4,38,0
The Trump administration just put Iran 'on notice' â but the Pentagon has no idea what that means,0,2,4,74,4,17,0,78,0
Twitter Users Can't Stop Poking Fun at Dwyane Wade's New Year's Eve Outfit,0,3,12,47,3,12,0,59,0
US swimmer dies in open-water race,0,1,2,26,1,5,0,28,0
Drake's 'More Life' Sets a New Streaming Record,0,2,7,30,3,7,0,37,0
Alton Towers ride evacuated because technical delay panicked customer,0,3,2,59,0,8,0,61,0
More Hotels Facing an Uncertain Future,0,1,5,28,0,5,0,33,0
"Man Broadcasts Murder of Infant Daughter on Facebook, Then Kills Himself",0,3,9,52,1,10,0,61,0
BAML: We’re revising our Fed rate-hike call because of a ’loss of momentum’ in US data,0,2,8,58,5,15,0,66,0
Judge Alex: Miami-Dade Dropping Sanctuary Status Is 'Harbinger' of What's to Come  Insider,0,2,12,60,5,13,0,72,0
The best SD cards you can buy for your DSLR camera,0,3,7,33,0,10,0,40,0
U.S. Pullout a Condition in Afghan Peace Talks,0,1,7,30,2,7,0,37,0
Little Girl Who Went Bald From Alopecia Celebrates ‘Crazy Hair Day’ [Video],0,3,12,48,4,11,0,60,0
PM accepts Michaelia Cash apology for 'oversight' on investment property,0,3,4,57,2,9,0,61,0
Austria To Ban Migrants From Purchasing Firearms,0,2,7,35,0,6,0,42,0
Rapper 'Little Kim' sentenced to 1 year in prison,0,1,3,35,2,8,1,38,0
Longtime Turner broadcaster Craig Sager dead at age 65,0,3,4,40,0,8,2,44,0
A Brief History of the Ownership of the Beatles Catalog,0,3,6,40,0,9,0,46,0
"Pushing an Agenda, and Raising Cash for It",0,1,5,29,1,7,0,34,0
Can Trump really bring back coal jobs? The verdict is mixed ,0,3,3,45,1,11,0,48,0
Mike Krzyzewski to Return vs. Pitt: Latest Comments and Reaction,0,3,7,46,2,9,0,53,0
"Preview: Daryl Hall and John Oates, the duo joined by a gunfight",0,3,5,46,2,11,0,51,0
"Alex Rodriguez Passes 2,000 RBI With Home Run vs. Orioles",0,3,10,32,2,9,4,42,0
Hammond puts aside £500m to fill post-Brexit skills gap,0,2,2,40,2,8,3,42,0
These strange 1917 photos were supposed to teach businessmen how to get in shape for success,0,3,1,72,0,15,4,73,0
200-Ton Rockslide Shuts Down Utah's Zion National Park Video ,0,3,9,38,2,9,3,47,0
NBA Power Rankings with 1 Week to Go in Regular Season,0,3,9,34,0,10,1,43,0
Second NFL Player Targeted By Stomach-Turning Racism,0,3,10,35,1,6,0,45,0
The galaxy of Trump's presidential appointments,0,3,2,39,1,5,0,41,0
Science journal retracts  107 'fabricated' research papers by Chinese authors,0,3,2,60,2,10,3,62,0
"Trump's America Donald Trump accepts Russia engaged in US election cyber attacks, chief of staff says",0,3,7,77,2,15,0,84,0
Oklahoma home invasion shooting: No charges against man who killed 3 intruders ,0,3,2,63,1,12,1,65,0
"James Corden jokes about the spying vibrator, making the point that nothing is sacred",0,3,2,69,1,13,0,71,0
"Amazingly, Donald Trump still doesn't know how to shake a hand",0,2,3,47,2,10,0,50,0
Global Colleges Ranked by Subject,0,2,4,25,0,4,0,29,0
Oil prices reach six-month high,0,1,1,25,1,4,0,26,0
"After Long Layoff, Baker-Finch Back at Colonial, Site of First PGA Win in 1989",0,1,13,45,3,13,4,58,0
Male models win The Amazing Race,0,1,4,23,0,5,0,27,0
Europe Needs a Higher Price on Carbon,0,3,5,26,0,6,0,31,0
House Democrats challenge Deutsche Bank over review of Trump’s accounts,0,2,5,56,1,9,0,61,0
Stocks Slump on Corporate Woes; Indexes Fall by 3.4%,0,1,6,33,3,8,2,39,0
US immigration judge grants asylum to Singapore teen blogger ,0,3,3,49,0,9,0,52,0
Trump Says CNN Is Fake News — But That’s Where He Wants Surrogates,0,2,14,38,2,12,0,52,0
New U.S. immigration bill proposes time-limit and employer scrutiny,0,1,3,53,3,8,0,56,0
Queer Muslim women from the south: ’We exist and we’re fierce’,0,2,3,45,4,10,0,48,0
Constitutionality of DNC Florida primary to be decided in appeal,0,1,5,50,0,9,0,55,0
Tillerson crosses the border to rebuild ties with Mexico,0,3,2,46,0,8,0,48,0
Pharmacist fights for licence after fake Viagra found at Sydney Children's Hospital,0,3,5,66,1,11,0,71,0
Trump press conference fact-check: What the president got wrong and right ,0,2,2,59,2,11,0,61,0
31 Somali refugees killed in helicopter attack off the coast of Yemen,0,2,2,54,0,11,2,56,0
New Australian industrial relations legislation passes House of Representatives,0,1,4,67,0,8,0,71,0
7 Technology Trends That Will Dominate 2017,0,3,5,27,0,6,5,32,0
Independent Film Service on Shopping Spree at Sundance,0,1,6,41,0,7,0,47,0
Missouri Circuit Court Judge Werner Moentmann rules that Planned Parenthood must repay money.,0,1,8,72,1,12,0,80,0
Takata’s $1 Billion Air-Bag Settlement Could Make a Sale Easier,0,3,9,41,3,9,1,50,0
"David Rockefeller, Billionaire Businessman and Philanthropist, Dies at 101",0,2,6,55,2,8,3,61,0
Russia launches Progress spacecraft to resupply Space Station,0,1,4,50,0,7,0,54,0
Meet Sandhurst's first Pakistani instructor,0,3,3,35,1,4,0,38,0
U.S. Demands Return of Drone Seized by Chinese Warship ,0,3,8,36,2,9,0,44,0
India becomes second country to give rivers human status,0,2,1,47,0,8,0,48,0
"Chile tsunami first reached Pichilemu, SHOA reports",0,1,6,38,1,6,0,44,0
Mika Brzezinski says Clinton campaign wanted her 'pulled off the air' ,0,3,3,54,2,11,0,57,0
"One quarter of Americans believe God will intervene in the Super Bowl, survey says",0,2,5,63,1,13,0,68,0
The Top Trump Controversies of The First 100 Days,0,3,7,31,0,8,3,38,0
Chicago grandmother guilty in torture death of 8-year-old granddaughter ,0,3,1,59,2,9,1,60,0
Digital Storage Options for Workers on the Go,0,1,5,33,0,7,0,38,0
North Dakota teen gets accepted by all 8 Ivy League schools,0,3,4,44,0,10,1,48,0
New Bionic Leg Can Learn and Predict How You Move,0,3,9,31,0,9,0,40,0
"U.S. Offers Europe Goodwill, and Expects Something in Return",0,1,8,41,3,8,0,49,0
"Free to Be Himself, James Harden Looks an Awful Lot Like an NBA MVP",0,3,15,38,1,13,0,53,0
Titus Young Reportedly Sentenced to 4 Years in Prison in Assault Case,0,3,8,49,0,11,1,57,0
Theresa May must not falter in tackling domestic violence,0,3,2,47,0,8,0,49,0
Global Warming Hysteria Comes to Texas - Breitbart,0,2,6,36,1,7,0,42,0
Boeing's Iran deal won't prevent production cut,0,2,2,37,2,6,0,39,0
"Watch Alec Baldwin Pull Double Duty, Interviews Trump as Bill O'Reilly on 'SNL'",0,3,14,49,4,12,0,63,0
Washington shooting suspect found dead in cell,0,2,1,39,0,6,0,40,0
"Wikinews interviews Mike Lebowitz, Chairman of the Modern Whig Party",0,1,7,51,1,9,0,58,0
49ers RB Tim Hightower Vows to Return Team-Issued No. 21 in Honor of Frank Gore,0,2,12,47,2,14,4,59,0
"Sherpa mountaineer Nawang Gombu, first to summit Mount Everest twice, dies",0,1,5,57,2,10,0,62,0
2007 Twenty20 World Championship: India vs Pakistan,0,1,5,33,1,6,6,38,0
Scotland's First Minister does comedy sketch for charity,0,1,3,45,1,7,0,48,0
Bill Gates says robots should be taxed The list,0,3,3,36,0,8,0,39,0
Derek Carr Injury: Raiders QB Suffers Broken Fibula vs. Colts,0,3,10,40,2,9,0,50,0
United Grapples With PR Crisis Over Videos of Man Being Dragged Off Plane ,0,2,13,48,0,13,0,61,0
Scientists create micro-battery using 3D printing,0,1,2,40,1,5,1,42,0
Large fire burns in Dubai near site of dramatic 2015 blaze ,0,3,2,42,0,11,4,44,0
Mayor declares weather emergency in New York City,0,1,4,38,0,7,0,42,0
Prince Harry receives colourful welcome at Nepalese embassy,0,3,3,49,0,7,0,52,0
Germany's GUN Records closes,0,1,5,19,1,3,0,24,0
Alexander Hamilton's Letters to be Auctioned in NYC,0,3,7,36,1,7,0,43,0
Questions and Apathy Surround Shootings by Officer in Miami Beach,0,1,7,49,0,9,0,56,0
"Jay Z Shuns Donald Trump Question, Recalls Meeting with Kalief Browder at Sundance Film Festival",0,2,13,68,1,14,0,81,0
7 Die as Police and Militants Clash in Southern Russia,0,1,6,38,0,9,1,44,0
"Apple Finally Widely Releases New Emoji Including Shrug, FacePalm, Selfie",0,3,11,51,2,9,0,62,0
Man arrested on suspicion of murdering girl in Rotherham,0,3,2,46,0,8,0,48,0
Donald Trump says US prepared to go it alone on North Korea nuclear threat,0,3,6,55,0,13,0,61,0
The Latest: Judge: Proof against shooter's wife 'debatable' ,0,3,4,43,5,8,0,47,0
Domestic Violence Endures on Staten Island    ,0,2,5,32,0,9,0,37,0
"In 30 years, the world's best CEO will be a ROBOT claims billionaire Alibaba founder Jack Ma",0,2,12,60,2,16,2,72,0
Rupert Murdoch Stepping Down As CEO Of 21st Century Fox,0,3,11,33,0,9,2,44,0
Keeping Score on Obama vs. Netanyahu,0,1,4,26,1,5,0,30,0
"SAHTECH, SEMI, and Semiconductor Industry to promote ""SEMI Safety Guideline"" in Taiwan",0,1,20,51,4,11,0,71,0
U.N. Says Thousands Killed in Sri Lanka,0,1,7,24,2,6,0,31,0
U.S. Marines accused of assaulting Australian freed by U.S. military court,0,1,6,54,4,10,0,60,0
Game of Thrones season 7: Mark Gatiss confirms his return (and presumably the Iron Bank),0,3,6,64,3,14,1,70,0
J.R. Smith and His Wife Give a Heartbreaking Update on Their Newborn Daughter,0,2,11,52,2,12,0,63,0
"Hands-on with Samsung's latest flagship smartphones, the Galaxy S8 and Galaxy S8+",0,3,6,58,4,11,2,64,0
Barclays CEO Jes Staley Faces Pressure Over Re-Election ,0,3,11,36,1,8,0,47,0
When an 18-Year-Old Son Needs Elbow Surgery,0,1,7,26,2,6,2,33,0
New Zealanders being urged to become condom testers,0,1,2,42,0,7,0,44,0
Hundreds of whales wash up dead on New Zealand beach,0,3,3,40,0,9,0,43,0
"Amid historically low approval ratings, Trump now has to turn vision into policy",0,3,2,65,1,12,0,67,0
"Lest We Forget, America Suffered Its Deadliest Mass Shooting This Year",0,3,11,48,1,10,0,59,0
Nigerian Mortgage Lenders Strain as Loans Sour on Job Losses,0,3,8,43,0,9,0,51,0
Erdogan Hits Germany With Nazi Slur as Relations Deteriorate,0,3,8,44,0,8,0,52,0
Prince Harry Opens Up About Mental Health After Mom’s Death,0,3,10,39,1,9,0,49,0
Officials Share Video Showing Shooting of Boston Terror Suspect Usaamah Rahim,0,3,10,57,0,10,0,67,0
#CuteAnimalTweetOff: Zoos compete to claim cutest animal,0,3,5,43,2,6,0,48,0
A porn site decided to step in when this State voted against sex education The list,0,3,3,65,0,15,0,68,0
"Carnival’s Princess Cruises to pay record fine for pollution, cover-up",0,3,3,55,3,9,0,58,0
California Approaches a Deal on Budget Cuts,0,1,5,32,0,6,0,37,0
Norway Slides Into Recession,0,1,4,21,0,3,0,25,0
Can Amazon Echo help solve a murder? Police will soon find out.,0,2,4,46,2,11,0,50,0
'Egg Sheeran' will be the perfect addition to your Easter baskets,0,2,3,50,2,10,0,53,0
Obama Reassures Countries on U.S. Debt,0,1,6,25,2,5,0,31,0
Rob Manfred Wants Indians to 'Transition Away From' Chief Wahoo Logo,0,3,10,46,2,10,0,56,0
Kellyanne Conway calls CIA report on Russian election meddling ‘laughable and ridiculous’,0,3,6,70,2,11,0,76,0
East Timor tears up oil and gas treaty with Australia after Hague dispute,0,2,4,57,0,12,0,61,0
Mnuchin Says to Expect Complete Tax Overhaul by August,0,3,7,39,0,8,0,46,0
Real Madrid 2-1 Real Betis: La Liga – as it happened,0,2,6,31,3,10,2,37,0
"ISIS is manufacturing arms on industrial scale, report finds ",0,3,4,47,1,9,0,51,0
African nations gather to support a ban on cluster bombs,0,1,1,46,0,9,0,47,0
Senate panel advances Jeff Sessions nomination to serve as attorney general,0,3,3,62,0,10,0,65,0
United Airlines just announced 10 major changes to avoid another violent passenger-removal incident,0,3,2,82,1,12,2,84,0
Kim Kardashian West: French arrests over Paris robbery,0,2,5,41,1,7,0,46,0
Dakota Access oil pipeline protesters unroll huge banner at Vikings game,0,3,3,59,0,10,0,62,0
Sunny Leone's Killer Moves & SRK's Intensity In 'Laila Main Laila' Will Set Your Screen On Fire,0,3,18,56,5,16,0,74,0
Moderate Is Said to Be Pick for Court,0,1,6,24,0,7,0,30,0
Brexit Brexit: What will be the short-term damage when the UK leaves the EU single market?,0,3,7,65,3,15,0,72,0
Former and current Fox News employees speak out on racial discrimination suit ,0,3,3,63,0,12,0,66,0
Stephen Curry: 'It's Comical That People [Are] Saying I'm Having a Down Year',0,3,12,46,7,12,0,58,0
Saudi Institute Reverses Decision to Allow Women to Wear Pants,0,2,8,45,0,9,0,53,0
Police end investigation into attack on Strictly's Gorka Márquez,0,2,4,51,1,8,0,55,0
A Trap for a Trader,0,3,3,12,0,4,0,15,0
ThumbTack Turns an iPod Into a Recording Device,0,1,7,33,0,7,0,40,0
Clinton v Trump on the economy: speeches underscore competing visions,0,2,2,57,1,9,0,59,0
These people lost bets — and paid the price in ink,0,2,1,38,1,10,0,39,0
Blast in Iraq Kills 3 Americans,0,1,4,21,0,5,1,25,0
European Tourism Interest In America Plummets 12% Following Travel Ban,0,2,9,49,1,9,2,58,0
"Soulja Boy Appears to Get Robbed in Wild IG Live Video, Chris Brown and Twitter React",0,2,14,55,1,15,0,69,0
Antonio Conte’s big regret about leaving Italy for Chelsea is not doing it sooner,0,3,4,63,1,13,0,67,0
How Crowdfunding Took On Private Equity And Won,0,3,8,32,0,7,0,40,0
Volunteers pitch in to stop Indigenous families being evicted from public housing,0,3,2,68,0,11,0,70,0
"UN: 30,000 people affected by flooding in Kenya",0,1,3,30,2,7,5,33,0
Disputed island disappears beneath sea on India-Bangladesh border,0,1,3,54,1,7,0,57,0
"Lost antique engagement ring found, thanks to comments section in Georgia newspaper - Yahoo",0,3,3,73,2,13,0,76,0
Ousted S Korean President Park Geun-hye faces prosecutors,0,3,6,43,1,7,0,49,0
Florida Supreme Court says hundreds of death row inmates may get new sentences and avoid execution,0,3,3,80,0,15,0,83,0
US Airways jet recovered from Hudson River,0,1,5,31,0,6,0,36,0
Rhode Island man arrested with record blood-alcohol reading,0,1,2,49,1,7,0,51,0
Sri Lanka's foreign minister killed in sniper attack,0,1,2,42,1,7,0,44,0
"Man removed from flight after allegedly harassing Ivanka Trump, Jared Kushner",0,2,5,61,1,10,0,66,0
"NYC's Rikers jail slated for closure within 10 years, mayor says",0,3,4,46,2,10,2,50,0
Trump: I'm 'Absolutely' Considering Breaking Up 'Outrageous' 9th Circuit  Insider,0,3,9,55,6,10,1,64,0
"God help us all, Martha Stewart's truck is stuck in the snow",0,2,3,44,2,11,0,47,0
Post Malone Reminds Us He Has Unreleased Music With Kanye West,0,3,11,41,0,10,0,52,0
Chaffetz calls on ethics head to testify day after chief criticized Trump ,0,2,2,60,0,12,0,62,0
'Perry Mason' actress Barbara Hale dies at 94 ,0,3,4,30,2,8,2,34,0
The UK has voted for this guy to be its national bird,0,3,3,39,0,11,0,42,0
Texas toddler dies after being left inside hot car ,0,3,1,41,0,9,0,42,0
Drug-dealers war in Rio de Janeiro,0,1,3,25,1,5,0,28,0
Dual U.S.-Israeli citizen charged with making threatening calls to Jewish Community Centers,0,3,7,70,3,11,0,77,0
Five New Power Centers: A Guide to the Fractured Democrats,0,3,8,40,1,9,0,48,0
Democratic Rep. Richmond: Kellyanne Conway Looked ’Familiar’ Kneeling on Oval Office Couch,0,2,11,64,4,11,0,75,0
China’s Anbang to acquire Strategic Hotels for $6.5 billion: source,0,2,4,48,4,9,2,52,0
Modern Military Families: Ensuring Security For The All-Volunteer Force,0,3,10,51,2,8,0,61,0
"Large hoard of Anglo-Saxon gold found in Staffordshire, England",0,1,5,48,2,8,0,53,0
Radio 1 apologises after Orlando Bloom says 'pikey' during live interview with Nick Grimshaw,0,3,5,71,2,13,1,76,0
Ecuador election: Voting to succeed President Correa begins,0,3,4,47,1,7,0,51,0
Catholic bishop attacked on altar during Mass for baseball Hall of Famer ,0,3,4,57,0,12,0,61,0
India washing machine launched with 'curry' button,0,3,1,41,2,6,0,42,0
"Clockwatch: Premier League, Ghana v Mali, and more – as it happened",0,2,5,47,4,11,0,52,0
Week 16 fantasy quarterback ranks,0,3,1,26,0,4,2,27,0
When therapists also need therapists: 'Suffering is not unique to one group',0,3,2,60,3,11,0,62,0
The Holocaust Survivor Who Built Houston's Hot New Hotel For Super Bowl LI,0,3,14,47,1,12,0,61,0
Nevada Plane Crash Kills 4,0,1,4,17,0,4,1,21,0
The Great Nevada Lithium Rush to Fuel the New Economy,0,3,8,36,0,9,0,44,0
Petraeus On Mishandling Classified Information: 'I Made a Serious Mistake',0,3,9,53,3,9,0,62,0
Putin Strikes Back: 'No Interference' With Trump Election,0,3,8,39,3,7,0,47,0
Experts: Social media giants fight Trump’s anti-terror plan while providing platform for terrorists ,0,3,3,81,3,13,0,84,0
Wendy's shows how to handle beef with Twitter troll,0,3,2,40,1,8,0,42,0
Lockerbie bomber Abdelbaset Ali al-Megrahi released on compassionate grounds,0,1,4,63,1,8,0,67,0
6 Immigrant Stories That Will Make You Believe In The American Dream Again,0,2,12,49,0,12,1,61,0
Arms Length Transaction!,0,2,3,18,1,2,0,21,0
More Empty Shop Windows in New York,0,1,6,23,0,6,0,29,0
"What are the odds? Mom, dad, son all share a birthday",0,3,2,38,3,10,0,40,0
U.S. Athletes Reassured After New Russian Hack - The New York Times,0,2,12,41,3,11,0,53,0
Texas Wins Victory for Farmers Against BLM,0,2,8,28,0,6,0,36,0
McLaren Mercedes drivers snatch the front row for 2007 Hungarian Grand Prix,0,1,6,54,0,11,4,60,0
South Africa reopens beaches after fatal shark attack,0,1,2,44,0,7,0,46,0
Even Germany’s Post Office Is Building an Electric Car,0,2,8,37,1,8,0,45,0
Cricket: India beat England in second one-day international,0,1,3,47,2,7,0,50,0
Akshay Kumar Is Willing To Return His National Award If People Think He Doesn’t Deserve It,0,3,16,58,1,15,0,74,0
"Girl, 8, dresses up as Ruth Bader Ginsburg",0,3,4,28,2,7,1,32,0
JPMorgan Plans to Sell Structured Notes Online Next Year,0,3,10,38,0,8,0,48,0
Amanda Nunes Trolls Ronda Rousey With Meme Following Dominating UFC 207 Victory,0,3,13,52,0,11,3,65,0
"Seth Troxler, NiÃ±o Arbol & More to Headline First-Ever BLACK Experience in Mexico City",0,2,17,53,4,13,0,70,0
Warriors sought intervention in Shaq-JaVale McGee feud,0,3,6,41,1,6,0,47,0
Ex-Barclays Banker Leaked Tips for Job With Plumber; Gets Jail,0,2,10,41,2,9,0,51,0
Trump names Alexander Acosta as new pick for labor secretary,0,3,3,48,0,9,0,51,0
"No peace in Syria until Assad is ousted, says Nikki Haley",0,3,5,41,1,10,0,46,0
Istanbul stadium attack: BBC witnesses anger at scene,0,3,4,41,1,7,0,45,0
PREVIEW: Martha MacCallum Sits Down With Trump Before 100-Day Mark  Insider,0,3,18,41,2,11,3,59,0
Boeing's new 787 Dreamliner lifts off in near-vertical ascent,0,2,2,46,2,8,3,48,0
Kendall Jenner Debunks Plastic Surgery Rumors: 'Why Would I Have My Face Reconstructed?' [Video],0,3,14,63,6,13,0,77,0
"Oklahoma state senator plans to resign following child prostitution charges, attorney says ",0,2,1,77,1,12,0,78,0
Mixed reactions to G8 summit,0,1,2,21,0,4,1,23,0
Alyx Ander Premieres 'Memories of You' feat. Srey Davi (Alyx's Day Mix): Exclusive,0,3,11,52,7,12,0,63,0
It's Time For An Outkast x Run The Jewels Collaboration,0,3,9,36,1,9,0,45,0
José Mourinho stops short of ruling out China move for Wayne Rooney,0,3,5,51,0,11,0,56,0
Arrest made over murder of UK gemstone expert in Kenya,0,1,4,41,0,9,0,45,0
"Metadata law reform needed after AFP illegally accesses journalist's call records, expert says",0,2,4,76,2,12,0,80,0
"Sunderland relegation ‘my worst day in football’, says David Moyes",0,2,3,51,3,9,0,54,0
"Madoff Accountant, David Friehling, Pleads Not Guilty",0,1,7,38,2,6,0,45,0
'Cream White' Yeezy Boosts Confirmed by Adidas,0,3,6,32,2,6,0,38,0
Big Changes on the Way in Lending to Students,0,1,5,32,0,8,0,37,0
Berlin Christmas Market Attack Suspect Anis Amri’s Fingerprints Found in Truck,0,3,10,57,1,10,0,67,0
Overcoming the Confidence Gap for Women ,0,2,4,30,0,6,0,34,0
Syrian Al-Qaeda affiliate claims twin bombing in Damascus,0,3,4,45,1,7,0,49,0
"If space didn't kill them, astronauts still had to train for survival in deserts and jungles",0,3,1,74,2,15,0,75,0
Taylor Swift surprises 96-year-old WWII veteran for Christmas ,0,2,7,43,2,8,2,50,0
"After Pope Encourages Giving Money To Homeless People, U.S. Bishop Says Don't",0,3,13,49,4,11,0,62,0
"Work-Life Balance Vs. Work-Life Integration, Is There Really A Difference?",0,3,12,48,5,9,0,60,0
US Chief Justice John Roberts hospitalized,0,1,6,31,0,5,0,37,0
"30 dead in Baghdad bomb blasts, hundreds of people injured",0,1,1,45,1,9,2,46,0
Taylor Swift Releases 'Fifty Shades' Theme 'I Don't Wanna Live Forever' With Zayn Malik,0,3,14,55,5,13,0,69,0
Jimmy Kimmel Will Host the Oscars in 2017 ,0,2,5,25,0,8,4,30,0
Santana Scratched From Start; Mets Say No Cause for Alarm,0,1,9,38,1,9,0,47,0
I Asked Teens For Advice For Earth Day And What They Said Gives Us Hope,0,3,15,42,0,14,0,57,0
eSports is a massive industry -- and it's growing,0,2,1,37,3,8,0,38,0
Watch This Amazing Dancing 6-Year-Old Demand R-E-S-P-E-C-T,0,3,14,29,8,6,1,43,0
US Health Spending Grew Especially Fast Last Year,0,3,9,33,0,7,0,42,0
Michelle Obama paid a surprise visit to some female students for International Women’s Day,0,3,5,71,1,13,0,76,0
18C: Proposed changes to Racial Discrimination Act defeated in Senate,0,3,6,51,1,9,2,57,0
'Steve being Steve': Iowa voters on King's 'somebody else's babies' remark,0,3,4,53,7,10,0,57,0
'They are not going to lie down': Boxing Day hunt crowds remain strong amid fight to scrap fox hunting ban,0,2,3,81,3,19,0,84,0
British police used a Taser on a black man they thought was a robber. He was their race-relations adviser.,0,3,3,82,3,18,0,85,0
A gorgeous 1890 postcard tour of the Alpine land of Tyrol,0,2,3,40,0,10,4,43,0
Labor Market Recovery Best in 25 Years - Business Insider,0,2,7,38,1,9,2,45,0
How Trump’s Regulation Skeptic Helps Wall Street Navigate the Rules,0,3,9,48,1,9,0,57,0
French left stakes its hopes on Manuel Valls in presidential race,0,3,3,52,0,10,0,55,0
Canadians Adopted Refugee Families for a Year. Then Came ‘Month 13.’ ,0,3,8,44,4,11,2,52,0
Amazon Rights Error After Tweet-Rage on Twitter,0,1,7,33,1,6,0,40,0
House votes to scrap rule meant to keep guns from severely mentally ill,0,2,1,58,0,12,0,59,0
Israeli Arabs Recoil at Attacks on Gaza as Allegiance to Their Country Is Strained,0,1,10,59,0,13,0,69,0
Fenway to Freeze Over,0,1,3,15,0,3,0,18,0
Greenpeace Literally Brought Marco Rubio A Spine To Mock His Vote For Rex Tillerson,0,3,14,56,0,13,0,70,0
Brexit Bill rebellion: Row erupts as Eurosceptic claims 27 Tory MPs poised to back ‘wrecking’ amendments ,0,3,7,77,3,16,2,84,0
Gladys Knight Starts Fundraising Effort for Community Center,0,3,7,46,0,7,0,53,0
"With Time Running Out, Giro Stage Victory Eludes Garmin Team Again",0,1,11,44,1,10,0,55,0
Comedian Lee Hurst under fire over torture remarks,0,3,3,40,0,7,0,43,0
Number of EU care workers in UK surges,0,2,5,26,0,7,0,31,0
Fed Cites Easing of Decline and Affirms Policy,0,1,6,33,0,7,0,39,0
United States charges eleven in credit card fraud case,0,1,2,44,0,8,0,46,0
The ‘Obama is a Muslim’ conspiracy theory gets a Shiite twist from a former Iraqi lawmaker,0,3,5,68,2,15,0,73,0
Partisanship is a helluva drug,0,2,1,25,0,4,0,26,0
"Male Mice Sing to Woo, but the Females Answer Just a First Call",0,1,9,41,1,12,0,50,0
Candidate’s Last Name on Campaign Signs Altered to Say ’Farted’ - Breitbart,0,2,9,51,4,11,0,60,0
"Rage is turning 30, but it was never meant to last so long",0,3,1,42,1,12,2,43,0
"Charles Manson returns to prison after stay at hospital, report says",0,3,2,55,1,10,0,57,0
At least 30 killed in attack on Kabul military hospital,0,3,2,42,0,9,2,44,0
"17,000 striking AT&T workers head back to work",0,3,3,29,2,7,5,32,0
Eating A Mediterranean Diet Could Make Your Brain Shrink Less With Age,0,3,12,47,0,11,0,59,0
DC family slaughter suspect facing 20 charges for ‘especially heinous’ crime,0,2,2,60,2,10,2,62,0
Eric Holder Rips Republicans For Trying To Make It More Difficult To Vote,0,3,13,48,0,12,0,61,0
Why Doesn't 2-Time MVP Stephen Curry Get MVP Calls?,0,3,13,26,3,8,1,39,0
21 July bombing suspect to be extradited back to the UK,0,1,3,40,0,10,2,43,0
AMD files antitrust lawsuit against Intel in US federal district court,0,1,6,54,0,10,0,60,0
Here’s why Google invested $1 billion in Elon Musk’s SpaceX,0,2,6,40,3,9,1,46,0
"Brit + Co's Brit Morin On Creativity, The Digital Generation And Her Best Business Advice",0,2,14,58,3,14,0,72,0
"AFC Asian Cup: Iraq shock Australia, Japan overcome UAE",0,1,11,34,2,8,0,45,0
Study: Whopping 93% Say They're More Productive Working Remotely,0,2,8,43,3,8,2,51,0
Travel chaos as fog descends on United Kingdom,0,1,3,36,0,7,0,39,0
US strikes Yemen more in a few weeks than it did all last year,0,3,3,46,0,13,0,49,0
Technical troubles hold up International Space Station repairs,0,1,4,51,0,7,0,55,0
"Seton Hall Upsets No. 12 Georgetown, 65-50",0,1,5,22,3,6,6,27,0
Children Forced to Learn Muslim Prayer by Heart,0,2,6,34,0,7,0,40,0
Uniqlo Might Pull Out of the U.S. Over Trump Threats,0,3,9,32,2,9,0,41,0
F.D.I.C.  Raises Fees to Replenish Bank Fund,0,1,9,24,4,7,0,33,0
Startups: Here's How To Get The Most Out Of A Strategic Investor,0,2,12,39,2,11,0,51,0
Tesla Model 3 Vs. Chevy Bolt EV: Test Ride Vs. Test Drive,0,2,12,30,3,11,1,42,0
US President Bush meets with Canadian and Mexican leaders,0,1,6,43,0,8,0,49,0
Biden rebuffs Giuliani on Black Lives Matter,0,2,5,33,0,6,0,38,0
Democratic ‘tracker’ fired for ‘stalking’ Republican candidate,0,2,2,50,4,6,0,52,0
Hillary Clinton: 'I Remain Convinced That The Future Is Female',0,3,10,41,3,9,0,51,0
"With Trade in Decline, U.S. Deficit Narrows",0,1,7,27,3,6,0,34,0
Dutch woman resident in UK for 30 years may have to leave after Brexit,0,3,4,51,0,13,2,55,0
AT&T and Johnson & Johnson Pull Ads From YouTube ,0,3,10,28,2,9,0,38,0
'Hidden Figures' Director On Taraji P. Henson Snub: 'It's Disappointing',0,3,10,46,7,9,0,56,0
"Kuwait Is Best Off, Nigeria Worst in Fitch's 2017 Oil Break-Even",0,3,10,37,3,10,4,47,0
Charles Manson prosecutor Vincent Bugliosi dies at 80 ,0,2,4,40,0,8,2,44,0
Six indicted over jet crash at New Jersey's Teterboro Airport,0,1,5,46,1,9,0,51,0
Boxing: Joshua Clottey of Ghana wins IBF welterweight title,0,1,7,43,1,8,0,50,0
"New South Wales, Queensland to have electorates redrawn: Australian Electoral Commission",0,1,7,69,2,10,0,76,0
Iraq approves execution of 'Chemical Ali',0,1,3,31,2,5,0,34,0
Hermine kicks up stiff winds in Northeast US,0,2,4,33,0,7,0,37,0
"Series of earthquakes strikes Reno, Nevada area",0,1,3,37,1,6,0,40,0
Twitter to raise 140-character limit for direct messages,0,2,1,44,1,7,3,45,0
"Miguel Ferrer, “NCIS: Los Angeles” star, is dead at 61",0,2,8,30,5,9,2,38,0
"Larry Sanders, Cleveland Cavaliers Reportedly Agree to Contract",0,2,7,48,1,7,0,55,0
Candle knocked over during voodoo sex ritual causes apartment fire,0,1,1,56,0,9,0,57,0
Donald Trump says US is becoming a 'one party system',0,3,4,38,2,9,0,42,0
Coca-Cola CEO Muhtar Kent to Step Down Next Year ,0,2,11,28,1,9,0,39,0
‘The Rock’ Joins Misty Copeland in Criticism of Under Armour’s Trump Praise,0,3,10,51,3,11,0,61,0
Golden Globes nominations 2017: ‘La La Land’ leads with seven; ‘The People v. O.J. Simpson’ leads TV with five,0,3,12,67,9,18,4,79,0
Gorgeous iridescent umbrella tells you when it's supposed to rain,0,3,1,54,1,9,0,55,0
Dramatic footage shows a group of winter swimmers form a human chain to save a skater who fell through ice ,0,3,1,86,0,20,0,87,0
Roman Catholic Church of Philippines Criticizes Duterte’s Bloody Drug War,0,2,9,54,1,9,0,63,0
Aroldis Chapman on Game 7 of World Series: ‘I Came in Tired.’,0,3,8,37,4,11,1,45,0
The confirmation hearing for Trump’s ambassador to Israel was a total circus,0,2,3,61,1,11,0,64,0
This Artist Illustrates Arabic Words As Their Literal Meaning,0,3,9,44,0,8,0,53,0
Adrian Peterson of Minnesota Vikings receives overwhelming support from hometown at Adrian Peterson Day,0,2,7,83,0,13,0,90,0
Trump lawyers ask court to move quickly on travel ban appeal ,0,3,1,49,0,11,0,50,0
Evacuations ordered amid heavy Northern California rain ,0,3,3,46,0,7,0,49,0
Solar Could Beat Coal to Become the Cheapest Power on Earth,0,3,8,41,0,10,0,49,0
"Biden questions Bush's ""special treatment"" of ""Scooter"" Libby",0,1,4,45,5,7,0,49,0
Fishermen find body of child killed by Chile tsunami in Pichilemu,0,1,3,52,0,10,0,55,0
New Zealand’s Trent Boult ruled out of final three ODIs against England,0,2,8,51,1,11,0,59,0
China responds to US plan for import quotas,0,1,3,33,0,7,0,36,0
"Yes, it snows in Hawaii: More than 2 feet of snow in forecast",0,3,3,43,2,12,1,46,0
"Is J. Cole Talking About Kanye West On His New Track ""False Prophets""?",0,3,13,41,4,12,0,54,0
Here’s How Celebrities Are Remembering Mary Tyler Moore On Twitter,0,3,10,46,1,9,0,56,0
"Trump signs first executive order, targeting Obamacare with few specifics",0,3,2,61,1,9,0,63,0
Comedian Dave Allen dies aged 68,0,1,3,22,0,5,2,25,0
Australian receives bravery award for rescues in Indonesian air disaster,0,1,2,61,0,9,0,63,0
Obama Makes Capitol Hill Plea to Democrats on Trade Agenda,0,3,8,41,0,9,0,49,0
"At Davos Forum, Russia and China Blame Capitalists for Economic Crisis",0,1,9,50,1,10,0,59,0
KPMGVoice: Using Smart Robots to Run Clinical Drug Trials,0,2,12,36,1,8,0,48,0
"Harrison Ford, Mark Hamill Take Touching Photo With Carrie Fisher's Daughter",0,3,11,53,2,10,0,64,0
"Republicans, Protect the Nation ",0,3,3,24,1,4,0,27,0
Obama Pushes More Federal Oversight of Cops After Dallas Attack on Cops - Breitbart,0,2,11,58,1,13,0,69,0
'Serial' Subject Adnan Syed Is Denied Bail Motion,0,3,8,32,2,7,0,40,0
Regional Al Qaeda Leader Killed In Yemen Airstrike - NBC News,0,3,12,38,1,10,0,50,0
"Jack Kilby, Nobel laureate and inventor of integrated circuit, dies at 81",0,1,3,55,2,11,2,58,0
Experts Watch for Signs Obama Will Move Appeals Courts to the Left,0,1,9,46,0,11,0,55,0
Tesla Tops GM by Market Value as Investors See Musk as Future,0,3,10,40,0,11,0,50,0
Boat accident in Democratic Republic of the Congo kills at least 73,0,1,4,50,0,11,2,54,0
A 'No Makeup' Cafe Is Opening in Tokyo,0,3,7,22,2,7,0,29,0
Climate Change Film 'An Inconvenient Truth' Gets a Sequel ,0,3,8,39,2,9,0,47,0
"In Redskins Country, Capitals Gain High Profile",0,1,7,33,1,6,0,40,0
OECD Indicators Signal Stronger Economic Growth,0,3,9,33,0,5,0,42,0
Kid Rock Gets Engaged to Longtime Girlfriend Audrey Berry,0,2,8,41,0,8,0,49,0
People Now Want Obama To Run For French Presidential Elections & A Petition Has Been Launched!,0,2,15,62,2,15,0,77,0
"The Rays, Surprising No More, Look to Improve",0,1,7,29,2,7,0,36,0
Is it still worth signing up for Obamacare?,0,3,2,33,1,7,0,35,0
China sentences six more to death over riots,0,1,1,36,0,7,0,37,0
The Parts of the Affordable Care Act That the Republican Bill Will Keep or Discard ,0,3,11,57,0,15,0,68,0
Tesla Now Closing in on GM to Be America’s Most Valuable Automaker,0,3,10,44,1,11,0,54,0
Watch rich people gaze wistfully in the trailer for Sofia Coppola's 'The Beguiled',0,3,5,62,3,12,0,67,0
Inside the 20-Year Quest to Build Computers That Play Poker,0,3,8,39,1,9,2,47,0
MGM Mirage and Dubai World Near an Agreement,0,1,8,29,0,7,0,37,0
Bush v. Gore Foes Join to Fight Gay Marriage Ban,0,1,8,30,1,9,0,38,0
Bella and Edward fall hilariously in love in comedic 'Twilight' spin,0,3,3,53,2,10,0,56,0
6 Bots That Deliver Science and Serendipity on Twitter ,0,3,6,39,0,9,1,45,0
"Atlanta Thrashers sold to True North Sports and Entertainment, moving to Winnipeg",0,1,7,62,1,11,0,69,0
"She was angry she always lost. So this woman threatened to kill lottery officials, police say.",0,3,2,74,3,15,0,76,0
Amazon Takes Aim At Costco With New Prime Visa Card,0,3,10,32,0,9,0,42,0
Brooklyn Beckham got his first tattoo and the internet has a lot of questions,0,2,2,62,0,13,0,64,0
Australian health workers to close intensive care units in Victoria next week,0,1,2,64,0,11,0,66,0
"BNP Executive Fired on U.S. Request Gets $384,000 From Bank",0,3,11,29,4,9,6,40,0
This Is What Famous Latinos Have To Say About Immigration,0,3,10,38,0,9,0,48,0
SpaceX successfully test fires Falcon 9 rocket in Texas,0,1,4,42,0,8,1,46,0
Russian officials: We're not counting on Trump to lift sanctions,0,3,3,50,2,9,0,53,0
"At 17, Mets Prospect Wilmer Flores Is on Fast Track to the Majors",0,1,9,41,1,12,2,50,0
Trump closed the White House comment line so people are calling his hotels,0,3,3,59,0,12,0,62,0
Democrats Ponder How to Use Marches to Build Challenge to Trump,0,2,8,45,0,10,0,53,0
"Banging on empty pots, Venezuelans protest food shortages",0,2,2,47,1,7,0,49,0
Twitter transfer of power: Trump gets @POTUS,0,2,7,29,2,6,0,36,0
Charity Officials Are Increasingly Receiving Million-Dollar Paydays,0,3,8,52,1,6,0,60,0
Retired NASCAR star Tony Stewart returns to sprint cars ,0,2,9,38,0,9,0,47,0
Environmental group sues Donald Trump over repeal of wildlife protection rule,0,3,3,64,0,10,0,67,0
Idaho senator arrested for disorderly conduct,0,1,1,39,0,5,0,40,0
Canadian energy company offers reward for info on pipeline bombings,0,1,1,57,0,9,0,58,0
'Fake News!': Trump Denies 'Apprentice' Work Rumors  Insider,0,2,8,38,6,8,0,46,0
Lake Malawi boat disaster: 'Man held on to bag of flour',0,2,3,40,3,10,0,43,0
Simple Bread Pudding Recipe - NYT Cooking,0,3,8,26,1,6,0,34,0
Listen to Bruce Springsteen's rejected 'Harry Potter' song because even The Boss couldn't get into Hogwarts,0,3,8,80,4,15,0,88,0
Texas Will Require Burial of Aborted Fetuses ,0,3,6,32,0,7,0,38,0
There’s a raging talent war for AI experts and its costing automakers millions,0,2,3,62,1,12,0,65,0
Dubai World to receive $9.5 billion in government aid,0,1,2,39,2,8,2,41,0
"Trump’s Tough Tweets Aren't Reflected In Foreign Policy, At Least So Far",0,3,12,46,3,11,0,58,0
How to ask for a promotion or pay rise – live chat,0,3,1,37,1,11,0,38,0
Black New England Patriots Players Boycotting Trump Visit,0,3,8,42,0,7,0,50,0
"An exclusive look at Snapchat's newest Discover publisher, The New York Times",0,3,7,57,2,11,0,64,0
Baseball’s Newest Infatuation Is With Outfield Defense,0,3,7,40,1,6,0,47,0
Raekwon Announces Release Date & Art for 7th Solo Album 'The Wild',0,3,9,42,3,11,1,51,0
"NIA Says 'ISI Hand' In Recent Train Accidents Can't Be Ruled Out, Further Investigation Is On",0,3,20,54,4,15,0,74,0
"Nina Dobrev and Orlando Bloom Are Hanging Out Romantically But It’s ‘Super Casual,’ Says Source",0,3,14,63,4,14,0,77,0
Somali interior minister killed by bomb attack in own home,0,1,1,48,0,9,0,49,0
Anxiety is numbing – but if we're going to beat Trump we need a survival strategy,0,3,2,62,2,15,0,64,0
{{ videoEntry.nbcsports$titleSEO || videoEntry.title }},0,2,5,37,9,4,0,42,0
The US Music Industry Crossed A Threshold In 2016,0,2,9,28,0,8,4,37,0
The Maine Drop New Single 'Black Butterflies & DÃ©jÃ  Vu',0,3,11,32,4,10,0,43,0
What Trump’s Done—or Undone—for Business in 100 Days,0,3,6,33,3,7,3,39,0
China and Europe face new avian flu outbreaks,0,1,2,36,0,7,0,38,0
Zika outbreak prompts travel warning for parts of Miami,0,2,2,45,0,8,0,47,0
TONIGHT on 'Hannity': Devin Nunes Discusses Explosive Surveillance Revelations  Insider,0,2,15,59,3,10,0,74,0
Australian Council of Social Service calls for slashing tax breaks for property investors,0,2,4,73,0,12,0,77,0
Murray to Meet Nadal in Final at Indian Wells,0,1,6,31,0,8,0,37,0
"Nearly 6,000 flights canceled as major blizzard hits Northeast ",0,3,2,47,1,9,4,49,0
Marist Basketball Player Finds Time for Two Dreams,0,1,7,36,0,7,0,43,0
Supreme Court Brexit appeal: Judges 'heading for split 7-4 decision' in narrow win for Remain campaigners,0,2,5,79,4,15,2,84,0
"When you’re not feeling conventional, an escape plan for Cleveland and Philadelphia",0,2,3,67,2,11,0,70,0
Karlie Kloss Confused Beyoncé With TLC And The #Beyhive Went Into Formation,0,3,14,49,1,11,0,63,0
Game of Thrones season 7: New teaser released featuring Oathbreaker,0,3,4,52,1,9,1,56,0
Mexico warns citizens in US after woman deported,0,2,3,38,0,7,0,41,0
"At Americas Summit, Leaders to Press U.S.",0,1,7,25,3,6,0,32,0
Trump’s reported pick for secretary of state has longstanding ties to the Russian government,0,2,2,76,1,13,0,78,0
"Trump Administration Plans Expanded Immigrant Detention, Documents Say",0,3,8,54,1,7,0,62,0
Tim Allen says being a conservative in Hollywood is like living in 1930's Germany ,0,2,4,59,1,14,4,63,0
2008 III IDEAS Show to showcase achievements of Internet industry in Taiwan,0,1,11,49,0,11,4,60,0
Telltale Games is making a five-part 'Guardians of the Galaxy' story,0,3,4,51,3,10,0,55,0
Going into bat to save a species: Dedication and a nice warm blanket helping to save endangered fruit bats,0,2,2,85,1,18,0,87,0
America’s War against ISIS Is Evolving into an Invasion of Syria,0,2,10,43,1,10,0,53,0
GM Will Test Self-Driving Cars On Michigan's Snowy Roads In Aggressive Push To Autonomous Future,0,2,17,63,2,14,0,80,0
"Polish Ex-Premier to Lead European Parliament, a First for Eastern Europe",0,1,9,52,2,10,0,61,0
"Financing, With Strings Attached",0,1,4,24,1,3,0,28,0
"Teachers 'bullied' into holding revision sessions for 'lazy' students, education union warns ",0,3,1,75,5,12,0,76,0
Forensic results forthcoming in Madeleine McCann case,0,1,4,43,0,6,0,47,0
Every NBA Team's Most Promising Prospect,0,3,8,26,1,5,0,34,0
"Meet 30-Year-Old Nikki, The Solo Biker Riding Her Motorcycle Across The Globe",0,3,13,48,3,11,2,61,0
"Adele tickets are being sold online for £9,000 despite pledge to stop touts",0,2,1,56,2,12,4,57,0
Donna Brazile: Donald Trump ’Doesn’t Even Look Like Change’ - Breitbart,0,2,10,46,5,10,0,56,0
Curlin Repeats as Horse of the Year,0,1,4,25,0,6,0,29,0
Transforming Carbon Waste Into Fuel,0,1,5,26,0,4,0,31,0
Even Car Sales Have Been Hit by India’s Chaotic Cash Clampdown,0,2,10,41,1,10,0,51,0
Gatwick Hotel owners say they have been pressured to close down,0,2,2,51,0,10,0,53,0
The Most Shocking Stories You Can’t Miss This Week,0,2,9,32,1,8,0,41,0
Here's Everything You Need To Know About The AgustaWestland Chopper Deal Everyone's Talking About,0,3,15,67,2,13,0,82,0
California State Senator Removed After Criticizing Late Lawmaker Over Vietnam War,0,2,11,60,0,10,0,71,0
Valentine's Day by the numbers Video ,0,3,3,27,1,6,0,30,0
Trump and Trudeau's Infrastructure Seen Too Tiny for Big Funds,0,3,8,44,1,9,0,52,0
Retired Colonel Lawrence Wilkerson Shreds White House For 'Rank Amateurism',0,3,10,54,2,9,0,64,0
The National Organization for Women calls for Fox News to fire Bill O'Reilly as 12 companies pull their ads,0,3,9,77,1,18,2,86,0
Croatian singer beaten in Belgrade,0,1,2,28,0,4,0,30,0
Nicola Sturgeon gives backing to Westminster terror row minister,0,3,3,53,0,8,0,56,0
Donald Trump forgets Paul Ryan's name and calls him Ron twice,0,3,5,45,1,10,0,50,0
Recovered Pieces of Asteroid Hold Clues to Early History,0,1,7,41,0,8,0,48,0
Former Penn State president Graham Spanier convicted of child endangerment,0,2,5,60,0,9,0,65,0
"Trump Team Considers Moving Press Corps, Alarming Reporters ",0,3,8,43,1,8,0,51,0
Bill De Blasio Is Waiting On Hillary Clinton To Speak Out On Trade,0,2,13,41,0,12,0,54,0
Chinese Start-up's New Smart Bicycle Has Android Support And Integrated Power Meter,0,3,12,58,2,11,0,70,0
Venezuela president to CNN: 'Do not put your nose in Venezuela',0,2,6,44,3,10,0,50,0
Adorable baby hippo is saved from certain death after spending days on its own trapped in a thick mud pool  ,0,3,1,86,0,21,0,87,0
Fire at Florida mosque being investigated as arson ,0,3,2,41,0,8,0,43,0
Only N. Korean held in killing of Kim's half brother set free,0,3,4,44,2,11,0,48,0
Amazon crushed its earnings,0,2,1,23,0,3,0,24,0
Star Wars 9 will feature Carrie Fisher after family give blessing,0,3,4,50,0,10,1,54,0
Extremely rare 'fire rainbow' that makes the sky look like it's burning is spotted in Singapore ,0,3,2,75,3,16,0,77,0
Here's What Keeps Ray Dalio Up At Night,0,3,8,23,1,7,0,31,0
The MVP All-Star Fund Launches With $100M To Get Pro Athletes Into Tech Unicorns,0,3,17,45,2,13,3,62,0
Trump Is Right To Attack The Cost Of Air Force One Replacement Program,0,3,13,45,0,12,0,58,0
US Defends Release of 9-Year-Old Bomb-Making Video Seized in Yemen Raid ,0,3,12,45,3,11,1,57,0
One of Apple's most underappreciated businesses is exploding â this chart shows how much,0,3,2,72,3,13,0,74,0
Ukip supporters: where should the party go from here?,0,3,1,42,2,8,0,43,0
Offset Ducks Cardi B Rumors During Migos' Talk With Tim Westwood,0,3,11,42,1,10,0,53,0
Canada to revisit same-sex marriage issue next week,0,1,1,42,1,7,0,43,0
Young people would rather watch David Attenborough talk about animals than the X factor The list,0,3,5,76,0,15,0,81,0
Chelsea Handler nixes two-party politics: 'I'm not a Democrat anymore' ,0,3,4,52,5,10,0,56,0
Thousands call for ear-piercing to be banned for babies in the UK,0,2,3,50,1,11,0,53,0
Ukranian manufacturer preparing to sell Adolf Hitler dolls,0,1,3,48,0,7,0,51,0
Nasty Women's Choir: The hilarious Christmas carolers we need at the end of 2016,0,3,5,56,2,13,4,61,0
Red Hot Chili Peppers' Chad Smith Plays Hometown Show,0,2,9,35,1,8,0,44,0
Trump's Executive Order Won't Save Coal Mining Jobs,0,3,8,34,2,7,0,42,0
"Phil Hill, first American to win the Formula One championship, dies at age 81",0,1,5,55,2,13,2,60,0
Mushroom corals change from male to female and back again,0,1,1,47,0,9,0,48,0
A Watch Company to Hold a Charitable Auction,0,1,6,31,0,7,0,37,0
EU regulators want to know if LinkedIn data is unique: sources,0,2,4,47,1,10,0,51,0
Greg Oden is back at Ohio State trying to find himself,0,3,4,40,0,10,0,44,0
Stephen Colbert and a cartoon owl take down Trump over 'clean coal',0,3,3,51,2,11,0,54,0
Animatronic Obama Going to Disney World With High-Tech Style,0,1,9,42,1,8,0,51,0
"Going Under the Knife, With Eyes and Ears Wide Open ",0,3,8,33,1,10,0,41,0
"11-Year-Old Chicago Shooting Victim Dies, Toddler Gunned Down Hours Later",0,3,11,48,3,9,2,59,0
Uber says there will be 'no surprises' with fares on New Year's Eve,0,3,4,48,3,12,0,52,0
U.N. Leader Says Trump Visa Bans ‘Violate Our Basic Principles’ ,0,3,11,39,4,10,0,50,0
"In Maharashtra Civic Polls, Candidates Are Hiring Detectives To Spy On Opponenets",0,2,12,57,1,11,0,69,0
ACLU files complaint against Jeff Sessions over Russia testimony ,0,3,7,49,0,9,0,56,0
President-Elect Donald Trump Tells His Biggest Lie Yet,0,2,9,37,1,7,0,46,0
"Two explosions in La Paz kill 2, injure 6",0,1,3,27,1,8,2,30,0
Canadian-born actor Leslie Nielsen dies aged 84,0,1,3,35,1,6,2,38,0
The Gorsuch Tally: Where senators stand on court nominee ,0,3,4,43,1,9,0,47,0
Powerful winds whip through the Great Lakes region and northeast US,0,3,5,52,0,10,0,57,0
"No One Pulls the NFL's Strings Like Its Greatest Puppet Master, Jerry Jones",0,3,14,47,2,12,0,61,0
Confessions of a LeBron James hater,0,2,4,26,0,5,0,30,0
Lewis Hamilton wins 2008 Chinese Grand Prix,0,1,5,28,0,6,4,33,0
Medicare System Overhaul Proposed by Two Senators,0,1,6,37,0,6,0,43,0
"O’Reilly’s Troubles Give Viewers Pause, but They Still Watch ",0,3,9,40,3,9,0,49,0
Discovery of lost VC reveals stories of heroism and tragedy,0,3,3,47,0,9,0,50,0
Detroit Red Wings win 2008 NHL Western finals,0,1,7,27,0,7,4,34,0
Disney has high hopes for new 'Ferb' Christmas special,0,1,3,41,2,8,0,44,0
"Real estate: Housing outlook moderate to grim, according to experts and property industry",0,3,2,73,2,12,0,75,0
The Fed just hiked rates for the 3rd time â that has a history of signaling a âmajor cyclical top for stocksâ,0,3,2,85,6,21,1,87,0
‘Saturday Night Live’ to Air Live Across the Country,0,2,7,35,2,8,0,42,0
"Watch Rae Sremmurd Freestyle Over Jay Z's ""99 Problems"" On Dutch Radio",0,2,11,43,3,11,2,54,0
Defense rests in Michael Jackson case,0,1,3,29,0,5,0,32,0
Josh Dobbs: The Rocket Scientist QB Who Could Be the Next NFL Draft Steal,0,2,16,43,1,13,0,59,0
Why Bitcoin's Greatest Asset Could Also Spell Its Doom,0,3,9,36,1,8,0,45,0
Genius Bar secrets revealed - Business Insider,0,3,4,35,1,6,0,39,0
VMwareVoice: Transforming Security: The Principle Of Least Privilege,0,2,10,49,2,7,0,59,0
Weight-loss surgery for 500kg woman in India,0,3,2,32,1,6,3,34,0
Dubai Stocks Lead Middle East Gains as Traders Seek Dividends,0,3,9,43,0,9,0,52,0
Preliminary report released on Spanair disaster that killed 154,0,1,2,50,0,8,3,52,0
"Trump Spokesman Claims The President-Elect Sold All His Stocks, But Provides No Evidence",0,3,14,60,2,12,0,74,0
"Police officer charged over double-death crash in Luton, UK",0,1,4,45,2,8,0,49,0
NFL Writers Realize Ben Roethlisberger Blocked Many of Them on Twitter,0,3,11,49,0,10,0,60,0
White House Announces Support for Women in Military Draft ,0,3,7,42,0,9,0,49,0
Son of poet Sylvia Plath commits suicide,0,1,3,31,0,6,0,34,0
#GrammysSoWhite Came to Life. Will the Awards Face Its Race Problem? ,0,2,11,44,3,11,0,55,0
"Ofsted ratings do not reveal best nurseries for children, major report shows ",0,3,1,63,1,12,0,64,0
Australia's Tech Underground Comes to Life,0,2,5,31,1,5,0,36,0
"Laws allowing same sex marriage in Washington, D.C. go into effect",0,1,4,49,3,10,0,53,0
Sean Spicer Scrambles to Correct Hitler Comments in White House Press Briefing,0,3,10,57,0,11,0,67,0
Delhi's Iconic Monuments Are Turning Into Makeshift Washrooms & Nothing Is Being Done About It,0,3,14,64,2,14,0,78,0
LOOK: Obamas' Holiday Card Doesn't Mention Christmas for 8th Year  Insider,0,3,12,47,3,11,1,59,0
Trump is erasing the red line in Syria and drawing a hard line on North Korea,0,2,4,58,0,15,0,62,0
DHS assessment: Individuals radicalized once in US,0,3,6,37,1,6,0,43,0
"Prison Worker Joyce Mitchell Planned to ‘Move On’ With Escaped Killers, DA Says",0,3,13,51,3,12,0,64,0
German carnival mocks Donald Trump and Theresa May with controversial floats,0,3,5,61,0,10,0,66,0
You'll Be 'Thunderstruck' By This AC/DC-Themed Christmas Lights Display,0,2,13,45,5,8,0,58,0
MN4 2004 asteroid now considered safe,0,1,2,25,0,5,5,27,0
Amber Heard did what abuse victims are “supposed” to do. People still didn’t believe her.,0,2,3,67,5,14,0,70,0
War graves lost as court gives council permission to bury civilians on top of World War I soldiers,0,3,4,77,0,17,0,81,0
Two House Chairmen Ask for Justice Department Probe Over Flynn ‘Leaks’,0,2,10,48,2,10,0,58,0
"A World of Lingo (Out of This World, Too)",0,1,7,23,3,8,0,30,0
"Clinton warns North Korea of ""provocative behavior""",0,1,3,40,2,6,0,43,0
#LifeAtComplex: Nick Young Chooses the Ultimate G.O.A.T.,0,2,11,33,6,6,0,44,0
"Donald Trump's son-in-law Jared Kushner and Michael Flynn met Russian ambassador, White House admits",0,3,9,74,4,13,0,83,0
China's Premier recognises government responsibility in milk incident,0,1,2,59,1,7,0,61,0
Elderly couple charms viewers as they find love on sweet episode of First Dates Hotel,0,3,4,67,0,14,0,71,0
Claremont serial killings: Man arrested over women's murders still in custody 24 hours later,0,2,2,73,2,13,2,75,0
Fox News hit with new Ailes harassment suit in wake of O'Reilly bombshell,0,3,5,55,1,12,0,60,0
Shaq to Pay for Funeral of Teen Who Accidentally Killed Himself on Instagram Live,0,3,10,58,0,13,0,68,0
Selena's Dad Sues Late Singer's Husband Chris Perez Over TV Series,0,3,12,42,2,10,0,54,0
US 'prepared to do more' in Syria if chemical weapons used again ,0,3,3,48,2,12,0,51,0
"Hey Sean Spicer, what's up with that cryptic tweet?",0,2,3,37,3,8,0,40,0
Fire breaks out in Galveston,0,1,2,22,0,4,0,24,0
"Trump Doesn't Read, So Protesters Are Flooding His Office With Books",0,3,11,45,2,10,0,56,0
Would you ditch your family for fame? 📷 Many millennials say they would,0,3,2,55,2,12,0,57,0
Kim Kardashian West robbery: Paris officials charge first four suspects in $14m jewellery heist,0,3,4,74,2,13,2,78,0
NCAA Tournament 2017: B/R Expert Predictions and Updated Results for 2nd Round,0,3,12,48,2,11,5,60,0
"Fort Lee, Virginia adopts RAPIDGate for fast civilian access",0,1,9,42,1,8,0,51,0
Marine scientist says Australia's blobfish faces extinction,0,1,2,50,1,6,0,52,0
Tommy Tuberville resigns after four seasons coaching Cincinnati,0,3,3,53,0,7,0,56,0
Where Does Phil Simms Wind Up Now That Tony Romo Is At CBS?,0,3,15,31,1,12,0,46,0
Prison suicides are on the rise nationally and it's pretty bad in Massachusetts,0,3,2,64,1,12,0,66,0
US university Penn State wins 2009 NCAA Division I volleyball championship,0,1,10,50,0,10,4,60,0
Bomb destroys Spanish police barracks and kills policeman in Basque Country,0,1,4,61,0,10,0,65,0
World's hottest borehole nearly complete,0,3,1,34,1,4,0,35,0
Protesters arrested after barricading themselves inside portion of Keystone Oil Pipeline,0,1,4,74,0,10,0,78,0
Recall of Thomas the Tank Engine toys due to lead-paint fears,0,1,4,46,1,10,0,50,0
"Israel Closes Media Center, Upsetting Palestinians",0,1,6,38,1,5,0,44,0
Apple unveils iPod nano,0,1,2,18,0,3,0,20,0
Fastest-Growing Type of Loan Faces Political Backlash,0,3,7,39,1,6,0,46,0
Cast of BBC's Strictly Come Dancing announced,0,1,7,31,1,6,0,38,0
China names its new head coach for swimming,0,1,1,35,0,7,0,36,0
Behind United Airlines’ Fateful Decision to Call Police,0,3,7,40,1,7,0,47,0
Fed’s Bullard Doesn’t See Much Impact From Trump Agenda in 2017,0,3,9,38,2,10,4,47,0
2007/08 UEFA Champions League: Manchester United vs. Barcelona,0,1,9,37,3,7,6,46,0
Foam manufacturer settles for US$25 million over Station nightclub fire,0,1,4,55,1,9,2,59,0
Entire U.S. Senate to go to White House for North Korea briefing,0,2,8,43,2,11,0,51,0
Is #MSNBCSoWhite? The departure of Melissa Harris-Perry raises the issue,0,2,12,48,3,9,0,60,0
Firefighters Save 18 Ducklings Trapped Inside Storm Drain  Insider,0,3,8,47,0,9,2,55,0
Should 'Fearless Girl' stare down the Wall Street bull forever?,0,3,5,46,3,9,0,51,0
Trump says Nato 'no longer obsolete',0,3,2,27,2,5,0,29,0
Sony in Expansion of U.S. and Foreign TV Business,0,1,8,31,2,8,0,39,0
First US Somali lawmaker gets 'Islamophobic threats' in taxi,0,3,5,45,2,8,0,50,0
Australian rules football: 2010 Gippsland Football League round 3 - Morwell v Traralgon,0,1,6,62,2,12,5,68,0
"Muslim cleric, two officers killed after gun attacks in southern Russia",0,1,2,58,1,10,0,60,0
British actress Natasha Richardson reportedly brain dead after skiing accident,0,1,3,66,0,9,0,69,0
A Clemson-Alabama rematch is the game college football needs,0,3,3,48,1,8,0,51,0
Mexicans mull response to Trump's wall: let migrants through – or boycott McDonald's?,0,2,4,64,5,12,0,68,0
"Falcons, Patriots advance to Super Bowl LI",0,3,6,29,1,6,0,35,0
EA Sports Madden Trolls Jerry Jones After Tony Romo-Super Bowl Comments,0,3,13,47,1,10,0,60,0
Doc Rivers: Cavaliers’ decision to rest LeBron James and co was ’not cool’,0,2,6,52,4,12,0,58,0
"Betsy DeVos Copied Lines From Outside Sources, Failed To Cite Them In Answers To Senate",0,2,16,56,1,14,0,72,0
"Kellyanne Conway Just Told Everybody To ""Go Buy Ivanka’s Stuff” — Potentially Violating Ethics Law",0,2,14,66,4,14,0,80,0
Ikea Really Wants Teenagers To Stop Secretly Sleeping In Its Stores,0,3,11,46,0,10,0,57,0
Donald Trump is playing a dangerous game in alienating intelligence agencies,0,2,2,64,0,10,0,66,0
Ciara Reportedly Involved in Car Crash in L.A.,0,2,7,30,2,7,0,37,0
Stella English wins sixth series of UK's The Apprentice,0,1,6,40,1,8,0,46,0
"Tiger Woods Hopes to Play in 2017 Masters, Beats Michael Strahan in Putting",0,3,9,49,1,12,4,58,0
"After Obama sanctions Russia, Trump says it’s time ‘to move on to bigger and better things’",0,2,4,68,4,15,0,72,0
The CEO of Boeing just met with Trump and said they had a 'very productive' conversation,0,3,6,65,2,15,0,71,0
Mom Outraged Over Video Showing Four-Year-Old Son Forced to Kiss Boy at Daycare,0,2,13,52,2,12,0,65,0
Trump sits down with ’Fox News Sunday’,0,2,4,26,2,6,0,30,0
This Guy Plowed Snow On An ATV While Wearing A Bikini Because New Brunswick,0,3,16,46,0,13,0,62,0
Oregon's Dillon Brooks Posterizes UCLA's Ike Anigbogu,0,2,10,35,2,6,0,45,0
Red Carpet Fashion At The 2017 Golden Globes,0,3,7,26,0,7,4,33,0
Woman charged with choking teen for blocking view at Disney fireworks show ,0,3,2,61,0,12,0,63,0
Hilarious Generator Predicts How Sean Spicer Would F*ck Up Your Name,0,2,11,46,1,10,0,57,0
Foreigners Filling Jobs That Iraqis Often Shun,0,1,7,33,0,6,0,40,0
Generic Tamiflu in India,0,1,3,18,0,3,0,21,0
Vogue Celebrates Muslims In Special Feature On American Women,0,3,9,44,0,8,0,53,0
President Trump’s First Hours In Office,0,2,6,27,1,5,0,33,0
Maxine Waters: 'Sex Actions' Allegations in Trump Dossier Are 'Absolutely True'  Insider,0,3,11,60,5,12,0,71,0
"Dale Earnhardt Jr. Is Struggling, but His Fans Stick With Him",0,1,10,39,2,10,0,49,0
"George W. Bush says ""we all need answers"" on Trump team-Russia connection",0,3,5,53,4,11,0,58,0
Officer dies in Glasgow police station shooting incident,0,1,2,47,0,7,0,49,0
"Aleppo: Evacuations of civilians from rebel enclaves halted, conflicting reports over sticking point",0,3,2,84,2,12,0,86,0
Blaze devastates Grand-Synthe migrant camp outside Dunkirk,0,3,4,47,1,6,0,51,0
Flipboard fights back with major change for readers,0,3,1,43,0,7,0,44,0
No Democratic Party Chair Winner In First Round Of Balloting,0,3,10,41,0,9,0,51,0
Did You Know Mixing Chocolate With Caffeine Can Ease Anxiety And Help You Focus Better?,0,2,15,57,1,14,0,72,0
Why Paying Your Nanny Under the Table Is a Really Bad Idea,0,3,10,37,0,11,0,47,0
'Space art': 3D-printed laughter to be printed on ISS and launched into orbit,0,3,5,55,4,12,1,60,0
Islanders’ new coach isn’t so sure he wants the job,0,2,1,39,2,9,0,40,0
"The world's longest Uber ride ended in Brooklyn, cost $294.09 ",0,2,3,40,4,10,5,43,0
NFL overhauls its social media policy just 7 weeks after last change [Video],0,3,4,57,2,12,1,61,0
Trump's America Karen Pence: The Second Lady of the United States on her passion for art therapy,0,3,9,69,2,16,0,78,0
Insurer Oversight Is Not Yet Broken,0,1,6,24,0,5,0,30,0
Trump Now Uses an iPhone — Despite Once Calling for an Apple Boycott,0,3,9,46,1,12,0,55,0
The released report on Russian meddling isn’t enough,0,2,2,42,1,7,0,44,0
Obama Auto Adviser Had Ties to an Industry Fund,0,1,7,32,0,8,0,39,0
12 cheetah cubs were just born at the Smithsonian and you need to see them,0,3,1,57,0,14,2,58,0
"PocketFinder: A GPS to Find People, Not Directions",0,1,10,31,2,7,0,41,0
Autistic boy shows up for standardized test with his service dog. Here’s what happened next.,0,2,2,73,3,14,0,75,0
The One Land Where Populists Aren’t,0,3,6,23,1,5,0,29,0
"As Sephora Adds Products, Rivalry Heats Up at Its Stores ",0,3,9,37,1,10,0,46,0
Iran Stepping Up Effort to Quell Election Protest,0,1,7,35,0,7,0,42,0
Suspected Iraqi bomber murders investigator,0,1,2,37,0,4,0,39,0
Zimbabwean pastor who led anti-Mugabe protests arrested in Harare,0,2,3,53,1,8,0,56,0
"Iran: If Enemies Do Wrong, Missiles Will Come Down on Them ",0,2,10,36,2,11,0,46,0
11 Pirates Seized by French Navy,0,1,4,21,0,5,2,25,0
Cavaliers Have Been Dominant but Not Intriguing,0,1,6,35,0,6,0,41,0
Donald Trump: Tax reform next after healthcare failure,0,3,3,43,1,7,0,46,0
Stars of bizarre Pink Windmill meme reunite as adults for Comic Relief ,0,2,5,54,0,12,0,59,0
PARTYNEXTDOOR Tweeted and Deleted a Response to Nicki Minaj,0,3,18,33,0,8,0,51,0
U.S. Has No Plans to Expand Airline Laptop Ban to U.K. Airports,0,3,12,36,4,11,0,48,0
"Billboard Dance Chart Upstarts: Miss Tara, Yellow Claw & Grey",0,2,9,40,3,9,0,49,0
"In Venting, a Computer Visionary Educates",0,1,5,30,1,5,0,35,0
Police raid French parliament in François Fillon investigation,0,3,4,51,0,7,0,55,0
China’s Premier Maps Out Cautious Economic Course ,0,3,7,35,1,7,0,42,0
EPA chief assailed – and applauded – for not banning controversial pesticide,0,2,3,60,2,11,0,63,0
CenturyLinkVoice: Get Your Daily Fiber...Network,0,3,8,32,4,4,0,40,0
Church of Scientology denied injunction against Anonymous,0,1,3,48,0,6,0,51,0
Inspiring America: 100 Years of Girl Scout Cookies,0,2,6,33,1,7,3,39,0
How Christmas films will mess up your festive relationship expectations,0,3,2,60,0,9,0,62,0
California train accident: Freight cars plunge into water,0,3,2,47,1,7,0,49,0
"Police feared extremists slipping through counter-terrorism program, FOI documents reveal",0,2,4,74,2,9,0,78,0
Father of newborn baby girl found BURIED ALIVE in a field in India is arrested for attempted manslaughter ,0,3,13,75,0,18,0,88,0
Fierce Lobbying Greets Bill to Ease Unionizing,0,1,6,34,0,6,0,40,0
"If Vick Is Sincere, Give Him a Chance to Prove It",0,1,9,29,1,10,0,38,0
Tech guy who set up Hillary’s private email blows off subpoena,0,2,2,49,1,10,0,51,0
"‘Evil, evil, evil as can be’: Emotional testimony as Dylann Roof trial begins",0,2,4,56,5,12,0,60,0
Senior Official Suggests Trump Not Tied To Two-State Solution,0,3,10,42,1,8,0,52,0
Indian Students Think Twice About Attending U.S. Universities,0,3,9,43,2,7,0,52,0
Bullish Bets on Crude Cut by Most Ever as Price Falls Below $50,0,2,9,39,1,12,2,48,0
Children who lived through Pearl Harbor attack remember,0,3,3,45,0,7,0,48,0
ESPN’s latest ax: ‘SportsCenter’ anchor back from maternity leave,0,2,6,47,4,8,0,53,0
EXCLUSIVE: US Diplomats Consider Filing Dissent Over Immigration Ban ,0,2,18,41,1,9,0,59,0
Acosta Confirmation Vote Could Happen This Week,0,3,7,34,0,6,0,41,0
How Hyundai Reunited Troops With Their Families for Super Bowl Surprise ,0,3,10,51,0,11,0,61,0
How a President Can Use Orders and Memos and Who Can Stop Them ,0,3,10,40,0,13,0,50,0
The No. 1 Danger In Virtual Reality Gaming Nobody Wants To Talk About,0,3,12,43,1,12,1,55,0
Nelson Mandela hospitalised again with lung infection recurrence,0,1,2,55,0,7,0,57,0
"In India, Cricket Loses to Politics on Security",0,1,6,33,1,7,0,39,0
Jennifer Lopez Opens Up About Dating Alex Rodriguez on 'Ellen',0,2,9,42,2,9,0,51,0
"Chinese, Spending Freely, Become Ever-Larger Tourism Force in New York - The New York Times",0,2,14,59,4,14,0,73,0
"Climate Bill Clears Hurdle, but Others Remain",0,1,6,32,1,6,0,38,0
Ball Brothers Work Out and Play Basketball on Christmas Day,0,2,8,42,0,9,0,50,0
Katy Perry Walked The Red Carpet With Quinoa In Her Teeth,0,3,11,36,0,10,0,47,0
Your fatty food addiction might not be your fault after all,0,2,1,48,0,10,0,49,0
Man jailed for hacking into Jennifer Lawrence's online account,0,2,3,50,1,8,0,53,0
"With Candidates Staying Out, Iowa Straw Poll Dies - First Draft. Political News, Now. ",0,2,13,54,5,14,0,67,0
Privatize Federal Graduate Student Loans,0,2,5,31,0,4,0,36,0
Closest comet in decades to share sky with lunar eclipse this weekend,0,3,1,57,0,11,0,58,0
"After Its Worst Peacetime Attack, Sweden Strikes a Defiant Tone",0,3,9,44,1,9,0,53,0
Two new cases of West Nile Virus reported in Indiana,0,1,5,38,0,9,0,43,0
Hundreds Jailed as Pakistan Bans Planned Protest,0,1,6,36,0,6,0,42,0
"Hundreds attend ""International Peace Conference""",0,1,4,38,2,4,0,42,0
Ferguson Security Video Renews Anger Over Michael Brown’s Death,0,3,9,45,1,8,0,54,0
Ousted PM Thaksin bemoans freezing of Swiss assets,0,1,5,38,0,7,0,43,0
Canada becomes 4th nation to allow same-sex marriage,0,1,1,42,1,7,1,43,0
Trump inauguration: Where next president stands on key issues,0,3,2,50,1,8,0,52,0
People Are Saying That This Teen Is The Best Babysitter After She Dressed Up As A Mermaid,0,3,17,56,0,16,0,73,0
"Robert Vaughn, star of TV’s The Man from UNCLE, dies aged 83",0,2,11,33,3,11,2,44,0
"Stephen Curry, LeBron James Lead List of NBA's Merchandise Sales",0,2,12,41,2,9,0,53,0
Trump Push to Help Small-Town Workers Leaves Farmers Behind,0,3,9,41,1,8,0,50,0
"Isil have 'several dozen' operatives in Europe and could strike with car bombs, Europol warns ",0,3,3,73,3,15,0,76,0
School doubles down on Charlie Brown Christmas ban ,0,3,4,39,0,8,0,43,0
Program Guide,0,2,2,10,0,1,0,12,0
"AMC Cinemas Beefs Up Marketing With Dine-In, Bottomless Popcorn",0,3,12,41,2,8,0,53,0
Russia Labels NATO Moves in Eastern Europe a Threat: State Media,0,3,12,41,1,10,0,53,0
Erdogan's Bid for Sweeping Power Set to Climax With Sunday Vote,0,2,9,43,1,10,0,52,0
Knife-wielding attacker is shot by police in south west France after stabbing a woman in the shoulder ,0,3,2,82,1,17,0,84,0
Dwyane Wade Injury: Updates on Bulls Star's Wrists and Return,0,2,8,42,2,9,0,50,0
At Least 10 Killed In Suspected Taliban Suicide Terror Attack In Lahore,0,3,11,47,0,11,2,58,0
E-Passport cloned in five minutes,0,1,2,26,1,4,0,28,0
The Undertaker Gets An Emotional Tribute From Roman Reigns After Retiring From WWE,0,3,15,55,0,12,0,70,0
US Senate confirms Robert Gates as new Secretary of Defense,0,1,7,43,0,9,0,50,0
Obama Seeks Vastly Expanded Afghan Force to Help Stabilize the Nation,0,1,9,50,0,10,0,59,0
LA police don’t have body cameras because of sticker shock,0,2,2,46,1,9,0,48,0
"Martellus Bennett Rumored to Be Drawing Interest from Patriots, Jaguars, Raiders",0,2,9,59,2,10,0,68,0
Billboard & Twitter Are Live Streaming #REVOLVEfestival: Watch,0,2,13,39,3,7,0,52,0
Apple now lets you watch videos on the tiny screen of its Watch - but would you want to?,0,2,2,66,2,18,0,68,0
Survivalist Sentenced To Death For Murder Of Pennsylvania State Trooper,0,3,10,52,0,9,0,62,0
"Afghanistan wooed a fugitive warlord, aiming to lure the Taliban, too. Now the warlord’s deal is stuck.",0,3,3,79,5,16,0,82,0
"This is How You Cook Perfect Scrambled Eggs, According to Anthony Bourdain",0,2,10,52,1,11,0,62,0
Russian passenger airliner makes safe landing in Moscow after concerns of gear damage,0,1,2,71,0,12,0,73,0
"Twitter glitch made 560,000 people follow Trump's @POTUS account ",0,2,7,40,3,9,6,47,0
"General Motors Sells Opel, Vauxhall to PSA for $2.3 Billion",0,3,9,36,3,9,2,45,0
Feds: IRS seized millions from innocent people and businesses,0,3,4,48,1,8,0,52,0
"4 dead after powerful storms in Alabama, sheriff says",0,3,1,42,1,8,1,43,0
Why Is Black-Ish Working With Serial Abuser Chris Brown?,0,2,10,36,2,8,0,46,0
Spicer: CNN's Acosta Owes Trump Apology for 'Rude' Behavior at News Conference  Insider,0,3,13,57,4,13,0,70,0
New Billionaire: How Papa John's CEO John Schnatter Turned Pizza Into Ten-Figure Fortune,0,2,16,57,3,12,0,73,0
Germany Is Planning a Bigger Stimulus Package,0,1,6,33,0,6,0,39,0
"Kid vandals, ages 7 to 11, raid day care, cause extensive damage ",0,3,1,46,3,12,3,47,0
Student on Trial in Italy Claims Police Pressure,0,1,6,35,0,7,0,41,0
'It's almost word-for-word Trump': Germany's Social Democrats leader launches a' social-populist' attack on Merkel,0,3,6,85,10,13,0,91,0
California Today: School Bond Measure? Why You Should Care - The New York Times,0,2,13,50,3,13,0,63,0
Nicola Sturgeon quips she could field SNP candidates in England,0,3,6,48,0,9,0,54,0
Louisiana Court Blocks Release of ‘Angola Three’ Inmate ,0,3,7,39,2,8,0,46,0
Trevor Noah Gives Bill O’Reilly The Send-Off He Deserves,0,3,11,35,2,8,0,46,0
"Waka Flocka Drops His Gucci Mane Diss Track ""Was My Dawg""",0,2,11,34,2,10,0,45,0
Future Turns Into a Modern-Day Casanova in 'Draco' Video: Watch,0,2,9,41,4,9,0,50,0
Thursday NBA Roundup: Warriors Don't Have Normal NBA Problems,0,3,13,38,2,8,0,51,0
Malaysian Ship Carrying Relief Material For Rohingyas Faces Protest In Myanmar,0,2,11,57,0,10,0,68,0
AMC released 3 new photos from the next episode of 'The Walking Dead',0,3,6,48,2,12,1,54,0
Man Whose PIL Led To Highway Liquor Ban Sad Now That His Favourite Chandigarh Bar Has Gone Dry,0,2,20,57,0,17,0,77,0
Fyre Festival Organizer: 'Let’s Just Do It and Be Legends',0,3,9,36,4,9,0,45,0
April the giraffe tends to wobbly newborn calf – video,0,3,1,43,1,9,0,44,0
"On Facebook’s 13th Birthday, A Look Back at Key Milestones",0,3,8,37,2,9,2,45,0
Bernie Sanders wants to take back “family values” from the GOP,0,3,5,45,2,10,0,50,0
A.J. Pierzynski leads Chicago White Sox to narrow 5-4 win against Detroit Tigers,0,1,8,55,3,12,2,63,0
Charles Manson 'moved from prison to hospital',0,3,2,36,2,6,0,38,0
Bringing Up a 'Baby' Rolls-Royce,0,1,5,20,3,4,0,25,0
U2 fan ordered to destroy CDs,0,1,3,20,0,5,1,23,0
Federal Reserve Readies Plan for Balance Sheet,0,3,6,34,0,6,0,40,0
Trump to tech titans: 'Everybody in this room has to like me a little bit',0,2,2,55,3,14,0,57,0
French MPs call for ban on veils for Muslim women,0,1,4,36,0,9,0,40,0
Border Wall Bids Deadline Extended for Another Week,0,3,7,37,0,7,0,44,0
Great Economic Expectations Are the Bull Market's Next Test,0,3,8,42,1,8,0,50,0
"China Aims To Be No. 1 Globally In EVs, Autonomous Cars By 2030",0,3,12,32,2,12,5,44,0
"British computer scientist's new ""nullity"" idea provokes reaction from mathematicians",0,1,1,72,3,9,0,73,0
Six Errors on the Path to  the Financial Crisis,0,1,5,33,0,9,0,38,0
Takata Agrees to Pay $1B to Settle Airbag Criminal Probe that Led to 11 Deaths in the U.S.,0,2,12,55,3,17,3,67,0
Campbell is sinking after sales fall more than expected,0,3,1,46,0,8,0,47,0
Europe’s Missed Private Equity Opportunity ,0,3,5,32,1,5,0,37,0
"Cards WR Larry Fitzgerald, 10-time Pro Bowler, returning for 2017",0,3,7,40,3,9,6,47,0
Colombian journalist denied entry into US,0,1,3,33,0,5,0,36,0
Gorillaz Nominated for 5 Grammy Awards,0,1,4,28,0,5,1,32,0
Euro reaches new lows,0,1,1,17,0,3,0,18,0
Judge: Ohio Lethal Injections Might Be Too Painful,0,3,8,34,1,7,0,42,0
Clinton’s Listless Dem Debate Performance Unlikely to Halt Sanders’s Momentum,0,2,9,57,2,9,0,66,0
Eight US soldiers killed in Afghanistan after clash with millitants,0,1,4,54,0,9,0,58,0
Trump attacks China in Twitter outburst,0,3,3,31,0,5,0,34,0
Bill Gates: Bioterrorism could kill more than nuclear war — but no one is ready to deal with it,0,3,3,72,2,18,0,75,0
Pictures of an airborne Harry Styles ignite a Photoshop battle for the ages,0,3,4,59,0,12,0,63,0
My Friend Is Bankrupting Herself. Should I Speak Up? ,0,3,9,33,2,9,0,42,0
Ruth Bader Ginsburg: We're not mindful enough of 'what makes America great',0,3,5,55,4,11,0,60,0
38 killed in attack on Afghan bank,0,1,1,25,0,6,2,26,0
President Trump's Economic Scorecard: The Starting Line,0,3,7,40,2,6,0,47,0
France Warns Trump: Moving U.S. Embassy to Jerusalem A ‘Provocation’,0,3,10,44,5,9,0,54,0
"Cavaliers vs. Warriors: Score, Highlights, Reaction from 2016-17 Regular Season",0,3,7,52,5,9,6,59,0
Are male or female doctors better for patients?,0,3,1,38,1,7,0,39,0
E.P.A. Expected to Regulate Carbon Dioxide and Other Heat-Trapping Gases,0,1,11,48,4,9,0,59,0
Bob Barker to retire as host of U.S. gameshow The Price Is Right,0,1,8,42,2,12,0,50,0
Death Toll in Fire at Oakland Artist Collective Rises to 33,0,2,7,40,0,10,2,47,0
ISIS claims deadly Jordan attack ,0,3,5,23,0,5,0,28,0
You Can’t Pretend Trump’s Flaws Away,0,2,6,23,2,5,0,29,0
Shaffer: Trump Wiretap Case 'Worse Than Watergate'  Insider,0,3,8,40,3,8,0,48,0
"Adam Schiff says there's direct evidence of ""deception"" between Trump camp, Russia",0,2,4,63,4,11,0,67,0
UN official criticises Australia's 'disturbing' number of Aboriginal children behind bars,0,3,4,72,3,10,0,76,0
Former SA Deputy President Appears In Court,0,1,8,29,0,6,0,37,0
Portable brain-scanning helmet could prevent stroke victims becoming severely disabled,0,3,1,75,1,9,0,76,0
A clever physics trick can reveal if your egg is hard boiled,0,2,1,48,0,11,0,49,0
‘Not My President’s Day’: Thousands Plan Anti-Trump Rallies Across U.S.,0,3,12,43,7,9,0,55,0
Justices Explore Role Race May Play in Employment,0,1,7,35,0,7,0,42,0
BBC Director-General Entwistle resigns,0,1,6,28,1,3,0,34,0
"From ObamaCare to the case of a burping kid, Gorsuch's legal writings show intellect, wit ",0,3,4,68,3,15,0,72,0
Melania Trump wears sky-blue cashmere Ralph Lauren ensemble ,0,2,4,47,1,8,0,51,0
MLB players are launching their own social media app,0,2,3,41,0,8,0,44,0
"Brexit: 'Thousands' of Britons are asking to remain EU citizens, says European Parliament's chief negotiator",0,3,7,82,5,14,0,89,0
Nokia unleashes patent legal battle on Apple,0,3,2,36,0,6,0,38,0
Space Shuttle Discovery lands in Florida,0,1,4,31,0,5,0,35,0
School Choice Deniers,0,3,3,16,0,2,0,19,0
Jihadis still work online,0,1,1,21,0,3,0,22,0
Steve Martin Deletes Carrie Fisher Tweet After Getting Thrashed by Internet,0,3,10,55,0,10,0,65,0
Northern Ireland's Ian Paisley to resign and retire,0,1,4,39,1,7,0,43,0
Devin Nunes’ Replacements Aren’t Exactly Eager To Investigate Trump-Russia Ties Either,0,3,12,61,3,10,0,73,0
"Americans Eat 554 Million Jack in the Box Tacos a Year, and No One Knows Why",0,3,11,46,1,15,3,57,0
"China’s Securities Regulator Signals Greater Oversight of Asset Managers, Brokerages",0,3,9,64,2,9,0,73,0
Man accused of Holocaust Museum shooting dies,0,1,3,36,0,6,0,39,0
House price growth jumps to highest since March despite weaker market post-Brexit vote,0,2,3,70,1,12,0,73,0
Dialing up the past: How did the early internet affect the media?,0,2,2,50,2,11,0,52,0
Demonetisation: Guard Fires Gun Shots In Air To Disperse Crowd At A Bank In Punjab,0,2,15,52,1,14,0,67,0
"Mary Tyler Moore, TV star who changed depiction of women, dies aged 80",0,3,5,49,2,12,2,54,0
Former CIA acting director on Clinton: I ’trust her’,0,2,6,35,3,8,0,41,0
Michael Brun Is Bright and Bubbly on Ben Alessi 'U' Remix: Listen,0,2,10,41,3,11,0,51,0
Just 2 People Turn Up as Self-Funded FIFA Movie Makes Hollywood Debut,0,2,14,42,1,11,1,56,0
"Fidel Castro, Antonin Scalia, John Gutfreund: The Year in Deaths",0,2,9,43,3,9,0,52,0
Santa Letters Sent to Random Couple Get Fulfilled in 'Miracle on 22nd Street' Mystery - Yahoo,0,3,11,62,3,15,2,73,0
Rising up from closing down: Surviving and thriving after a store shuts its doors,0,3,2,65,1,13,0,67,0
American botanist Lou Jost discovers world's smallest orchid,0,1,3,49,1,7,0,52,0
Who could it be? Mystery as skeleton of 5ft 7in man was found in dangerous desert,0,3,2,61,1,15,2,63,0
Young Americans Are Killing Marriage,0,3,5,27,0,4,0,32,0
"Revolutionary Power Plant Captures All Its Carbon Emissions, At No Extra Cost",0,2,12,53,1,11,0,65,0
"U.S. slams Russian ’barbarism’ in Syria, Moscow says peace almost impossible",0,2,5,56,5,10,0,61,0
U. S. unseals charge against Jordanian woman in 2001 Jerusalem Sbarro bombing,0,3,5,55,2,11,4,60,0
"MLB: Twins defeat Orioles 7-2, sweep series",0,1,5,27,3,6,2,32,0
Turkish protesters march against Internet censorship,0,1,2,45,0,5,0,47,0
"Oscars 2017: Hollywood talent agency cancels party, hosts pro-refugee rally instead",0,3,2,64,3,10,4,66,0
Can French presidential candidate Emmanuel Macron deliver on his promise to remake the country?,0,2,4,77,1,13,0,81,0
Mexico opens immigrant defense centers at its US consulates,0,3,3,48,0,8,0,51,0
Crisis Reshaping Wall St. as Stars Begin to Scatter,0,1,7,35,1,8,0,42,0
'This Is a Real War': Gingrich on How Trump Should Combat Media 'Falsehoods'  Insider,0,3,12,54,5,14,0,66,0
Specter Faces Conservative Challenge,0,1,4,29,0,3,0,33,0
Thereâs already a rumor about the 2019 iPhones claiming they'll all have beautiful new screens,0,2,2,73,3,14,4,75,0
"Jakarta, a city under pressure from a growing population in need of a leader with vision",0,3,1,71,1,15,0,72,0
30 Taken to Hospital After 25-Car Pileup on I-91,0,3,6,26,2,8,6,32,0
Kodak Black Is Accused of Assaulting a Woman at Miami Strip Club,0,3,9,44,0,11,0,53,0
White Supremacists Plan Armed March Against Jews and Jewish Businesses in Montana,0,3,10,60,0,11,0,70,0
Windows Vista faces possible trademark challenges,0,1,2,42,0,5,0,44,0
Nigerian gunmen kidnap three-year-old British girl,0,1,2,41,2,5,0,43,0
Radioactive Boars Hunted After Taking Over Towns Near Fukushima,0,3,9,46,0,8,0,55,0
"Georgia, South Carolina and Mississippi devastated by series of deadly storms, tornadoes",0,2,4,71,2,11,0,75,0
Exploring Hong Kong history through its food,0,3,3,35,0,6,0,38,0
A Family Remembers Their Daughter 4 Years After Sandy Hook Shooting,0,3,10,46,0,10,1,56,0
Casey Affleck Wins Best Actor Oscar Despite Backlash Over Sexual Harassment Allegations,0,3,12,64,0,11,0,76,0
Racism Conference Adopts Resolution,0,1,4,28,0,3,0,32,0
'Rocky': Look Back at the Film on Its 40th Anniversary ,0,2,6,34,3,10,2,40,0
Why we should root for Rickie Fowler to win the Masters,0,3,4,41,0,10,0,45,0
Germany Releases Berlin Attack Suspect as ISIS Claims Involvement ,0,2,11,46,0,9,0,57,0
US Secret Service officer arrested during prostitution sting,0,1,4,49,0,7,0,53,0
China and Russia continue joint army exercise,0,1,2,37,0,6,0,39,0
The Camden Sisters Had A Mini “7th Heaven” Reunion Because Nostalgia,0,3,10,45,2,10,1,55,0
"Many Try to Run for President in Iran, but Few Will Be Allowed",0,1,9,40,1,12,0,49,0
Wilderness Bill Clears the House on Its Second Go-Round,0,1,8,38,1,8,0,46,0
Journalist shouted down at Corbyn press conference – video,0,3,2,47,1,8,0,49,0
Ex-Sheriff Guilty of Rape,0,1,4,17,1,3,0,21,0
Mel Gibson Welcomes Baby No. 9,0,3,5,18,1,5,1,23,0
Earthquake shakes western Mexico,0,1,2,27,0,3,0,29,0
Kennedy Leaves Hospital a Day After Having Seizure,0,1,7,36,0,7,0,43,0
Brighton’s long march ends in Chris Hughton’s completion of a job well done,0,3,3,58,2,12,0,61,0
"Third Runway Approved for Heathrow, Angering Critics",0,1,6,39,1,6,0,45,0
"Cheesemaker Sargento expands listeria recall, cuts supplier",0,3,2,50,1,6,0,52,0
Trump refuses to answer reporter's question on Russia,0,2,2,43,1,7,0,45,0
Texas police officer dies falling into massive sinkhole,0,2,1,47,0,7,0,48,0
A.I.G. Sells Its Japanese Headquarters for $1.2 Billion,0,1,8,33,5,7,2,41,0
Hate crime charges filed in Chicago beating streamed on Facebook Live ,0,2,4,55,0,11,0,59,0
"Eight killed in Dagestan, Russia after ambush",0,1,3,35,1,6,0,38,0
This Punjabi Mum Addressing Parents Of LGBT South Asians Will Fill You With Joy,0,2,17,49,0,13,0,66,0
Palestinians Press for War Crimes Inquiry on Gaza,0,1,6,36,0,7,0,42,0
"Meet This 2-YO Snake Charmer From Australia, Catching Reptiles Is His Hobby!",0,2,13,48,3,11,1,61,0
"Seismologist Mario Pardo rebukes notion that Pichilemu, Chile experiencing ""seismic swarm""",0,1,5,72,3,10,0,77,0
US Navy Is Testing An App To Prevent On-Duty Sexual Assault,0,3,13,35,1,10,0,48,0
Alec Baldwin Is Back as Donald Trump to Befriend Aliens in 'SNL' Cold Open,0,3,13,46,2,13,0,59,0
Documents regarding post-9/11 prisoner transport flights released,0,1,1,53,2,6,3,54,0
"For the Trumps, ‘Made in U.S.A.’ May Be a Tricky Label to Stitch ",0,2,11,35,6,13,0,46,0
Trump draws far smaller inaugural crowd than Obama,0,2,2,41,0,7,0,43,0
Yankees Rally as Biggest Hits Stay Inside the Park,0,1,7,35,0,8,0,42,0
Top Democrat: The FBI helped Trump with its email announcement,0,2,7,45,1,9,0,52,0
"Living Stronger: NASA astronaut, 57, setting records and breaking barriers",0,3,6,54,3,9,2,60,0
Trump’s Spokesman Lying Is Now A Ridiculous Meme,0,2,8,32,1,7,0,40,0
Capitol Hill worker killed by falling tree branch,0,2,2,40,0,7,0,42,0
Zoo Sues Studio For Traumatizing Raccoon Used In 'Erotic' Ad,0,3,10,39,2,9,0,49,0
Obama Seeks Accord With Military on Iraq,0,1,6,28,0,6,0,34,0
"For Every Slap On Jawan, Kill 100 Jihadis, Gautam Gambhir Lashes Out Against Attack On Soldiers In Kashmir",0,3,17,67,2,17,3,84,0
Bodies of missing US Navy sailors found inside damaged warship,0,2,4,49,0,9,0,53,0
"Julian Assange tweeted  for the first time, as if the world needs more tweets",0,3,2,60,1,14,0,62,0
"British man fully ""recovers"" from HIV",0,1,4,26,2,5,0,30,0
Ewan McGregor snubs Good Morning Britain due to Piers Morgan comments on the Women’s March,0,3,10,65,1,14,0,75,0
Prince Laurent of Belgium testifies in marine fraud case,0,1,3,45,0,8,0,48,0
A glimpse into history: Photo of young Harriet Tubman surfaces ,0,3,4,48,1,10,0,52,0
Suspect in 1998 bombing of US embassy in Tanzania won't face death penalty,0,1,4,53,1,12,4,57,0
Two Killed in Army National Guard Helicopter Crash,0,3,7,36,0,7,0,43,0
An Updated Look at Every Team's Cap Situation Heading into Free Agency,0,3,10,48,1,11,0,58,0
Study Sees More Young Citizens With Parents in the U.S. Illegally,0,1,10,43,2,10,0,53,0
Looking for Mystery Man Tied to Faux Avon Bid,0,2,7,30,0,8,0,37,0
Fight Looms as Bill de Blasio Plans to Seek 90 New Homeless Shelters ,0,3,9,45,0,13,2,54,0
16 Reasons The Holidays Suck If You’re Anxious,0,3,7,29,1,7,2,36,0
Is Gascony the Most Delicious Corner of France? - The New York Times,0,2,10,44,2,12,0,54,0
Retired Catholic priests call for abolishment of celibacy,0,2,2,48,0,7,0,50,0
Ikea’s not-so-secret ingredient: Swedish meatballs - MarketWatch,0,2,4,49,5,6,0,53,0
Singers in Russian Military Choir Among 92 Feared Dead After Plane Crashes Into Black Sea ,0,3,13,60,0,15,2,73,0
"Tony Romo retiring from NFL, going into broadcasting: report ",0,3,5,45,2,9,0,50,0
"To Buff Up Before Games, NBA Stars Hit the Nail Salon",0,3,12,30,1,10,0,42,0
Mad Max and Furiosa's stunt doubles marry after meeting on set,0,2,3,48,1,10,0,51,0
Poland Gets $20 Billion Credit Line From I.M.F.,0,1,9,25,4,7,2,34,0
Bill O’Reilly’s Exit From Fox News,0,2,7,20,2,5,0,27,0
Israel debates approval of illegal 'wildcat' settlements in the West Bank,0,3,3,58,2,10,0,61,0
Flooding kills 91 in El Salvador,0,1,3,22,0,5,2,25,0
’He Was the Nationalist Candidate’,0,2,4,24,2,4,0,28,0
D'Angelo Russell Sinks Game-Winning Buzzer-Beater Hours After Death of Grandmother,0,3,12,58,3,9,0,70,0
"Rex Tillerson Meets With Mexico’s Foreign Minister, Will Visit Mexico City",0,2,11,51,2,10,0,62,0
Apple Slashes iPhone 7 (Plus) Production By 10% Due To ‘Sluggish’ Sales,0,3,10,42,5,11,3,52,0
Nevada Senate Overrides Veto on Domestic Partners Measure,0,1,7,43,0,7,0,50,0
Sick of Making Lousy Sports Bets? Now You Can Outsource Them ,0,3,10,39,1,11,0,49,0
Here's that mighty 5-storey pregnant Beyoncé portrait you needed to see,0,3,2,56,2,10,1,58,0
Bill Gates: Bioterrorism could kill more than nuclear war — but no one is ready to deal with it,0,2,3,72,2,18,0,75,0
"Update: U.S. Army intelligence had detected 9/11 terrorists year before, says officer",0,1,4,62,5,11,3,66,0
Pence tries to reassure European leaders shaken by Trump,0,3,3,45,0,8,0,48,0
Trump’s lies are working brilliantly. This new poll proves it.,0,2,2,48,3,9,0,50,0
Ukip cannot be allowed to lead the Eurosceptic campaign,0,2,2,45,0,8,0,47,0
Malaysia expels North Korean ambassador after Kim Jong Nam murder,0,2,6,50,0,9,0,56,0
Kahne takes Checkered Flag at Richmond,0,1,4,29,0,5,0,33,0
That Time Cops Searched A Samsung Smart TV For Evidence Of Child Abuse,0,2,14,44,0,12,0,58,0
Iran Backs Taliban With Cash and Arms,0,2,6,25,0,6,0,31,0
The son of 'El Chapo' Guzman's shadowy business partner just busted out of prison,0,3,4,61,3,13,0,65,0
Former Inspector General: Powerful Democrat Women Standing in Way of Hillary Indictment - Breitbart,0,2,11,73,2,13,0,84,0
Six killed as helicopter crashes in central Italy close to avalanche site,0,2,2,60,0,11,0,62,0
A hot $1 billion hedge fund is building computers to predict how human traders will act,0,3,1,69,1,15,1,70,0
Six-Hour Meeting of Chinese Tycoons Eases LeEco Cash Crunch,0,3,10,40,1,8,0,50,0
White House looks to reassure China after Trump-Taiwan call,0,3,5,45,1,8,0,50,0
"Peace, Positivity as Massive Women’s March Makes Voices Heard in D.C.",0,3,10,45,4,10,0,55,0
"’Let’s Put An End To All This Madness,’ Says Brother Of Slain Police Officer",0,2,14,45,4,13,0,59,0
We Really Wish We Could Watch the Expletive-Filled Video Kevin Garnett Created for the Celtics,0,2,13,66,1,14,0,79,0
Marshawn Lynch's Agent Says RB Hasn't Made Decision Regarding NFL Comeback,0,3,14,48,2,10,0,62,0
Cowen & Co. Races to Be $6 Billion Pot Industry’s Financial Guru,0,3,9,39,4,11,1,48,0
Corruption threatens Brazil's Olympics and World Cup,0,1,5,40,1,6,0,45,0
Israeli foreign minister reportedly boycotts Brazilian President's visit,0,1,3,61,1,7,0,64,0
Can Changing When And What We Eat Help Outwit Disease?,0,2,10,34,1,9,0,44,0
Discovery Space Shuttle Launch scheduled for July 13,0,1,5,38,0,7,2,43,0
Taliban Kill Afghan Woman Accused of Adultery in Northeast ,0,2,7,43,0,9,0,50,0
U.S. Quietly Plans Informal Talks With Cuba,0,1,8,27,2,6,0,35,0
"Janet Jackson, 50, gives birth to a boy, Eissa Al Mana",0,3,5,34,3,10,2,39,0
"For older people living alone, daily automated calls can mean safety",0,2,1,56,1,10,0,57,0
"LA County email hack exposes data of 750,000 people",0,3,3,33,1,8,6,36,0
"Tropical storm hits Philippines, 45,000 people displaced",0,1,2,41,2,6,5,43,0
Obamacare Repeal Would Take Insurance From 30 Million People,0,3,8,42,0,8,2,50,0
"Temporary restraining order stops demolition of partially collapsed building in Buffalo, New York",0,1,4,80,1,12,0,84,0
Syrian Refugee Boy Who Fled War Feared Drowned Off San Diego,0,3,11,39,0,10,0,50,0
The Right Type of Happiness to Pursue,0,3,5,26,0,6,0,31,0
ABC's 'black-ish' tackles Trump in emotional post-election episode ,0,3,4,50,5,8,0,54,0
"International Board fixes soccer field size, halts technology experiments",0,1,2,62,1,8,0,64,0
21-Year-Old Delhi Boy Bags A Whopping Rs 1.25 Crore Package From Uber And Nobody Can Keep Calm,0,3,17,53,3,16,5,70,0
#LetThemDie: 'Heartless' Donald Trump Blasted For Slashing Meals On Wheels Funds,0,3,13,53,4,10,0,66,0
Is the need for more sleep a sign of pending dementia?,0,3,1,42,1,10,0,43,0
Russia aims to beef up military ties with Philippines as 2 ships visit ,0,2,2,55,0,13,1,57,0
Is Art Market Recovering?  London May Tell ,0,3,7,27,1,8,0,34,0
China cuts GDP target to 6.5% as leaders seek stability in economy,0,3,4,47,2,11,2,51,0
"Mets Shut Down Redding, Once a Candidate for the Rotation",0,1,7,40,1,9,0,47,0
Available to the Highest Bidder: Coffee With Ivanka Trump ,0,2,7,41,1,9,0,48,0
US researchers discover new way to procure water from thin air,0,3,2,50,0,10,0,52,0
"Leopard runs through Indian city causing chaos, attacks 35 people",0,2,2,51,1,9,2,53,0
NH home of woman missing 35 years is eyed in new search ,0,3,2,40,0,12,2,42,0
"Superannuation funds grow for fifth straight year, industry beats retail",0,3,1,61,1,9,0,62,0
Michael Schumacher calls off Formula 1 comeback due to injury,0,1,3,48,0,9,1,51,0
Las Vegas Columnist Quits After Ban On Writing About Adelson,0,2,10,41,0,9,0,51,0
John Gotti Jr. arrested on murder charges,0,1,3,31,1,6,0,34,0
Indian Markets hits record close in Diwali trade,0,1,3,38,0,7,0,41,0
Exclusive: Muslim woman talks to Katie Couric about Supreme Court victory,0,2,6,56,1,10,0,62,0
SpaceX Plans to Launch First Mission With Private Crew to the Moon,0,3,10,45,0,11,0,55,0
Dollar at highest since 2003; oil falls in choppy trade,0,2,1,40,1,9,4,41,0
U.N. denied access to Guantanamo inmates,0,1,3,30,2,5,0,33,0
Supporters Flock to D.C. Pizzeria Targeted by Fake News,0,3,8,37,2,8,0,45,0
Watch Live: Michelle Obama Gives Final Remarks as First Lady,0,3,9,41,1,9,0,50,0
"Philae, Europe's comet lander, wakes up after seven months",0,2,2,45,3,8,0,47,0
Higher education is awash with hysteria. That might have helped elect Trump.,0,2,3,60,2,11,0,63,0
Anti-abortion activist Bernard Nathanson dies aged 84,0,1,3,41,1,6,2,44,0
Scientology branch in Germany drops legal fight against government surveillance,0,1,2,68,0,9,0,70,0
Japan to use renewable energy,0,1,1,24,0,4,0,25,0
Michigan State Investigating Sexual Assault Complaint Regarding Football Players,0,3,9,63,0,8,0,72,0
Hartmarx Wins Court Approval to Sell Itself,0,1,6,31,0,6,0,37,0
Evidence That Mice Produce Egg Cells After Birth,0,1,8,33,0,7,0,41,0
Iraq collects victim signatures for Blackwater lawsuit,0,1,2,46,0,6,0,48,0
$10 note: RBA celebrates Australian writers in new design,0,2,4,41,2,8,2,45,0
Berlusconi Spars With Murdoch Over Pay TV,0,1,8,27,0,6,0,35,0
"In Sessions hearing, ‘senatorial courtesy’ is lost in the tumult of Trump",0,2,3,56,3,11,0,59,0
Golden Globe winners 2017: The complete list,0,3,3,30,1,6,4,33,0
"As Coming Out Becomes More Common, Is Hip-Hop Less Homophobic?",0,2,11,39,3,9,0,50,0
Melania appears not to have received St Patrick's Day memo as Trumps fly to 'Southern White House',0,3,8,71,3,16,0,79,0
Indonesian goverment bans pornographic sites,0,1,1,39,0,4,0,40,0
Profit Drops 95% at Bank of New York Mellon,0,1,6,26,1,8,2,32,0
Arrested man dies in police cell in Luton,0,3,2,32,0,7,0,34,0
Twin tragedies give survivor a new face,0,3,1,32,0,6,0,33,0
New York Times sues FBI for Comey memos,0,2,7,25,0,7,0,32,0
Peltz-Immelt Showdown Heats Up as GE Rushes to Boost Profits,0,3,10,40,1,9,0,50,0
Ted Cruz: ‘Of Course’ I Would Fire Trump Campaign Manager - Breitbart,0,2,11,43,4,11,0,54,0
"Ed Sheeran Hints When New Taylor Swift Music is Coming, Reveals Nearly Career-Ending Injury in BBC Interview",0,3,18,72,2,16,0,90,0
The Most Popular Investor Picks for Emerging Markets in 2017,0,3,7,40,0,9,4,47,0
"Iceland's President Says He Would Gladly Ban Pineapple Pizzas If He Could, Starts An Online Row",0,3,16,62,2,15,0,78,0
Car bombing in Chechnya kills boy,0,1,2,26,0,5,0,28,0
Family and Lawyer Fear for Reporter Who Threw His Shoes at Bush,0,1,9,43,0,11,0,52,0
"Obama Looks at Adding Bases and Troops in Iraq, to Fight ISIS ",0,2,11,38,1,12,0,49,0
'It popped clean out': Spencer Matthews screams in agony after The Jump crash,0,3,5,57,3,12,0,62,0
American tourist killed in Beijing,0,1,2,28,0,4,0,30,0
Here's what NASA saw when it landed on Saturn's largest moon,0,2,6,42,2,10,0,48,0
Third day of 'King Taksin operation' sees Bangkok airport closed,0,1,4,49,2,9,0,53,0
Matsuzaka Sends Cuba Into Unfamiliar Territory,0,1,6,35,0,5,0,41,0
"Tree car crash kills two in Oxfordshire, England",0,1,3,37,1,7,0,40,0
"FACT CHECK: Clinton’s Speech On Trump And Atlantic City, Annotated",0,2,17,37,3,9,0,54,0
NASA's Phoenix spacecraft lands safely on Mars,0,1,6,33,1,6,0,39,0
See Darren Criss menace Grant Gustin and Melissa Benoist in 'The Flash' musical episode,0,3,9,63,2,13,0,72,0
New 'failed states index' report published,0,1,1,34,2,5,0,35,0
Trump says he shaved $600M off Americaâs most expensive weapons system,0,3,3,53,3,10,3,56,0
Chickens Coming Home to Roost (Sorta),0,2,5,25,2,5,0,30,0
"Lending Locked, U.S. Tries Trillion-Dollar Key",0,1,8,29,4,5,0,37,0
Ezekiel Elliott's Yacht Party Searched by US Coast Guard for Safety Reasons,0,3,11,52,1,11,0,63,0
TDP MLA Kodela Shiva's Anti-Rape Tips Compare Women To Cars And Asks Them Stay 'Parked' At Home To Avoid Accidents,0,3,25,66,4,19,0,91,0
"For Tiger Woods, Timing Is Everything",0,1,6,25,1,5,0,31,0
Nebraska High School Fan Trolls Referee with iPhone Sign,0,3,8,40,0,8,0,48,0
India activist Kailash Satyarthi's Nobel medal stolen from home,0,2,4,50,1,8,0,54,0
Ad Uses Maya Angelou's 'Phenomenal Woman' To Show The Endless Strength Of Women,0,2,13,51,3,12,0,64,0
Wikinews interviews Australian wheelchair basketball player Tina McKenzie,0,1,5,61,0,7,0,66,0
Odell Beckham Jr. Calls NFL Out for Fining Him for Craig Sager Cleats,0,2,13,43,1,12,0,56,0
"I'm a schmuck, 'distracted' Harrison Ford told tower after plane blunder",0,3,3,55,4,10,0,58,0
Radio Host Is Arrested in Threats on 3 Judges,0,1,6,30,0,8,1,36,0
Donald Trump’s Revised Travel Ban Would Cover Seven Countries From Prior Order,0,3,12,54,1,11,0,66,0
Irrfan Khan’s Hindi Medium Is A Humorous Dig At India's Undying Obsession With English Language,0,3,15,64,2,14,0,79,0
Drake Pays Tribute to President Obama with Strange Mash-Up Image (And It's Blowing Up Online),0,2,14,61,4,14,0,75,0
Malala Yousafzai's UN speech set to music for International Women's Day,0,3,7,52,2,10,0,59,0
Former CIA chief cuts ties with Trump,0,3,5,26,0,6,0,31,0
PHOTOS: Chaos in Venezuela as Police Repress Resistance to Supreme Court ’Self-Coup’ - Breitbart,0,2,16,62,5,13,0,78,0
John Rohatinsky backs drug allegations made against Alberto Salazar,0,2,4,55,0,8,0,59,0
Inside the mind of New York state prison worker Joyce Mitchell ,0,3,5,47,0,11,0,52,0
Climate campaigners scale UK Parliament and hang protest banners from the building,0,1,4,67,0,11,0,71,0
"On Facebook’s 13th Birthday, A Look Back at Key Milestones",0,2,8,37,2,9,2,45,0
Trump's personal lawyer will serve as key RNC finance executive,0,3,4,49,1,9,0,53,0
38 dead and 155 wounded in twin bomb attack near Istanbul stadium ,0,3,1,48,0,12,5,49,0
Defamation Suit Filed by Donald Trump Is Dismissed,0,1,7,36,0,7,0,43,0
"Auburn SS Haley Fagan, Florida HC Tim Walton Involved in Altercation After Game",0,3,14,52,1,12,0,66,0
Steven A. Cohen Was Mystery Buyer of $141 Million Sculpture,0,3,8,37,2,9,3,45,0
U.S. Senate releases version of Healthcare Bill,0,1,5,34,2,6,0,39,0
Dutch election: voters go to the polls in the Netherlands – live,0,3,2,49,2,11,0,51,0
Greensboro Church Selling Syracuse vs. UNC-Greensboro Shirts Ahead of NIT Game,0,3,14,52,2,10,0,66,0
Barack Obama to make first public speech since Donald Trump became president,0,3,4,61,0,11,0,65,0
This Nora Ephron Speech Is For Women Who Think Feminism Doesn't Apply To Them,0,2,14,49,1,13,0,63,0
"17 Essays About TV, Music And Film You Should Read Right Now",0,3,12,34,1,11,2,46,0
"U.S. has 'strongest job market in nearly a decade,' says Janet Yellen",0,3,4,49,5,11,0,53,0
I know the fears of immigrants in the schools I oversee. I was undocumented myself.,0,2,3,64,2,14,0,67,0
Greta Gerwig Talks Connecting With Early Female Punk Bands for '20th Century Women',0,2,11,56,2,12,2,67,0
Shuttle Lifts Off for Trip to Telescope,0,1,5,28,0,6,0,33,0
How a court ruling that a lesbian was illegally passed over for a job could be a ‘big moment’ for LGBT rights,0,3,5,81,2,21,0,86,0
Seattle police hunt man who shot Sikh amid hate crime fears,0,3,2,47,0,10,0,49,0
"Shawn Mendes' Manager Discusses Breakout 2016, Fan Outreach & Grammy Reaction",0,3,9,51,3,10,4,60,0
Statue of Liberty lights go out after power cut,0,2,2,37,0,8,0,39,0
Watch Lance Bass Join BSB On Stage in Las Vegas,0,3,11,27,0,9,0,38,0
Kim Jong Nam Killing Caught on Video   ,0,3,6,24,0,9,0,30,0
Four Ways NOAA Benefits Your Life Today,0,2,10,23,0,6,0,33,0
Extremist images 'fingerprinted' by tech firms,0,2,1,38,2,5,0,39,0
Celebs to descend on Washington for anti-Trump mega-rally ,0,3,3,45,2,8,0,48,0
WATCH: Little Girl Wows With Amazing Taylor Swift Impersonation  Insider,0,2,14,47,1,10,0,61,0
Bruce Allen faces greatest Redskins challenge: Getting Daniel Snyder a new stadium deal,0,2,6,68,1,12,0,74,0
Since '85: The Best Air Jordan of Every Year,0,3,7,25,2,8,2,32,0
Father of boy missing 20 years pleads guilty to manslaughter ,0,3,1,48,0,10,2,49,0
Democratic senator says Trump’s ’major pivots in foreign policy’ are ’how wars start’,0,2,2,66,5,12,0,68,0
First ‘Hamilton’ show without Lin-Manuel Miranda is a total letdown,0,2,5,50,3,9,0,55,0
White House to Propose $54 Billion Defense Spending Increase,0,3,7,42,1,8,2,49,0
Palestinian Dance Competition Winner Performs To ’Jihad’ Song ’Pull The Trigger’,0,2,11,55,4,10,0,66,0
"J.R. Smith Shows Up to NBA Finals Game 4 on PhunkeeDuck, Nearly Wipes Out",0,3,15,41,3,13,1,56,0
New year celebrations ring in 2017 around the world,0,2,1,38,0,8,4,39,0
"Trump Brand Gets Post-Election Bounce Among Wealthy, Survey For Forbes Finds",0,3,12,52,2,10,0,64,0
Wikinews exclusive: 'speed not behind New Zealand's road toll',0,1,3,47,4,8,0,50,0
Goldman Sachs Denies Bonuses for 100 Investment Bankers,0,3,6,39,0,7,3,45,0
"Dwyane Wade's Son, Nephew Put Together Highlight Reel at Chicago High School",0,3,11,52,2,11,0,63,0
World Cup workers walk off the job,0,1,2,26,0,6,0,28,0
Neil deGrasse Tyson Cites Celebrity Flat-Earthers To Make A Point About Politics,0,3,13,55,1,11,0,68,0
13 Killed in Texas as Church Bus and Pickup Truck Collide - The New York Times,0,2,11,49,1,15,2,60,0
Scottish Labour agrees reform plan,0,3,2,28,0,4,0,30,0
Why Russia-brokered Syrian ceasefire has chance of succeeding,0,2,3,50,1,7,0,53,0
Bernie Sanders predicts Trump will only be a one-term president,0,3,3,50,1,9,0,53,0
"Drunken man steals forklift, crashes it, police say",0,3,1,41,2,7,0,42,0
South Korea opposition seek interim leader's impeachment,0,3,2,47,1,6,0,49,0
Jack Wilshere ‘wants to be wanted by Arsenal’ amid Manchester City talk,0,3,5,53,2,11,0,58,0
Interpol suspends €20m Fifa partnership,0,2,2,30,1,4,2,32,0
"Gaikwad To Fly Again, SC Notice To Government On Gau Rakshaks And Other Must Read Stories",0,3,17,56,1,15,0,73,0
"Linux installed on 2,460 desktop computers in Italian schools",0,1,2,46,1,8,4,48,0
Texas man arrested after rescuing drowning swimmer,0,1,1,43,0,6,0,44,0
Pulitzer Prize-winning author says we’re thinking about money all wrong,0,2,2,58,2,9,0,60,0
The burrowers: copper mine's fate hints at light at the end of tunnel for Michigan,0,3,2,64,2,14,0,66,0
Expedia names Chelsea Clinton to board of directors,0,3,3,41,0,7,0,44,0
Suicide bomber hits checkpoint in Pakistan,0,1,2,35,0,5,0,37,0
WATCH: 'Who Gave You Your Manners?': Russia's Lavrov Scolds NBC's Mitchell  Insider,0,3,18,46,7,12,0,64,0
China's Defense-Spending Confusion Highlights Strategic Worries,0,2,7,49,2,5,0,56,0
"Trained dolphins recruited to locate, save elusive porpoise from extinction ",0,2,1,64,1,10,0,65,0
Texas man gets drug charge cleared after suspected meth turns out to be kitty litter ,0,2,1,69,0,15,0,70,0
Trump May Turn to Arab Allies for Help With Israeli-Palestinian Relations ,0,3,10,52,1,11,0,62,0
Government looked into impact of tax breaks on housing market but did not act: FOI investigation,0,3,4,76,1,15,0,80,0
"Texas immigration law ’more dangerous’ than infamous Arizona bill, critics say",0,2,2,63,3,10,0,65,0
Donald Trump plays his 'ninth round of golf' in seven weeks as President,0,3,3,55,2,12,0,58,0
"Apple debuts iOS 9: Battery enhancements, smarter Siri and more",0,2,5,46,2,9,1,51,0
Mamdouh Habib to be released from Guantanamo Bay without charge,0,1,4,50,0,9,0,54,0
Nebraska lawmaker quits after unsavory Women's March retweet,0,3,3,49,1,7,0,52,0
Hundreds of lawsuits filed against music sharers in US,0,1,3,43,0,8,0,46,0
"Pakistan freezes accounts of 5,000 suspected terrorists",0,2,1,43,1,6,4,44,0
Accused Sexual Predator Proclaims April National Sexual Assault Awareness Month,0,2,10,60,0,9,0,70,0
EXCLUSIVE - WATCH: YouTube Stars Diamond and Silk Destroy Black Lives Matter - Breitbart,0,2,24,48,3,13,0,72,0
The Folks at Merriam-Webster Sum Up 2016: Surreal ,0,3,7,29,2,8,4,36,0
Scottish football team Hibernian appoint new manager,0,1,2,44,0,6,0,46,0
Expedition 27 crew successfully returns to Earth,0,1,2,38,0,6,2,40,0
LeBron James' Public Comments Making Life Uncomfortable for Cleveland Cavaliers,0,2,10,59,1,9,0,69,0
Suns Troll Visiting Cavaliers Fans with 'Bandwagon Cam',0,3,7,39,2,7,0,46,0
"God, Firearms and America Come Together at a Church in Kentucky",0,1,7,45,1,10,0,52,0
Georgian Opposition Members Held on Arms Charges,0,1,6,36,0,6,0,42,0
PCCW Chairman Drops Bid to Privatize Group,0,1,9,27,0,6,0,36,0
Material World   ,0,2,2,11,0,4,0,13,0
"Jusuf Nurkic's Leg Injury Diagnosed as a Fracture, Out at Least 2 Weeks",0,3,9,47,2,12,1,56,0
Kyrie Irving Wins the Water Bottle Challenge During Knicks Game,0,3,9,45,0,9,0,54,0
How to visit nearly every national park in one epic road trip,0,2,1,49,0,11,0,50,0
U.K.’s Challenge: Reconciling Its Brexit Aims ,0,3,7,29,4,6,0,36,0
"WWE Superstar Kane Announces He's Running for Mayor of Knox County, Tennessee",0,3,12,52,2,11,0,64,0
"California Today: After Lawmaker’s Silencing, More Cries of ‘She Persisted’ ",0,2,9,52,5,10,0,61,0
Top Democrat Would Support Challenge to Electoral Vote Certification ,0,3,8,52,0,9,0,60,0
Hasan Minhaj of “The Daily Show” to host White House Correspondents Dinner,0,2,9,52,2,11,0,61,0
Automation Can Actually Create More Jobs,0,3,6,29,0,5,0,35,0
The MLS Is Growing in Teams—Just Not Profits,0,2,10,26,1,7,0,36,0
"Indian Silicon Valley CEO Abused Wife For 10 Years, To Get Jail Sentence Of Just 30 Days",0,3,17,50,1,16,4,67,0
Study says young stars 'shoot water bullets',0,1,1,35,2,6,0,36,0
Thai official resigns after stealing paintings in Japan,0,2,2,46,0,7,0,48,0
Bodies retrieved from Philippine ferry capsized in typhoon,0,1,2,49,0,7,0,51,0
Australia and New Zealand to pursue 'TPP 12 minus one',0,3,6,35,2,9,2,41,0
Quips and Quotes From Warren Buffett’s 2016 Shareholder Letter ,0,3,7,42,1,9,4,49,0
"Bomb blast in Delhi kills 12, injures 62",0,1,2,26,1,7,4,28,0
State of the UnionVerifizierter Account,0,3,4,31,0,4,0,35,0
Donald Trump addressed alleged lurid sexual acts by saying he's a 'germaphobe',0,2,2,62,3,11,0,64,0
Trump Revives Auto Efficiency Debate With Pledge to Slash Rules,0,3,9,45,0,9,0,54,0
Mary Beard v Arron Banks: 'Your vision of the EU is like mine of Rome – a dream',0,3,8,51,4,17,0,59,0
Gabon court upholds presidential candidate Bongo's win after protest,0,1,2,57,1,8,0,59,0
OracleVoice: Education Ministry Moves From Spreadsheet Scrum To Financial Restart,0,3,11,60,1,9,0,71,0
Northern Ireland 0-0 Romania,0,3,3,19,1,3,2,22,0
"Details, but Little Insight, on Craigslist Killing Suspect",0,1,6,43,2,7,0,49,0
Abbott labs ends dispute with Brazilian government over AIDS drug,0,1,6,50,0,9,0,56,0
A Meteorologist Burned His Daughter Over Text And Now Other Weather Reporters Are Bonding Online,0,3,15,67,0,14,0,82,0
2017 Oscars: Justin Hurwitz Wins Best Original Score for 'La La Land',0,2,10,41,3,11,4,51,0
Bank of Japan Steps Up Effort to Ease Credit,0,1,7,29,0,8,0,36,0
Evocative Photos Highlight New Zealand's Largest Street Gang,0,3,8,44,1,7,0,52,0
Former judge calls for Cherie Blair's resignation,0,1,3,39,1,6,0,42,0
Plane carrying 160 crashes in Venezuela,0,1,2,29,0,5,3,31,0
"Review: Lemony Snicket’s Creations, in a Cloud of Marvelous Gloom ",0,3,7,46,3,10,0,53,0
Big Bet Philanthropy: How More Givers Are Spending Big And Taking Risks To Solve Society's Problems,0,3,16,66,2,15,0,82,0
Paul Pierce Takes in Boston One More Time Before Last Game Against Celtics,0,3,12,50,0,12,0,62,0
Visa crackdown puts these rural doctors at risk,0,3,1,39,0,7,0,40,0
New York Escape: Road Closed Near Prison as Cops Pursue New Lead,0,2,11,41,1,11,0,52,0
Kristen Stewart shaved her head and we're all just so happy for her,0,3,2,52,1,12,0,54,0
Rakhi Sawant Is Likely To Get Arrested For Her Objectionable Comments Against Sage Valmiki,0,2,14,63,0,13,0,77,0
’You can taste the difference’: the secrets of Coney Island’s gelato master,0,2,3,57,4,11,0,60,0
David Njoku Is a Rare NFL-Bound Talent from a Rare Family,0,3,11,35,1,10,0,46,0
"British student walks free, after putting feet on trainseat",0,1,1,49,1,8,0,50,0
"Chelsea Manning Fundraiser Garners More Than $83,000 in One Week",0,3,8,40,2,9,5,48,0
deadmau5 Spent the Day Trolling Reported Old Buddy Glenn Morrison,0,3,8,47,0,9,1,55,0
U.S. Kills 5 Afghans in Raid on House,0,1,6,21,2,7,1,27,0
'The Walking Dead' showrunner teases season 8: 'The first four episodes will melt people's minds',0,3,4,72,6,14,1,76,0
Vanessa Marcotte case: New DNA technology could help solve jogger's slaying,0,2,6,57,2,10,0,63,0
Tsunami warning briefly issued for Indian Ocean after latest earthquake,0,1,3,59,0,9,0,62,0
Fans of OS/2 want IBM to release it as open-source software,0,1,6,40,2,10,1,46,0
Passenger caught smuggling cocaine into US via film stock,0,3,3,46,0,8,0,49,0
Jimmy Kimmel skewers Donald Trump and shows support for 'overrated' Meryl Streep,0,2,6,61,2,11,0,67,0
How Aaron Rodgers saved the Packers' season,0,3,4,32,1,6,0,36,0
Emergency directive for Sikorsky S-92A helicopters,0,1,4,38,1,5,2,42,0
"11 Stunning Photos Of Iconic Stars, And The Stories Behind How They Were Taken",0,2,13,49,1,13,2,62,0
"Presidential candidate of Haiti, Dany Toussaint, arrested by United Nations troops",0,1,6,64,2,10,0,70,0
Emma Stone Hilariously Fails Jimmy Fallon's 'Singing Whisper Challenge',0,2,9,51,3,8,0,60,0
"D.C. scraps plan for $1,000 speeding ticket. It’ll only cost you $500.",0,3,3,41,8,11,7,44,0
60 Injured in Crowd Crush at Australia's Falls Music and Arts Festival,0,3,8,48,1,11,2,56,0
Your Complete Guide to Rewatching ‘Twin Peaks’ - NYT Watching Search,0,3,11,44,3,10,0,55,0
Mubarak arrested in Egypt ahead of corruption probe,0,1,2,42,0,7,0,44,0
Iraqi PM Nouri al-Maliki says U.S Troops can leave when they want,0,1,8,44,2,11,0,52,0
End Of The Boom Boom Era As Shahid Afridi Calls Time On His International Career,0,3,15,51,0,14,0,66,0
"Scandinavian Nonbelievers, Which Is Not to Say Atheists",0,1,7,40,1,7,0,47,0
'My Turn': T.J. Watt Ready to Show the NFL He's Not Just J.J.'s Little Brother,0,2,17,38,9,14,0,55,0
The Chainsmokers' 'Closer' Ties Record for Most Weeks at No. 1 on Hot Dance/Electronic Songs,0,3,12,60,5,14,1,72,0
Brazil's overcrowded prisons experience massacres 'almost daily',0,3,1,54,3,6,0,55,0
"TRUMP: 'If China is not going to solve North Korea, we will'",0,3,9,36,4,11,0,45,0
Furious South Koreans Blast 'Ignorant' Trump For 'Distortion Of History',0,3,10,49,4,9,0,59,0
Google planning PayPal rival,0,1,3,22,0,3,0,25,0
Business Insider is hiring a paid social media intern for our video team. Apply now!,0,3,3,65,2,14,0,68,0
"NHL, MLB player unions support U.S. women hockey players’ boycott",0,2,8,44,4,9,0,52,0
"In the End, Henrik Lundqvist Comes Up a Save Short",0,1,8,32,1,9,0,40,0
At least eight dead after drone strikes in Pakistan,0,1,2,41,0,8,0,43,0
How a ‘Low Volatility’ Stock Plunged 85% in an Hour   ,0,3,6,31,3,12,2,37,0
New Mexico Outlaws School ‘Lunch Shaming’ ,0,2,6,28,2,6,0,34,0
Iraqi Forces Recapture ISIS-Held Mosul Airport Under Fire: State TV,0,3,15,41,2,9,0,56,0
Plane makes emergency water landing in Darwin Harbour,0,1,3,43,0,7,0,46,0
30 Under 30 Europe 2017: Law & Policy,0,3,4,16,2,7,8,20,0
"e-waste: What happens to discarded televisions, computers and mobile phones?",0,2,1,62,4,9,0,63,0
No More Waiting: Inflation May Have Already Hit Fed's Target,0,3,10,39,2,9,0,49,0
"Meet Roshni Misbah, Delhi's Badass ‘Hijabi Biker’ Who's Become An Internet Sensation",0,3,12,56,5,11,0,68,0
"Trump's Syria strike celebrated by 'terrorists', Iran says",0,3,3,44,4,7,0,47,0
Australian rules football: 2010 Gippsland Football League round 1 - Wonthaggi v Leongatha,0,1,6,64,2,12,5,70,0
Making Up for Lost Time,0,1,4,15,0,4,0,19,0
Americans aren't as attached to democracy as you might think,0,3,1,49,1,9,0,50,0
Internet Mocks Floyd Mayweather Jr. for Wearing Jorts to Game 2 of NBA Finals,0,3,12,50,1,13,1,62,0
U.N. seeks to build peace talks on fragile Syria truce,0,2,3,40,2,9,0,43,0
A Muppet with autism to be welcomed soon on 'Sesame Street' ,0,3,4,43,2,11,0,47,0
Brawn Strategy Lifts Button to 4th Victory,0,1,5,30,0,6,1,35,0
Former Astronaut Bolden to Be Interviewed for Top NASA Job,0,1,11,38,0,9,0,49,0
Big Star Remembered in SXSW Concert Film 'Thank You Friends': Watch an Exclusive Clip,0,2,15,54,3,13,0,69,0
Johnny Depp's money worries blamed on $2m-a-month lifestyle,0,3,2,45,4,7,1,47,0
Buddhist relic collection tours North America and world,0,1,3,45,0,7,0,48,0
Amazon Alexa helpfully tries to give porn to a child,0,3,2,41,0,9,0,43,0
Quake Death Toll Tops 280 in Italy,0,1,5,20,0,6,3,25,0
"Trump’s energy plan doesn’t mention solar, an industry that just added 51,000 jobs",0,2,1,60,4,12,5,61,0
Harvard Book Store Creates Bowling Green Massacre Section,0,3,8,42,0,7,0,50,0
Fußball-Bundesliga 2008–09: Goalkeeper Butt signs with Bayern Munich,0,1,6,46,3,7,6,52,0
The Anti-Defamation League Is Offering Sean Spicer Remedial Holocaust Lessons,0,2,11,56,1,9,0,67,0
Nigeria air strike error: Urgent plea to evacuate wounded,0,3,2,46,1,8,0,48,0
Astronomers discover 7 potentially habitable exoplanets orbiting nearby dwarf star - Yahoo,0,3,2,75,1,11,1,77,0
Canadian boy killed in Cambodian seige; Police storm school,0,1,3,47,1,8,0,50,0
Maine Senators Collins and Snowe Gain by Backing Stimulus,0,1,7,42,0,8,0,49,0
Ocean Combed for Jet Data in Biggest Aviation Search,0,1,7,37,0,8,0,44,0
Bleacher Buzz LeBron James Working to Help Produce HBO Documentary on Muhammad Ali's Life,0,3,15,60,1,13,0,75,0
Prosecutors won't pursue misconduct charge against Christie ,0,3,2,50,1,7,0,52,0
Keep Fidgeting! Movement Helps Improve Focus in Kids With ADHD,0,3,12,40,1,9,0,52,0
Trump signals he won't press human rights ahead of key diplomatic week,0,3,1,57,1,11,0,58,0
FreedomWorks Opposes Speaker Ryan’s Obamacare 2.0 Plan,0,2,7,37,2,6,2,44,0
The 30 Funniest Women in Hollywood History,0,2,5,29,0,6,2,34,0
"Is Hebrew the world's first alphabet? Israelites in Egypt may have turned hieroglyphs into letters 3,800 years ago",0,3,4,86,3,17,4,90,0
"UN getting daily reports of rapes, killings and other abuses against Rohingya Muslims in Burma",0,2,5,74,1,14,0,79,0
It's the absolute worst time for 'Girlboss' on Netflix,0,2,3,40,3,8,0,43,0
It Looks Like Andrea Bocelli Won't Perform At Trump's Inauguration,0,3,10,45,2,9,0,55,0
"To Get a Business Loan, Know How the Bank Thinks",0,1,8,30,1,9,0,38,0
"Warren Buffett, in Annual Letter, Offers Hymn to U.S. Economy - The New York Times",0,2,13,50,5,14,0,63,0
25 dead after mine explosion in West Virginia,0,1,2,34,0,7,2,36,0
'We love you': Syrians 'thank' Trump for US airstrikes by changing their Twitter profiles to photos of him,0,2,6,78,5,17,0,84,0
WINNER Hits New Peak on World Digital Song Sales Chart With Latest Comeback,0,2,17,46,0,12,0,63,0
Saudi Arabia Says It Will Work With Trump to Contain Iran,0,3,10,37,0,10,0,47,0
"GOP's Obamacare replacement bill is an 'age tax' on older Americans, AARP says",0,3,9,53,4,12,0,62,0
Thai police arrest man smuggling semen into Laos,0,3,2,39,0,7,0,41,0
Far-Right Israeli May Be Next Foreign Minister,0,1,8,31,1,6,0,39,0
Satellite radio approved in Canada,0,1,2,28,0,4,0,30,0
Betty White Requests a 'Golden Girls' Reboot for Her 95th Birthday ,0,3,8,44,2,11,2,52,0
The most incredible photos of the US Army in 2016,0,2,4,32,0,9,4,36,0
Priest charged in exorcism death,0,1,1,27,0,4,0,28,0
Ad-Spending Growth to Slow Significantly in 2017 ,0,3,5,32,1,7,4,37,0
"Trump bars door to refugees, visitors from seven mainly Muslim nations",0,2,2,57,1,10,0,59,0
Beacon Sets the Mood With Contemplative Dance Jams at Billboard Lounge,0,2,9,51,0,10,0,60,0
Prospect Park spends over $2M to collect human poo,0,2,3,37,1,8,1,40,0
Southern Ocean whale slaughter to resume,0,1,2,33,0,5,0,35,0
Governor of Illinois arrested on suspicion of corruption,0,1,2,47,0,7,0,49,0
The NBA's Ageless Wonders: Ranking the Best 30 Players over 30,0,2,9,37,2,10,4,46,0
'Wolfenstein 3D' mod asks you politely whether you want to shoot Nazis,0,3,3,53,2,11,1,56,0
N.B.A. Finals: LeBron James and Cavaliers Hold Off Warriors ,0,3,11,36,4,9,0,47,0
"Zsa Zsa Gabor, Famous for Being a Celebrity, Dies at 99",0,3,7,34,2,10,2,41,0
How a 91-year-old imam came to symbolize the feud between Qatar and its neighbors,0,2,2,62,2,13,2,64,0
North Korea to test missile that could reach U.S. mainland,0,1,4,43,2,9,0,47,0
Salman Khan Will Have His First Live Concert In Australia Soon And It's Called 'DA-BANG'!,0,3,20,50,5,14,0,70,0
Travis Scott's Love For Portland Goes Beyond His 'More Life' Collaboration,0,3,11,50,3,10,0,61,0
Parents Unable to Halt Cuts at Conserve School,0,1,6,33,0,7,0,39,0
"Chain-smoking TWO-year-old, now aged nine, kicks his 40-a-day habit and becomes the star pupil at his primary school",0,3,4,86,7,17,2,90,0
Coal miners trapped in West Virginia mine,0,1,3,32,0,6,0,35,0
"Before Owning The Court With Their Smashes, These Premier Badminton League Stars Scorched The Ramp",0,3,15,68,1,14,0,83,0
NFL Sunday night roundup: Raiders clinch playoff berth for first time since 2002,0,3,5,58,1,12,4,63,0
Truck bomb in Iraq kills over 100,0,1,2,22,0,6,3,24,0
"The BBC Kids and Their Parents Are Back, in a Cartoon ",0,2,10,32,1,11,0,42,0
Airports Boost Security After Fort Lauderdale Shooting ,0,2,7,41,0,7,0,48,0
Anzac Day 2017: Artists honour digger who died in the battle for Bullecourt,0,3,4,54,1,12,4,58,0
This photo series proves trans people are more than their gender identity,0,2,1,61,0,11,0,62,0
Ex-GOP Official Who Accused Dems Of Voter Fraud Charged With Voter Fraud,0,2,15,45,1,11,0,60,0
Demonetisation: Indians Are Sending Old Notes To Their Relatives Abroad To Exchange Them By June 30,0,3,15,66,1,15,2,81,0
French workers use threats in compensation demand,0,1,1,42,0,6,0,43,0
Disney animator Ollie Johnston dies at 95,0,1,3,30,0,6,2,33,0
"Vandals damage 100 headstones at Jewish cemetery, police say",0,3,2,46,1,8,3,48,0
Novelist Chris Cleave On ’Brexit’: ’We’ve Just Shot Ourselves In Both Feet’,0,2,12,46,6,11,0,58,0
Seasonal Flu Reaches Epidemic Levels in US ,0,3,7,29,0,7,0,36,0
Dylann Roof Laughed During Church Slaying Confession to FBI ,0,3,10,41,0,9,0,51,0
Nigeria's Port Harcourt covered in mystery cloud of soot,0,3,3,44,1,8,0,47,0
UN observers in Syria fired upon as report alleges US warplanes readying attack,0,1,5,62,0,12,0,67,0
African troops invade rebel-held island of Anjouan,0,1,2,41,1,6,0,43,0
"Trump, White House push back on Russia ties brought up in House hearing",0,2,5,53,1,12,0,58,0
Trump's Net Worth Falls $200 Million Since Election,0,2,7,32,2,7,3,39,0
Federal Panel Backs Approval of New Drug to Fight Heart Attacks ,0,2,9,44,0,11,0,53,0
"Now May Be Time for Foreigners to Buy Japan Stocks, Goldman Says",0,2,10,42,1,11,0,52,0
'Full Frontal' Visits Scotland To Meet The Original Donald Trump Haters,0,3,11,48,2,10,0,59,0
Memo To Steven Mnuchin: Trump's Tax Plan Would Add $7 Trillion To The Debt Over 10 Years,0,2,15,51,3,16,3,66,0
Just One Gram Of DNA Can Potentially Hold All The Data Stored On The Internet,0,3,17,46,0,14,0,63,0
"Russian teenagers talk politics, protests and Putin",0,3,2,42,1,6,0,44,0
New insulin-resistance discovery may help diabetes sufferers,0,1,1,52,1,6,0,53,0
Syria's Assad calls US troops 'invaders' but still hopes to cooperate with Trump,0,3,5,60,3,12,0,65,0
Trump Winery Looking to Add Foreign Workers ,0,3,6,31,0,7,0,37,0
It’s Official: Brazil Ousts Impeached President Dilma Rousseff,0,2,8,45,2,7,0,53,0
"'Trump Sheriff' Threatens Mayor, Scorns Him For Getting His A** Kicked Aiding Woman",0,3,13,53,5,12,0,66,0
Obama Orders “Full Review” Of Election Hacking Concerns,0,3,8,38,2,7,0,46,0
Sectarian Tension Takes Volatile Form in Bahrain,0,1,6,36,0,6,0,42,0
Patriots star Rob Gronkowski to have back surgery Friday,0,2,4,44,0,8,0,48,0
Jewish men attacked with hacksaw by men ‘shouting anti-Semitic abuse’ in Paris,0,3,3,61,3,11,0,64,0
Seann Walsh: ‘I wrote a line for The Thick Of It – it's probably my proudest moment’,0,2,7,56,5,16,0,63,0
Romania to adopt euro between 2012 and 2014,0,1,1,27,0,7,8,28,0
Former head of Royal Bank of Scotland Fred Goodwin to reduce pension,0,1,6,51,0,11,0,57,0
"Martin McGuinness, Irish rebel turned politician, dies at 66 ",0,3,4,44,2,9,2,48,0
"In accidental 'reply all' to reporter, Collins thanks CEO for defending HHS nominee",0,2,8,60,3,12,0,68,0
Kim Jong-un: Trying to make sense of North Korea's leader,0,2,5,40,3,9,0,45,0
Congressman plans to block D.C. law to let terminally ill patients end their lives,0,3,3,64,2,13,0,67,0
MILO Burns Gay Pride Flag In Unofficial Trump Ad - Breitbart,0,2,13,36,1,10,0,49,0
100 Women 2016: Fighting bulls and sexism,0,3,2,25,1,6,7,27,0
Felipe Massa wins 2008 French Grand Prix,0,1,5,25,0,6,4,30,0
Hillary Clinton 2016 campaign rally on Roosevelt Island – as it happened,0,2,4,52,1,11,4,56,0
NFL Former NFL RB Jamal Anderson Avoids Arrest After Exposing Penis at Gas Station,0,2,18,51,0,13,0,69,0
Starbucks Also Unleashed A Dragon Frappuccino Over The Weekend,0,3,9,45,0,8,0,54,0
"Duterte opens ASEAN summit with oblique swipe at US, EU ",0,3,10,35,1,10,0,45,0
Man dies in Serbian enclave; could not call ambulance,0,1,2,42,1,8,0,44,0
The Milanese malaise plumbs new depths of calamity in Serie A,0,3,4,47,0,10,0,51,0
"Suicide bomber kills more than 50 in Yemen, ISIS claims responsibility",0,2,6,51,1,10,2,57,0
Russia announces Libyan arms deal,0,1,2,27,0,4,0,29,0
"2 Dead, 2 Injured at Elementary School Shooting in San Bernardino in Apparent Murder-Suicide",0,3,10,65,2,13,2,75,0
U.S. to Pledge $40 Million for Afghanistan Elections,0,1,6,34,3,7,2,40,0
Mark Rutte’s Test,0,2,3,11,1,2,0,14,0
MATTIS: Moscow needs to 'prove itself' before the US and Russian militaries can work together,0,2,10,66,3,14,0,76,0
Graham: 2017 Will Be ‘The Year of Kickin’ Russia in the Ass’,0,3,8,33,4,11,4,41,0
A TEDx Speaker Called Out The People Who Made Rude Memes Of Her In The Most Polite Way,0,3,20,49,0,17,0,69,0
"Contractor Must Pay in Iraq Fraud, Court Rules",0,1,7,31,1,7,0,38,0
Strong earthquake hits northern Pakistan,0,1,2,34,0,4,0,36,0
Snapchat just released a 35-minute video about itself,0,2,1,42,1,7,2,43,0
This Student Had To Draw A Spider In His Biology Class And People Can’t Handle How Bad It Is,0,3,19,54,1,18,0,73,0
Petroleum Resource Rent Tax concessions under the microscope ahead of May budget,0,2,5,64,0,11,0,69,0
Costs of bank cyber thefts hit SWIFT profit last year,0,2,6,38,0,9,0,44,0
"For Obama, Talk About Economy Goes Into Late Night",0,1,9,32,1,8,0,41,0
Why a rising number of criminals are using Facebook Live to film their acts,0,3,3,59,0,13,0,62,0
"In Donald Trump’s Washington, Business Lobbyists Champ at the Bit",0,3,8,46,2,9,0,54,0
"Small towns seethe at bank closures, but others are plotting a new future",0,3,1,59,1,12,0,60,0
Why Erdogan's spat with Europe is significant,0,3,3,35,1,6,0,38,0
"Samsung Heir, Seeking to Modernize Opaque Culture, Instead Faces Scandal",0,3,9,52,2,9,0,61,0
Apple 'spaceship' headquarters readies for boarding,0,3,1,43,2,5,0,44,0
"Iran: If Enemies Do Wrong, Missiles Will Come Down on Them ",0,3,10,36,2,11,0,46,0
New Zealand journalist deported from Fiji,0,1,3,33,0,5,0,36,0
Father sacked for missing work for son's birth is inundated with job offers,0,3,1,61,1,12,0,62,0
"Iraq: Shootings, bombings kill dozens in Baghdad, Baquba, Qiyara, Madaen",0,1,6,52,5,9,0,58,0
'History is watching': JK Rowling criticises Theresa May's 'plans to praise' Donald Trump,0,2,8,63,6,12,0,71,0
Guinea swears in civilian prime minister,0,1,1,34,0,5,0,35,0
Former Chilean President Pinochet suffers heart attack,0,1,4,44,0,6,0,48,0
Gibraltar accuses EU of behaving like a 'cuckolded husband who is taking it out on the children',0,3,3,75,2,16,0,78,0
"Wikinews interviews Donald K. Allen, independent candidate for US presidency",0,1,6,59,2,9,0,65,0
Seth Meyers Rips Donald Trump's Response To Russian Hacking Revelation,0,3,10,50,1,9,0,60,0
Maya Moore Helps UConn Roll Past DePaul,0,1,9,24,0,6,0,33,0
South Korea Military Says North Korea Fired Missile Into Waters Off Coast,0,3,12,50,0,11,0,62,0
Massachusetts Sued Over Cost of Health Care,0,1,6,31,0,6,0,37,0
Shoe thrown at Chinese PM during speech at Cambridge University in the UK,0,1,8,53,0,12,0,61,0
Would You Spend $200 For a Watch Made Out of Your Pet’s Hair?,0,3,10,33,3,12,3,43,0
Former Ecuadorian football referee Byron Moreno arrested for drug smuggling,0,1,4,62,0,9,0,66,0
Queensland state Green party to run environmental lawyer in treasurer's electorate,0,1,2,69,1,10,0,71,0
Netflix dominates Saturdays â here's how it stacks up against TV networks the rest of the week,0,3,4,73,3,16,0,77,0
Howard and Magic Defeat Celtics and Force a Game 7,0,1,6,34,0,9,1,40,0
Floyd Landis Is on Road Again but Detours From Attention,0,1,8,39,0,9,0,47,0
New Yankee Stadium Has Room to Breathe and Room to Spend,0,1,8,38,0,10,0,46,0
Memo To Steven Mnuchin: Trump's Tax Plan Would Add $7 Trillion To The Debt Over 10 Years,0,3,15,51,3,16,3,66,0
Michelle Obama's reaction to Melania Trump's gift is about where everyone's at today,0,3,4,65,3,12,0,69,0
Trump Stands By Unproven Wiretap Claim At Joint News Conference With Merkel,0,2,12,52,0,11,0,64,0
NATO Says Top Taliban Leader Slain,0,1,9,20,0,5,0,29,0
Congressional computers continue to be used to vandalize Wikipedia,0,1,2,56,0,8,0,58,0
United States confirms first military death sentence since 1957,0,1,2,49,0,8,4,51,0
Starbucks Baristas Totally Hate The Unicorn Frappuccino And Are Losing It Online,0,3,12,57,0,11,0,69,0
'Russia hacking code' found on Vermont utility computer,0,3,2,44,2,7,0,46,0
National security adviser: Term 'radical Islamic terrorism' isn't helpful,0,3,3,58,4,8,0,61,0
North Korea Mocks China for ‘Dancing to U.S. Tune’ ,0,3,8,30,4,9,0,38,0
What is AppNexus? We Explain What the Ad Tech Company Does,0,3,10,37,1,10,0,47,0
China to establish protest zones for Olympics,0,1,2,37,0,6,0,39,0
"Politics, Diversity Major Topics of Jokes and Speeches at 2017 Golden Globes ",0,3,8,52,1,12,4,60,0
Parents Release Video Of Teen Believed Kidnapped By Teacher,0,2,9,42,0,8,0,51,0
6.4 magnitude earthquake hits Taiwan,0,1,1,28,1,4,2,29,0
Kirchner Resigns as Party Leader in Argentina,0,1,5,34,0,6,0,39,0
North Korea video imagines US forces' destruction,0,3,4,38,1,6,0,42,0
Australian family rescued after night on Japan mountain,0,3,2,46,0,7,0,48,0
HHS Secretary says passing health care bill through House and Senate 'a fine needle' to be thread ,0,3,6,73,2,17,0,79,0
Bill and Hillary Clinton to attend Trump inauguration,0,3,4,42,0,7,0,46,0
Mother's diet before conception 'can affect child's lifelong risk of disease',0,3,1,62,4,10,0,63,0
Earlier Investigation Focused on Alleged Relationship Between Female Prison Worker and Escaped Killer,0,2,11,78,0,12,0,89,0
"India Injects Rs 20,000 Crore Into Urgent Arms Deals, Wants To Keep Forces Ready For War",0,3,15,51,2,15,5,66,0
Michigan city scoops another's ice cream record,0,3,1,39,1,6,0,40,0
Montel Williams Show breached standards with 'psychic' Sylvia Browne,0,1,5,53,2,8,0,58,0
"Wait, Rob Lowe Is The New KFC Colonel?",0,3,10,19,2,7,0,29,0
Felipe Massa wins 2008 Turkish Grand Prix,0,1,5,26,0,6,4,31,0
"Los Angeles Dodgers Kenley Jansen Re-Signs with Dodgers: Latest Contract Details, Comments, Reaction",0,3,13,71,4,12,0,84,0
Oscars 'La La Land' flub joins list of embarrassing award show errors,0,3,4,52,2,11,0,56,0
"Trump's Tax Plan: Doubles Standard Deductions, Ends ‘Death Tax’ | Fox Business",0,2,11,50,6,11,0,61,0
Intel chair Nunes' White House meeting with source raises concern over Trump inquiry,0,2,5,66,1,12,0,71,0
Re-creation of 1919 cross-Atlantic flight is successful,0,1,2,41,2,6,4,43,0
India’s Requests for Information About Facebook Users Rises Again - India Real Time,0,3,11,58,2,12,0,69,0
"After a Sensational Crime, a Trial Marked by Quiet",0,1,6,35,1,8,0,41,0
"Nothing Is Set in Stone, So Renegotiate",0,1,6,26,1,6,0,32,0
Lyon-Besiktas Europa League Match Delayed by Projectiles Thrown on to Pitch,0,3,9,55,1,10,0,64,0
Comcast BusinessVoice: How To Make The Best Of A Valued Employee Leaving Your Business,0,3,15,57,1,13,0,72,0
Washington Post Names 2 Managing Editors,0,1,5,29,0,5,1,34,0
"Lorde, Flume, Weezer, Big Sean, Odesza & More for Bumbershoot 2017",0,3,8,39,5,10,4,47,0
"Seth Rogen, Billy Eichner in Talks to Voice Timon & Pumbaa in Live-Action 'Lion King'",0,3,12,54,5,14,0,66,0
"Moon, Ahn and a Self-Described Strongman Vie to Lead South Korea",0,2,9,43,2,10,0,52,0
Tech companies are pushing the FCC to preserve its net neutrality rules,0,3,4,56,0,11,0,60,0
Heathrow: Second day of freezing fog grounds 80-plus flights,0,3,2,46,2,8,2,48,0
"A letter to … My mother, who hit me when I was a child",0,3,3,36,2,13,0,39,0
"Alicia Keys, Snoop Dogg, YG & T.I. Pay Tribute to Tupac at Rock and Roll Hall of Fame 2017 Induction",0,3,16,56,5,19,4,72,0
"Why synthetic marijuana like K2 or Spice can cause ""really bizarre"" symptoms",0,3,3,59,2,11,1,62,0
Cavaliers SG Iman Shumpert's Latest Rap Is About ESPN's 'First Take',0,3,15,39,4,10,0,54,0
The Trump Cabinet: Bonfire of the agencies,0,3,4,31,1,6,0,35,0
Can Georgia's dedicated liberal women turn red state blue?,0,3,2,46,2,8,0,48,0
Trump Says United States Can ‘Solve’ North Korea Without China,0,3,10,41,2,9,0,51,0
Do YOU trim your pubic hair? Then you're 80% more likely to have an STD,0,3,8,44,3,14,2,52,0
Brent Musburger Retiring from Sports Broadcasting: Latest Details and Reaction,0,3,8,60,1,9,0,68,0
Coptic Christians select their 118th pope,0,1,2,31,0,5,3,33,0
"Taliban militants kill 20 Afghan police officers in attack, official says ",0,2,2,58,1,11,2,60,0
"UN: Ethiopian GDP grew only 1.7% in 2009, may not reach anti-poverty goals",0,1,6,45,5,12,6,51,0
United was plagued with a huge issue even before dragging a customer off a plane,0,2,1,65,0,14,0,66,0
"Back on the Mekong Delta, John Kerry meets a man who once tried to kill him and finds exoneration",0,2,5,73,1,18,0,78,0
Police Arrest Dozens of Protesters During Trump Inauguration Protests,0,3,8,53,0,8,0,61,0
2017 NBA Power Rankings: Stacking Up All 30 Teams Before the Home Stretch,0,3,12,42,1,12,6,54,0
Binge Eater: Black hole taking record-breaking decade to devour star,0,3,3,54,2,9,0,57,0
Íngrid Betancourt returns to France,0,1,3,28,0,4,0,31,0
Pence on 'Trumpcare': 'Congress just wasn't ready',0,2,3,35,6,6,0,38,0
Record Deliveries Help Airbus Parent Post Profit,0,1,7,35,0,6,0,42,0
Last chance to sign up for Obamacare for 2017 coverage,0,3,2,39,0,9,4,41,0
Berlin Truck Attack: Christmas Market Suspect Released Due to Insufficient Evidence,0,2,10,62,1,10,0,72,0
United CEO Oscar Munoz felt 'shame' to see passenger dragged off flight ,0,2,6,52,2,12,0,58,0
Prince Search Warrants Reveal More Than 100 Pills Found at Paisley Park,0,3,10,47,0,11,3,57,0
Trump Backers Go to Court to Block Vote Recounts in 3 States ,0,3,8,40,0,12,1,48,0
Morgan StanleyVoice: Own Your Financial Future: A Guide For Women,0,2,11,43,2,9,0,54,0
Mike Zimmer Says He Has 'No Idea' If Teddy Bridgewater Will Play in 2017 Season,0,2,13,46,2,14,4,59,0
Citigroup Considering Reverse Stock Split,0,1,5,32,0,4,0,37,0
Audi boss warns Google's self driving cars could monitor where you are to sell ads,0,3,2,65,1,14,0,67,0
Copenhagen climate conference opens,0,1,1,31,0,3,0,32,0
Armed police storm Tube train at Bank Station over reports of passenger wielding knife,0,3,4,69,0,13,0,73,0
S. Koreans to March for 6th Weekend Calling for Park Ouster ,0,3,7,40,1,11,1,47,0
US hacking claims: Clinton blames Russia and FBI boss for loss,0,3,7,44,1,10,0,51,0
Guard rail kills ten in Malaysian bus crash,0,1,2,34,0,7,0,36,0
Court Says Gay Employees Can Sue Under 1964 Civil Rights Act ,0,3,10,36,0,11,4,46,0
Manchester United v Chelsea: match preview,0,2,3,33,1,5,0,36,0
Thousands gather in London to protest against government cuts,0,1,2,51,0,8,0,53,0
Bernanke Defends His Role in Merrill Sale,0,1,6,29,0,6,0,35,0
"How Caris LeVert, a Rookie With the Brooklyn Nets, Spends His Sundays ",0,3,11,45,2,12,0,56,0
Swedish File-Sharers Convicted,0,1,4,23,1,2,0,27,0
Niall Horan Celebrates St. Patrick's Day By Joking About His Irishness on Twitter,0,3,12,55,2,12,0,67,0
Hairs Provide Clues to Shifts in Elephant Diet,0,1,6,33,0,7,0,39,0
LeBron James Calls Out His Team's 'Toughness' Following Loss to Nuggets,0,2,11,47,3,10,0,58,0
11-year-old boy dies after being shot in Liverpool,0,1,1,38,2,7,2,39,0
"Xenophobia Threatens Italy, President Giorgio Napolitano Warns",0,1,7,48,1,6,0,55,0
Rural Areas Brace for a Shortage of Doctors Due to Visa Policy ,0,3,8,43,0,12,0,51,0
Signs G.O.P. Is Rethinking Stance on Gay Marriage,0,1,9,30,3,7,0,39,0
"George Michael: we grieve for an artist, a time we knew, and for the young lovers we were",0,3,2,67,3,17,0,69,0
"Watch NASA Launch A Rocket Into Space In A Live, 360-Degree Video Feed On April 19",0,3,18,42,2,15,5,60,0
"The story of the British Black Panthers through race, politics, love and power",0,3,4,60,2,12,0,64,0
Another Los Angeles Times Promotion Draws Fire,0,1,7,33,0,6,0,40,0
"In Austin, a Thriving Weekly with an Arts Mission",0,1,6,34,1,8,0,40,0
Anti-Islamic senator to control Aussie senate,0,2,3,36,1,5,0,39,0
The Countries With The Highest And Lowest Salary Expectations,0,2,9,44,0,8,0,53,0
Jackass star Ryan Dunn dies in car accident aged 34,0,1,3,37,0,9,2,40,0
Trump Has Options for Undoing Obama’s Climate Legacy - The New York Times,0,2,11,48,2,12,0,59,0
Migrant workers in Dominos Pizza 'slavery',0,1,3,32,2,5,0,35,0
The White House just shared an article condemning Donald Trump The list,0,3,6,54,0,11,0,60,0
Turkey's Tourism Industry Suffers After Recent Terror Attacks ,0,3,8,45,1,8,0,53,0
Deutsche Bank Posts $1.6 Billion Profit,0,1,5,25,2,5,2,30,0
A Bunch Of Asian Superheroes Are Teaming Up And People Are Excited,0,3,12,43,0,11,0,55,0
New Version of Malicious Computer Program Is Released,0,1,7,39,0,7,0,46,0
Thousands of children and teenagers with anorexia forced to wait months for help,0,2,1,67,0,12,0,68,0
Stephen Colbert Brings Back 'Colbert Report' Alter Ego For Obama Send-Off,0,3,12,48,3,10,0,60,0
Israel ambassador to US: Move embassy to Jerusalem,0,3,5,37,1,7,0,42,0
First sign of enhanced U.S.-Russia relations under Trump: An invite to Syria talks,0,2,7,59,4,12,0,66,0
Civilians dead following U.S. air strike on 'terrorist compound',0,1,3,49,4,8,0,52,0
Captain killed as DC-9 cargo jet crashes onto Mexican highway,0,1,4,46,1,9,1,50,0
"Fixing 401(k)s: What’s Being Done to Improve Access, Limit Early Withdrawals",0,3,9,49,5,10,3,58,0
Couple jailed for holding disabled woman in their home as sex slave,0,3,1,55,0,11,0,56,0
Blair launches third and final manifesto,0,1,1,34,0,5,0,35,0
Jeff Sessions Now Admits Grabbing A Woman By The Genitals Is Sexual Assault,0,3,13,50,0,12,0,63,0
New-elected W.Va. sheriff charged with stealing meth from evidence room,0,2,3,56,3,9,0,59,0
"'Christmas in the Stars': Revisiting the Sadly Forgotten 'Star Wars' Holiday Album, Bon Jovi and All",0,3,12,67,6,15,0,79,0
America badly needs a coherent foreign policy strategy. Will 2016 candidates ever share their vision? ,0,3,2,79,2,15,4,81,0
"Australian Open 2017 day eight: Nadal beats Monfils, Raonic downs Bautista Agut– as it happened",0,2,7,67,3,14,4,74,0
Fox News Host Thinks Snoop Dog and Bow Wow Should Be 'Killed' for Anti-Trump Actions,0,3,14,53,3,14,0,67,0
Do You Really Need A Cofounder For Your Startup?,0,3,9,30,1,8,0,39,0
"Julie Bishop calls on US to increase role in region, raises concerns over South China Sea",0,2,7,66,1,15,0,73,0
2007 Rugby World Cup: Argentina 33 - 3 Georgia,0,1,5,24,2,8,7,29,0
Florida Has Called Two Tribesmen From Tamil Nadu To Catch Pythons Harming Ecosystem,0,3,13,58,0,12,0,71,0
NASA 'mixtape' highlights best of 2016 space research,0,3,4,36,2,7,4,40,0
Lawmaker Denies Effort for Lobbyists,0,1,4,28,0,4,0,32,0
This page is unavailable.,0,3,1,20,1,3,0,21,0
Gasoline Industry Wrestles With Biofuel Law’s Unintended Consequences,0,3,8,53,1,7,0,61,0
Two-year-old punished in dryer,0,1,1,24,2,3,0,25,0
Zadie Smith and Michael Chabon nominated for book critics award,0,2,4,50,0,9,0,54,0
"Injured ants get rescued after sending chemical SOS, researchers find",0,3,4,55,1,9,0,59,0
Lindsay Lohan “trying so hard” for a “Mean Girls” sequel,0,3,4,39,4,9,0,43,0
Spike Lee: ‘Black men are still viewed as predators’,0,3,3,38,3,8,0,41,0
"Trump thinks something terrible happened in Sweden, so here come the IKEA and ABBA jokes",0,3,10,63,1,14,0,73,0
McKesson Buys Drugstore Brand,0,1,5,21,0,3,0,26,0
Coptic Christian mother sees husband and son killed,0,3,2,42,0,7,0,44,0
Excessive surgeries swell Medicare costs in United States,0,1,4,46,0,7,0,50,0
UNHCR: Somalia violence killed 258 civilians last month; tens of thousands displaced,0,1,6,62,2,11,3,68,0
Chris Pratt keeps cropping Jennifer Lawrence out of photos,0,3,4,46,0,8,0,50,0
Jeb Bush shakes up team ahead of campaign launch,0,3,2,38,0,8,0,40,0
Tax Havens Likely to Be Target of G-20 Nations,0,1,7,28,1,8,2,35,0
Rhetoric of Rationing Health Care Overlooks Reality,0,1,6,39,0,6,0,45,0
"In private meeting, Pence vows ‘full evaluation of voting rolls’ over claims of fraud",0,2,2,67,3,13,0,69,0
Bomb explosion in Kashmir kills three,0,1,2,30,0,5,0,32,0
Turkey car bomb and gun attack on courthouse in Izmir,0,3,2,42,0,9,0,44,0
Why sexual harassment scandals like Uber's are bound to persist in tech,0,3,2,57,1,11,0,59,0
Spotify to Develop Its Own Hardware to 'Affect the Way the World Experiences Music',0,3,10,58,2,13,0,68,0
Idris Elba Cracks Up While Getting Dating Advice From Kids,0,3,10,39,0,9,0,49,0
U2 Sued for Allegedly Stealing 'Achtung Baby' Song 'The Fly',0,3,9,37,4,9,1,46,0
General Motors is gaining amid reported talks to sell its European business,0,3,3,61,0,11,0,64,0
"Baghdad morgue received over 1,000 bodies in July",0,1,2,35,1,7,4,37,0
Northern Ireland's power-sharing agreement on the brink of collapse as Martin McGuinness quits,0,2,5,75,2,12,0,80,0
"Joining high court, the real Neil Gorsuch set to stand up ",0,3,3,43,1,11,0,46,0
'Beware of Jews' sign found in north London reported to police,0,3,3,47,2,10,0,50,0
Rio de Janeiro to host 2016 Olympics,0,1,3,23,0,6,4,26,0
"The back story behind Oscar's social media sensation ""Gary from Chicago""",0,3,4,55,3,10,0,59,0
"Four shot in restaurant in Alabama, US",0,1,4,27,1,6,0,31,0
FBI releases information on San Bernardino shooter iPhone hacking but vendor remains unidentified,0,3,6,79,0,12,0,85,0
Watching Alex Trebek Say 'Yas Queen' on 'Jeopardy' Will Make Your Day,0,2,11,43,4,11,0,54,0
Facebook creeping is no longer totally anonymous,0,3,1,41,0,6,0,42,0
These 52 Amazing Photos From Around The World Sum Up 2016 Perfectly,0,3,10,40,0,11,6,50,0
Zimbabwe begins vote recount,0,1,1,24,0,3,0,25,0
NT family vows to rebuild tattoo parlour gutted by fire police say is suspicious,0,3,2,65,0,13,0,67,0
Was Penn State's explosive comeback enough for playoff bid?,0,3,3,46,2,8,0,49,0
Debt Doesn't Have To Be A Dirty 4-Letter Word,0,2,9,25,2,8,1,34,0
Javier Velásquez named as Peru’s new Prime Minister,0,1,5,38,1,7,0,43,0
Yale University Group Seeks to Allow Women into All-Male Fraternities  Insider,0,3,10,56,1,11,0,66,0
Vaughan Gething: ‘You can go to A&E and be there five hours but have a good experience’,0,2,5,62,4,16,0,67,0
VP Mike Pence criticises AP for publishing wife's AOL email address,0,2,9,47,1,10,0,56,0
Here Are The Men Who Made ISRO’s World Record 104 Satellite Launch Possible,0,3,15,44,1,12,3,59,0
Mitt Romney is now top contender for secretary of state,0,3,2,44,0,9,0,46,0
Young Musician of the Year finalist hit with council ban following noise complaint,0,3,3,67,0,12,0,70,0
Washington Sees Excess in Its Fund for Jobless,0,1,6,33,0,7,0,39,0
Why NBA Stans Need To Stop Slandering College Basketball,0,2,11,37,0,8,0,48,0
Police identify student they say fatally stabbed USC professor ,0,3,4,50,0,9,0,54,0
A Reminder That ’00s Ryan Gosling Was Truly Iconic,0,3,8,31,1,8,2,39,0
Pentagon Finds It Has No Records Approving Mike Flynn’s Russian-TV Pay,0,3,13,45,2,10,0,58,0
Samsung made a ton of cash even though its flagship phones were a fiery disaster,0,2,1,65,0,14,0,66,0
2 Countries Agree to Ease Bank Secrecy Rules,0,1,6,30,0,7,1,36,0
Visa crackdown puts these rural doctors at risk,0,2,1,39,0,7,0,40,0
Ghost in the Shell: Studio admits whitewashing controversy hurt film at the box office,0,2,3,69,1,13,0,72,0
Emmanuel Macron Steps Into France’s Political Void ,0,3,7,36,1,7,0,43,0
Taliban Seize Vital Pakistan Area Closer to the Capital,0,1,7,40,0,8,0,47,0
Scouting Reports for Riley Curry and the All-NBA Kid Team,0,3,10,37,1,9,0,47,0
Massive sand trucks added to NYC's New Year's Eve security plans,0,2,7,45,2,10,0,52,0
23 Movies You Probably Didn't Know Were Based On Books,0,3,9,33,1,9,2,42,0
"Queen Elizabeth has been in power so long, 4 out of 5 UK residents weren't alive when she ascended the throne",0,3,4,81,2,20,2,85,0
Poisoned liquor kills 17 in Kenyan slum,0,1,2,29,0,6,2,31,0
Big 12 Powers Oklahoma and Baylor Roll,0,1,5,25,0,6,2,30,0
Former U.S. governor Palin signs TV deal with Fox News,0,1,8,35,2,9,0,43,0
Illinois budget cuts to close historic sites and parks,0,1,1,45,0,8,0,46,0
"Obama’s High School Basketball Coaches, Teammates Remember ‘Barry’",0,3,8,47,4,7,0,55,0
London nightclub acid attack leaves woman blind in one eye,0,3,1,48,0,9,0,49,0
Some Poor Venezuelan Parents Give Away Children Amid Deep Crisis,0,3,10,45,0,9,0,55,0
Alejandro Sanz to Celebrate 'Mas' Album Anniversary With Special Concert,0,2,9,52,2,9,0,61,0
Boy Scouts of America welcomes first transgender member,0,3,3,45,0,7,0,48,0
McDonald Named Chief Executive at Procter & Gamble,0,1,7,35,1,7,0,42,0
How to Watch the 2017 Grammy Awards,0,3,4,21,0,6,4,25,0
Trump says Air Force One Boeing order should be cancelled,0,3,5,43,0,9,0,48,0
"J.K. Just Maybe, Possibly, Probably Called Trump A ""Populist Maniac""",0,3,11,42,6,9,0,53,0
Alma Cocina Latina review: A Venezuelan stunner beckons in Baltimore,0,2,6,52,1,9,0,58,0
The People’s Burger?,0,2,3,13,2,2,0,16,0
"A $750,000 insurance policy, a dead infant and a 15-year-old case",0,2,1,41,5,10,8,42,0
"Dial-a-Mattress, in Bankruptcy, Will Sell to Rival",0,1,6,34,4,6,0,40,0
Malaysia Charges Two Women for Murder of Kim Jong Nam,0,3,8,36,0,9,0,44,0
"Simone Biles, Mr. T To Compete In Next Season Of 'Dancing With The Stars'",0,3,14,42,4,13,0,56,0
Brian Westbrook Responds to Drew Pearson at Start of Day 3 of 2017 NFL Draft,0,2,11,46,0,14,5,57,0
Google has an idea for a goofy hat with a camera on the brim that works like Snap's Spectacles,0,3,3,72,1,18,0,75,0
NFL Combine 2017: B/R Expert Predictions for Each Day,0,3,10,29,2,8,4,39,0
Stephen Curry needs to resemble the league MVP before it's too late,0,3,5,50,1,11,0,55,0
Gas leak kills six and injures 28 at Chinese fertiliser factory,0,1,2,49,0,10,2,51,0
Sad YouTuber finds a way to express her sorrow over her VR-distracted boyfriend,0,3,5,61,1,12,0,66,0
Sleeping Passenger Awakens to Exploding Headphones During Flight,0,3,7,50,0,7,0,57,0
Mayors back global warming pact,0,1,1,26,0,4,0,27,0
Unexpected places to find the American flag,0,2,2,35,0,6,0,37,0
Donald Trump's inauguration speech in full - read and watch,0,3,2,46,2,9,0,48,0
Trump nominees take aim at Russia at confirmation hearings,0,2,2,48,0,8,0,50,0
Sri Lanka Bars Swede Over Stand on War,0,1,7,24,0,7,0,31,0
Nestlé Is Cutting Almost Half the Sugar in Your Chocolate,0,3,8,40,0,9,0,48,0
Muslim Women in Hijab Break Barriers: ‘Take the Good With the Bad’ ,0,2,9,43,3,12,0,52,0
"Why Remy Ma's ""ShETHER"" Is One Of The Most Savage Diss Tracks Ever",0,3,18,33,3,12,0,51,0
Trump Resurrects Put-Down Nicknames With ‘Fake Tears’ Schumer,0,3,9,42,3,7,0,51,0
"Hillary Clinton on Trump: ‘As an American, I’m pretty worried’",0,3,6,42,5,9,0,48,0
"Heavy earthquake hits Sumatra, Indonesia",0,1,3,32,1,4,0,35,0
Obama budget calls for record US deficit,0,1,3,31,0,6,0,34,0
Usain Bolt sets new world record in 100m sprint,0,1,2,34,0,8,3,36,0
Beyoncé Just Announced She’s Pregnant With Twins,0,3,7,34,1,6,0,41,0
"Stocks Fall, Rattled by Trump Saying Dollar Getting ‘Too Strong’",0,3,9,43,3,9,0,52,0
"Take that, dudes: Female astronaut breaks record for most time spent in space.",0,3,2,61,3,12,0,63,0
London attack: Theresa May evacuated from Westminster,0,3,4,42,1,6,0,46,0
The gruelling life of a Kurdish smuggler,0,3,2,32,0,6,0,34,0
Princess Kiko gives birth to imperial baby boy,0,1,2,37,0,7,0,39,0
"Rare pennies in circulation could be worth $85,000 ",0,3,1,35,2,8,5,36,0
Three High School Football Players Charged With False Imprisonment In Hazing Case,0,2,12,58,0,11,0,70,0
Samantha Bee 'Fixed' Bill O'Reilly's Fox News Exit Statement,0,3,10,38,4,8,0,48,0
EU budget chief claims win in Lithuanian presidential elections,0,1,3,52,0,8,0,55,0
"Lady Gaga at the Super Bowl: No Controversy, Lots of Glitter ",0,2,8,40,2,11,0,48,0
"Prison Worker May Have Provided Contraband to Escapees, District Attorney  Says",0,3,10,57,1,11,0,67,0
Rebecca Minnock: grandmother of missing child is jailed - live,0,2,2,49,2,9,0,51,0
Stephen Colbert Visits 'Billy On The Street' To Pop The Liberal 'New York Bubble',0,3,14,50,4,13,0,64,0
Libya frees foreign HIV medics,0,1,4,22,0,4,0,26,0
Deadly car bomb attack hits rural Aleppo ,0,3,2,32,0,7,0,34,0
Ben Affleck Refuses to Play Batman Again If the Script Is 'Not Good Enough',0,3,12,48,2,13,0,60,0
"Andrew Sachs, the much loved Fawlty Towers actor, dies aged 86",0,2,4,44,2,10,2,48,0
"Foes Rally, but President of Georgia Vows to Stay",0,1,6,34,1,8,0,40,0
President Barack Obama Delivers Farewell Address: Watch Here,0,2,8,44,1,7,0,52,0
Frances’ Juppe sets battle lines with ’brutal’ Fillon before primary runoff,0,2,3,59,3,10,0,62,0
"Distrust. Dysfunction. Disappointment. Yes, These Are Your Chicago Bulls",0,2,9,51,4,8,0,60,0
HIV vaccine trial ready to roll in Thailand,0,1,4,32,0,7,0,36,0
"Here's what Elon Musk, Richard Branson, and 29 other successful people ask job candidates during interviews",0,3,5,82,3,15,2,87,0
"Ships Tread Water, Waiting for Cargo",0,1,5,25,1,5,0,30,0
"In Book, Radomski Talks About Dealing Drugs and Dealing With Mitchell",0,1,10,48,1,10,0,58,0
NASA's journey to Mars aided by University of Canberra researchers,0,2,7,49,1,9,0,56,0
London killer's final hours ,0,3,1,22,1,4,0,23,0
Prepare for the Super Bowl with NFL stars reading mean tweets about themselves,0,3,6,60,0,12,0,66,0
Credibility of Congress' Russia probes still in question ,0,3,3,45,1,8,0,48,0
Ally Brooke Hernandez Drops Hints About Fifth Harmony's New Album,0,2,10,45,1,9,0,55,0
"Jayant ""Dr Death"" Patel arrested in Oregon, US",0,1,7,29,3,7,0,36,0
Mike Wiley’s Recipe for Olive Oil-Poached Cod With Cauliflower Couscous,0,2,10,50,2,9,0,60,0
Rossi won't continue with legal appeals over failed bid for Washington State Governorship,0,1,4,72,1,12,0,76,0
"75 years ago, what if Japan never attacked Pearl Harbor?",0,3,3,40,2,9,2,43,0
"At PwC trial, Corzine defends bet that led to MF Global demise",0,2,7,43,1,11,0,50,0
"One killed, many boats damaged in storms on Spanish island of Majorca",0,1,3,54,1,11,0,57,0
Trump threatens to defund Berkeley after violent protests force cancellation of Breitbart editor’s speech,0,3,3,88,1,13,0,91,0
"Brave Marathoner With Brain Cancer, Known for Running in a Tutu, Dies",0,3,9,47,2,11,0,56,0
Wear and Tear by Tracy Tynan review – trapped in a parental horror film,0,3,4,53,1,13,0,57,0
J.K. Rowling fights back as Donald Trump reinstates anti-abortion policy,0,3,5,55,3,9,0,60,0
Saginaw Spirit victorious in first home shootout,0,1,2,40,0,6,0,42,0
‘Charging Bull’ Sculptor Says ‘Fearless Girl’ Violates His Rights,0,3,9,44,4,8,0,53,0
"People Are Losing It Over This Guy's Massive ""Wheel Of Fortune"" Fuckup",0,3,12,44,3,11,0,56,0
Daredevil tourists are arrested after scaling a 420ft tall rock pillar at a UNESCO World Heritage site,0,3,9,74,0,16,3,83,0
India's Jagadish Chandra Bose Is The Reason Why The World Will Enjoy Super Fast 5G Internet,0,2,16,58,1,15,1,74,0
"Over 100 killed, wounded in Taliban attack on Afghan military base",0,3,3,49,1,10,3,52,0
All hail Adelaide: How the Australian city became 'the new Portland',0,3,5,50,3,10,0,55,0
Iraqi official:  At least 6 people killed in Baghdad suicide bombing ,0,3,3,52,1,12,1,55,0
"To Save the Whales, You Must First Save the Sardines",0,3,8,34,1,9,0,42,0
Teaching Teenagers About Harassment,0,1,4,28,0,3,0,32,0
Guillermo from 'Jimmy Kimmel Live!' Asks Silly Questions at Super Bowl Media Day,0,2,11,54,3,12,0,65,0
HARLEY-DAVIDSON: Motorcycle shipments tumbled,0,3,15,25,2,3,0,40,0
Jeremy Corbyn's spin doctor Seumas Milne quits Guardian to work for Labour full-time,0,3,6,64,2,12,0,70,0
Recording Academy Calls on Trump to Support Copyright Reform in New Letter,0,3,9,54,0,11,0,63,0
Wooden Watch: Everyone is chasing Villanova's Josh Hart,0,2,6,40,2,7,0,46,0
London mayor race 2016: Labour announce shortlisted six,0,3,2,41,1,7,4,43,0
Marcus Foster's Redemption: Creighton Star Thriving After Kansas State Flameout,0,2,10,58,2,9,0,68,0
Xstrata and Anglo American in Merger Talks,0,1,5,31,0,6,0,36,0
Nancy Reagan Dead at 94 - Breitbart,0,2,4,22,1,6,2,26,0
Missing teens in D.C.: Cases highlight dangers for runaways,0,3,4,44,3,8,0,48,0
California Asks Removal of Prison Overseer,0,1,5,32,0,5,0,37,0
"Lobby of Trump Tower Evacuated Over Suspicious Bag, Later Deemed Safe",0,2,10,48,1,10,0,58,0
Carrie Fisher talks about the aftermath of her affair with Harrison Ford,0,3,4,57,0,11,0,61,0
"Even though he bashes anonymous sources, Trump uses them himself ",0,3,2,52,1,10,0,54,0
"Deutsche Borse, LSE to Further Address Antitrust Concerns ",0,2,9,40,1,8,0,49,0
UN creates rapid-response fund for disasters,0,1,2,36,1,5,0,38,0
"Golden Globes: Meryl Streep, Jimmy Fallon, Hugh Laurie take on Donald Trump",0,3,10,51,3,11,0,61,0
"DELIBERATE BUT ‘NOT TERROR’: 3 dead, at least 20 injured after car plows into crowd in Melbourne  ",0,3,23,50,4,18,3,73,0
"Half of the world's species could become extinct, biologists say",0,2,1,52,2,9,0,53,0
"With Their Elevated Homicide Rates, Four Cities Stand Out ",0,2,9,39,1,9,0,48,0
"Samsung, Facing Calls for a Shake-Up, Offers ‘Plan B’",0,3,8,32,5,8,0,40,0
"CBSE Announces New Exam Format For Its Schools, Class X Board Exams Will Return in 2018",0,2,17,50,1,15,4,67,0
Quick searing knife toasts bread as you slice it ,0,2,1,39,0,9,0,40,0
Davos 2017: Business leaders prepare to temper Trump,0,3,3,37,1,7,4,40,0
How Many 'Signature Moments' Does Russell Westbrook Need to Convince Us He's the NBA MVP?,0,3,17,54,4,14,0,71,0
"Sean McDermott to Bills: Latest Contract Details, Comments and Reaction",0,3,9,51,2,9,0,60,0
Suspect charged in murder of Lauren Burk,0,1,3,31,0,6,0,34,0
Lifeline and Tracfone Provide Cellphones for the Needy,0,1,5,42,0,7,0,47,0
"Investors Ignore Business Plans, Study Finds",0,1,6,32,1,5,0,38,0
Trump as president is unthinkable. That’s why so many find it fascinating.,0,2,2,58,3,11,0,60,0
Sectarian Politics in Iraq Stall Efforts to Govern in the Provinces,0,1,7,50,0,10,0,57,0
US Army to court martial soldier over three Afghan murders,0,1,4,45,0,9,0,49,0
Haunted attractions in Texas prepare for 2013 Halloween season,0,1,3,47,0,8,4,50,0
South Carolina Man Killed by Police Was Shot 17 Times in Back: Lawsuit,0,3,10,45,1,12,2,55,0
"UBS Profit Surges, Beats Forecasts on Wealth-Management Gains",0,3,10,42,2,7,0,52,0
'Sesame Street' Mocked Trump For Decades Before He Went After PBS,0,3,13,40,2,10,0,53,0
Economists to Trump: Paying for the Wall Is the Least of Your Worries,0,3,8,48,1,12,0,56,0
US says China will return underwater drone; Trump slams Beijing,0,3,5,48,1,9,0,53,0
Condoleezza Rice in Iraq for surprise visit,0,1,3,34,0,6,0,37,0
Philip Davies MP criticised after speaking for over an hour in 'bid to block' domestic violence bill,0,3,4,78,2,16,0,82,0
"Golf adds 'The Dustin Johnson Rule,' eliminates penalty for accidentally causing ball to move on the green",0,3,5,82,3,16,0,87,0
The week in politics,0,2,1,16,0,3,0,17,0
Lloyds Chairman Victor Blank to Step Down,0,1,6,29,0,6,0,35,0
Former Governor Enters Debate on A.I.G.,0,1,7,24,3,5,0,31,0
"BREAKING NEWS: Envelope bomb explodes at IMF office in Paris, injuring one person ",0,2,17,50,2,13,0,67,0
Hiding Hillary Day 260: Hillary Fundraises with Cher - Breitbart,0,2,7,43,2,9,3,50,0
Mysterious illness tied to marijuana use on the rise in states with legal weed,0,3,1,64,0,13,0,65,0
British haulage managing director Edward Stobart dies at age 56,0,1,3,49,0,9,2,52,0
"New York commuter train derails in Brooklyn at rush hour, injuring dozens",0,3,3,58,1,11,0,61,0
Trump threatens ‘consequences’ for U.S. firms that relocate offshore,0,3,3,53,4,8,0,56,0
"Trump Names Picks For National Security Adviser, Attorney General, CIA Director",0,2,13,54,2,10,0,67,0
AL West Rivals Mariners and A's Trade Shots in Spring Training Twitter Battle,0,3,12,52,1,12,0,64,0
Victorian police fear death toll could rise in Melbourne car attack,0,2,2,55,0,10,0,57,0
"Australian government to review censorship of ""hate material""",0,1,1,51,2,7,0,52,0
Here's how Rep. Lewis responded to Trump without saying his name,0,3,4,48,2,10,0,52,0
"Newspaper fail lauds Pat Venditte, 'amphibious' MLB pitcher",0,3,6,43,3,7,0,49,0
Theresa May scraps rule allowing ministers to pick private office staff,0,3,2,59,0,10,0,61,0
BT reaches deal with Ofcom to legally separate Openreach,0,3,4,44,0,8,0,48,0
"Cats Don’t Cause Mental Illness, Study Finds",0,2,7,29,2,6,0,36,0
How Russian oil giant Rosneft could claim U.S. oil,0,2,5,35,2,8,0,40,0
"Mike Pence on Donald Trump's Twitter use, record-low approval rating",0,3,5,51,3,9,0,56,0
"Somali piracy: Kenyan navy kills three, Chinese ship hijacked, British couple freed",0,1,4,65,3,11,0,69,0
Toyota Moves Ahead of G.M. in 2008 Sales,0,1,6,21,2,7,4,27,0
Heikki Kovalainen wins 2008 Hungarian Grand Prix,0,1,5,33,0,6,4,38,0
The DeMarcus Cousins Trade Could Be a Big Deal—for the Warriors ,0,2,10,42,1,11,0,52,0
"Jebreen, Extremist Saudi Cleric, Was Treated in Germany",0,1,7,39,2,7,0,46,0
Why you REALLY should exercise: Interactive body map reveals the true risks of being lazy,0,3,8,66,1,14,0,74,0
I use my iPhone to hide that I’m homeless,0,2,3,29,1,8,0,32,0
"1 in 10 pregnant women with Zika had a fetus or infant with birth defects, CDC says ",0,2,4,59,1,17,3,63,0
Departments to Toughen Standards for Mining,0,1,4,34,0,5,0,38,0
TV Paparazzi Turn Cameras to Corporate Titans,0,1,7,32,0,6,0,39,0
Duke Guard Grayson Allen Comes Close to Tripping Boston College Defender,0,2,10,52,0,10,0,62,0
35 Expelled Russian Diplomats and Families Arrive Back in Moscow,0,3,7,46,0,9,2,53,0
Gangs Said to Contact Politicians,0,1,4,25,0,4,0,29,0
2 Univ. of Louisville Football Players Shot at Party Celebrating Lamar Jackson's Heisman Trophy Win ,0,3,12,70,2,15,1,82,0
Trump Promised to ‘Open the Mines’ — Here’s Why That Is Unlikely,0,2,9,40,4,11,0,49,0
IPhone sales exceed BlackBerry,0,1,4,23,0,3,0,27,0
The scary moment a car carrying backpackers' stuff falls off ferry and drifts out to sea,0,2,1,71,1,15,0,72,0
Cyclone Kills Nearly 200 in Bangladesh and India,0,1,5,33,0,7,3,38,0
Hundreds Protest Cuts in Water in California,0,1,5,33,0,6,0,38,0
Poll: 49% of Americans agree with Trump's immigration ban,0,3,3,41,3,8,2,44,0
Wild 3-pointer at the buzzer gives Florida victory over Wisconsin,0,3,3,51,1,9,1,54,0
"A Customized Ski Holiday in the Dolomites, Italian-Style",0,3,7,40,2,7,0,47,0
Drug-resistant superbug may be more widespread than previously known,0,2,1,58,1,8,0,59,0
"6 Fun, Little Stories About The NBA, According To The League's Most Legendary Photographer",0,3,15,58,3,13,1,73,0
Clapper: ’Our Institutions Are Under Assault’ By President Trump - Breitbart,0,2,10,52,4,10,0,62,0
US Hiring Accelerates and More People Begin Looking for Work ,0,3,9,42,0,10,0,51,0
Second man arrested over death of ex-navy officer Mike Samwell,0,2,3,49,1,9,0,52,0
Snap has enough demand to push its IPO valuation as high as $25 billion,0,3,4,51,1,13,2,55,0
"Knight, Swift Transportation Merge To Create $5 Billion Trucking Giant",0,3,9,49,2,9,1,58,0
"Brady Shows Off, and Shows Some Rust, for the Cameras",0,1,7,35,2,9,0,42,0
"Roger Waters Posts New Tease of First Solo Rock Album in 25 Years, 'Is This the Life We Really Want?'",0,2,16,60,4,19,2,76,0
Delays at Manchester airport after van blazes in tunnel under runway,0,3,2,56,0,10,0,58,0
Conservatives flock to CPAC to chart agenda under Trump ,0,2,6,41,0,9,0,47,0
Manafort: GOP Presidential Nominating Process a ’System of the 1920s - Not 2016’ - Breitbart,0,2,10,55,5,14,8,65,0
Syria conflict: Rebels begin evacuating Homs enclave of al-Wair,0,3,4,49,2,8,0,53,0
Korean Peninsula on the 'brink of war': DPRK,0,1,6,28,3,7,0,34,0
"The Last Stand: Hillary Plans Closing Rally in Philadelphia with Bill, Chelsea, Barack And Michelle - Breitbart",0,2,14,77,4,16,0,91,0
NBC NewsVerifizierter Account,0,2,6,21,0,2,0,27,0
Erin Moran's Neighbors Say She Was 'Full of Energy' Before She Died in Her Mother-in-Law's Trailer,0,2,15,62,6,15,0,77,0
Cyclone Debbie: Brisbane drenched as system moves through south-east Queensland,0,3,4,64,2,9,0,68,0
"Bill O’Reilly Thrives at Fox News, Even as Harassment Settlements Add Up ",0,3,11,48,2,12,0,59,0
‘Cash Me Ousside’ Girl in Kodak Black’s New Video,0,3,8,30,3,8,0,38,0
Prospects for a space elevator rise,0,1,1,29,0,5,0,30,0
Russia launches most powerful nuclear attack submarine yet,0,3,1,50,0,7,0,51,0
More than 20 US airstrikes conducted in Yemen overnight ,0,2,4,41,0,9,2,45,0
A porn site decided to step in when this State voted against sex education The list,0,2,3,65,0,15,0,68,0
Donald Trump met Russian ambassador Sergey Kislyak during election campaign,0,3,5,61,0,9,0,66,0
"Nick Young Explains His Recent Hot Shooting: ""It's the Draco Soulja Effect""",0,2,11,49,4,11,0,60,0
Le Mans 24-hour race now has technology and spectacle in balance,0,2,2,49,1,10,2,51,0
The incompetence displayed by Trump’s immigration orders will be terrifying in a crisis,0,2,2,72,1,12,0,74,0
Colombia landslide: Farc rebels offer to help rebuild town,0,3,2,47,1,8,0,49,0
Canadian merchant Ed Mirvish Dies at 92,0,1,4,27,0,6,2,31,0
Nick Kyrgios courts more controversy with abusive Donald Trump T-shirt,0,3,5,55,1,9,0,60,0
Serbia and Montenegro military announces mandatory service shortening,0,1,2,60,0,7,0,62,0
"Starbucks Plans to Hire 10,000 Refugees After Trump Action",0,3,7,37,1,8,5,44,0
Pepsi Pulls Controversial Kendall Jenner Ad After Outcry,0,3,8,41,0,7,0,49,0
"Five-year-old girl dies after car crashes into river in Worcestershire, England",0,1,3,63,3,10,0,66,0
Americans Are Dying With an Average of $62K of Debt,0,3,7,32,1,9,2,39,0
Forget the Cigarette Lighter Adapter. Now You Can Dock Your iPod in the Car Radio.,0,1,12,54,2,14,0,66,0
"NHS staff most stressed public sector workers, survey finds",0,2,3,47,1,8,0,50,0
Heavy Rains Flood Desert Capital of Peru,0,3,6,28,0,6,0,34,0
Former 'American Idol' Contestant Cries Over Being Called 'White Boy',0,3,10,46,4,9,0,56,0
Losses Widen for American and United Airlines,0,1,5,34,0,6,0,39,0
Dylann Roof Found Guilty in Charleston Church Massacre - The New York Times,0,2,11,51,1,12,0,62,0
Train in deadly 2015 Amtrak derailment had safety equipment that could have prevented it,0,2,2,69,0,13,4,71,0
Florida schools begin to enforce new statewide ban on saggy pants and other revealing attire,0,1,1,77,0,14,0,78,0
Government backs driverless car trials in London,0,3,2,40,0,6,0,42,0
British man's attempt to swim across Atlantic slowed by sharks and jellyfish,0,3,2,62,1,11,0,64,0
Michigan student and California engineer sue Amazon for remote deletion of 'Nineteen Eighty-Four',0,1,6,76,3,12,0,82,0
"Facebook removed a line about monitoring 'private channels' from Mark Zuckerberg's 6,000-word company manifesto",0,2,3,86,5,13,4,89,0
Ivanka Trump's perfume is a big winner on Amazon,0,3,3,36,1,8,0,39,0
U.S.-China Military Talks Resume,0,1,6,20,3,3,0,26,0
18 Tumblr Posts For Those Who Need Their Faith In Humanity Restored,0,3,11,43,0,11,2,54,0
Harvard Law School gives its highest honour to Pakistani judge,0,1,4,49,0,9,0,53,0
Theresa May said 'strong' 28 times and 'stable' 15 times in 13 minutes The list,0,3,3,52,4,14,6,55,0
"Israel Opens the Gaza Border for 25,000 Carnations, Bound for Europe",0,1,7,44,2,10,5,51,0
Illinois State Wins National Signing Day by Adding Kobe Buffalomeat to Program,0,3,10,57,0,11,0,67,0
Richard Sherman Blasts the NFL (Again) for Forcing Players to Play in Thursday Night Games,0,3,13,61,2,14,0,74,0
Saudi Arabia Wants to Take Its Biggest and Best Companies Global,0,3,9,45,0,10,0,54,0
Copy of handbook for leaders of the Church of Jesus Christ of Latter-day Saints obtained by Wikinews,0,1,7,76,1,16,0,83,0
Donald Trump's Supreme Court Pick Came Of Age In A Very Different Republican Party,0,3,14,54,1,13,0,68,0
"In Nepal, one daughter’s search for her mother",0,2,2,35,2,7,0,37,0
"McKinney, Texas, Cop Placed on Leave After Pulling Gun on Teens at Pool Party",0,2,12,50,2,13,0,62,0
Loose bulls charging through Arizona neighborhood caught on video ,0,2,2,55,0,9,0,57,0
"After reports of civilian slaughter, Syrian rebels say Aleppo cease-fire reached",0,2,3,65,2,10,0,68,0
"To Avoid Layoffs, Some Companies Turn to Work-Sharing",0,1,8,36,2,7,0,44,0
"Celebrities Should Shut Up About Politics, Says Mark Wahlberg",0,3,9,43,1,8,0,52,0
Trump Voter Shocked To Find That Her Meals On Wheels Could Be Cut,0,3,13,40,0,12,0,53,0
Mattis says he's 'grateful' to be nominated as defense secretary; House GOP introduces waiver language ,0,3,5,79,4,15,0,84,0
Donald Trump: ‘Perhaps’ Both Angela Merkel and I Were Wiretapped by Obama Administration - Breitbart,0,2,12,70,4,14,0,82,0
Economic opportunities for women still lagging: World Bank and OECD,0,1,7,50,1,9,0,57,0
"After Rampage, a Hush Returns, Filled With Pain",0,1,7,31,2,7,0,38,0
SEC Rejects Bitcoin ETFs: Should You Reject Bitcoin Investments?,0,3,13,41,2,8,0,54,0
Former President George H.W. Bush Hospitalized for ‘Mild Case of Pneumonia’,0,3,10,51,4,10,0,61,0
Pakistan's Musharraf announces resignation,0,1,2,36,1,3,0,38,0
CanadaVOTES: NDP candidate David Sparrow in Don Valley West,0,1,14,36,1,8,0,50,0
Bat hibernation: Scottish quest to solve puzzle – in pictures,0,2,2,48,2,9,0,50,0
"Poll: Arabs discouraged by US policies, back nuclear-armed Iran",0,1,5,47,3,8,0,52,0
"Botched drug trial leaves one person brain dead, five others hospitalized in France",0,2,2,68,1,12,0,70,0
Explosion at Yemen weapons factory kills dozens,0,1,2,39,0,6,0,41,0
How Centrelink debt letters are harming Australians' mental health,0,3,3,54,1,8,0,57,0
"The Quail is the ultimate candy shop, if your candy is cars",0,2,2,45,1,11,0,47,0
Anthony Crolla shows heart but loses on points to Venezuelan Jorge Linares,0,3,5,58,0,11,0,63,0
Super Mario Run is coming to Android devices,0,3,4,33,0,7,0,37,0
Missing European divers found alive,0,1,2,29,0,4,0,31,0
What does it mean to be British in 2017? – join our live look at the week,0,3,2,49,2,16,4,51,0
Pettitte Maintains Composure in Victory,0,1,4,31,0,4,0,35,0
"Still Working, but Making Do With Less",0,1,6,25,1,6,0,31,0
"Restored warplanes flown in Hamilton, Canada",0,1,3,35,1,5,0,38,0
Coachella Secondary Prices Tick Up After Midweek Slump,0,2,8,39,0,7,0,47,0
UN Security Council votes to extend Ivory Coast sanctions,0,1,6,43,0,8,0,49,0
"Bill Paxton, actor in 'Twister' and 'Aliens,' dies at 61",0,2,4,35,6,9,2,39,0
The Chainsmokers Teamed With Sony For First 'Lost In Music' VR Festival Experience,0,2,14,54,2,12,0,68,0
Student Charged With Hazing in Peanut Butter Allergy Case ,0,2,8,41,0,9,0,49,0
Iraqi Airways drops flights to United Kingdom and Sweden,0,1,5,43,0,8,0,48,0
Texas officer lets teen do 200 pushups to avoid pot citation,0,3,1,46,0,10,3,47,0
Walsh: ‘Inner City Diverse Populations’ Prevent Universal Health Care (VIDEO),0,2,14,49,5,9,0,63,0
Singer Joy Villa Wears ‘Make America Great Again’ Dress at 2017 Grammy Awards,0,2,11,48,2,12,4,59,0
"Doctor says: When it comes to breastfeeding, your health and happiness matter as much as your baby’s",0,2,2,79,3,16,0,81,0
A region in Italy wants to ban veiled women from being treated at hospitals,0,2,2,60,0,13,0,62,0
Trump Deepens Goldman Ties as He Builds out Economic Team ,0,3,8,40,0,10,0,48,0
2 Auditors Held in India Fault System,0,1,5,25,0,6,1,30,0
This Young Girl Met The Queen Then Got Smacked In The Face By A Soldier,0,2,15,42,0,14,0,57,0
First Make-In-India Artillery Gun Will Be Showcased At Republic Day Parade This Year,0,2,15,55,2,12,0,70,0
Iraq gunmen kidnap campaigning female journalist,0,3,1,42,0,5,0,43,0
Here's Trump's record on the middle class,0,2,2,31,2,6,0,33,0
Winter Weather May Be a Bummer for Jolly Holiday Travelers,0,3,8,41,0,9,0,49,0
Transition Holds Clues to How Obama Will Govern,0,1,7,33,0,7,0,40,0
Instant Awesome: Steph Curry reconnects with young fan Brody after visiting him at the hospital,0,2,5,75,1,14,0,80,0
Two winners confirmed in US 'Mega Millions' jackpot,0,1,5,37,2,7,0,42,0
"Shashi Tharoor Compares Winston Churchill To Hitler, Says He Was Responsible For The Bengal Famine",0,3,15,68,1,14,0,83,0
Home Price Index Fell Again in November,0,1,6,27,0,6,0,33,0
Scientists find key human language gene,0,1,1,33,0,5,0,34,0
Moscow 30 under 30: the people’s power list,0,2,1,29,2,7,4,30,0
Spanish Singer Bimba Bose Dies at 41,0,3,5,23,0,6,2,28,0
Beyonce's 'Daddy Lessons' Rejected by Grammy Country Committee,0,3,7,45,3,7,0,52,0
Redditors Gleefully Spoof Donald Trump’s Awkward Photo-Op With Angela Merkel,0,2,11,54,2,9,0,65,0
"Rape in India, Four Years After Delhi Gang Rape Case – The Numbers ",0,3,11,41,2,13,0,52,0
Jake Butt to collect on loss-of-value policy following torn ACL,0,3,5,47,2,9,0,52,0
Kipp Stone Praises His Favorite Superhero on '100 Black Panthers': Exclusive Premiere,0,3,10,58,3,11,3,68,0
U.S. Overtures Find Support Among Cuban-Americans,0,1,8,33,3,5,0,41,0
"Planes, trains, cars, buses - What's best for the earth?",0,3,2,39,6,9,0,41,0
Brazil's president moves out of official residence because of 'ghosts',0,3,1,57,3,9,0,58,0
Australia grants temporary asylum to 12 Commonwealth Games athletes,0,1,3,54,0,8,2,57,0
Bomb hurt seven police in Basque city of Bilbao,0,1,3,36,0,8,0,39,0
Here Are Some Of The Amusing Confessions That PC Will Make In Her Solo Koffee With Karan Stint!,0,3,19,58,1,17,0,77,0
"GOP to expand school choice, target unions in states",0,2,3,40,1,8,0,43,0
Could veterans have concussion-related CTE?,0,2,4,33,2,4,0,37,0
Disabled Goldfish Gets Its Own Wheelchair And The Internet Cheers,0,3,10,46,0,9,0,56,0
"Teachers given projects based on racist stereotypes, study finds",0,3,1,54,1,8,0,55,0
Researchers Think They're Getting Closer to Making Spray-On Solar Cells a Reality,0,3,11,57,2,11,0,68,0
Two Britons killed in British consulate convoy attack in Basra,0,1,4,49,0,9,0,53,0
Union paying Southern Rail conductors £300 a week to strike,0,3,3,43,1,9,3,46,0
Madonna Mocks Kendall Jenner Pepsi Ad Fiasco By Recalling Her Own Cola Controversy,0,3,13,57,0,12,0,70,0
Louisville Men Build Reputation on Pressure Defense,0,1,6,39,0,6,0,45,0
Guatemalan president and first lady granted divorce,0,1,1,44,0,6,0,45,0
The 44 Presidents of the United States who came before Donald Trump,0,3,6,48,0,11,2,54,0
Praying and drinking urine save nuns stuck in a Rome elevator for three days,0,2,2,61,0,13,0,63,0
Formula One's Most Valuable Teams,0,3,5,23,1,4,0,28,0
'Life threatening' winter storm bears down on Northeast ,0,3,2,44,2,8,0,46,0
Nintendo is discontinuing the NES Classic,0,3,5,31,0,5,0,36,0
Sears Tower Is Going Green,0,1,5,17,0,4,0,22,0
Survivors of High-Seas Drama Return to France,0,1,6,32,1,6,0,38,0
'Bad Dog!': Huckabee Slams Rapper Bow Wow for Tweet Targeting Melania Trump  Insider,0,3,12,55,4,13,0,67,0
"RuPaul secretly got married, so now envision history's greatest wedding",0,3,2,58,2,9,0,60,0
"Greece on fire, death toll exceeds 60",0,1,1,27,1,6,2,28,0
Trump's America Trump revokes guidelines on transgender bathrooms in schools,0,3,3,63,1,9,0,66,0
Review: ‘Rogue One’ Leaves ‘Star Wars’ Fans Wanting More and Less - The New York Times,0,2,14,51,6,15,0,65,0
Zimbabwe bans the beating of children,0,3,1,31,0,5,0,32,0
"J.J. Watt Surprises 8-Year-Old Fan in the Hospital with Visit, Jersey",0,3,10,43,5,10,1,53,0
Discrimination Lawsuit Alleges Black Fox News Employees Were Forced to Arm Wrestle White Co-Workers,0,3,14,71,1,13,0,85,0
U.S. Scrambles for Information on Iran,0,1,5,26,2,5,0,31,0
"A tragic end for Rashaan Salaam, Heisman Trophy winner and former college football star",0,2,5,68,1,13,0,73,0
Elizabeth Warren: ’nasty women’ will defeat Trump on election day,0,2,3,50,3,9,0,53,0
Police break up 'fully-fledged rave' on London Underground,0,2,3,45,3,7,0,48,0
Chelsea Clinton joins Expedia board of directors ,0,2,3,39,0,7,0,42,0
Mortar exchange kills thirteen in Somali capital,0,1,2,40,0,6,0,42,0
Outcry Erupts Over Reports That Israel Used Phosphorus Arms on Gazans,0,1,10,49,0,10,0,59,0
Dems force vote delay on key Trump Cabinet picks ,0,3,3,37,0,9,0,40,0
High school basketball star dies after making game-winning shot in overtime,0,1,1,63,1,10,0,64,0
David Pogue tested 40 Bluetooth earbuds to find the best of the best,0,3,3,51,0,12,2,54,0
Nigel Farage to host new nightly LBC radio show,0,2,5,34,0,8,0,39,0
Breast cancer drug rejected for NHS use on cost-benefit grounds,0,2,4,49,1,9,0,53,0
EU Sanctions Hawk Says Russia Stance Wouldn’t Budge on U.S. Thaw,0,2,12,39,3,10,0,51,0
"Bitcoin jumps above $1,000 for first time in three years",0,2,1,40,2,9,4,41,0
Chinese Officials Protest Sinking of Cargo Ship by Russians,0,1,7,44,0,8,0,51,0
Blake Griffin Explains the Lyrics to Fetty Wap's 'Trap Queen',0,3,8,41,3,9,0,49,0
Paul George Comments on Referees' Treatment of Pacers,0,3,6,39,1,7,0,45,0
Ohio State Buckeyes QB Cardale Jones living the dream this summer - Big Ten Blog- ESPN,0,2,14,55,2,15,0,69,0
Price Transparency Is Nice. Just Don’t Expect It to Cut Health Costs. ,0,2,11,44,3,12,0,55,0
"In First Start, Burnett Shows What Makes Yankees Different",0,1,9,40,1,8,0,49,0
Steelers RB Le'Veon Bell Debuts 1st Hip-Hop Music Video for 'Machine',0,3,12,42,4,10,1,54,0
"Trump Decries Civil Rights Icon John Lewis as ‘No Action,’ Sparking Backlash",0,3,11,51,3,11,0,62,0
Suicide rates are rising faster outside U.S. cities,0,3,3,39,2,7,0,42,0
"The Cat Is Finally Out Of The Bag, Shraddha Disses Rumours Of Her Relationship With Farhan",0,2,16,58,1,15,0,74,0
'Handmaid's Tale' Waitlists Surge In Libraries Across America,0,3,8,43,3,7,0,51,0
"Underwater volcano causes 3,300 ft column of steam",0,1,1,37,1,7,4,38,0
"Look Up Tonight and You’ll See a Comet, an Eclipse, and a Full Moon",0,2,9,42,3,13,0,51,0
People are sharing #DisabledAndCute photos to fight stigma The list,0,2,5,52,1,9,0,57,0
Two injured in explosion at Toronto fairground,0,1,2,38,0,6,0,40,0
Obama-era Surgeon General replaced,0,2,3,27,1,3,0,30,0
'Very Fake News': Pres. Trump Questioned on Intel Leaks by CNN's Acosta  Insider,0,3,13,49,5,13,0,62,0
Julian Assange held while Sweden appeals bail,0,1,3,36,0,6,0,39,0
Kanye West and Donald Trump: 'The two most powerful American narcissists in the same room',0,2,6,67,3,14,0,73,0
19-Year-Old Becomes Youngest Woman Ever Eligible To Run For Office In Georgia,0,3,13,49,2,11,2,62,0
Valentine's Day celebrations banned in Islamabad,0,3,3,39,1,5,0,42,0
"2017 NBA management rankings, from top to bottom",0,3,3,33,1,7,4,36,0
"Ford's US auto sales spike, surpassing GM",0,1,5,28,2,6,0,33,0
U.S. Win Provides a Special Memory,0,1,6,21,2,5,0,27,0
Facebook Messenger Hits 1.2 Billion User Milestone,0,3,6,35,1,6,2,41,0
CISF Jawan Kills Four Colleagues After An Argument In Bihar's Aurangabad,0,3,14,47,1,10,0,61,0
A 'Star Wars' fan spliced together the end of 'Rogue One' with the beginning of 'A New Hope',0,3,8,61,6,17,0,69,0
Wail of sirens marks Holocaust Remembrance Day in Israel,0,1,5,43,0,8,0,48,0
Swine flu outbreaks appear globally; WHO raises pandemic alert level to 5,0,1,4,56,1,11,1,60,0
Sir Andy Murray says his wife will have to watch her language now she is 'Lady Kim' ,0,3,5,60,2,17,0,65,0
This account points out everything wrong with Instagram’s nipple policy The list,0,3,3,65,1,11,0,68,0
Memphis Grizzlies Mike Conley Injury Update: Grizzlies PG to Return vs. Kings,0,2,11,53,2,11,0,64,0
MLB Power Rankings at the Start of March,0,2,7,26,0,7,0,33,0
Trump Jr.: Cruz Can Only Win Nomination By ’Bribing’ Delegates,0,2,10,39,4,9,0,49,0
Watch Joey Bada$$' Powerful New Video for 'Land of the Free',0,3,8,37,5,10,0,45,0
"On ‘S.N.L.,’ Donald Trump Botches His ‘Independence Day’ Moment ",0,3,11,36,8,9,0,47,0
Fire at tombs in Uganda result in clashes between protestors and police,0,1,2,58,0,11,0,60,0
New China-Mongolia Mining Deal: Economic Windfall or Environmental Threat?   ,0,3,9,54,3,11,0,63,0
More than 100 hundred people die from hunger in Somalia in 48 hours,0,3,2,48,0,12,5,50,0
Investors Are Cherry Picking the Assets of a Fallen Renewable Energy Giant,0,2,9,54,0,11,0,63,0
UN renews Darfur peacekeeping mission,0,1,3,30,0,4,0,33,0
"As Season Nears End, Soccer's Giants Stay in Trophy Chase",0,1,9,37,2,9,0,46,0
Abbas fires security chiefs for failure to curb lawlessness,0,1,1,50,0,8,0,51,0
Ed Sheeran Is Brought to Tears During His Trip to Liberia for Red Nose Day [Video],0,3,13,52,2,15,0,65,0
Our Favorite Gadgets: Best Tech Gifts 2016.com,0,3,6,28,2,6,4,34,0
Inside the Hotel Industry’s Plan to Combat Airbnb ,0,2,6,35,1,8,0,41,0
Apple Park: Apple's new 'spaceship' campus - in pictures,0,3,3,40,5,8,0,43,0
How American Cuisine Became a Melting Pot,0,2,6,29,0,6,0,35,0
"Final Four 2017: Schedule, Odds, Predictions for NCAA Tournament Semifinals",0,3,11,48,3,9,4,59,0
What Ahmadinejad’s run says about the state of Iranian politics,0,2,3,50,1,9,0,53,0
Intergalactic Representatives at the U.N.,0,1,4,31,2,4,0,35,0
Jo Cox's husband has written a memoir during sleepless nights following her death,0,2,2,66,1,12,0,68,0
George Michael worked at a 'homeless shelter' but asked people to keep it secret,0,3,2,63,2,13,0,65,0
What it was like to cover Beau Biden’s funeral,0,3,3,34,1,8,0,37,0
Canadian theatre producers sentenced for fraud,0,1,1,40,0,5,0,41,0
Logan's Hugh Jackman: 'People think it’s easier to stay in your own backyard' – video interview,0,3,4,70,6,15,0,74,0
Tension in DNC Chair Race Comes From Outside - Not Inside - The Party,0,3,13,41,2,13,0,54,0
Chinese hunger strike continues at Australian detention centre,0,1,2,53,0,7,0,55,0
How are you celebrating the Women's World Cup?,0,2,4,33,2,7,0,37,0
Former U.S. presidential candidate and Senator George McGovern dies aged 90,0,1,7,54,2,10,2,61,0
2017 NFL Mock Draft: Doug Farrar's Final Predictions,0,2,9,30,2,7,4,39,0
Judge who swore at abusive defendant cleared of misconduct,0,2,1,49,0,8,0,50,0
See How Out Of Control Peru's Flooding Is,0,2,8,25,1,7,0,33,0
Melbourne Victory held to draw by Perth Glory,0,1,4,34,0,7,0,38,0
Clinton Family Foundation donated $100G to NYT group same year paper endorsed Hillary ,0,2,8,61,1,13,3,69,0
"Trump supporter thought president would only deport ‘bad hombres.’ Instead, her husband is being deported.",0,3,2,85,5,14,0,87,0
Nine US troops killed in Afghanistan as Taliban attack base,0,1,5,45,0,9,0,50,0
How the Trolls Stole Washington ,0,2,4,23,0,5,0,27,0
Camila Cabello's Solo Debut: What We Do (And Don't) Want to Hear,0,2,11,37,5,11,0,48,0
"Ersan Ilyasova Traded to Hawks; 76ers Receive Tiago Splitter, More",0,2,8,45,2,9,2,53,0
EU demands China investigate torture of lawyer and release political prisoners,0,3,3,65,0,10,0,68,0
Will Ferrell returns as an evil 'Elf' this holiday season,0,2,3,43,2,9,0,46,0
Tea Party-endorsed Christine O'Donnell wins Delaware Senate primary election,0,1,7,59,2,8,0,66,0
A Kentucky County Is an Economic Prisoner of Its Own Jail,0,3,9,38,0,10,0,47,0
Two dead after severe flash flood in Maryland,0,2,2,36,0,7,0,38,0
Keith Olbermann Calls Out Trump: 'You Are A Jackass',0,3,9,32,3,8,0,41,0
Second fugitive California inmate captured after standoff ,0,3,2,49,0,7,0,51,0
Petroleum Resource Rent Tax concessions under the microscope ahead of May budget,0,3,5,64,0,11,0,69,0
Justice Dept. Says Judge in Immigration Case Is Out of Bounds - The New York Times,0,2,13,52,2,15,0,65,0
Classic Shrimp Scampi Recipe - NYT Cooking,0,3,8,27,1,6,0,35,0
"‘I’m Nobody’? Not a Chance, Emily Dickinson ",0,3,6,26,5,7,0,32,0
Sir Tim Barrow profile: 'He will report back reliably on EU thinking',0,3,6,49,3,11,0,55,0
Beware The False Temptations Of The Russia Story,0,3,8,33,0,7,0,41,0
Melania Trump’s demand for a retraction by People magazine is simply amazing,0,2,3,61,1,11,0,64,0
Senate Confirms Neil Gorsuch as Supreme Court Justice,0,3,7,39,0,7,0,46,0
"Breakthrough Awards Give Scientists Some Celebrity Treatment, But It's Not Enough",0,3,11,58,2,10,0,69,0
Phil Jackson will keep meddling in bad look for Hornacek,0,2,3,44,0,9,0,47,0
Clinton Says U.S. Feeds Mexico Drug Trade,0,1,8,25,2,6,0,33,0
Some Australian government welfare recipients will be forced to pay their bills,0,1,2,66,0,11,0,68,0
Seattle Seahawks Richard Sherman Says 'Karma' Caught Up to Cam Newton,0,2,10,47,2,10,0,57,0
Chase Utley payback backfires in ejection-filled Mets nightmare,0,2,3,52,1,7,0,55,0
Muslim Teen Can Finally Box In Her Hijab,0,3,8,25,0,7,0,33,0
"San Jose, CA, USA, city manager resigns amid Norcal investigation",0,1,8,45,3,9,0,53,0
Man And Protester He Sucker-Punched At Trump Rally Shake Hands In Court,0,2,13,46,1,11,0,59,0
Soros-Backed Blogger Under Fire For Anti-Semitic Tweets,0,2,9,38,2,6,0,47,0
Falling Prices in Japan Feed Deflation Fears,0,1,6,32,0,6,0,38,0
"Scandal, radicals and insurgencies – all bets are off for the French presidency",0,3,2,63,2,12,0,65,0
Funeral of Pope John Paul II will be Friday 8 April at 10.00,0,1,8,34,1,12,5,42,0
The best pictures from International Women's Day 2017,0,3,4,37,1,7,4,41,0
Media Analyst Calls Out MSNBC Reporter's 'Brazen' Questions to Debra Messing  Insider,0,3,15,55,3,12,0,70,0
Disney and MLB purchase streaming rights for 'League of Legends',0,2,6,47,2,9,0,53,0
JuJu Smith Schuster Drafted by Steelers; Top Twitter Takes to 2nd-Round Pick,0,3,11,51,2,11,1,62,0
Gates Issues Warning to North Korea,0,1,5,25,0,5,0,30,0
1940s: Classic New England summers at Cape Cod's Provincetown,0,3,6,41,2,8,4,47,0
Jayalalithaa’s Coffin Maker Has Made More Than 500 VIP Caskets Including Former PM And Film Stars,0,2,18,60,1,15,3,78,0
Underwater volcano erupts in Pacific near Japan,0,1,3,38,0,6,0,41,0
"Hurt by the Economy, Europeans Vent Their Anger",0,1,6,33,1,7,0,39,0
"Call them 'Virtual reality experiences,' because that's what the cool kids say",0,2,2,61,4,11,0,63,0
China’s FX Regulator Announces Latest Steps to Keep Cash at Home,0,2,10,43,1,10,0,53,0
Conway: Stop trying to 'delegitimize' Trump victory,0,2,3,39,3,6,0,42,0
"Army, local police probe recent mystery deaths of 11 Fort Hood soldiers ",0,3,3,54,1,12,2,57,0
Oklahoma Police Chief Gives Himself A Ticket For Speeding,0,3,9,40,0,8,0,49,0
West Wing Battle Brews Between Nationalists and Globalists,0,2,7,44,0,7,0,51,0
British motorists showered with cash on motorway,0,1,1,41,0,6,0,42,0
U.S. Military Investigating Reports of Civilian Deaths in Syria Airstrike ,0,2,9,53,2,10,0,62,0
California county's corporate anti-electioneering measure abandoned,0,1,1,59,2,5,0,60,0
Bodies found at crash site of US helicopter in Afghanistan,0,1,4,45,0,9,0,49,0
These Companies All Boosted Paid Parental Leave In 2016,0,3,8,35,0,8,4,43,0
House Republicans ’can’t believe’ Trump called their healthcare bill ’mean’,0,2,3,58,5,9,0,61,0
What's Next in the Legal Battle Over Trump's Executive Order ,0,3,8,41,2,10,0,49,0
Trump Again Attacks Media at Campaign-Style Rally in Florida,0,3,8,43,1,8,0,51,0
"Sean Spicer, in daily briefing, discusses budget, security leaks ",0,3,2,51,3,9,0,53,0
Canadian PM Trudeau says he won't 'lecture' Trump on US immigration policy ,0,3,7,53,3,12,0,60,0
Bus catches fire on George St in Sydney,0,3,4,28,0,7,0,32,0
AP: Man-made earthquakes in Oklahoma decline after new regulations,0,2,4,52,2,8,0,56,0
Exxon’s $20 Billion Spending Plan Points to U.S. Energy Surge ,0,3,9,37,4,10,2,46,0
California City Bans Display of Vietnam National Flag on City Poles,0,3,9,48,0,10,0,57,0
"Quarterly Earnings Fall at Staples, as Sales Grow 19%",0,1,6,35,2,8,2,41,0
Melenchon Crashes Front-Runners’ Party as French Risks Rise,0,2,8,42,2,7,0,50,0
"Allow some mental health patients to self-harm because stopping them can make problem worse, says researcher",0,3,1,90,2,15,0,91,0
Buzz Aldrin's Antarctic expedition cut short due to altitude sickness,0,3,3,56,1,9,0,59,0
"Ohio policeman helps girl, 10, with maths homework",0,2,1,38,2,7,2,39,0
Video Shows Heated Exchange Between Lil Yachty and Confrontational Fan,0,3,9,52,0,9,0,61,0
Ice shelf breaks free in Canadian Arctic,0,1,3,31,0,6,0,34,0
Baylor Keeps Barreling Through Big 12,0,1,5,25,0,5,2,30,0
Apple Pay UK launch could come this summer,0,3,4,31,0,7,0,35,0
Revamped Nuggets Have Reason to Hope,0,1,5,26,0,5,0,31,0
Iranian opposition group declares all acts of current government void,0,1,1,59,0,9,0,60,0
"163 new species, including 'Klingon Newt', discovered ",0,3,2,38,4,7,3,40,0
That Thing With Feathers Trapped in Amber? It Was a Dinosaur Tail ,0,2,10,43,1,12,0,53,0
"Istanbul nightclub suspect arrested, Turkish officials say",0,3,2,49,1,6,0,51,0
Is Trump's refugee ban legal?,0,3,2,21,2,4,0,23,0
Lawmakers react to U.S. cruise missile strike on Syria,0,3,4,40,2,8,0,44,0
"'The First Noel' Christmas Musical Opens at The Apollo, Bringing Refreshing Complexity to Seasonal Fare",0,3,13,73,3,14,0,86,0
Two-Thirds of Americans Aren’t Putting Money in Their 401(k),0,2,7,38,4,8,3,45,0
Philadelphia Newspapers Seeking Bankruptcy,0,1,4,35,0,3,0,39,0
"2007 Rugby World Cup: South Africa, Wales, Scotland and Ireland win",0,1,8,42,3,10,4,50,0
Jimmy Kimmel Has 'Activists' Ask Warriors Fans to Support Team Name Change,0,2,11,50,2,11,0,61,0
Lonzo Ball Declares for 2017 NBA Draft After Sweet 16 Loss to Kentucky,0,3,11,41,0,12,6,52,0
WikiLeaks dump shows how CIA compromised iPhones and Macs,0,3,7,42,0,8,0,49,0
"To Get on the Web, Turn On Your TV",0,1,8,17,1,8,0,25,0
"Belgian king swears in PM Van Rompuy, cabinet",0,1,5,32,1,7,0,37,0
"Just Spending Money Won't Clean Ganga, Experts Say No Major Improvement Has Come In Water Quality",0,3,16,64,2,15,0,80,0
"Hey, Steve Harvey, Who Says I Might Not Steal Your Girl? ",0,3,11,32,3,11,0,43,0
67th Annual Golden Globe Award highlights,0,1,4,30,0,5,2,34,0
"Meet Tim Ryan, the Ohio Democrat challenging Nancy Pelosi to lead House Democrats",0,3,9,59,1,12,0,68,0
Australia qualifies for FIFA World Cup 2006,0,1,7,26,0,6,4,33,0
Google announces new operating system,0,1,1,32,0,4,0,33,0
Burrowing Under Luminous Ice to Retrieve Mussels - The New York Times,0,2,10,47,1,11,0,57,0
Erdogan says Turkey won’t wait at Europe’s door forever,0,2,3,42,2,8,0,45,0
The Funeral: Your Last Chance to Be a Big Spender,0,1,8,31,1,9,0,39,0
These Are The Most-Coveted Beauty Gifts In America,0,3,9,33,1,7,0,42,0
NTSB says pilot error caused crash of Colgan Air Flight 3407,0,1,7,39,0,10,4,46,0
Calls for bottled water bans grow in Canada,0,1,2,34,0,7,0,36,0
No one should feel good about Trump’s attack on Syria,0,3,3,40,1,9,0,43,0
Getaround Raises $45 Million To Expand Airbnb-For-Cars Model,0,3,9,39,3,7,2,48,0
The 10 Least Stressful Jobs In 2017,0,3,5,18,0,6,6,23,0
"After Another Brick, It's Time to Stop Pretending 'The Walking Dead' Is Worth Watching",0,3,13,56,4,13,0,69,0
'Blind Sheikh' linked to 1993 World Trade Center bombing dies in US federal prison ,0,3,7,56,2,14,4,63,0
"Fresno shooting rampage: Suspected gunman wanted to kill as many white people as possible, cops say ",0,2,2,80,2,16,0,82,0
Drug cartel and police shootouts erupt in Mexico,0,1,2,39,0,7,0,41,0
"Dazed and Confused by Trump, Europe Asks If It Can Step Up Alone",0,2,11,40,1,12,0,51,0
Kelvin MacKenzie pays price after Sun takes eye off the ball,0,2,4,46,0,10,0,50,0
Michael Kors has identified a huge weakness in its business — and it should terrify Macy’s,0,2,3,70,2,15,0,73,0
Former NFL quarterback Steve McNair shot dead,0,1,7,32,0,6,0,39,0
Ebay's New Guaranteed Delivery Program Goes Head-To-Head With Amazon Prime And Jet,0,3,14,54,3,11,0,68,0
Watch Michelle Obama Deliver Final Speech As First Lady,0,3,9,38,0,8,0,47,0
'At best delusional': readers react to Theresa May's Brexit speech,0,3,4,49,4,9,0,53,0
Google ordered to explain why taxpayer-funded adverts appear alongside extremist material,0,2,1,77,1,10,0,78,0
"Pope Francis Goes Forward with Egypt Trip, Despite Jihadist Bombings",0,2,9,49,1,9,0,58,0
How Good (or Not Evil) Is Google?,0,1,6,18,3,6,0,24,0
ISIS is going broke,0,2,4,12,0,3,0,16,0
Boston Mayor Says Trump's Victory Is In Part Backlash To African-American Progress,0,3,13,56,2,11,0,69,0
London attack: How a lone knifeman brought terror to Westminster Bridge and the Houses of Parliament,0,2,6,78,1,15,0,84,0
A Christmas Tree Ornament Is Worth A Thousand Words,0,2,9,34,0,8,0,43,0
Ferry hijacked to protest slogans in assassinated Turkish-Armenian journalist's funeral,0,1,3,73,2,9,0,76,0
Irish bishop resigns over child abuse scandal,0,1,1,38,0,6,0,39,0
Teacher opens Books & Braids salon for young girls at elementary school,0,3,3,56,1,11,0,59,0
Suncor makes bid to take over Petro-Canada,0,1,3,32,1,6,0,35,0
ESPN Layoffs at Leading Edge of the Coming ‘Sports Bubble’,0,3,10,37,2,9,0,47,0
Trump Plans Technology Conference With Silicon Valley Executives ,0,2,8,49,0,8,0,57,0
Paris bans 'sexist' adverts from billboards following outcry over 'porno chic' fashion campaign ,0,2,1,78,4,13,0,79,0
"With ‘Trousergate,’ Politics and Pants Collide in Britain ",0,3,6,41,3,8,0,47,0
11-Year-Old Has His Legs Amputated After Being Brutally Beaten Up By Warden At Malaysian Islamic School,0,3,17,67,2,15,2,84,0
United States - ESPN FC,0,2,8,10,1,4,0,18,0
"In Debate on Spending, a Detour for Politics",0,1,5,31,1,7,0,36,0
Here's how much millionaires would save under GOP Obamacare repeal bill,0,3,5,55,1,10,0,60,0
"How to qualify for the Masters, the world's most prestigious golf tournament",0,2,2,61,2,11,0,63,0
Please enjoy Obama photographer Pete Souza's latest flawless Trump troll,0,3,5,57,1,9,0,62,0
The Awards That Should've Been Given Out at the 2017 Grammys,0,3,8,37,1,10,4,45,0
"Texas Oil Fields Rebound From Price Lull, but Jobs Are Left Behind ",0,3,11,43,1,12,0,54,0
"After Trump's comments, the wrong John Lewis is getting buried in tweets",0,3,4,55,2,11,0,59,0
Deaflympics 2013: US swimmer breaks second world record,0,1,3,40,1,7,4,43,0
"Indiana Town's Entire Police Force Resigns, Citing Unfair Treatment  Insider",0,3,10,54,2,10,0,64,0
The Man Behind ‘America’s Wine Superstore’,0,3,6,28,3,5,0,34,0
State Dept. carries out layoffs under Rex Tillerson,0,3,4,39,1,7,0,43,0
"Giraffes in process of 'silent extinction,' wildlife group says",0,3,1,51,3,8,0,52,0
Elon Musk's SpaceX is betting big on its rocket launch this week,0,3,4,48,1,11,0,52,0
Campos-Duffy: Leaked Trump Dossier Is an 'Attack on the American People'  Insider,0,3,10,55,4,12,0,65,0
MLB spring training is unnecessarily long. Blame pitchers.,0,3,4,45,2,7,0,49,0
"Former top Trump aide Flynn paid over $30,000 by Russian TV, top House Dem says",0,2,8,49,3,14,5,57,0
Trump's devastating new travel ban is built on a harmful myth,0,2,1,49,1,10,0,50,0
"Oh nothing, just Chris Hemsworth crashing a couple's wedding photos",0,3,3,53,2,9,0,56,0
Dutch government collapses over Afghanistan troops,0,1,2,43,0,5,0,45,0
Van Crashes Into Plane at Dallas Airport,0,3,6,28,0,6,0,34,0
Princess Cristina of Spain Found Not Guilty in Fraud Trial; Husband Is Convicted ,0,3,11,56,1,13,0,67,0
7th Heaven television series comes to an end,0,1,1,35,0,7,1,36,0
"BBC's Mock The Week 'breached guidelines' with Olympian humour, say corporation's Trust",0,1,8,63,5,11,0,71,0
2008 Taipei Game Show review: Variations differ from past years,0,1,4,45,1,9,4,49,0
"States push to protect abortion funding, despite GOP healthcare fail ",0,2,4,54,1,10,0,58,0
David Beckham arrives in Trinidad and Tobago amid security fears,0,1,4,51,0,9,0,55,0
N.C. man told police he went to D.C. pizzeria with gun to investigate conspiracy theory,0,2,4,65,4,14,0,69,0
Sessions to submit written answers to questions about Russia contacts ,0,3,2,58,0,10,0,60,0
Fourteen dead as passenger helicopter crashes off Estonia,0,1,2,48,0,7,0,50,0
Bitcoin dives after China's 3 biggest exchanges say they'll keep blocking withdrawals,0,2,2,69,2,11,1,71,0
UK's highest court to rule on use of information extracted under torture,0,1,2,58,1,11,0,60,0
Violent protests break out in Kyrgyzstan over allegedly rigged parliamentary elections,0,1,2,74,0,10,0,76,0
Pittsburgh Steelers woken up at 3 a.m. by false fire alarm in Boston hotel,0,2,3,55,2,13,1,58,0
Hundreds of veterans gathering at Dakota pipeline protest,0,3,2,48,0,7,0,50,0
Human Error and Management Decisions Faulted in W. Va. Bayer Explosion,0,1,9,49,2,10,0,58,0
Russian sale of fighter jets to UAE highlights shift toward Kremlin amid U.S. hesitancy ,0,3,7,65,2,14,0,72,0
Bank of East Asia Buys Taiwan Unit of A.I.G.,0,1,9,24,3,8,0,33,0
Marine Le Pen’s party is facing allegations of Holocaust denial … again,0,2,4,54,2,11,0,58,0
Christopher Lee Dies at 93; Actor Breathed Life Into Nightmarish Villains ,0,3,9,51,1,11,2,60,0
Apple CEO Tim Cook Emailed Employees to Denounce Donald Trump’s Refugee Ban,0,3,13,50,1,11,0,63,0
Viewers strongly approve of Trump's speech to Congress,0,3,3,43,1,7,0,46,0
Oscars 2017: Hollywood Sound Man Kevin O’Connell Hopes to End Record Drought,0,3,11,48,2,11,4,59,0
Brazil hit by first general strike in two decades,0,2,1,40,0,8,0,41,0
"2007 World Deaf Swimming Championships Day 3: ""Bad weather"" and ""New Record Day of Belarus""",0,1,10,57,5,14,5,67,0
"Adult ADHD Can’t Be Diagnosed With A Simple Screening Test, Doctors Warn",0,2,15,44,2,11,0,59,0
"Gen. Petraeus, Amb. Crocker testify before US Armed Services Committee",0,1,9,49,3,9,0,58,0
"Berlin attacker had 14 aliases, was subject of repeated counterterror briefings",0,3,1,65,1,10,2,66,0
"Canwest, a Canadian Media Company, Posts a Loss",0,1,6,32,2,7,0,38,0
Pakistani army storms Red Mosque; Ghazi is killed,0,1,4,37,1,7,0,41,0
Page Not Found  Insider,0,3,4,15,0,4,0,19,0
"Change Your Calendar, Change Your Life",0,3,6,26,1,5,0,32,0
Expedition 33 crew returns to Earth,0,1,2,26,0,5,2,28,0
Australian Broadcasting Corporation plans to call California for Obama before polls close,0,1,5,73,0,11,0,78,0
'SNL' Weekend Update crams a week of Trump missteps into 8 minutes,0,3,6,46,2,11,1,52,0
Comedian Jimmy Kimmel to Host 2017 Oscars,0,3,5,26,0,6,4,31,0
Funk Legend Dennis Coffey Shares Rediscovered 1968 Live Cut 'Fuzz': Exclusive Premiere,0,3,11,57,3,11,4,68,0
Stan Lai: Volunteers will play the greatest key role at 2009 Summer Deaflympics,0,1,5,57,1,12,4,62,0
Catholic Church paid A$276m to abuse victims in Australia,0,2,4,41,1,8,3,45,0
Samsung DeX gadget transforms the Galaxy S8 into a PC,0,3,7,36,0,9,1,43,0
Facebook Murder Suspect Steve Stephens Commits Suicide,0,3,7,41,0,6,0,48,0
Watch the trailer to Apple's first original TV show which looks like 'Shark Tank' for apps,0,3,6,66,3,15,0,72,0
"‘I was trying to get help,’ Times Square driver says in jailhouse interview",0,2,3,57,3,12,0,60,0
Chilean actor Oscar Garcés accused of sexual abuse,0,1,3,40,0,7,0,43,0
Did Russell Westbrook Just Make His MVP Case?,0,3,10,27,1,7,0,37,0
"We, the two-headed snake, dies in U.S. museum at age 8",0,1,3,35,5,10,1,38,0
American war deserter given stay of deportation in Canada,0,1,2,47,0,8,0,49,0
Alleged Anthrax killer Bruce Ivins reportedly made edits to Wikipedia,0,1,5,55,0,9,0,60,0
Jet flies 150 miles past destination in US; pilots say they were distracted,0,1,3,56,1,12,3,59,0
New Looks at the Fields of Death for Jews,0,1,5,28,0,8,0,33,0
Tom Price Defends Trump Proposal To Cut Funding To Public Health And Research,0,2,13,52,0,12,0,65,0
Polite boy shakes hands with the Queen,0,2,2,30,0,6,0,32,0
Watch 'SNL' Spoof Justin Bieber and Lady Gaga in 'Celebrity Family Feud' Skit,0,3,13,48,4,12,0,61,0
"In First Use of Replay, Umpires at Yankee Stadium Get It Right",0,1,10,40,1,11,0,50,0
"South China Sea: Australia in firing line if US and China go to war, experts warn",0,3,7,57,2,15,0,64,0
Travis Scott Says He's 'So Hurt' About Grammy Snub,0,3,9,30,3,8,0,39,0
No easy tusk! Asian elephants are spotted CLIMBING near vertical mountainside ,0,3,10,56,1,11,0,66,0
No. 11 Syracuse Stays Unbeaten in Big East With Win Over Rutgers,0,1,10,40,1,11,2,50,0
Germany's right wing party voted to expel lawmaker who criticized Holocaust memorial,0,2,2,70,1,11,0,72,0
Somaliland agrees to UAE military base in Berbera,0,3,5,37,0,7,0,42,0
Hong Kong’s New Leader Will Inherit a Fragile Economy,0,2,8,36,1,8,0,44,0
The Resistance Now: Big corporations come at Trump on climate,0,2,5,46,1,9,0,51,0
Gunman shoots at gamblers at Las Vegas casino,0,1,3,35,0,7,0,38,0
Rush Limbaugh Defends Marco Rubio: He’s Right About Obama - Breitbart,0,2,10,46,3,10,0,56,0
DR Congo: Ethnic clashes leave 31 dead,0,3,4,25,1,6,2,29,0
6 Pilots Grounded Over Allegations Of Delaying The Landing Of Flight Carrying Mamata Banerjee,0,3,13,66,0,13,1,79,0
Fugitive Mexican ex-Gov. Javier Duarte detained in Guatemala ,0,2,6,45,2,8,0,51,0
"US service member killed in blast near Mosul, coalition says",0,2,3,47,1,9,0,50,0
Trumps Leave Board of Trump Casino Company,0,1,6,30,0,6,0,36,0
Source of UK foot-and-mouth outbreak discovered,0,1,3,37,2,5,0,40,0
UK police involved in stand-off with gunman Raoul Moat,0,1,4,41,1,8,0,45,0
Aleppo Evacuations Move Toward Conclusion,0,3,5,32,0,4,0,37,0
MEPs seek to exempt citizens with joint EU citizenship from US travel ban,0,2,7,54,0,12,0,61,0
Rag'n'Bone Man's 'Human' Hits No. 1 on Alternative Songs Chart,0,3,9,37,6,9,1,46,0
Canada's Health Minister will attempt to stop Americans from buying prescription drugs in bulk,0,1,4,76,1,13,0,80,0
‘10 Concerts’ Facebook Meme May Reveal More Than Musical Tastes ,0,3,9,41,2,10,2,50,0
"Chuck Barris, creator of the 'Gong Show,' dead at 87 ",0,3,4,33,4,10,2,37,0
Empire Diner Aims to Recapture Glory Days With Contemporary Spin ,0,2,9,46,0,10,0,55,0
Time-lapse shows elaborate patterns - Business Insider,0,3,3,43,2,6,0,46,0
A genuinely believable CGI actor? It won't be long,0,3,5,35,2,8,0,40,0
Democrats Fight Back on Gun Control,0,2,5,25,0,5,0,30,0
"Thanks To This Adorable Therapy Donkey, A Little Girl Overcame Her Speech Disorder",0,2,13,56,1,12,0,69,0
Donald Trump Taps Mick Mulvaney as Budget Director - Breitbart,0,2,8,44,1,9,0,52,0
ABC to move Internet news network back to U.S. TVs,0,1,8,31,2,9,0,39,0
Source: Fox News and Bill O'Reilly are talking exit,0,3,6,35,2,8,0,41,0
Stockholm truck attack kills 4; suspect held on suspicion of terror,0,3,1,54,1,10,1,55,0
Time to change time again: Daylight saving time returns,0,3,2,44,1,8,0,46,0
"Trump Spokesman Claims The President-Elect Sold All His Stocks, But Provides No Evidence",0,2,14,60,2,12,0,74,0
EU Aid to Support Afghan Peace Deal With Warlord,0,3,9,31,0,8,0,40,0
Junk food to be banned in English schools,0,1,2,32,0,7,0,34,0
The Carhullan Army: a near-future struggle that feels all too close,0,3,3,52,2,10,0,55,0
"On Sixth Try, Endeavour Lifts Off",0,1,6,21,1,5,0,27,0
UK Conservative party wins last seat in 2010 general election,0,1,3,45,0,9,4,48,0
"Barack Obama visits Hawaii, hits the links and enjoys fine dining ",0,3,3,51,1,11,0,54,0
Shadowy Iranian Vigilantes Vow Bolder Action,0,1,6,33,0,5,0,39,0
"Golden St Warriors Warriors Players, Coaches Donate $75,000 to Oakland Fire Relief Efforts",0,3,11,59,3,12,5,70,0
"It's like online dating, but for someone to have your baby",0,3,1,45,2,10,0,46,0
War Hero in Vietnam Forces Government to Listen,0,1,6,34,0,7,0,40,0
Bruney Looks to Explain Continued Elbow Pain,0,1,6,32,0,6,0,38,0
Amazon is doubling down on retail stores with plans to have up to 100 pop-up stores in US shopping malls,0,2,3,78,1,19,3,81,0
Some babies die waiting for a liver transplant. This baby was matched in 40 minutes.,0,3,2,64,2,14,2,66,0
India Is All Set To Trial-Run Its First 700 MW Nuclear Reactor!,0,3,13,34,2,11,3,47,0
U.S. Home-Price Growth Continued Accelerating in February,0,2,8,40,3,6,0,48,0
"Cheque In Kannada Dishonoured, Customer Drags Bank To Court",0,3,9,41,1,8,0,50,0
Japanese scientists want to be first to drill into the Earth's mantle,0,3,2,55,1,11,0,57,0
How The Perceived ’War On Cops’ Plays Into Politics And Policing,0,2,11,41,2,10,0,52,0
"Escaped killers' driver went to hospital instead, source says",0,3,1,50,2,8,0,51,0
"Big Brown victorious in Kentucky Derby, runner-up Eight Belles breaks down",0,1,6,56,2,10,0,62,0
Elizabeth Warren Tells Us That She Can't Even With Jamie Dimon's Mansplaining,0,2,12,52,2,11,0,64,0
In Defense of the Blowout ,0,3,3,18,0,5,0,21,0
Prime Minister of Thailand survives no-confidence vote,0,1,3,44,1,6,0,47,0
"Chances Are, You're Not Using Your Rewards Credit Card Correctly",0,3,10,43,2,9,0,53,0
Trump administration sends mixed signals on Syria ahead of G7 meeting,0,3,3,55,0,10,1,58,0
Dow Chemical Pushes White House to Kill Risk Study Showing Pesticide Dangers,0,3,11,54,0,11,0,65,0
Facebook blocks Pulitzer-winning reporter over Malta government exposé,0,2,3,59,1,7,0,62,0
Tear gas fired over Peru toll booths,0,2,2,28,0,6,0,30,0
At Least 34 Dead in Baghdad Bombing,0,1,5,22,0,6,2,27,0
Usain Bolt disappointed with time after 200m victory in New York,0,3,4,47,0,10,3,51,0
Trump’s outdated claims that China is devaluing its currency,0,3,2,49,1,8,0,51,0
California immigrant families brace for possibility of sudden deportation,0,2,1,64,0,8,0,65,0
Growing Need for Medicaid Strains States,0,1,5,30,0,5,0,35,0
"Raids of Illegal Immigrants Bring Harsh Memories, and Strong Fears ",0,2,8,48,1,10,0,56,0
Student makes ridiculous Twitter bet for free Wendy’s chicken nuggets ,0,2,3,56,1,10,0,59,0
Shakira & Maluma's 'Chantaje' Reaches 1 Billion Views on YouTube,0,2,8,42,4,9,1,50,0
First Women Win Seats in Kuwait Parliament,0,1,6,30,0,6,0,36,0
"Charity haircuts and collaborative art at spring festival in Cambridge, Massachusetts",0,1,3,71,1,10,0,74,0
GOP Health Insurance Fix Could Raise Premiums For Older Patients,0,3,12,43,0,9,0,55,0
Pakistan International Airlines Sacrifices A Goat On The Runway For Safe Landing Of The Plane!,0,3,15,64,1,14,0,79,0
Another Magnum Opus For Prabhas! Makers Of Rs.1000 Cr ‘Mahabharata’ Offer Him A Prominent Role,0,2,15,57,4,14,4,72,0
Boeing 757 makes emergency landing at Vnukovo airport in Moscow,0,1,3,48,0,9,3,51,0
"Firefighter killed while tackling pub blaze in Edinburgh, Scotland",0,1,3,54,1,8,0,57,0
'Orange is the New Black' is quickly becoming a feminist classic,0,2,3,49,2,10,0,52,0
NBA Phil Jackson Comments on Using Word 'Posse' to Describe LeBron James' Associates,0,3,14,55,3,12,0,69,0
The White House Is Already In Flames,0,3,7,23,0,6,0,30,0
Two Spanish train stations bombed,0,1,2,27,0,4,0,29,0
Billionaire Taizo Son Ditches Japan to Start Afresh in Singapore,0,3,8,47,0,9,0,55,0
"Organization Urges Teachers, Students to Skip School & Protest Trump  Insider",0,2,9,55,2,11,0,64,0
Bang & Olufsen's fancy Beoplay H9 headphones come with noise cancellation,0,3,4,56,2,10,1,60,0
"Populism, Real and Phony ",0,3,3,17,1,4,0,20,0
Tobacco Companies Lose Appeal,0,1,4,22,0,3,0,26,0
New Orleans police officer commits suicide,0,1,2,35,0,5,0,37,0
London Terrorist Attack: French Teens on School Trip Were on Bridge,0,2,9,47,1,10,0,56,0
Barcelona defeat Manchester United in 2009 Champions League Final,0,1,6,47,0,8,4,53,0
Chris Brown's Ex Claims He Threatened To Kill Her,0,3,9,31,1,8,0,40,0
Tinder's in-house sociologist explains how to score a date for Valentine's Day,0,3,3,61,3,11,0,64,0
SpaceX to send two people around the moon who paid for a 2018 private mission,0,3,2,57,0,14,4,59,0
UBS Ousts Top Banker Who Served Rich U.S. Clients,0,1,12,27,2,8,0,39,0
Ohio Seeks to End Interest Abuses in Payday Loans,0,1,7,34,0,8,0,41,0
"Back on Camera, and Back to Making Money",0,1,5,27,1,7,0,32,0
"11 revealing answers DeVos gave to Democratic senators’ questions about vouchers, Common Core and more",0,2,5,79,2,14,2,84,0
"Senate confirms Trump's picks for Treasury, VA secretaries ",0,2,5,44,2,8,0,49,0
"Donald Trump says he wants to expand US nuclear arsenal, make it 'top of the pack'",0,3,4,60,3,15,0,64,0
Harry Styles Hangs From a Helicopter on 'Sign of the Times' Video Set,0,2,9,46,2,12,0,55,0
People are plotting to get back at the politicians who voted to sell your web data,0,3,1,66,0,15,0,67,0
"No, Germany doesn’t owe America ‘vast sums’ of money for NATO",0,3,7,40,4,10,0,47,0
Mini-Donald Trump Steals the Show at Pre-Inauguration Festivities  Insider,0,2,9,54,2,9,0,63,0
'American Idol' Alum Blake Lewis & Postmodern Jukebox Cover the Killers: Watch,0,3,10,53,4,11,0,63,0
"Tropical Storm Adrian forms in Eastern Pacific, threatens Central America",0,1,7,56,1,9,0,63,0
"Chelsea Clinton Writes Children's Book, 'She Persisted'",0,3,7,38,4,6,0,45,0
"Without immigrants, the US economy would be a 'disaster,' experts say ",0,2,3,52,4,11,0,55,0
These theaters have playgrounds because everyone loves loud kids at movies,0,3,1,63,0,10,0,64,0
Trump’s claim that Obama first ‘identified’ the 7 countries in his travel ban,0,3,2,59,3,12,1,61,0
"Baldwin, Seymour among attendees at Oscar viewing party held by Children Uniting Nations",0,1,6,69,1,12,0,75,0
LIGO Has Detected Gravitational Waves (Again),0,2,9,29,2,5,0,38,0
Inside Jeanie Buss' Lakers takeover,0,3,4,26,1,4,0,30,0
Iraqi troops hunt deadly IS snipers in Mosul,0,3,4,33,0,7,0,37,0
NDIS: Federal Government announces independent review of National Disability Insurance Scheme,0,3,10,72,1,10,0,82,0
2008 Tour de Taiwan Stage 7: Kam-po Wong places first for the second time,0,1,5,48,2,13,5,53,0
Celebrating Black History Month: Iconic Civil Rights Moments,0,3,8,44,1,7,0,52,0
Gunmen Kidnap 3 Workers With Aid Group in Darfur,0,1,7,32,0,8,1,39,0
"Madonna on Trump: Election win like ""being dumped by a lover""",0,3,3,45,3,10,0,48,0
Symptoms from previous surgeries to keep Warriors' Steve Kerr out,0,2,4,51,1,9,0,55,0
"Fires ravage rural areas of New South Wales, Australia",0,2,5,40,1,8,0,45,0
"Maryland teen was plotting mass school shooting, police say - Yahoo",0,3,2,53,2,10,0,55,0
Eric Trump suspends operations of his charitable foundation,0,3,2,50,0,7,0,52,0
Man gets $75 after being wrongly imprisoned for 31 years,0,3,1,41,1,9,4,42,0
Mariah Carey Drops New YG Collab 'I Don't': Listen,0,3,10,28,4,8,0,38,0
Mexican Drug Lord ‘El Chapo’ Pleads Not Guilty in U.S. Court ,0,3,11,35,4,11,0,46,0
Lewis Hamilton: 2017 rules made battle with Sebastian Vettel ‘harder than ever’,0,3,4,57,3,11,4,61,0
South Korean city wins 2018 Winter Olympics,0,1,4,29,0,6,4,33,0
Paul Ryan gave a spot-on speech on the baseball shooting,0,2,2,44,1,9,0,46,0
Social Media Ad Spending to Outweigh Print Revenue by 2020,0,3,7,38,0,9,4,45,0
"Born In Sudan, Based In Brooklyn. A Singer Remixes Her Identities",0,2,11,42,2,10,0,53,0
How Beyoncé Channeled Her Inner Goddess At The Grammys,0,3,9,37,0,8,0,46,0
Coca-Cola Considers Buying Back Shares,0,1,6,27,1,4,0,33,0
Taylor Swift Is the Highest-Paid Artist of 2016,0,3,6,29,1,7,4,35,0
Why a skirmish over pot legalization in Massachusetts is making some progressives paranoid,0,3,2,76,0,12,0,78,0
Harvard Dropout James Murdoch Steps Into Limelight at Fox,0,3,8,41,0,8,0,49,0
Rockets fired into Israel from Lebanon,0,1,3,30,0,5,0,33,0
Sugary Drinks Tied to Accelerated Brain Aging ,0,3,6,33,0,7,0,39,0
Investors Said to Be Less Wary of German Economy,0,1,7,33,0,8,0,40,0
Donald Trump was asked about anti-Semitism - His response was baffling to say the least The list,0,3,5,73,2,16,0,78,0
A moment that changed me: a clump of hair falling out in the shower,0,3,1,52,1,13,0,53,0
"Mark Webber wins 2009 Brazilian Grand Prix, Jenson Button and Brawn win championship",0,1,8,59,1,12,4,67,0
"In China, a sense of betrayal after the assassination of Kim Jong Nam ",0,3,5,51,1,13,0,56,0
Paris clashes: 13 arrested as scuffles break out after protest against police brutality ,0,2,1,71,1,13,2,72,0
"Trevor Noah: 'When I See Trump, I See a Stand-Up Comedian'",0,3,11,32,5,10,0,43,0
"Truck carrying explosives crashes, explodes in Utah",0,1,2,42,1,6,0,44,0
These Kids Gave Their Class Goldfish A Burning Viking Longship Burial,0,3,11,48,0,10,0,59,0
"Africa makes first draft version of UNCCC treaty, with harder goals",0,1,6,50,1,10,0,56,0
The girl who interrupted her dad's BBC interview just made herself a star,0,2,4,56,1,12,0,60,0
Morocco raises terror threat level to 'maximum',0,1,1,38,2,6,0,39,0
Sky pulls broadcast of show that cast white actor as Michael Jackson,0,2,3,54,0,11,0,57,0
Surprising report says the Patriots 'are not expected' to trade Jimmy Garoppolo,0,3,4,62,2,11,0,66,0
Donald Trump Is No 'Email Person' but 'Knows Things About Hacking' ,0,3,10,42,4,11,0,52,0
Watch Adele Panic Over a Mosquito Onstage,0,2,6,29,0,6,0,35,0
Juror Being Replaced In Oregon Occupation Case; Trial Draws Crowds,0,2,10,46,1,9,0,56,0
Arab States Aligned With U.S. Savor Turmoil in Iran,0,1,9,32,2,8,0,41,0
RNC: FBI Proves Hillary ’Deliberately Lying’ about Emails,0,2,11,36,3,7,0,47,0
Escaped South Carolina Inmate Captured by Police After Officer Stabbing ,0,3,9,53,0,10,0,62,0
Toasting each other’s health with a post-match pint of Lambrini Bianco,0,3,3,55,2,10,0,58,0
Got a weird skin rash? Maybe Facebook can help,0,2,3,34,1,8,0,37,0
Naval Show to Feature Submarines From China,0,1,6,31,0,6,0,37,0
"Robert James Waller, “Bridges of Madison County"" author, is dead at 77",0,3,6,47,4,11,2,53,0
"Four Indonesian airlines allowed back into Europe; Zambia, Kazakhstan banned",0,1,5,60,2,9,0,65,0
Wells Fargo CEO Says Ousting Majority of Board Would Be ‘Crazy’,0,3,12,39,2,10,0,51,0
"Russia to 'Sex And The City' star: Ambassador would be happy to meet you, too",0,2,6,53,4,14,0,59,0
Frances Bean Cobain pays tribute to dad Kurt on his birthday,0,3,4,46,0,10,0,50,0
Joe Biden Tells Donald Trump To 'Grow Up' in New Video Interview,0,3,11,40,2,11,0,51,0
2007 FIFA U-17 World Cup: Ghana vs. Germany,0,1,9,18,3,7,6,27,0
Trump should try acting a bit more vice presidential,0,2,1,43,0,8,0,44,0
Local Officials Grapple With Trump's Fearmongering On 'Sanctuary City' Policies,0,2,10,57,3,9,0,67,0
Planned Russian Exercises in September Sow NATO Worries,0,3,10,38,0,7,0,48,0
Jenni Murray: 'I want to see how women run the world',0,3,3,37,3,10,0,40,0
Get ready to say goodbye to these six shows,0,2,1,34,0,8,0,35,0
China to surpass Japan to become second largest economy,0,1,2,45,0,8,0,47,0
Repealing Obamacare could kill more people each year than gun homicides,0,2,2,59,0,10,0,61,0
"North Korea test-fires ballistic missile, South Korean media say",0,2,4,50,2,8,0,54,0
"Donald Trump Talks Vladimir Putin, Voter Fraud Claims, and More With Bill O’ Reilly",0,3,13,54,3,13,0,67,0
Why a Russian Hacking Inquiry Is in Donald Trump’s Best Interests ,0,3,9,45,1,11,0,54,0
"Who Needs Retirement, Anyway?",0,1,4,20,2,3,0,24,0
Final call for a free G&T: BA starts charging for food and drink in short-haul economy,0,2,5,63,3,15,0,68,0
"Watch This Teacher Rap About the Civil War Over Migos' ""Bad and Boujee""",0,3,11,45,3,12,0,56,0
Wikileaks claims news organisations pressured to remove articles on billionaire fraudster,0,1,1,78,0,10,0,79,0
Rebecca Minnock: Grandmother jailed over missing mum lies,0,3,3,46,1,7,0,49,0
Videos Capture Massive Green Fireball Streaking Across Midwest,0,3,8,47,0,7,0,55,0
U.S. Objects to China Plan to Require Web-Filtering Software,0,1,9,40,3,8,0,49,0
In all his glory: Michelangelo's naked Christ comes to Britain,0,2,4,47,2,9,0,51,0
"Thunder Fan Wins $20,000 by Sinking Half-Court Shot at Halftime",0,3,8,38,3,9,5,46,0
Explosives found in California cave,0,1,2,29,0,4,0,31,0
Senior North Korean Diplomat Is Sought in Death of Kim Jong-nam ,0,3,9,43,1,11,0,52,0
Mexican Soccer Player Rafa Marquez Partners With Spotify for 'Actitud' Playlist,0,2,10,57,2,10,0,67,0
China Near to Joining Influential Stock Index,0,2,6,33,0,6,0,39,0
Lady Gaga Opens Super Bowl LI Halftime Show With Tribute to America ,0,3,12,44,0,12,0,56,0
Films Like ‘O.J.: Made in America’ May Be Cut From Oscar Consideration ,0,3,12,42,5,12,0,54,0
"Hacked WikiLeaks emails show concerns about Clinton candidacy, email server",0,2,4,61,1,9,0,65,0
"For Beckham and M.L.S., Breaking Up Is Hard to Do",0,1,10,26,4,9,0,36,0
'HNDRXX' Keeps Future at No. 1 on Billboard Artist 100 Chart,0,3,12,31,3,10,4,43,0
Amazing insight into what US intelligence knew about Hitler in 1943,0,2,4,49,0,10,4,53,0
"Golf adds 'The Dustin Johnson Rule,' eliminates penalty for accidentally causing ball to move on the green",0,2,5,82,3,16,0,87,0
Donald Trump’s inauguration weather will be dreary. Here’s the forecast timeline.,0,3,3,64,4,10,0,67,0
Florida Teen Accused of Murdering His Mom on Her Birthday,0,2,8,40,0,9,0,48,0
Sprint Nextel customer service rep. harasses client; Sprint cancels his account,0,1,3,64,2,10,0,67,0
"Is Trump ready for war in the South China Sea, or is his team just not being clear?",0,3,5,59,2,17,0,64,0
Garth Brooks Clarifies Why He Won't Play Trump Inauguration,0,3,9,41,1,8,0,50,0
Breitbart News Daily: Washington’s Battle Flag SEAL at War Schweizer on ‘Cash’ - Breitbart,0,2,14,58,5,13,0,72,0
Vikings' beautiful glass stadium is killing birds at an alarming rate,0,3,1,57,1,10,0,58,0
"Burr and Warner: In the spotlight, and arm in arm, on Russia probe",0,3,4,47,3,12,0,51,0
No Receipts For Your Taxes Or IRS? No Problem,0,3,11,25,1,8,0,36,0
"Cousins: Mouthguard came out by accident, ejection 'ridiculous'",0,2,2,50,4,7,0,52,0
"Man in custody after claiming to have bomb near White House, source says ",0,3,3,56,1,13,0,59,0
"Fascism helped create a time zone oddity in Spain. 70 years later, it may finally be undone.",0,3,2,69,3,16,2,71,0
Strike by U.N. Workers Forces 174 Schools to Close for a Day,0,1,8,36,2,11,3,44,0
Businessman Convicted in Arms Plot,0,1,4,26,0,4,0,30,0
Trump Could Roll Back Decades Of Progress That Made Immigrant Detention More Humane,0,3,13,58,0,12,0,71,0
South Korea Heightens Military Readiness as North Scraps Pacts,0,1,8,46,0,8,0,54,0
Newcastle United's St. James' Park naming rights go up for sale,0,1,5,45,3,10,0,50,0
"Iran satellite launches tied to ballistic missile program, UN experts say ",0,2,3,59,1,11,0,62,0
Vanuatu hit by 7.2 magnitude earthquake,0,1,1,30,1,5,2,31,0
"Emirates airline had to change pilots, crew, and passenger roster after Trump's order",0,3,2,68,3,12,0,70,0
Government watchdog to review Mar-a-Lago cost and security ,0,3,3,46,2,8,0,49,0
"Rugby star filmed attack on ex-wife's 'new partner' after bugging her home to catch them together, court hears",0,2,1,87,5,17,0,88,0
Bill Paxton's death certificate reveals heart defect ,0,3,2,43,1,7,0,45,0
Trident: Barack Obama administration asked David Cameron to keep failed nuclear missile test launch secret,0,3,5,86,1,14,0,91,0
Le Pen Says French Foreign Policy Must Be Decided in Paris,0,3,10,38,0,10,0,48,0
Damian Lewis and Paul Giamatti explain why ‘Billions’ Season 2 is more relevant than ever,0,2,6,66,2,14,1,72,0
Unilever Sets Up U.K.-Netherlands Clash in Search for New Home,0,3,10,40,3,9,0,50,0
George Brandis takes aim at Penny Wong after Question Time attack on One Nation,0,3,8,58,0,13,0,66,0
"Grief, Anger at Funerals for Victims of Egypt Church Bombings",0,3,7,44,1,9,0,51,0
Wife of Russian dissident blames Kremlin for husband's mysterious illness,0,3,3,60,1,9,0,63,0
"Rangers Win in Overtime, Despite 12 Penalties",0,1,5,31,1,6,2,36,0
UK union ups strike stakes at services for unemployed,0,1,2,43,0,8,0,45,0
Fireball lights up sky across Canadian prairies,0,1,2,39,0,6,0,41,0
Denim-garbed Canadian snowmobile daredevil is your new role model,0,3,2,54,1,8,0,56,0
Inside the Baghdad Music and Ballet School Some Iraqis Call ‘Immoral’,0,3,9,48,2,10,0,57,0
Chaffetz calls on ethics head to testify day after chief criticized Trump ,0,3,2,60,0,12,0,62,0
Judge issues final order upholding Alabama same-sex marriage,0,2,2,50,1,7,0,52,0
Four young girls killed in Zambia wall collapse,0,1,2,38,0,7,0,40,0
World leaders react to death of Osama bin Laden,0,1,3,36,0,8,0,39,0
Western Mosul Reduced to Rubble in Fight to Oust ISIS,0,2,10,34,0,9,0,44,0
Meet Lara: Facebook's first chatbot 'dating coach' will set you up with someone based on your interests,0,3,3,80,4,16,0,83,0
More than 100 killed in southern Sudan tribal clash,0,1,2,38,0,8,3,40,0
Erdogan Calls Dutch ‘Nazi Remnants’ After Turkish Minister Is Barred ,0,3,10,47,2,10,0,57,0
A teenager wouldn't stop dabbing as his dad was sworn in by the Speaker of the House The list,0,3,4,70,1,18,0,74,0
Omnifone Nears Broadband Music Service in Europe,0,1,6,36,0,6,0,42,0
Uber and Lyft drivers share the 14 weirdest things they've ever experienced on the job,0,3,2,67,1,14,2,69,0
Meet the volunteers caring for senior citizens’ dogs,0,3,1,43,1,7,0,44,0
Turkish opposition to appeal referendum result that expanded Erdogan's powers,0,3,2,65,1,9,0,67,0
The Story of the Dress That Might Win 'La La Land' the Costume Oscar,0,3,11,42,2,13,0,53,0
Assisted-suicide doctor Jack Kevorkian to run for US Congress,0,1,6,46,1,8,0,52,0
Standing up straight could help symptoms of depression - study,0,3,1,51,1,9,0,52,0
Chinese Group to Pay Record $2.2 Billion for Hong Kong Land,0,2,8,37,2,10,2,45,0
"Donald Trump suspends US refugee program, indefinitely bars Syrians",0,3,5,53,1,8,0,58,0
Here's One Reason Why Trump's Legislative Agenda Is Flailing,0,2,9,41,2,8,0,50,0
Forest Whitaker’s Character Studies,0,3,4,27,1,3,0,31,0
There's A Prosecco-Flavored Edible Nail Polish Because Why Not,0,3,10,42,2,8,0,52,0
You Can Still Sign Up For Health Insurance Today,0,3,9,31,0,8,0,40,0
UAE launches national authority for scientific research,0,1,3,46,0,6,0,49,0
Cat Shreds On A Sled,0,3,5,11,0,4,0,16,0
Scientist Promotes Idea of Chaco Meridian in Southwest,0,1,6,41,0,7,0,47,0
Sarah Palin: President Trump Should ‘Call for the Unshackling of the Political Bands Tying Us to the UN’,0,3,13,71,3,17,0,84,0
Scots report crime using Facebook,0,1,2,27,0,4,0,29,0
Red Bulls Let Win Slip Away in Final Minute vs. Revolution,0,1,9,38,1,10,0,47,0
Ghent Library moves home via human chain,0,3,2,32,0,6,0,34,0
"5 Things to Read Today: Pearl Harbor Attack’s 75th Anniversary, Senate Clears Bill to Ease FDA Approvals, and More ",0,3,16,73,4,19,3,89,0
Quebec man found not guilty in shooting death of Laval officer,0,1,2,50,0,10,0,52,0
This breast pump is legit quiet enough to use on a conference call,0,3,1,53,0,12,0,54,0
Army Veteran Accused of Helping Fake Islamic State Attack in Kansas City,0,3,10,51,0,11,0,61,0
"Rhoden: In Detroit and Oakland, Coaches Combat the Culture of Losing",0,1,8,48,2,10,0,56,0
"Tired Of Waitlists And Uncertainty, Some Chinese Favor U.S. Visa Over Green Card",0,3,14,51,3,12,0,65,0
Did You Know Mixing Chocolate With Caffeine Can Ease Anxiety And Help You Focus Better?,0,3,15,57,1,14,0,72,0
New Illinois Law Enlists Hairstylists to Prevent Domestic Abuse,0,3,8,47,0,8,0,55,0
U.S. Army to court-martial Abu Ghraib officer,0,1,5,31,3,6,0,36,0
CeeLo Green Says He's 'Alive and Well' After Cell Phone Explosion Video Surfaces,0,3,13,52,3,12,0,65,0
"Eddie Murphy Teases a 'Coming to America' Sequel, and People Go Insane",0,3,9,47,3,11,0,56,0
Mrs. Obama Visits Students as Motivator in Chief,0,1,6,34,1,7,0,40,0
How a GPS Glitch Can Change the Taste of Your Salad,0,2,10,31,0,10,0,41,0
Wayne Rooney has equalled the record – but what does the future hold for striker?,0,3,2,63,2,14,0,65,0
That Thing With Feathers Trapped in Amber? It Was a Dinosaur Tail ,0,3,10,43,1,12,0,53,0
Petraeus calls for care in using term 'radical Islamic terrorism',0,3,2,52,2,9,0,54,0
"Trump makes rounds in DC, after completing Cabinet line-up ",0,3,4,44,2,9,0,48,0
Le fail: France loses biggest upset in Women's World Cup history,0,2,5,47,2,10,0,52,0
Uber and Lyft drivers share the 14 weirdest things they've ever experienced on the job,0,2,2,67,1,14,2,69,0
The ‘Sandman’ Editor’s Next Move,0,2,5,20,3,4,0,25,0
6 of Rihanna's Coziest Looks From Her Fenty x Puma Line,0,3,8,35,1,10,1,43,0
Joss Whedon Poised to Direct a Batgirl Movie ,0,2,6,31,0,8,0,37,0
Omidyar charity gives $100 million to boost journalism and fight hate speech,0,2,1,60,1,11,3,61,0
A Night Frozen in Time,0,1,4,14,0,4,0,18,0
Cheetahs and Blue Bulls to meet in 2006 Currie Cup rugby final,0,1,5,42,0,11,4,47,0
Hate Doing Laundry? This Is the Robot for You,0,3,7,29,1,8,0,36,0
If Adele's 'Hello' Was About Calling Congress,0,2,7,29,3,6,0,36,0
"Deal of the Week: Intel Buys Mobileye; What's Softbank's ""Vision''?",0,3,8,42,8,9,0,50,0
Hong Kong and Mumbai Have Some of the Most Unaffordable Housing,0,3,8,45,0,10,0,53,0
13 drug-resistant TB cases reported in Thailand,0,1,3,35,1,6,2,38,0
McDonald's pull sliced tomatoes from menu in US,0,1,4,35,1,7,0,39,0
French fry 'king' J. R. Simplot dies at age 99,0,1,4,27,4,9,2,31,0
"Novartis Profit Rises 62%, but Outlook Dims",0,1,5,28,2,6,2,33,0
North Korea: Is Kim Jong Un 'the world's most dangerous man'?,0,3,6,40,5,10,0,46,0
CanadaVOTES: NDP candidate Katy Austin running in Simcoe—Grey,0,1,13,39,2,7,0,52,0
Lorde blesses us all with another new song and album release date,0,3,1,53,0,11,0,54,0
A neurologist captured these bizarre and creepy images to study the physics of human expression,0,2,1,80,0,14,0,81,0
"From Lincoln to Obama, How Crowds at the Capitol Have Been Counted ",0,3,9,45,1,12,0,54,0
"According To This Fake Voter ID, Salman Khan Is 64-Year-Old And Not 51 As We Thought!",0,3,17,45,4,15,4,62,0
"Deadly boiler explosion: At least 3 killed, 4 injured at Missouri business ",0,3,3,56,2,12,2,59,0
European Union to train Somali security forces,0,1,3,37,0,6,0,40,0
Eye Opener: Bitter cold breaks records across U.S.,0,3,5,35,3,7,0,40,0
Luis Fonsi Talks Anatomy of 'Despacito': 'I Wanted to Make a Fun Song That Would Make People Want to Dance',0,2,16,67,5,19,0,83,0
Winter storm plasters the Northeast — snow totals 17 inches and counting,0,3,2,56,1,11,2,58,0
"Immigration hawks buoyed by Trump picks for DHS secretary, AG ",0,3,7,44,1,10,0,51,0
DJ Khaled Confirms Nicki Minaj Is on 'Grateful',0,3,8,30,2,7,0,38,0
8 Silicon Valley CEOs Who Condemned Donald Trump's Immigration Order In The Strongest Of Words,0,3,16,62,1,14,1,78,0
Next Shuttle flight delayed to next year; ISS crew begin spacewalk,0,1,5,50,1,10,0,55,0
Hillary Iran Deal Support Disqualifies Her as Commander-in-Chief,0,2,8,47,2,7,0,55,0
Trump administration files notice it will appeal ruling against second version of travel ban,0,2,1,78,0,13,0,79,0
Blind woman claims she was kicked off American Airlines flight with service dog ,0,3,3,64,0,13,0,67,0
Broadcasting U.S. Open Is Like Four Rounds of Juggling,0,1,9,35,2,8,0,44,0
"‘Pepsi Rajdhani’ & ‘Coke Shatabdi’, Indian Railways Plans To Brand Trains And Stations",0,2,12,56,6,12,0,68,0
American Injured in Turkey Nightclub Calls Attack 'a Massive Tragedy' ,0,2,8,50,2,10,0,58,0
Film director Sydney Pollack dies at age 73,0,1,3,31,0,7,2,34,0
Rise in Consumer Prices Eases Deflation Fears,0,1,6,33,0,6,0,39,0
Trade Deficit in U.S. Narrows in February to Four-Month Low,0,3,9,38,3,9,0,47,0
Brooklyn Beckham got his first tattoo and the internet has a lot of questions,0,3,2,62,0,13,0,64,0
"China’s Global Shopping Spree Sparks Opposition at Home, Too",0,3,8,42,2,8,0,50,0
Rachel Weisz wants Botox ban for actors,0,1,3,30,0,6,0,33,0
Fiat Nearing a Deal for Chrysler Stake,0,1,5,27,0,6,0,32,0
More Customers Give Up the Cellphone Contract,0,1,6,33,0,6,0,39,0
Bankruptcy Could Be More Costly,0,1,5,22,0,4,0,27,0
Favorites and a Few Surprises Emerge at Wimbledon,0,1,5,37,0,7,0,42,0
Thousands Shut Down Ireland’s Streets In Legal Abortion Protests,0,3,9,46,1,8,0,55,0
"Bigfoot, Tasmanian tigers and night parrots: Searching for the mythical or mysterious",0,3,3,69,2,11,0,72,0
Syria: Celebrations as families return to homes in Aleppo,0,3,3,45,1,8,0,48,0
70 killed after tanker explosion in Nigeria,0,1,1,34,0,6,2,35,0
Former Norwegian prime minister detained at Dulles Airport for an hour. He visited Iran in 2014.,0,3,6,69,2,15,4,75,0
Freddie Starr arrested as part of Savile child sex inquiry,0,1,3,46,0,9,0,49,0
"Derek Jeter, Jeb Bush Among Bidders Reportedly Interested in Buying Marlins",0,3,10,54,1,10,0,64,0
Pound sterling to stay at record lows even after Article 50 is triggered,0,3,2,56,0,12,2,58,0
Another Democrat Trashes Elie Wiesel: ’Holocaust Whore’,0,2,7,39,3,6,0,46,0
"Inauguration protesters to be barred from National Mall, other sites",0,3,3,55,1,9,0,58,0
BC election writ drops; referendum campaigns underway,0,1,2,44,1,6,0,46,0
"Indian Hackers Leak 1.7 Million Snapchat Users' Data As Payback For Alleged ""Poor Country"" Comment, Claims Report",0,3,16,74,5,16,2,90,0
VP Cheney role surfaces in U.S. domestic spying,0,1,5,33,2,7,0,38,0
'It couldn't happen': Top intelligence officials are shooting down Trump's allegations of wiretapping,0,3,3,81,5,12,0,84,0
Major snowstorm sweeps across Eastern US,0,1,4,31,0,5,0,35,0
Indonesian volcano eruption prompts thousands to evacuate,0,1,1,50,0,6,0,51,0
"Fast Food for the Dude: Greasy, Fatty, Salty Is Red-Hot Formula",0,2,10,39,4,10,0,49,0
Fourteen dead in two attacks in Somalia,0,1,2,31,0,6,0,33,0
"Daw Aung San Suu Kyi, Burmese Pro-Democracy Leader, Goes on Trial",0,1,11,41,3,10,0,52,0
President Trump: I Get 4 to 5 Hours of Sleep ,0,2,6,26,1,10,2,32,0
Reeperbahn rendezvous: the glorious dive bar photos of Anders Petersen,0,3,3,57,1,9,0,60,0
Should Ivanka Trump the Woman Wear Ivanka Trump the Brand? ,0,3,8,40,1,10,0,48,0
Former Guatemalan president arrested,0,1,2,31,0,3,0,33,0
Adidas apologizes for email congratulating runners who ‘survived’ Boston Marathon,0,3,3,67,2,9,0,70,0
Eric Prydz Releases Hopeful Pryda Track 'Lillo' in Honor of Fan Who Passed of Cancer: Listen,0,3,13,61,3,15,0,74,0
Kim Jong-nam: VX dose was 'high and lethal',0,3,4,28,4,7,0,32,0
"Our Mob, God's Story: Indigenous artists share Christian faith through painting",0,3,6,60,3,10,0,66,0
Australia names squad for remaining 2010 football World Cup qualifiers,0,1,3,54,0,9,4,57,0
"Amgen’s Repatha Study Shows Reduced Risk of Heart Attack, Stroke",0,2,9,44,2,9,0,53,0
Man buys his stolen camera on eBay,0,1,2,26,0,6,0,28,0
Trump’s FBI comments to Russians were aimed at cooperation: aides,0,2,5,49,2,9,0,54,0
"Nigerian 'witch boy' Hope 'happy', 'healthy' a year after being rescued from streets",0,3,2,63,7,12,0,65,0
Samantha Bee dives into the 'deep state' conspiracy,0,3,2,40,2,7,0,42,0
"Military Planners, in Nod to Obama, Are Preparing for a Faster Iraq Withdrawal",0,1,9,55,2,12,0,64,0
Beijing park dispenses loo roll using facial recognition,0,3,1,48,0,7,0,49,0
2007/08 Bundesliga: Bayern Munich vs. Hertha BSC Berlin,0,1,8,31,3,7,6,39,0
US to reduce nuclear weapons arsenal,0,1,2,29,0,5,0,31,0
Nancy Pelosi named new Speaker of the US House of Representatives,0,1,7,48,0,10,0,55,0
Thousands Congregate in Bethlehem to Celebrate Christmas,0,2,5,45,0,6,0,50,0
"Brands Try to Blacklist Breitbart, but Ads Slip Through Anyway ",0,3,8,44,1,10,0,52,0
UK Prime Minister announces date for general election,0,1,4,42,0,7,0,46,0
Seth Meyers slams the GOP 'power grab' against North Carolina's governor-elect,0,3,7,57,4,10,0,64,0
Man Monis's girlfriend Amirah Droudis sentenced to 44 years' jail for murder of his ex-wife,0,3,4,68,3,14,2,72,0
First trial without jury given the go-ahead in the UK,0,1,3,40,1,9,0,43,0
Tillerson: US strategy on North Korea relies on China's participation ,0,3,6,52,2,10,0,58,0
New Survey Shows No One in Tech Actually Cares About Diversity,0,2,10,42,0,10,0,52,0
News One in four Ryanair passengers forced to put cabin bags in the hold,0,2,3,56,0,13,0,59,0
"#MarchForScience spreads to Antarctica, Arctic Circle",0,3,6,40,2,5,0,46,0
Fidel Castro: A First-Person Account of the Day the Music Stopped in Cuba,0,2,10,49,2,12,0,59,0
FedEx slides after earnings miss,0,3,2,26,0,4,0,28,0
Sex toy 'armed' robber jailed,0,1,1,22,2,4,0,23,0
Idaho judge says rape is 'a direct consequence of the social media system',0,3,1,59,2,12,0,60,0
700 Merrill Employees Received $1 Million Bonuses,0,1,5,33,1,6,4,38,0
Gunman charged with killing three in Wisconsin shooting,0,1,2,46,0,7,0,48,0
Work From Stimulus Package to Add Some Speed to Trains,0,1,8,37,0,9,0,45,0
Venue Owned by Hall & Oates' Daryl Hall Sues Over Occupancy Clash,0,3,10,42,2,11,0,52,0
Premier Casting U.S. Withdrawal as Iraq Victory,0,1,7,32,2,6,0,39,0
"Princess Charlotte 'sleeps through night', reports Prince Charles",0,3,4,51,3,7,0,55,0
Non-infectious diseases such as cancer rising sharply in Africa,0,3,2,52,1,8,0,54,0
Florida Man Allegedly Kills Woman and Has Sex With Her Corpse After She Rebuffs His Advances,0,3,15,62,0,15,0,77,0
Merry XXXmas! Christmas shoppers are stunned by a German department store's VERY rude window display,0,3,10,74,2,14,0,84,0
The Stock Market Impact Of Trump-Ryan Tax Cuts,0,3,9,29,1,7,0,38,0
J. Geils found dead in Massachusetts home at age 71 ,0,3,3,36,1,10,2,39,0
Turkey sets the price to lift the ban on YouTube and Google services,0,1,4,52,0,12,0,56,0
Watch John Legend & Cynthia Erivo Pay Tribute to Artists Who Passed in 2016 at the 2017 Grammys,0,3,11,58,1,17,8,69,0
Prices at the pump spike overnight in U.S.,0,1,3,30,2,7,0,33,0
The Braves Sign Glavine to a One-Year Contract,0,1,7,31,1,7,0,38,0
Defense secretary: North Korea’s weapons capabilities a ’serious threat’,0,2,3,57,4,8,0,60,0
"In Gaza, Weighing Crimes and Ethics in Urban Warfare",0,1,7,36,1,8,0,43,0
British Postage Service Honors David Bowie with 10 Commemorative Stamps,0,3,8,52,0,9,2,60,0
China Sees a Presumptive Winner in 2022 Olympics - China Real Time Report,0,3,9,47,1,12,4,56,0
"Lady Gaga, Metallica to Duet at Grammys",0,3,5,27,1,6,0,32,0
UFC: Rousey’s comeback halted in first round by Nunes,0,2,5,38,2,8,0,43,0
Blog alliance forms over leaked Downing Street memo,0,1,3,41,0,7,0,44,0
1960s Activist Says ’Offensive’ To Equate Transgender Claims With Racial Equality - Breitbart,0,2,11,63,3,12,4,74,0
Former Obama Spokesperson Gibbs Heads Communications at McDonald's | Fox Business,0,3,10,59,2,10,0,69,0
"LeBron James Had Drake's ""Lose You"" Track Months Before Release",0,3,11,40,3,9,0,51,0
Berliners get an appetite for refugees’ cuisine,0,3,1,39,1,6,0,40,0
Sony's DRM protected CDs install Windows rootkits,0,1,7,35,1,6,0,42,0
Guidant announces more defibrillator problems,0,1,1,40,0,4,0,41,0
US President Barack Obama test drives Chevy Volt in Michigan,0,1,8,43,0,9,0,51,0
"Iraqi troops fighting ISIS storm Mosul government complex, then pull back",0,3,6,56,1,10,0,62,0
Ben Carson: slaves were immigrants with dreams their family could find prosperity in America,0,2,3,75,1,13,0,78,0
EPA emerges as major target after Trump solicits policy advice from industry,0,2,4,61,0,11,0,65,0
'Breaking Bad' Fanatic Given Life in Prison for Killing Cop and Attempting to Dissolve Body in Acid,0,3,12,69,2,16,0,81,0
"Trump softens tone in Sunday appearance, talks tornadoes and NAFTA",0,3,7,49,1,9,0,56,0
"On Foreign Policy, Obama’s Crown Has Proved Too Heavy for Him",0,2,10,39,2,10,0,49,0
Trump's America Donald Trump says Mexico will repay United States for cost of border wall,0,3,7,67,1,14,0,74,0
"Trump Says 'Major, Major' Conflict With North Korea Possible, But Seeks Diplomacy",0,3,12,54,4,11,0,66,0
Madeleine Albright’s defense of Clinton’s foreign policy was weak on the merits,0,2,3,63,2,11,0,66,0
Revisited ‘Last Tango in Paris’ Rape Scene Causes Internet Outcry - The New York Times,0,2,13,56,3,14,0,69,0
Iman Shumpert Rumored to Be a Trade Target for Minnesota Timberwolves,0,3,8,51,0,10,0,59,0
"In A Bid To Save Cows, Madhya Pradesh Will Ban Plastic Bags From May 1",0,3,14,40,1,14,1,54,0
U.S. and China Quarrel Over Sea Confrontation Near Hainan,0,1,9,38,2,8,0,47,0
Man jailed for six years for killing banker with one punch,0,3,1,47,0,10,0,48,0
Coalition Of Abortion Providers Sues Texas Over 'Fetal Burial' Rules,0,3,10,47,2,9,0,57,0
Roundup: Smart Thoughts On Ryan Lochte And White Privilege,0,2,9,40,1,8,0,49,0
New FBI photos show devastation at the Pentagon after 9/11 attacks,0,3,5,47,1,10,3,52,0
Facebook to start putting warning labels on 'fake news',0,3,1,44,2,8,0,45,0
"Wikinews interviews Kent Mesplay, Green Party presidential candidate",0,1,5,55,1,7,0,60,0
A group demanded a space for students of color. Now they say they’re being called racists.,0,2,2,70,3,15,0,72,0
Equity Hedge Funds Best Start Since 2013 Fueled by Asia Wagers,0,3,9,39,0,10,4,48,0
Groundhog predicts 6 more weeks of winter weather for US,0,1,3,43,0,9,1,46,0
Barclays Says It Will Not Seek Bailout,0,1,7,25,0,6,0,32,0
Katniss makes a final stand in 'Hunger Games: Mockingjay -- Part 2' trailer,0,3,5,52,5,12,1,57,0
Romanian PM to 'press ahead' with corruption decrees as protests grow,0,3,3,54,2,10,0,57,0
Soviet leader Gorbachev says a new union could rise again,0,3,2,46,0,9,0,48,0
"Trump Speaks With Taiwan’s Leader, an Affront to China ",0,2,7,37,2,9,0,44,0
Golden Globes 2017: See All the Stars on the Red Carpet,0,3,7,33,1,10,4,40,0
Tour de France: Tom Boonen wins stage 12,0,1,4,26,1,7,2,30,0
Why Fox stock is immune to Bill O'Reilly scandal,0,3,5,34,1,8,0,39,0
Two Kenyans kidnapped in Somalia by gunmen,0,1,3,33,0,6,0,36,0
"Exclusive: Obama, aides expected to weigh Syria military options on Friday",0,2,4,58,2,10,0,62,0
Stowaway snake flies from Brisbane to New Zealand on private jet,0,3,4,50,0,10,0,54,0
Market maker Bernard L. Madoff arrested in $50B 'giant Ponzi scheme',0,1,6,46,4,10,2,52,0
Silent protest in Athens over recent fires,0,1,2,34,0,6,0,36,0
Verdicts announced in France's largest child abuse case,0,1,2,45,1,7,0,47,0
Trump and Spicer’s remarks about British ‘wiretapping’ are absurd – and dangerous,0,3,3,63,4,11,0,66,0
Tropical storm Erin forms in Gulf of Mexico,0,1,4,32,0,7,0,36,0
Jeb Bush seeks to stir passions no logo can reach as 2016 launch looms,0,2,2,51,0,13,4,53,0
"White House aide: Kellyanne Conway's endorsement of Ivanka Trump's brand was 'light-hearted, flippant'",0,3,6,77,7,12,0,83,0
No one can keep a straight face in this 'SNL' sketch about chocolate,0,3,4,50,2,12,0,54,0
Fox News falsely reported that the Quebec terrorism suspect was Moroccan. Then Canada got mad.,0,3,6,72,2,14,0,78,0
South Korea Seeks Arrest of Samsung Chief Suspected of Bribery,0,2,8,45,0,9,0,53,0
A raptor strikes at sunset,0,2,1,21,0,4,0,22,0
Muslim group subtly trolls Trump with 'Making America Great' billboards,0,3,5,55,2,9,0,60,0
'The world's doors were closed': Jared Kushner's grandma on refugee life,0,3,3,54,5,10,0,57,0
Let the Red Carpet Knockoff War Begin,0,2,6,25,0,6,0,31,0
"Finland offers helicopters, personnel to assist Greece with forest fires",0,1,2,60,1,9,0,62,0
"Yiannopoulos Quits Breitbart, Apologizes for Uproar Over Year-Old Comments",0,3,9,55,2,8,0,64,0
John Clarke: Paul Keating honours '10 out of 10' satirist's ability to reveal truths,0,3,4,59,4,13,4,63,0
Mumps Outbreak Reaches 367 Cases in Washington State; Numbers Expected to Rise ,0,3,9,54,1,12,3,63,0
The lack of women in tech is getting worse,0,3,1,33,0,8,0,34,0
ISIS claims 2 suicide bombings in Baghdad; 16 people killed,0,2,5,41,1,9,3,46,0
deadmau5 Files Trademark Petition to Protect His Cat Meowingtons' Brand,0,3,8,52,1,9,1,60,0
Alton Towers crash: Leah Washington has leg amputated,0,3,4,41,1,7,0,45,0
"Buffalo, NY firefighter injured while battling blaze",0,1,3,42,1,6,0,45,0
Burmese government denies ongoing genocide of Rohingya Muslims,0,3,3,52,0,7,0,55,0
'Crazy Ex-Girlfriend' Star Rachel Bloom Breaks Down Four Standout Songs From New Season 2 Soundtrack,0,3,15,67,3,14,1,82,0
ISO 2 Affordable Bedrooms In NYC? Good Luck With That,0,2,13,29,1,9,1,42,0
India and Pakistan Agree to Fight Terror Together,0,1,6,36,0,7,0,42,0
Exclusive: Watch the Premiere of Soen's 'Lucidity' Video,0,3,6,39,4,7,0,45,0
Netmarble Looks Set to Score South Korea’s Biggest IPO Since 2010 ,0,2,11,39,1,11,4,50,0
Former national security adviser Michael Flynn's security clearance suspended ,0,3,3,65,1,9,0,68,0
Trump's America Trump appoints General HR McMaster as new national security adviser,0,3,8,63,1,11,0,71,0
Cuisinart Recall ‘Just Screwed Up the Holidays for a Lot of People’ ,0,3,8,46,2,12,0,54,0
"Al Jarreau, Grammy-winning jazz singer, dead at 76",0,3,3,35,3,7,2,38,0
Hate Performance Reviews? Good News: They're Getting Shorter And Simpler,0,3,10,50,3,9,0,60,0
"Zambian ""porn"" journalist found not guilty",0,1,1,34,2,5,0,35,0
"In Sun, Oracle Sees a Software Gem",0,1,6,21,1,6,0,27,0
"Before Duterte was the Philippines’ president, he was ‘the Death Squad mayor’",0,2,5,57,4,11,0,62,0
Former CIA agent indicted after leaking classified information,0,1,4,51,0,7,0,55,0
Dramatic NatGeo photos show how climate change is transforming the world,0,3,3,59,0,10,0,62,0
Bombings reported in Bangkok,0,1,2,23,0,3,0,25,0
"WhoSay - #CelebsUnfiltered, Social Celebrities, Entertainment News, Photos, Videos, and Exclusives",0,3,11,70,7,10,0,81,0
Pakistani Reporter Is Killed After Rally for Taliban Truce,0,1,8,42,0,8,0,50,0
Supreme Court sends Obamacare contraception case back to lower courts,0,2,3,57,0,9,0,60,0
Last chance to sign up for Obamacare for 2017 coverage,0,2,2,39,0,9,4,41,0
Will Smith's Killer Cardell Hayes Sentenced to 25 Years for Manslaughter,0,3,8,51,1,10,2,59,0
Trump’s Tweet-And-Switch On Shutdown And Flynn,0,2,8,30,3,5,0,38,0
Fake impotence drugs linked to low blood sugar outbreak,0,1,1,46,0,8,0,47,0
New Guideline Will Allow First-Year Doctors to Work 24-Hour Shifts - The New York Times,0,2,14,54,3,14,2,68,0
"Sales Fall 10%, but Home Depot Tops Forecasts",0,1,6,28,2,7,2,34,0
People who are underweight as well as those who are obese are more likely to suffer from migraine,0,2,1,79,0,17,0,80,0
Brexit jitters mean less junk mail (and less money for the Royal Mail),0,2,3,53,2,12,0,56,0
People Are Freaking Out Over Patrick Stewart In Drag Compared To Kellyanne Conway,0,2,13,56,0,12,0,69,0
Miley Cyrus had a weed bar at Liam Hemsworth and Wayne Coyne's birthday party,0,2,6,57,1,13,0,63,0
Raids take place as enquiry into failed UK bombings continues,0,1,3,49,0,9,0,52,0
Andy Richter Returns As Conan's Sean Spicer After Greatest Monologue Ever,0,3,11,51,1,10,0,62,0
Stampede at rally in Kenya kills at least five; dozens wounded,0,1,2,49,1,10,0,51,0
Senator Responds to Trump’s N.R.A. Speech With Photos of Shooting Victims ,0,3,11,48,4,11,0,59,0
Cambodian police officer accused of faking being hit by politician's car,0,3,1,60,1,10,0,61,0
US House of Representatives passes health care bill,0,1,4,40,0,7,0,44,0
Travis Scott Says He's 'So Hurt' About Grammy Snub,0,2,9,30,3,8,0,39,0
UK government formally launches same-sex marriage legislation in Parliament,0,1,3,63,1,8,0,66,0
STS-116 launch scrubbed,0,1,3,14,1,2,3,17,0
"In Africa, a Homegrown Rival Takes On Netflix",0,3,7,30,1,7,0,37,0
Eat Me: A Natural and Unnatural History of Cannibalism – review,0,2,7,44,2,10,0,51,0
Ranking College Football's Top Big-Play Threats in 2017,0,2,7,35,2,7,4,42,0
Trump’s Take on Foreign Policy Breaks Transition Taboo,0,2,7,39,1,7,0,46,0
Mike Trout surprises young fan with gifts - SportsNation - ESPN,0,2,8,43,2,10,0,51,0
Dallas Cowboys Cowboys 'Hire' Wrestling Icon Sting as Intimidation Coach,0,3,9,52,2,9,0,61,0
Tearful reunion between a boy and his neighbor's dog after a year apart - Yahoo,0,3,2,61,2,14,0,63,0
"Trump Shows He Is Willing to Act Forcefully, Quickly ",0,3,8,35,1,9,0,43,0
Georgian spy plane shot down,0,1,1,23,0,4,0,24,0
John Lewis Captures Spotlight After Calling Trump Illegitimate,0,3,8,47,0,7,0,55,0
Coral Bleaching Now Covers Over Two-Thirds of Great Barrier Reef: Scientists,0,3,11,53,2,10,0,64,0
Italian chocolatemaker Ferrero rules out buying UK's Cadbury,0,1,5,47,1,7,0,52,0
Moguls’ Feud Puts Berlusconi’s Italian Media Empire in Play,0,3,8,41,2,8,0,49,0
Haitian priest Jean-Juste held in relation to the murder of a journalist,0,1,3,57,1,11,0,60,0
Mar-a-Lago Doubles Its Initiation Fee as Membership Interest Swells ,0,2,9,48,2,9,0,57,0
Newsmax CEO And Trump Friend Blames Reince Priebus For Rocky Start,0,3,13,43,0,10,0,56,0
Widow of Orlando nightclub shooter files petition to change child's name,0,2,2,59,1,10,0,61,0
Roman Polanski in Legal Bid to Return to US,0,3,7,28,0,8,0,35,0
British pop star Leona Lewis breaks US Billboard records,0,1,6,42,0,8,0,48,0
Obama adviser Susan Rice denies targeting Trump team,0,3,4,41,0,7,0,45,0
Jamie Foxx’s favorite jewelry designer is a 20-year-old college student,0,2,2,55,3,9,2,57,0
"Watch E! News Now Season 2016 Excerpt Free Online - 2016 Victoria's Secret Fashion Show: the Good, Bad and Ugly | Yahoo View",0,3,17,71,6,22,8,88,0
Icahn Pressed EPA Candidates on Ethanol Rule He Wants Scrapped,0,3,11,42,0,9,0,53,0
"For Bond Investors, a Focus on Scrutiny Over Timing",0,1,7,35,1,8,0,42,0
A War on Graffiti in Brazil,0,3,4,18,0,5,0,22,0
UK coach driver jailed for triple-death crash near London,0,1,3,45,1,8,0,48,0
Yahoo Reverses Its Web Strategy With New Videos,0,1,8,32,0,7,0,40,0
Ex-Penn St president guilty of 1 count of child endangerment ,0,3,3,46,1,10,1,49,0
Trump’s Mar-a-Lago Travel Triggers Cost and Ethics Concerns,0,3,8,41,3,7,0,49,0
Rumors say Cuban President Fidel Castro has died,0,1,5,36,0,7,0,41,0
MV Sirius Star oil tanker released by pirates,0,1,4,34,0,7,0,38,0
Even Small Changes In Global Temperatures Can Have Disastrous Consequences For Birds,0,3,12,61,0,11,0,73,0
NHC upgrades Tropical Depression Four-E to Tropical Storm Carlos,0,1,10,45,1,8,0,55,0
Strangers help seek match for teen in need of kidney,0,3,1,42,0,9,0,43,0
"Inscription reveals colossus unearthed in Cairo slum not of Ramses II, more likely Pharaoh Psamtek I",0,2,8,76,1,15,0,84,0
About time! Google will launch two flagship smartwatches early next year with Android 2.0 running the show ,0,3,3,83,2,17,2,86,0
Tillerson Treads a Fine Line in China Talks Amid North Korea Tensions,0,3,10,48,0,11,0,58,0
People Are Hysterical Because Cats Are Now Allowed In The Westminster Dog Show,0,3,13,53,0,12,0,66,0
Drake's 'More Life' Project Coming in Early 2017,0,2,6,28,3,7,4,34,0
Supreme Court hears border shooting case as Trump's travel ban awaits ,0,3,3,55,1,11,0,58,0
U.S. Congressman William Jefferson faces 16-count indictment for corruption,0,1,5,57,3,8,2,62,0
Prince William calls for end to stigma on mental illness ,0,2,2,45,0,10,0,47,0
Italian judge convicts 23 in CIA kidnapping case,0,1,4,35,0,7,2,39,0
Destinations Britain's 20 greatest landscapes,0,2,2,36,1,4,2,38,0
Chief of Independent News and Media to Resign,0,1,5,33,0,7,0,38,0
Canadian teams vie for spot at the World Curling Championship,0,1,4,48,0,9,0,52,0
Milo Ventimiglia Defended Rory Gilmore And Threw Shade At Dean And Logan,0,3,12,49,0,11,0,61,0
Donald Trump lashes out at union leader on Twitter,0,3,3,39,0,8,0,42,0
"Delta will pay you up to $10,000 to give up your seat",0,3,1,34,2,11,5,35,0
"Seek a Lost Ball, and Ye Shall Find",0,1,6,21,1,7,0,27,0
"No Zika detected in Florida mosquitoes so far this year, officials say ",0,2,3,55,1,12,0,58,0
"Farewell X-Men: Hugh Jackman, Patrick Stewart say life imitates art in Logan's finale",0,3,8,61,4,12,0,69,0
eSports is a massive industry -- and it's growing,0,3,1,37,3,8,0,38,0
Cop who fatally shot retiree during role-play scenario is fired,0,3,1,52,1,9,0,53,0
What to Stream: The Films of 'La La Land' Director Damien Chazelle [Video],0,3,11,46,5,12,0,57,0
Watching Alex Trebek Say 'Yas Queen' on 'Jeopardy' Will Make Your Day,0,3,11,43,4,11,0,54,0
Watch Ed Sheeran Tease New Music Coming This Week,0,3,9,32,0,8,0,41,0
North and South Korea exchange fire,0,1,3,27,0,5,0,30,0
Reports indicate Bush appointing friend to lead Plame inquiry,0,1,3,50,0,8,0,53,0
LeBron James Ethers Charles Barkley During Epic Post-Game Rant,0,3,11,42,1,8,0,53,0
Hebrew may be world's oldest alphabet ,0,3,1,30,1,6,0,31,0
Devon and Leah Still celebrate two years in remission ,0,3,3,42,0,9,0,45,0
"Boxing Gennady Golovkin vs. Danny Jacobs: Fight Date Announced, Comments, Reaction",0,2,10,58,4,10,0,68,0
Obama Tells Mayors to Spend Wisely,0,1,5,24,0,5,0,29,0
Pakistani Singer-Turned-Preacher Junaid Jamshed Among 48 Dead in Plane Crash,0,2,10,53,2,9,2,63,0
This 7-minute workout is all you need to get in shape,0,3,1,40,1,10,1,41,0
Security Blanket: New Moves to Slow China’s Wave of Acquisitions,0,3,8,45,2,9,0,53,0
Saudi Arabia Cuts Output in Accordance With OPEC Deal ,0,3,11,34,0,9,0,45,0
MLB stars on No. 42: What Jackie Robinson Day means to us,0,3,8,34,2,11,2,42,0
Australian rules football: West Gippsland Latrobe Football League Finals week one results,0,1,7,70,1,11,0,77,0
ITV Wales drops local news sign language,0,1,4,30,0,6,0,34,0
Showing Off Your Solutions in a White Paper,0,1,6,30,0,7,0,36,0
Oprah Winfrey for president? 'Now I'm thinking',0,2,4,33,4,6,0,37,0
Argentina to pay off IMF debt,0,1,4,20,0,5,0,24,0
"Churchill bust takes center stage as Trump, May reaffirm special relationship ",0,3,3,63,1,11,0,66,0
"White House Budget Cuts Entitlements $1.7 Trillion, Slashes EPA 30% - Breitbart",0,2,11,48,5,11,4,59,0
Jets player turns himself in for alleged Pittsburgh fight,0,2,2,47,0,8,0,49,0
Do Conference Tournaments Help or Hurt? Theories Abound,0,1,7,40,1,7,0,47,0
"Even With the Putter, Loft Is a Consideration",0,1,6,31,1,7,0,37,0
Country Style: Tips to take from the countryside's best dressed set,0,3,3,52,2,10,0,55,0
John Green Responded On Tumblr To Accusations Of Sexual Abuse,0,3,10,42,0,9,0,52,0
Vatican denies church is shielding war criminal,0,1,1,40,0,6,0,41,0
Trump wire-tap claim denied by ex-spy chief Clapper,0,3,2,40,2,7,0,42,0
Indonesian court overturns Garuda pilot's conviction over air disaster,0,1,2,59,1,8,0,61,0
"8 Habits That Make Millennials Stressed, Anxious And Unproductive",0,3,8,47,1,8,1,55,0
Clerics May Be Key to Outcome of Unrest,0,1,6,26,0,7,0,32,0
WebMD and HLTH Plan to Merge,0,1,9,14,0,5,0,23,0
"Gustav Metzger, 'Auto-Destructive' Artist Who Inspired Pete Townshend, Dies at 90",0,3,10,54,5,10,2,64,0
Beyonce Drops Out of Coachella Performance,0,3,5,32,0,5,0,37,0
Liz Claiborne Looks for a Mizrahian Lift,0,1,5,29,0,6,0,34,0
"SpaceX successfully launches Falcon 9 rocket, months after launch-pad blast",0,2,3,60,2,9,1,63,0
Going for a roll in the hay? French farmers become the latest profession to strip off for a VERY racy 2017 calendar,0,3,6,83,1,21,4,89,0
"Reddit ban results in new ""fat steeple hate"" subreddit - Business Insider",0,3,3,56,3,11,0,59,0
Adam Johnson secretly filmed saying he wished he had raped 15-year-old victim,0,3,2,60,2,11,2,62,0
Olympic skiing champion Jean Vuarnet dies aged 83,0,3,3,37,0,7,2,40,0
Watch Louis C.K. Get Edgy (Again) on 'Saturday Night Live',0,3,10,33,6,9,0,43,0
Lady Gaga Debuts New Single & Plays Beyonce Collaboration During 2017 Coachella Performance,0,2,11,63,1,12,4,74,0
"Trump Proposes Slashing Medical Research This Year, Too",0,2,8,39,1,7,0,47,0
Dresden Unveils Controversial Monument that Looks Like Radical Islamist Fortification,0,3,9,67,0,9,0,76,0
We Need To Talk About How “Love Actually” Has The Best Movie Soundtrack Ever,0,3,14,47,2,13,0,61,0
EPA Chief Still Doesn't Think Humans Are The Primary Cause Of Climate Change,0,3,15,48,1,12,0,63,0
Should designers dress Melania and Ivanka? The question is more complex than it seems.,0,3,4,67,2,13,0,71,0
U.S. Joins Rights Panel After a Vote at the U.N.,0,1,9,26,4,9,0,35,0
US border patrol chief has been asked to leave the agency by Trump administration,0,3,3,65,0,13,0,68,0
India Now Ranks 97th In The World With An Average Internet Speed Of 5.6 Mbps,0,3,13,44,1,14,4,57,0
Kathy Griffin Beheads Donald Trump in Bloody Shock Photo,0,2,8,40,0,8,0,48,0
Awkward Handoff of Lombardi Trophy Has Roots in Renegade Raiders ,0,3,8,47,0,10,0,55,0
"Trump’s Pick for Navy Secretary Withdraws Over Ethics Rules, Finances",0,3,9,49,2,9,0,58,0
Listen to Jidenna's Debut Studio Album 'The Chief',0,2,7,33,3,7,0,40,0
Report: Denver Broncos are in ‘driver’s seat’ to land Tony Romo,0,2,5,44,4,10,0,49,0
Can prefab homes solve UK's housing crisis?,0,2,3,32,2,6,0,35,0
These Photos Of Sachin Tendulkar Carrying Harbhajan Singh's Daughter Will Simply Melt Your Heart,0,3,14,68,1,13,0,82,0
Twelfth Night review – Tamsin Greig is brilliant in a show full of fun,0,3,4,52,1,13,0,56,0
NATO: 130 militants killed in Afghanistan,0,1,5,27,1,5,3,32,0
‘Split’ Tops Box Office Third Straight Week,0,3,7,28,2,6,0,35,0
Defense Lawyer Dismissed as Trial Over 2008 Mumbai Attacks Begins,0,1,8,44,0,9,4,52,0
"Trump’s Interests vs. America’s, Las Vegas Edition",0,2,6,34,4,6,0,40,0
Cooper claims he learned of Plame through Rove,0,1,3,36,0,7,0,39,0
The Draymond Green slur that enraged LeBron James,0,2,6,36,0,7,0,42,0
'Fake doctor' also worked for pharmaceutical giant AstraZeneca,0,3,3,50,2,7,0,53,0
74-Year-Old Man Arrested After Alleged 'Massacre' Of Kim Kardashian’s Books,0,3,11,48,5,9,2,59,0
UNICEF says 2016 worst year for Syrian kids yet,0,2,7,28,0,8,4,35,0
Jennifer Lawrence Prays For 'Compassion To Return To The White House' Amid Trump's Immigration Ban,0,2,15,66,3,14,0,81,0
Officials: Almost 100 killed in air raids in Pakistan,0,1,3,38,1,8,3,41,0
North Carolina Lawmakers Introduce Bill to Ban Same-Sex Marriage,0,3,9,46,1,8,0,55,0
The Democratic whip made an app,0,3,2,24,0,5,0,26,0
"In Peacekeeping, a Muddling of the Mission",0,1,4,31,1,6,0,35,0
"Catch Virgil Abloh and Guillaume Berg of Paris, IL on Episode 38 of OVO Sound Radio",0,3,14,51,1,15,2,65,0
"In ultimate insult, Trump rolls back EPA's climate policies from within the EPA",0,2,8,57,2,12,0,65,0
Too Many Favorite Shows? Take Them In at High Speed ,0,3,9,32,1,10,0,41,0
"Suspect accused of killing Georgia officer and wounding another is found dead, police chief says ",0,3,2,79,1,15,0,81,0
"Grammys: Adele pays tribute to Beyonce, Flume the only Aussie winner",0,3,5,51,2,10,0,56,0
"For Homeland Security Nominee, Good Leadership Is in the Details",0,1,8,46,1,9,0,54,0
Should DeVos Block an Embattled Student Loan Giant's Expansion?,0,2,9,44,2,8,0,53,0
'The Walking Dead' Season 7 Finale Features One Last Tearful Tribute,0,2,10,45,2,10,1,55,0
A Post-Brexit Roadmap for Disaffected Clinton Voters,0,2,7,38,1,6,0,45,0
Trump planning to sign updated travel ban early next week,0,2,1,47,0,9,0,48,0
Watch Live: Joe Biden Speaks at SXSW,0,3,9,20,1,6,0,29,0
Hospital Cafeteria Worker Saves Thousands of Dollars to Buy Toys for Kids at Christmas - Yahoo,0,3,11,67,1,15,0,78,0
"Beijing’s Pick Lam Chosen as Hong Kong Leader, in No Surprise",0,3,9,40,2,10,0,49,0
India's 'School for Justice' teaches human trafficking survivors to be lawyers,0,3,3,62,3,10,0,65,0
Ed Klein on DNC/Media Collusion: ‘You Can Cover the Circus but You Can’t Sleep with the Elephants’ - Breitbart,0,2,16,70,6,18,0,86,0
Chaos worked for Trump as a candidate. As president? Not so much,0,3,4,47,2,11,0,51,0
"MMA Ronda Rousey to Mayweather, McGregor: 'If Money Is the Motivation Then F--K You'",0,3,16,49,6,13,0,65,0
Iranian President Asks Court to Reconsider Spy Case,0,1,7,37,0,7,0,44,0
‘Extremist’ sect threatens protests against Dalai Lama during UK visit,0,3,5,54,2,9,0,59,0
"US Army website hacked, Syrian Electronic Army takes credit ",0,3,6,44,1,9,0,50,0
British Airways cabin crew begins strike,0,1,2,33,0,5,0,35,0
Yahoo boss Marissa Mayer loses millions in bonuses over security lapses,0,3,3,58,0,10,0,61,0
"Priebus defends Trump, top aide; says media has 'obsession' to 'delegitimize' president ",0,3,2,68,6,12,0,70,0
Creator of Web Cartoon xkcd Writing a Paper Book,0,1,6,34,0,8,0,40,0
How Democrats will use the GOP health care bill against Republicans in 2018,0,2,6,53,0,12,4,59,0
'Portlandia' Renewed for Eighth and Final Season,0,3,5,35,2,6,0,40,0
"A comet will fly past Earth on New Year's Eve. No, it's not a sign of the apocalypse.",0,3,6,57,5,17,0,63,0
Scottish FA apologise after fans boo Liechtenstein national anthem,0,1,4,54,0,8,0,58,0
"Scarlett Johansson says she 'will never, ever' comment on divorce from Romain Dauriac - Yahoo",0,3,5,70,4,14,0,75,0
Frank Ocean Co-Signs Meryl Streep's Golden Globes Speech,0,2,9,38,2,7,0,47,0
Hammond was a picture of relaxed swagger – because he was in the ring alone,0,2,1,59,1,14,0,60,0
Quiet rooms for autistic children popping up at airports,0,2,1,47,0,8,0,48,0
Macron’s rise shows that extremism – whether left or right – is not inevitable,0,3,1,61,3,13,0,62,0
99 million-year-old dinosaur tail found in chunk of amber bought at market,0,3,0,59,2,11,2,59,0
Deepika Padukone And Vin Diesel Get A Traditional Welcome After Landing In Mumbai!,0,3,13,56,1,12,0,69,0
Murdered journalist Hrant Dink feared for safety: brother,0,1,3,46,1,7,0,49,0
UN warns Gambia's President Yahya Jammeh must leave power when term ends,0,3,6,54,1,11,0,60,0
"Best U.S. Cities to Celebrate Pride, and What to Do There",0,3,9,35,3,10,0,44,0
UK Government in secret move to boost relations with Russia,0,3,4,46,0,9,0,50,0
"Facing German Suffering, and Not Looking Away",0,1,6,32,1,6,0,38,0
Ranveer Singh And Akshay Kumar Jamming On 'Hookah Baar' Is Absolutely Entertaining And Unmissable!,0,3,14,68,3,13,0,82,0
A Goth Male Soprano Who Plumbs the Darkness ,0,2,7,29,0,8,0,36,0
"Press fired up as Comey rejects Trump wiretap claim, offers no evidence on Russia probe ",0,3,4,68,1,15,0,72,0
Nick Cannon Threatens The National Enquirer With Lawsuit Over Upcoming Article,0,3,11,57,0,10,0,68,0
Singer George Michael Dies At 53,0,2,5,20,0,5,2,25,0
Trump's top oilman: Dakota tribes being used by 'fringe',0,3,2,42,4,8,0,44,0
"Migos, Jimmy Fallon, and The Roots Perform ""Bad and Boujee"" With Office Supplies",0,3,11,53,4,12,0,64,0
Michael Skakel’s Murder Conviction Has Been Reinstated ,0,2,7,40,1,7,0,47,0
Mulayam Singh Expels Son Akhilesh Yadav From Samajwadi Party + 5 More Stories You Need To Read Today,0,3,16,65,1,17,1,81,0
NYT: Immigration Hard-Liners Rising in Trump Administration,0,2,9,42,2,6,0,51,0
Backspin: Sebastian Bach on His Discography and Why ‘Heavy Metal Is for Life’ [Video],0,3,11,56,5,13,0,67,0
Beyonce Hits 100M Instagram Follows: See Her 10 Most Popular Posts,0,3,10,40,1,10,5,50,0
Thousands of American Airlines Flight Attendants: New Uniforms Making Us Sick,0,3,10,56,1,10,0,66,0
Bernie Sanders On The Attack Ahead Of Clinton Rally,0,2,9,34,0,8,0,43,0
Kellyanne Conway Has Referred To The Fake 'Bowling Green Massacre' Before,0,3,11,50,2,10,0,61,0
R&B singer D’Angelo sentenced on cocaine charge,0,1,4,35,2,6,0,39,0
NYPD Captain Apologizes for Controversial Comments on Rape,0,3,9,42,0,7,0,51,0
Doubts on yesterday's Italian Lotto and Superenalotto drawing,0,1,4,49,1,7,0,53,0
President Trump’s predecessors learned about tariffs the hard way,0,3,2,54,1,8,0,56,0
"20,000 Californian state workers may lose their jobs",0,1,1,38,1,7,5,39,0
"Autism could be caused by a lack of a protein in the brain, study finds",0,2,1,55,1,14,0,56,0
Nicaraguan campesinos tell Ortega to take his canal and shove it,0,3,2,52,0,10,0,54,0
Shadowy forces are fighting for control of your local movie theater,0,3,1,56,0,10,0,57,0
US air force colonel claims he spotted UFOs over Arkansas,0,1,6,42,0,9,0,48,0
UK study reveals smoking could shorten men's lives by 10–15 years,0,1,2,47,2,10,4,49,0
Zimbabwe prime minister Tsvangirai ends cabinet boycott,0,1,2,47,0,6,0,49,0
Under Armour drops as Wall Street traders focus on Spieth meltdown,0,2,5,51,0,10,0,56,0
Strategic arms talks between Russia and the US end without declaration,0,1,4,56,0,10,0,60,0
Eli Pariser: activist whose filter bubble warnings presaged Trump and Brexit,0,3,4,61,1,10,0,65,0
Manchester City weigh new Raheem Sterling bid after £30m cuts no ice,0,3,4,50,1,11,2,54,0
Anti-Trump Republicans Rush to Express Outrage over Trump Video with George H.W. Bush’s Nephew - Breitbart,0,2,14,72,5,15,0,86,0
A family found a rattlesnake in their toilet — then 23 more,0,3,1,44,1,11,2,45,0
Rise above: will Donald Trump's America trigger a punk protest renaissance?,0,2,4,58,3,10,0,62,0
"GOP Congress rolls back rules on hunting, broadband privacy ",0,2,4,46,1,9,0,50,0
Stephen Colbert takes on the horror of Trump's mass-texting capabilities,0,3,3,58,2,9,0,61,0
Man getting lost Purple Heart 66 years after brother's death ,0,3,3,45,1,10,2,48,0
Mom to carry baby without brain to full term to donate organs,0,3,1,49,0,11,0,50,0
Trump’s Revised Travel Ban Excludes Iraqis ,0,3,6,30,1,6,0,36,0
Bombings kill over 100 in Baghdad,0,1,2,23,0,5,3,25,0
14 GIFs That Perfectly Depict Oakland’s Black Barber Shops,0,2,10,37,1,8,2,47,0
Jenson Button wins 2009 Monaco Grand Prix,0,1,5,26,0,6,4,31,0
Reese Witherspoon Thinks Now Is The Perfect Time For 'Legally Blonde 3',0,3,11,46,2,11,1,57,0
'The Last Jedi' director shares an exciting peek of the opening crawl,0,3,3,53,2,11,0,56,0
"Not Only Is Miley Cyrus In Marvel's Next Movie, But She May Be Coming Back For Another One",0,3,18,53,2,17,0,71,0
17 Realities Everyone Who Is Child-Free By Choice Knows,0,2,9,35,1,8,2,44,0
Baylor hires Temple coach Matt Rhule,0,3,4,27,0,5,0,31,0
Twitter broadens its campaign against hate and abuse,0,2,1,44,0,7,0,45,0
Farm Exports Fall Sharply in Global Recession,0,1,6,33,0,6,0,39,0
"After Game 2 Loss, Devils Have Injury and Energy Concerns",0,1,8,38,1,9,1,46,0
Three killed in Utah coal mine rescue,0,1,2,29,0,6,0,31,0
Life Comes Full Circle For Sushmita Sen As She Returns To Manila To Judge The Miss Universe Pageant,0,3,18,64,0,17,0,82,0
"Quadruple Murder-Suicide ‘Up in the Wilderness,’ Police Say",0,2,7,41,4,7,0,48,0
Wall Street Closes Lower as Global Forecast Dims,0,1,7,34,0,7,0,41,0
Hastert pleads not guilty to 2 counts of fraud charges in hush-money scandal,0,3,1,61,1,12,1,62,0
Benedict Cumberbatch and Wife Sophie Hunter Have Baby Boy,0,3,8,41,0,8,0,49,0
Jenson Button wins half of the 2009 Malaysian Grand Prix points,0,1,5,44,0,10,4,49,0
South African President Jacob Zuma: Protesters racists,0,3,6,41,1,6,0,47,0
Syria still has chemical weapons says U.S. defense secretary,0,3,3,47,2,8,0,50,0
Joe Piscopo Considers Running for Governor of New Jersey. No Joke. ,0,3,9,45,2,11,0,54,0
UK study highlights child abuse by humanitarian workers,0,1,2,46,0,7,0,48,0
This top Brooklyn chef has been leaving an important message about immigrants on receipts The list,0,3,3,80,0,15,0,83,0
Swim team swaps pool for snow,0,2,1,23,0,5,0,24,0
"NFL playoff picture: Patriots, Raiders punch their tickets",0,2,5,44,2,7,0,49,0
Rubio camp hits New York Times for ‘absurd’ piece questioning his finances ,0,3,4,57,2,12,0,61,0
"'Yes We Did,' Obama Says in Farewell Address, but Warns of Threats to Democracy ",0,3,10,52,4,14,0,62,0
North Korea says it is ready to strike U.S. aircraft carrier,0,2,4,44,2,10,0,48,0
Bob Dylan receives Nobel Prize in Sweden,0,2,5,29,0,6,0,34,0
How to Predict Gentrification: Look for Falling Crime ,0,3,6,39,1,8,0,45,0
Watch President Trump's Address to the Joint Session of Congress Live Stream Here,0,3,10,58,1,12,0,68,0
Man Shot by ICE Agents During Attempted Arrest in Chicago: Police,0,3,11,43,1,10,0,54,0
Blue Apron Has Been Dinged For A “Serious” Worker Safety Violation — Again,0,2,12,47,3,12,0,59,0
G.M. Tries a New Tack to Win Government Aid,0,1,8,25,2,8,0,33,0
Israeli official: Proof of US role in UN vote to be given to Trump,0,2,7,45,1,13,0,52,0
"Gary Kubiak brings end to Broncos' locker room squabble, report says",0,3,3,53,2,10,0,56,0
"David Guttenfelder, a Photojournalist, Answers Readers’ Questions on North Korea ",0,3,8,60,3,10,0,68,0
British university falls short of Smurf gathering world record,0,1,2,52,0,8,0,54,0
Icy weather possible early Saturday in Washington,0,2,3,40,0,6,0,43,0
"Fred Thompson campaign staffer leaves, Thompson's political past scrutinized",0,1,3,63,2,8,0,66,0
"Flooding closes highways in eastern Iowa, US",0,1,4,33,1,6,0,37,0
The Resurgent Threat of al Qaeda,0,3,4,23,0,5,0,27,0
Sharing Selectively on Social Networking Sites,0,1,5,36,0,5,0,41,0
"Sorry, that page doesn’t exist!",0,3,1,23,3,4,0,24,0
"Jailed C.I.A. Mole Kept Spying for Russia, via Son, U.S. Says",0,1,12,32,7,10,0,44,0
The Times Reports Quarterly Loss of $74.5 Million,0,1,6,31,2,7,3,37,0
Syracuse buzzer-beater gave them an important upset win over Duke,0,2,2,53,1,9,0,55,0
"Russia Stockpiles the Gems, Awaiting the Return of  Demand",0,1,6,42,1,9,0,48,0
Presidential Intelligence Sharing Is Highly Precedented,0,2,6,44,0,5,0,50,0
"Brexit will reduce net migration to zero due to immigration controls on EU nationals, says report",0,2,3,78,1,15,0,81,0
DfE says £3bn savings for schools 'doable' without larger class sizes,0,3,2,53,3,10,1,55,0
Head of Joint Chiefs Praises Pakistani Operation,0,1,6,36,0,6,0,42,0
"Politicians avoid integration issues for fear of being seen as racist, Sajid Javid says",0,3,3,70,1,13,0,73,0
"Italian PM Prodi loses confidence vote, resigns",0,1,4,36,1,6,0,40,0
Doomed Jet Carrying Brazilian Team Reportedly Ran Out of Fuel ,0,3,9,43,0,10,0,52,0
"Science News Vantablack: It's blacker than black, but where is the world's darkest material being used?",0,3,4,79,5,15,0,83,0
"Jon 'War Machine' Koppenhaver Guilty of 29 Charges, Mistrial on Attempted Murder",0,3,9,55,3,11,2,64,0
Sarah Paulson & Amanda Peet Kiss On The Golden Globes Red Carpet,0,2,11,41,1,11,0,52,0
Nobel Peace Prize misused says Norwegian lawyer and activist,0,1,4,48,0,8,0,52,0
The Woodcraft Folk loses subsidy,0,1,3,25,0,4,0,28,0
Obama says Trump claim he ordered Trump Tower wiretapped is false ,0,3,4,51,0,11,0,55,0
Football: Roma defeats Inter 3-1 in Milan,0,1,4,27,2,6,2,31,0
Cops: Nashville man put mom's dog in trash compactor,0,3,2,40,2,8,0,42,0
Six Afghan civilians killed after explosion near US military base,0,1,4,52,0,9,0,56,0
Space shuttle Discovery photographed from ISS,0,1,5,35,0,5,0,40,0
Meet Anjali Lama - Nepal's First Transgender Model Who'll Walk At Mumbai's Lakme Fashion Week!,0,2,14,61,5,14,0,75,0
Canada Drops W.T.O. Complaint Against Europe,0,1,8,28,3,5,0,36,0
Uber Slayer: How China’s Didi Beat the Ride-Hailing Superpower,0,3,9,42,3,8,0,51,0
Middle-Market Woes Inspire Starbucks’s Bet on Luxury Coffee  ,0,3,8,42,2,9,0,50,0
US home prices drop at record levels,0,1,2,28,0,6,0,30,0
Queensland Cabinet reshuffle: Mark Furner to replace Stirling Hinchliffe after resignation,0,2,6,73,1,10,0,79,0
Someone made a map of the world according to Donald Trump The list,0,3,4,50,0,12,0,54,0
Multifaith council commends Malaysian politician's comments on conversion to Islam,0,1,3,69,1,9,0,72,0
Feist leads 2008 Juno Award winners,0,1,3,23,0,5,4,26,0
UBSVoice: Buying Power: What Is Your Salary Actually Worth?,0,3,12,36,3,8,0,48,0
Search continues for victims of Indonesian volcano eruption,0,1,2,50,0,7,0,52,0
News From Elsewhere,0,3,3,14,0,2,0,17,0
2 Oficials Offer Hope and Caution on Chinese Econonmy,0,1,6,38,0,8,1,44,0
Bush loses power to 'fast-track' trade deals,0,1,1,34,3,6,0,35,0
Who pastors the pastor? Even ministers suffer from suicidal thoughts.,0,3,2,56,2,9,0,58,0
"Donald Trump Made The Dollar Rise 5.6%, Now He's Making It Fall",0,3,11,35,4,11,2,46,0
Must See: The World's Wonders from Space,0,3,6,26,2,6,0,32,0
"German Drugmaker Stada Supports Takeover Offer From Bain Capital, Cinven",0,3,10,52,1,9,0,62,0
Trump’s rather weird meeting with the 2017 Teachers of the Year,0,2,3,45,1,10,4,48,0
The Audi S3 Is the Sports Sedan You Didn't Know You Were Waiting For,0,3,13,40,1,13,1,53,0
"Sen. Perdue on Syria: 'We've got to stop ISIS, and that's job one' ",0,3,8,39,7,13,0,47,0
Twitter drops lawsuit against US government as order to unmask anti-Trump account withdrawn,0,3,4,74,1,12,0,78,0
Kim Jong-un hails 'eventful significance' of country's new high-thrust rocket engine,0,3,2,67,5,10,0,69,0
President Trump on Dow 20K: ‘I’m Very Proud of That’,0,3,8,29,4,9,2,37,0
Oscar-Nominated 'Zootopia' Directors Reveal Judy Hopps' Women's March Sign,0,3,10,51,5,8,0,61,0
Trump signs orders that take aim at Dodd-Frank,0,3,3,35,1,7,0,38,0
China’s Banking Giants Try to Snatch Share of Mobile Payments,0,3,8,43,1,9,0,51,0
"Paraguay protesters seek end to re-election proposal, vote looms",0,2,1,53,2,8,0,54,0
Soyuz TMA-15 launches crew to International Space Station,0,1,7,40,1,7,2,47,0
Cop Fired Over Tirade At Traffic Stop Once Allegedly Threatened To 'Blow Up' A School,0,3,15,54,2,14,0,69,0
"Amid the swirling sands of the Sahara, a music revolution",0,2,2,45,1,9,0,47,0
NASA Troubleshooting Drill Problem on Mars Curiosity Rover,0,3,10,41,0,7,0,51,0
Two-year-old saves twin brother from falling furniture,0,3,1,45,2,6,0,46,0
The One 2017 1st-Round Opponent Each Playoff Team Matches Up with Best,0,3,10,43,1,11,5,53,0
"Oscar Nominations Snub Amy Adams, 'Jackie,' Tom Hanks And More",0,3,10,39,4,9,0,49,0
US Soccer says players must stand for national anthem ,0,2,3,42,0,9,0,45,0
European airspace closed by volcanic ash,0,1,1,34,0,5,0,35,0
Haze crisis over Malaysia prompts talks with Indonesia,0,1,3,44,0,7,0,47,0
Iraqi police discover 20 bodies,0,1,1,24,0,4,2,25,0
Cubs' Javier Baez Honors 2016 World Series with Tattoo Before Spring Training,0,3,10,51,1,11,4,61,0
Congressman removes Capitol Hill painting depicting police as pigs,0,3,3,55,0,8,0,58,0
Donald Trump Selects Trading Firm Founder Vincent Viola as Army Secretary ,0,2,10,53,0,11,0,63,0
Deadly Mexico fireworks blast hit market packed for holidays,0,2,2,50,0,8,0,52,0
15 Leslie Knope Quotes To Chant In The Mirror When The Patriarchy’s Got You Down,0,2,14,49,1,14,2,63,0
World Bank: The way climate change is really going to hurt us is through water,0,2,3,60,1,14,0,63,0
"$1,000 reward offered for answer from US President",0,1,3,34,2,7,4,37,0
P1 Pico Projector Stands Out From a Small Crowd,0,1,8,30,0,8,1,38,0
Brisbane storm: Bureau of Meteorology warns more on the way after early morning light show,0,3,3,72,1,14,0,75,0
Altice cable deal gives Viacom shares much needed boost,0,2,2,45,0,8,0,47,0
Kraft Heinz Takeover Bid Shakes Up Big Food and Its Slow Growth,0,3,11,41,0,11,0,52,0
Australian Labor Party announces new Climate Change Policy,0,1,6,45,0,7,0,51,0
The Lox Drop Their New Album 'Filthy America... It's Beautiful',0,3,10,38,6,9,0,48,0
"Keith Broomfield, American Slain Fighting ISIS, ‘Knew the Risk’",0,3,11,40,4,8,0,51,0
Climate Change May Be Intensifying China’s Smog Crisis ,0,3,8,38,1,8,0,46,0
This Guy Perfectly Recreated His Disney Photo With Minnie Mouse Decades Later,0,3,12,54,0,11,0,66,0
What’s New in the West Bank? Blessed Outposts and Donald Trump,0,3,8,42,2,10,0,50,0
South African former apartheid party dissolves,0,1,2,39,0,5,0,41,0
Celeb Chef Gordon Ramsay’s In-Laws Charged in Computer Hacking Case,0,3,10,46,2,9,0,56,0
"Heckler Captures Video of DeMarcus Cousins Yelling 'Suck a D*ck, B*tch!' at Him During Game",0,3,13,58,6,14,0,71,0
Paris attack puts security at the top of the agenda two days before French election ,0,2,2,67,0,15,0,69,0
6 Reasons Why the Warriors Are Playing Their Best Basketball of the Season,0,3,9,52,0,12,1,61,0
Ford Motors posts US$2.7 billion annual profit,0,1,4,32,2,6,2,36,0
Mike Pompeo Sworn In as CIA Director After Senate Confirmation,0,3,11,42,0,9,0,53,0
A Dying Man's Ex-Wife Told Him Trump Had Been Impeached So He Could Die in Peace,0,3,16,47,2,15,0,63,0
'Dictator Maduro!': Thousands of Venezuelans take to the streets to protest the ban on the opposition leader,0,2,4,84,4,16,0,88,0
Putin orders Russian government to normalize relations with Georgia,0,1,3,56,0,8,0,59,0
Ireland rejects EU Lisbon Treaty,0,1,5,23,0,4,0,28,0
"As Arms Meeting Looms, Russia Offers Carrot of Sharp Cuts",0,1,9,38,1,9,0,47,0
"FDA recalls ""Mama's"" brand smoked salmon",0,1,4,28,3,5,0,32,0
"Texas High School Students Caught Doing Nazi Salute, Saying ‘Heil Trump’ at Senior Picture Day",0,3,14,63,3,14,0,77,0
Three Drivers to Watch at the Indy 500,0,1,4,24,0,7,3,28,0
Where is the snow?,0,3,1,13,1,3,0,14,0
These Democrats aren’t attending Trump’s inauguration,0,2,3,43,2,5,0,46,0
"In farewell, Obama urges Americans to escape their ‘bubbles’",0,3,3,46,3,8,0,49,0
Walmart Employee In Texas Films Man's Racist Rant Against 'Foreigners',0,2,10,48,3,9,0,58,0
Syria's Cease-Fire Holding Despite Minor Violations,0,2,7,37,2,5,0,44,0
"‘Today, He Acted Like a Politician’: Voters’ Reactions to Trump’s Speech ",0,2,9,47,6,11,0,56,0
Shockers' Darral Willis Jr. calls Kentucky 'nothing special',0,3,5,44,4,7,0,49,0
Washington Talks End Without Agreement On Israeli Settlements,0,3,8,46,0,7,0,54,0
The ten most lucrative bus lane cameras in England - is one of them near you?,0,3,2,58,2,15,0,60,0
Rethinking the Widely Held 2% Inflation Target,0,2,5,33,1,6,1,38,0
San Francisco Symphony Nixes Chapel Hill Concerts Due to North Carolina's HB2,0,3,12,52,1,11,1,64,0
Trump says US 'must be paid more' to defend Germany ,0,3,4,36,2,10,0,40,0
UK and US accuse Russia of 'interfering in other parts of the globe',0,2,5,49,2,12,0,54,0
Oddities in WannaCry ransomware puzzle cybersecurity researchers,0,2,3,55,0,6,0,58,0
"'Explosive' Haitian cholera outbreak kills 292, neighboring countries prepare",0,1,2,61,3,8,3,63,0
A Town Reborn Faces a New Threat,0,1,6,20,0,6,0,26,0
Cardinals' Stephen Piscotty clears concussion protocol after being hit by ball,0,2,3,64,1,10,0,67,0
Legs-it: politicians and others tweet their legs after 'sexist' reaction to Theresa May and Nicola Sturgeon,0,3,5,83,4,15,0,88,0
Iraqi City of Mosul Transformed a Year After Islamic State Capture,0,2,9,47,0,10,0,56,0
Bikers Rally In Waco,0,3,4,13,0,3,0,17,0
AP's National Guard Story Is A Lesson About How News Works In The Trump Era,0,3,16,44,1,14,0,60,0
Ex-convict arrested in plot to attack a bar on New Year’s Eve was known as an ’impressionable’ panhandler,0,2,4,80,4,17,0,84,0
Stallone Sues Warner Bros. Over Unpaid 'Demolition Man' Profits,0,3,9,43,3,8,0,52,0
"After reports of civilian slaughter, Syrian rebels say Aleppo cease-fire reached",0,3,3,65,2,10,0,68,0
Trump Says He Will Leave Family Business. The Pros Tell Him How,0,2,12,39,1,11,0,51,0
Brawl Erupts in Turkey's Parliament Over Constitutional Reform ,0,3,7,47,1,8,0,54,0
"Andrew Bogut Trade Rumors: Latest News, Speculation Surrounding Mavericks Center",0,2,10,59,2,9,0,69,0
18 Things You’ll Get If You’re The Best And The Worst Person You Know,0,2,13,39,2,13,2,52,0
EA Sports Madden Trolls Jerry Jones After Tony Romo-Super Bowl Comments,0,2,13,47,1,10,0,60,0
Kardashian-Jenner Family Sends Gourmet Meals to Skid Row for the Holidays,0,3,9,53,1,10,0,62,0
Mental health org and 'Stranger Things' star send warnings about '13 Reasons Why',0,2,5,58,4,12,2,63,0
"Open Carry law takes effect in Texas, but activists keep fighting",0,2,3,51,1,10,0,54,0
Mexico warns its citizens to 'take precautions' in the US,0,3,3,43,2,9,0,46,0
Three Hard Lessons the Internet Is Teaching Traditional Stores,0,3,8,46,0,8,0,54,0
The government was warned that the Oroville Dam emergency spillway was unsafe. It didn’t listen.,0,2,4,75,3,14,0,79,0
Son Says Prison Worker Mom Joyce Mitchell Wouldn’t Help Inmates Escape,0,2,11,48,1,10,0,59,0
"Todd Fisher shares details about Debbie Reynolds, Carrie Fisher memorial ",0,2,6,56,1,10,0,62,0
Top Democrat: Obama may make torture report partly public,0,3,3,45,1,8,0,48,0
"Trump Tweet Hyping ‘Judge Jeanine’ Show Wasn’t Criticism of Paul Ryan, Aides Say",0,3,12,52,4,12,0,64,0
Kosmos-3M rocket launches fourth SAR-Lupe satellite,0,1,6,37,2,5,1,43,0
Paris-Orly flights resume but chaos endures after terror attack,0,3,2,52,1,8,0,54,0
Season 2 of 'Better Call Saul' Might See the Return of a Major 'Breaking Bad' Character,0,2,11,56,4,15,1,67,0
Hedge Fund Is Dissolving as It Faces 2nd Inquiry,0,1,7,32,0,8,1,39,0
"UK Muslims Donate 10 Tons Of Food To Homeless, 90% Of Whom Are Non-Muslims",0,3,14,40,3,13,4,54,0
Oculus Rift live blog: This is the future of virtual reality,0,3,3,46,1,10,0,49,0
Donald Trump inauguration: Mormon Tabernacle Choir singer resigns rather than perform for President-elect,0,3,6,85,2,12,0,91,0
"Common Debuts New Song, Discusses Chance the Rapper & the State of Hip-Hop at Tribeca Film Festival",0,2,13,67,3,16,0,80,0
"It’s Do-or-Die Time on Health Care for Trump, GOP",0,3,10,27,4,8,0,37,0
U.S. minimum wage gets first federal boost in a decade,0,1,2,41,2,9,0,43,0
Joost van der Westhuizen: Ex-South Africa captain in 'critical condition',0,2,5,55,4,9,0,60,0
ABC News Public Relations — PRESIDENT DONALD TRUMP WILL DO FIRST ONE-ON-ONE...,0,3,45,16,6,11,0,61,0
Factbox: What Apple and the U.S. government are fighting over,0,2,5,44,3,9,0,49,0
Official: Ban on electronics in carry-ons tracks back to 2016 bombing,0,3,2,51,2,10,4,53,0
"Suburban Chicago School Teaches ‘Blackenomics,’ ‘Trans-Rights,’ and ‘White Genocide Against Blacks’",0,3,11,69,9,10,0,80,0
"On Holocaust Remembrance Day, anti-Semitism Remains a Scourge",0,2,7,45,2,7,0,52,0
Imagining A World Without Prisons For Communities Defined By Them,0,2,10,46,0,9,0,56,0
US unemployment fell to four-year low before Katrina,0,1,3,41,1,7,0,44,0
A Race to Be the First to Use Stimulus Money,0,1,7,28,0,9,0,35,0
South Sudan: UN warns of 'social engineering' amid looming threat of genocide,0,3,4,59,3,11,0,63,0
Broadcasters push for new layer of intellectual monopoly at WIPO,0,1,5,50,0,9,0,55,0
House Republicans Vote Privately to Gut Independent Ethics Office (UPDATE),0,2,14,49,2,9,0,63,0
"UK should expect a very hefty bill for Brexit, says Jean-Claude Juncker",0,2,6,52,2,11,0,58,0
Concerns Keep U.S. From Talks on Racism,0,1,7,24,2,6,0,31,0
Oracle Tops Forecast and Declares Dividend,0,1,5,32,0,5,0,37,0
Arkansas executes Ledell Lee in first lethal injection case for 12 years,0,3,3,56,0,11,2,59,0
China’s Hot Stock Market Beckons Chinese Firms Home,0,3,8,35,1,7,0,43,0
China-Led Development Bank Adds More Members in Status Boost,0,3,9,42,1,8,0,51,0
Texas Cop Survives Being Run Over Twice -- Suspect Shot Dead,0,2,10,38,2,10,0,48,0
World's oldest male panda Pan Pan dies in China aged 31,0,3,4,38,1,10,2,42,0
Beauty and the Beast: Emma Watson on why she chose Belle over Cinderella,0,3,6,53,1,12,0,59,0
Canada presses Iran for an international investigation into Kazemi death,0,1,3,60,0,9,0,63,0
Federal Judge Says Trump’s Order on Sanctuary Cities Is Likely Unconstitutional,0,3,10,58,1,10,0,68,0
Missing Malaysian boat: Dozens from sunken vessel rescued as search continues for six more,0,3,3,73,1,13,0,76,0
Kellogg Foundation Made Huge Grants to John Podesta’s Center for American Progress,0,3,10,60,1,11,0,70,0
44 worshippers shot dead at Nigerian mosque,0,1,1,34,0,6,2,35,0
Suspects Held in Killing of Parents of 17,0,1,4,28,0,7,2,32,0
11 Spine-Chilling Dialogues From 'The Silence Of The Lambs' That Will Give You The Creeps,0,3,15,55,3,14,2,70,0
Former Indian PM Narasimha Rao passes away,0,1,6,30,0,6,0,36,0
Antwerp now has 'text lanes' for pedestrians who are glued to their mobile phones,0,3,1,65,2,13,0,66,0
This Mom And Her Son Have The Cutest Project In Their Yard,0,3,12,35,0,11,0,47,0
"Fox, Glenn Beck, others cleared in ‘clock kid’ Ahmed Mohamed’s defamation suit",0,3,5,57,5,11,0,62,0
BASF makes $4.9 billion hostile bid for Engelhard,0,1,5,33,2,7,2,38,0
"This London Crowd Completely Lost It When Giggs Performed His ""KMT"" Verse",0,2,14,46,2,11,0,60,0
"Snowstorms Cause Pileups, Power Outages Along the East Coast ",0,3,8,43,1,9,0,51,0
Disney Channel Has Aired Its First Ever Same-Sex Smooch,0,3,10,36,1,8,0,46,0
Lightning struck a tree and seemingly opened up the gates of Hell,0,3,2,52,0,11,0,54,0
The Public Does Not Seem To Be Clamoring For A Tax Cut,0,2,12,31,0,11,0,43,0
Bitcoin may be the biggest winner of 2017 so far,0,3,1,34,0,9,4,35,0
F.A.A. Plans New Medical Helicopter Safety Rules,0,1,9,30,3,6,0,39,0
Arrested prison employee allegedly gave hacksaw blades to escaped killers,0,3,1,63,0,9,0,64,0
Scotland suffers severe flooding following downpour,0,1,1,45,0,5,0,46,0
"In Icy Kentucky, Thousands Are Still Without Power",0,1,8,34,1,7,0,42,0
"Google doubles Gmail storage, adds text formatting",0,1,2,41,1,6,0,43,0
John Boyega Photobombs 'Star Wars' Fans For A Terrific Cause,0,3,10,39,2,9,0,49,0
Soda sales just fell for the 12th year in a row,0,3,1,34,0,10,2,35,0
Kid Rock Gets Engaged to Longtime Girlfriend Audrey Berry,0,3,8,41,0,8,0,49,0
The SA Baxter Foundry Uses Green Technology to Cut Toxic Waste,0,1,11,41,0,10,0,52,0
Man Arrested For Breaching White House Complex,0,3,7,33,0,6,0,40,0
Rex Ryan fired as Bills' postseason drought reaches 17 seasons,0,3,3,47,1,9,2,50,0
China threatens to cut sales of iPhones and US cars if ’naive’ Trump pursues trade war,0,2,5,64,2,15,0,69,0
Premier League set to announce £312m pre-tax loss in the light of Brexit and new UK accounting rules,0,2,5,73,2,17,3,78,0
Car bomb defused in central London,0,1,2,27,0,5,0,29,0
Deadly attack near Egypt's old monastery,0,3,2,32,1,5,0,34,0
"As East and West Pull on Moldova, Loyalties and Divisions Run Deep",0,1,9,45,1,11,0,54,0
"Carmelo Anthony Comments on No-Trade Clause, Rumors and Knicks Front Office",0,3,10,53,2,10,0,63,0
LeBron's New Intel Ad Makes Fun of People Who Call Him a Crybaby,0,2,12,39,1,12,0,51,0
National Security Adviser Michael Flynn's job security in jeopardy,0,2,5,52,1,8,0,57,0
U.S. Officials: Putin Personally Involved in U.S. Election Hack,0,3,10,40,5,8,0,50,0
Celebrity Babies Born in 2016,0,3,3,18,0,4,4,21,0
Watch a Trump surrogate get shut down after calling Trump the 'Martin Luther King of healthcare',0,2,6,73,2,15,0,79,0
Team Trump Responds to Hillary’s ’Deplorables’ Flub: ’She Ripped Off Her Mask’ - Breitbart,0,2,12,58,7,13,0,70,0
Bill O'Brien Reportedly 'Absolutely Loves' Patrick Mahomes,0,3,8,41,3,6,0,49,0
"Afghanistan wants more US help in fight against Taliban, IS ",0,3,6,43,1,10,0,49,0
China Exceeded U.N. Cap on North Korean Coal Imports in December,0,3,10,42,2,10,0,52,0
Tyrese Reveals on Instagram That He Secretly Got Married on Valentine's Day,0,2,10,53,1,11,0,63,0
Government's childcare rebate closer as senate passes smaller package of savings to fund reforms,0,3,1,81,1,13,0,82,0
Keith Richards Remembers Chuck Berry... And That Time the Rock Icon Punched Him,0,3,12,52,3,12,0,64,0
Chuck Todd: Trump on the Brink of ‘Lame Duck’ Presidency,0,3,7,37,3,9,0,44,0
N. Korea Issues Threat on Uranium,0,1,5,22,1,5,0,27,0
Telecom Commission of Solomon Islands issues phone company US$1M fine,0,1,7,51,1,9,1,58,0
Plastic surgeons often miss patients' mental disorders,0,3,1,46,1,6,0,47,0
Nigeria destroys illegal small arms,0,1,1,30,0,4,0,31,0
Jon Stewart’s Well-Timed Comeback,0,2,5,23,2,3,0,28,0
Champions League round of sixteen—first leg results,0,1,2,42,1,6,0,44,0
Paul says he finished drafting bill to replace ObamaCare ,0,3,3,45,0,9,0,48,0
Cody Garbrandt Is Living the Dream: How UFC's New Stud Got His Superpower,0,2,14,45,2,12,0,59,0
'MI6 officers' named on US-based website,0,1,4,27,3,5,1,31,0
"What's their angle? Breaking down the Putin, Trump and Obama spy games",0,2,5,51,3,11,0,56,0
Police Say ‘Car Surfing’ to Blame in Iowa Teen’s Death,0,3,8,34,3,9,0,42,0
"Despite Innumerable Petitions, China Is Going To Host The Barbaric Yulin Dog Meat Festival In June",0,2,16,66,1,15,0,82,0
Judge Approves $33.3 Billion Federal Loan to G.M.,0,1,7,28,4,7,3,35,0
"Flights, massages and other freebies to enjoy on Tax Day",0,3,3,43,1,9,0,46,0
"Supreme Court, Back at 9, Endures as Centrist",0,3,5,30,2,7,1,35,0
"What's their angle? Breaking down the Putin, Trump and Obama spy games",0,3,5,51,3,11,0,56,0
Two People Poisoned After Drinking Herbal Tea From Chinatown Store in San Francisco,0,3,12,59,0,12,0,71,0
Imprisoned Haitian priest may need US doctors,0,1,4,35,0,6,0,39,0
"Florida beachgoer finds centuries-old partial human skull, officials say",0,2,1,61,2,8,0,62,0
Petition Calls for ABC to Fire Jesse Williams Over ’Racist’ BET Awards Speech - Breitbart,0,2,16,56,3,14,0,72,0
"Aamir Khan Sheds His Serious Persona, Shows His Naughty Side In This Promo Of Koffee With Karan!",0,3,17,61,2,16,0,78,0
"After Randeep Hooda, Virender Sehwag And Yogeswar Dutt Also Clarify Their Statements About Gurmehar Kaur",0,2,15,74,1,14,0,89,0
"President Trump, White House Apprentice ",0,2,5,29,1,5,0,34,0
Theresa May avoids questions over possible knowledge of Trident missile error before vote,0,3,3,74,0,12,0,77,0
Guardians of the Galaxy Vol. 2 has tie-in Doritos bags that play the soundtrack,0,3,4,59,2,13,1,63,0
Sean Spicer Reacts to Melissa McCarthy's 'SNL' Impression,0,3,10,37,3,7,0,47,0
"As Citizens Lash Out Against Cutting Trees, Mumbai Metro Gets An Arborist To Preserve Greenery",0,3,15,64,1,14,0,79,0
Going for a roll in the hay? French farmers become the latest profession to strip off for a VERY racy 2017 calendar,0,2,6,83,1,21,4,89,0
Murdered woman's sister supports executing ex-soldier in potentially historic move ,0,2,1,70,2,10,0,71,0
Netanyahu hopes to work with Trump to undo Iran nuclear deal ,0,3,3,47,0,11,0,50,0
Union leader threatens illegal strikes if Government tightens rules on industrial action,0,2,2,75,0,11,0,77,0
New Status in Africa Empowers an Ever-Eccentric Qaddafi,0,1,7,40,1,7,0,47,0
"Lady Gaga Talks Super Bowl, Says Her Sister Lobbied to 'Suspend' Her in the Air",0,2,12,50,3,14,0,62,0
Independent Report in Larry Nassar Case Expected by End of June: USA Gymnastics,0,3,12,54,1,12,0,66,0
Ka-ching! How the gambling lobby won the fight over pokie reforms,0,3,2,51,2,10,0,53,0
Referee Jeff Triplette appears to call penalty on wrong team,0,3,3,48,0,9,0,51,0
"U.S. Vice President Biden's mother dies, aged 92",0,1,5,30,4,7,2,35,0
Your lazy self can now order takeout by just yelling at Alexa,0,2,2,48,0,11,0,50,0
17 Realities Everyone Who Is Child-Free By Choice Knows,0,3,9,35,1,8,2,44,0
"2 Chicago girls, 11 and 12, shot in head in separate incidents ",0,3,1,43,2,12,5,44,0
Beloved zoo hippo dies after beating in El Salvador,0,2,3,40,0,8,0,43,0
Fukushima radiation reaches United States shores for first time,0,3,3,52,0,8,0,55,0
Time Running Short for CIT to Find Financing,0,1,8,29,0,7,0,37,0
Brazilian President meets President of Colombia,0,1,4,38,0,5,0,42,0
Katy vs. Britney: Can Either Redeem Pop in 2016?,0,2,6,27,3,8,4,33,0
Lloyd Releases His New EP 'Tru',0,2,7,17,2,5,0,24,0
Fifth Harmony Cancels NHL All-Star Game Performance,0,3,10,34,1,6,0,44,0
"Body found in Cradle Mountain, Tasmania, Australia",0,1,5,37,2,6,0,42,0
Rain-Delayed Wrigley Field Erupts After Chicago Blackhawks Win Game 5,0,2,10,48,1,9,1,58,0
Everything we know about the next iPhone so far,0,3,2,37,0,8,0,39,0
Donald Trump Agrees Not to Talk Publicly About Mexico Paying for Border Wall,0,3,11,53,0,12,0,64,0
"Why pay for child care you don't use, like on public holidays?",0,3,1,47,3,11,0,48,0
President Obama Reveals His Advice to Trump in Final Press Conference ,0,2,9,50,0,11,0,59,0
"Petition to sack Kay Burley following Alton Towers interview passes 50,000 signatures",0,2,5,63,1,11,5,68,0
Germany Has Responded Slowly to Bank Crisis,0,1,6,31,0,6,0,37,0
Six killed in Burundi church massacre,0,1,2,30,0,5,0,32,0
"In 2016, the enemy of your enemy is your friend — even if that friend is your enemy Putin",0,2,2,63,2,18,4,65,0
Canadian light aircraft stolen; Wisconsin State Capitol evacuated,0,1,4,53,1,7,0,57,0
No Privacy: Chinese Feel They’re ‘Running Naked’ Online,0,3,8,36,4,7,0,44,0
"Train Delays, Police Action Cause Chaos Around NYC’s Penn Station ",0,3,12,42,2,10,0,54,0
Notre Dame Routs Louisville to End Seven-Game Skid,0,1,8,34,1,7,0,42,0
Joseph De Veuster voted greatest Belgian,0,1,4,31,0,5,0,35,0
Billionaire Chase Coleman's Tiger Global made a nearly $500 million bet on Fiat,0,3,6,56,2,12,3,62,0
The Internet of Everything â $12.6 trillion ROI expected over the next decade [SLIDE DECK],0,2,15,54,6,14,3,69,0
Obama supports Middle East protesters in speech,0,1,3,38,0,6,0,41,0
'Moonlight' Kids Return to School as Oscar Winners,0,2,6,35,2,7,0,41,0
"Ivan Koloff, the ‘Russian Bear’ and Supreme Wrestling Heel, Dies at 74",0,3,8,45,4,11,2,53,0
Leaked Report Points to Larger Pakistani Role in Mumbai Attacks,0,1,8,46,0,9,0,54,0
Top airlines look to no-frills fares to win back travelers to Europe,0,2,2,54,1,11,0,56,0
"On Foreign Policy, Trump Still Speaking Campaign Language ",0,3,8,41,1,8,0,49,0
Rescue efforts underway as hundreds of whales stranded on beach in New Zealand,0,3,3,63,0,12,0,66,0
Five Charts Show Lurking Risks in China’s Economic Stabilization,0,3,8,47,1,8,0,55,0
FTC Cracks Down on Deceptive Debt Collection Texts,0,2,9,34,0,7,0,43,0
LaVar Ball: I prefer Lonzo with Lakers to learn from Magic Johnson,0,2,8,46,1,11,0,54,0
Florida shooting: US Army veteran Esteban Santiago fronts court,0,3,6,48,1,8,0,54,0
Fox Announces Overhaul at the Top of Its Entertainment Divisions,0,1,7,48,0,9,0,55,0
"In Book, Torre Reveals Fraying Relationship With Cashman",0,1,8,40,1,7,0,48,0
NBA Top 22 Under 22: Ranking the League's Top Young Stars,0,2,10,31,2,10,4,41,0
Wind power provides half of the electricity on US grid for first time ever,0,3,3,58,0,13,0,61,0
Trade Minister Quits as Iraq Investigates Corruption,0,1,6,40,0,6,0,46,0
Rebel Force in Congo Shows Signs of Division,0,1,6,31,0,7,0,37,0
Tiffany tanks as Lady Gaga fails to boost sales,0,2,3,36,0,8,0,39,0
Taliban militant kills at least thirteen in northwest Pakistan,0,1,2,52,0,8,0,54,0
"After the Richmond by-election, shouldn't all Brexit MPs in Remain constituencies resign?",0,3,6,68,4,11,0,74,0
Michael Flynn: People Granted Immunity 'Probably Have Committed A Crime',0,3,10,50,3,9,0,60,0
Uber CEO apologizes for outburst at driver ,0,2,4,32,0,7,0,36,0
The Continuing Quest for the Perfect Shot,0,2,5,30,0,6,0,35,0
Taking the Measure of the Big East,0,1,4,24,0,6,0,28,0
Foot-and-mouth source confirmed as research laboratory,0,1,1,46,2,5,0,47,0
FBI releases file on 1970s Trump housing discrimination case,0,3,4,44,0,8,4,48,0
Novak Djokovic vs. Denis Istomin: Score and Reaction from 2017 Australian Open,0,3,8,53,2,11,4,61,0
Philadelphia's Mummers undergo sensitivity training before parade ,0,3,2,56,1,7,0,58,0
LeBron's Cavaliers Lost An NBA-High $40 Million Last Season Despite Championship,0,3,14,51,3,10,2,65,0
"Court Temporarily Blocks Trump’s Travel Ban, and Airlines Are Told to Allow Passengers ",0,2,11,61,2,13,0,72,0
Magic to offer David Griffin top basketball ops position at Cavs season's end,0,3,4,60,1,12,0,64,0
What happens in Puerto Rico won’t stay there,0,2,3,33,1,7,0,36,0
Cher's Thoughts On Tubas In Two Tweets,0,3,7,24,1,6,0,31,0
Academy Awards retains PricewaterhouseCoopers despite Best Picture mix-up ,0,2,6,59,1,8,0,65,0
'Bloody Sunday Inquiry' publishes report into British Army killing of activists in Northern Ireland,0,1,7,77,2,13,0,84,0
How America’s Past Shapes Native Americans’ Present,0,2,7,36,2,6,0,43,0
Amsterdam pet shop owner creates beer for dogs,0,1,1,38,0,7,0,39,0
Musical Show of Unity Upsets Many in Israel,0,1,6,30,0,7,0,36,0
Israel Lifts Restrictions On Settlement Building In East Jerusalem,0,2,9,49,0,8,0,58,0
Standing Rock Sioux want ‘no forcible removal’ of protesters from Dakota Access pipeline site,0,2,5,73,2,13,0,78,0
Fox News Poll:  Trump and the Carrier deal ,0,3,5,28,1,9,0,33,0
"Body of missing student found in Bath, England",0,1,3,35,1,7,0,38,0
The Case for Newt,0,2,3,11,0,3,0,14,0
US Senator Robert Byrd dies at age 92,0,1,5,23,0,7,2,28,0
"Once on the way to the U.S., Somali refugees sent back to camp",0,2,4,43,3,12,0,47,0
Government to announce $300m training fund amid 457 visa change skills shortage concern,0,3,1,67,1,12,6,68,0
EU fines Microsoft $1.35 billion for non-compliance with antitrust decision,0,1,3,57,3,9,3,60,0
David Cameron jokes he doesn't have to hear Donald Trump 'wiretaps' anymore,0,3,4,57,3,11,0,61,0
"No Zika detected in Florida mosquitoes so far this year, officials say ",0,3,3,55,1,12,0,58,0
Geithner Hints at Harder Line on China Trade,0,1,6,31,0,7,0,37,0
"Local mayors: By Sessions’s definition, there might not actually be sanctuary cities",0,3,3,67,3,11,0,70,0
Markets dragged down by credit crisis,0,1,1,31,0,5,0,32,0
Army warns of new threat: Energy drinks,0,2,2,30,1,6,0,32,0
Martin Shkreli Wins Ruling Splitting Fraud Trial From Ex-Lawyer,0,2,10,44,1,8,0,54,0
Meet the Women Responsible for Pink Protest Hats,0,3,6,35,0,7,0,41,0
Everyone is making the same point about 'Beauty and the Beast' gay character backlash,0,3,3,67,2,13,0,70,0
Former US Representative Dan Rostenkowski dies aged 82,0,1,6,39,0,7,2,45,0
Wikinews interviews Australian Statistician Brian Pink,0,1,5,44,0,5,0,49,0
Hamas strikes deal with Fatah,0,1,2,23,0,4,0,25,0
Global markets plunge,0,1,1,18,0,2,0,19,0
"China Pressure on North Korea Gives Peace a Chance, Says Pence",0,3,9,42,1,10,0,51,0
St Louis Cardinals win baseball's World Series,0,1,5,34,1,6,0,39,0
Raymond Kopa: Real Madrid and France legend dies at 85,0,3,5,37,1,9,2,42,0
Michael Phelps Makes Political Super Bowl Pick ,0,3,7,33,0,7,0,40,0
WSJ Survey: Economists Think Fed Won’t Raise Rates Before September - Real Time Economics,0,3,15,58,3,13,0,73,0
"After Promising Not To Talk Business With Father, Eric Trump Says He'll Give Him Financial Reports",0,2,16,65,2,15,0,81,0
Saudi Arabia creates a girls council to empower women — but where are the girls?,0,3,2,62,2,14,0,64,0
'Bad language' at Live 8 concerts trigger complaints to the BBC,0,1,5,45,2,10,1,50,0
‘Famous in Love’ Explores Hollywood’s Glamour and Darkness,0,3,6,42,3,7,0,48,0
Mall mayhem: Fights break out across the US,0,3,4,31,1,7,0,35,0
"Honduras deploys 8,000 troops to ensure peaceful elections",0,1,1,45,1,7,4,46,0
"Michael Hayden says Obama's Russia response was ""too timid""",0,3,4,44,3,8,0,48,0
Obama Gains Support From G.O.P. Governors,0,1,8,25,3,5,0,33,0
Death toll up to six in Minneapolis bridge collapse,0,1,2,41,0,8,0,43,0
Samantha Bee's 'Full Frontal' Apologizes for Saying Cancer Patient Has 'Nazi Hair',0,3,11,55,5,11,0,66,0
Ivanka Trump's perfume is a big winner on Amazon,0,2,3,36,1,8,0,39,0
Georgian President declares country is in 'state of war',0,1,2,44,2,8,0,46,0
New Leaks Suggest The iPhone 8 May Have An Invisible Front Camera Underneath The Display,0,3,14,59,0,14,1,73,0
Remains of Five Archbishops of Canterbury Discovered Under London Museum,0,3,8,55,0,9,0,63,0
Arkansas execution: Judge orders post-mortem,0,2,2,36,2,4,0,38,0
This Gay Man Responded To A Cruel Tweet About Him In The Best Way,0,3,14,38,0,13,0,52,0
Katniss makes a final stand in 'Hunger Games: Mockingjay -- Part 2' trailer,0,2,5,52,5,12,1,57,0
"Georges St-Pierre to face Michael Bisping; date, venue still TBD",0,3,8,44,3,9,0,52,0
Picture | Kirk Douglas Through the Years ,0,3,5,28,1,7,0,33,0
Explosion at University of Missouri-Columbia leaves four injured,0,1,4,52,1,7,0,56,0
This Photographer Transforms One Room Into A World Of Colours,0,3,10,42,0,9,0,52,0
Rupert Murdoch Deserves a Little Credit,0,3,5,29,0,5,0,34,0
How long do U.S. retirees live compared to peers in other countries?,0,2,3,51,3,11,0,54,0
Review: Drake the Creator Meets Drake the Curator on ‘More Life’ ,0,3,8,43,3,11,0,51,0
English actor Norman Painting dies at age 85,0,1,3,32,0,7,2,35,0
Audi and VW sites raided in emissions probe,0,2,3,33,0,7,0,36,0
US border agents ask Muhammad Ali's son: 'Are you a Muslim?',0,3,6,39,5,10,0,45,0
Quick searing knife toasts bread as you slice it ,0,3,1,39,0,9,0,40,0
Bosnia's ISIS problem is growing â and that's troubling for Europe - Business Insider,0,2,8,61,5,13,0,69,0
"Listen To Quentin Miller's New EP, 'Shredded Metal'",0,3,9,31,4,7,0,40,0
"Lawyers, others vie for pieces of NFL concussion settlement",0,2,4,46,1,8,0,50,0
"1,500 Tribals Thrown Out Of Their Homes In Devamachi Forest In Karnataka",0,2,11,45,1,11,4,56,0
Why Snapchat Is the New TV,0,3,6,15,0,5,0,21,0
Teen charged over 'bomb attempt' at US Christmas celebration,0,1,4,46,2,8,0,50,0
"Take a look at the making of the hit scam email prank show, 'Scamalot'",0,3,2,52,3,13,0,54,0
"Drake Details 'More Life' Playlist, Reveals Plans To Get Back Into Acting",0,3,12,47,3,11,0,59,0
Elon Musk wasn’t prepared for Tesla’s Model 3 to be this popular,0,2,4,46,2,11,1,50,0
NASA plans for future moon missions,0,1,4,26,0,5,0,30,0
Obama nominates Sonia Sotomayor to U.S. Supreme Court,0,1,7,37,2,7,0,44,0
Hotel Service Employees Feel Economic Pain Early,0,1,7,35,0,6,0,42,0
SA heatwave: 100 flying foxes die during extreme weather,0,2,2,42,1,8,3,44,0
World's tallest solar tower under construction deep in Israeli desert,0,2,2,57,1,9,0,59,0
"Avalanche hits Tignes French Alpine ski resort, reportedly causing casualties",0,3,4,63,1,9,0,67,0
'World' stops turning for longest-running US soap opera,0,1,3,42,3,7,0,45,0
Romanian government to strengthen laws against tax evasion,0,1,1,50,0,7,0,51,0
"Tara Palmer-Tomkinson died of 'natural causes - a perforated ulcer', socialite's sister reveals",0,3,3,74,6,12,0,77,0
Pakistan arrests 35 people suspected in US soldiers' death,0,1,3,44,1,8,2,47,0
IMF Chief's Conviction For Negligence Raises Questions About Her Future,0,3,12,49,1,9,0,61,0
Blimp Goes Down At U.S. Open; Pilot Injured,0,2,9,24,3,7,0,33,0
20 Democratic Senators Now Support Blocking Neil Gorsuch,0,3,7,40,0,7,2,47,0
University is still a white middle-class affair – it’s not just Cambridge,0,2,2,57,3,11,0,59,0
Actor Bob Denver dies at 70,0,1,3,17,0,5,2,20,0
"Peter Buffett Talks Creativity, Music, Philanthropy, And Life With Dad Warren Buffett",0,2,12,59,3,11,0,71,0
Mick Jagger: 73-year-old Rolling Stones frontman becomes father for eighth time,0,3,4,60,3,10,2,64,0
BBC News Used The Wrong Subtitles For Donald Trump’s Inauguration And It’s Glorious,0,2,15,54,2,12,0,69,0
iPad 2017 review: Good becomes perfect at $329,0,2,2,28,2,7,7,30,0
Mom Fat-Shamed at Target Speaks Out on Postpartum Pressure,0,3,8,41,1,8,0,49,0
The President’s Speech: Scenes From Trump’s First Address to Congress,0,3,9,48,3,9,0,57,0
"‘I could have lost my life, too,’ says driver hit by ‘shamed’ girl who jumped from bridge",0,3,1,66,6,16,0,67,0
16 dead after U.S. helicopter crashes in Afghanistan,0,1,3,38,2,7,2,41,0
Trump Says New Vetting Will Keep ‘Radical Islamic Terrorists’ Out Of U.S.,0,2,13,45,4,11,0,58,0
20 killed and over 40 missing as overcrowded bus crashes into Nepal river,0,1,1,56,0,12,4,57,0
N.C.A.A. Ban on Lawyers for Athletes Is Ruled Illegal,0,1,10,31,4,8,0,41,0
2 Detroit police officers responding to burglary injured in shooting,0,3,1,57,0,9,1,58,0
This Hospital Granted A Patient's Dying Wish For A Glass Of Wine And Cigarette While Watching The Sunset,0,3,18,68,1,17,0,86,0
Moschino Unveils $254 Barbie & Ken Gift Set,0,3,6,25,2,7,3,31,0
India's First AC Ambulance On Rails Will Rush To Action During Disasters!,0,3,13,47,2,11,0,60,0
New South Africa finance minister Gigaba calls for radical reform,0,3,4,52,0,9,0,56,0
"11 Stunning Photos Of Iconic Stars, And The Stories Behind How They Were Taken",0,3,13,49,1,13,2,62,0
Fan Praises Nets Center for His Help on Highway,0,1,7,32,0,8,0,39,0
"Chinese pressure on North Korea 'working,' UN Ambassador Nikki Haley says ",0,3,8,52,3,11,0,60,0
"Remy Ma Takes Direct Aim At Nicki Minaj On New Diss Song ""shETHER""",0,3,17,35,2,12,0,52,0
Huge Gay Pride parade held in Brazil,0,1,4,26,0,6,0,30,0
Taliban in Pakistan captures convoy bound for NATO troops,0,1,6,43,0,8,0,49,0
Newsmax CEO And Trump Friend Blames Reince Priebus For Rocky Start,0,2,13,43,0,10,0,56,0
"Chinese pressure on North Korea 'working,' UN Ambassador Nikki Haley says ",0,2,8,52,3,11,0,60,0
Billions Withdrawn Before Madoff Arrest,0,1,5,30,0,4,0,35,0
'La La Land' Has Hollywood Singing A Different Tune About Musicals,0,2,11,43,2,10,0,54,0
"John Glenn's widow turns 97, says she misses him 'terribly' ",0,3,2,42,4,10,2,44,0
It’s time to drop the vagina as a protest symbol,0,3,1,37,1,9,0,38,0
Amazon deforestation accelerating,0,1,1,30,0,2,0,31,0
"Mall Shooting in San Antonio Leaves One Dead, Many Injured",0,2,9,39,1,9,0,48,0
Calpers to Oppose Re-election of Bank of America Board,0,1,6,39,1,8,0,45,0
Australian rules football: Six goal win moves Morwell to second on Gippsland Football League ladder,0,1,6,78,1,14,0,84,0
Officials investigating cause of massive Boston-area fire,0,3,2,48,1,6,0,50,0
Twitter's controversial head of China leaves after eight months,0,2,2,52,1,8,0,54,0
Jessica Alba's Honest Company Organic Baby Powder recalled,0,3,7,43,1,7,0,50,0
World-Beater Status at Risk as India Rebuts Threat to Growth,0,3,8,42,1,9,0,50,0
Quirky Homes Show Their True Colors,0,3,6,24,0,5,0,30,0
7.2 magnitude earthquake strikes Mariana Islands,0,1,2,38,1,5,2,40,0
Kidnapped Honduras teens' bodies found,0,3,2,31,1,4,0,33,0
Hot Debate Gives Way to Embrace of Obama,0,1,6,27,0,7,0,33,0
Toyota's new concept for millennials has built-in camping hacks,0,3,1,52,2,8,0,53,0
DeVos and Tax Credit Vouchers: Arizona Shows What Can Go Wrong ,0,3,11,40,1,11,0,51,0
Indonesia's Child Protection Commission wants compensation for minors jailed in adult prisons,0,3,4,77,1,11,0,81,0
Sanders’ Jewish outreach coordinator under fire after anti-Netanyahu rant,0,2,3,60,2,8,0,63,0
Mom Turns 9-Month-Old Daughter Into Adorable Elf on the Shelf - Yahoo,0,2,10,44,3,11,1,54,0
Stewart battles rain to win Pepsi 400 at Daytona,0,1,3,34,0,8,3,37,0
8 Silicon Valley CEOs Who Condemned Donald Trump's Immigration Order In The Strongest Of Words,0,2,16,62,1,14,1,78,0
Former Iranian President Says Donald Trump Is Not Really In Charge,0,3,11,45,0,10,0,56,0
Obama signs healthcare bill for 9/11 emergency workers,0,1,1,42,1,7,3,43,0
"Assange would agree to extradition if Obama pardons Chelsea Manning, WikiLeaks says ",0,3,6,65,1,12,0,71,0
Former Mexican president trolls Donald Trump's address to Congress,0,3,5,52,1,8,0,57,0
Policeman rescues woman from burning car in nick of time,0,3,1,46,0,9,0,47,0
An Income Gap in Who May Lose TV,0,1,8,17,0,7,0,25,0
Third Fox News employee joins racial discrimination lawsuit,0,3,3,49,0,7,0,52,0
The Lush New Décor Look That’s Vanquishing Minimalism,0,2,8,37,1,7,0,45,0
Mariah Carey Talks Collaborating With YG on 'I Don't' & Wanting to Burn a Wedding Dress in the Video,0,3,14,64,4,18,0,78,0
"Barbara Tarbuck, ‘General Hospital’ Actress, Dies at 74",0,2,6,36,4,7,2,42,0
Chelsea manager Jose Mourinho banned from driving for six months after he is caught speeding,0,3,3,75,0,14,0,78,0
The death toll in a bomb attack on Syrian evacuees has risen to 112,0,2,2,49,0,13,3,51,0
"A guy trained a machine to ""watch"" Blade Runner. Then things got seriously sci-fi.",0,2,4,60,5,13,0,64,0
How the Presidency Changed Obama ,0,3,4,24,0,5,0,28,0
Hawaii May Be Breaking Law by Allowing Foreign Men to Fish ,0,3,9,39,0,11,0,48,0
"Deadly tornadoes rip through southern US, killing over 300",0,1,3,43,1,8,3,46,0
NATO soldiers honour fallen Canadians,0,1,5,28,0,4,0,33,0
"Quadruple Murder-Suicide ‘Up in the Wilderness,’ Police Say",0,3,7,41,4,7,0,48,0
16 Of The World's Best Photographs Prove That Drone Photography Is The Next Big Thing!,0,3,14,54,2,14,2,68,0
Obama commutes Chelsea Manning's sentence,0,3,3,33,1,4,0,36,0
Trump says top priority is to 'protect and serve' America amid backlash over extreme vetting ,0,3,2,74,2,15,0,76,0
"Ugandan government, rebels agree to ceasefire",0,1,1,38,1,5,0,39,0
What’s at Stake in Trump’s Proposed E.P.A. Cuts ,0,2,8,27,5,8,0,35,0
People Think Nicki Minaj Took Shots At Remy Ma On New Song,0,3,12,35,0,11,0,47,0
Ben Roethlisberger 'Leaning Towards' Return to Steelers for 2017-18 Season,0,2,7,49,3,9,6,56,0
"4-year-old who's read 1,000 books tours Library of Congress ",0,3,2,40,4,9,5,42,0
A Goth Male Soprano Who Plumbs the Darkness ,0,3,7,29,0,8,0,36,0
"Trump, Citing No Evidence, Suggests Susan Rice Committed Crime ",0,3,9,43,2,9,0,52,0
A Hollywood Film Is Funding Fake News As Part Of Its Publicity Campaign,0,3,13,46,0,12,0,59,0
"Peter Vaughan, Maester Aemon On 'Game Of Thrones,' Dies At 93",0,2,10,35,4,10,2,45,0
Blake Is Out on Day 1 at Wimbledon,0,1,5,21,0,7,1,26,0
"Angered by U.S. anti-missile system, China takes economic revenge",0,3,4,49,4,8,0,53,0
Apple concerned with iPhone icons' alleged misuse,0,1,2,40,1,6,0,42,0
NASA denies rumors of finding life on Mars,0,1,5,30,0,7,0,35,0
Will Trump Take ‘Brutally Forthright’ Advice From McMaster? ,0,3,9,40,3,8,0,49,0
Sheryl Sandberg On 'Option B' At Work After A Loss,0,2,10,29,2,9,0,39,0
Tracy McGrady Named to 2017 Basketball Hall of Fame Class,0,2,8,36,0,9,4,44,0
Trump Said to Offer Goldman's Cohn National Economic Council Job,0,3,9,45,1,9,0,54,0
"With a Hollywood Writers’ Strike Looming, Here’s What to Know ",0,3,8,41,3,10,0,49,0
"Loss of Tax Revenues Is Felt Acutely in West, Report Finds",0,1,9,38,1,10,0,47,0
Muslim students tried to meet with a lawmaker. They were first asked: ‘Do you beat your wife?’,0,3,3,70,5,16,0,73,0
This Guy From Chennai Invented A Fan That Works Without Power For His Grandfather,0,3,14,54,0,13,0,68,0
"Caspian Airlines Jet Crashes in Iran, Killing 168",0,1,6,32,1,7,3,38,0
Warriors circle Saturday for Kevin Durant's comeback,0,2,4,41,1,6,0,45,0
A life in pictures - George Michael,0,2,3,25,1,6,0,28,0
"Mashable on Periscope: ""The Mashable House at #SXSW is open! #MashHouse""",0,3,11,45,6,10,0,56,0
"The Weeknd Brings Out Kendrick Lamar, Shows Off Style & Heart at Vevo Concert in Los Angeles",0,3,14,60,2,16,0,74,0
Microsoft and Yahoo Executives Meet,0,1,4,27,0,4,0,31,0
"'Rocky', 'Raging Bull' producer Robert Chartoff dies at 81 ",0,3,5,38,5,9,2,43,0
"Starbucks Coffee, Now in Instant",0,1,4,23,1,4,0,27,0
Black Teachers Are Leaving The Profession Due To Racism,0,3,9,38,0,8,0,47,0
Changes in Fred Thompson US Presidential campaign,0,1,6,37,0,6,0,43,0
Pakistan Backtracks on Link to Mumbai Attacks,0,1,5,34,0,6,0,39,0
105-Year-Old Cyclist Sets New World Record,0,3,7,25,2,5,3,32,0
Sixteen killed in Pakistan during Taliban ambush,0,1,3,39,0,6,0,42,0
Uber CEO Leaves Trump’s Advisory Council Amid Controversy,0,3,10,39,1,7,0,49,0
It's Time To Start Telling Our Friends How Much Money We Make,0,3,12,37,1,11,0,49,0
Ed Sheeran Reveals He Once Got Drunk and Smashed Justin Bieber in the Face with a Golf Club,0,3,13,61,0,17,0,74,0
Pictured: The sewer where 200 partygoers attended illegal rave after wading through water-filled tunnels,0,2,2,84,2,13,3,86,0
"Iranian commander warns there are 100,000 missiles ready to strike Israel",0,2,2,54,1,10,6,56,0
Scarlett Johansson Is The Top-Grossing Actor Of 2016,0,3,8,32,1,7,4,40,0
Up to 50 teens could face sex offenders register after receiving video of alleged rape,0,3,1,69,0,14,2,70,0
Trump aide lashes out at Freedom Caucus lawmaker ,0,3,3,38,0,8,0,41,0
Massive rubbish mound collapse kills 16 people including four children in Sri Lanka,0,2,3,66,0,12,2,69,0
Haiti's banks reopen,0,1,1,16,1,2,0,17,0
19 Pictures You’ll Understand If Your Dad Loses His Damn Mind Over The Thermostat,0,3,13,52,1,13,2,65,0
Lamoureux Twins Give Minnesota a 1-2 Punch,0,1,5,28,1,6,2,33,0
Study says zombies would wipe out humans in less than 100 days,0,3,1,47,0,11,3,48,0
California Warns of Layoffs at Schools,0,1,4,29,0,5,0,33,0
Shouldn't the Guggenheim Be Called the Ehrenwiesen?,0,3,5,38,2,6,0,43,0
A More Assertive Donovan Drives U.S. Soccer Ambitions,0,1,9,35,2,7,0,44,0
Mexico wall: Trump questions talks over border dispute,0,3,2,44,1,7,0,46,0
Ashley Graham: At Times ‘I Think I Am the Fattest Woman Alive’,0,2,11,37,3,11,0,48,0
Canadian PM Trudeau says he won't 'lecture' Trump on US immigration policy ,0,2,7,53,3,12,0,60,0
Saudi Arabia calls an end to tax-free living as oil slump continues to bite,0,3,2,59,1,13,0,61,0
Parole board to recommend Oscar Pistorius be released in August,0,3,4,50,0,9,0,54,0
Dieses Video ist nicht verfügbar. VENEZUELA UNDERCOVER,0,3,21,26,1,6,0,47,0
Women Braid Hair Together in Show of Solidarity at U.S.-Mexico Border,0,3,10,46,3,10,0,56,0
Rhode Island could be the next state to make tuition free,0,2,2,45,0,10,0,47,0
"Coffee lovers rejoice: Drinking 4 cups a day is NOT bad for your health, study finds",0,3,5,61,2,15,1,66,0
"U.S., South Korean Warplanes Prepare for Action at 'Max Thunder' Drill",0,3,10,45,5,10,0,55,0
REACTION: Top Dems Urging Hillary Clinton to Run for New York City Mayor  Insider,0,3,19,47,1,14,0,66,0
Death toll from tsunami in Southeast Asia increases,0,1,3,41,0,7,0,44,0
People Are Desperately Waiting For Nicki Minaj To Respond To Remy Ma’s Diss Track,0,3,14,53,1,13,0,67,0
Mexico caught the cartel boss who reportedly almost took out 'El Chapo' GuzmÃ¡n's mother and sons,0,3,5,73,4,15,0,78,0
Lockdown lifted at Arizona Air Force base after reports of shots fired ,0,3,4,55,0,12,0,59,0
"Markets Weather Italy Referendum Result, but Banks Are Vulnerable ",0,3,8,48,1,9,0,56,0
"Threat to ships in Malacca Strait, says Singapore Navy",0,1,5,40,1,8,0,45,0
Families could lose up to 16% of income after national insurance changes,0,3,1,57,1,11,2,58,0
Here’s what happens if a presidential nominee has to drop out of the election,0,2,1,62,1,13,0,63,0
Japan's population declines,0,1,1,23,1,2,0,24,0
Barack Obama Will Make First Post-Presidency Public Appearance in Chicago Next Week,0,2,12,59,1,11,0,71,0
Watch Live: SpaceX Launches Resupply Flight to International Space Station,0,3,10,54,1,9,0,64,0
Baseball Investigators to Meet With Alex Rodriguez on Sunday,0,1,7,45,0,8,0,52,0
Fairfield Tops No. 20 Marist in Overtime,0,1,5,26,1,6,2,31,0
"Recession unlikely, interest rates set to remain steady: RBA Statement on Monetary Policy",0,3,7,68,2,12,0,75,0
"Despite A Flop Show Against England, Virat Kohli Still Rules The Roost Among The T20I Batsmen",0,3,17,58,1,15,2,75,0
Paula Creamer Is Feeling Better and Aiming to Win on L.P.G.A. Tour,0,1,12,39,4,11,0,51,0
Family holidays Seven bucket list holidays your family should take in 2017,0,3,2,57,0,11,4,59,0
Drake Won't Be at the Grammy Awards,0,2,5,23,1,6,0,28,0
"Family of five killed in Staten Island, NY house fire",0,1,5,38,1,9,0,43,0
Obama Set for First Step on Immigration Reform,0,1,6,33,0,7,0,39,0
Tech companies must do more to avoid using minerals tainted by rights abuses,0,2,1,63,0,12,0,64,0
Magic Ties Series With 76ers at 1-1,0,1,4,20,1,6,4,24,0
"West Palm Beach, Florida plane crash kills four",0,1,4,35,1,7,0,39,0
"For A Palestinian Father, Six-Day War Led To A Divided Life",0,2,12,35,2,10,0,47,0
Trump Shut Down A Journalist And A Repressive President Praised Him,0,2,11,46,0,10,0,57,0
"To Honour The Victims Of Quebec City Mosque Shooting, Eiffel Tower Goes Dark",0,3,13,50,1,12,0,63,0
Deere Profit Fell 38% in 2nd Quarter,0,1,4,22,1,6,3,26,0
Live updates from Hillary Clinton’s 2016 campaign kickoff rally in NYC [Video],0,2,7,53,3,11,4,60,0
Germany Arrests Teens Plotting 'Islamist-Motivated Attack': Cops,0,2,8,46,4,6,0,54,0
"Deep in Bedrock, Clean Energy and Quake Fears",0,1,6,31,1,7,0,37,0
How the world's fattest woman has lost 66lbs in FIVE DAYS ahead of her lifesaving treatment in India,0,2,10,70,1,17,2,80,0
Police gun down Isis fighters on streets of Saudi Arabia,0,3,4,43,0,9,0,47,0
Here Are Some Of The Victims Of The Istanbul Nightclub Massacre,0,2,11,42,0,10,0,53,0
"The voice of Aleppo: How Bana, seven, escaped to freedom",0,2,4,40,3,9,0,44,0
"On the eve of an Oprah movie about Henrietta Lacks, an ugly feud consumes the family",0,3,4,64,1,15,0,68,0
'El Chapo' Guzman faces life in prison; not-guilty plea entered ,0,2,3,47,4,10,0,50,0
A Rapidly Expanding Snapchat Is Angering Its Neighbors in L.A.,0,2,10,41,2,9,0,51,0
Sturgill Simpson: A Guide to the Surprise Album of the Year Nominee,0,3,8,47,1,11,0,55,0
After a Goalie Steps In,0,1,4,15,0,4,0,19,0
"Kellyanne Conway Just Told Everybody To ""Go Buy Ivanka’s Stuff” — Potentially Violating Ethics Law",0,3,14,66,4,14,0,80,0
"This man lost a bet, so his friends duct-taped him to a yield sign",0,2,1,50,2,13,0,51,0
A Marketer Travels Globally and Snacks Locally,0,1,6,34,0,6,0,40,0
Tim Allen says being a conservative in Hollywood is like living in 1930's Germany ,0,3,4,59,1,14,4,63,0
Why a Russian Hacking Inquiry Is in Donald Trump’s Best Interests ,0,2,9,45,1,11,0,54,0
Woke Former First Daughter Malia Obama Joined the Dakota Access Pipeline Protest,0,3,11,58,0,11,0,69,0
Soldiers in Madagascar Occupy Vacant Palace in a Show of Force,0,1,7,45,0,10,0,52,0
Spicer clarifies Hitler remarks as Pelosi calls for his firing ,0,2,3,50,0,10,0,53,0
"Roosevelt Island to Shine Under the Hillary Clinton Spotlight - First Draft. Political News, Now. ",0,2,12,67,4,15,0,79,0
Trump Says Michelle Obama's 'No Hope' Comment About the Past ,0,2,9,39,3,10,0,48,0
Mich. woman says she was forced to give birth on jail floor,0,3,1,46,1,11,0,47,0
Brits get more sleep than most. So why are we so grumpy?,0,3,2,41,2,11,0,43,0
An Arms Dealer Is Sentenced to 30 Years in a Scheme to Sell Weapons to Terrorists,0,1,10,54,0,15,2,64,0
Sources: Trump labor pick Andrew Puzder has voiced second thoughts about nomination,0,3,4,67,1,11,0,71,0
7 Die in Bus Crash Near Hoover Dam,0,1,6,20,0,7,1,26,0
BBC Interview Gatecrashed By Adorable Kids Becomes The Biggest Blooper Of Year Already!,0,3,15,59,1,12,0,74,0
Trump’s Budget — and Much of His Agenda — Is Still Stuck in the Mud,0,3,9,41,3,14,0,50,0
Young man who walked miles to work now drives after police raise cash ,0,3,1,56,0,13,0,57,0
Delaware woman killed after falling from zip line,0,2,1,41,0,7,0,42,0
MILO: Aquinas and Augustine Were Radical Progressives - Breitbart,0,2,10,45,2,8,0,55,0
French Council Defangs Plan to Crack Down on Internet Piracy,0,1,8,43,0,9,0,51,0
Experts Compile Mock N.B.A. Drafts Because They Have To,0,1,11,33,3,8,0,44,0
LeBron James Helps Cavaliers Complete Sweep of Hawks,0,1,8,37,0,7,0,45,0
"Dump the electoral college? Bad idea, says Al Gore’s former campaign chairman.",0,3,4,59,4,11,0,63,0
More bodies recovered from capsized Chinese cruise ship,0,3,2,46,0,7,0,48,0
Heartwarming video shows cat tending to pregnant goat,0,3,1,45,0,7,0,46,0
Leicester City sack Claudio Ranieri nine months after Premier League title win – video report,0,3,6,72,1,14,0,78,0
Tom Cruise Discovers a Cursed World in 'The Mummy' Trailer,0,3,8,39,2,9,0,47,0
"Future’s New Album Is Very Good, Possibly Despicable",0,3,8,35,2,7,0,43,0
Jon Huntsman Accepts Post As Ambassador To Russia,0,3,8,34,0,7,0,42,0
Italy’s Banca Monte Dei Paschi Seeks More Time to Raise Capital ,0,3,10,42,1,11,0,52,0
LeVar Burton on LaVar Ball: He and Trump Are 'Two Peas in a Pod',0,2,12,36,3,13,0,48,0
White House Continues To Insist It Can Prove Trump's Wiretap Claim,0,3,11,44,1,10,0,55,0
"A closer look at Carter Page, the Trump associate who was under FBI scrutiny ",0,3,7,55,1,14,0,62,0
Lebanon Chooses Saad Hariri as Premier,0,1,5,28,0,5,0,33,0
"TV Viewership Falls in N.F.L. and Premier League: A Blip, or Something Worse? - The New York Times",0,2,17,57,7,17,0,74,0
Gay-Rights Advocates Look to Cities as Firewall Against Rollback,0,3,8,47,1,8,0,55,0
Cam Newton Shares Video Letter Dedicated to Son: 'Be Better Than Me',0,3,11,43,3,11,0,54,0
In defence of the humble Australian lawn,0,3,2,32,0,6,0,34,0
Watch Live: Senate Debates Mike Pompeo Nomination for CIA Director,0,2,11,45,1,9,0,56,0
"Vladimir Putin: 'Our prostitutes are the best in the world, but I doubt Donald Trump would fall for them' ",0,3,6,77,4,19,0,83,0
Five Detained After Cairo Bomb Blast,0,1,6,25,0,5,0,31,0
Tennis Continues to Fail Serena Williams When It Comes To Racism,0,2,10,44,0,10,0,54,0
Iran promises retaliation for Israeli action against nuclear facilities,0,1,2,61,0,8,0,63,0
Cyprus peace talks: Can Cypriots heal their divided island?,0,3,3,46,2,8,0,49,0
New York Times reporter Judith Miller breaks silence on Plame leak investigation,0,1,6,63,0,11,0,69,0
Satirical website criticizes Glenn Beck for 'hypocritical' attempts to silence free speech,0,1,3,74,2,11,0,77,0
A Major Proponent of H-1B Visa Reform Loses Patience With Trump,0,3,11,40,1,10,1,51,0
"Israeli settlements jeopardise Middle East peace, Kerry says; Trump tells Netanyahu to 'stay strong'",0,3,6,77,4,13,0,83,0
"As celebrity books boom, professional authors are driven out of full-time work",0,3,1,64,2,11,0,65,0
Blues musician Pinetop Perkins dies at age 97,0,1,3,33,0,7,2,36,0
F.B.I. and States Vastly Expand DNA Databases,0,1,10,26,3,6,0,36,0
Donald Trump's state visit to UK may be moved from London to Brexit heartland amid security concerns,0,3,6,77,1,16,0,83,0
"Texas releases abortion booklet with debunked cancer link, suicide risk claim",0,3,1,65,1,10,0,66,0
More Atheists Shout It From the Rooftops,0,1,6,28,0,6,0,34,0
A Christmas Story,0,2,3,12,0,2,0,15,0
"Why is the US banning kratom, the virtually harmless herb?",0,2,3,44,2,9,0,47,0
"Isil slave markets sell girls for as little as 'pack of cigarettes', says UN",0,3,3,57,3,13,0,60,0
The 34-Year-Old Hedge Fund Manager Who Bet Everything On A Stock That Tanked,0,3,14,46,2,12,2,60,0
Suicide bombers kills 31 in Pakistan,0,1,2,27,0,5,2,29,0
"UK's richest people getting special deal from HMRC, warns watchdog",0,3,6,49,2,9,0,55,0
Potash Market Rebound in ‘Full Force’ as Global Demand Improves,0,3,8,44,2,9,0,52,0
Netanyahu: Iran missile test must not go unanswered,0,3,2,41,1,7,0,43,0
Australian telecomms firm Telstra offers rebates to those affected by bombings,0,1,2,66,0,10,0,68,0
"Officials: Eight insurgents killed in Orakzai, Pakistan",0,1,4,43,2,6,0,47,0
"Trump quickly condemns Louvre attack, still quiet on Quebec",0,3,3,47,1,8,0,50,0
Bob Bradley sacked as Swansea City manager after only 11 games in charge,0,3,4,54,0,12,2,58,0
People Love This Girl’s Joyous Response To Her Boyfriend Gifting Her An Empty Box,0,3,14,53,1,13,0,67,0
Former communist leader Hua Guofeng dies age 87,0,1,3,35,0,7,2,38,0
This Rolls Royce is painted with real diamond dust,0,2,3,39,0,8,0,42,0
Hotdog cheese burger layered with chips & more freaky combinations,0,2,1,55,1,9,0,56,0
Chuck Schumer: Democrats Could Work With Trump If He Ditches His Hard-Right Policies,0,3,14,56,2,12,0,70,0
Qantas to Start Australia's First Nonstop Flight to Europe in 2018,0,3,7,44,1,10,4,51,0
Ukraine and Russia Sign Deal Over Gas,0,1,6,25,0,6,0,31,0
Keeping Pitchers Under Thumb at World Baseball Classic,0,1,7,40,0,7,0,47,0
Naked woman leads cops on high-speed chase,0,2,1,34,1,6,0,35,0
"Donald Trump Jr., running the family business, says he has nearly ‘zero contact’ with his father",0,2,3,73,5,15,0,76,0
"O.J. Simpson laywer, Cochran, dead at 67",0,1,4,24,4,6,2,28,0
A Casino Rises in the Place of a Fallen Steel Giant,0,1,7,34,0,10,0,41,0
"North Dakota Oil Pipeline Spills An Estimated 176,000 Gallons",0,3,8,38,1,8,6,46,0
Mental illness and heart disease are often found in the same patients,0,2,1,57,0,11,0,58,0
Mexican helicopter crash leaves soldier dead,0,1,1,38,0,5,0,39,0
Repairs Continue on Oroville Dam Ahead of Upcoming Storm,0,3,7,41,0,8,0,48,0
The Voter-ID Fight in Missouri,0,2,6,19,1,4,0,25,0
"Quick-thinking grandfather fights off 3-year-old's would-be kidnapper, cops say ",0,3,1,63,6,9,1,64,0
Rep. Jordan to Introduce Bill Calling for Clean Repeal of ObamaCare  Insider,0,3,10,53,1,12,0,63,0
"Over a dozen injured, one killed in bomb blast in Egypt",0,1,2,42,1,10,0,44,0
Floella Benjamin: ‘The Queen gave me a masterclass in people skills’,0,3,4,51,3,10,0,55,0
Speaker Ryan defends CBO estimate the 24M would lose insurance by 2026,0,3,6,47,0,11,6,53,0
"The world's longest Uber ride ended in Brooklyn, cost $294.09 ",0,3,3,40,4,10,5,43,0
"Without Superfund Tax, Stimulus Money Helps Pay for Cleanups",0,1,8,43,1,8,0,51,0
Yankee Candle Issues Recall: What You Need to Know  Insider,0,2,9,39,1,10,0,48,0
Sales and Rentals of Movies for Home Viewing Continue Slide ,0,3,7,43,0,10,0,50,0
A Reporter’s Notebook: The Laci Peterson Story Then and Now,0,3,9,39,2,9,0,48,0
Work on Lehman Brothers’ rescue to continue over weekend,0,1,3,44,1,8,0,47,0
Markets rally as world's central banks infuse cash,0,1,1,41,1,7,0,42,0
Cuomo May Want to Talk to Private Equity Firms,0,1,7,31,0,8,0,38,0
Look out below! Terrifying moment a huge crane topples over in the middle of a road full of workmen ,0,3,2,78,1,19,0,80,0
"GM to Lay Off Nearly 1,300 Workers at Detroit Plant, Cut Production at Several Factories",0,2,12,56,2,14,4,68,0
First fertilised fish fossil found,0,1,1,29,0,4,0,30,0
Killing Stirs Racial Unease in Texas,0,1,5,26,0,5,0,31,0
Judge Jeanine on Potential Voter Fraud: 'Dead People Vote All the Time'  Insider,0,2,11,53,3,13,0,64,0
4 Sane Ways To Play Dow 20K,0,3,6,12,0,6,3,18,0
"Election 2016 results: Arizona primaries, Utah and Idaho caucuses",0,2,4,47,2,8,4,51,0
2 Other Times Kellyanne Conway Referenced Bowling Green 'Massacre' or 'Attack' ,0,2,9,54,4,11,1,63,0
As it happened: Clinton and Trump go head-to-head in second debate,0,2,3,50,3,10,0,53,0
"UCLA commit LaMelo Ball, brother of Lonzo, scores 92 in high school game",0,3,8,48,2,12,2,56,0
George Osborne Says British Government to Begin Selling RBS Shares  ,0,3,11,46,0,11,0,57,0
Odes to hope (and techno): poems to get you going again,0,2,1,41,3,10,0,42,0
U.S. Supreme Court hesitant to expand debt collection abuse law,0,2,4,48,2,9,0,52,0
Voluntary sterilization of poor women proposed by Louisiana state legislator,0,1,2,65,0,9,0,67,0
Canada increases oil production to assist U.S.,0,1,3,35,2,6,0,38,0
These photos show what it was like to live in New York’s legendary Chelsea Hotel,0,2,5,60,1,14,0,65,0
EU seeks to expedite police requests for data from tech firms,0,2,2,49,0,10,0,51,0
President Obama Writes Note Praising The 'Diverse Tales' Honored At Sunday's Golden Globes,0,3,13,62,3,12,0,75,0
Oakland Warehouse Fire: Victims Had No Warning Before Killer Smoke,0,2,10,46,1,9,0,56,0
Key moments from today's hearing with FBI Director Comey and NSA Director Rogers ,0,2,11,56,1,13,0,67,0
2015 NBA Finals -- League admits to missed calls at end of Game 2,0,2,6,39,2,13,5,45,0
Japanese Bank Raises Stock Sale to  $9.4 Billion,0,1,6,30,2,8,2,36,0
Four jackpot winners confirmed in US 'Mega Millions' lottery drawing,0,1,5,52,2,9,0,57,0
The Japanese yen is getting slammed,0,3,2,28,0,5,0,30,0
Democrats Meet to Plot Party’s New Course ,0,3,6,28,1,7,0,34,0
London attack: Police release six people without charge,0,3,2,45,1,7,0,47,0
Trace Adkins on How Buck Owens & Clint Eastwood Inspired 'Something's Going On',0,3,11,52,4,12,0,63,0
5 Tech Issues Donald Trump Will Face as President - Yahoo,0,3,8,37,1,10,1,45,0
Cleveland bar customers fight back during armed robbery ,0,2,1,47,0,8,0,48,0
Duke of York's ex-girlfriend Koo Stark in £200k High Court dispute,0,3,6,44,3,10,3,50,0
LeBron James is quite ‘okay’ with Kyrie Irving’s flat-Earth comments,0,3,6,49,4,9,0,55,0
Ministers urged to sack Lord Heseltine after he vows to join Brexit rebellion in Lords over Article 50,0,3,6,77,0,17,2,83,0
"For Solace and Solidarity in the Trump Age, Liberals Turn the TV Back On ",0,2,11,47,1,14,0,58,0
President Donald Trump complained to the CIA about the media,0,2,6,45,0,9,0,51,0
Swimmers Start New Year With Icy Plunges,0,3,7,27,0,6,0,34,0
Congress Passes Bill to Tighten Weapons Programs,0,1,6,36,0,6,0,42,0
This rainbow tree is real â and it grows naturally in the Philippines,0,3,2,55,2,12,0,57,0
"Yan Wang Preston’s best photograph: a Chinese village's ancient tree – sold for $25,000",0,3,4,59,6,13,5,63,0
US stock markets soar after bailout plan,0,1,2,32,0,6,0,34,0
New Zealand political party destroys leaked emails,0,1,2,42,0,6,0,44,0
"Watch 1,400 US workers learn their jobs are moving to Mexico",0,2,4,41,1,10,4,45,0
Sotomayor Selection Creates a Puff of Pride,0,1,5,32,0,6,0,37,0
Japan Airlines to relist shares,0,1,2,25,0,4,0,27,0
"Two dead as earthquake strikes Kütahya, Turkey",0,1,3,36,1,6,0,39,0
Fernando Llorente and Tom Carroll seal Swansea’s vital win over Stoke,0,2,6,52,1,10,0,58,0
"Under New Rules, Winning Is All in the Mind",0,1,7,27,1,8,0,34,0
From blood-sucking ants to colourful sea slugs: Scientists reveal 133 new species of animals and plants found in 2016,0,2,2,88,2,18,7,90,0
Donald Trump is losing his war with the media,0,3,2,35,0,8,0,37,0
Glasgow's Common Weal launch; 'Not me first. All of us first',0,1,5,41,5,10,0,46,0
Explosion in Baghdad claims 28 lives,0,1,2,27,0,5,2,29,0
Texas Uber Driver Says Mack Brown 'Couldn't Coach' in Front of Mack Brown,0,3,11,47,3,12,0,58,0
US and UK explore possibility of aid airdrops in Syria,0,3,5,40,0,9,0,45,0
Roddy White Retires from NFL After 11 Seasons with Falcons,0,2,9,38,0,9,2,47,0
Facebook artificial intelligence spots suicidal users,0,2,1,47,0,5,0,48,0
"'To Me, She Is Royalty': Carrie Fisher 1956 - 2016",0,3,7,21,5,9,8,28,0
Archbishop in Sicily bans mafia from being godfathers,0,3,2,44,0,7,0,46,0
Keep It Moving ,0,3,3,9,0,3,0,12,0
'Dangerous phenomenon': Israeli man charged with trying to join ISIS ,0,2,6,50,3,10,0,56,0
Racism motivated Trump voters more than authoritarianism,0,3,2,48,0,6,0,50,0
Kobe Bryant Gifts Oregon Ducks with New Nike Kobe A.D. NXT Shoe,0,3,14,36,2,11,0,50,0
"On YouTube and Hulu, Viewers Settle In for Longer Videos",0,1,9,37,1,9,0,46,0
Syria missile strike: Bashar al-Assad allies say US attack on Syria crosses 'red lines',0,3,6,64,4,13,0,70,0
"Schiphol airliner crash blamed on altimeter failure, pilot error",0,1,1,54,1,8,0,55,0
Player’s Harrowing Tale of Sexual Abuse Rocks Soccer in Britain ,0,3,8,45,1,10,0,53,0
Stockholm attack suspect was failed asylum-seeker; 2nd man arrested ,0,2,1,55,2,9,1,56,0
Poland made software patent directive stop,0,1,1,36,0,5,0,37,0
Scuffles as Pro-Trump Rallies Held; 6 Arrested in California Clash,0,3,8,46,2,9,1,54,0
"What Happens When An Aid Group Sees Abuse, But Is Sworn To Secrecy?",0,2,13,40,2,12,0,53,0
Julian Assange: The CIA director is waging war on truth-tellers like WikiLeaks,0,3,8,57,2,11,0,65,0
Report: Uber created a fake version of its app to trick and evade authorities,0,3,2,61,1,13,0,63,0
Pepsi Pulls Ad Accused of Trivializing Black Lives Matter ,0,3,8,41,0,9,0,49,0
Jordanian pilot burned alive in a cage by ISIS 'had no idea he was about to be executed on camera' ,0,3,5,72,2,20,0,77,0
Mayor of Oslo resigns after tax fraud scandal,0,1,2,36,0,7,0,38,0
Is the need for more sleep a sign of pending dementia?,0,2,1,42,1,10,0,43,0
PSLV rocket launches ten satellites,0,1,4,27,0,4,0,31,0
'Girlfriend's Day' is the bleak Netflix comedy you need today,0,2,3,46,3,9,0,49,0
Romania government scraps corruption decree after protests,0,3,1,51,0,6,0,52,0
Africa’s Biggest Bank Chasing Nigerian Deals After Oil Slump,0,3,9,42,1,8,0,51,0
Charleston Survivor: Black And White People Need To 'Get To Know One Another',0,3,13,49,3,12,0,62,0
"Cory Bernardi will be shocked by crossbench workload, Xenophon says",0,3,3,54,1,9,0,57,0
Twitter Reacts to Tim Tebow Hitting a Home Run in First Minor League At-Bat,0,2,12,49,1,13,0,61,0
"Sorry, “skeptics”: Global warming may not be so great for plant life after all",0,3,2,59,4,13,0,61,0
Iran claims airliners were denied fuel,0,1,1,32,0,5,0,33,0
The Design of 'Rogue One': An Exclusive Look at the 'Star Wars' Film's Concept Art,0,2,12,50,6,14,0,62,0
General Motors Quits Venezuela After Officials Seize Plant,0,3,8,43,0,7,0,51,0
"Time magazine's 2006 Person of the Year is ""you""",0,1,3,30,3,8,4,33,0
"Brexit Britain will leave European Union single market, Theresa May says",0,3,6,55,1,10,0,61,0
Marco Rubio Says Hackers Targeted His Campaign Aides,0,2,8,37,0,7,0,45,0
"Study Finds Many Americans Need More Than A Year to Recover From $1,500 Financial Hit",0,2,13,52,2,14,4,65,0
"We’ve got new details about the “Guardians of the Galaxy” ride at Disneyland, and apparently it’s full of secrets",0,3,4,86,5,18,0,90,0
ISIS Has Seen Its Income More Than Halved Since 2014 [Infographic],0,2,13,37,2,10,4,50,0
"Obama warns ""history will cast a harsh judgment"" if Guantanamo facility isn't closed",0,3,2,67,3,12,0,69,0
A Farewell Note,0,2,3,10,0,2,0,13,0
Drunken Brawl Ends in Conviction for South Korean Tycoon’s Son,0,3,8,44,1,9,0,52,0
"Adrian Peterson Reportedly Wants to Play for Raiders, Seahawks",0,2,7,46,1,8,0,53,0
Outraged Pulse Club Owner Slams Made-for-TV Reenactment of Attack,0,3,10,45,2,8,0,55,0
"Bobby Murcer, former New York Yankees player dead at 62",0,1,5,38,1,9,2,43,0
"26.9 Crore Indians Came Online For The First Time In Last Three Years, Ahead Of China & The US",0,3,18,52,3,18,3,70,0
Security guards increasingly being treated poorly by employers: union,0,3,1,59,1,8,0,60,0
Destroyed Kelso High School to be rebuilt,0,1,4,31,0,6,0,35,0
Marchers Use Donald Trump’s 100th Day to Protest Climate Policies,0,3,8,44,1,9,3,52,0
"Bristol Organic Food Festival 2008 lauched, 100 thousand expected to attend",0,1,4,53,1,10,7,57,0
Tom Hardy returning to CBeebies on Valentines Day for bedtime story,0,2,6,51,0,10,0,57,0
"Theranos to Lay Off 41% of Workforce, Company Says",0,2,6,32,2,8,2,38,0
Texas A&M President Resigns,0,1,5,18,1,3,0,23,0
An Unexpected Increase in Factory Orders,0,1,5,30,0,5,0,35,0
Pacific Islands Forum condemns Fiji takeover,0,1,4,35,0,5,0,39,0
David Tennant Is Going To Voice Scrooge McDuck In 'DuckTales' Reboot,0,2,13,43,2,10,0,56,0
"'Orange Is the New Black' Season 3, Episode 1: Mother's Day blues",0,3,8,39,5,11,2,47,0
Mexican politician Silverio Cavazos killed by gunmen,0,1,3,43,0,6,0,46,0
"Australian government introduces ""Fair Work"" to parliament",0,1,3,47,2,6,0,50,0
"For women, heavy drinking has been normalized. That’s dangerous.",0,3,2,50,4,8,0,52,0
Wall Street Surges Anew As Donald Trump Vows To Dismantle Dodd Frank,0,3,12,45,0,11,0,57,0
NFL NFL Pro Bowl Selections 2017: Voting Results and Full List of Players Announced,0,3,15,50,1,13,4,65,0
Two artists have done something incredible with fire and ice in this Rube Goldberg machine,0,3,3,73,0,14,0,76,0
An Hour of Running May Add 7 Hours to Your Life ,0,3,8,28,0,11,1,36,0
Twitter's Dick Costolo steps down as chief executive,0,2,3,41,1,7,0,44,0
Trump wants to restock Guantánamo. Who’s the ‘worst of the worst’ now?,0,3,3,51,5,11,0,54,0
Its Official! 45 New Cities Will Have Flight Connectivity By September,0,2,10,47,1,10,2,57,0
UK weather: Snow and storms to strike Britain with low temperatures lasting for weeks,0,3,4,67,1,13,0,71,0
Heartbreaking photo of son kissing casket a reminder of 9/11 cancer victims,0,3,1,59,1,11,3,60,0
Trump Names Pick for Elevated Deputy National Security Adviser Role ,0,3,9,49,0,10,0,58,0
Adler shotgun: Barnaby Joyce calls for more relaxed restrictions on controversial firearm,0,2,3,74,1,11,0,77,0
"100 per cent renewable energy network affordable, secure and 'off the shelf': study",0,2,0,64,4,12,3,64,0
"Two die after passenger ship and cargo ship collide near Haifa, Israel",0,1,3,55,1,11,0,58,0
Hunt master investigated by police after allegedly whipping saboteur with riding crop ,0,2,1,73,0,12,0,74,0
U.S. accuses China of developing space warfare,0,1,3,35,2,6,0,38,0
Throwing a Lifeline for the High Seas,0,2,4,27,0,6,0,31,0
Indian airliner crashes; nearly 160 presumed dead,0,1,1,38,1,6,3,39,0
The Sound of the Rangers Gets a Tuneup - Video - NYTimes.com,0,3,9,37,3,11,0,46,0
"Current, former major leaguers die in Dominican crashes ",0,3,2,45,1,8,0,47,0
Prince Charles visits Westminster attack victims in hospital and praises 'marvellous efforts' of medics,0,3,3,85,2,13,0,88,0
New Zealand’s Trent Boult ruled out of final three ODIs against England,0,3,8,51,1,11,0,59,0
Young Quakers disappointed by UK visa denials,0,1,4,35,0,6,0,39,0
White House Backs ‘Right to Try’ Law for Terminally Ill Patients ,0,3,9,43,2,11,0,52,0
Crocodiles (and Polo Ponies) Go Missing  as Scalpel-Wielding Consumers Revolt,0,3,9,55,3,10,0,64,0
"Dusty Rhodes, WWE Hall of Famer, Dies at Age 69",0,3,9,25,2,9,2,34,0
Man Sentenced To 4 Months Jail For Landing Gyrocopter On US Capitol Lawn,0,2,13,46,0,12,1,59,0
Credit Restrictions Cost Home Buyers ‘Deal of a Lifetime’,0,2,7,40,2,8,0,47,0
Campaign to preserve 'Queen's' Malta cathedral,0,3,3,35,3,5,0,38,0
"Dow Flirts With 20,000 as Stocks Rise, Gold Falls Ahead of Fed",0,2,9,35,2,11,5,44,0
South Korea: Critics call for arrest of impeached Park Geun-hye,0,3,5,47,2,9,0,52,0
Four Products to Keep You Flying This Holiday Season,0,3,8,36,0,8,0,44,0
"New subway line, awaited since the 1920s, opens in New York ",0,3,3,40,2,11,4,43,0
NBA Power Rankings Entering Final Weeks of 2016-17 Season,0,3,9,33,1,8,6,42,0
"Joseph Wapner, Original ‘The People’s Court’ Judge, Dies in Sleep: Report",0,3,10,47,6,10,0,57,0
Jimmy Fallon Trolls Donald Trump With #WorstLieIEverTold Tweets,0,3,12,43,1,7,0,55,0
Trump accuses 'sick' Obama of wiretapping him and his proof is [INSERT PROOF HERE],0,3,17,48,4,13,0,65,0
Worst trade ever: looking for positives in the Kings’ DeMarcus Cousins debacle,0,2,5,60,2,11,0,65,0
Israeli nurse dies after being set alight by patient,0,3,1,43,0,8,0,44,0
Three killed in Tennessee vehicle crash,0,1,2,32,0,5,0,34,0
"Polish Wikinews reaches 9,000 articles",0,1,2,27,1,4,4,29,0
Wax Hitler will return to museum after repairs,0,1,2,37,0,7,0,39,0
"As Leaks Multiply, Fears of a ‘Deep State’ in America ",0,3,7,34,3,10,0,41,0
Police: Austrian children kept in dungeon were in 'oppressive' conditions,0,1,2,59,3,9,0,61,0
"Girl who says she was raped 43,000 times dedicates her life to helping others",0,3,1,57,1,13,5,58,0
Taliban Kill Afghan Woman Accused of Adultery in Northeast ,0,3,7,43,0,9,0,50,0
US F-18 fighter jet crashes in San Diego residential area,0,1,5,40,1,9,2,45,0
Burmese government denies ongoing genocide of Rohingya Muslims,0,2,3,52,0,7,0,55,0
All of Chino y Nacho's Hits on Hot Latin Songs Chart,0,3,8,33,1,10,0,41,0
"In speeches and interviews, Obama holds on to the spotlight for his last days",0,3,2,61,1,13,0,63,0
Rubi Ibarra Garcia birthday: Man killed in horse race at viral party,0,3,4,52,1,11,0,56,0
Mitchell Trubisky Reportedly Has Jets 'Very Intrigued' Ahead of 2017 NFL Draft,0,2,12,49,2,11,4,61,0
Attacks on Christians in Egypt Undercut Sisi’s Promise of Security ,0,2,7,49,1,10,0,56,0
Michael Moorcock: My family values,0,3,3,26,1,4,0,29,0
"House Republicans Propose Rules to Punish Broadcasting, Photography From Chamber Floor",0,2,10,65,1,10,0,75,0
"100,000 more children missed school for family holiday last year, figures show",0,3,0,59,2,11,6,59,0
Pair Behind Planned Parenthood Sting Videos Charged in California,0,3,8,49,0,8,0,57,0
Runaway train causes chaos on London Underground,0,1,3,39,0,6,0,42,0
Indiana Town's Entire Police Force Quits in Protest of 'Immoral Things',0,3,9,49,3,10,0,58,0
Women’s March Highlights: Viewer Questions ,0,3,5,31,2,5,0,36,0
"G.O.P. Hurries to Slash Oil and Gas Rules, Ending Industries’ 8-Year Wait ",0,3,12,43,6,12,1,55,0
Oil price reaches new high,0,1,1,21,0,4,0,22,0
Former white supremacists help others leave hate groups,0,3,1,47,0,7,0,48,0
Spanish airline LTE suspends all flights,0,1,4,31,0,5,0,35,0
"Indonesian militants planned New Year's Eve machete attack, police say",0,3,4,55,2,9,0,59,0
Four-year old appears on This Morning to speak about saving his mother's life - but is distracted by boats,0,2,3,82,3,18,0,85,0
Slain partiers came to Istanbul from near and far to celebrate the New Year,0,3,4,58,0,13,0,62,0
Australian man arrested after dragging dead possum behind car,0,1,1,52,0,8,0,53,0
"Damian Lewis: 'As an actor educated at Eton, I'm still always in a minority'",0,3,5,53,5,13,0,58,0
Warriors Executives Use NBA Finals Off Day to Play Pickup Game at Prison,0,3,13,47,0,12,0,60,0
Japan's Flying Fish Makes for the Freshest Sashimi,0,3,6,36,1,7,0,42,0
Romania switches to Winter Time,0,1,3,24,0,4,0,27,0
HSBC is cutting about 100 senior bankers around the world,0,3,4,41,0,9,3,45,0
16 times Ed Miliband was the sassiest politician on Twitter,0,3,3,45,0,9,2,48,0
Patrick Stewart Applying for U.S. Citizenship to Fight Trump,0,2,8,42,2,8,0,50,0
Snapchat files for IPO as $SNAP — looks to raise $3 billion,0,2,8,36,3,11,1,44,0
ISIS boss al-Baghdadi reportedly escaped capture by minutes ,0,2,5,46,1,8,0,51,0
Profit Decline at Nokia Comes With a Warning,0,1,6,31,0,7,0,37,0
David Axelrod: I woke up this morning as an alternative fact,0,3,3,46,1,10,0,49,0
Mumbai Police Shows Shobhaa De Her Place After She Body Shames A Police Official!,0,3,14,53,1,13,0,67,0
Conservative ministers call on Theresa May to divert foreign aid money to defence budget,0,2,3,72,0,13,0,75,0
Rwandan genocide investigations to be completed by end of July,0,1,2,51,0,9,0,53,0
Best reads of 2016: RN presenters share their picks,0,3,3,35,1,8,4,38,0
Why Executive Order May Not Be Enough for Trump to Build Border Wall ,0,3,11,45,0,13,0,56,0
People Are Calling This Pupper A Hero After Her Forever Family Wrote The Shelter This Heartbreaking Letter,0,3,17,73,0,16,0,90,0
Scientists Want to Give the Atmosphere an Antacid to Relieve Climate Change,0,2,8,56,0,11,0,64,0
Henrik Lundqvist crisis hijacking Rangers season — what now?,0,2,3,47,2,8,0,50,0
Ghosts of a Faded Gilded Age Haunt a 19th-Century Chinese Banking Hub,0,1,9,46,1,11,2,55,0
"Maliki Pushes for Election Gains, Despite Fears",0,1,6,34,1,6,0,40,0
Ryan Dunn twice over drink-drive limit at time of fatal accident,0,1,2,51,1,10,0,53,0
Tony Bellew stops hobbling David Haye in extraordinary boxing upset,0,3,4,54,0,9,0,58,0
What It’s Like To Grow Up With Your Best Friend,0,3,10,27,1,9,0,37,0
Shocking Video Shows Passenger Being Forcibly Removed From Overbooked Flight,0,3,10,57,0,9,0,67,0
Alec Baldwin Says That Angry 2007 Voicemail Hurt Daughter In A 'Permanent' Way,0,3,12,48,2,12,4,60,0
"Indonesians’ Taste for Dog Meat Is Growing, Even as Others Shun It ",0,2,10,43,2,12,0,53,0
Lorde new album release date hinted at by record label,0,3,1,44,0,9,0,45,0
Here's how Rep. Lewis responded to Trump without saying his name,0,2,4,48,2,10,0,52,0
Baylor Graduate Claims School Paid for Another Student's Tuition to Not Discuss Sexual Assault,0,3,12,68,1,13,0,80,0
Seal in Japan falls in love with stuffed animal lookalike - Yahoo,0,2,3,50,1,11,0,53,0
"Kylie Jenner Remembers She's 19, Crashes High School Prom",0,2,8,37,2,8,2,45,0
"Treasuries Rise With Gold, Dollar as U.S. Stocks Edge Higher",0,3,10,38,3,9,0,48,0
Philippines Proposes ‘Gentleman’s Agreement’ with China on South China Sea - Breitbart,0,2,9,62,4,11,0,71,0
Teen inspires first transgender doll,0,3,1,31,0,4,0,32,0
Brian Westbrook Responds to Drew Pearson at Start of Day 3 of 2017 NFL Draft,0,3,11,46,0,14,5,57,0
Dalai Lama visits monastery despite protests from China,0,1,3,45,0,7,0,48,0
Resources Minister Matt Canavan opens $5 billion infrastructure fund for clean-coal power stations,0,3,4,79,2,12,1,83,0
Bring Me The Horizon's Oli Sykes Created a 'Star Wars'-Themed Clothing Line,0,3,12,48,4,11,0,60,0
"Former Sen. Bob Dole's Influence Helped Lead to Call Between Trump, Taiwan",0,3,11,49,3,11,0,60,0
Pot is ruining Denver’s restaurant industry,0,2,2,35,1,5,0,37,0
".asia domain applications near 300,000 on opening of registration",0,1,0,49,2,8,6,49,0
"Two jockeys killed in fire in North Yorkshire, England",0,1,4,41,1,8,0,45,0
'Game of Thrones' creators reveal final season's episode run and we're devastated,0,3,2,64,4,11,0,66,0
"Stop Trashing LeBron For Taking Games Off, the NBA is to Blame",0,3,12,38,1,11,0,50,0
Meryl Streep's Golden Globes speech sparks outrage among MMA fans,0,3,7,48,1,9,0,55,0
There's $29.4 billion in cryptocurrencies â here's which ones people are using the most,0,3,1,66,6,13,3,67,0
Human Rights Watch: US abuse of Iraqi prisoners continues,0,1,6,42,1,8,0,48,0
Lake created by coal waste landslide floods Bosnian highway ,0,2,2,49,0,9,0,51,0
"Brilliant, bold, bisexual, boss: the author of 'Goodnight Moon' was before her time",0,3,3,62,6,12,0,65,0
"Peter Vaughan, star of Game of Thrones and Porridge, dies aged 93",0,3,5,45,2,11,2,50,0
Biggest Steals From Round One Of The 2017 NFL Draft,0,3,11,27,0,9,4,38,0
Microsoft: We've already patched the Shadow Broker Windows exploits,0,3,5,52,2,8,0,57,0
"Saudi Arabia, Iraq Push OPEC Over Its Ceiling",0,3,11,26,1,7,0,37,0
New Exodus Fuels Concerns in Pakistan,0,1,5,27,0,5,0,32,0
Perez promises to be Trump’s ’worst nightmare’,0,2,2,35,3,6,0,37,0
Steven Mnuchin Is Confirmed as Treasury Secretary ,0,2,6,37,0,7,0,43,0
School Celebrates Crossing Guard Who's Served Same Corner For 50 Years,0,3,10,47,1,10,2,57,0
"Australian Treasurer hands down budget, announces two years of deficits",0,1,2,59,1,9,0,61,0
Valentine's Day celebrations banned in Islamabad,0,2,3,39,1,5,0,42,0
A school bus driver left a 6-year-old at an empty house. She was found walking down a highway.,0,3,2,70,4,17,1,72,0
"Obama Speaks Up, Praising Protests and Opposing Religious Test ",0,3,8,45,1,9,0,53,0
"Golden St Warriors Steve Kerr Comments on Marijuana Use, Charles Barkley, Coaching Future",0,3,12,63,2,12,0,75,0
"Kathleen Sebelius, Kansas Governor, Seen as Top Choice in Health and Human Services Post",0,1,11,62,2,13,0,73,0
South Downs to get National Park status in UK,0,1,6,31,0,8,0,37,0
Inside Forbes: We're Kicking Off 2017 By Embracing The Next Wave Of Media Realities,0,3,13,51,2,13,4,64,0
A partner at Dan Loeb's Third Point has left,0,2,5,30,1,8,0,35,0
Canada's supercomputer goes online,0,1,1,29,1,3,0,30,0
France Opens Germanwings Crash Criminal Inquiry ,0,3,6,36,0,6,0,42,0
John Coates isn't Australia's only voice at the International Olympic Committee,0,3,6,61,2,10,0,67,0
"24 CRPF Jawans Martyred AsAmbush Them In Chhattisgarh's Sukma, CM Raman Singh Calls Emergency Meeting",0,2,19,64,2,14,2,83,0
Nordstrom Surges After Belt-Tightening Effort Bolsters Earnings,0,3,8,48,1,6,0,56,0
Tabcorp to sell Odyssey gaming arm as proposed Tatts merger rolls on,0,2,3,54,0,11,0,57,0
Drug-resistant infections on the rise in American hospitals,0,1,2,49,1,7,0,51,0
Slipknot bassist Paul Gray found dead in hotel room at age 38,0,1,3,45,0,11,2,48,0
New 'Fargo' trailer gives us double the Ewan McGregor,0,3,5,38,2,8,0,43,0
How to Treat Acne Scars Without Making Them Worse,0,3,8,33,0,8,0,41,0
Singapore's first hypercar will be an all-electric carbon-fibre machine,0,3,1,59,3,8,0,60,0
"Couple gives waitress a $400 tip, then pays for her college tuition",0,3,1,50,2,11,3,51,0
"For A More Ordered Life, Organize Like A Chef",0,2,9,27,1,8,0,36,0
"Alright, So, How Does Arthur Wear Glasses?",0,3,7,26,3,6,0,33,0
"FBI recruits for ""War on Porn""",0,1,5,18,2,5,0,23,0
Indonesia investigates video showing apparent security forces torture,0,1,1,61,0,7,0,62,0
Britain to Add 700 Troops to Afghan War,0,1,5,24,0,7,3,29,0
Sotheby’s to Auction Off Record-Breaking Diamond Earrings,0,3,7,42,2,6,0,49,0
UK opposition leader calls for Burma aid to be dispatched by air if access for aid workers does not improve,0,1,3,85,0,19,0,88,0
Glazer caps Manchester United's player transfer spending at £25m a year,0,1,3,54,2,10,2,57,0
"If you like piñatas and cakes, you'll love candy-filled smash cakes",0,3,1,53,3,10,0,54,0
No Post-High School Plans? Chicago Doesn't Think You Should Graduate,0,2,11,45,3,9,0,56,0
U.S. accidentally delivered nuclear missile components to Taiwan,0,1,3,52,2,7,0,55,0
Interview with Jimbo Wales,0,1,3,20,0,3,0,23,0
Travel industry experts warn US tourism could take major hit under Trump ,0,2,4,57,0,12,0,61,0
Turns out that iconic 'Seinfeld' theme song was completely improvised,0,3,2,56,2,9,0,58,0
MT duo & Robot Taiwan 2008: Vast opportunities for machinery industry,0,1,5,48,2,10,4,53,0
"The real dictators of Potomac, Maryland",0,2,3,30,1,5,0,33,0
Why an undefeated high school debate team refuses to compete at Liberty University this weekend,0,2,3,78,0,14,0,81,0
Donald Trump inauguration: R Kelly responds to rumours that he'll perform,0,3,4,57,2,10,0,61,0
Vietnamese police blamed for deaths of over 100 political protesters,0,1,1,55,0,9,3,56,0
Police: Man who streamed 114-mph drive had suspended license,0,3,2,45,2,8,3,47,0
"Trump picks for attorney general, DHS kick off week of confirmation hearings ",0,3,4,60,1,12,0,64,0
2017 NFL Free Agents: Chris Simms' Predictions for the Top 11 Available,0,3,10,42,2,11,6,52,0
Galaxy S8 Vs Galaxy S7: What's The Difference?,0,3,8,26,3,7,2,34,0
Dolly Parton Announces Dec. 13 Telethon for Tennessee Wildfire Victims,0,3,8,50,1,9,2,58,0
Secretive Nonprofits Back Governors Around The Country,0,2,7,41,0,6,0,48,0
"People Are Thanking George Michael For Proving ""There’s No One Right Way To Be A Man""",0,2,16,51,3,15,0,67,0
Townsville aquarium's leopard shark switches to asexual reproduction in extreme form of inbreeding,0,3,1,84,1,12,0,85,0
France's Fillon under pressure to end presidential bid,0,3,2,44,1,7,0,46,0
Trump travels to Dover Air Force Base to honor Navy SEAL killed in Yemen,0,2,11,48,0,13,0,59,0
Australia considers childcare ban on unvaccinated children,0,3,1,51,0,6,0,52,0
Los Angeles Mayor Eric Garcetti wins second term ,0,2,5,36,0,8,0,41,0
"After disappointing Super Tuesday, Kasich turns focus to Midwestern states",0,2,5,59,1,9,0,64,0
Connecticut Men Keep Rolling in Big East Play,0,1,7,31,0,7,0,38,0
Tomato flavor is broken. Can it be fixed?,0,2,2,30,2,7,0,32,0
Charles Oakley Arrested at Madison Square Garden After Altercation in Stands,0,3,9,57,0,10,0,66,0
"Foul-mouthed, anti-Trump professor accosts U.S. Senator on hiking trail",0,2,5,53,5,8,0,58,0
Ex-LA County Sheriff Lee Baca Found Guilty in Corruption Retrial,0,3,11,43,1,9,0,54,0
Philadelphia’s Cinco de Mayo festival is canceled amid fears of an ICE raid,0,3,6,56,1,12,0,62,0
LOOK: Fox News and Fox Business Are Going Red for Women Today  Insider,0,3,14,42,1,13,0,56,0
"For Likely No. 1 Pick Markelle Fultz, Will Missing NCAA Tourney Affect Career?",0,2,15,47,3,12,1,62,0
Judge Allows Jury to Consider Manslaughter in Walter Scott Trial,0,3,8,47,0,9,0,55,0
Heatwave: How to keep cool this weekend — even if you're struck by a power blackout,0,3,2,63,3,15,0,65,0
A fire destroyed this Texas mosque. Thousands have chipped in to help rebuild it.,0,3,3,63,2,13,0,66,0
"A Florida of Sun, Sky, Sea and Mind - The New York Times",0,2,10,31,3,12,0,41,0
Alianna DeFreeze case: Suspect in slaying of Ohio girl found in vacant home enters plea,0,2,5,67,1,14,0,72,0
Md. politician Mel Franklin has wrecked a government vehicle before,0,3,3,54,1,9,0,57,0
"Joint session 2017: The history of the ""designated survivor""",0,3,2,43,3,8,4,45,0
"NFL Jeff Fisher Discusses Future in Coaching, Desire to Play the Rams, More",0,3,12,49,2,12,0,61,0
2007/08 Bundesliga: Bayern Munich vs. Hannover 96,0,1,4,28,3,6,8,32,0
Employment Contracts Are Now Viewed as Rewritable,0,1,6,37,0,6,0,43,0
SpaceX readies Falcon 9 for historic launch,0,3,3,33,0,6,1,36,0
High School Basketball Star LaMelo Ball Drops 92 Points in a Game,0,2,10,42,0,11,2,52,0
Oakland CF Billy Burns Makes a Pair of Outstanding Catches vs. Texas,0,2,10,46,1,11,0,56,0
'I Committed First Murder At 12' SP Candidate In UP Heard Bragging In Leaked Audio Clip,0,2,17,51,2,15,2,68,0
Migrants should be told 'when to put rubbish out and when to queue',0,3,1,52,2,12,0,53,0
Yale grad students' 'hunger strike' apparently involves eating when hungry ,0,3,1,61,3,10,0,62,0
Tourists evacuated following shootout between Mexican army and drug hitmen,0,1,2,63,0,9,0,65,0
Donald Trump Shared a 'Very Nice' Holiday Letter From His New BFF Vladimir Putin,0,3,15,50,2,13,0,65,0
New York prison employee arraigned for allegedly helping killers escape,0,2,2,60,0,9,0,62,0
Beauty and the Beast waltzes its way to the top of the UK box office,0,3,4,50,0,14,0,54,0
What happens when you normalize the abnormal,0,2,1,37,0,6,0,38,0
Aaron Hernandez was no innocent bystander in a bloodstained life,0,3,2,53,0,9,0,55,0
"Russian teenagers talk politics, protests and Putin",0,2,2,42,1,6,0,44,0
North Korea Moves Missile to Launch Pad,0,1,6,27,0,6,0,33,0
Kosovo: voters go to the polls for the first time since independence declared from Serbia,0,1,2,72,1,14,0,74,0
"Depending on Context, Bird Couples Sing in Harmony or Discord",0,1,7,44,1,9,0,51,0
"Inauguration Day tips: Bring cash, pack a phone charger and get there early",0,3,3,58,2,12,0,61,0
"Hillary Clinton Apologized to Obama After Election Defeat, Won’t Run Again",0,2,10,52,2,10,0,62,0
Many pros in Brazil soccer league don't want to play after plane crash,0,3,2,55,1,12,0,57,0
Everything We've Learned About Family Is From Vin Diesel in the 'Furious' Franchise,0,3,11,57,3,12,0,68,0
"Bomb explodes in central Athens, Greece; no injuries reported",0,1,3,48,2,8,0,51,0
2005 National Conference in the Norwegian Centre Party,0,1,5,38,0,7,4,43,0
SAPVoice: How Mexico City Became A Hotbed For Startups,0,2,12,33,1,8,0,45,0
May Calls for Unity in 2017 as Divided U.K. Prepares for Brexit,0,2,8,38,2,11,4,46,0
Nigeria’s Botched Airstrike Shows Boko Haram Isn’t Defeated,0,3,8,42,2,7,0,50,0
Lawmakers Move Quickly on Stimulus Vote,0,1,5,29,0,5,0,34,0
Trump tells Chinese president US will honor 'one China' policy ,0,3,5,46,2,10,0,51,0
"Summer Of Lay-Offs: After Cognizant, IT Giant Wipro Terminates About 600 Employees",0,3,13,52,3,11,3,65,0
"Cousins: Mouthguard came out by accident, ejection 'ridiculous'",0,3,2,50,4,7,0,52,0
A Walled City in Tuscany Clings to Its Ancient Menu,0,1,8,34,0,9,0,42,0
Apple says it spent $50 billion last year with U.S. suppliers,0,2,3,43,3,10,2,46,0
James Harrison celebrates Steelers win with early morning gym session,0,2,3,57,0,9,0,60,0
Poland building collapse leaves three dead,0,2,1,36,0,5,0,37,0
RNA journal submits articles to Wikipedia,0,1,4,32,0,5,0,36,0
"Syria Clearly to Blame in Chemical Attack on Town, U.S. Says",0,3,9,38,3,10,0,47,0
"A Bookstore Is Displaying All Books By Men Backwards, And It’s Eye-Opening",0,3,13,47,3,11,0,60,0
President Obama’s farewell speech was a remarkable pep talk on democracy,0,2,2,59,1,10,0,61,0
Chrissy Teigen Opens Up About Dealing With Postpartum Depression,0,2,9,47,0,8,0,56,0
"Loss at Smithfield Foods, as Pork Prices Stabilize",0,1,6,36,1,7,0,42,0
Atlanta fire: Section of highway collapses after blaze,0,3,2,44,1,7,0,46,0
This Girl Celebrated The Iconic Way She Came Out And It’s Perfect,0,3,12,41,1,11,0,53,0
"Consider China's Disappointing 2016 Box Office Numbers An Anomaly, Not A Trend",0,3,11,50,2,11,4,61,0
Obama Toughens Lighting Rules to Cut Energy Use,0,1,7,33,0,7,0,40,0
How Fashion People Celebrate The Lunar New Year,0,3,8,32,0,7,0,40,0
DREAMer to be released after 6 weeks in ICE custody,0,2,8,33,0,9,1,41,0
Obama to leave more troops than planned in Afghanistan,0,2,2,44,0,8,0,46,0
John Kerry finds Vietnam War site where he killed a man,0,3,4,41,0,10,0,45,0
Guy in Court for Traffic Ticket Ends Up Behind Bars After Cocaine Falls Out of His Hat,0,3,14,56,0,16,0,70,0
US-led coalition Mosul air strike killed up to 240 Iraqi civilians 'because Isis snipers used roof',0,3,5,73,3,15,3,78,0
Officers accused of framing men for murder in UK's 'biggest' trial of police,0,1,3,58,3,12,0,61,0
"Braintree fire: Grieving father pays tribute to wife and daughter, 11, who died in house blaze started by candles",0,3,2,88,3,18,2,90,0
Canadian folk singer attacked and killed by coyotes in Nova Scotia,0,1,3,53,0,10,0,56,0
Cleveland woman points gun at barber over 7-year-old son's haircut ,0,3,1,52,3,10,1,53,0
DeMarcus Cousins Calls Out Kings For Trading Him: 'It Was a Coward Move',0,3,13,44,3,12,0,57,0
"Rick Ross, Jidenna & Desiigner Don't Think Snoop Dogg Should Apologize to Donald Trump for 'Lavender' Video",0,3,14,72,5,16,0,86,0
Cleveland Browns punter Andy Lee to wear No. 8 to honor late child,0,2,5,47,1,12,1,52,0
Latin Nominees at 2017 Grammys More Niche Than Commercial,0,3,7,38,0,8,4,45,0
Rust Belt voters made Trump president. Now they want jobs,0,3,4,43,1,9,0,47,0
WA election: Hanson defends Liberals preference deal amid 'hatred' of Colin Barnett,0,3,6,63,3,11,0,69,0
"Do this, not that: How the White House plans to work with Hillary Clinton’s campaign",0,3,6,61,3,14,0,67,0
"In Pain and Joy of Envy, the Brain May Play a Role",0,1,8,30,1,11,0,38,0
'Vinyl Cafe' Radio Show Host Stuart McLean Dead At 68,0,2,10,30,2,9,2,40,0
Jodie Foster tells US travel ban rally: 'It is our time to resist',0,3,5,46,3,12,0,51,0
Donald Trump's 'Celebrity Apprentice' deal may include money from brands,0,3,4,56,3,9,0,60,0
James Earl Jones to get Tony Award for lifetime achievement ,0,2,5,45,0,10,0,50,0
Man hands himself in after St Albans home raided by police during drug operation,0,2,3,64,0,13,0,67,0
Scores killed by flooding in Yemen,0,1,2,27,0,5,0,29,0
Why ESPN is being forced to fire some of your favorite anchors,0,2,5,46,0,11,0,51,0
Desiigner And Dak Prescott Are Featured In Champ Sports' Latest 'The Moment' Commercial,0,2,13,59,3,12,0,72,0
Home video captures alleged UFOs in Haiti,0,1,5,30,0,6,0,35,0
Architects design 'world's tallest' wooden skyscraper,0,3,1,44,3,5,0,45,0
Michelle Kwan Joins Hillary Clinton’s Presidential Campaign,0,3,7,45,1,6,0,52,0
NASA Releases A View Of How Carbon Dioxide Is Moving Over The Earth And You're Going To Be Scared,0,2,22,56,1,18,0,78,0
Captain Planet returns – to take superhero TV down to zero,0,2,4,43,1,10,0,47,0
"Barack and Michelle Obama meet Bono for lunch in NYC, diners applaud and cheer ",0,3,7,57,1,14,0,64,0
15 Survivors Seek $250M-Plus in Deadly Biloxi Train-Bus Crash,0,3,9,36,3,8,5,45,0
King Day in Atlanta: Protests Mix With Prayer,0,1,7,30,1,7,0,37,0
Bob Diaco of UConn Huskies -- Do not need UCF Knights consent for rivalry,0,3,10,48,2,13,0,58,0
Uber Was Tracking Your iPhone Even After You Deleted Their App,0,3,11,41,0,10,0,52,0
Organic Farmers Object to Whole Foods Rating System ,0,2,7,37,0,8,0,44,0
Donald Trump to hold talks with Vladimir Putin 'within weeks' of becoming President,0,2,5,64,2,12,0,69,0
"NATO tankers in Pakistan attacked, four killed",0,1,5,34,1,6,0,39,0
"LaVar Ball Responds to Nike Criticism, Says Big Baller Brand Will Be Competitor",0,2,13,53,1,12,0,66,0
GM’s Long History of Trying to Turn Around Opel ,0,3,8,30,1,9,0,38,0
"Two dead after car crash in Inverness, Scotland",0,1,3,36,1,7,0,39,0
Trump’s Take on Foreign Policy Breaks Transition Taboo,0,3,7,39,1,7,0,46,0
"Brother, Can You Spare $350 a Game?",0,1,5,18,3,6,3,23,0
Lyft pledges $1 million ACLU donation in response to Trump's #MuslimBan,0,3,8,49,3,10,1,57,0
"Nearing 100 days, Trump’s approval at record lows but his base is holding",0,3,2,54,2,12,3,56,0
Vanesa Martin & Manuel Medrano's Gorgeous 'Complicidad' Video: Exclusive Premiere,0,3,9,58,5,9,0,67,0
Ex-player Darryl Hamilton dies apparent murder-suicide,0,2,3,44,2,5,0,47,0
John Hurt dead: 143 roles compressed into four minutes from The Elephant Man and Alien to Harry Potter,0,3,8,73,1,17,3,81,0
Obama’s Last News Conference: Full Transcript and Video ,0,3,7,39,2,8,0,46,0
Bolivia road crash leaves at least 47 dead,0,1,1,32,0,7,2,33,0
Ghana president accused of plagiarising speeches by George W Bush and Bill Clinton in his inaugural address,0,3,6,85,0,16,0,91,0
Former Gitmo Detainee Fails Again in Try to Leave Uruguay ,0,3,8,40,0,10,0,48,0
Sydney Harbour boat crash rescuers awarded with bravery awards,0,3,2,52,0,8,0,54,0
Senator Says He Had Affair With an Aide,0,1,7,25,0,7,0,32,0
White House evasive as House Intelligence Committee grinds to a halt,0,2,5,53,0,10,0,58,0
Will Ivanka Trump Be the Most Powerful First Daughter in History? ,0,3,9,45,1,11,0,54,0
No Joy in Cricketville; Mighty Texan Struck Out,0,1,7,32,1,7,0,39,0
Burmese Nobel Laureate to Face Military Trial,0,1,6,33,0,6,0,39,0
***LIVE AT 10PM ET*** THE DANGEROUS FAGGOT TOUR RETURNS IN CALIFORNIA - Breitbart,0,2,52,8,7,12,2,60,0
Missing woman's relatives find missing man's body in Missouri ,0,3,2,49,2,9,0,51,0
"Jahlil Okafor Trade Rumors: Latest News, Speculation Surrounding 76ers Center",0,2,9,55,2,9,2,64,0
Translation Error Costs Cuba the Use of Two Pitchers,0,1,7,37,0,8,0,44,0
Southern California auto maker announces fully-electric sedan,0,1,2,52,1,6,0,54,0
'Trial of the century': The heir to the Samsung empire is headed to court next week,0,3,3,62,3,15,0,65,0
Arrest in Stockholm Truck Attack: ‘We Think He Is the Driver’ ,0,3,9,39,3,11,0,48,0
Even After Demonetisation Illegal Cash Seized From States Where Polls Are Going On Have Tripled,0,3,15,66,0,14,0,81,0
Court of Appeal upholds Ontario's talks with Caledonia,0,1,4,42,1,7,0,46,0
Cardinals land free-agent CF Dexter Fowler,0,3,5,31,1,5,0,36,0
Down the drain: Inmates escape Tennessee jail through broken toilet ,0,3,3,54,1,10,0,57,0
"The fabulous life of Snap CEO Evan Spiegel, who just took his company public at a $33 billion valuation",0,3,7,74,2,18,2,81,0
Buildings destroyed to slow flooding in China lake,0,1,2,41,0,7,0,43,0
Second Paris fire kills 16 in 18-story building,0,1,2,33,1,7,4,35,0
Russian Opposition Leader Alexei Navalny Detained by Police During Moscow Protest,0,3,10,61,0,10,0,71,0
"‘Big Cats’, brand reviews and the rampant commercialism of the Lions",0,2,3,52,3,10,0,55,0
Food Is Just One Serving Of What Meals On Wheels Gives Seniors,0,2,12,39,0,11,0,51,0
Demosphere.net launches new Wiki,0,1,2,26,1,3,0,28,0
Prince George kicks a ball and plays with toy car at charity polo match,0,3,2,56,0,13,0,58,0
Fox News Host Argues Against Border Wall Using Racial Stereotypes,0,3,10,46,0,9,0,56,0
"Citi beats on the bottom line, misses on the top",0,3,1,37,1,9,0,38,0
Transfer Strategy Pays Dividends as Gonzaga Finally Advances to NCAA Final Four,0,3,13,55,0,11,0,68,0
"Meet Harrison Bailey, the 15-Year-Old QB Who Made Cam Newton's Jaw Drop",0,2,13,41,4,11,2,54,0
Ex-Trump adviser Carter Page denies working with Russians to help campaign ,0,3,5,58,1,11,0,63,0
Why every generation feels entitled,0,3,1,30,0,4,0,31,0
BBC Sport - Boris Becker seeking British citizenship Becker to seek British citizenship,0,3,9,65,1,12,0,74,0
"Julie Bishop calls on US to increase role in region, raises concerns over South China Sea",0,3,7,66,1,15,0,73,0
Fox News Poll:  Voters want congressional investigations into Russia ,0,3,5,53,1,10,0,58,0
Drinking 3 cups of coffee daily can help prevent Alzheimer's ,0,3,2,47,1,10,1,49,0
"Up to ten reported dead, 50 injured after pipeline blast in Iran",0,1,2,48,1,11,2,50,0
Ariel Winter Poses For Untouched Shots In The Name Of Body Positivity,0,3,12,46,0,11,0,58,0
"With Coming Election, the Netherlands Considers a New Relationship to Muslims ",0,2,8,58,1,11,0,66,0
Watch Live: White House Press Briefing,0,3,6,26,1,5,0,32,0
"Intruder jumped White House fence, arrested near residence ",0,3,3,47,1,8,0,50,0
HBO's 'The Young Pope' hasn't got a prayer,0,2,6,25,4,7,0,31,0
Former Spectator editor Alexander Chancellor has died suddenly at the age of 77 ,0,3,4,61,0,13,2,65,0
"QB De'Andre Johnson, dismissed by FSU for punching woman, signs with FAU",0,3,11,47,3,11,0,58,0
Intelligence Inputs From Hyderabad Helped Police In Arresting Suspected ISIS Terrorists,0,3,14,63,0,10,0,77,0
Macau Gaming Revenue Rises 8% in December,0,3,5,28,1,6,1,33,0
Gay Talese's sense of wonder,0,3,2,21,1,4,0,23,0
GOP Health Care Bill Is More Unpopular Than Obamacare Ever Was,0,3,13,39,0,10,0,52,0
United States Government loses AAA credit rating from Standard and Poor's,0,1,8,54,1,10,0,62,0
Memorable moments from Trump's first 100 days in office ,0,3,2,41,1,9,3,43,0
U.S. Plan to Stem Foreclosures Is Mired in Paper Avalanche,0,1,9,38,2,9,0,47,0
Does the Spanish Star Wars title shed light on who will be ‘The Last Jedi’?,0,3,7,51,3,14,0,58,0
"Sometimes, a Political Position Is Just About Wanting a Cigar",0,1,8,43,1,9,0,51,0
Artists erect giant bunny on Italian mountainside,0,1,2,41,0,6,0,43,0
Belgium train crash: Several hurt in Leuven derailment,0,2,3,43,1,7,0,46,0
"Insane Clown Posse's Violent J Talks Duo's Solo Albums, Juggalos' Washington March & Big Plans for 2018",0,3,14,64,5,16,4,78,0
"A Visit with 43, Part IV",0,2,5,11,1,5,2,16,0
Baptist Figure Faces Backlash Over His Criticism of Donald Trump,0,3,9,46,0,9,0,55,0
Syria files UN Security Council complaint after US raid,0,1,7,40,0,8,0,47,0
Phil Simms Shares His Perspective on CBS Deciding to Replace Him with Tony Romo,0,2,13,53,0,13,0,66,0
US Senate blocks Alaska refuge drilling,0,1,4,30,0,5,0,34,0
Here Are 21 Cartoons People Are Sharing In Response To Trump’s Refugee Ban,0,3,12,47,1,12,2,59,0
This list of every ’Word of the Year’ is like taking a trip through time,0,2,3,53,2,14,0,56,0
"In Somaliland, women are being raped and having miscarriages as a result of extreme drought",0,3,2,74,1,14,0,76,0
"6.4 million sign up for Affordable Care Act plans, more than in previous years",0,3,3,58,2,13,2,61,0
"To counter North Korea, admiral says the U.S. should consider adding ballistic missile interceptors in Hawaii",0,3,6,85,3,15,0,91,0
Death Penalty Is Repealed in New Mexico,0,1,6,27,0,6,0,33,0
International Committee of the Red Cross condemns Gaza blockade,0,1,5,50,0,8,0,55,0
"The rise of Larry Ellison, the jet-setting billionaire founder of Oracle",0,3,4,56,2,10,0,60,0
Law will delay University of Minnesota strike,0,1,3,36,0,6,0,39,0
Citizenship test: Australians around the country have their say on values,0,3,2,60,1,10,0,62,0
Who is Billy Bush: the man egging on Trump in tape about groping women,0,2,4,52,1,13,0,56,0
People Are Posting Their Princess Leia Buns to Remember Carrie Fisher,0,2,10,49,0,10,0,59,0
Cats vs. Christmas Trees: Felines Declare War On Holiday Spirit,0,3,9,43,2,9,0,52,0
Parent: Susp. Morehead State coach head-butted son last season,0,3,4,47,3,8,0,51,0
"Thousands Of Displaced Syrians In 'No Man's Land', Face Starvation After Jordan Closes Borders",0,3,14,63,4,13,0,77,0
Find me all the red balloons; MIT wins DARPA challenge,0,1,9,35,1,9,0,44,0
Gareth Southgate lets England players and Eddie Jones do the talking,0,3,5,53,0,10,0,58,0
Afghan family with US visas unlawfully detained at airport for several days,0,2,3,61,0,11,0,64,0
Poland wins the 2008 Eurovision Dance Contest,0,1,4,31,0,6,4,35,0
House vote sets stage for Congress to repeal ObamaCare,0,2,4,42,0,8,0,46,0
"Ersan Ilyasova Traded to Hawks; 76ers Receive Tiago Splitter, More",0,3,8,45,2,9,2,53,0
Accused Bourke St driver Dimitrious Gargasoulas tells court 'I am the saviour',0,2,6,59,2,11,0,65,0
"For Germany, Trump Poses a Problem With No Clear Solution ",0,3,9,38,1,10,0,47,0
Trump sued for allegedly violating the Constitution,0,2,2,43,0,6,0,45,0
Proof of alien life or just a strange rock? Conspiracy theorists spot a 'huge tower' on the surface of Mars,0,2,3,82,3,19,0,85,0
Trump’s Empty Promise of ‘Law and Order’,0,2,5,26,3,6,0,31,0
Scaramucci’s White House Role Now Uncertain ,0,3,6,31,1,6,0,37,0
Assisted suicide is a murky business in new Lifetime drama,0,2,2,47,0,9,0,49,0
U.S. Considers Financial Pay Rules,0,1,6,22,2,4,0,28,0
"Cannibal hamsters forced to eat their own babies due to 'collapsing' habitat, study finds",0,3,1,72,3,13,0,73,0
"Wall Street ends higher on technology, energy boost",0,2,2,41,1,7,0,43,0
$10 note: RBA celebrates Australian writers in new design,0,3,4,41,2,8,2,45,0
State Dept. says US officials will not meet with Muslim Brotherhood delegation ,0,3,6,60,1,12,0,66,0
Justin Bieber's Biggest Moments of 2016,0,3,4,25,1,5,4,29,0
What to expect from Carrie Fisher and Debbie Reynolds' public memorial ,0,3,5,54,1,11,0,59,0
Israeli General Refused NZ Visa,0,1,6,21,0,4,0,27,0
"The Actor Who Played Barb On ""Stranger Things"" Opened Up About Her Bisexuality On Twitter",0,2,15,58,2,14,0,73,0
Mnuchin Warns Health Care Debacle Will Delay Tax Reforms,0,3,9,39,0,8,0,48,0
Family of Dr. King Charged Group Building His Monument,0,1,8,37,1,8,0,45,0
"Tsunami bulletin issued from Pacific coast of California-Mexico border to Vancouver, Canada",0,1,6,72,2,11,0,78,0
Reading Literature Won’t Give You Superpowers,0,2,6,33,1,5,0,39,0
China Tightens Security in Tibet,0,1,4,24,0,4,0,28,0
Goldman Sachs Says Trump Rally Has Been Curbed,0,3,8,31,0,7,0,39,0
Timeline of the Syrian Civil War and U.S. Response,0,3,7,33,2,8,0,40,0
Tom Brady's stolen Super Bowl jerseys found in possession of international media member,0,3,4,70,1,12,0,74,0
US investigators probe close call on North Carolina runway,0,1,4,46,0,8,0,50,0
"A 9,500-year-old skull gets a 3D makeover",0,3,2,25,3,6,5,27,0
Ranking Kanye West's Albums From Worst To Best,0,3,8,30,1,7,0,38,0
New Year’s resolutions often fail. Good thing the year is full of fresh starts.,0,3,3,60,3,13,0,63,0
Why Women Driven By Passion And Purpose Get Seats In Corporate Boardrooms,0,3,12,50,0,11,0,62,0
Father Imprisoned for Genital Cutting Is Deported to Ethiopia ,0,2,7,46,0,9,0,53,0
Gold drops suddenly and sharply,0,3,1,26,0,4,0,27,0
Ocean: An Illustrated Atlas Maps the Sea and Its Mysteries,0,1,8,40,1,9,0,48,0
Lebanon rape law: Wedding dresses hang in Beirut sea front protest,0,3,3,52,1,10,0,55,0
Russell Westbrook breaks NBA single-season record for triple-doubles ,0,3,5,54,2,8,0,59,0
"In Physical Game, Hawks Take a 3-2 Advantage",0,1,6,27,2,7,2,33,0
"An EpiPen rival says it will offer its device for free â but it could cost insurers as much as $4,500",0,3,3,72,4,20,4,75,0
U.S. vice president Joe Biden says positive consensus on same-sex marriage is 'inevitable',0,1,4,69,5,12,0,73,0
James Mattis Strikes Far Harsher Tone Than Trump on Russia ,0,2,9,40,0,10,0,49,0
Police: Suspect in Death of Lawrence Teenager Will Be Tried as Adult,0,3,9,47,1,11,0,56,0
"Judge Who Praised Rapist Probably Isn't Going Anywhere, Utah Officials Say",0,3,11,51,2,10,0,62,0
Urban Meyer watches CFP decision from maternity ward,0,3,5,40,0,7,0,45,0
First 'honest' Oscar ballot is in: 'I hated Arrival - it just sucked',0,2,4,47,6,12,0,51,0
Deutsche Bank Investment Banking Chief Jeffrey Urwin in Talks to Depart,0,3,9,52,0,10,0,61,0
36 Isil militants killed as US drops the biggest non-nuclear bomb ever used in combat,0,3,3,65,1,14,2,68,0
Carter: Race relations in Palestine are worse than apartheid,0,1,3,48,1,8,0,51,0
History shows George Washington was incredibly hard to kill ,0,3,3,48,0,9,0,51,0
’Pokemon Go’ Causes Stampede in Taiwan - Breitbart,0,2,6,34,3,7,0,40,0
Graham 'will do whatever is necessary' to get Gorsuch confirmed to Supreme Court ,0,3,4,62,2,13,0,66,0
Mauritanians See Chance to Break Cycle of Coups,0,1,6,34,0,7,0,40,0
Has China Won The Drone War?,0,3,6,16,1,5,0,22,0
Swedish Journo: Sweden Will Collapse Without Illegal Migrants,0,3,8,45,1,7,0,53,0
Bonus Cuts Hurting More Than Top Wall Streeters,0,1,8,32,0,7,0,40,0
Japan Sends Destroyers on Anti-Piracy Patrol,0,1,6,32,1,5,0,38,0
"Seventeen-year-old shot dead in Merseyside, England",0,1,3,40,3,5,0,43,0
Kobe and Vanessa Bryant Just Welcomed Their Third Baby Girl,0,2,9,41,0,9,0,50,0
"Pulled in 2 Directions, Markets Finally Break Loose",0,1,6,36,1,7,1,42,0
The Demise of Deadly Diesel,0,3,4,19,0,4,0,23,0
Missy Elliott Pays Tribute to Aaliyah's 'Timeless Music & Style' 20 Years After 'One in a Million' Was Released,0,3,14,71,6,18,2,85,0
President of Poland Is Sanguine on Economy,0,1,5,31,0,6,0,36,0
"At Paris Air Show, Little Flash and Lots of Introspection",0,1,8,39,1,9,0,47,0
CrossCountry allows passengers to change Advance tickets without paying fee,0,3,3,63,0,9,0,66,0
Watch Amazon make its first drone delivery,0,3,2,34,0,6,0,36,0
U.S. List of Those Detained for Trump’s Travel Ban Is Called Incomplete ,0,2,11,46,3,12,0,57,0
Tough Choices Loom on Long Road to Replacing Obamacare,0,3,7,39,0,8,0,46,0
Workers at Swansea auto parts plant vote to strike,0,1,2,40,0,8,0,42,0
More than 160 dead in bushfires in Australia,0,1,2,32,0,7,3,34,0
"Gulf of Mexico waters are freakishly warm, which could mean explosive springtime storms",0,2,2,72,1,12,0,74,0
ECB Rejects Monte Paschi Bid for More Time on Capital,0,3,10,34,0,9,0,44,0
Goose IPO Vaults Reiss From Aspiring Writer to Millionaire,0,2,10,40,0,8,0,50,0
"Dave Grohl breaks leg during Foo Fighters concert, gets a cast, returns to finish onstage",0,3,4,69,2,14,0,73,0
American Car Buyers Will Pay the Price for a Mexico Tariff,0,3,8,40,0,10,0,48,0
Northeast Braces for Potentially Historic March Blizzard,0,3,6,44,0,6,0,50,0
"Explosion At French Nuclear Plant, No Risk Of Contamination Or Leakage Yet!",0,2,12,50,2,11,0,62,0
Passenger and horrified onlookers below film moment tourist helicopter plunges into a river,0,3,1,78,0,12,0,79,0
England beat India in one-day cricket series opener,0,1,2,41,1,7,0,43,0
Paris shooting: Election campaign halts as investigation gathers pace,0,2,2,58,1,8,0,60,0
Who Will Own Your Data If the Tech Bubble Bursts?,0,2,9,30,1,9,0,39,0
Dylann Roof trial: Jury seated in Charleston,0,2,4,33,1,6,0,37,0
Saving a Kashmiri Village After Remaking His Life,0,1,7,35,0,7,0,42,0
At least fifteen dead after stampede at Mali mosque,0,1,2,41,0,8,0,43,0
61 Of The Greatest Signs From Women’s Marches Around The Country,0,2,10,41,1,10,2,51,0
"Russia now recognizes Ukrainian rebel documents, passports ",0,3,2,49,1,7,0,51,0
’Refugee Child’ Sexually Assaults 10-Year-Old Girl After Liberal Parents House Him - Breitbart,0,2,13,62,5,12,2,75,0
Trump hits back at US media reports on Russia contacts,0,3,4,41,0,9,0,45,0
PBOC Conducts 60 Billion Yuan China Open-Market Operations,0,3,11,37,1,7,2,48,0
LeBron James plotted Heat exit while Dwyane Wade sat nearby,0,2,6,44,0,9,0,50,0
Thousands flee Aleppo as Assadâ€™s forces move to split Syrian rebel stronghold,0,2,4,62,2,11,0,66,0
New Orleans Woman Survives Tornado Hiding in Bathtub: 'I Just Started Praying' ,0,2,11,53,3,12,0,64,0
‘Finally. Someone who thinks like me.’,0,2,2,27,4,5,0,29,0
"Interview with Anna Mikkola, Finnish Left Alliance candidate for European Parliament",0,1,8,65,1,10,0,73,0
Haiti might have to postpone elections again,0,1,1,37,0,6,0,38,0
"Brexit: UK employees 'not confident' of Government's ability to negotiate a good deal, survey finds",0,3,4,76,5,14,0,80,0
Molly Ball: Don’t Trust Pelosi’s Predictions About Dems Retaking the House - Breitbart,0,2,11,59,4,12,0,70,0
UN Ambassador Haley hits Russia hard on Ukraine,0,3,6,34,0,7,0,40,0
'Top Model' winner CariDee English on her modeling career and her battle with psoriasis,0,1,5,67,2,13,0,72,0
"Namibia struck by floods, president declares state of emergency",0,1,1,53,1,8,0,54,0
Dalai Lama expresses hope for Trump-Putin relationship,0,3,4,43,1,6,0,47,0
Press freedom groups condemn two-day radio station ban in Burundi,0,1,2,53,1,9,0,55,0
Cheap Trick Debuts 'Long Time Coming' Single From 'We're All Alright!' Album: Exclusive,0,3,13,55,7,12,0,68,0
Australian Bureau of Statistics faces budget cut,0,1,3,39,0,6,0,42,0
One Benefit of Co-op Education: Likelihood of a Job,0,1,6,35,2,8,0,41,0
"Gregg Popovich Rips Donald Trump, Praises Women's March in Washington D.C.",0,2,11,49,4,10,0,60,0
FIFA’s film about itself made $607 at theaters this weekend,0,3,4,41,2,9,3,45,0
CN Health & Safety Plan planned to be cancelled,0,1,5,33,1,8,0,38,0
Badlands on Twitter: US park climate change tweets deleted,0,3,4,45,1,8,0,49,0
Ridiculous Fox anchor to Teen Vogue writer: 'stick to the thigh-high boots',0,3,4,56,4,11,0,60,0
IMF meeting drops anti-protectionism pledge,0,3,3,35,1,4,0,38,0
"It’s Do-or-Die Time on Health Care for Trump, GOP",0,2,10,27,4,8,0,37,0
"Tom Brady Wore A Massive Coat, And The Internet Loved It",0,3,11,34,1,10,0,45,0
Dam removal proposal for Klamath River,0,1,3,30,0,5,0,33,0
Newsreader Natasha Kaplinsky gives birth to baby boy,0,1,3,42,0,7,0,45,0
NDIS debate: Pyne says Government has 'no intention' of increasing taxes to fund program,0,2,6,66,3,13,0,72,0
Roche Names Leaders for Genentech,0,1,4,25,0,4,0,29,0
U.S. makes new arrest in fraud probe of bankrupt video tech firm,0,2,2,49,2,11,0,51,0
UK elections: David Cameron becomes Prime Minister,0,1,6,37,1,6,0,43,0
J.Crew Cuts 175 Jobs As Brand Loses Cool With Women,0,2,10,28,1,9,3,38,0
Insurgents kill several people in Baghdad as Iraq's parliamentary elections start,0,1,3,67,1,10,0,70,0
Sen. Tom Cotton says House moved too fast on health care efforts,0,3,4,48,1,11,0,52,0
"If Trump Weakens Fuel Economy Standards, American Innovation Will Be The Price",0,2,12,54,1,11,0,66,0
Smokeless tobacco might be far less common among big league newcomers ,0,2,1,58,0,11,0,59,0
Parole panel delays decision on whether to release Charles Manson follower ,0,3,3,61,0,11,0,64,0
Iowa Pol Pushing Bill To Get More GOP Profs On College Campuses,0,3,14,38,0,11,0,52,0
Bruce Highway crash: Fatal four-vehicle collision closes major road near Maryborough,0,2,4,68,2,10,0,72,0
Officer quits to avoid firing after shooting of unarmed teen ,0,3,1,50,0,10,0,51,0
Emma Watson Plays Life Coach at New York’s Grand Central Station [Video],0,3,11,47,3,11,0,58,0
"German Justice Minister: We need judges, prosecutors to crack down on fake news on Facebook",0,3,5,70,2,14,0,75,0
State Department website removes article touting history of Trump’s Mar-a-Lago estate,0,3,5,67,3,10,0,72,0
Criminal charges filed in Nov. 19 NBA brawl,0,1,5,28,1,7,2,33,0
"Americans’ right to protest is in grave danger under Trump, United Nations warns",0,3,4,62,2,12,0,66,0
"G-Eazy & Carnage Roam the Streets as Bobble Heads in 'Guala', Announce Joint 'Step Brothers' EP",0,2,14,59,7,15,0,73,0
Coalition talks between Israeli Likud and Labour parties underway,0,1,4,53,0,8,0,57,0
"The week in finance: Donald Trump takes charge, while inflation is the focus in Australia",0,3,4,69,2,14,0,73,0
Sunil Grover's Latest Post Isn't A Sly Dig At Kapil Sharma But A Hint About New Beginnings,0,2,17,55,2,16,0,72,0
Astronaut set to spend one year in space,0,2,1,32,0,7,0,33,0
Data Shows China Relies More on Growth at Home,0,1,7,31,0,8,0,38,0
Protests Wane in Moldova as Vote Recount Is Announced,0,1,7,38,0,8,0,45,0
Latinos See Historic ‘Firsts’ As New Congress Gets Started,0,3,9,39,2,8,0,48,0
Paris clashes: 13 arrested as scuffles break out after protest against police brutality ,0,3,1,71,1,13,2,72,0
"Move to impeach IRS boss fails, spotlights GOP split",0,3,7,36,1,8,0,43,0
"Lose an AirPod, Pay the Price",0,3,5,18,1,5,0,23,0
U.S. women's hockey tops Canada for world championship as Hilary Knight scores in OT,0,3,7,61,3,13,0,68,0
British MP reveals Fred Goodwin superinjunction,0,1,5,37,0,5,0,42,0
U.N. Rights Official Fears War Crimes in Sri Lanka,0,1,9,31,2,8,0,40,0
The art of surgery: life drawing and leprosy,0,2,1,35,1,7,0,36,0
"As Costs of College Sports Rise, Students Balk at Paying Tab",0,1,9,40,1,10,0,49,0
"U.S.A. Basketball Is Already Cruising in Rio. Now, to Take the Court. - The New York Times",0,2,15,52,7,16,0,67,0
Super Bowl: The veiled political statement in Lady Gaga's performance,0,2,5,53,2,9,0,58,0
Innocent Googling? No Such Thing in Tehran,0,1,6,29,1,6,0,35,0
"Talking to robots might make you feel better about your love life, new research shows",0,2,1,69,1,14,0,70,0
Invest Another $100 in Madoff (Hammer Included),0,1,5,30,3,6,3,35,0
"Petrol Pumps Will Continue To Accept Cards, But Only Till 13 January!",0,3,11,43,2,11,2,54,0
Nissan Reveals How Connected Cars Could Turn Into A Goldmine,0,3,10,41,0,9,0,51,0
Problems Pile Up for Uber in a Traffic Accident of a Week,0,3,7,39,0,11,0,46,0
Good news: automation already destroyed most of the jobs,0,2,1,46,1,8,0,47,0
Federal Judge Temporarily Blocks Donald Trump's Travel Ban,0,2,8,42,1,7,0,50,0
"Water streaming across Antarctica surprises, worries scientists",0,3,2,54,1,6,0,56,0
Drake Celebrates 'Views' Quadruple Platinum Certification,0,3,6,44,2,5,0,50,0
Here’s the Final Version of the Oculus Rift — and Some Insane New Controllers,0,3,9,53,2,13,0,62,0
Trump’s pick for national security adviser had role in firm co-led by man who tried to sell material to the KGB,0,2,4,85,2,20,0,89,0
Early John Lennon Bandmate & Childhood Friend Pete Shotton Dies at 75,0,3,9,46,1,11,2,55,0
American fighting with Kurds in Syria killed in ISIS battle ,0,3,7,43,0,10,0,50,0
"Jahlil Okafor Trade Rumors: Latest News, Speculation Surrounding 76ers Center",0,3,9,55,2,9,2,64,0
"Ricky Rubio Trade Rumors: News, Speculation Surrounding Timberwolves Guard",0,2,9,55,2,8,0,64,0
Spotify Is Now Letting Other Companies Check Out Your Tunes — And You,0,2,12,44,1,12,0,56,0
"Obama alters Afghanistan exit plan once more, will leave 8,400 troops",0,2,2,51,2,10,4,53,0
Truck Plows Into Crowd Near Christmas Market In Berlin,0,3,9,37,0,8,0,46,0
Buying a Kalashnikov Is Easier Than Ever at the Moscow Airport,0,3,8,44,0,10,0,52,0
Sesame Street introduces muppet with autism to teach children about disorder,0,2,2,64,0,10,0,66,0
"Bush backtracks over legal status of alleged ""Dirty Bomber"" Jose Padilla",0,1,5,55,2,10,0,60,0
‘Jurassic World’ Bites Off Biggest Global Debut of All Time With $511.8 Million,0,2,11,48,4,12,4,59,0
House Passes Expansion of Programs for Service,0,1,5,35,0,6,0,40,0
First charges laid over riot text messages,0,1,1,35,0,6,0,36,0
Kyle Edmund battles bravely in defeat to Stan Wawrinka at the Brisbane International,0,2,6,66,0,12,0,72,0
New report details strain on US Army,0,1,4,26,0,6,0,30,0
California judge disqualified from predatory lending case,0,1,1,50,0,6,0,51,0
Universal Music Commits to Virtual Reality With MelodyVR Deal,0,3,10,43,0,8,0,53,0
Officials Set Timetable for Getting Particle Collider Back on Track,0,1,8,50,0,9,0,58,0
"David Horowitz: Stephen Miller, a Second Thoughts Warrior",0,3,7,41,2,7,0,48,0
MSNBC’s Reid: ’Empty Vessel’ Trump Could Provoke a Crisis With ’Christians Versus Islam’ Talk - Breitbart,0,2,18,65,7,15,0,83,0
TWU members reject contract,0,1,3,21,0,3,0,24,0
People Are Mad That Marvel Paired A Holocaust Survivor With A Fascist Adjacent Group,0,3,14,57,0,13,0,71,0
"Majority of Americans do not believe Donald Trump will keep his promises, poll finds",0,3,4,66,1,13,0,70,0
Companies Hang On to Venezuela Plants Despite Seizures,0,3,7,40,0,7,0,47,0
Venus vs. Serena: ‘A Williams Is Going to Win’ the Australian Open ,0,3,9,42,4,12,0,51,0
"Man Viciously Kills, Dismembers Parents in Tennessee",0,3,6,39,1,6,0,45,0
"How Much Will the Inauguration Cost, and Who’s Paying? ",0,3,7,36,3,9,0,43,0
"OPEC Achieves Cuts in Output, Halting Price Slide",0,1,10,31,1,7,0,41,0
Kosmos-3M launches final SAR-Lupe satellite,0,1,6,30,2,4,1,36,0
Madoff Trustee Seeks $3.2 Billion From Hedge Fund,0,1,7,31,2,7,2,38,0
Mike Conaway Emerges From Relative Obscurity to Lead House Russia Inquiry ,0,3,10,53,0,11,0,63,0
'Overwatch' will ban you if you use custom games to farm XP,0,2,3,43,2,11,0,46,0
Wildfire Near Boulder Forces Thousands of Coloradans From Their Homes,0,3,9,51,0,9,0,60,0
The Irony That Could Trip Up Trump's Quest To Make The U.S. Economy 'Great Again',0,3,16,46,5,14,0,62,0
"2008 Computex Preview: WiMAX, threat? opportunity?",0,1,6,31,4,5,4,37,0
Polar bear and wild reindeer decline worsening as climate change continues to melt Arctic ice: study,0,2,2,82,1,15,0,84,0
Antitrust Rulings Put Chill on Health-Insurance Mergers,0,2,7,41,1,6,0,48,0
Team Plagiarizes Golden State Warriors. Team Is Undefeated. ,0,2,8,42,2,8,0,50,0
Trump's First Day as President Brought Out Thousands of Protesters,0,2,8,48,1,9,0,56,0
"At last, a good use for tobacco: Plants are being used to grow human skin proteins to treat injuries",0,2,2,78,2,18,0,80,0
Mika Brzezinski: Hillary Campaign Tried to Get Me ‘Pulled Off the Air’,0,3,10,46,3,11,0,56,0
Cornel West: ‘I’m Not Convinced That the Democratic Party Can Be Reformed’,0,3,11,48,4,11,0,59,0
Steve Bannon Allegedly Made Millions Off 'Seinfeld' and Larry David Knew Nothing About It,0,3,13,61,2,13,0,74,0
"‘S.N.L.’ Goes After Trump Again, With Melissa McCarthy as Sean Spicer ",0,3,13,40,6,11,0,53,0
Career education with the future employer in mind,0,3,1,41,0,7,0,42,0
"With 'The Grand Tour,' Amazon Bets Millions On Jeremy Clarkson's Car Show",0,2,12,46,4,11,0,58,0
Taliban insurgents disguised in army uniforms kill up to 140 Afghan soldiers at a military base,0,2,2,75,0,15,3,77,0
South Koreans are showing the world how protests can work,0,3,2,46,0,9,0,48,0
"I had a 'screw it moment', says MEP who held sign up behind Nigel Farage",0,3,6,49,3,14,0,55,0
"For Just $4 Million, You Can Watch YG Perform ""FDT"" At Trump's Inauguration",0,2,15,42,5,12,1,57,0
'Pharma bro' Martin Shkreli says he wasn't hit in the face by dog poop,0,3,3,51,3,13,0,54,0
Mass graves found in Lebanon,0,1,2,22,0,4,0,24,0
NCAA Says Rick Pitino Did Not Properly Handle Louisville Recruiting Sex Scandal,0,3,15,53,0,11,0,68,0
This British teen standing up for gender equality is our feminist hero,0,3,2,57,0,11,0,59,0
Commodities Still Attract the Adventurous,0,1,4,33,0,4,0,37,0
Boots recalled after owner discovers swastika footprints,0,3,1,49,0,6,0,50,0
Graceland to Open New Entertainment Complex in March,0,3,6,39,0,7,0,45,0
"‘The Good Fork Cookbook,’ reviewed: A reminder of what made Brooklyn hype-worthy",0,3,6,58,5,11,0,64,0
Scores killed and wounded as violence escalates in Iraq,0,1,2,45,0,8,0,47,0
"Section 18C: What racial vilification complaints have been upheld, dismissed by a judge?",0,3,3,68,3,12,2,71,0
"Minimum wage: ACTU pushing for $45-a-week increase, employers want lower pay rise",0,3,5,58,5,11,2,63,0
Swiss Voters Get a Say on Future of Corporate Tax Paradise,0,3,8,40,0,10,0,48,0
Robert Randolph Premieres 'She Got Soul': Watch,0,2,7,31,3,6,0,38,0
A dog that REALLY turns heads: Fancy-dress loving pooch walks on hind legs wearing a wig and ball gown,0,3,8,74,2,18,0,82,0
Recap: Indian Finance Minister Arun Jaitley Presents the Budget to Parliament - India Real Time,0,2,12,67,2,14,0,79,0
Turkey's Erdogan accuses Germany of 'Nazi practices' over rallies,0,3,4,50,3,8,0,54,0
"Cops: Man accused of killing wife, stepson, claimed self-defense",0,3,2,50,4,8,0,52,0
French Election Will Signal Nation’s Commitment to Economic Reform,0,3,8,49,1,8,0,57,0
"In Interview, Republican Chairman Strays From the Party Line on Abortion",0,1,9,52,1,10,0,61,0
Everyone is Upset About the Cavaliers Trading for Kyle Korver,0,3,7,45,0,9,0,52,0
Tony Blair admits he did not realise how many migrants would come to the UK after EU expanded ,0,3,6,70,0,18,0,76,0
"For Now, Albert Pujols Is at Home in St. Louis",0,1,8,27,2,9,0,35,0
Rapid Declines in Manufacturing Spread Global Anxiety,0,1,6,41,0,6,0,47,0
Arsenal drawn against Bayern Munich in Champions League last 16,0,3,5,47,0,9,2,52,0
"Tom Hanks is outdated, says son Chet",0,3,3,26,1,6,0,29,0
Troubling Issues From Linda McMahon's Time As Wrestling CEO Go Unmentioned In Senate Hearing,0,3,17,61,1,13,0,78,0
"Nightly News Nearly 200,000 Forced From Homes Due to Calif. Reservoir Flooding Emergency",0,3,11,57,2,12,6,68,0
Mugabe Rival Is Back in Zimbabwe,0,1,5,22,0,5,0,27,0
Rosario Dawson’s family friend is living out of an RV,0,2,4,39,1,9,0,43,0
Trump Rescinds Rules on Bathrooms for Transgender Students ,0,3,6,45,0,8,0,51,0
'The Walking Dead' recap: Rick makes a new best friend in episode 10,0,2,4,47,3,12,2,51,0
One brutal table from McKinsey shows how miserable banking is right now,0,3,3,57,0,11,0,60,0
Trump: 'No guarantee' on Russia relations,0,2,3,30,3,5,0,33,0
"On Criminal-Justice Reform, Obama Should Practice What He Preaches — Civility",0,2,11,53,3,10,0,64,0
Greenwood Calls Out Celebs: Do Not Use the Stage as a Pulpit for Politics  Insider,0,3,11,55,1,15,0,66,0
United Airlines Domestic Flights Grounded for 2 Hours by Computer Outage,0,3,8,53,0,10,1,61,0
First supernova seen during explosion breakout,0,1,1,40,0,5,0,41,0
"Revealed: 100,000 wait more than two weeks to see cancer specialist",0,3,1,48,2,10,6,49,0
Racing Drivers: Tatiana Calderón and Ramona Karlsson,0,3,6,39,1,6,0,45,0
Snowden and WikiLeaks Clash Over How to Disclose Secrets - The New York Times,0,2,12,51,1,13,0,63,0
A dispute over St. Petersburg’s grand Orthodox cathedral stirs up Russia’s anti-Semitic conspiracies,0,2,6,78,4,12,0,84,0
'I Don't Believe It': Trump Responds to CIA Report of Russian Interference  Insider,0,3,13,53,4,13,0,66,0
Spotify's Troy Carter Appointed Entertainment Advisor for Prince's Estate,0,2,8,55,2,8,0,63,0
"As Indian Outsourcing Changed, Satyam Hesitated",0,1,6,35,1,5,0,41,0
"After 5 Months, China to Try Would-Be Protester",0,1,7,30,2,7,1,37,0
Bahamas billionaires spat turns serious with murder-for-hire claim,0,2,1,56,2,7,0,57,0
Australian town to change name to promote road safety,0,1,1,44,0,8,0,45,0
North Dakota Bar Owner Pulls Off a Monumental Coup,0,2,8,34,0,8,0,42,0
Is Facebook Doing Enough to Keep Murders Off Their Site?,0,3,9,37,1,9,0,46,0
Arms and Airports: Fort Lauderdale Renews Concerns Over Guns in the Terminal ,0,3,9,55,1,12,0,64,0
Canada has no immediate plans to deter people from crossing border illegally ,0,2,1,64,0,12,0,65,0
IPCC attacks Met chief's call for more trust in police marksmen,0,3,5,47,1,10,0,52,0
President Trump addresses joint session of Congress | Live Coverage,0,3,5,52,1,9,0,57,0
"Accounts, People, Miscellany",0,1,3,21,2,2,0,24,0
Former NZ Prime Minister confirmed as head of UNDP,0,1,9,33,0,8,0,42,0
"If Donald Trump Pushes on Taiwan, How China Could Push Back ",0,3,10,38,1,11,0,48,0
Alaska senator Ted Stevens indicted in corruption scandal,0,1,3,47,0,7,0,50,0
Archie Miller Agrees to Contract with Indiana to Replace Tom Crean,0,3,8,48,0,10,0,56,0
"Dolly Parton College Course Combines Music, History and Appalachia Pride ",0,2,9,53,1,10,0,62,0
Adele Restarts Touching George Michael Tribute At The Grammys: 'I Can't Mess This Up For Him',0,3,16,58,4,15,0,74,0
UK bans laptops and big smartphones on airlines from 6 countries,0,2,2,51,0,10,1,53,0
Liberal group launches site tracking Trump's Mar-a-Lago trips,0,3,4,47,3,7,0,51,0
Romania Fed Cup captain Ilie Nastase heard making a derogatory comment about Serena Williams' unborn child,0,2,7,83,1,15,0,90,0
'Coup' in North Carolina: GOP governor signs first of several bills to gut his Democratic successor's power,0,2,7,80,4,16,0,87,0
Judges overturn abuse conviction of man who killed himself during trial,0,3,1,60,0,10,0,61,0
Canadian Conservatives vow to defend Arctic sovereignty,0,1,3,46,0,6,0,49,0
Obama has few options to protect DREAMers before Trump takes office,0,2,7,50,0,10,0,57,0
"German GDP drops by 3.8%, largest decline in 40 years",0,1,4,33,3,9,4,37,0
Thousands protest Iraq war in Washington D.C.,0,1,5,32,2,6,0,37,0
Japan Eliminates U.S. in World Baseball Classic,0,1,7,32,2,6,0,39,0
‘Greatest threat to democracy’: Commander of bin Laden raid slams Trump’s anti-media sentiment,0,2,4,73,5,12,0,77,0
"World’s Billionaire Ranks Fell in 2016, as Did Their Combined Wealth ",0,2,8,44,2,11,4,52,0
Cathay's New CEO Faces One of Aviation's Toughest Turnaround Jobs,0,3,11,43,2,9,0,54,0
Aussie Fund Giant Sees 'Great Opportunity' in Trump,0,2,7,35,2,7,0,42,0
DWP admits it hasn’t assessed impact of closing 78 local jobcentres despite announcing policy last month,0,3,3,83,1,15,2,86,0
"Trump Can Help Spur Rebound in Diamond Sales, Top Producer Says",0,3,10,42,1,10,0,52,0
Herman Cain: SimCity rumor 'a lie',0,1,4,22,3,5,0,26,0
Is Cleveland Cavaliers' Secret Playoff Defense a Smoke Screen or the Real Deal?,0,3,10,55,2,12,0,65,0
Thousands Sign Petition to Oust Professor Over Harassment of Ivanka Trump  Insider,0,3,10,60,0,12,0,70,0
Japan Wants to Keep Trade Hardliner Wilbur Ross Away From Some Economy Talks,0,3,12,52,0,12,0,64,0
Evacuated Bristol families return home,0,1,2,32,0,4,0,34,0
Japanese students feared dead after avalanche; at least 6 injured ,0,3,1,53,1,10,1,54,0
David Gilkey: His NPR Buddies Share Stories About Their Favorite Pictures,0,2,13,49,1,10,0,62,0
"Sony Music's Carmine Coppola Elevated to EVP, CFO",0,3,11,29,2,7,0,40,0
Canadian trio claim South Pole record for trans-Antarctic trip,0,1,4,49,1,8,0,53,0
Man masterfully transforms his face with makeup to look like Caitlyn Jenner,0,2,3,61,0,11,0,64,0
"As Others Fled Venezuela, Stanford Saw a Chance",0,1,7,32,1,7,0,39,0
30 Under 30 Asia 2017: Pioneer Women,0,2,4,17,1,6,8,21,0
Iran to end nuclear cooperation,0,1,1,26,0,4,0,27,0
BBC Sport - Lewis Hamilton 'living his dream' after Canada win Winner Hamilton 'living his dream',0,3,9,68,5,15,0,77,0
Bombings in Iraq kill scores,0,1,2,22,0,4,0,24,0
Trump transition knew Flynn might register as foreign agent ,0,3,2,49,0,9,0,51,0
UConn fires Bob Diaco after 11-26 mark in three seasons,0,2,4,37,1,9,4,41,0
Tina Fey: Trump “can’t muster the dignity of seventh grader”,0,2,3,44,4,9,0,47,0
"Boy, 15, charged with killing of Polish man in Harlow",0,2,3,37,2,9,2,40,0
Woolworths sells fuel business to BP for nearly $1.8b,0,3,3,38,2,8,2,41,0
Chrissy Teigen Just Paid This Woman's Beauty School Tuition,0,3,9,41,1,8,0,50,0
Icahn’s bid for auto parts maker fails,0,2,1,30,1,6,0,31,0
Trump's First Day as President Brought Out Thousands of Protesters,0,3,8,48,1,9,0,56,0
Good news: science says your cat actually does want to chill with you,0,3,1,55,1,12,0,56,0
People are trying to turn Chernobyl into a solar farm The list,0,3,3,48,0,11,0,51,0
Amazon Has Officially Made Its First Drone Delivery,0,3,8,36,0,7,0,44,0
David Shulkin Chosen for Secretary of Veterans Affairs ,0,3,6,41,0,8,0,47,0
Sources: Dogs may have picked up escaped convicts' scent  - CNN Video,0,3,6,48,3,12,0,54,0
Twitter will remove 140-word character limit in direct messages,0,3,1,50,1,8,3,51,0
Trump Jr. Blasphemously Compares Himself to Salt Bae in Defense of Viral Sitting Meme,0,3,11,60,1,13,0,71,0
Woman charged with murder of missing Mornington Peninsula mother Joanne Martell,0,2,5,64,0,10,0,69,0
Wells Fargo is closing over 400 bank branches,0,3,2,33,0,7,3,35,0
Over one hundred die in Madrid plane crash,0,1,2,33,0,7,0,35,0
Jennifer Lopez on Black Eye Photo: 'Sometimes Work Can Be Rough',0,3,10,41,3,10,0,51,0
Concerns over China Oil subsidiary of Unocal buying into US Energy infrastructure,0,1,7,63,0,11,0,70,0
New Study Shows Anti-Semitism Soared Last Year,0,3,8,31,1,6,0,39,0
Unauthorised autobiography of Julian Assange sells less than 700 copies,0,1,3,56,0,9,3,59,0
Trump refuses to answer reporter's question on Russia,0,3,2,43,1,7,0,45,0
"1 in 4 workers have less than $1,000 saved for retirement",0,2,0,39,2,10,6,39,0
Poison drummer Rikki Rockett arrested for rape,0,1,3,37,0,6,0,40,0
Rex Tillerson embarks on Asia trip amid Korea concerns,0,3,4,42,0,8,0,46,0
Clinton Says U.S. Is Ready to Lead on Climate,0,1,8,27,2,8,0,35,0
Animation shows Swiss solar plane aiming for stratosphere,0,3,2,48,0,7,0,50,0
CanadaVOTES: Animal Alliance (AAEVPC) candidate Marie Crawford running in Toronto—Danforth,0,1,18,59,4,9,0,77,0
Austrian students' protests expanding through Europe,0,1,2,44,1,5,0,46,0
Alphabet Scraps Plan to Blanket Globe With Internet Balloons,0,3,8,44,0,8,0,52,0
Want to Go to the Super Bowl? Book Your Trip Right Now,0,3,9,33,1,11,0,42,0
China's Name-and-Shame TV Show Puts Household Brands on Edge,0,3,10,39,3,8,0,49,0
A California waiter refused to serve 4 Latina women until he saw ‘proof of residency’,0,2,3,65,2,14,1,68,0
"End Of ’Wet-Foot, Dry-Foot’ Means Cubans Can Join Ranks Of ’Undocumented’",0,2,13,43,7,10,0,56,0
Ban Ki-moon calls for Zimbabwe elections to be postponed,0,1,3,44,1,8,0,47,0
Ranking 2017 draft's top 100 players,0,3,1,22,1,5,7,23,0
"'I was told that men are the abusers, women the victims': Two male rape survivors on their battle to be heard",0,3,2,83,4,20,0,85,0
UK MPs vote not to lower abortion limit,0,1,4,28,0,7,0,32,0
The Complicated Connection Between Football and ALS,0,2,8,37,0,6,0,45,0
Paul Ryan: ‘We Have to Use Every Tool at Our Disposal to Keep This Executive Branch Honest’ - Breitbart,0,2,15,66,4,18,0,81,0
More women compete on primetime TV at the Olympics than any other point in the year,0,2,4,64,0,15,0,68,0
"Amid Crackdown, Iran Admits Voting Errors",0,1,6,29,1,5,0,35,0
Burberry shares are jumping on talk of a Â£15 billion takeover,0,2,2,47,1,10,2,49,0
Trump's 20 Million Twitter Followers Get Smaller Under The Microscope,0,3,9,48,1,9,2,57,0
"Japan's 50 Richest In 2017 Grow Wealthier From Telecom, Videogames And Technology",0,2,10,52,2,11,6,62,0
Man rips off Hitler waxwork's head in Berlin,0,1,3,33,1,7,0,36,0
"Car bomb attack in Iraqi town, at least two dead and 45 injured",0,1,2,46,1,12,2,48,0
Money Hoarding Returns! People Are Withdrawing Money From ATMs And Keeping It At Home,0,3,16,55,1,13,0,71,0
Justin Trudeau Throws Some Grade-A Shade At Donald Trump,0,3,10,37,1,8,0,47,0
Suicide Bomber on Motorcycle Kills 7 Civilians in Afghanistan,0,1,6,46,0,8,1,52,0
Drug combo reversed plaque buildup in heart patients’ arteries,0,2,1,52,1,8,0,53,0
President of Mexico Urges Action on Emissions,0,1,5,34,0,6,0,39,0
Ed Sheeran Reveals He Once Got Drunk and Smashed Justin Bieber in the Face with a Golf Club,0,2,13,61,0,17,0,74,0
British Cycling accused of covering up bullying culture and misleading UK Sport,0,3,5,63,0,11,0,68,0
New Survey Shows No One in Tech Actually Cares About Diversity,0,3,10,42,0,10,0,52,0
Obama's private prayer published in Israeli newspaper,0,1,2,44,1,6,0,46,0
Con Ed Settles With New York Over Fatal 2014 East Harlem Explosion,0,3,11,40,0,11,4,51,0
Mother of the Detroit Tigers baseball player Urbina was kidnapped by FARC leader,0,1,8,60,0,12,0,68,0
New York Representative Eric Massa to retire,0,1,5,33,0,6,0,38,0
"Locals and officer claim to have seen a UFO in Charlotte, North Carolina",0,1,7,52,1,12,0,59,0
Gregg Popovich compared Becky Hammon to Steve Kerr and says she has what it takes to be an NBA coach,0,3,9,72,0,19,0,81,0
"Jim Harbaugh Meets Usher at Michelle Obama Event, Names Him 2017 Captain",0,3,10,46,1,11,4,56,0
New York City Mass Transit facing service cuts,0,1,5,34,0,7,0,39,0
‘A Bit Irrational’: Theater Shooter James Holmes’ Ex-Girlfriend Asked Him to See Therapist,0,2,13,60,5,12,0,73,0
Rocket carrying NASA carbon dioxide satellite crashes into ocean,0,1,5,51,0,8,0,56,0
"Bud Selig, an Apostle for Equity, Reaches Hall of Fame ",0,3,7,36,2,10,0,43,0
Scribd Invites Writers to Upload Work and Name Their Price,0,1,8,41,0,9,0,49,0
Australian opposition minister gives speech on poverty,0,1,1,47,0,6,0,48,0
El Chapo's NYC Prison Conditions Described as More Horrific Than Guantanamo Bay,0,3,13,54,1,11,0,67,0
"Against China’s objections, Ted Cruz and Texas governor meet with Taiwanese president",0,3,6,66,2,11,0,72,0
Carrie Fisher Will Reportedly Appear in 'Star Wars: Episode IX',0,3,10,41,3,9,0,51,0
Chris Pratt pulled off an absurdly brilliant magic trick on Graham Norton's show The list,0,2,5,69,1,14,0,74,0
Leicester City 0-3 Manchester United: Premier League – as it happened,0,3,6,48,3,10,2,54,0
"Sunwing Airlines pilot in Canada arrested after being found drunk and ""slumped over in the seat""",0,3,3,76,2,15,0,79,0
"Do Body Cameras Help Policing? 1,200 New York Officers Aim to Find Out ",0,3,11,41,2,13,4,52,0
"Syrian Government Recaptures All of Aleppo From Rebels, State TV Reports ",0,2,11,50,1,11,0,61,0
"Saturn's rings could contain millions of 'moonlets', new Nasa images reveal",0,3,2,59,4,10,0,61,0
"NHL: Penguins defeat Thrashers, catch Devils",0,1,6,31,2,5,0,37,0
Red Cross says 100 dead after roadworks trigger pipeline explosion in Nigeria,0,1,3,60,0,11,3,63,0
Textbook retailer The Coop faces membership backlash over allegations of running 'corporate clique',0,2,3,82,2,12,0,85,0
How drones lit up the sky in Lady Gaga's Super Bowl halftime show ,0,3,5,47,1,13,0,52,0
The Guardian view on Putin’s Europe: the new fellow travellers,0,3,4,47,2,9,0,51,0
House Approves Bill to Overturn FCC Privacy Rule,0,3,9,32,0,7,0,41,0
NATO airstrike kills seven Afghan security forces members,0,1,5,45,0,7,0,50,0
"Lordi horror movie receives 300,000 euros of Finnish government funding",0,1,2,53,1,9,6,55,0
American Airlines pilot dies after medical episode on flight ,0,2,2,50,0,9,0,52,0
Uncertainty looms for patients at community clinics ahead of proposed health care changes,0,3,1,76,0,12,0,77,0
WWE Hall of Fame 2018: Early Projections for Next Year's Class of Legends,0,3,11,44,2,12,4,55,0
LeBron James Ethers Charles Barkley During Epic Post-Game Rant,0,2,11,42,1,8,0,53,0
Trump administration's hardline immigration stance in Supreme Court case could see Melania Trump deported,0,3,5,86,1,13,0,91,0
Ravens WR Steve Smith Sr. says he's probably retiring after 16 seasons,0,2,6,49,2,11,2,55,0
"Europeans brought a deadly stomach bacteria to the Americas 500 years ago, which is STILL making people ill",0,3,7,79,1,17,3,86,0
"Shawn Mendes Announces New Single, 'There's Nothing Holdin' Me Back'",0,3,10,44,5,9,0,54,0
Water Flowing Over Emergency Spillway at Tallest US Dam ,0,3,9,38,0,9,0,47,0
"Oscar Nominations 2017: 14 for ‘La La Land,’ and 6 for Black Actors ",0,3,7,37,4,13,7,44,0
Bag that washed ashore on Lake Erie near Cleveland confirmed to be from missing plane,0,3,4,67,0,14,0,71,0
New threats made against US Jewish centers,0,2,4,32,0,6,0,36,0
Trials in Cambodia Expose the Cogs in a Killing Machine,0,1,6,40,0,9,0,46,0
Golfer Cody Gribble Pushes Gator into Water at Arnold Palmer Invitational,0,3,9,54,0,10,0,63,0
Review: Encores! Serves a Bathtub Martini in ‘The New Yorkers’ ,0,3,8,41,4,10,0,49,0
Trump Grants Oval Office Meeting to TMZ Founder ,0,3,9,31,0,8,0,40,0
MTA to test open-gangway trains to give passengers more room,0,2,3,47,1,9,0,50,0
Don Rickles Will Always Be Our Best Man,0,3,8,24,0,7,0,32,0
"The Party’s Over … Over My Budget, That Is ",0,3,8,23,3,9,0,31,0
A foreign policy expert explains why Marine Le Pen could win the French election,0,2,5,62,0,13,0,67,0
German Manufacturer MAN in Bribery Investigation,0,1,7,36,0,5,0,43,0
Why We Feel So Squeezed in the Skies ,0,3,6,23,0,8,0,29,0
"Not Scotland, but Closer: Golf in Nova Scotia",0,1,6,30,2,7,0,36,0
Pornhub Wants To Make The First Ever Sex Tape In Space,0,2,11,33,0,10,0,44,0
Has Trump finally found a court that will endorse the travel ban once and for all?,0,2,2,64,1,15,0,66,0
Longer Unemployment for Those 45 and Older,0,1,4,30,0,6,2,34,0
Adidas Lays Out Plans for 2017 Sneaker Collaborations,0,3,6,36,0,7,4,42,0
World's largest fund manager demands cuts to executive pay and bonuses,0,3,1,58,1,10,0,59,0
Shriver speaks out over Schwarzenegger’s affair and love child,0,1,2,51,1,8,0,53,0
Davey Johnson Has a Soft Spot for Dutch Baseball Team,0,1,8,36,0,9,0,44,0
South West sustainable egg farmer fights blanket environmental policy geared at large-scale farms,0,3,2,82,1,12,0,84,0
How 'genderless nipples' is challenging Instagram's nudity policy,0,3,2,53,3,7,0,55,0
F.B.I. and S.E.C. Probe Missing Fund Manager,0,1,10,22,6,6,0,32,0
Healthy U.S. April auto sales fail to offset growth fears,0,2,4,42,2,9,0,46,0
Wall Street Charging Bull sculptor accuses New York of violating rights over Fearless Girl installation,0,3,8,81,0,14,0,89,0
Cashmere Cat Releases 10-Song Track List for Debut Album '9',0,2,8,37,3,9,3,45,0
Eyewitnesses challenge Egyptian state media impartiality in fatal protests,0,1,2,64,0,8,0,66,0
‘Cash me outside’ girl is pissed people are using her catch phrase,0,2,1,52,2,11,0,53,0
Thousands demand climate change action,0,1,1,33,0,4,0,34,0
'Nerdsploitation' is not a thing. There's never been a better time to be a nerd,0,3,2,59,4,14,0,61,0
Ford is starting to sell supersize pickup trucks in China. Will anyone buy them?,0,3,3,62,2,13,0,65,0
A Leader Beyond Reproach Limits the Possibilities for Political Change,0,1,8,53,0,9,0,61,0
Jordan Peele on making a hit comedy-horror movie out of America’s racial tensions,0,3,3,64,2,12,0,67,0
Detained in Turkey: A Journal Reporter’s Story,0,3,6,32,2,6,0,38,0
Trump attacks 'dishonest media' while making false claims at Florida rally,0,2,2,60,2,10,0,62,0
Manhunt Underway in NYC for Escaped Prisoner Still Wearing Leg Shackles ,0,3,11,50,0,11,0,61,0
Doctors Find Possible Tie Between Zika and Another Deformity,0,2,8,44,0,8,0,52,0
Amber Harrison hires high-profile barrister in battle against Seven West Media,0,3,5,62,1,10,0,67,0
Budget Passes but Critics Say the Deficit Is in the Details,0,1,7,42,0,10,0,49,0
Croatia Courts Old Enemy and Its Tourism Spending,0,1,7,35,0,7,0,42,0
'Mother of All Bombs': US Forces Drop Massive Non-Nuclear Bomb in Afghanistan  Insider,0,3,13,56,4,13,0,69,0
Alitalia conditionally accepts joint bid by Air France and KLM,0,1,6,47,0,9,0,53,0
"I bought a comfortable desk chair, and it was one of the best purchases I made last year",0,3,2,68,1,17,0,70,0
Curious Coloradan Adam Hirtle Shoots Himself to See What It Feels Like: Cops,0,2,12,51,1,12,0,63,0
"**Horse Race Live Wire** Trump, Clinton Projected to Win New York Primary - Breitbart",0,2,12,54,6,13,0,66,0
Drug screening can't wait after Kawhi Leonard boosts MVP bid,0,3,6,44,1,9,0,50,0
Jon Ossoff rides anti-Trump wave to potential upset in Republican Georgia,0,3,5,57,1,10,0,62,0
Spain defeat Serbia in 2009 European Basketball Championships,0,1,5,45,0,7,4,50,0
Chapeco Buries Soccer Club President as Fans Look to Future ,0,2,8,42,0,10,0,50,0
"Japan Quietly Reflates, Buying Time for Reckoning With Debt",0,3,8,42,1,8,0,50,0
FULL TEXT: President Trump's first-ever joint address to Congress ,0,3,11,43,3,9,0,54,0
US diplomacy in crisis amid cuts and confusion at state department,0,2,2,54,0,10,0,56,0
Julia Roberts signs onto first-ever TV series,0,2,4,34,1,6,0,38,0
Israeli Vote Brings Push for Release of a Soldier,0,1,6,35,0,8,0,41,0
Of Course 'Rogue One' Totally Smashed the Box Office With a $155 Million Opening,0,3,11,50,3,13,3,61,0
Rebels Raid Sri Lankan Capital,0,1,5,21,0,4,0,26,0
Ivan Basso Tries to  Rebuild a Career and a Reputation,0,1,6,38,0,10,0,44,0
"Luckily for the world, Donald Trump only has to get the big decisions right",0,3,3,58,1,13,0,61,0
Trump: TrumpCare Failed Because Of Democrats!,0,2,7,31,2,5,0,38,0
BREAKING: Trump’s Saudi Arms Deal Is Actually Fake,0,2,15,26,2,7,0,41,0
This Is a Special Keepsake Inauguration Column,0,1,6,34,0,6,0,40,0
Trump Nominates Conservative Neil Gorsuch To Supreme Court,0,3,8,43,0,7,0,51,0
Police arrest at least 20 as protesters clash at pro-Trump rally in Berkeley ,0,3,3,58,1,13,2,61,0
Hungarian conservative party wins majority in parliament,0,1,1,49,0,6,0,50,0
Les Enfants Terribles: Cocteau's scandalous siblings dance on the edge,0,3,4,55,2,9,0,59,0
Croydon 'hate crime': Six arrested on suspicion of attempted murder after attack on refugee boy,0,3,2,76,3,14,0,78,0
This Giant Seal Is a Smash in Tasmania Video ,0,3,7,29,0,9,0,36,0
Remembering Chuck Berry,0,2,3,18,0,2,0,21,0
Australian teacher drops 'gay' from kookaburra folk song,0,1,1,46,2,7,0,47,0
Jamie Foxx Target of Racial Slur in Croatia,0,3,6,30,0,7,0,36,0
Second Accident in Two Days Strikes Delhi Subway Project,0,1,8,40,0,8,0,48,0
Nicole Kidman: It's sexist to call my daughters bossy,0,3,3,40,2,8,0,43,0
Trump is erasing the red line in Syria and drawing a hard line on North Korea,0,3,4,58,0,15,0,62,0
"Wikinews Shorts: September 3, 2010/Fuel tanker aground in Northwest Passage",0,1,6,52,3,9,5,58,0
Stimulus Ideals Conflict on the Texas Prairie,0,1,5,34,0,6,0,39,0
Mets Send Reyes and Church to Disabled List,0,1,6,30,0,7,0,36,0
Couple tie knot with combined age of 194,0,3,1,29,0,7,3,30,0
Supporters raise over $40G to keep 108-year-old in home ,0,3,2,37,3,9,5,39,0
Latvian Health Official Resigns Over Cuts,0,1,6,30,0,5,0,36,0
Fed on Collision Course With Ruble as World's Best Rally Fizzles,0,3,9,44,1,10,0,53,0
Man arrested after crashing motorized bar stool while drunk,0,1,1,50,0,8,0,51,0
Air Force officer pleads guilty to selling stolen military gear on eBay,0,3,3,57,0,11,0,60,0
Martin Shkreli the Musical Heads for Off-Broadway; Martin Shkreli the Man Heads to Trial,0,3,11,62,2,13,0,73,0
"Despite Some Good News, Stocks Tumble",0,1,6,25,1,5,0,31,0
GOP House votes to reject Obama administration stream protection rule,0,3,5,55,0,9,0,60,0
Thai police search of Buddhist temple fails to turn up wanted monk,0,2,2,53,0,11,0,55,0
’Everybody Stretches’ Without Gravity: Mark Kelly Talks About NASA’s Twins Study,0,2,14,52,4,10,0,66,0
Somali pirates release tanker after receiving millions of dollars in ransom,0,1,1,64,0,10,0,65,0
Turkey votes to expand president's powers; critics cry fraud ,0,3,1,49,2,9,0,50,0
Hilda Solis begins new job as US Secretary of Labor,0,1,6,36,0,9,0,42,0
Watch this time-lapse of two people eating IHOPâs 'All You Can Eat Pancakes' for 5 hours,0,3,10,59,5,15,1,69,0
OutFront: Transgender Activist Creates Nonprofit to Fund Trans Surgeries,0,3,9,54,1,8,0,63,0
"This Week in Billboard Chart History: In 2009, Kelly Clarkson Made a Record Leap to No. 1 on the Hot 100",0,3,13,60,3,20,8,73,0
Mother Facing Likely Deportation Takes Refuge In Denver Church,0,3,9,45,0,8,0,54,0
Bleacher Report's Expert Consensus Free-Agency Predictions,0,3,7,44,2,5,0,51,0
Park Geun-hye: Choi Soon-sil's daughter arrested in Denmark amid South Korea political scandal,0,3,7,71,4,12,0,78,0
Aleppo dentist brings 'Hollywood smiles' to Somalis after fleeing Syria,0,3,4,56,2,9,0,60,0
Travis Scott Hinted at a Collaboration With Quavo and Twitter Was Appropriately Lit,0,3,10,61,0,12,0,71,0
President of Paraguay Had a Child as Bishop,0,1,5,31,0,7,0,36,0
"Remembering the ""smell of death""",0,2,1,25,2,4,0,26,0
Analysis shows declining engagement with Trump's tweets ,0,3,2,46,1,7,0,48,0
"New Jobless Filings Fall, but Long-Term Claims Rise",0,1,8,34,2,7,0,42,0
"Pledge aside, dead billionaires don't have to give away half their fortunes",0,2,1,61,2,11,0,62,0
Oklahoma Goes for a Triple,0,1,3,19,0,4,0,22,0
Texas Father and Son Killed in France Terrorist Attack,0,2,7,39,0,8,0,46,0
Lift accident in Hong Kong skyscraper kills six,0,1,3,37,0,7,0,40,0
Bombings in Iraq kill dozens,0,1,2,22,0,4,0,24,0
"Bizarre tale of the Queen, 'Jack' the bonsai tree and a first-class jaunt from China",0,3,4,62,4,14,0,66,0
"Sure-Footed, Boonen Captures His 3rd Paris-Roubaix",0,1,7,34,3,5,1,41,0
Wikimedia Commons celebrates first anniversary,0,1,2,40,0,4,0,42,0
Black Teachers Are Leaving The Profession Due To Racism,0,2,9,38,0,8,0,47,0
Garth Brooks in Talks to Play Donald Trump's Inauguration: Report,0,3,8,46,2,9,0,54,0
Released video: Israeli soldier shoot bound man at short range,0,1,2,50,1,9,0,52,0
Camila Cabello Exits Fifth Harmony: Social Media Reacts,0,3,8,39,1,7,0,47,0
Another Unlikely Star Powers the Makeshift Mets,0,1,6,35,0,6,0,41,0
Masterminds of USS Cole and Limburg bombings escape from Yemeni prison,0,1,7,53,0,10,0,60,0
80 Are Killed in 3 Suicide Bombings in Iraq,0,1,5,27,0,8,3,32,0
Lars von Trier eyeing up Cannes return following controversial Nazi comments,0,2,4,62,0,10,0,66,0
Aleppo battle: Rebels on brink amid rapid losses,0,3,2,38,1,7,0,40,0
How Does Christoph Niemann Make Art Look Effortless? With A Lot Of Work,0,2,13,45,1,12,0,58,0
Facebook and UK government clash over tributes to killer,0,1,3,45,0,8,0,48,0
Trump speaks at unveiling of Boeing 787 Dreamliner -- live updates,0,3,3,48,2,10,3,51,0
Russell Westbrook Goes Off on Reporter Questioning Oklahoma City Thunder's Team Play,0,3,11,61,1,11,0,72,0
Live Look at the Capitol Building in Washington D.C. Video ,0,3,8,39,2,10,0,47,0
Sir Christopher Lee dies at 93 - latest reaction and tributes,0,3,3,45,1,10,2,48,0
Iraqi City of Mosul Transformed a Year After Islamic State Capture,0,3,9,47,0,10,0,56,0
He Will Not Divide Us: Shia LaBeouf launches four year anti-Trump art project,0,3,9,54,2,12,0,63,0
The Unfair Opacity of Credit Cards Peddled to the Poor,0,2,7,38,0,9,0,45,0
Donald Trump Says He Will Dissolve Trump Foundation,0,3,8,36,0,7,0,44,0
"Train crash in Netanya, Israel injures at least 50; no casualties",0,1,3,48,2,10,2,51,0
All eyes on Marco Rubio as Senate panel prepares for vote on Rex Tillerson,0,2,6,55,0,13,0,61,0
One-Man Traffic Jam Will Hit City When Trump Visits ,0,3,10,32,1,9,0,42,0
"Pain-level rationing of hip and knee surgery due to cash crisis, admits NHS",0,2,4,57,2,12,0,61,0
"Nissan to Cut 20,000 Jobs Amid Loss",0,1,5,18,1,6,5,23,0
Ernie Els isn’t going away quietly after Masters disaster,0,2,3,45,1,8,0,48,0
Satellite photos show North Korean nuclear site 'primed and ready',0,3,3,52,2,9,0,55,0
5 Lessons From Martin Luther King Jr. To Apply To Trump's America,0,2,11,40,2,11,1,51,0
"New Year fire kills at least 59, injures 212 more at Bangkok pub",0,1,3,43,1,12,5,46,0
Bangladesh plants million trees to cut lightning toll,0,2,1,45,0,7,0,46,0
Apple plans another special event,0,1,1,28,0,4,0,29,0
Willow Smith Drops A Three-Song Project Called 'Mellifluous',0,3,9,41,3,7,0,50,0
Mad about Maddi,0,2,2,11,0,2,0,13,0
Inspiring America: Homeless Sisters Run For Gold at Brooklyn Track Club,0,3,10,50,1,10,0,60,0
United States Justice Department opens investigation into White House leaks,0,1,6,60,0,9,0,66,0
"Susan Rice, Obama colleagues take heat for past claims on Syria chemical weapons purge ",0,3,4,68,1,14,0,72,0
In Aaron Hernandez’s Jail Cell: Three Handwritten Notes Found Beside Bible,0,3,11,51,2,10,0,62,0
Taiwan bans eating dog and cat meat,0,2,1,28,0,6,0,29,0
Cyprus to charge five over 2005 plane crash that killed 121,0,1,1,41,0,10,7,42,0
UN says world faces largest humanitarian crisis since 1945 with 20 million at risk of starvation,0,3,2,73,0,15,6,75,0
"Harnessing the Sun, With Help From Cities",0,1,6,28,1,6,0,34,0
At least 22 dead after typhoon hits Vietnam,0,1,2,32,0,7,2,34,0
Snapchat raises $3.4 billion in IPO,0,3,4,22,2,5,2,26,0
Dancing for a cause: Kiribati’s climate activist Olympic weightlifter,0,3,3,56,2,8,0,59,0
"Imperial College London geology students fined in China for ""illegal map-making""",0,1,4,63,3,10,0,67,0
"The Heat's big, naked goofball champion",0,2,2,30,2,5,0,32,0
"Egypt anti-government protests continue, Internet shut down",0,1,2,49,2,6,0,51,0
"Ludacris Sure Had The Last Laugh Over Bill O'Reilly And Pepsi, Didn't He?",0,3,14,43,4,12,0,57,0
I Want Revenge Is the Derby Favorite in a Field of Long Shots,0,1,9,40,0,12,0,49,0
Pope appeals for respectful Sundays,0,1,2,29,0,4,0,31,0
Trump Attacks Senator’s Credibility Over Gorsuch’s Comments ,0,2,7,44,2,7,0,51,0
Congresswoman With Ties to Bank Helped Pave the Way to Aid,0,1,8,40,0,10,0,48,0
Europe Steps Up Security on New Year’s Eve,0,3,7,27,1,7,0,34,0
Czech Parliament Vote Clouds U.S. Antimissile Plan,0,1,8,34,2,6,0,42,0
McCain launches tour of US states,0,1,4,24,0,5,0,28,0
The Atlantic Daily: Hacking and Hatred,0,2,5,27,1,5,0,32,0
South Korean court approves arrest of billionaire Samsung heir,0,3,3,51,0,8,0,54,0
911 Calls Reveal Mischa Barton's Neighbors Told Cops She Threatened to Kill Herself,0,3,11,56,1,12,3,67,0
Trump’s Blistering Speech at CPAC Follows Bannon’s Blueprint ,0,2,10,41,2,8,0,51,0
Krauthammer: 'Pretty Big Violation' If Trump Team Was 'Improperly' Surveilled  Insider,0,2,11,59,5,11,0,70,0
Diplomats urge Russia and Assad to show grace in Aleppo victory,0,3,4,49,0,10,0,53,0
Tiny French Town Mourns Triple Loss in Jet Crash,0,1,8,32,0,8,0,40,0
The 25 Best Movies Of 2016,0,3,4,11,0,5,6,15,0
UK drivers urged not to panic buy during delivery strikes,0,1,2,46,0,9,0,48,0
U.S. Open Day 1 Report,0,1,5,10,2,4,1,15,0
Rex Tillerson Wins Senate Confirmation to Be Secretary of State,0,3,8,46,0,9,0,54,0
Interior Dept. agency changes website from family visiting park to a giant pile of coal,0,3,2,70,1,14,0,72,0
Robbie Keane: Another cousin of footballer dies after Dublin sewer accident,0,3,4,60,1,10,0,64,0
"Clinton advisers point fingers at Huma Abedin, inner circle for loss ",0,3,3,54,1,11,0,57,0
Torture in secret prisons: The dark side of China's anti-corruption crackdown,0,3,3,61,3,10,0,64,0
A Swing By Tatis Still Stings The Mets,0,1,8,23,0,7,0,31,0
A painting stolen by Nazis is up for auction — despite a Jewish family’s demand for its return,0,3,3,72,2,17,0,75,0
23 Australians arrested in global child porn network,0,1,1,42,0,7,2,43,0
Former US VP Al Gore spearheads transport of hurricane victims to relief in home state,0,1,7,65,0,14,0,72,0
Driverless flying taxi service set to launch in Dubai,0,3,2,43,0,8,0,45,0
How David Bowie Fearlessly Changed Rock'n'Roll: Billboard's Special Tribute,0,3,10,53,4,8,0,63,0
Wells Fargo Directors Face Shareholders’ Ire,0,3,6,32,1,5,0,38,0
Instagram is changing comments in a big way,0,2,1,35,0,7,0,36,0
A Tormented Kenyan Town Strikes Back Against the Members of a Street Gang,0,1,10,51,0,12,0,61,0
Trump: Hillary Clinton Is ’Trigger-Happy and Very Unstable’ - Breitbart,0,2,9,48,5,9,0,57,0
Gay-club shooter considered attacking Disney World,0,2,3,41,1,5,0,44,0
Two-thirds of Navy strike fighter jets can't fly,0,3,2,37,2,7,0,39,0
Bayern Munich Starlet wins awards at 2007 FIFA U17 World Cup,0,1,10,34,0,10,6,44,0
George H.W. Bush hospitalized due to 'mild case of pneumonia' ,0,3,4,44,4,10,0,48,0
Delaware officers held hostage in prison standoff,0,3,1,42,0,6,0,43,0
U.S. prepares for arrival of Hurricane Sandy,0,1,4,32,2,6,0,36,0
Vince Carter Turns Back the Clock During Historic Performance for Grizzlies,0,3,9,56,0,10,0,65,0
Northampton couple convicted of nearly 100 child sex offences,0,2,1,49,0,8,3,50,0
Trump Was the Elephant in the Ballroom at the Golden Globes ,0,3,6,43,0,11,0,49,0
NFL1000: Where Does Jabrill Peppers Fit in the NFL?,0,2,11,26,2,8,4,37,0
Here’s Pictures Of Brad Pitt And Angelina Jolie Flying On An Economy Flight,0,3,13,49,1,12,0,62,0
Iranian Baha'i dies in jail,0,1,2,20,1,4,0,22,0
"Golden Guitars: Travis Collins, Sara Storer, Troy Cassar-Daley take out country music gongs",0,3,9,66,4,12,0,75,0
"Taylor Swift Donated $15,000 To The Firefighter Who Saved His Own Family",0,2,11,43,2,11,5,54,0
52% Voters Approve Trump Job Performance — Stat Buried in 2nd-to-Last Graph of Story,0,3,10,54,4,13,3,64,0
Prosecutors Look to Reclaim More Madoff Assets,0,1,6,34,0,6,0,40,0
European Aircraft Industry Seeks More Backing From Government,0,1,8,46,0,7,0,54,0
ISIS Militants Retake Ancient City of Palmyra From Syrian Forces,0,3,12,43,0,9,0,55,0
Bomb explosion kills two in Nepal church,0,1,2,32,0,6,0,34,0
DHS Secretary Kelly says executive order ‘wasn’t a surprise’  ,0,3,5,44,3,10,0,49,0
Trump Says Iran ‘Put on Notice’ After Ballistic Missile Test,0,2,9,40,2,9,0,49,0
"In Trump Country, Shock at Trump Budget Cuts, but Still Loyalty ",0,3,9,42,2,11,0,51,0
Drake's 'More Life' Playlist Is Apparently Dropping Really Soon,0,3,9,43,3,8,0,52,0
What will Trump do if North Korea carries out another nuclear weapons test?,0,3,4,58,1,12,0,62,0
Kyrgyzstan to Give U.S. 6 Months to Leave Base,0,1,7,28,2,8,1,35,0
Nine rescued from roof of blazing Taiwanese skyscraper,0,1,2,45,0,7,0,47,0
Colin Kaepernick Helps Get Plane to Bring Food and Water to Somalia,0,3,9,47,0,11,0,56,0
GM’s Chevrolet Volt Electric Car Will Be Sold in China as a Buick,0,3,11,41,1,12,0,52,0
Manhunt continues for gun theft suspect who penned Trump manifesto,0,3,2,55,0,9,0,57,0
Madonna Defends Anti-Trump Speech at Women's March,0,3,7,35,2,6,0,42,0
Wilders Wants Freedom Party to Be Part of Dutch Coalition Talks,0,3,9,44,0,10,0,53,0
Iman Remembers David Bowie on the Anniversary of His Death ,0,3,7,42,0,10,0,49,0
Twitter more popular than MySpace in United Kingdom,0,1,5,39,0,7,0,44,0
In Short Supply in Donald Trump’s Cabinet: Lawyers ,0,3,7,34,2,8,0,41,0
Obama Pledges Attention to Flooding,0,1,4,27,0,4,0,31,0
Iraq electoral commission: No fraud found in vote recount,0,1,2,46,1,8,0,48,0
"Truck carrying 30,000 pounds of bananas crashes in New Hampshire",0,2,3,46,1,9,5,49,0
Trump sons tell New York Times they can avoid conflicts,0,3,4,42,0,9,0,46,0
Alzheimer's disease reversed in mice using caffeine,0,1,1,43,1,6,0,44,0
Brexit ruling: MPs 'could stop EU withdrawal even after Article 50 is triggered',0,3,6,57,3,12,2,63,0
"Eyeing Trump, Obama takes new action to ban Arctic drilling",0,3,4,45,1,9,0,49,0
Sherlock season 4 episode 2: Toby Jones' villain Culverton Smith draws comparisons to Jimmy Savile,0,3,7,73,2,14,2,80,0
Alleged 9-11 conspirators withdraw offer of guilty pleas,0,1,1,44,1,7,3,45,0
SEC delays IEX bid for stock exchange status,0,2,6,31,0,7,0,37,0
Afghan attack kills five Canadians,0,1,2,28,0,4,0,30,0
California rancher cleared to shoot mountain lion preying on his herds,0,3,1,59,0,10,0,60,0
Tiger Woods: Masters too early for four-time champion's return,0,3,3,48,3,8,0,51,0
I'm Still Standing - Elton John says: 'I am not retiring',0,3,6,36,5,10,0,42,0
"A Model Risked Her Life and Broke the Law, All for a Photo Shoot [Video]",0,3,11,44,3,14,0,55,0
Woman who had ovary frozen in childhood gives birth,0,3,1,42,0,8,0,43,0
Oscar Robertson rooting for Russell Westbrook to record most triple-doubles,0,2,4,61,1,9,0,65,0
When Consumers Cut Back: An Object Lesson From Japan,0,1,9,34,1,8,0,43,0
Melania had to remind Donald to put his hand over his heart for the national anthem,0,3,2,66,0,15,0,68,0
China's plan to reduce troop numbers to save money for high-tech weapons is on track,0,2,1,67,2,14,0,68,0
Texas Teacher Claims She Was Canned for Doing Porn More Than 16 Years Ago,0,3,12,46,0,13,2,58,0
PewDiePie: Disney drops YouTube millionaire  over anti-Semitic video controversy,0,3,7,62,2,9,0,69,0
Migrant crisis: EU leaders agree plan to stop Libya influx,0,2,4,44,1,9,0,48,0
Cargo plane crashes near Khartoum; at least four dead,0,1,2,42,1,8,0,44,0
Investors Cheer Trump's Inauguration As America's 45th President,0,3,7,46,2,7,2,53,0
Thornton Helps L.S.U. Edge Butler,0,1,7,19,3,4,0,26,0
26 Dogs Who Depend On Coffee As Much As We Do,0,2,10,23,0,10,2,33,0
Drexel professor draws ire after posting 'White Genocide' tweet on Christmas ,0,3,4,60,2,11,0,64,0
"Americans are getting fatter, not-for-profit's report finds",0,1,1,48,4,6,0,49,0
"US, UK investigators collaborating after US 777 incident similar to London crash",0,1,7,58,1,11,3,65,0
New Here? Let the Phone Show You Around,0,1,7,24,1,7,0,31,0
National Security Adviser Michael Flynn's job security in jeopardy,0,3,5,52,1,8,0,57,0
Australians enjoy second lunar eclipse for 2007,0,1,1,36,0,6,4,37,0
Australian state of Queensland will go to the polls on March 21,0,1,3,47,0,11,2,50,0
Secretary of state pick Rex Tillerson faces some Senate GOP criticism,0,3,7,52,0,10,0,59,0
Bloody Year in Chicago Continues with 12 Killings Over Christmas Weekend ,0,3,8,52,0,11,2,60,0
"Consumer law breaches should attract larger fines, review suggests",0,3,1,56,1,8,0,57,0
"Meet RBI's New Deputy Governor, Viral Acharya, Who Also Has A Music Album To His Credit!",0,3,18,51,4,15,0,69,0
"Comey Confirms F.B.I. Investigation of Russian Election Interference, Links to Trump Campaign ",0,3,12,66,4,12,0,78,0
"Going to Mars, but Staying Close to Home",0,1,5,27,1,7,0,32,0
Complaint Against Navjot Singh Sidhu For Cracking Tasteless Jokes On The Kapil Sharma Show,0,3,14,63,0,13,0,77,0
Larry Summers: CEOs used to bash Trump. Now they’re enabling his reckless policies.,0,3,7,60,4,12,0,67,0
Somalia Mogadishu car bomb: At least 16 people killed,0,3,3,39,1,8,2,42,0
UK's Daily Mail to pay Melania Trump damages over modeling claims,0,3,6,48,1,10,0,54,0
George Takei joked about running for Congress but we want it to be real,0,3,3,55,0,13,0,58,0
D.L. Hughley Slammed for Insensitive Tweet on Debbie Reynolds' Death  Insider,0,3,10,53,3,11,0,63,0
Trump said he’ll ‘totally destroy’ the Johnson Amendment. What is it and why should people care?,0,3,4,72,5,15,0,76,0
At least 160 killed as crowded church collapses in Nigeria ,0,3,2,44,0,10,3,46,0
Happy Days star Scott Baio defends himself after backlash over Erin Moran: 'You bash me because I support Trump',0,2,9,82,3,18,0,91,0
Nunes on meeting source on White House grounds: 'There was no sneaking around' ,0,3,4,59,3,13,0,63,0
White House to resume public tours in March after unusually long break,0,3,3,56,0,11,0,59,0
America Doesn’t Have a Successor,0,2,4,23,1,4,0,27,0
"Trump Signs Executive Actions on Lobbying Ban, Plans for ISIS ",0,3,11,40,1,10,0,51,0
A Painful Departure for G.M. Brands,0,1,6,22,2,5,0,28,0
Donald Trump Trashes ’Phony’ Bob Vander Plaats On Twitter - Breitbart,0,2,10,46,3,10,0,56,0
New Clues for Detecting Colorectal Cancers Earlier,0,3,6,38,0,6,0,44,0
"Stephen K. Bannon’s CPAC Comments, Annotated and Explained ",0,2,10,38,3,8,0,48,0
U.S. Senate resumes debate over immigration bill,0,1,3,37,2,6,0,40,0
Saudi Stock Exchange appoints first female chief in history of the kingdom,0,3,3,60,0,11,0,63,0
Uber CEO Travis Kalanick caught on video arguing with driver about fares,0,3,6,55,0,11,0,61,0
James Corden and Kristen Bell's high-flying duet went a bit haywire,0,2,4,51,2,10,0,55,0
MSNBC Scolds Brian Williams for ’Patronizing’ Rachel Maddow - Breitbart,0,2,12,47,3,9,0,59,0
Chinese Exports Fall 22.6% in April,0,1,4,21,2,5,3,25,0
Georgian Leader Faces Calls to Quit,0,1,5,25,0,5,0,30,0
J.K. Rowling has the perfect response to Trump trolls burning her books,0,3,4,54,2,11,0,58,0
"After a Year in Europe, Brandon Jennings Wants to Be Drafted by the Knicks",0,1,9,51,1,13,0,60,0
Wife describes 'terrifying' moment her husband was stabbed on train by man shouting 'I want to kill a Muslim',0,3,3,84,4,18,0,87,0
Shia LaBeouf War Movie ‘Man Down’ Grosses £7 at UK Box Office,0,3,12,34,3,11,1,46,0
SS-GB: BBC to re-examine sound after yet more mumbling complaints,0,3,7,46,3,9,0,53,0
"In Major Defeat for Trump, Push to Repeal Health Law Fails ",0,3,9,38,1,11,0,47,0
'Alien: Covenant' faux advert shows you the birth of the robot apocalypse,0,3,2,57,3,11,0,59,0
Russian Ksenia Sukhinova crowned Miss World 2008,0,1,5,33,0,6,4,38,0
"Ban unpaid internships that penalise working-class young, say MPs",0,2,3,52,2,8,0,55,0
Why Did Usain Bolt Just Lose 1 of His 9 Olympic Gold Medals?,0,2,10,35,1,12,2,45,0
Negotiations between Athens and Skopje lead to deadlock,0,1,3,45,0,7,0,48,0
Porfirio Lobo wins Honduran presidential elections,0,1,3,42,0,5,0,45,0
Mardi Gras Crash in Alabama Injures 12 Students in Marching Band ,0,3,8,44,0,11,2,52,0
"Every Drake Album, Ranked: Critic's Take",0,3,6,26,3,5,0,32,0
Bankers  Point to the Rules as the Problem,0,1,4,30,0,8,0,34,0
"Kidnappers release two aid workers in Darfur, Sudan after more than 100 days",0,1,3,57,1,12,3,60,0
2 Chainz Announces The Release Date For 'Pretty Girls Like Trap Music',0,3,11,45,2,11,1,56,0
Gorsuch Would Be 8th Man to Hold 'Justice Scalia's Seat' ,0,3,8,35,3,10,1,43,0
Giuliani Removes Himself From Consideration for Trump Cabinet Position  Insider,0,3,9,60,0,10,0,69,0
"Kim Kardashian robbery may have been ‘inside job,’ investigators say",0,3,2,54,3,9,0,56,0
Kathrine Switzer: 50 years ago women were not allowed to run the marathon,0,3,2,56,1,12,2,58,0
Senior Republican statesmen propose replacing Obama’s climate policies with a carbon tax,0,3,3,73,1,11,0,76,0
The White House’s genius plan to pass an infrastructure bill is really silly,0,2,3,60,1,12,0,63,0
Same-sex marriage passes third reading in House of Commons,0,1,3,46,1,8,0,49,0
Clinton Says She’d Expect Sanders’ Criticism Of Obama From GOP,0,2,12,39,2,9,0,51,0
"Mike Bloomberg Would Lose In Landside Against Trump, Sanders - Breitbart",0,2,10,50,2,10,0,60,0
"Miguel Ferrer, Star of 'NCIS: LA,' 'RoboCop' Dead at 61 ",0,3,12,25,7,10,2,37,0
"Kings won't deal DeMarcus Cousins before Feb. 23 deadline, Divac says",0,2,6,48,3,10,2,54,0
Rumor the German shepherd wins best in show at Westminster Kennel Club dog show ,0,2,5,61,0,14,0,66,0
"Two students shot at Los Angeles school, suspect in custody",0,1,3,46,1,9,0,49,0
Irish woman wins record lottery jackpot,0,1,1,33,0,5,0,34,0
Dutch prosecutors seize gold bars and cars in 'tax evader' raids,0,3,1,51,2,10,0,52,0
"Scotland Yard says suicide bomb blast killed Bhutto, not bullet",0,1,3,50,1,9,0,53,0
Trump in Cincinnati: How to watch his first post-election rally live,0,3,3,53,2,10,0,56,0
Wild Child Takes Charge ,0,3,4,16,0,4,0,20,0
"To Find Out Who You Are, Peer Into the Cheese Ball ",0,3,10,29,1,11,0,39,0
How cartoons portrayed the Women’s March and Trump’s historic weekend,0,3,4,54,2,9,0,58,0
Hillary Clinton Said Putin’s “Personal Beef” Against Her Contributed To Election Loss,0,3,12,59,3,11,0,71,0
26 Ways To Make This Year’s Christmas Dinner The Best Yet,0,2,10,34,1,10,2,44,0
Clinton: ’I Really Don’t Know’ Why Young People Don’t Support Me,0,2,11,38,5,10,0,49,0
Watch Camila Cabello and Machine Gun Kelly Perform in Radio 1's Live Lounge,0,3,10,51,1,12,1,61,0
Woman falls off California's highest bridge while taking selfie,0,3,2,52,1,8,0,54,0
"Donald Trump's action in Syria proves he is not in league with Putin, says his son Eric",0,3,5,64,2,16,0,69,0
"Lobby of Trump Tower Evacuated Over Suspicious Bag, Later Deemed Safe",0,3,10,48,1,10,0,58,0
Will Trump Be the Transformative President Obama Wanted to Be?,0,2,8,44,1,9,0,52,0
With friends like these: China’s awkward position after North Korea’s missile test,0,2,4,64,3,11,0,68,0
"Trump, desperate for a win, bets on health care",0,3,1,36,2,8,0,37,0
US FAA to make airliner fuel tank inertion mandatory over 1996 air disaster,0,1,5,54,0,12,4,59,0
Experts raise serious questions over safety of U.S. oil industry and warn another spill may be 'unavoidable',0,1,3,85,4,16,0,88,0
Israeli parliament retroactively legalizes thousands of West Bank settlement homes,0,3,3,70,0,9,0,73,0
Cory Bernardi to split with Coalition to form Australian Conservatives party,0,3,5,61,0,10,0,66,0
Find The Right Credit Card The Right Way,0,2,8,25,0,7,0,33,0
Canadian woman survives six days without lungs while waiting for transplant,0,3,1,64,0,10,0,65,0
Halliburton's KBR awarded half billion dollar repair contract for Gulf Coast Navy facilities,0,1,7,72,1,12,0,79,0
This Is How Taiwanese And Chinese People Are Reacting To Trump’s Surprise Phone Call,0,3,14,56,1,13,0,70,0
Sessions Controversy Heightens Trump’s Feeling of Being Under Siege ,0,2,8,50,1,9,0,58,0
3 U.S. Soldiers Die in Attack at a Base in Southern Iraq,0,1,8,34,2,11,1,42,0
Edmonton prison conflict wounds eight,0,1,1,32,0,4,0,33,0
"On Nov. 9, Hillary Clinton Voters Ate Their Grief",0,3,8,30,2,8,1,38,0
"Raiders won't retain Bill Musgrave, promote Todd Downing to OC",0,3,7,44,2,9,0,51,0
“Missing Richard Simmons” Is The Best Mystery Podcast Since “Serial”,0,3,10,45,4,9,0,55,0
Colombian government and rebels announce cocaine crop plan,0,3,1,50,0,7,0,51,0
Middle Eastern Christians Facing ’Tragedy’: Church,0,2,6,36,3,5,0,42,0
Hispanic Caucus Fears DHS Head Will Turn A Blind Eye To Agents' Bad Conduct,0,3,16,45,1,13,0,61,0
"Trinidad James, Ben Ferguson clash over use of n-word",0,2,4,39,2,8,0,43,0
Kim Jong Nam Killing Caught on Video   ,0,2,6,24,0,9,0,30,0
Still slow: U.S. economy grew 1.6% in 2016,0,2,3,21,5,7,6,24,0
UK woman convicted of 'mercy' murder of son,0,1,2,32,2,7,0,34,0
Years of International Herald Tribune Articles Disappear,0,1,6,44,0,6,0,50,0
Help Refugees: a lifeline for teenagers living in seedy Athens squats,0,3,3,55,1,10,0,58,0
Seven dead after gunman opens fire in Netherlands shopping centre,0,1,2,54,0,9,0,56,0
You can now sleep on this Malaysian oil rig,0,2,2,33,0,8,0,35,0
Irish Obama song proves popular on Internet,0,1,3,34,0,6,0,37,0
Giuliani to Help Defend Accused Iran Money Launderer,0,3,7,38,0,7,0,45,0
Demystifying Obamacare For 2017: It's No Gamble,0,3,6,29,2,6,4,35,0
"Three-car accident in Birmingham, England leaves eight injured",0,1,3,50,2,7,0,53,0
"Romeo and Juliet, Flushed and Feverish at the Met Opera ",0,2,6,39,1,10,0,45,0
Obamacare enrollment: healthcare experts urge sign-up despite uncertainty,0,2,1,63,2,7,0,64,0
European Leaders to Meet Amid Economic Divisions,0,1,6,36,0,6,0,42,0
15 Weird Roles Famous Actors Played Before They Blew Up,0,3,9,35,0,9,2,44,0
Too Many Favorite Shows? Take Them In at High Speed - The New York Times,0,2,13,43,2,14,0,56,0
DraLo? Drake and Jennifer Lopez revive romance rumors with snuggle pic,0,2,5,54,1,10,0,59,0
Mountaineers 'Climb Up' for AIDS funding,0,1,7,26,2,5,0,33,0
Financial Stocks Pull Down European Markets,0,1,6,32,0,5,0,38,0
"Hey, hey, it’s the Monkees!",0,3,2,17,4,4,0,19,0
Gazprom stops supplying gas to Moldova,0,1,2,31,0,5,0,33,0
ESA launches Herschel Space Observatory and Planck Satellite,0,1,8,45,0,7,0,53,0
Elizabeth Warren tells Jimmy Fallon that Mitch McConnell won't even look at her now,0,3,7,62,1,13,0,69,0
White House cuts Hubble from budget,0,1,3,27,0,5,0,30,0
Fragile Male State Senator Not OK With College Course On Masculinity,0,3,12,46,0,10,0,58,0
"Anthony Scaramucci Joining Trump Administration, Transition Team Confirms",0,3,8,57,1,7,0,65,0
American Samoa received eight minutes warning before 2009 tsunami,0,1,2,51,0,8,4,53,0
Adrian Peterson of Minnesota Vikings receives overwhelming support from hometown at Adrian Peterson Day,0,3,7,83,0,13,0,90,0
Top 2017 Emerging EMEA Picks Are All Things Russia; Avoid Turkey,0,3,13,36,1,10,4,49,0
Spanish Court Weighs Inquiry on Torture for 6 Bush-Era Officials,0,1,8,45,1,9,1,53,0
Ex-Boston Drummer Sib Hashian Dead After Collapsing on Cruise Ship,0,3,10,46,1,9,0,56,0
This map by NASA shows the drastic amount of ice thatâs disappeared from the Arctic,0,3,6,63,2,14,0,69,0
Find The Right Credit Card The Right Way,0,3,8,25,0,7,0,33,0
Premier League: United snatch victory in dramatic Manchester derby,0,1,4,53,1,8,0,57,0
EU sets date for membership talks with Turkey,0,1,3,35,0,7,0,38,0
"Fire breaks out in Ku-ring-gai Chase National Park, Australia",0,1,6,44,3,8,0,50,0
"New Trump, same as the old Trump",0,3,3,22,1,6,0,25,0
Bomb blast damages buildings in Athens,0,1,2,31,0,5,0,33,0
"Rihanna and Azealia Banks Feud Over Refugees, Immigration on Instagram",0,3,8,52,1,9,0,60,0
Trump names Lt. Gen. H.R. McMaster as national security adviser,0,3,7,43,4,9,0,50,0
S.E.C. Seeks to Limit Stock Trades by Its Workers,0,1,9,29,3,8,0,38,0
Freelancers say they got stiffed after company acquired One World Media,0,2,4,57,0,10,0,61,0
Happy Gilmore Was On to Something,0,1,5,23,0,5,0,28,0
"Late-night TV hosts on Trump: ’100 days, 99 problems’",0,2,4,31,5,8,5,35,0
A Congolese Rebel Leader Who Once Seemed Untouchable Is Caught,0,1,10,43,0,9,0,53,0
McCain and Obama face off in U.S. presidential candidate debate,0,1,5,47,2,9,0,52,0
Yahoo Confuses Twitterverse by Rebranding Its Core Business as Oath,0,3,8,50,0,9,0,58,0
The desperate families fleeing eastern Aleppo,0,3,2,38,0,5,0,40,0
Maatsuyker Island: Volunteers wanted to really 'get away from it all' at remote lighthouse,0,2,3,71,3,13,0,74,0
Insider Trading Inquiry Cites Lawyers at S.E.C.,0,1,8,30,3,6,0,38,0
Henry Cavill auditioning in the original 'Superman' suit is a thing of beauty,0,3,3,60,2,12,0,63,0
Rouhani Loses Key Ally as Former Iran Leader Rafsanjani Dies,0,3,9,42,0,9,0,51,0
A Reprieve for Newcastle,0,1,3,18,0,3,0,21,0
"Dams Are Thwarting Louisiana Marsh Restoration, Study Says",0,1,8,42,1,7,0,50,0
North Korea Sets Date for Launching,0,1,5,25,0,5,0,30,0
"In Israel, Teaching Kids Cyber Skills Is a National Mission ",0,3,9,40,1,10,0,49,0
"Skillet on Upcoming Tour, 'Feel Invincible' Success & New 'Classic Rock' Sound",0,3,10,51,6,11,0,61,0
"North Korea's nuclear capability 'improving', US says",0,3,4,39,4,6,0,43,0
See the view from SpaceX's historic mission,0,3,3,33,1,6,0,36,0
Spectacular snow moon regales world,0,3,1,30,0,4,0,31,0
Birth Control Pills a Step Closer to Being Sold Sans Prescription,0,3,9,46,0,10,0,55,0
There's a secret room behind Mount Rushmore that is inaccessible to tourists,0,3,3,61,1,11,0,64,0
Sonam Kapoor Urges PM Modi To Take A Stand For Bollywood After Attack On Sanjay Leela Bhansali,0,3,18,60,0,16,0,78,0
"Switched at Birth, Women Find New Identity",0,1,6,29,1,6,0,35,0
Philippines braces for next storm,0,1,1,28,0,4,0,29,0
The Princess Diarist by Carrie Fisher – digested read,0,2,5,39,1,8,0,44,0
Justin Trudeau takes aim at Matthew Perry and the best of the rest on April Fools' Day,0,3,7,62,1,16,0,69,0
New top U.S. diplomat plays central role in Trump’s China shift,0,2,5,45,3,10,0,50,0
'Hamilton' Cast Bids Farewell To Obama With 'One Last Time' Performance,0,3,11,46,4,10,0,57,0
"If Theresa May can't trust the Queen, it bodes ill for their future relationship",0,3,4,61,2,13,0,65,0
Globe's 'Rogue One' ad is a heck of a tearjerker aimed at inspiring courage,0,2,3,56,3,13,0,59,0
Safety official wants rail cars replaced faster after fire ,0,3,1,49,0,9,0,50,0
Bomb Threat Forces Emergency Airplane Landing in Prague,0,2,7,41,0,7,0,48,0
Hasan Minhaj of “The Daily Show” to host White House Correspondents Dinner,0,3,9,52,2,11,0,61,0
Trump administration weighs deeper involvement in Yemen war,0,2,2,50,0,7,0,52,0
“American Ninja Warrior” contestant rescues choking man,0,3,3,44,2,6,0,47,0
Give Roy Williams the Credit He Deserves: UNC Coach Is Best of This Generation,0,3,14,50,1,13,0,64,0
'Avatar' makes the leap from screen to comic book: An exclusive look,0,3,2,52,3,11,0,54,0
Inspiring America: 100 Years of Girl Scout Cookies,0,3,6,33,1,7,3,39,0
Australian parliamentary security officers allowed to address members as 'mates' again,0,1,1,73,2,10,0,74,0
"Casey Affleck plays rowdy Dunkin' Donuts fan in ""Saturday Night Live"" spoof",0,3,7,54,3,11,0,61,0
Two strong earthquakes jolt Japan,0,1,2,27,0,4,0,29,0
4 U.S. Soldiers Killed in Afghanistan,0,1,5,24,2,5,1,29,0
Trump scolds Qatar as Tillerson seeks to ease crisis,0,2,3,41,0,8,0,44,0
"Corpus Christi tap water ban is over, mayor says",0,3,2,37,1,8,0,39,0
Tegan and Sara Launch Justice-Fighting Foundation For LGBTQ Girls and Women,0,2,14,50,1,10,0,64,0
Lawyer who killed lover’s dog blames being lone Jew at boarding school,0,2,2,56,1,11,0,58,0
Abortion Industry: Gorsuch Confirmation ‘Dark Day for Women’,0,3,7,43,3,7,0,50,0
Why Robert Shiller Is Worried About the Trump Rally,0,3,8,35,0,8,0,43,0
Sydney-based professor 'heading back' to Australia after murky flight ordeal in China,0,2,3,68,3,11,0,71,0
'Battle of Orgreave': Probe into 1984 miners' clash policing ruled out,0,3,3,49,4,10,4,52,0
"The U.S. can’t ignore Russia, or its increasingly horrendous behavior",0,2,4,52,4,9,0,56,0
Donald Trump Inaugural Speech: Full Transcript,0,2,6,34,1,5,0,40,0
17 gorgeous planters to help your garden glow,0,3,0,36,0,7,2,36,0
"The week in apps: Yahoo gets caller ID, Yelp does 411, and more",0,3,5,40,3,12,3,45,0
50 dead after ferry in Myanmar capsizes,0,1,1,30,0,6,2,31,0
Asif Ali Zardari sworn in as President of Pakistan,0,1,5,37,0,8,0,42,0
"Lana Del Rey's 'Lust for Life,' Feat. The Weeknd, Leads Billboard + Twitter Trending 140 Chart",0,3,13,56,7,15,3,69,0
Kremlin Says Syria Missile Strike Harms U.S.-Russia Relations,0,2,10,41,3,7,0,51,0
Verizon says customer phone records were not handed over to the NSA,0,1,4,52,0,11,0,56,0
"Warriors without Kevin Durant, Steve Kerr for Game 3; Jusuf Nurkic returns",0,3,8,52,2,11,1,60,0
"'Hamilton Mixtape': Watch Performances By Andra Day, Ja Rule and Ashanti",0,3,10,48,4,10,0,58,0
Trump's Net Worth Falls $200 Million Since Election,0,3,7,32,2,7,3,39,0
New Jersey teen faces child porn charges for posting nude photos of herself online,0,1,2,67,0,13,0,69,0
Jefferson Starship Protests San Francisco City Hall for Blocking Summer Of Love Concert,0,3,12,63,0,12,0,75,0
Clinton Says Her Relationship With Putin Is ... ’Interesting’,0,2,8,40,5,8,0,48,0
"2018 Ford Mustang gets new styling, more power and tech ",0,3,2,39,1,10,4,41,0
China Wins Big With Stakes in $22 Billion Abu Dhabi Oil Venture,0,2,10,39,1,11,2,49,0
Puerto Rico hit with islandwide blackout after fire erupts,0,2,2,48,0,8,0,50,0
Amazon rainforest being destroyed faster than previously believed,0,1,1,57,0,7,0,58,0
Here's What It Was Like To Be At Rihanna's Biggest Fashion Show Yet,0,3,13,40,2,12,0,53,0
Trump's grand plans collide with 100-day mark,0,3,1,33,2,6,3,34,0
"Photographing the abandoned: Roman Robroek, Urban Explorer",0,3,5,45,2,6,0,50,0
Microsoft releases Windows Phone 7 to manufacturing,0,1,3,41,0,6,1,44,0
Architects design 'world's tallest' wooden skyscraper,0,2,1,44,3,5,0,45,0
Mark Cuban: Russell Westbrook still not superstar unless Thunder win,0,2,5,53,1,9,0,58,0
Rock 'n' roll icon Chuck Berry dead at age 90 in Missouri,0,3,4,38,2,11,2,42,0
Trump's first budget faces early Republican resistance ,0,3,2,45,1,7,0,47,0
Fyre Festival organisers promise refunds and 2018 VIP passes,0,2,5,43,0,8,4,48,0
Incoming BBC chair calls for 'crown jewel' sports review in first appearance,0,3,4,59,2,11,0,63,0
Washington prepares for Donald Trump's big moment,0,3,3,39,1,6,0,42,0
Gene therapy lets a French teen dodge sickle cell disease,0,3,2,46,0,9,0,48,0
A win-win for game day: Spinach and artichoke dip makeover,0,3,2,45,2,9,0,47,0
Morgan Stanley Exploring Move to Manhattan’s West Side ,0,3,7,39,1,8,0,46,0
The Limit Does Not Exist by Forbes on iTunes,0,2,7,29,0,8,0,36,0
Staging a Financial Recovery,0,1,3,22,0,3,0,25,0
Russian ambassador to Turkey shot in Ankara ,0,3,3,34,0,7,0,37,0
From Gandhi to guns: An Indian woman explores the NRA convention,0,3,7,46,1,10,0,53,0
Death Toll in Tennessee Wildfires Rises to 13 as Recovery Efforts Are Underway ,0,3,9,55,0,13,2,64,0
"Trump calls for lower drug prices, fewer regulations in meeting with pharmaceutical executives",0,3,1,80,1,12,0,81,0
Fillon France election: Party brings forward crisis meeting,0,2,3,48,1,7,0,51,0
"Amazon jungle faces death spiral of drought and deforestation, warn scientists",0,2,1,66,1,10,0,67,0
"How cartoonists take a skewed view of Trump, Putin and the election-hack headlines",0,3,3,65,2,12,0,68,0
Trump plays hardball with Dems on ObamaCare payments ,0,3,4,41,0,8,0,45,0
6 stunning pre-fab homes across North America,0,2,2,35,1,6,1,37,0
"Dusty Rhodes dead at 69, WWE announces",0,3,5,24,1,6,2,29,0
"Islamic State Takes Victory Lap After Orlando, French Police Murders",0,2,10,48,1,9,0,58,0
Sussan Ley under pressure over New Year's Eve trips to Gold Coast,0,3,7,46,1,11,0,53,0
Weezer's 'Feels Like Summer' Debuts at No. 1 on Billboard + Twitter Trending 140 Chart,0,2,10,53,5,14,4,63,0
Even millionaire secretary of state nominees buy their own cereal,0,2,1,55,0,9,0,56,0
"Security guard for Scientology building shoots, kills man",0,1,2,47,1,7,0,49,0
Italian authorities disrupt scheme to steal Enzo Ferrari’s body and hold it for ransom,0,3,3,69,1,13,0,72,0
LaVar Ball claims he 'would kill Michael Jordan one-on-one' back in his heyday,0,3,5,57,4,12,0,62,0
Tracking President Trump’s Flip-Flops,0,3,5,27,2,3,0,32,0
"Vet, assistant mauled to death by 3 lions on Jordan reserve ",0,2,2,45,1,11,1,47,0
Bush Defends Free Press Against Trump Attacks: 'Power Can Be Very Addictive',0,3,12,50,3,11,0,62,0
General Tso's Chicken creator dies in Taiwan aged 98,0,3,4,37,1,8,2,41,0
"Fantasia Barrino cancels Tennessee concert, citing second-degree burns",0,3,3,58,2,7,0,61,0
Morgan StanleyVoice: Are Millennials Democratizing Sustainable Investing?,0,2,8,57,2,6,0,65,0
Sit back and let the #NoBallChallenge take over your timeline,0,3,4,47,1,9,0,51,0
Egyptian archaeologist finds artifacts which may lead to Cleopatra's tomb,0,1,2,61,1,9,0,63,0
Donald Trump mocks Arnold Schwarzenegger's “Celebrity Apprentice” ratings,0,2,6,57,3,7,0,63,0
NRA Asks Lady Gaga to Not Get Political at Super Bowl: People Don't Want to Hear 'How Stupid & Racist They Are',0,3,20,65,5,21,0,85,0
Indonesian blackout caused by lack of generation capacity,0,1,1,49,0,7,0,50,0
Meet Lara: Facebook's first chatbot 'dating coach' will set you up with someone based on your interests,0,2,3,80,4,16,0,83,0
VIDEO: Black Students Assault Breitbart Journalist at CSU LA,0,2,15,36,1,8,0,51,0
Mika Brzezinski says Clinton campaign wanted her 'pulled off the air' ,0,2,3,54,2,11,0,57,0
White House Criticizes “Mean-Spirited” Anti-LGBT Law In North Carolina,0,2,14,44,4,8,0,58,0
Turkish Premier Ailing,0,1,3,17,0,2,0,20,0
UK businesses welcome May's free trade call but warn of no-deal Brexit disaster,0,3,4,61,2,12,0,65,0
Treatment for eating disorders goes mobile ,0,3,1,36,0,6,0,37,0
Cheeky little girl steals the Pope's skullcap as she gives him a kiss ,0,3,2,54,1,13,0,56,0
Tyrod Taylor Rumors: Browns Reportedly Have 'Significant Interest' in QB,0,3,10,50,3,9,0,60,0
Polar bear Knut's death linked to encephalitis,0,1,2,37,1,6,0,39,0
Next steps in legal battle over the travel ban,0,2,1,37,0,8,0,38,0
Gurugram Residents Come Together To Start India's First Organic Veggies Market,0,2,11,56,1,10,0,67,0
"My Friendship With Shah Rukh Khan Just Cannot Die, Reveals KJo, In His Autobiography",0,2,15,54,2,13,0,69,0
New York's rental market is entering a 'slow grind',0,2,2,38,3,8,0,40,0
Israel makes it official: Cannabis is not a crime,0,2,2,38,1,8,0,40,0
Australian Football League's Richmond Tigers beat GWS Giants by 12 points,0,1,9,51,1,10,2,60,0
"Mislabeled As A Memoirist, Author Asks: Whose Work Gets To Be Journalism?",0,2,12,47,3,11,0,59,0
Long-lost locket belonged to Titanic survivor who tragically lost husband,0,3,2,61,1,9,0,63,0
Meals On Wheels Sees 500 Percent Surge In Volunteers Since Budget Cuts Proposed,0,3,12,52,0,12,3,64,0
"On Her Latest, Norah Jones Returns To Old Influences",0,2,9,34,1,8,0,43,0
Would you erase your ex? Bad memories could soon be DELETED from our minds for good,0,3,9,58,1,15,0,67,0
"Marriage is more beneficial for men than women, study shows",0,3,1,48,1,9,0,49,0
Andrew Bogut Is Actually Trying To Argue LeBron Purposefully Slammed His Head Into A Camera,0,3,16,61,0,14,0,77,0
Heavy earthquake hits the Philippines,0,1,2,31,0,4,0,33,0
Ed Sheeran's 'Divide' Smashes Spotify Records For First-Day Streams,0,3,10,45,4,8,0,55,0
Mariah Carey's Rep Says 'Rockin' Eve' Producers 'Set Her Up to Fail',0,3,11,40,6,11,0,51,0
Journal Register Seeks Bankruptcy Protection,0,1,5,35,0,4,0,40,0
"Date set for Bradfield, Higgins by-elections: Australian Electoral Commission",0,1,6,60,3,8,0,66,0
UK Prince William picks brother Harry to be best man at royal wedding,0,1,5,52,0,12,0,57,0
Donald Trump should note even a superpower needs friends sometimes,0,3,2,55,0,9,0,57,0
North Korea warns airlines over satellite fears,0,1,2,39,0,6,0,41,0
Fiat Chrysler Profit Doubles on Lower Costs,0,3,6,31,0,6,0,37,0
Top-Ranked Banks Slip to Bottom as Scandinavian Haven Splinters,0,3,8,46,1,8,0,54,0
Letters regarding Times Square bombing sent to Congress,0,1,4,44,0,7,0,48,0
"Billy Joel admits, 'It's time to slow down' ",0,3,3,29,4,8,0,32,0
Fairfax Wins Central Bank’s Approval to Take Over Indian Lender,0,3,9,44,1,9,0,53,0
Flint mayor: City needs 2 years before it can treat its own water,0,3,2,49,1,12,1,51,0
El Salvador has first day without a murder in two years,0,3,2,43,0,10,0,45,0
GM’s Dim Europe View Is Dismissed ,0,3,7,20,1,6,0,27,0
US court paves way for renewed hunting of wolves in Wyoming ,0,3,3,46,0,11,0,49,0
Budget Has Obama Courting Fellow Democrats,0,1,6,31,0,5,0,37,0
Indian wedding scammer is going hungry because he doesn't like the vegan food options available in jail,0,3,1,85,1,16,0,86,0
Ex-GOP Official Who Accused Dems Of Voter Fraud Charged With Voter Fraud,0,3,15,45,1,11,0,60,0
The Chainsmokers Tease Upcoming 'Paris' Video,0,2,6,32,2,5,0,38,0
Salvage operation begins to retrieve black boxes from Adam Air Flight 574,0,1,4,55,0,11,3,59,0
WWE Wrestlers and Fans Respond to The Undertaker's Retirement With #ThankYouTaker Tributes,0,3,14,63,2,11,0,77,0
"Braylon Beam, 6-year-old cancer patient, signs 1-day deal to coach Carolina Panthers",0,2,4,62,5,11,2,66,0
Mr. Gay Syria: ISIS can suck it!,0,2,7,16,3,6,0,23,0
Ayodhya dispute: India top court orders trial for BJP leaders,0,3,5,46,1,9,0,51,0
American Citizens: U.S. Border Agents Can Search Your Cellphone,0,3,10,42,3,8,0,52,0
Facebook is taking on LinkedIn by letting businesses post job listings,0,2,3,57,0,10,0,60,0
US political columnist James J. Kilpatrick dies at age 89,0,1,5,40,1,9,2,45,0
Celebrities React To Debbie Reynolds' Heartbreaking Death,0,3,7,43,1,6,0,50,0
Post Malone Announces New Album 'Beerbongs & Bentleys',0,2,7,37,3,7,0,44,0
Fox News picks Tucker Carlson to take over for Megyn Kelly,0,3,6,42,0,10,0,48,0
America must lead the free world – the alternative is chaos,0,3,1,47,1,10,0,48,0
This Big Short Threatens to Be a Big Bust,0,3,7,26,0,8,0,33,0
"Hurricanes surprise Bryan Bickell, join him for multiple sclerosis benefit walk",0,3,3,65,1,10,0,68,0
Study: Nationwide medical marijuana laws would save lives — and a billion taxpayer dollars,0,3,2,73,2,13,0,75,0
Singer-songwriter Peter Sarstedt dies aged 75,0,3,3,34,1,5,2,37,0
Carrie Fisher dead: What happens to the upcoming Star Wars movies?,0,3,5,49,2,10,0,54,0
Cassini just sent back images from its first-ever dive through Saturn’s rings,0,3,2,62,2,11,0,64,0
Utah teen gives chocolates to all 537 girls in school on Valentine's Day - Yahoo,0,2,4,57,2,14,3,61,0
A $165 Billion Manager Says the Japanese Stock Gloom Is Overdone,0,2,9,41,1,10,3,50,0
Vitamin C can help prevent cancer say the National Institutes of Health,0,1,5,55,0,11,0,60,0
Chimamanda Ngozi Adichie Says It's Not A Woman's Job To Be Likable,0,3,12,41,2,11,0,53,0
"Donald Trump should not be allowed to address UK Parliament, speaker says",0,3,5,56,1,11,0,61,0
Adele bests Beyoncé and the Grammys reach peak irrelevance,0,2,3,47,0,8,0,50,0
Will Trump Address U.K. Parliament? Not if Commons Speaker Can Help It ,0,2,12,44,3,12,0,56,0
Disney's Live-Action 'Aladdin' Holds Open Casting Call for Leads,0,3,9,43,4,8,0,52,0
Sessions twice met with Russian ambassador in 2016 despite denial ,0,2,2,50,0,10,4,52,0
Crew in Moscow to Simulate Part of a Flight to Mars,0,1,6,35,0,10,0,41,0
Prime Minister Blair flies to Washington,0,1,4,31,0,5,0,35,0
Trump warns Wall Street: I'm going to cut drug prices,0,2,4,38,2,9,0,42,0
Fifth Harmony's New Deal: Quartet Re-Ups With Epic After Camila Cabello's Exit: Exclusive,0,3,14,58,5,12,0,72,0
Source: Chargers agree to 4-year deal with Anthony Lynn,0,3,4,40,2,8,1,44,0
Mets and Yankees Season-Ticket Holders Are Having Second Thoughts,0,1,9,47,1,8,0,56,0
BP reports progress in oil spill cleanup,0,1,2,32,0,6,0,34,0
Yemeni families of drone strike victims file lawsuit against U.S.,0,3,3,51,2,9,0,54,0
Jamaica: Violence kills at least 30,0,1,2,25,1,5,2,27,0
I’m Courtside With LeBron! (In Virtual Reality),0,3,8,29,4,6,0,37,0
American Apparel to Sell Stake to Buyout Firm,0,1,6,32,0,7,0,38,0
Thomas Jefferson and Abraham Lincoln are tough acts to follow,0,3,4,48,0,9,0,52,0
"Watch: Donald Trump Live in Fayetteville, NC",0,2,7,29,2,6,0,36,0
"Child stabbed in West Bank arson, Israeli settlers retaliate",0,1,4,47,1,8,0,51,0
Private Jets Lose That Feel-Good Factor,0,1,7,26,1,5,0,33,0
State of emergency declared in New York over H1N1 swine flu virus,0,1,5,47,0,11,2,52,0
Poll predicts another Liberal Party minority government in Canada,0,1,4,53,0,8,0,57,0
SodaStream is issuing a massive recall,0,3,2,31,0,5,0,33,0
"Exclusive: ’If there’s a shutdown, there’s a shutdown,’ Trump says",0,2,3,47,7,9,0,50,0
Sydney racial violence continues,0,1,1,28,0,3,0,29,0
Iman Shumpert Reportedly a Trade Target for Rockets Ahead of 2017 Deadline,0,3,8,51,0,11,4,59,0
North Carolina gov.-elect sues over law stripping his powers ,0,3,2,48,2,9,0,50,0
Dave Chappelle's 'SNL' Monologue Drew a Number of FCC Complaints for Using the 'N-Word',0,3,15,53,6,13,0,68,0
The Increasing Significance of the Decline of Men ,0,2,5,37,0,8,0,42,0
Emma Stone and Ryan Gosling describe their most spectacular dancing fail,0,3,4,58,0,10,0,62,0
Sports World Wonders How Trump’s Immigration Order Will Affect Athletes,0,3,10,51,1,9,0,61,0
Sir David Clementi confirmed as new BBC chair,0,3,6,32,0,7,0,38,0
Donald Trump says 'you always have to be concerned about nuclear war' as tensions with North Korea rise,0,3,4,80,2,17,0,84,0
6 million borrowers are 90 days late on their car loans,0,2,0,42,0,10,3,42,0
Lilly Singh Trades YouTube Videos For Paperbacks With New Book,0,2,11,42,0,9,0,53,0
Zagat Helps Bring Ratings to Health Care,0,1,6,28,0,6,0,34,0
U.K. Police Detain Man on Terrorism Suspicions Near Parliament,0,3,9,43,2,8,0,52,0
Trevor Noah Loves The Giant Eggs That Donald Trump Laid At His Easter Party,0,2,14,48,0,13,0,62,0
Now Donald Trump Must Fight The War He Isn't Ready For,0,3,11,32,1,10,0,43,0
Which Is Your Favorite Collab From Pitbull's New Album 'Climate Change'? Vote!,0,2,12,50,5,11,0,62,0
Opposition Leader predicts 'people's revolt' in Australia over carbon tax,0,1,3,58,3,9,0,61,0
Liberal group launches site tracking Trump's Mar-a-Lago trips,0,2,4,47,3,7,0,51,0
2017 Stella Prize: What will be named Australia's best book by a female author?,0,3,4,55,3,13,4,59,0
Republican slams Democratic women for wearing white to Trump’s speech [Video],0,3,4,60,3,10,0,64,0
The Night They Locked Up All the Smartphones,0,2,7,30,0,7,0,37,0
"Trump Aide Reassures Canada on Trade Talks, Isolating Mexico",0,3,8,43,1,8,0,51,0
Joint Chiefs Chairman Criticizes Afghan Air Strikes,0,1,7,38,0,6,0,45,0
Why Big Donors Are Fast-Tracking Charitable Gifts To Year-End 2016,0,3,11,40,2,9,4,51,0
How much does the chicken pox vaccine cost? Depends on where you live.,0,2,2,54,2,12,0,56,0
How a 23-year-old kid suddenly became the Oakland Raiders' best shot at a championship,0,2,3,65,3,13,2,68,0
Justin Trudeau Throws Some Grade-A Shade At Donald Trump,0,2,10,37,1,8,0,47,0
AT&T to purchase T-Mobile for US$39 billion,0,1,7,25,3,6,2,32,0
U.S. Freezes Assets of 2 Burmese Businessmen Who Backed Military Junta,0,1,10,47,2,10,1,57,0
Another Way Lead Kills Condors,0,1,5,21,0,4,0,26,0
Antonio Brown’s Antics Are Reportedly ‘Wearing Thin’ on Steelers Organization,0,3,9,56,3,9,0,65,0
Fall sweeps through Texas,0,1,2,20,0,3,0,22,0
Sheffield United relegated from English Football League Championship,0,1,6,55,0,7,0,61,0
Graham: I will never be satisfied until we punish Russia,0,3,3,43,1,9,0,46,0
Australian murder victims killed in different ways,0,1,1,43,0,6,0,44,0
Apple AirPods review: Do they actually stay in your ears?,0,3,4,42,2,9,0,46,0
"Avalanches are becoming more common, thanks to climate change, researchers say",0,2,1,65,2,10,0,66,0
"deadmau5 Drops Another Hip-Hop Track With Shotty Horroh, But This One Is Way Crazy: Listen",0,3,15,57,3,14,1,72,0
"Tim Lee: Trump Should Focus on Tax Cuts, Not Deficit",0,2,9,32,2,9,0,41,0
Orrin Hatch accidentally compares Iraq to Vietnam,0,1,4,39,0,6,0,43,0
Plane crash in Congo kills at least 70,0,1,2,27,0,7,2,29,0
Bill Gates Launches $1 Billion Breakthrough Energy Investment Fund,0,3,8,48,1,8,1,56,0
Discrimination Lawsuit Alleges Black Fox News Employees Were Forced to Arm Wrestle White Co-Workers,0,2,14,71,1,13,0,85,0
"For Australian Winemakers, More Turns Out to Be Less",0,1,8,35,1,8,0,43,0
Trump becomes 45th President of the United States,0,3,4,36,0,7,2,40,0
Palestinian Islamists attack children's festival in Gaza Strip,0,1,4,50,1,7,0,54,0
Donald Trump takes 12th golf trip since becoming President nine weeks ago,0,2,3,57,0,11,2,60,0
Kobe Bryant Recalls Being Angry at Allen Iverson's 41 Points vs. Lakers in 1999,0,2,9,49,2,13,6,58,0
Dog Mauls Family After One of Its Owners Tried to Dress Him in a Sweater,0,2,11,47,0,14,0,58,0
"Man Is Shot Dead by Soldiers at Paris Airport, Grounding Flights",0,3,9,44,1,10,0,53,0
Never Mind What It Costs. Can I Get 70 % Off?,0,1,9,21,3,10,2,30,0
Trump: My first 100 days are 'just about the most successful' in US history ,0,3,4,52,3,14,3,56,0
Romanian Visa card transactions increase by 60 percent in 2004,0,1,2,45,0,9,6,47,0
Donald Trump tells Republicans to 'go nuclear' to stop Democrats blocking Supreme Court nomination,0,3,6,77,2,13,0,83,0
"Carbon Monoxide Leak At Hotel Pool Leaves 1 Teen Dead, 12 People Hospitalized",0,3,11,50,1,12,3,61,0
"Alia Bhatt Makes A Sensible Comment On Nepotism In Bollywood, Says You Can't Fool People",0,3,15,57,2,14,0,72,0
People Think This Video Of A Woman Dancing With Her Sick Grandmother Is The Sweetest,0,3,15,55,0,14,0,70,0
Church closure threatens masterpiece by Jewish artist who fled Nazis,0,2,3,56,0,9,0,59,0
About time! Google will launch two flagship smartwatches early next year with Android 2.0 running the show ,0,2,3,83,2,17,2,86,0
Future Tense: How a Pair of Albums Turned the Rapper From Mixtape MC to Mastermind,0,2,12,55,1,14,0,67,0
These twin baby girls have different skin colors,0,3,1,40,0,7,0,41,0
Fundraising to keep Avro Vulcan flying succeeds,0,1,3,38,0,6,0,41,0
Inside Taylor Swift's $25 Million Beverly Hills Mansion - Yahoo,0,2,8,41,3,9,2,49,0
States Join E.P.A. Study of Pathogens in Ohio River,0,1,9,31,3,8,0,40,0
Idaho judge says rape is 'a direct consequence of the social media system',0,2,1,59,2,12,0,60,0
Chemical weapons experts are reportedly in Turkey to investigate the alleged sarin attack in Syria,0,3,3,81,0,14,0,84,0
"Blue State Blues: After Berkeley, Treat Violent, Anti-Speech Left Like the KKK",0,3,14,49,4,11,0,63,0
Repealing Obamacare affects everyone,0,3,2,31,0,3,0,33,0
Ranking the Top 25 Sophomores Heading into the 2017 College Football Season,0,3,7,51,0,11,6,58,0
MLB: Barry Bonds breaks Hank Aaron's home run record,0,1,7,35,2,8,0,42,0
Iraqi government approves power-sharing deal eight months after elections,0,1,1,63,1,8,0,64,0
Facebook's New Feature Is About to Make Your Timeline Way More Colorful,0,3,11,48,1,11,0,59,0
Wikipedia features Encyclopædia Britannica on its main page,0,1,3,49,0,7,0,52,0
Syrian officials and Lebanese President accused by U.N. report,0,1,5,47,2,8,0,52,0
Wall Street: Markets unmoved by Trump's tax plan unveiling,0,3,4,44,2,8,0,48,0
Bristol Central Library closed after fire,0,1,3,33,0,5,0,36,0
Christie Brinkley poses for Sports Illustrated Swimsuit edition with daughters,0,2,5,64,0,9,0,69,0
Angry fan threw eggs at Chargers' headquarters after news broke that the team would relocate to Los Angeles,0,2,4,85,1,17,0,89,0
Roger Ailes Has Died,0,2,4,13,0,3,0,17,0
"London terror: Cops sift through 2,500 items to assemble killer's profile ",0,3,2,54,3,11,4,56,0
"The Cat Is Finally Out Of The Bag, Shraddha Disses Rumours Of Her Relationship With Farhan",0,3,16,58,1,15,0,74,0
Distance Insulates Journalists Who Use Private Information,0,1,7,45,0,6,0,52,0
Africans being attacked by roaming mobs in India,0,3,2,39,0,7,0,41,0
Mugabe: A vote for MDC is a wasted vote,0,1,5,25,1,8,0,30,0
ECB Stands Ready to Support Banks If Needed After France Vote,0,2,12,39,0,10,0,51,0
"Romania Set for First Female, and First Muslim, Prime Minister ",0,3,8,43,2,10,0,51,0
"Bronx, New York church destroyed in suspicious blaze",0,1,3,41,1,7,0,44,0
"EU, US declare intent to cooperate on climate change at summit",0,1,4,47,1,10,0,51,0
Procedure to Bypass G.O.P. on Health Care Carries Risks for Democrats,0,1,10,46,3,10,0,56,0
Nicki Minaj Drops New Three New Singles,0,3,7,26,0,6,0,33,0
Greek Debt-Relief Measures Unblocked by Eurozone,0,3,6,36,1,5,0,42,0
Percy Harvin Plans to Retire from NFL After 8-Year Career,0,2,10,36,1,9,1,46,0
Hillary Clinton's unpaid intern limbo: a grassroots campaign of 'free help',0,2,2,59,4,10,0,61,0
DOJ stirs free-speech fight after demanding libertarian site turn over info on commenters ,0,3,3,73,1,13,0,76,0
Bill to Ease Rules on Development Divides Floridians,0,1,6,39,0,7,0,45,0
Indonesia accuses Australia of reaching 'new low' over people-smuggler bribery allegations,0,2,2,75,3,10,0,77,0
Hurricanes may be associated with sunspots,0,1,1,36,0,5,0,37,0
20 Likeliest NBA Players to Be Dealt This Offseason,0,3,9,32,0,8,2,41,0
NFL star Michael Vick indicted for running dog fighting operation,0,1,5,51,0,9,0,56,0
Smoldering Mounds of Trash Obstruct Ukraine’s Road to Recovery,0,3,7,46,1,8,0,53,0
"STEM enrolments hit 20-year low, but scientists have an idea to stop the slide",0,2,4,57,2,13,2,61,0
Two pastors arrested for sex crimes against children,0,2,1,44,0,7,0,45,0
"Bob Weir Ropes Grateful Dead Classics, Dylan Covers & Cowboy Songs Into MusicNOW Festival Kick-Off Show",0,3,19,66,3,15,0,85,0
Kardashian West robbery: First suspects under formal investigation,0,3,3,55,1,7,0,58,0
Canada Offers Energy Subsidy to Pulp and Paper Industry,0,1,7,40,0,8,0,47,0
Michael Flynn Resigns as National Security Adviser,0,3,6,38,0,6,0,44,0
"The most popular Final Four picks are Kansas, Villanova, North Carolina, and Arizona",0,2,8,61,3,12,0,69,0
Secret memos reveal Bush administration endorsed enhanced interrogation techniques,0,1,2,72,0,8,0,74,0
"According to Facebook, Australia couldn't get enough of Trump in 2016",0,2,4,49,2,10,4,53,0
19 Dead Over 48 Hours as Tornadoes Wreak Havoc in the South ,0,3,7,37,0,12,4,44,0
Justin Timberlake Makes Two Half-Court Shots: Watch,0,2,8,35,2,6,0,43,0
Deported mother: ’I did it for love’,0,2,2,25,3,6,0,27,0
Russia to Ban Hunting of Baby Seals,0,1,5,24,0,6,0,29,0
Australian Jesse Williams drafted in fifth round by the NFL's Seattle Seahawks,0,1,8,58,1,11,0,66,0
"Here’s How Apple Music Compares With Spotify, Pandora, and Tidal",0,3,9,43,3,9,0,52,0
7 Times Carrie Underwood's Faith Was Inspiring [Video],0,3,7,36,3,7,1,43,0
HIV-positive man receives 35 years for spitting on Dallas police officer,0,1,4,55,1,10,2,59,0
Casey Affleck Wins Best Actor Oscar Despite Backlash Over Sexual Harassment Allegations,0,2,12,64,0,11,0,76,0
UK Prime Minister: The world will enter a recession,0,1,5,37,1,8,0,42,0
Roddick and Ivanovic Advance at Australian Open,0,1,5,36,0,6,0,41,0
Morgan StanleyVoice: Retirement And The Coming Longevity Crunch,0,2,9,46,1,7,0,55,0
An armed robber is holding 7 people hostage inside a Paris travel agency,0,3,2,57,0,12,1,59,0
At Least 4 Dead as Tornadoes Batter the Southeast ,0,3,6,34,0,9,1,40,0
Car crash puts Poland's prime minister in hospital,0,2,2,40,1,7,0,42,0
Service dogs get their own pictures in high school yearbook,0,2,1,49,0,9,0,50,0
Clemson Beats Alabama 35-31 with Last-Second Touchdown,0,2,6,36,2,6,4,42,0
"As Far As Barcelona Are Concerned, Lionel Messi Is Indispensable To The Club",0,3,13,50,1,12,0,63,0
Robin Thicke Accused of Child Abuse Amidst Custody Fight: Report,0,3,9,45,1,9,0,54,0
Lonzo Ball Reacts to LeBron James 'Mocking' His Shooting Form,0,3,10,40,2,9,0,50,0
Iran warns West about meddling while clerics opine,0,1,2,41,0,7,0,43,0
"Michael Brown, Director of FEMA resigns",0,1,7,26,1,5,0,33,0
"Persons from Punta Arenas, Chile on strike after government announcement to increase gas prices",0,1,4,77,1,13,0,81,0
Nokia's Classic 3310 Phone Lives Again - And It Has 'Snake' Too,0,3,10,34,4,11,4,44,0
US says polar bears are threatened species,0,1,2,34,0,6,0,36,0
The 10 top-selling movies of the year on iTunes,0,3,2,34,1,8,2,36,0
Slater and Gordon investors lose hope of recovering money as shares crash to 11c,0,3,2,63,0,13,2,65,0
Check Out the First Trailer for ESPN’s 'This Was the XFL' Documentary,0,2,14,41,3,11,0,55,0
'Beauty and the Beast' Box Office: 5 Biggest Records Broken,0,3,7,39,3,9,1,46,0
US lawmakers approve bill taxing executive bonuses,0,1,2,42,0,6,0,44,0
Airline bombing suspect spent months in Yemen,0,1,2,37,0,6,0,39,0
Permanent Flood Solutions Just Out of Reach for Fargo,0,1,7,38,0,8,0,45,0
"Remy Ma on ""shETHER"": 'I'm Just Not Particularly Proud of It'",0,3,13,32,6,10,0,45,0
"Braylon Beam, 6-year-old cancer patient, signs 1-day deal to coach Carolina Panthers",0,3,4,62,5,11,2,66,0
Formula One Threatens to Sue Teams Seceding Over Cost Cap,0,1,9,39,0,9,0,48,0
‘The Art of Dissent’ ,0,2,3,12,2,4,0,15,0
Series of explosions hit hotels in Amman,0,1,2,32,0,6,0,34,0
Megyn Kelly leaving Fox News for NBC News,0,2,8,26,0,7,0,34,0
"In Argentina, a Camera and a Blog Make a Star",0,1,6,29,1,9,0,35,0
"Older Viewers and Conservatives Are Watching Less NFL, Survey Finds",0,2,11,46,1,9,0,57,0
Lufthansa Says Fare Slide to Slow as CEO Seeks Further Cost Cuts,0,2,12,41,0,11,0,53,0
That story about Serena Williams and the anti-abortion priest isn't real The list,0,3,4,63,2,12,0,67,0
"Thor and his Aussie roommate are back, dealing with real life struggles",0,2,2,57,1,11,0,59,0
Marissa Mayer will step down as Yahoo's CEO after the Verizon deal closes,0,3,7,53,1,12,0,60,0
"Olympic condoms auctioned: ""faster, higher, stronger""",0,1,1,42,5,5,0,43,0
Texas looks set to follow North Carolina with push for 'bathroom bill',0,3,3,54,2,11,0,57,0
"National Disability Insurance Scheme rollout plagued with problems, FOI documents reveal",0,3,7,70,1,10,0,77,0
Saudi Arabia says man who planned mosque attack killed in shootout ,0,3,2,54,0,11,0,56,0
"Kushner, Bannon sit down to work out differences on Trump’s orders",0,2,3,51,2,10,0,54,0
"In Rube Goldberg Price Scheme, EpiPen Competitor Auvi-Q To Be Free For Patients, $4,500 For Their Insurers",0,3,18,63,5,16,4,81,0
"Wikinews interviews Juana Bustamante, Chilean earthquake survivor from Paniahue",0,1,5,65,1,8,0,70,0
"Which? survey finds household appliances to blame for almost 12,000 fires in three years",0,2,1,67,2,13,5,68,0
Many Japanese Look for a Shift to Female Heirs to the Throne ,0,2,7,42,0,12,0,49,0
Celtics-Bulls Series Marked by Big Shots and Rugged Play,0,1,8,39,1,8,0,47,0
Tennis Star Maria Sharapova Suspended For 2 Years For Doping,0,2,9,41,0,9,1,50,0
One dead in Michigan school shooting,0,1,2,29,0,5,0,31,0
Perth-London flights announced by Qantas for 2018,0,2,3,35,1,6,4,38,0
"Gunman In Zurich Mosque Shooting Is Dead, Police Say",0,2,9,34,1,8,0,43,0
Istanbul attack: CCTV footage shows gunman killing man outside Reina nightclub and firing into the street,0,3,6,83,1,15,0,89,0
What's your experience of discriminatory dress codes at work?,0,3,1,50,2,8,0,51,0
India plans to give 88 million cows 'identity cards' which can be tracked online ,0,3,1,62,2,14,2,63,0
Three British Army soldiers killed in Iraq,0,1,4,32,0,6,0,36,0
Uber's Loss Exceeds $800 Million in Third Quarter on $1.7 Billion in Net Revenue,0,3,9,49,4,13,5,58,0
"Melissa McCarthy Is Easter Spicey, The Apologizing Easter Bunny",0,3,10,44,1,8,0,54,0
Henri Van Breda denies South Africa axe murders,0,3,5,35,0,7,0,40,0
Colombia Mad Over Wiz Khalifa's Visit to Pablo Escobar Tomb,0,2,9,40,1,9,0,49,0
"Inmate’s teacher alleges rape, prison negligence",0,2,1,40,2,5,0,41,0
Pakistan Rehearses Its Two-Step on Airstrikes,0,1,6,33,1,5,0,39,0
Egypt court upholds ruling halting transfer of islands to Saudi Arabia,0,3,3,57,0,10,0,60,0
Four U.N. staff dead after plane crash in Bolivia,0,1,4,35,2,8,0,39,0
Hundreds of Palestinian prisoners in Israel go on hunger strike,0,3,3,51,0,9,0,54,0
Watch Aziz Ansari Call Donald Trump the 'Chris Brown of Politics' on 'SNL',0,3,12,46,4,12,0,58,0
Can Trump’s Justice Department Undo Police Reform?,0,2,7,35,2,6,0,42,0
Vote: NFL playoff predictions?,0,3,4,21,2,3,0,25,0
Now The Real Coach Of Geeta Phogat Might Sue Dangal Producers Over His Characterisation,0,3,14,60,0,13,0,74,0
Manus Island refugee charged over fake passport after Fiji deportation,0,3,3,58,0,9,0,61,0
U.S. Forces Play Crucial Role Against ISIS in Mosul - The New York Times,0,2,16,40,3,13,0,56,0
"For a Post in Europe, a Renaissance Admiral",0,1,5,30,1,7,0,35,0
3rd Brazilian prison riot in a week leaves 4 dead,0,3,1,37,0,9,2,38,0
Female lawyers to be granted court access in Saudi Arabia,0,1,3,45,0,9,0,48,0
Vladimir Putin’s popularity is soaring among Republicans,0,3,3,46,1,6,0,49,0
White House Proposes New Rules to Steady Insurance Markets Under Health Law ,0,2,11,53,0,12,0,64,0
Attack on Alt-Right Leader Has Internet Asking: Is It O.K. to Punch a Nazi? ,0,3,13,44,5,14,0,57,0
"CarMax, Others Settle US Actions Over Ads on Used Car Safety ",0,3,12,37,1,11,0,49,0
Shots Fired at Climate Skeptic’s Office During March for Science,0,2,8,46,1,9,0,54,0
Local government officials confiscate London ice cream made from human breast milk for health reasons,0,1,2,85,0,14,0,87,0
The baby names to choose if you want a little millionaire,0,2,1,46,0,10,0,47,0
'The Trumps' Is The Spoof Lego Set No One Will Want This Holiday Season,0,3,14,42,2,13,0,56,0
Ronda Rousey knocked out in 48 seconds at UFC 207,0,3,5,30,0,9,5,35,0
New York Prison Break: 7 Inmates Who’ve Passed Through Dannemora,0,2,9,43,2,9,1,52,0
"Wikinews interviews Gene Amondson, Prohibition Party presidential nominee",0,1,5,60,1,7,0,65,0
GOP Lawmakers Struggle to Unite on Health Bill ,0,3,8,31,0,8,0,39,0
Ed Werder is among the 100 people being laid off by ESPN,0,3,6,36,0,11,3,42,0
Civil Lawsuits Over Collapse of Utah Mine Are Settled,0,1,8,37,0,8,0,45,0
Donald Trump Budget Slashes Funds for E.P.A. and State Department ,0,2,10,43,3,10,0,53,0
Carbon Offsets: A Small Price to Pay for Efficiency,0,1,7,35,1,8,0,42,0
"‘If your toe falls off, tape it’: Joel Berry II’s path to NCAA legend status",0,3,9,48,5,14,0,57,0
Tracking the President’s Visits to Trump Properties ,0,3,5,39,1,7,0,44,0
Rocking Out Backstage With an Opera Star - Video - NYTimes.com,0,3,10,39,3,10,0,49,0
Father v son: The Yadav family drama gripping Indian politics,0,3,4,47,1,9,0,51,0
The market's fear index is plunging at the fastest pace since Trump's election,0,3,2,62,2,12,0,64,0
Harvard Law School to Allow Applicants to Take GRE ,0,3,9,33,0,9,0,42,0
Maoists in India Briefly Seize Passenger Train,0,1,6,34,0,6,0,40,0
"FBI arrests Ohio pastor, another man on child sex charges ",0,3,4,43,1,10,0,47,0
Church of Scientology attempting to block 'intolerant' German film,0,1,3,53,2,8,0,56,0
Google's dream of a steering-wheel-free future is reportedly being curtailed,0,2,1,63,3,9,0,64,0
Gordon Ramsay's father-in-law admits to computer hacking ,0,3,2,45,3,7,0,47,0
"In Tech Industry, Some Signs of a Comeback",0,1,6,28,1,7,0,34,0
E. coli outbreak linked to peanut butter substitute,0,2,1,42,1,7,0,43,0
"'Frozen woman' mannequin fools Hudson, New York police",0,3,4,40,3,7,0,44,0
"With final detainee transfer, Obama’s Guantanamo policy takes its last breath",0,3,3,62,2,10,0,65,0
Controversial painting to be removed from Capitol,0,2,2,41,0,6,0,43,0
City Plans to Make Older Buildings Refit to Save Energy,0,1,8,38,0,9,0,46,0
Former Google exec calls Trump travel ban an 'enormous problem',0,3,3,49,2,9,0,52,0
"Here's how Inauguration Day unfolded, moment by moment",0,2,3,42,2,7,0,45,0
Delingpole: Donald Trump Is Turning into David Cameron. This Is Bad.,0,3,10,45,3,10,0,55,0
Migos Soar to No. 1 on Billboard Artist 100,0,3,5,25,1,8,4,30,0
Explosion in Russian nightclub kills at least 94,0,1,2,37,0,7,2,39,0
"Hugh Jackman Explains 'Logan' Is In A ""Different Universe"" Than Other X-Men Movies",0,3,14,51,5,12,0,65,0
Where nursery rhymes really come from,0,3,1,31,0,5,0,32,0
Airports May Soon Have Lie-Detecting Security Kiosks To Identify Whether You're Conning Authorities,0,3,14,71,2,12,0,85,0
President Trump’s Spokesman Just Lied About The Size Of The Inauguration Crowd,0,3,12,54,1,11,0,66,0
Chris Christie Backs 'Coalition Of The Willing' For Iraq,0,2,9,37,2,8,0,46,0
Oscar Winner of Best Foreign Language Film Boycotted Event Because of Trump's 'Inhuman Law',0,2,12,63,3,13,0,75,0
Medvedev Visits Newspaper of Slain Journalists,0,1,5,36,0,5,0,41,0
Australian PM announces public affairs channel,0,1,3,38,0,5,0,41,0
Private school housemaster cleared of abusing boys after victim's father writes to court to defend him,0,2,1,85,1,15,0,86,0
"Scott Walker Moves To Kill A Century-Old Nature Magazine, And Readers Are Furious",0,2,14,53,2,12,0,67,0
CEO Responds To 7-Year-Old Girl Who Asked 'Google Boss' For A Job,0,2,15,34,4,11,1,49,0
Golfer Tiger Woods delivers apology speech,0,1,3,34,0,5,0,37,0
Women 'treated like rock stars' after finding themselves alone on British Airways flight,0,3,3,71,2,12,0,74,0
Camel Rock Festival held in Scilly,0,1,4,25,0,5,0,29,0
"FA Cup photo essay – road to Wembley, quarter-final: Middlesbrough v Manchester City",0,3,7,61,4,12,0,68,0
"Early Voting Didn’t Boost Overall Election Turnout, Studies Show ",0,3,9,45,2,9,0,54,0
Chest-Puffing Grouse to Test Trump’s Conservation Approach,0,3,7,43,2,6,0,50,0
"House Repeal Bill Bids Goodbye To ObamaCare Taxes On Under $250,000-A-Year Earners",0,3,14,47,4,11,6,61,0
Twelve dead after suicide bomb attack in Pakistan,0,1,2,40,0,7,0,42,0
Collegians Show a Commitment to Elevating Cricket in America,0,1,6,46,0,8,0,52,0
Vettel Leads Red Bull to 1-2 Finish at Silverstone,0,1,6,33,1,8,2,39,0
Nearly three million contraband cigarettes seized by Canadian and U.S. authorities,0,1,4,66,2,10,0,70,0
What Happened to Archway?,0,1,3,18,1,3,0,21,0
'Scooter' Libby jail sentence commuted by US President George Bush,0,1,7,48,2,9,0,55,0
Russia rejects latest US proposal on missile defense,0,1,3,42,0,7,0,45,0
British PM Tony Blair pressured by resignations,0,1,5,36,0,6,0,41,0
Alan Turing given posthumous pardon,0,1,2,29,0,4,0,31,0
Indonesia angered as nation's airlines all remain banned in EU airspace,0,1,3,57,1,10,0,60,0
"This Is Wang Qi, The Chinese Man Who Has Been Trapped In India For Almost Half A Century",0,3,18,52,1,17,0,70,0
"U.S. watchdog group lists ""most corrupt members of Congress""",0,1,3,45,4,8,0,48,0
Communities Built on Faith   ,0,2,3,20,0,6,0,23,0
John Biggs elected as Labour mayor of Tower Hamlets,0,3,5,38,0,8,0,43,0
Investors cheer as Macron emerges as favorite to lead France,0,3,3,48,0,9,0,51,0
New poll indicates Barack Obama's approval rating under 50%,0,1,3,44,2,8,2,47,0
Hundreds of Syrian men disappear crossing into government-held territory ,0,3,2,61,1,9,0,63,0
New Roger Stone Documentary Reveals Trump’s Man,0,2,7,33,1,6,0,40,0
Prince Harry to attend Army and Navy rugby match with Invictus competitors,0,2,5,58,0,11,0,63,0
"Ask Billboard: 'Black Beatles,' 'Black Barbies' & Other Response Songs",0,2,9,45,7,9,0,54,0
Adam Silver Discusses Future of Broadcasting NBA Games,0,2,9,38,0,7,0,47,0
Bodies Bending Sound in the Guggenheim - Video - NYTimes.com,0,2,8,40,3,9,0,48,0
Global Markets: Stocks Gaining Ground After Early Softness,0,3,8,42,1,7,0,50,0
Why a rising number of criminals are using Facebook Live to film their acts,0,2,3,59,0,13,0,62,0
Baby pygmy hippo in debut splash,0,3,1,26,0,5,0,27,0
American soldier killed fighting ISIS in Afghanistan ,0,2,6,40,0,7,0,46,0
"Venezuela buys more weapons, now from Spain",0,1,2,34,1,6,0,36,0
How skiing is going green in Chamonix,0,3,2,29,0,6,0,31,0
Latino Groups Praise Pick of Alexander Acosta for Trump Cabinet,0,3,8,46,0,9,0,54,0
Denver Broncos Von Miller Wears Fur Cleats Before Broncos' Game vs. Patriots,0,2,11,52,2,11,0,63,0
Louisiana officials accused of blocking rescue volunteers,0,1,1,50,0,6,0,51,0
"Cyclists Hunt for an Edge. This Time, It’s Data, Not Drugs",0,3,9,35,4,10,0,44,0
Pelicans' DeMarcus Cousins suspended one game after 18th technical foul,0,3,4,55,1,9,2,59,0
A New Tool for the War on Fake Rolexes,0,2,6,24,0,8,0,30,0
US military to carry out review following Wikileaks release of classified 2007 video,0,1,3,65,0,12,4,68,0
There Is No Right-Wing Equivalent to Political Correctness,0,2,8,42,1,7,0,50,0
NYC woman arrested after flashing BB guns at hotel wants to star in prison TV show ,0,3,7,60,0,16,0,67,0
"Nurseries not harmful to children, says new UK study",0,1,3,40,1,8,0,43,0
"Inspired by Wolverine, Scientists Develop Self-Healing Artificial Material",0,2,8,57,2,7,0,65,0
How a devastating loss in Florida taught Jeb Bush what it takes to win,0,3,4,53,0,13,0,57,0
China launches 1st domestically-built aircraft carrier,0,3,1,46,1,5,1,47,0
The Trump administration just put Iran 'on notice' â but the Pentagon has no idea what that means,0,3,4,74,4,17,0,78,0
"People are buying Ferraris, Joe Hockey – that doesn't make them affordable",0,3,4,56,3,11,0,60,0
"Italy Bus Crash Kills 16, Mostly Hungarian Teenagers on School Trip",0,3,9,45,1,10,2,54,0
The astonishing Amazon 'anumeric' people whose language has no words for numbers,0,2,2,65,2,11,0,67,0
"Meet Hammad Shoaib, Pakistan’s Very Own Ranveer Singh Who Has Taken The Internet By A Storm!",0,3,16,58,3,15,0,74,0
Jewish centres evacuated in US after new wave of bomb threats,0,3,3,48,0,10,0,51,0
Facebook Debuts Video App For Apple TV And Amazon Fire TV,0,3,13,34,0,10,0,47,0
Two British servicemen killed in roadside bombing,0,1,2,41,0,6,0,43,0
Mars Investigating Skittles Said to Be Intended for Cattle,0,3,7,43,0,8,0,50,0
All the news from Apple's WWDC 2015 Keynote,0,3,7,24,1,7,4,31,0
Ethiopian airliner crashes into Mediterranean Sea,0,1,3,41,0,5,0,44,0
The Grim Logic Behind Syria’s Chemical Weapons Attack ,0,3,8,37,1,8,0,45,0
George RR Martin: 'I think Winds of Winter will be out this year',0,3,7,43,3,12,0,50,0
Zimbabwe DNA tests 'prove hunter was killed by a crocodile',0,3,4,44,2,9,0,48,0
Warriors Fans Told LeBron Changed His Name to Jordan in New 'Lie Witness News',0,2,13,50,2,13,0,63,0
That Shot Was Out? A Clue on When to Challenge a Call,0,1,9,32,1,11,0,41,0
Cardell Hayes found guilty of manslaughter in Will Smith case,0,3,4,48,0,9,0,52,0
Ex-trooper charged in 2014 shooting death of pregnant wife ,0,2,1,44,1,9,4,45,0
Search for climbers on US mountain ends; two presumed dead,0,1,3,45,1,9,0,48,0
Grads of LifeVoice: The Changing Nature Of Work And How Smart Companies Are Adapting,0,3,14,56,1,13,0,70,0
Easter celebrations: Christian leaders call for peace in 'world of pain',0,3,2,57,3,10,0,59,0
#ThankYouObama Floods Twitter With Love For Outgoing POTUS,0,3,14,36,1,7,0,50,0
Democrats Criticize Supreme Court Nominee Gorsuch As Pro-Business,0,2,9,48,1,7,0,57,0
"Myanmar to Bar Rohingya From Fleeing, but Won’t Address Their Plight ",0,2,9,47,2,11,0,56,0
Clemson earns a rematch against Alabama for the NCAA football national championship,0,2,6,66,0,11,0,72,0
China Goes on a Commodities Shopping Spree,0,1,5,31,0,6,0,36,0
Homeland Security Head Is Pressed to Define 'Sanctuary City' ,0,3,8,42,2,9,0,50,0
Seth MacFarlane Suggests Why Donald Trump Can't Handle Criticism Any More,0,2,12,50,1,10,0,62,0
Turkey faces long and difficult fight against Isis in Syria,0,3,3,47,0,9,0,50,0
China Mourns Cuba's Fidel Castro Despite Past Animosity,0,2,8,39,1,7,0,47,0
Trump Wiretapping Claims Rejected by Senate Intelligence Chiefs,0,3,7,49,0,7,0,56,0
Should I Trust Wikipedia With My Health?,0,2,7,26,1,6,0,33,0
Local Agencies Team Up to Sell Industry on Minneapolis,0,1,7,39,0,8,0,46,0
India wins Gavaskar Border trophy defeating Australia 2-0,0,1,4,43,1,7,2,47,0
"Dance party broken up by police in Utah, USA",0,1,5,30,1,8,0,35,0
Seriously exciting times: Australia just got its first direct flight to Europe,0,3,3,63,1,11,0,66,0
Did Gorka Really Wear A Medal Linked To Nazi Ally To Trump Inaugural Ball?,0,2,14,46,1,13,0,60,0
About Those 79 Cents,0,2,3,12,0,3,2,15,0
Theresa May needs to focus on changing the attitudes of British businesses as much as she does on Brexit,0,2,4,82,0,18,0,86,0
Anti-Semitic Valentine at Republican student event sparks outrage,0,3,4,53,1,7,0,57,0
Uganda introduces anti-homosexual legislation,0,1,1,40,1,3,0,41,0
Mills & Boon introduce surround-sound steamy romance novels for bored housewives,0,2,2,66,2,10,0,68,0
Secrets of what ancient mummies look like under their wrappings are finally being revealed,0,3,1,76,0,13,0,77,0
3.6-Million-Year-Old Early Human Footprints Have Been Discovered In Tanzania,0,3,11,51,4,8,2,62,0
Hillary Clinton says ‘misogyny played a role’ in her loss. Research suggests she might be right.,0,2,3,74,4,15,0,77,0
Retired French doctor is unwitting owner of 'lost' Leonardo da Vinci drawing worth €15 million,0,3,4,71,3,14,2,75,0
Sabathia Makes It No Fun at All for the Mets,0,1,7,28,0,9,0,35,0
Trump Says He Will 'Renegotiate' NAFTA,0,3,10,21,2,5,0,31,0
Ikea to sell rugs made by Syrian refugees in 2019,0,2,2,34,0,9,4,36,0
Polar vortex brings rare multi-coloured clouds to Britain,0,3,2,47,1,7,0,49,0
Valech Report released,0,1,2,18,0,2,0,20,0
"Indiana kids dead after falling through ice on pond behind home, authorities say",0,3,1,66,1,12,0,67,0
Donald Trump Keeps His Promise; Selects Constitutionalist Neil Gorsuch for Supreme Court,0,2,11,65,1,11,0,76,0
"Obama Attacks Trump Over His Anti-Immigration Executive Order, Supports Anti-Trump Protests Across America",0,3,15,76,3,12,0,91,0
Political Cartoon Compares Betsy DeVos to Civil RIghts Icon Ruby Bridges,0,3,12,50,0,10,0,62,0
"100 Days of President Trump: The Good, the Bad, and the Ugly",0,2,7,36,3,11,3,43,0
Tonga: Four guilty over ferry disaster that killed 74,0,1,2,40,1,8,2,42,0
He was her schoolgirl crush. She was his close friend’s little sister.,0,2,2,54,3,11,0,56,0
7 mental tricks US Olympic athletes use to perform under pressure,0,2,3,51,0,10,1,54,0
White House Won't Penalize Kellyanne Conway For Plugging Ivanka Trump's Brand,0,3,11,54,2,10,0,65,0
"White House vows plan will offer insurance to every American, downplays upcoming CBO report ",0,3,6,71,1,14,0,77,0
Opium production in Afghanistan reaches record highs,0,1,2,44,0,6,0,46,0
"The 2017 Marc Gasol All-Stars, featuring the true heir to the throne",0,3,5,46,2,11,4,51,0
"Billboard Dance Chart Upstarts: Jax Jones, R3hab & filous",0,3,7,38,3,8,1,45,0
Billboard near Elon Musk's Tesla factory asks him to 'dump Trump' ,0,2,5,47,3,11,0,52,0
Cornell Students: the Word ‘Plantation’ Is Always Racist,0,2,7,39,3,7,0,46,0
An Alarming Percentage Of Women At UT Austin Reported Being Raped,0,3,12,43,0,10,0,55,0
Somali pirates demand $2 million ransom for US captain held hostage,0,1,3,52,1,10,1,55,0
"Missing Manager, Mets Find Their Offense",0,1,6,28,1,5,0,34,0
'Deadshot Mary': The undercover cop who became a tabloid sensation,0,3,3,51,3,9,0,54,0
Clinton and Trump Campaigns Are Buzzing About the Race … for the Cabinet - The New York Times,0,2,12,62,2,17,0,74,0
Trump ditches press pool to play golf,0,3,1,30,0,6,0,31,0
Prince William in Paris on first official visit since mother Diana's death,0,3,4,58,1,11,0,62,0
Striking NYC transit workers will return to jobs,0,1,4,37,0,7,0,41,0
Alleged Boob-Biter Azealia Banks Will Not Serve Jail Time for Her 2015 Assault Case,0,2,13,52,1,13,4,65,0
Ukip donor Arron Banks says he is 'sick to death' of hearing about Hillsborough tragedy which killed 96,0,3,4,78,2,17,2,82,0
Ex-Barclays Banker Leaked Tips for Job With Plumber; Gets Jail,0,3,10,41,2,9,0,51,0
Seven injured in head-on car collision near Ledge Point in WA,0,3,5,45,1,10,0,50,0
Odell Beckham Jr. Fields Punt in Sumo Suit at Pro Bowl Practice,0,3,10,41,1,11,0,51,0
Dylann Roof Found Guilty of Charleston Church Massacre,0,2,7,40,0,7,0,47,0
Casey Affleck Addresses 2010 Sexual Harassment Allegations After Best Actor Win,0,2,10,55,0,10,4,65,0
Congress Relaunches Transgender Equality Task Force,0,3,6,40,0,5,0,46,0
Chipotle Continues on Rocky Path as Earnings Slide,0,2,6,37,0,7,0,43,0
Scapegoat or Spy? Vatican Consultant Commands Attention at Leaks Trial - The New York Times,0,2,12,63,2,14,0,75,0
New search engine to search inside Wikipedia,0,1,2,36,0,6,0,38,0
Tesla Model 3 Vs. Chevy Bolt EV: Test Ride Vs. Test Drive,0,3,12,30,3,11,1,42,0
Five injured as Adam Air 737 overruns Batam island runway,0,1,4,41,0,9,3,45,0
"This Week in Billboard Chart History: In 1991, Gloria Estefan's 'Dark' Lit Up the Hot 100",0,2,12,50,5,15,7,62,0
Donald Trump Picks Ben Carson to Head Housing Agency,0,3,8,36,0,8,0,44,0
The Adorable Moment A Baby Koala Held His Mom During Her Surgery,0,2,12,41,0,11,0,53,0
British University academics vote for strike action,0,1,2,43,0,6,0,45,0
John Glenn wrote Jeff Bezos a beautiful letter that he read for the first time the day the astronaut died,0,2,4,82,0,19,0,86,0
ECB’s Next Trick? Acknowledge Europe’s Improving Economy ,0,3,9,38,3,7,0,47,0
"U.S. to Confront, Not Board, North Korean Ships",0,1,8,28,4,7,0,36,0
Dulko Sends Sharapova to Another Early Exit,0,1,6,31,0,6,0,37,0
Aussies Are Shunning Bunnies And Embracing The Easter Bilby Instead,0,3,10,48,0,9,0,58,0
Bank of Canada’s Poloz Warns of Perils of Protectionism,0,3,6,40,1,8,0,46,0
Somali pirates capture two ships,0,1,1,27,0,4,0,28,0
"Can CNN, the Go-to Site, Get You to Stay?",0,1,9,20,4,8,0,29,0
Boise Region Grapples With Smog,0,1,5,22,0,4,0,27,0
Stares and stripes: Can you tell how many zebras are in this photograph? You'll need to look very closely...,0,2,3,81,6,18,0,84,0
Trump’s Mar-a-Lago Hit With 13 Health Violations in January,0,3,8,38,3,8,2,46,0
Seven killed in Chinese bombing,0,1,2,25,0,4,0,27,0
Al Gore-owned cable news channel to relaunch August 1 with viewer-created content,0,1,3,64,2,11,1,67,0
Casey Anthony: 'I Don't Give A S**t About What Anyone Thinks About Me',0,3,13,39,6,12,0,52,0
"Many Americans don't know Obamacare and the Affordable Care Act are the same, exact thing",0,3,6,67,2,14,0,73,0
Odense SC win Danish squash championship,0,1,4,31,0,5,0,35,0
TAM Linhas Aéreas plane crashes at São Paulo airport in Brazil,0,1,8,44,0,10,0,52,0
Is this the world’s most terrifying creature? Pig gives birth to mutant offspring that looks like a monkey,0,3,2,85,2,17,0,87,0
Syrian war: CNN goes inside Aleppo under airstrikes,0,2,5,38,1,7,0,43,0
Injured NASA astronaut replaced on crew of upcoming mission,0,1,5,46,0,8,0,51,0
Chrysler Franchisees Make Case Against Closings,0,1,6,36,0,5,0,42,0
Tearful Adele Wins Raves for Insisting on Starting George Michael Tribute Over Again at Grammys,0,3,12,69,0,14,0,81,0
Record rainfall closes Australia's Uluru national park,0,3,3,44,1,6,0,47,0
Britain's new EU ambassador 'had nothing to do' with Donald Trump Russian dossier ,0,3,6,60,3,13,0,66,0
Moderate Cleric Among 9 Killed in Pakistan Blasts,0,1,6,35,0,7,1,41,0
Committee to Protect Journalists calls for release of Gambian journalists,0,1,4,60,0,9,0,64,0
David Miliband in running for top UN development job,0,2,4,40,0,8,0,44,0
"Ecuador Re-elects President, Preliminary Results Show",0,1,6,40,2,5,0,46,0
Twitter no longer recommends Trump's profile when you search 'asshole',0,3,2,56,3,9,0,58,0
Man in standoff with deputies uses Facebook Live to surrender,0,3,3,49,0,9,0,52,0
"Lil Uzi Vert Literally Got Animated For His ""P's & Q's"" Video",0,3,11,34,5,11,0,45,0
"When voting on Brexit, emotional ties to Europe likely won’t be on Brits’ minds",0,2,4,59,3,13,0,63,0
Could violence in Ukraine be a precursor to something worse?,0,2,2,48,1,9,0,50,0
Kevin Love to Return from Knee Injury vs. Jazz,0,3,6,31,1,8,0,37,0
UK hostage Peter Moore released in Iraq,0,1,5,28,0,6,0,33,0
Australia flood: Six missing following record rainfall,0,3,2,45,1,6,0,47,0
The Oscars: What's in the Academy Awards goodie bags?,0,3,5,37,3,8,0,42,0
Obama: I could have won third term ,0,3,2,25,1,7,0,27,0
Hackers Tricking Japan's Mobile Gamers With Offers of Fake Fantasy Cash,0,3,10,50,1,10,0,60,0
Supreme Court returns case on transgender bathroom access to lower court ,0,3,2,60,0,11,0,62,0
Ikea significantly expanding paid parental leave,0,2,1,42,0,5,0,43,0
Fox Is Reportedly Using Trump’s ‘Grab ’Em By the P***y’ Tape in Sexual Harassment Seminars,0,3,13,56,7,14,0,69,0
"Sara Connor addresses letter to Bali High Court, pleads for sentence not to be increased on appeal",0,3,5,76,1,16,0,81,0
Same-Sex Ruling Belies the Staid Image of Iowa,0,1,7,31,1,7,0,38,0
Krauthammer: Syria Strike 'Total Contradiction to Bannonism'  Insider,0,2,7,51,3,8,0,58,0
"Kevin Wilson Named Ohio State Offensive Coordinator: Contract Details, Reaction",0,2,10,58,2,9,0,68,0
EU faces crisis as IMF warns Greek debts are on ‘explosive’ path ,0,3,6,45,2,12,0,51,0
"Matt Miller's Scouting Notebook: Top 5 Coming into Focus, New Big Board & More",0,3,11,49,4,13,1,60,0
Donald Trump Summons Tech Leaders to a Round-Table Meeting ,0,2,8,41,1,9,0,49,0
Warplane Reportedly Bombs Site Of Deadly Gas Attack Following U.S. Incursion In Syria,0,3,14,57,2,12,0,71,0
"British Tanks Roll on Channel Tunnel Test Run Amid Trump, Russia Fears",0,2,11,47,1,11,0,58,0
Angela Davis' Women's March speech: 'this country’s history cannot be deleted',0,3,4,58,6,10,0,62,0
Rory McIlroy on Playing With Trump Again: ‘I’d Think Twice About It’ ,0,3,12,41,4,12,0,53,0
"Tennessee wildfires have killed 7, mayor says ",0,2,1,36,1,7,1,37,0
British Airways Posts Worst Annual Results in Two Decades,0,1,8,41,0,8,0,49,0
"Prince William’s Dance Moves Haven’t Improved, But Who Cares? He’s a Future King",0,3,12,51,5,12,0,63,0
Two Alameda County Deputies Fired for Role in SF Beating,0,3,9,38,0,9,0,47,0
Jimmy Kimmel Wil Host This Year's Academy Awards Ceremony,0,3,9,39,1,8,0,48,0
"Who is Rex Tillerson, the ExxonMobil chairman who may become secretary of state?",0,3,5,61,2,12,0,66,0
German Economy Shrank in Last Quarter,0,1,5,27,0,5,0,32,0
"Pichilemu and Cobquecura, Chile rocked again by aftershocks",0,1,3,48,1,7,0,51,0
London bus bomb 'an hour late',0,1,1,22,2,5,0,23,0
"Shareef O'Neal, son of Shaquille O'Neal, commits to Arizona",0,3,7,40,4,8,0,47,0
Timeline: The rise and fall of Michael Flynn [Video],0,3,5,36,3,8,0,41,0
Ari Fleischer advises Sean Spicer to correct any wrong statistics he used,0,3,4,58,0,11,0,62,0
Delta Sees ‘Good Momentum’ Heading Into 2017 ,0,3,6,26,2,7,4,32,0
Canadian supermarkets to give leftover stock to food banks,0,3,1,49,0,8,0,50,0
House Republicans unveil Obamacare replacement plan ,0,3,3,43,0,6,0,46,0
Here's What Trump's FCC Might Look Like,0,3,9,22,2,6,0,31,0
Disney to leave smoking out of their films,0,1,1,34,0,7,0,35,0
Largest exoplanet so far is discovered,0,1,1,32,0,5,0,33,0
Will Ferrell and Amy Poehler start an underground casino in 'The House',0,3,6,52,2,11,0,58,0
Woman pulled alive from River Thames after Westminster Bridge attack,0,2,5,54,0,9,0,59,0
"21-Year-Old KashmirI Girl Who Pelted Stones At Police Wants To Play Football For India, Shows Not All Is Lost.",0,3,21,65,4,18,2,86,0
Juelz Santana Drops 'D's Up' Feat. Migos & Jim Jones: Listen,0,3,10,34,6,10,0,44,0
"Turkey recalls ambassador to Sweden over ""genocide"" vote",0,1,2,45,2,7,0,47,0
"‘There’s no happy hour for menstruation’: Tax liquor instead of tampons, lawmakers say",0,3,2,67,5,12,0,69,0
"In an Unusual Season, the Jazz Senses a Special Year",0,1,7,35,1,9,0,42,0
Longtime Hillary Clinton staffer mulls lieutenant governor run in Virginia,0,2,4,61,0,9,0,65,0
"Chance The Rapper Talks His Grammy Wins, His Daughter & Upcoming Album",0,3,11,46,2,11,0,57,0
Australian of the Year: General David Morrison's tumultuous 12 months,0,3,5,51,2,9,2,56,0
SpaceX Plan For Moon Flyby Faces Economic And Technical Challenges,0,2,11,46,0,9,0,57,0
Nauru and Manus Island refugees yet to be vetted under US-Australia deal,0,3,6,54,1,11,0,60,0
Deadly blaze in Paris possibly caused by arson,0,1,2,37,0,7,0,39,0
Cashmere Cat Releases 10-Song Track List for Debut Album '9',0,3,8,37,3,9,3,45,0
Four Animal Rights Activists Are Arrested,0,1,6,30,0,5,0,36,0
More fruit and veg for prisoners might just alleviate the crisis in our jails,0,3,1,63,0,13,0,64,0
Kim Jong-Un is big fan of Serie A football after exploits of Cagliari's North Korean striker Kwang-Song Han,0,3,11,76,3,17,0,87,0
Aaron Hernandez's Death Highlights A Serious Problem,0,3,7,38,1,6,0,45,0
Paul says he finished drafting bill to replace ObamaCare ,0,2,3,45,0,9,0,48,0
Suicide bomber detonates explosive-laden car killing at least 32 in Iraq,0,3,2,57,1,10,2,59,0
"Rhode Island offshore wind farm, first in the U.S., to power thousands of homes",0,3,4,58,4,13,0,62,0
D.C.’s Lamont Peterson beats David Avanesyan for WBA welterweight title,0,3,9,50,3,9,0,59,0
"Nine killed by car bomb in Iraq, 31 injured",0,1,2,30,1,8,2,32,0
Appellate Court Sides With Chicago Woman In Landmark Embryo Case,0,2,10,45,0,9,0,55,0
"Christopher Lee, ‘Star Wars’ and ‘Lord of the Rings’ Actor, Dies: Reports",0,3,9,46,7,11,0,55,0
Deviate: The Science of Seeing Differently by Beau Lotto review – why we need brain control,0,3,7,67,2,15,0,74,0
"ISIS claims responsibility for Berlin attack, says driver was ‘soldier of the Islamic State’",0,2,7,69,3,13,0,76,0
Directive Limits Activity in Roadless Areas of Forests,0,1,6,41,0,7,0,47,0
Helen Alfredsson Shoots 62 to Set Sybase Record,0,1,6,32,0,7,2,38,0
Research Again Finds That Talk Therapy Can Change The Brain,0,3,10,40,0,9,0,50,0
Cuomo’s $1.4 Billion Plan Targets Brooklyn in Fight Against Poor Health and Poverty ,0,2,10,56,3,13,2,66,0
"Google, Apple, Netflix, More Tech Companies Protest Trump's Immigration Order",0,2,10,54,4,9,0,64,0
Barack Obama wins Nobel Peace Prize,0,1,5,25,0,5,0,30,0
National Oceanic and Atmospheric Administration launches VORTEX2 to study tornadoes,0,1,10,63,0,9,1,73,0
Video game's secret sex scenes spark outrage,0,1,1,36,1,6,0,37,0
"10 years on Diana, Princess of Wales remembered",0,1,3,34,1,7,2,37,0
Hungarian President Signs University Law Sparking Protests,0,3,7,45,0,6,0,52,0
"Madonna Kisses Ariana Grande, Covers Britney Spears at Art Basel Miami Beach 2016",0,3,11,53,1,12,4,64,0
The Danger in China’s Dual Debt Cycle,0,3,6,24,1,6,0,30,0
An Augusta green jacket was found at a Canadian thrift store and it can be yours,0,3,3,62,0,15,0,65,0
Red Sox Upgrade Fenway Sleep Room to Give Players Better Naps,0,3,10,41,0,10,0,51,0
Emulator allows iPhone to run Windows XP,0,3,5,29,0,6,0,34,0
F.D.I.C. Increases Fees to Insure Bank Deposits,0,1,9,28,4,6,0,37,0
Trump Wrote Off $100 Million in Business Losses in 2005 ,0,3,6,32,1,10,7,38,0
Polish lawmakers occupy parliament in protest ,0,3,1,39,0,6,0,40,0
"UN/WHO making progress in treating HIV/AIDS, but will miss 2005 target",0,1,12,41,3,10,4,53,0
"Demonetisation Was Government's Idea Not Ours, RBI Tells Parliamentary Panel",0,3,12,53,2,9,0,65,0
Ric Flair Reportedly Kicked out of Indiana Bar for Insulting Employee,0,3,8,51,0,10,0,59,0
Channing Frye Edited His Own Wikipedia Page to Welcome 'All People to Frye Island',0,3,12,55,2,13,0,67,0
World Bank Cuts 2015 Global Growth Forecast to 2.8% ,0,3,6,29,2,9,6,35,0
Democrats Rev Up Health Care Offensive as Bill Clears Committees,0,2,9,46,0,9,0,55,0
Lindsey Vonn: ‘My scars remind me that I’m strong and beautiful’,0,3,4,46,4,10,0,50,0
Trump Gives Generals More Freedom on ISIS Fight ,0,3,10,30,0,8,0,40,0
"South Sudan plane crashes, all 49 passengers, crew survive ",0,3,2,44,2,9,2,46,0
Jennifer Lopez & Roberto Carlos Premiere New Single 'Chegaste': Listen,0,3,9,48,4,9,0,57,0
Kids Tell Jimmy Kimmel Their Own Adorable Versions Of The Easter Story,0,2,12,47,0,11,0,59,0
North American couple held by Afghan terrorists pleads for any kind of help ,0,3,3,60,0,13,0,63,0
Authorities arrest 7 state officials over Mexico childcare centre fire,0,1,2,58,0,9,1,60,0
Three Candidates Are Killed in Iraq,0,1,5,25,0,5,0,30,0
"At NIF, a  Quest for Fusion Energy (or Maybe Folly)",0,1,9,29,3,10,0,38,0
Teen wants to take grandma to prom -- his high school says no,0,3,1,46,2,12,0,47,0
US Senator Ted Stevens convicted on 7 counts,0,1,5,31,0,7,1,36,0
Kindle Joins a Bookstore Ritual: Authors Can Sign It,0,1,8,35,1,8,0,43,0
Lady Gaga And Metallica's Grammy Performance Had Tough Technical Difficulties,0,3,10,57,1,9,0,67,0
"WATCH: Obama Reflects on Term, Looks to Future in New Year's Message  Insider",0,2,14,47,3,13,0,61,0
New York And Florida Dominate 2016 List Of America's Most Expensive ZIP Codes,0,3,14,46,1,12,4,60,0
25 Cheat Sheets That Make Cooking Healthier Less Of A Freaking Chore,0,2,11,44,0,11,2,55,0
Keep Fidgeting! Movement Helps Improve Focus in Kids With ADHD,0,2,12,40,1,9,0,52,0
"Americans Need To Know Trump's Endgame For Syria, Duckworth Tells Constituents",0,3,11,55,2,10,0,66,0
Sara Evans Launches Born to Fly Records: No More 'Following the Rules of Anyone Else',0,3,12,56,3,14,0,68,0
The Teutonic cadence was chilling to the Trump opposers in the crowd. Then that chill deepened…,0,3,4,74,2,15,0,78,0
"Petrol pricing in Bathurst, NSW reduced for only seven days",0,1,5,44,1,9,0,49,0
Leicester fans sing 'Gibraltar is ours' in clashes with Spanish police ahead of Atletico Madrid quarter-final,0,3,5,86,3,15,0,91,0
"After Russian Ban, I.O.C. President Addresses Antidoping Efforts - The New York Times",0,2,14,54,5,12,0,68,0
Indonesian police who posed with slain alleged thieves to be counselled,0,3,1,60,0,10,0,61,0
"SRK Flirts With An Old Lady And Leaves Her Blushing, Proves His Magic Floors Everyone",0,3,17,53,1,14,0,70,0
Glenn Beck wants to heal the America he divided — one hug at a time,0,3,3,49,1,14,0,52,0
CA Taxpayers to Fund Convicted Murderer's Sex Change Operation  Insider,0,3,10,50,1,10,0,60,0
Kate McKinnon slays on 'SNL' with more Cristiano Ronaldo jokes,0,2,8,43,2,9,0,51,0
‘Cash Me Ousside’ Girl in Kodak Black’s New Video,0,2,8,30,3,8,0,38,0
"Steve Lacy Describes Working With Kendrick Lamar and Creating ""PRIDE""",0,3,13,45,2,9,0,58,0
Seth Meyers Hilariously Explains Holiday-Themed Teen Slang,0,3,8,43,1,6,0,51,0
"Building Coalitions, One Issue at a Time",0,1,5,28,1,6,0,33,0
Maryland County To Become ’Sanctuary City’ Ahead Of Trump Inauguration,0,2,10,49,2,9,0,59,0
Tourists are getting pulled over for staring at the Northern Lights,0,2,3,54,0,10,0,57,0
Asia investors boost use of unorthodox data sources in battle to beat benchmarks,0,2,1,67,0,12,0,68,0
'Life is winning': Pence fired up March for Life crowd ,0,3,4,38,3,10,0,42,0
"Wreckage of gas tanker removed after crash onto railway line in County Durham, England",0,1,4,68,1,13,0,72,0
Obama Faces Pressure to Strike Firmer Tone on Iran,0,1,7,35,0,8,0,42,0
Here's a Reminder That Christina Aguilera Has a Christmas Album (and It's Amazing),0,3,10,56,4,12,0,66,0
"80 years since Alcoholics Anonymous began, glimpse inside a 1965 meeting",0,3,2,53,1,10,6,55,0
Draymond Green’s suspension has brought the Warriors’ worst nightmare to life,0,2,3,62,2,10,0,65,0
"I get it, Ryan Lochte. I don’t want my mom to know what I’ve done, either",0,2,5,48,5,15,0,53,0
Trump's vineyard is hiring -- foreign workers,0,3,1,35,3,6,0,36,0
Mike Tyson set to retire after loss,0,1,2,27,0,6,0,29,0
"Asian American group slams “Ghost in the Shell,” Scarlett Johansson",0,3,6,49,3,9,0,55,0
Pakistan test fires nuclear-capable cruise missile,0,1,1,43,1,5,0,44,0
The Trump-Clinton Gender Gap Could Be The Largest In More Than 60 Years,0,2,13,43,1,12,2,56,0
Here's what Trump's budget proposes to cut,0,3,2,32,2,6,0,34,0
CeeLo Green Says He's 'Alive and Well' After Cell Phone Explosion Video Surfaces,0,2,13,52,3,12,0,65,0
Republican slams Democratic women for wearing white to Trump’s speech [Video],0,2,4,60,3,10,0,64,0
New York Assembly passes same-sex marriage bill,0,1,3,37,1,6,0,40,0
Welsh TV pioneer Owen Edwards dies at age 76,0,1,5,29,0,8,2,34,0
Lessons (or Not) When a Start-Up Misses the Mark,0,1,7,30,3,8,0,37,0
"Nor'easter pounds into region; more than 5,400 flights canceled ",0,2,1,47,3,9,4,48,0
Testimony: Robert Durst's Slain Friend Once Posed As His Missing Wife,0,2,11,46,2,10,0,57,0
Stock markets worldwide continue to fall,0,1,1,34,0,5,0,35,0
Double bombing in Pakistani city leaves at least 22 dead,0,1,2,43,0,9,2,45,0
Trump Tells Pena Nieto He Might Send Troops to Mexico: AP,0,3,11,35,1,10,0,46,0
Oil Prices Fall on Saudi Minister’s View of Output Deal    ,0,3,8,37,1,13,0,45,0
"In killing intentional walk, baseball loses a part of history, and gains nothing",0,3,1,65,2,12,0,66,0
Single Shot at Doctor’s Office May Be Future of HIV Prevention,0,3,11,40,1,10,0,51,0
U.N. Security Council Approves Syrian Cease-Fire Plan by Russia-Turkey,0,3,11,47,4,8,0,58,0
"Samsung foldable phone could become reality this year, finally",0,2,1,52,1,8,0,53,0
PM Narendra Modi Feels That Kashmir's Youth Have Two Paths - Tourism Or Terrorism,0,3,14,52,2,13,0,66,0
Tour de France: Linus Gerdemann wins stage 7,0,1,4,31,1,7,1,35,0
Kremlin Critic on Ballot in Olympic City,0,1,5,29,0,6,0,34,0
West Virginia Governor Is Urged to Add Financing for Mental Health Care,0,1,10,50,0,11,0,60,0
Witnesses Come Forward Following Facebook Livestream Gang Rape,0,2,8,47,0,7,0,55,0
Associated Press goes after bloggers for copyright violation,0,1,2,51,0,7,0,53,0
"State Dept. Officials Should Quit if They Disagree With Trump, White House Warns ",0,3,12,54,2,13,0,66,0
Hospitals in England told to put operations on hold to free up beds,0,3,2,53,0,12,0,55,0
L.A.-based lawyer sues FBI over Clinton email warrant ,0,2,6,37,3,8,0,43,0
'The Hunger Games: Mockingjay — Part 2' Trailer: Katniss Declares War [Video],0,3,10,48,7,11,1,58,0
Three Simple Rules for Eating Seafood ,0,2,5,27,0,6,0,32,0
Scott Pruitt Confirmed As EPA Chief Despite New Firestorm Over Emails,0,2,13,46,0,10,0,59,0
"Astronaut Gene Cernan Didn't Just Go to the Moon, He Took Us All With Him ",0,3,13,44,2,15,0,57,0
"2 dead in shooting at San Bernardino elementary school, police say ",0,2,2,52,1,11,1,54,0
Gibraltar police investigate suspicious death,0,1,1,40,0,4,0,41,0
"Trump's critics are pulling a Trump, using Twitter to troll back",0,3,3,49,2,10,0,52,0
"Los Angeles hospital lies, discriminates for Saudi liver transplant patient",0,1,3,62,1,9,0,65,0
Kardashian Family Friend Jonathan Cheban Says Kanye Is 'Doing Much Better',0,3,11,51,2,10,0,62,0
Rory McIlroy: Golfing with Trump Not an 'Endorsement' or 'Political Statement'  Insider,0,3,10,60,5,12,0,70,0
Aviation experts suggest Air France Flight 447 broke up in midair,0,1,4,48,0,10,3,52,0
Priyanka Chopra Drank Thandai With Jimmy Fallon This Holi And It's Aww-dorable,0,2,12,53,2,11,0,65,0
"Brian Fallon: Sean Spicer lied, should resign",0,3,4,33,2,6,0,37,0
Number of Americans Enrolling on Health-Care Website Jumps ,0,2,7,43,1,8,0,50,0
George H.W. Bush Resurfaces To Toss Out Super Bowl Coin Following Hospitalization,0,3,13,55,2,11,0,68,0
US B-2 bomber crash in Guam caused by moisture on sensors,0,1,4,41,1,10,1,45,0
Disturbing video captures United passenger being forcibly removed from overbooked flight,0,3,2,76,0,10,0,78,0
Former Prime Minister of Finland Harri Holkeri dies aged 74,0,1,6,42,0,9,2,48,0
"Accounts, People & Miscellany",0,1,3,21,2,3,0,24,0
"Love, Hate and supporting a great cause",0,3,2,30,1,6,0,32,0
"Young Thug And Lil Durk Target Cyber Trolls On ""Internet""",0,2,10,36,2,9,0,46,0
Draymond Green expresses displeasure with NBA CBA deal,0,3,8,39,0,7,0,47,0
EXID Score First Top 5 Entry on World Albums With 'Eclipse' EP,0,2,14,34,2,11,1,48,0
"A driver passed out from a suspected drug overdose. From the back seat, a child was trying to wake him.",0,2,2,79,3,19,0,81,0
This Puppy Striking A Pose In Front Of A Dog Statue Is Leaving People Shook,0,3,15,46,0,14,0,61,0
U.S. Navy Veteran Protests Kaepernick at Chargers Game: ’Respect or Leave’ - Breitbart,0,2,11,57,6,12,0,68,0
We finally have a tracklist and release date for Harry Styles' debut album,0,3,3,58,1,12,0,61,0
Computer giants attack Aussie CSIRO's WLAN patent,0,1,11,31,1,6,0,42,0
Signs of Hope Emerge in the West Bank,0,1,5,25,0,7,0,30,0
Rank the best MVP performances in past McDonald's All-American Games,0,2,9,48,2,9,0,57,0
G8 finance ministers agree on deal to relieve debts of 18 poorest nations,0,1,1,57,0,12,3,58,0
Russia court to consider Jehovah's Witnesses ban,0,3,3,38,1,6,0,41,0
"Raiders’ Exit Is a Loss for Oakland Workers, Touchdown for Taxpayers",0,3,8,48,2,10,0,56,0
Five in custody over alleged Christmas Day terror plot in Melbourne,0,3,4,53,0,10,0,57,0
"Tattoo with identifying details leads to prosecution of thief in Bristol, UK",0,1,4,60,1,11,0,64,0
Jackpot rises on 'Mega Millions' lottery in US; breaks record,0,1,5,44,3,9,0,49,0
"Conservatives on course for landslide victory, polls suggest",0,3,1,51,1,7,0,52,0
U.S. Wary of Its New Neighbor in Djibouti: A Chinese Naval Base - The New York Times,0,2,15,49,4,16,0,64,0
Merck’s Ebola Vaccine Found to Protect Against Deadly Virus,0,3,8,42,1,8,0,50,0
Ed Sheeran & Taylor Swift's Most Adorable BFF Moments on Instagram,0,3,11,43,2,10,0,54,0
Hollywood Now Cast as Sensible,0,1,4,22,0,4,0,26,0
"Indian Ocean tsunami, one year after",0,1,2,28,1,5,0,30,0
English Wikinews publishes 10000th article,0,1,2,31,0,4,5,33,0
Katy Perry Says 'Bon Appetit' by Handing Out Cherry Pies to Fans in Times Square,0,3,12,52,2,14,0,64,0
Billy Crystal: Feeling Lonely Behind the Facade,0,1,6,34,1,6,0,40,0
March Madness 2017 Predictions: Breaking Down Experts' Picks,0,2,7,40,2,7,4,47,0
'We have to forgive': Scars haunt Colombian rebels as they disarm,0,3,3,49,3,10,0,52,0
Trump Embraces Pillars of Obama’s Foreign Policy ,0,2,6,35,1,7,0,41,0
"Two people killed in fire in Greater Manchester, England",0,1,4,43,1,8,0,47,0
2 Uighurs in Troubled Region Killed by the Police,0,1,5,35,0,8,1,40,0
Google's case against Uber just took an unexpected turn,0,3,2,44,1,8,0,46,0
Adidas Is Revisting Its History to Make Its Next Great Sneaker,0,2,10,42,0,10,0,52,0
Joe Biden Marks End of His Term,0,3,6,19,0,6,0,25,0
Tory and SNP positions in Scotland suggest surge in tactical voting,0,3,5,52,0,10,0,57,0
"At First, Funny Videos. Now, a Reference Tool.",0,1,7,28,4,7,0,35,0
"After Setback on Sanctuary Cities Order, Trump Attacks ‘Messy’ Federal Courts System   ",0,3,11,59,3,14,0,70,0
Katrina conspiracy meteorologist quits Idaho TV News,0,1,5,41,0,6,0,46,0
Former Taiwanese president jailed for life on corruption charges,0,1,2,54,0,8,0,56,0
Somalia’s New Army Chief Survives Car Bomb That Kills 13,0,3,9,35,1,9,2,44,0
2017 Super Bowl Spread Pick: New England Patriots Vs Atlanta Falcons Odds And Advice From A Pro,0,3,16,58,1,16,4,74,0
Toshiba looking to sell Westinghouse nuclear business,0,3,2,45,0,6,0,47,0
Looking back at New Year’s Eve in Times Square,0,3,6,31,1,8,0,37,0
The 9 Best GIFs From Today’s Apple Event,0,3,9,22,1,7,1,31,0
Iraqi Girl Banned from Entering U.S. Dreams of Becoming an Astronaut,0,3,9,47,2,10,0,56,0
A $31.6 billion hedge fund is calling for a major overhaul of laws meant to prevent another financial crisis,0,2,1,84,2,18,3,85,0
The man forcibly removed from a United flight went to the hospital for his injuries,0,3,2,67,0,14,0,69,0
"Norway Is No. 1 in Happiness. The U.S., Sadly, Is No. 14. ",0,2,10,25,8,12,3,35,0
Civil rights leader Walter Fauntroy arrested at Dulles International Airport,0,2,6,61,0,9,0,67,0
What Killed Burlington College?,0,2,4,23,1,3,0,27,0
Eric Trump announces wife Lara is pregnant with baby boy ,0,3,3,44,0,10,0,47,0
NBA: Minnesota ready to trade Kevin Garnett to Boston,0,1,7,37,1,8,0,44,0
Shale's the Wild Horse OPEC Can't Tame,0,3,9,21,2,6,0,30,0
Official: Military aircraft crashes in Afghanistan,0,1,3,41,1,5,0,44,0
Homer and Marge aren't over on 'The Simpsons' because love conquers all,0,2,4,53,3,11,0,57,0
The People v. Robert Durst: Why prosecutors fear for witnesses' lives,0,3,5,51,3,10,0,56,0
Trump picks Iowa Gov. Terry Branstad as U.S. ambassador to China,0,2,8,43,3,10,0,51,0
"Tired Of Waitlists And Uncertainty, Some Chinese Favor U.S. Visa Over Green Card",0,2,14,51,3,12,0,65,0
Xbox 360 not a hit in Japan,0,1,2,16,0,6,3,18,0
Charities Now Seek Bankruptcy Protection,0,1,5,31,0,4,0,36,0
"Study links foie gras consumption with Alzheimer's, arthritis, diabetes, other diseases",0,1,2,71,4,10,0,73,0
Company sets tough test for job applicants: 'Convince us James Blunt isn't awful',0,3,4,61,4,12,0,65,0
Two Pilots Arrested in A Week for Allegedly Flying While Drunk,0,3,9,43,0,10,0,52,0
Theresa May calls attack on asylum seeker 'abominable' and backs Tory MP who described attackers as 'scum',0,3,5,81,4,16,0,86,0
Trump Presides Over His First White House Easter Egg Roll ,0,3,10,38,0,10,0,48,0
"Gunman opens fire inside store in California, USA",0,1,5,36,1,7,0,41,0
"Houston shooting: Nine injured, suspect dead",0,2,2,35,2,5,0,37,0
"Rams' Tavon Austin, Robert Quinn bring holiday joy to single mother of six",0,2,5,55,2,12,0,60,0
Microsoft Hires LinkedIn's Kevin Scott As CTO,0,2,10,28,1,6,0,38,0
Andrew Napolitano: 9th Circuit Ruling ’Intellectually Dishonest’ - Breitbart,0,2,7,56,4,8,1,63,0
Soulja Boy Reportedly Loses Thousands in Cash and Jewelry to a Burglar,0,3,8,51,0,11,0,59,0
Gbagbo appears at international court for alleged crimes against humanity,0,1,1,63,0,9,0,64,0
"Donald Trump Sticks To Claim Of Widespread Voter Fraud, Despite Having No Proof",0,2,13,53,1,12,0,66,0
Climate Change Could Escalate Risk Of Extreme Rainfall By As Much As 400 Percent,0,3,13,51,0,13,3,64,0
'Big Bang Theory' Leads Taking Pay Cuts So Female Co-Stars Can Get Raises,0,2,14,44,3,12,0,58,0
Hugh Jackman never turned his back on Wolverine,0,2,3,37,0,7,0,40,0
Bollywood stars Aishwarya Rai and Abhishek Bachchan engaged,0,1,5,47,0,7,0,52,0
Illinois Governor Urges Senator to Quit and Calls for a Law on Special Elections,0,1,9,58,0,13,0,67,0
How Canada can navigate the Trump transition,0,3,3,35,0,6,0,38,0
Criminal-justice reform in Congress has officially caved to a dangerous myth,0,2,2,63,1,10,0,65,0
New York Man Who Completed 744 Marathons Dies at Age 96 ,0,3,8,32,0,11,5,40,0
"Give workers 'breathing breaks' to boost happiness, says expert ",0,3,1,51,3,9,0,52,0
"There's no such thing as a Labour safe seat anymore, MP tipped to replace Jeremy Corbyn admits ",0,2,6,70,2,17,0,76,0
Donald Trump Blasts 'Totally Biased' 'SNL' On Twitter For 3rd Time,0,2,12,39,4,10,1,51,0
Iran's foreign minister mocks Donald Trump 'putting him on notice',0,3,3,51,3,9,0,54,0
Sessions’s recusal does little to quell partisan fervor over Russia,0,2,2,55,1,9,0,57,0
"U.S. Admits Airstrike in Syria, Meant to Hit ISIS, Killed Syrian Troops - The New York Times",0,2,18,53,5,16,0,71,0
New Military Command for Cyberspace,0,1,4,27,0,4,0,31,0
Donald Trump Strikes Nationalistic Tone in Inaugural Speech,0,3,7,45,0,7,0,52,0
Wieners Rush Red Carpet To Protest Australia's 'Sausage Fest' Film Awards,0,3,11,49,3,10,0,60,0
"Trump Signals 'America First,' Silicon Valley Second With Work Visa Reform",0,2,11,50,3,10,0,61,0
European Union Looks to Tighten Banking Supervision,0,1,6,39,0,6,0,45,0
"Cops: Youth soccer coach fathered child with former player, 15",0,3,2,47,2,9,2,49,0
"With civil war and a tsunami behind it, Sri Lanka’s east coast is opening up to tourism",0,3,3,66,2,16,0,69,0
Chinese protest against hotelier's Nanjing massacre denial,0,3,2,49,1,6,0,51,0
Economy Will Miss That New-Car Smell ,0,3,7,23,1,6,0,30,0
British schoolboy found guilty of racial harassment of schoolgirl,0,1,1,56,0,8,0,57,0
Financial abortion: Should men be able to 'opt out' of parenthood?,0,3,2,50,4,10,0,52,0
"Durst told friend he killed mutual friend, key witness testifies ",0,3,1,53,1,10,0,54,0
Zac Efron Riding Camels Shirtless In The Desert Is A Once-In-A-Lifetime Thirst Moment,0,3,16,54,3,12,0,70,0
Australia Wildfire Suspects Are Freed,0,1,5,28,0,4,0,33,0
"'Piano Man' speaks and is identified, returns home to Germany",0,1,3,46,3,9,0,49,0
Omarosa weds Pastor John Allen Newman at Trump's DC hotel - Yahoo,0,3,9,43,2,11,0,52,0
G.O.P. Forces Delay on Confirming Eric Holder as Attorney General,0,1,10,43,3,9,0,53,0
Brazilian Buzzsaw Rips Through United States in Confederations Cup,0,1,8,50,0,8,0,58,0
This Is What 100 Years Of Women’s Protest Looks Like In The US,0,3,13,33,1,12,3,46,0
Economic Confidence Continues to Fall,0,1,4,29,0,4,0,33,0
Federal Panel Backs Approval of New Drug to Fight Heart Attacks ,0,3,9,44,0,11,0,53,0
"Fear and loathing on the campaign trail, October 2008",0,1,2,38,1,8,4,40,0
European Commission to investigate anti-competitive allegations against Google,0,1,3,67,1,7,0,70,0
"Facebook hired PR firm to discredit Google, reveals leaked correspondence",0,1,4,59,1,9,0,63,0
18 Reasons Jess Mariano Is Still Rory’s Best Boyfriend,0,3,8,35,1,8,2,43,0
Senate Democrats Press Wells Fargo Board For Answers on Sales Practices ,0,3,10,51,0,11,0,61,0
Karzai retains lead in Afghan presidential elections,0,1,2,44,0,6,0,46,0
"English Football: Roundup for April 25, 2009",0,1,4,26,2,6,6,30,0
Watch This Man Turn A Mango Into A Flower In A Minute,0,3,12,30,0,11,0,42,0
"Aaron Hernandez Reportedly Wrote ""John 3:16"" on His Forehead Before Committing Suicide",0,2,10,59,3,11,3,69,0
Wikimedia Foundation and Answers.com announce partnership,0,1,3,48,1,5,0,51,0
Redding Falters Again,0,1,3,16,0,2,0,19,0
The Latest Setback for Prosecutors in the Freddie Gray Case,0,2,7,43,0,9,0,50,0
"Vesna Vulovic, stewardess who survived jet crash in 1972, dies in Belgrade",0,3,3,54,2,11,4,57,0
5 Newspapers in Northeast to Share Content,0,1,4,31,0,6,1,35,0
Senator Ted Kennedy dies at age 77,0,1,3,23,0,6,2,26,0
"Husband of murdered MP Jo Cox: 'I'll remember dead officer, not his killer'",0,3,6,52,5,12,0,58,0
Soldiers question U.S. Defense Secretary on issues during Kuwait visit,0,1,6,53,2,9,0,59,0
Watch Live: Loretta Lynch Addresses Hate Crime Reports,0,3,8,38,1,7,0,46,0
European oil companies stop trade with Iran,0,1,2,35,0,6,0,37,0
Maggie Gyllenhaal was told she wasn't 'sexy enough' to get movie roles,0,3,2,54,3,11,0,56,0
Security Budget Shows Soaring Olympic Costs,0,1,6,32,0,5,0,38,0
Suspect Is Held in Slaying of Chechen Exile,0,1,6,30,0,7,0,36,0
Snow causes German travel woes,0,1,2,24,0,4,0,26,0
J.J. Watt Impresses Arnold Schwarzenegger with Spot-on Governator Impression,0,3,9,56,3,8,0,65,0
The Myth of the Consensus Supreme Court Nominee,0,2,6,34,0,7,0,40,0
Giant Sinkhole Forces 22 Families Out of Homes Near Detroit,0,2,8,40,0,9,2,48,0
The Lead CNNVerifizierter Account,0,2,7,23,0,3,0,30,0
Nicole Kidman has sparked a crucial conversation about domestic violence,0,3,2,61,0,9,0,63,0
"NBA Announces 2K eLeague: Latest Details, Comments and Reaction",0,2,10,42,2,8,1,52,0
Disney rep says company plans to ’thoroughly review’ alligator signage after attack,0,2,1,69,2,11,0,70,0
Obama Condemns Iranian Crackdown,0,1,4,25,0,3,0,29,0
India and U.S.A. work toward nuclear fuel agreement,0,1,4,37,3,7,0,41,0
Is it OK for joggers to run in a cemetery?,0,2,3,29,1,9,0,32,0
Key HIV gene discovered,0,1,4,16,0,3,0,20,0
Why we should be concerned with the rise and rise of early planned births,0,3,1,59,0,13,0,60,0
Jens Stoltenberg reveals the next Norwegian cabinet,0,1,3,42,0,6,0,45,0
USA Gymnastics Blasted for Skipping Senate Hearing on Sex Abuse,0,2,10,44,0,9,0,54,0
Astronomers detect ultra-faint galaxy from the very early universe Featured Stories Additional stories,0,3,4,85,1,12,0,89,0
Evacuations ordered as rivers rise in California,0,3,2,40,0,6,0,42,0
Trade Deficit Narrows as Imports Decline Sharply,0,1,6,36,0,6,0,42,0
College Student Crowdfunds His Own Custom Cancer Treatment,0,2,8,43,0,7,0,51,0
Donald Trump Can Clear Up Questions About His Ties To Russia By Releasing His Tax Returns,0,2,16,58,0,15,0,74,0
"Zuckerberg Explains How He Built 'Jarvis', The Artificial Intelligence That Runs His Home",0,3,13,61,3,12,0,74,0
Assisted-suicide doctor Jack Kevorkian dies at age 83,0,1,3,40,1,7,2,43,0
Syrian Activists Say Dozens Dead in Idlib Chemical Attack,0,3,8,41,0,8,0,49,0
Rod Culleton's election invalid: High Court orders special recount of WA senate vote,0,2,6,64,2,12,0,70,0
"After harsh scolding, Spicer and press avoid fisticuffs. Is this a truce? ",0,3,3,56,3,12,0,59,0
Sarkozy and Merkel Try to Shape European Unity,0,1,6,33,0,7,0,39,0
Patience and time in the gym pay off for Kia Nurse in UConn's second-round win,0,3,5,57,2,14,0,62,0
Anniversaries for Tibet and Tiananmen Square Have China on Edge,0,1,7,47,0,9,0,54,0
A Dose Of Reality On The AT&T-Time Warner Merger,0,3,12,26,2,8,0,38,0
Cross Inflation Off the Long List of Worries,0,1,6,31,0,7,0,37,0
"Medtronic Drops Dr. Kuklo, Accused of Faking a Study",0,1,7,35,2,8,0,42,0
The governor’s race that could define the Democratic Party’s future,0,2,3,53,2,9,0,56,0
"Allen Iverson Answers Everything: 2017 MVP, Rest as BS...and Breaking Ankles",0,3,12,45,5,10,4,57,0
Hamas begins to use force to release Alan Johnston,0,1,3,39,0,8,0,42,0
Donald Trump Signs Huge Wall Street Giveaway,0,3,7,31,0,6,0,38,0
Bobby Portis Played 2 Months with 3rd-Degree Burn on Foot After Heat Pack Injury,0,3,11,53,1,13,2,64,0
Cheetah numbers decline as researchers warn of dangers of human encroachment,0,3,1,65,0,10,0,66,0
China’s HNA Group Offers to Buy Singapore’s CWT ,0,3,11,27,2,8,0,38,0
Drone operator worked for U.S. intelligence agency,0,2,3,39,2,6,0,42,0
Pakistan's military claims capture of Taliban stronghold,0,1,2,47,1,6,0,49,0
"Oscars 2017: Emma Stone, Ryan Gosling, Natalie Portman and more read mean Tweets for Jimmy Kimmel",0,3,10,65,3,15,4,75,0
Toy company Lego to produce Women of Nasa set,0,3,4,33,0,8,0,37,0
Afghan Women Protest New Law on Home Life,0,1,7,27,0,7,0,34,0
The U.S. Government’s Warning to Courts That Jail The Poor,0,2,10,36,3,9,0,46,0
'SNL' Imagines a Day in the Life of Donald Trump in Nightmarish John Cena Sketch,0,2,12,52,2,14,0,64,0
Blood test to predict likelihood of disease years in the future,0,3,1,52,0,10,0,53,0
An All-Female DC Villains Movie Starring Margot Robbie Is Actually Happening,0,3,13,52,1,10,0,65,0
Why Fake News Is An Antitrust Problem,0,3,7,24,0,6,0,31,0
Starbucks offers employees free legal advice on Trump's travel ban,0,3,2,54,1,9,0,56,0
"Dak Prescott Reportedly Will Start, Tony Romo to Play in Week 17 vs. Eagles",0,2,10,48,2,13,2,58,0
Major snow disruption in Britain; Wikinews reports from affected village,0,1,3,59,1,9,0,62,0
"Scottish higher education should be for all, not the gilded few",0,3,1,51,1,10,0,52,0
Farmers clash amidst high security at APEC summit in South Korea,0,1,7,47,0,10,0,54,0
Daisy Dick wins Barbury International Horse Trials,0,1,6,38,0,6,0,44,0
France's Fillon under pressure to end presidential bid,0,2,2,44,1,7,0,46,0
Hawaii Judge Blocks Trump's Revised Travel Ban,0,3,7,32,1,6,0,39,0
Facebook Live: 4-Star DT Elijah Conliffe Announces College Commitment,0,3,10,48,2,8,1,58,0
Obama Declared An Emergency In Flint One Year Ago. The Crisis Isn't Over.,0,3,13,45,3,12,0,58,0
"Blast On Bhopal-Ujjain Train, More On Sahayak System In Army And Other Must Reads Of The Day",0,3,18,56,2,16,0,74,0
Stock markets worldwide fall dramatically,0,1,1,36,0,4,0,37,0
Occupation in London enters fifth day,0,1,2,30,0,5,0,32,0
"Dwyane Wade: Latest News, Rumors, Speculation on Bulls SG's Future",0,3,10,43,4,9,0,53,0
There’s going to be a ‘Married at First Sight’ baby,0,2,4,35,3,9,0,39,0
Obama's Final Hawaiian Vacation as President ,0,2,5,33,1,6,0,38,0
Gymnastics Doctor Larry Nassar Loses License Over Sex-Abuse Claims,0,3,10,47,1,8,0,57,0
Google has more problems as YouTube ad boycott reaches another country,0,3,3,57,0,10,0,60,0
"The First Trailer For The New ""DuckTales"" Is Here And It’s GooOOood",0,3,15,38,3,11,0,53,0
Yankees Take on a Full Lineup of Charitable Work,0,1,6,34,0,8,0,40,0
"Trump Praises ‘Fox & Friends,’ Renews Old Feuds in Early Morning Tweet Series",0,3,11,50,4,12,0,61,0
Outgoing French President Hollande says 'ultimate duty' is to prevent Le Pen victory ,0,2,6,64,2,13,0,70,0
Calif. man carrying Mace arrested on White House grounds after scaling fence,0,2,4,60,1,11,0,64,0
Al-Qaeda says bin Laden death will 'not be wasted'; Pentagon releases videos of terrorist leader in compound,0,1,4,84,4,16,0,88,0
Mother's diet before conception 'can affect child's lifelong risk of disease',0,2,1,62,4,10,0,63,0
‘Prevenge’ Review: Prepartum Panic,0,3,4,24,3,3,0,28,0
Donald Trump Plays Background Role in Health-Care Battle   ,0,3,8,40,1,10,0,48,0
Marlins Slide Past Mets With Rally in Ninth,0,1,7,29,0,7,0,36,0
"Article 50 appeal: royal prerogative is crucial, attorney general tells court",0,3,1,62,2,10,2,63,0
Western Digital to raise Toshiba chip offer in last-ditch bid: source,0,2,3,54,2,10,0,57,0
"After Fire Destroys Texas Mosque, Donations Pour In to Help Rebuild - Yahoo",0,3,11,50,2,12,0,61,0
Trump praises Priebus in face of critical stories ,0,3,2,40,0,8,0,42,0
HHS Secretary Tom Price Says 'Nobody Will Be Worse Off Financially' Under Obamacare Repeal,0,2,16,59,2,13,0,75,0
Armstrong Remains in Third as Tour de France Leaves Pyrenees,0,1,7,44,0,9,0,51,0
Bob Seger Pens a Song to Honor Glenn Frey on the Anniversary of His Death ,0,3,10,49,0,15,0,59,0
Nick Cannon on Ex Mariah Carey's New Year's Eve Flub: 'She Got a Little Flustered',0,3,13,50,5,14,0,63,0
Trevor Noah Quizzes Congress: 'Why Are Americans Mad?',0,3,8,35,4,7,0,43,0
France protests treatment of government minister by US authorities; US government admits mistake,0,1,5,78,1,12,0,83,0
Trump's full remarks following US strikes on Syria,0,3,4,38,1,7,0,42,0
How Mary Tyler Moore & Her 'Groundbreaking' Show Inspired Joan Jett,0,3,10,44,3,10,0,54,0
War threats over Gibraltar are rightwing imperial fantasies,0,3,2,50,0,7,0,52,0
"As Bizarre As It May Sound, SRK Feels That None Of His Performances Deserve A National Award",0,2,19,56,1,16,0,75,0
US Election 2016 US election: Green Party's Jill Stein drops Pennsylvania presidential recount petition,0,3,10,74,2,13,4,84,0
More than 100 reported dead after Syrian troops move against protesters,0,1,2,56,0,10,3,58,0
Pakistani Court Lifts Ban on Sharif,0,1,5,25,0,5,0,30,0
"Police let market town brothel stay open for 10 years, councillors say",0,3,1,55,1,11,2,56,0
Wife Of 'American Pie' Singer Don Mclean Gets Protective Order,0,3,10,41,2,9,0,51,0
This Girl Captured The Exact Moment A Seagull Stole Her Ice Cream And It's Intense,0,2,15,52,1,14,0,67,0
Drake Slams Coachella Country Club for 'Racial Profiling',0,3,7,41,2,7,0,48,0
Mike Pence will go to the Super Bowl,0,2,4,25,0,7,0,29,0
19 Reasons Why Christopher Lee Was A Pretty Amazing Human Being,0,3,10,41,0,10,2,51,0
"Nav Releases New Track ""Some Way"" f/ The Weeknd",0,3,8,28,3,8,0,36,0
Donald Trump signs three executive memos,0,3,2,33,0,5,0,35,0
Retail sales fall for a second straight month as auto sales tumble,0,2,1,54,0,11,0,55,0
Suspect in Dallas Police Department attack confirmed dead after standoff,0,3,4,59,0,9,0,63,0
"28 pages: the controversy over Saudi Arabia and 9/11, explained",0,2,2,44,3,9,5,46,0
Why listing the Muslim Brotherhood as a terror group is a bad idea,0,3,3,51,0,12,0,54,0
Canada's Best Employers 2017,0,3,3,17,1,3,4,20,0
President Obama Knows Better Than To Complain About FLOTUS' Outfits,0,3,15,42,1,9,0,57,0
"In Canada, 2 Oil Giants Said Near Merger Deal",0,1,8,27,1,8,1,35,0
A Survivor’s Tale: How Hiroshima Shaped A Japanese-American Family,0,2,10,45,3,8,0,55,0
The truth about the ’dorms for adults’ that $16 billion WeWork is betting its future on,0,2,3,64,3,15,2,67,0
Hurricane Paloma hits Cuba,0,1,3,20,0,3,0,23,0
Report: Shooting In Paris Kills At Least One Police Officer On Champs Elysee,0,3,13,50,1,12,0,63,0
"Zanu-PF attempts to reassign Zimbabwean ministries, MDC angered",0,1,7,47,2,7,0,54,0
Ikea just debuted a bizarre new collection inspired by 'todayâs nomadic youth' â take a look,0,3,1,74,6,15,0,75,0
"Children struggling to concentrate at school due to lack of sleep, MPs told",0,3,3,59,1,12,0,62,0
How Many Health Workers Have Been Killed In Syria?,0,2,9,32,1,8,0,41,0
Are we really not there yet on women in tech sales?,0,3,1,39,1,10,0,40,0
Useless on-site broadcasts a bad idea that won’t go away,0,2,1,44,2,9,0,45,0
Japanese couple married for 37 years wear matching outfits every day ,0,3,1,55,0,11,2,56,0
Israeli Minister Says U.S. Warned Israel About Annexing West Bank,0,3,11,43,2,9,0,54,0
The Oral History of Michael Jordan's Minor League Baseball Career,0,3,9,46,1,9,0,55,0
Northern Irish police raid women's homes in crackdown on abortion pills,0,3,2,58,1,10,0,60,0
Republicans Seeking Immediate Cuts to Social Security? Not So Fast ,0,3,9,47,1,10,0,56,0
U.S. war protest mom met Bush in 2004,0,1,3,21,2,7,4,24,0
Iranian airline finalizes deal to purchase 60 Boeing planes,0,2,2,47,0,8,2,49,0
"Boom: Dow hits 20,000 for first time ever",0,3,2,25,2,7,5,27,0
Bangkok Band Jams Old Music Into New Groove,0,3,8,28,0,7,0,36,0
Court Debates Strip Search of Student,0,1,5,27,0,5,0,32,0
Disabled Army veteran fights off intruder at Georgia home ,0,3,3,46,0,9,0,49,0
China Population Crisis: New Two-Child Policy Fails To Yield Major Gains,0,2,12,48,2,10,0,60,0
Ranking MLB's Top 2017 Sleeper Teams,0,3,7,19,1,5,4,26,0
Governments 'concerned' by situation in Ossetia,0,1,2,38,2,5,0,40,0
"Truck ploughs into crowded Christmas market in Berlin, killing 12",0,3,3,50,1,9,2,53,0
Escaped Murderers Sweat and Matt Remain on Run for Third Day,0,3,8,42,0,10,0,50,0
Central banks worldwide cut interest rates,0,1,1,36,0,5,0,37,0
Syria chemical attack: Andrew Wilkie questions Assad's role in strike,0,2,4,54,2,9,0,58,0
"A city stilled, shocked and then enraged by attack",0,3,1,40,1,8,0,41,0
Microsoft and Yahoo team up to make IM clients compatible,0,1,4,44,0,9,0,48,0
One dead in Oakland residential building fire,0,3,2,37,0,6,0,39,0
Suspected Arms Dealer Challenges U.S. Tactics,0,1,7,31,2,5,0,38,0
Russian warship escorted by Royal Navy frigate through English Channel,0,3,5,56,0,9,0,61,0
Christopher Lee tributes led by Peter Jackson,0,3,4,35,0,6,0,39,0
The Christmas Story: Joy to the World,0,3,5,25,1,6,0,30,0
"Glastonbury line-up leak? Ed Sheeran, Diana Ross and Lorde among alleged performers",0,3,6,63,3,11,0,69,0
"Malcolm Turnbull calls Bill Shorten 'sycophant', 'parasite' during heated Question Time exchange",0,3,6,74,5,11,0,80,0
Kim Jong Un's wife Ri Sol-Ju spotted in public for the first time in nine months,0,3,6,57,2,15,0,63,0
President Trump Is Going To War With The Numbers He Doesn’t Like,0,3,12,40,1,11,0,52,0
Trump Hosts Senators in First Bipartisan Outreach Since Health-Bill Failure ,0,3,10,55,1,10,0,65,0
G.D.P. Revised Down Slightly for 4th Quarter,0,1,7,27,3,6,1,34,0
"'No Evidence' On Trump's Wiretap Claim, Says Top Democrat On Intelligence Committee",0,2,12,56,4,11,0,68,0
Some Ask if Bailout Is Unconstitutional,0,1,5,29,0,5,0,34,0
November Jobs Report Sets Table for Interest-Rate Rise | Fox Business,0,3,10,47,2,10,0,57,0
Russian military cargo jet crash kills eleven in Siberia,0,1,2,46,0,8,0,48,0
The Adorable Moment A Baby Koala Held His Mom During Her Surgery,0,3,12,41,0,11,0,53,0
99 Things All Yuccies Love,0,3,4,16,0,4,2,20,0
"Latin Connection Podcast: Maluma on U.S. Tour, 'Cuatro Babys' Controversy & More",0,2,11,51,7,11,0,62,0
Carrie Fisher hospitalized after suffering heart attack on plane,0,3,2,54,0,8,0,56,0
Rebekah Brooks resigns from News International,0,1,4,37,0,5,0,41,0
Turkey-Netherlands row: Dutch warn citizens after Erdogan threat,0,2,4,51,2,7,0,55,0
Sports community shows support for Isaiah Thomas following Game 1 loss to Bulls,0,3,5,61,0,12,1,66,0
Nigeria swears in new president after death of Umaru Yar'Adua,0,1,4,47,1,9,0,51,0
Big Order Lifts Outlook at Airbus,0,1,5,23,0,5,0,28,0
Neil Gorsuch's Supreme Court Nomination Clears Senate Committee In Partisan Vote,0,3,11,58,1,10,0,69,0
'Egg Sheeran' will be the perfect addition to your Easter baskets,0,3,3,50,2,10,0,53,0
Deepening Slump Seen in European Output,0,1,5,29,0,5,0,34,0
China Thinks It Has Figured Out Online Grocery Shopping,0,3,9,38,0,8,0,47,0
Vibrator Maker Shells Out Millions Over Claims It ‘Secretly’ Tracked User Data,0,3,12,53,2,11,0,65,0
"Run the Jewels Announce 'Stay Gold' IPA, Keep Reppin' Bernie Sanders on 'Daily Show'",0,3,14,51,6,13,0,65,0
Pissed Jeans Have No Idea How a Gym Works in 'The Bar is Low' Video: Watch,0,2,13,43,3,15,0,56,0
South African parliament questioned over media policy,0,1,2,45,0,6,0,47,0
"How Lionel Messi showed he is the most complete player ever: the guts, the glory, the goals",0,3,3,69,3,16,0,72,0
Thunder Fans Show Up Well Prepared for Kevin Durant's Return to Oklahoma City,0,3,11,53,1,12,0,64,0
Marine dad surprised with magical tea party photo shoot with 4-year-old daughter - Yahoo,0,3,2,69,3,13,1,71,0
Carriers Sweeten the Deal for Prepaid Cellphones,0,1,5,37,0,6,0,42,0
Apple fixed an annoying iPhone battery bug and didn't tell people for weeks,0,3,2,60,1,12,0,62,0
Britain’s Labour Party in turmoil over Brexit vote results,0,2,4,45,1,8,0,49,0
Climate change impacts Wyoming,0,1,2,25,0,3,0,27,0
Drinking on Antidepressants ,0,3,2,23,0,3,0,25,0
22 Year Old Mira Rajput Spoke About Being A Proud Homemaker But Her Views Might Offend People!,0,3,16,59,1,16,2,75,0
A Burmese Icon Tends a Flickering Flame,0,1,6,27,0,6,0,33,0
Man getting lost Purple Heart 66 years after brother's death ,0,2,3,45,1,10,2,48,0
Jaguar spotting: A new wild cat may be roaming the United States,0,3,4,48,1,11,0,52,0
North Korea Is Said to Detain Another U.S. Citizen ,0,3,9,31,2,9,0,40,0
Homeland Security Suspends Implementation of President Trump’s Travel Ban,0,2,8,56,1,8,0,64,0
Unilever Bid Follows Familiar Playbook for Warren Buffett and 3G ,0,3,8,46,0,10,1,54,0
Entire U.S. Senate to go to White House for North Korea briefing,0,3,8,43,2,11,0,51,0
Boosie Badazz Show Canceled Following Shooting That Left 2 Victims Hospitalized,0,3,10,58,0,10,1,68,0
This Texas Gun Owner Has Been An NRA Member For 46 Years. Now He's Speaking Out.,0,3,17,43,3,15,2,60,0
"U.S. CEOs Become More Optimistic on Outlook for Sales, Jobs",0,2,11,36,3,9,0,47,0
China Detains 81 Ahead of 50th Anniversary of Tibetan Uprising,0,1,6,43,0,9,4,49,0
A college professor wrote a biting explanation for why so many professors are Democrats,0,2,2,72,0,13,0,74,0
"‘We shouldn’t have to keep saying sorry’: After the London attack, Muslims react with fear and anger",0,3,4,75,5,16,0,79,0
Obama Defends Clinton When Asked About Her Emails,0,2,8,34,0,7,0,42,0
Philippine Drug Enforcement Agency says army will only play a 'support' role in drug war,0,3,4,68,2,14,0,72,0
Joaquin “El Chapo” Guzman arrives in U.S. after extradition,0,2,6,41,4,8,0,47,0
McKinney pool party incident was about race,0,2,2,35,0,6,0,37,0
California offers rebates for alternative fuel vehicles,0,1,1,48,0,6,0,49,0
"Kim Clijsters, a Former No. 1, Is Expected to Return to Tennis",0,1,8,39,3,11,1,47,0
Former eBay Executive Tries a New Bid. This One Is Political.,0,1,10,39,2,10,0,49,0
FAA Chief Seeks to Serve Out Full Term With Trump Support   ,0,3,12,35,0,13,0,47,0
House Expected to Follow Senate’s Lead on Rush to Repeal Health Law ,0,3,9,46,1,12,0,55,0
China and Russia sign trade deals worth US$3.5 billion,0,1,4,38,2,8,2,42,0
Ford offers US$78 million for Romanian auto plant,0,1,4,35,1,7,2,39,0
"Google, Sun Microsystems to collaborate on software development",0,1,3,52,1,7,0,55,0
Australia's cherry season predicted to be expensive after unseasonably cold weather,0,3,1,71,1,10,0,72,0
The life of Martin Luther King Jr: Telegraph time tunnel,0,2,6,40,1,9,0,46,0
Ring In the Holidays With Live Performances From 'Drag Race' Royalty: Watch,0,3,11,50,3,11,0,61,0
"The 'Trainspotting' cast recreate iconic film poster, 20 years on",0,3,2,49,3,9,2,51,0
Lonzo Ball and His Brothers Aren't Worth a Billion Dollars to a Sneaker Brand (Yet),0,3,11,55,3,14,0,66,0
Wall St: US shares tread water amid rising geopolitical tensions,0,3,4,50,1,9,0,54,0
This guy built his own iPhone by buying parts in China,0,3,3,41,0,10,0,44,0
China Fires 8 Top Regulators Over Milk Scandal,0,1,7,31,0,7,1,38,0
Israel seizes West Bank land,0,1,3,21,0,4,0,24,0
Houston mayor urges evacuations as Hurricane Rita moves closer to shore,0,1,3,58,0,10,0,61,0
Texas teacher allegedly paid student to keep relationship quiet ,0,3,1,54,0,9,0,55,0
Here Are the Best Plays From the 2017 NBA All-Star Game,0,2,11,29,1,10,4,40,0
Florida State Senator Resigns After Using Racial Slur in Tirade ,0,3,9,45,0,10,0,54,0
"Sundance 2017 will have mobile theaters, complete with snacks",0,3,1,47,1,8,4,48,0
Ukip's Paul Nuttall fails to turn up for hustings in Stoke amid Hillsborough controversy,0,3,5,69,1,13,0,74,0
World’s best husband: Man is seen carrying a pile of shopping bags so high you can only see his feet ,0,3,2,77,2,20,0,79,0
Nine dead as plane crashes into cars in Mexico,0,1,2,36,0,8,0,38,0
"Nike, Under Armour, Adidas not interested in deal with Lonzo Ball",0,2,6,47,2,10,0,53,0
"After Demonetisation, Banks Are Reporting A 10-Fold Increase In ‘Suspect Transactions’",0,3,11,59,4,10,2,70,0
Rupert Murdoch’s Sky takeover gets EU approval,0,3,5,34,1,6,0,39,0
The Best Podcasts for Self-Improvement,0,3,5,28,1,4,0,33,0
Donald Trump rally violence: Fights break out at California event to support President,0,3,5,68,1,12,0,73,0
Court unanimously ousts South Korea's leader for corruption ,0,3,3,48,1,8,0,51,0
"With the rightwing papers leading the election charge, May need only follow",0,3,2,61,1,11,0,63,0
3 bodies found at Italian hotel buried by avalanche as search continues for dozens feared dead ,0,2,1,77,0,16,1,78,0
How ‘Wonder Woman’ director Patty Jenkins cracked the superhero-movie glass ceiling,0,2,5,65,3,10,0,70,0
8 space phenomena and missions to look forward to in 2017,0,3,0,42,0,10,5,42,0
CPAC Cheers Repeal of Trans Protections As Trans Conservatives Protest,0,2,12,49,0,9,0,61,0
‘Churchill was full of flaws and lived with his mistakes’ – Brian Cox’s latest film challenge,0,3,3,71,4,15,0,74,0
World War One veteran becomes world's oldest man,0,1,3,37,1,7,0,40,0
"Heavy Rain and Floods in Sri Lanka: Over 50,000 Families Affected",0,1,8,40,2,10,5,48,0
"In Singapore, a More Progressive Islamic Education",0,1,6,37,1,6,0,43,0
Hoda Kotb explains meaning of daughter’s name,0,3,2,36,1,6,0,38,0
Queen Elizabeth II attends church after missing services two weeks in a row,0,2,4,59,0,12,0,63,0
REPORT: Hudson's Bay is in talks to buy Neiman Marcus,0,3,10,32,2,9,0,42,0
"Gladys Powers, last female veteran of World War I dies age 109",0,1,5,42,1,11,3,47,0
U.N. Health Aid Plan Unites Air Travelers and Bill Clinton,0,1,10,37,2,9,0,47,0
"Ahead of his trial, a man accused of triple murder jumps to his death from a courthouse balcony",0,3,1,76,1,17,0,77,0
"Asian and Hispanic Minorities Growing, but More Slowly",0,1,6,40,1,7,0,46,0
Two arrests made in Zotob worm attack,0,1,2,29,0,6,0,31,0
Trump's Immigration Crackdown Triggers Anxiety Across U.S. Farms,0,3,9,45,3,7,0,54,0
7 ways to boost your happiness,0,2,0,24,0,5,1,24,0
"Egypt unearths 8 mummies in 3,500-year-old tombs",0,2,1,33,3,6,5,34,0
"Two pilots killed in head-on collision at Radom Air Show, Poland",0,1,5,47,2,10,0,52,0
Two Airbus A320 Planes Carrying Hundreds Of Passengers Escape Midair Crash Over Varanasi,0,2,13,60,0,12,3,73,0
Judge Neil Gorsuch: What You Need to Know About the SCOTUS Nominee ,0,3,15,39,1,12,0,54,0
Glastonbury headliners announced,0,1,1,29,0,2,0,30,0
EXCLUSIVE: India's Legion Hackers Admit They Have Nothing To Do With Anonymous.,0,3,20,45,3,11,0,65,0
"Texas police chief arrested following chase, standoff",0,2,1,45,1,6,0,46,0
"Where did this Gonzaga team come from? Well, everywhere",0,2,3,42,2,8,0,45,0
France's Hard Left Faces off Against Center Left in Primary ,0,3,8,41,1,10,0,49,0
Disposable Friendships in a Mobile World,0,2,4,31,0,5,0,35,0
U.S. senators denounce Trump plan to focus counter-extremism program on Islam,0,2,4,60,3,10,0,64,0
Australian ex-PM Kevin Rudd berates Israeli PM Benjamin Netanyahu,0,2,10,46,1,8,0,56,0
The Idiot's Guide To Electronic Music And Its Sub Genres,0,2,10,36,1,9,0,46,0
Shinzo Abe to become first Japanese prime minister to visit Pearl Harbor in 65 years,0,2,5,63,0,14,2,68,0
Robert Boyle wins Honorary Oscar for his art direction career,0,1,4,48,0,9,0,52,0
Sports World Celebrates National Puppy Day on Social Media,0,3,8,42,0,8,0,50,0
Dutch election exit polls show Prime Minister's VVD Party on track to win most seats,0,3,7,62,1,14,0,69,0
30 Awesome All-Female Duets for International Women's Day,0,3,7,39,2,7,2,46,0
Univision’s Ramos: The ‘Trump Effect’ Is Scaring Illegal Immigrants Away from Entering the US,0,3,13,63,4,13,0,76,0
Australians need bigger toilets,0,1,1,27,0,3,0,28,0
How “Auntie Maxine” Became A Meme — And The Hero Of The Anti-Trump Internet,0,3,14,44,4,13,0,58,0
"In Silicon Valley, Recruiting Clashes With Immigration Limits",0,1,8,45,1,7,0,53,0
Japan's January exports fall by 46% from last year,0,1,2,36,2,8,2,38,0
Officials Consistently Inconsistent in the N.B.A.,0,1,6,35,3,5,0,41,0
The studio behind 'Ghost in the Shell' admits the 'whitewashing' controversy hurt its box office,0,3,3,75,4,14,0,78,0
Fed Hikes Key Interest Rate for 2nd Time in a Decade ,0,3,7,34,0,11,1,41,0
Stream Drake's 'More Life' Playlist,0,3,5,23,3,4,0,28,0
Can A Bath Of Milk And Honey Replace Female Genital Mutilation?,0,2,11,41,1,10,0,52,0
Iraqi journalist throws shoes at US president George Bush,0,1,5,44,0,8,0,49,0
Ex-Leader of Liberia Cites C.I.A. in Jailbreak,0,1,8,28,4,6,0,36,0
United Airlines Is No Angel,0,2,5,18,0,4,0,23,0
Donald Trump invites press to off-the-record session at Mar-A-Lago,0,3,5,49,4,8,0,54,0
"YES Pulls the Plug, Temporarily, on a Yankees Star",0,1,8,32,2,8,0,40,0
Queen Elizabeth misses second holiday church service this season,0,3,2,54,0,8,0,56,0
Bad Hospital Design Is Making Us Sicker ,0,2,7,26,0,7,0,33,0
Pakistan Seizes Terror Suspect,0,1,4,23,0,3,0,27,0
"PepsiCo Wants to Sell Healthy Food, Consumers Want Chips",0,3,9,38,1,8,0,47,0
Helen Thomas probes White House on torture; online community sends flowers,0,1,4,59,1,10,0,63,0
14 things we learned from Ewan McGregor's glorious Reddit AMA,0,3,7,42,1,9,2,49,0
"Four arrested in three Naperville, Illinois prostitution stings",0,1,3,52,1,7,0,55,0
"United Arab Emirates Aid Debt-Ridden Member, Dubai",0,1,8,34,2,6,0,42,0
Pilgrims journey to Jerusalem for Good Friday,0,1,4,35,0,6,0,39,0
Man gets $75 after being wrongly imprisoned for 31 years,0,2,1,41,1,9,4,42,0
How to Survive the Longest Flight in the World,0,3,5,33,0,8,0,38,0
"Patients' medical payments can vary up to 400pc among specialists, report finds",0,3,1,62,2,11,3,63,0
"Michelle Obama tells Oprah Winfrey the election ""was painful""",0,3,4,47,2,8,0,51,0
Concert Promoter Alleges Fraud in Planning for Prince Tribute ,0,3,7,46,0,9,0,53,0
Trump: I'm 'Absolutely' Considering Breaking Up 'Outrageous' 9th Circuit  Insider,0,2,9,55,6,10,1,64,0
Mesut Özil doesn't track back but he wins possession more than you'd think,0,3,2,58,2,12,0,60,0
Intel's offices across the EU raided,0,1,3,27,1,5,0,30,0
Trump Under Pressure to Get Answers From Iran on Missing Ex-F.B.I. Agent ,0,3,13,44,4,12,0,57,0
"Spooked Of Ghosts, Brazilian President Vacates Presidential Palace With Family",0,3,10,58,1,9,0,68,0
San Francisco Asks: Where Have All the Children Gone? ,0,3,8,35,2,9,0,43,0
"Finally, some good airline news: The FCC won't let people talk on cellphones during flights",0,3,5,69,3,14,0,74,0
Osborne Editorship Spurs Review of U.K. Lawmakers in Second Jobs,0,3,9,44,2,9,0,53,0
"Cavendish, a Top Sprinter, Lets a Chance to Win a Giro Stage Slip Away",0,1,10,45,2,13,0,55,0
"Hail the rise of cat men, an antidote to toxic masculinity",0,3,1,46,1,10,0,47,0
"Kellyanne Conway says you need ""bile in your throat"" to run for office",0,3,2,54,2,12,0,56,0
Nestlé set to cut 300 UK jobs and move production of Blue Riband bars to Poland,0,2,6,55,0,15,3,61,0
The Office of Government Ethics had trouble connecting with Trump's transition team,0,3,5,66,1,11,0,71,0
CanadaVOTES: Animal Alliance (AAEVPC) party leader Liz White running in Toronto Centre,0,1,18,54,3,11,0,72,0
SpaceX to send two people around the moon who paid for a 2018 private mission,0,2,2,57,0,14,4,59,0
Twin explosions kill at least 40 near religious sites in Syria's capital ,0,2,2,56,1,12,2,58,0
Meek Mill Laughs Off Rumours Linking Him To Nicki Minaj’s Recent Robbery,0,2,12,48,1,11,0,60,0
Some States in a Pinch May Raise Gasoline Tax,0,1,7,30,0,8,0,37,0
How should I upgrade from Windows Vista before it becomes unsupported?,0,3,4,55,1,10,0,59,0
Madison Bumgarner says dirt bike ride 'not the most responsible decision',0,2,2,59,2,10,0,61,0
"Bob Dylan’s Forgotten Pro-Israel Song, Revisited",0,2,7,33,3,5,0,40,0
"A year after cancer diagnosis, Texans OL David Quessenberry eyes return to field",0,3,6,61,1,12,0,67,0
Thailand forces registration of prepaid phones to thwart insurgency,0,1,1,58,0,8,0,59,0
Shooting to Software Stardom on the iPhone,0,1,4,32,0,6,0,36,0
Seattle's Headset Offers Big Data Analytics To The Cannabis Industry - 'Just Like Walmart',0,3,13,60,4,13,0,73,0
Chicago Aviation Security Chief Is Fired Weeks After United Episode ,0,2,10,48,0,10,0,58,0
"Tech hipster augmented reality monocles are coming, this prank proves it",0,2,1,60,1,10,0,61,0
Tracy McGrady Named to 2017 Basketball Hall of Fame Class,0,3,8,36,0,9,4,44,0
Lindsay Lohan surrenders to police,0,1,2,28,0,4,0,30,0
How the Indy 500 recovered from civil war to celebrate its 100th running,0,2,2,52,0,12,6,54,0
Prince Harry meets Lady Gaga at Royal Albert Hall,0,3,7,34,0,8,0,41,0
CNN host Jake Tapper has fantastic response to getting called a ’dick’ by Clinton campaign chair,0,2,6,73,2,15,0,79,0
London is Europe's cocaine capital – but only during the week,0,2,2,47,2,10,0,49,0
New Internet site PleaseRobMe claims to reveal location of social networkers,0,1,5,61,0,10,0,66,0
Climate Hope City: how Minecraft can tell the story of climate change,0,3,4,53,1,11,0,57,0
Ric Flair Reportedly Kicked out of Indiana Bar for Insulting Employee,0,2,8,51,0,10,0,59,0
UN summit results in pledge to mitigate food crisis,0,1,2,41,0,8,0,43,0
"Shooting in German hospital, four killed",0,1,2,32,1,5,0,34,0
Jubilant Sanders Supporters Jeer Clinton’s ‘Victory’ Speech after Iowa Tie,0,2,9,53,3,9,0,62,0
"Canny and confrontational, Miley Cyrus is this generation’s Madonna",0,3,4,53,2,8,0,57,0
"India's Kanika Tekriwal, 28, Is Revving Up The Private Jet And Helicopter Market",0,3,12,51,3,12,2,63,0
Donald Trump's Cabinet Picks So Far,0,3,6,23,1,5,0,29,0
Hong Kong by-elections start,0,1,2,22,1,3,0,24,0
"457 visa crackdown coming for fast-food workers, Peter Dutton says",0,3,2,50,2,9,3,52,0
Why Women Should Remember To Smile,0,2,6,23,0,5,0,29,0
Saudis Retool to Root Out Terrorist Risk,0,1,6,28,0,6,0,34,0
Palmer Luckey: Trump-supporting Oculus founder leaves Facebook,0,3,5,49,2,6,0,54,0
Fatal stabbings kill three at Belgian day care center,0,1,2,43,0,8,0,45,0
"Number of cholera cases in Zimbabwe reaches 80,000",0,1,2,35,1,7,5,37,0
"Venezuela's Economy Has Become So Poor That They Are Going To Print 20,000-Bolivar Notes",0,3,14,53,3,13,5,67,0
"Melania Trump, America’s First Lady in Absentia?",0,3,6,33,3,6,0,39,0
"Meet LiLou, San Francisco airport's first therapy pig for stressed fliers ",0,3,5,56,2,11,0,61,0
George Will: ’I Think We May Have Passed Peak Trump’ - Breitbart,0,2,11,38,4,11,0,49,0
Seven injured in Chapel Hill celebrations after North Carolina wins NCAA tournament,0,2,9,63,0,11,0,72,0
Stay Woke: The White House Website Is Suddenly Not Available in Spanish,0,3,11,48,1,11,0,59,0
"Bomb scare closes Times Square, New York",0,1,5,28,1,6,0,33,0
Report: Takata could pay up to $1 billion to settle criminal investigation with US over exploding airbags,0,3,4,82,2,16,1,86,0
"Art Linkletter, creator of ""Kids Say the Darndest Things"", dies peacefully at 97",0,1,6,56,4,12,2,62,0
Black hole and distant sun locked in slow-motion dance of death,0,3,1,51,1,10,0,52,0
Snoop Dogg And Bill Gates Are Crashing Reddit’s Secret Santa Exchange,0,3,11,47,1,10,0,58,0
Charles Manson reportedly moved from hospital back to prison ,0,3,2,50,0,9,0,52,0
Richmond Park offers a first glimpse at a changed political landscape,0,3,2,57,0,10,0,59,0
US airstrike kills high-profile terrorist leader ,0,2,2,40,1,6,0,42,0
Google begins massive effort to make books available online,0,1,1,50,0,8,0,51,0
When Words Are Worth a Thousand Pictures at Ballpark and on TV,0,1,9,42,0,11,0,51,0
"Chevron Sells Canadian Refinery, Gas Stations in $1.1 Billion Deal",0,2,8,44,3,9,2,52,0
7th-grader's science project finds cancer-fighting chemicals in green tea,0,2,0,61,3,8,1,61,0
Trump's senseless Syria strikes accomplish nothing,0,3,2,42,1,5,0,44,0
Anti-Donald Trump protester ‘tries to set himself on fire’ outside Trump International Hotel in Washington DC,0,2,9,82,3,15,0,91,0
Plumber creates giant moving Star Wars AT-ACT in his garden for friend's son,0,3,8,54,2,12,0,62,0
Tech Startups Are Seeing Their Share of Venture Investing Pie Shrink,0,3,10,48,0,10,0,58,0
John McCain denies romantic relationship with lobbyist,0,1,3,45,0,6,0,48,0
Lonzo Ball Is Life: UCLA's Superstar Freshman Is Ready to Win It All,0,3,15,39,2,12,0,54,0
Thousands of children and teenagers with anorexia forced to wait months for help,0,3,1,67,0,12,0,68,0
Investigators Probed Jeff Sessions’ Contacts With Russian Officials  ,0,3,8,51,1,9,0,59,0
Wreckage of plane thought to be missing Air France flight found in Atlantic,0,1,4,59,0,12,0,63,0
Ex-President of Argentina Trails in Bid for Congress,0,1,6,38,1,7,0,44,0
"State should provide sex workers for people with disabilities, says German MP",0,3,4,61,1,11,0,65,0
Former Bush attorney general says he believes there was surveillance on Trump Tower,0,3,4,67,0,12,0,71,0
A Human Language Gene Changes the Sound of Mouse Squeaks,0,1,8,39,0,9,0,47,0
Mariano Rivera Jr to Nationals: Twitter Reacts as RHP Selected in 2015 MLB Draft,0,2,14,48,1,13,4,62,0
White House Defends Executive Order Barring Travelers From Certain Muslim Countries,0,3,11,62,0,10,0,73,0
"Ford CEO on meeting with Trump, economy and border tax",0,3,5,39,1,9,0,44,0
"Wikinews interviews Christopher Beyette, prince of the Principality of Vikesland",0,1,5,65,1,9,0,70,0
Police investigate Uber rider's claim that L.A. driver sexually assaulted her,0,2,4,60,3,10,0,64,0
Euro 2016: Republic of Ireland 1-1 Scotland,0,3,4,25,2,6,6,29,0
"Julian Assange to Be Questioned by Sweden Over Rape Claim, Ecuador Says - The New York Times",0,2,14,60,2,16,0,74,0
US Senate to vote on troop pullout from Iraq today,0,1,4,37,0,9,0,41,0
Spicer: 'Hitler didn't even sink to chemical weapons',0,3,2,40,4,7,0,42,0
Spectacular snow moon regales world,0,2,1,30,0,4,0,31,0
French journalist held hostage in Iraq freed,0,1,2,36,0,6,0,38,0
Hedge Fund Manager Accused of Fraud,0,1,5,25,0,5,0,30,0
"Russian Hackers Gained ‘Limited’ Access to R.N.C., Comey Says ",0,2,10,37,6,9,0,47,0
Mike Pence's New Neighborhood Gets Plastered With 'Trust Women' Signs,0,3,10,47,3,9,0,57,0
"'Deadpool 2' Brings In Thanos Himself, Josh Brolin, As Cable",0,2,9,37,4,9,1,46,0
Romanian government approves new minorities law,0,1,1,41,0,5,0,42,0
Trump set to take center stage at CPAC as theme appears to be now or never ,0,3,5,54,0,16,0,59,0
Eurozone now officially in recession,0,1,1,31,0,4,0,32,0
Volkswagen deal on diesel cars gives buyback option for some ,0,3,1,50,0,10,0,51,0
Some Experts Say Trump Team’s Falsehoods Are Classic ‘Gaslighting’,0,2,9,46,3,8,0,55,0
Chris Brown's Ex Claims He Threatened To Kill Her,0,2,9,31,1,8,0,40,0
Fake Shark Brings New Single 'Heart 2 Heart' to Life in Colorful Video: Premiere,0,3,11,52,3,13,1,63,0
White House video showcases family residence,0,3,2,37,0,5,0,39,0
"Fatal drug overdoses more than doubled since 1999, CDC finds ",0,2,4,42,1,10,4,46,0
US Senate confirms Supreme Court nominee Elena Kagan,0,1,7,38,0,7,0,45,0
Beyonce sings 'Love Drought' and 'Sandcastles' at Grammy Awards 2017,0,3,6,45,4,9,4,51,0
Ann Coulter finds an unlikely ally in her free-speech spat with Berkeley: Bill Maher,0,3,5,64,2,13,0,69,0
Nokia unleashes patent legal battle on Apple,0,2,2,36,0,6,0,38,0
Vladimir Putin dismisses head of Russian Navy Admiral Vladimir Kuroyedov,0,1,7,56,0,9,0,63,0
"N. Korean Leader Dying of Cancer, Report Says",0,1,7,29,2,7,0,36,0
The Cleveland Cavaliers are Muting Drake’s Golden State Warriors References,0,3,9,56,1,9,0,65,0
Clean Slates for Youths Sentenced Fraudulently,0,1,5,36,0,5,0,41,0
Seven arrested in UK cruise ship drugs seizure,0,1,3,36,0,7,0,39,0
"The limits of outrage: Liberal journalists coming to grips with Trump's win, Hillary's loss ",0,3,4,70,4,14,0,74,0
Jackson Said to Have Had Pulse When Found,0,1,7,27,0,7,0,34,0
Jake Gyllenhaal: ‘I would love to not talk about my personal life’,0,2,3,49,3,11,0,52,0
"Corporations, Tending to a Tattered Image, Clip Wings of Private Jets",0,1,8,49,2,10,0,57,0
"Union Membership Up Sharply in 2008, Report Says",0,1,6,30,1,7,4,36,0
The $65 European Airfare Is Coming to the U.S.,0,3,7,26,3,8,2,33,0
Gannett Reports a 60% Fall in  Quarterly Profit,0,1,5,31,1,8,2,36,0
Americans are quitting jobs at the fastest pace in 16 years,0,3,1,46,0,10,2,47,0
"Recap: U.S., Sweden Play to a Goalless Draw - The Daily Fix",0,3,10,33,5,11,0,43,0
Onboard Device Could Offer Clue to Montana Crash,0,1,7,34,0,7,0,41,0
"Cadillac unveils Obama's 'Beast', the 2009 Presidential State Car",0,1,6,43,4,8,4,49,0
"Seven die in bombing in Falluja, Iraq",0,1,3,27,1,6,0,30,0
Donald Trump supporters descend on Washington DC ahead of inauguration,0,3,5,56,0,9,0,61,0
No more forced removals - United Airlines,0,3,3,31,1,6,0,34,0
Behind the Profits Lies Trouble for 2 Bank Giants,0,1,6,34,0,8,1,40,0
"Our royal palace is haunted by friendly GHOSTS, claims the Queen of Sweden ",0,3,9,52,1,13,0,61,0
Finding Shelter From Trump's Tweet Storm,0,2,6,28,1,5,0,34,0
North Korea Says It Will Halt Talks and Restart Its Nuclear Program,0,1,11,45,0,11,0,56,0
California police use fire hose on man before fatal shooting ,0,2,1,50,0,10,0,51,0
That time Trump surprised a White House tour group in front of a portrait of Hillary Clinton,0,3,6,70,0,16,0,76,0
Tottenham Hotspur v Southampton: Premier League – live updates!,0,3,5,47,3,8,0,52,0
"In Afghanistan, Soldiers Bridge 2 Stages of War",0,1,6,32,1,7,1,38,0
FBI Investigating Identities of Violent UC Berkeley Rioters,0,3,10,42,0,7,0,52,0
U.S. to Extend Its Job Benefits to Gay Partners,0,1,8,29,2,8,0,37,0
French Vogue Makes History With First Transgender Cover Model,0,3,9,44,0,8,0,53,0
Vladimir Putin’s Childhood Besties Defend Their 'Petty' Pal In 'SNL' Spoof,0,3,13,46,5,10,0,59,0
Perth man dies during Christmas swim while two rescued from rip,0,3,2,51,0,10,0,53,0
France Opens Germanwings Crash Criminal Inquiry ,0,2,6,36,0,6,0,42,0
Dave Clarke Will Not Play in the U.S. While Donald Trump Is President,0,3,12,43,2,12,0,55,0
Wilmer Valderrama’s Worst New Year’s Eve Wasn’t So Bad After All [Video],0,3,12,44,5,11,0,56,0
Vikings likely to pass on Bridgewater's fifth-year option,0,3,2,46,2,7,0,48,0
Demonstrations planned to protest internet censorship in Finland,0,1,2,55,0,7,0,57,0
Free diver Kimi Werner on finding peace underwater,0,2,3,40,0,7,0,43,0
Uber reportedly used secret program to track Lyft drivers ,0,3,2,47,0,9,0,49,0
North Carolina Wins Fourth Straight Game at Duke,0,1,7,34,0,7,0,41,0
Financial Journalists Fumble to Cover a Lasting Slump,0,1,6,40,0,7,0,46,0
"Planets Jupiter, Mercury and Mars line up, visible to naked eye",0,1,4,47,2,10,0,51,0
WHO says Zimbabwean cholera epidemic 'past its peak',0,1,4,39,2,7,0,43,0
IS group to step up attacks on Europe - Europol,0,3,4,33,1,9,0,37,0
Trump accuses Obama administration of wiretapping Trump Tower phones ,0,3,4,56,0,9,0,60,0
"Clinging to Hairspray, Trump Casts Cloud of Fear Over Climate Scientists ",0,2,9,52,1,11,0,61,0
Here's what you need to know about Marine Le Pen â the far-right leader who could be the next president of France,0,3,5,85,4,21,0,90,0
Video Shows Moments Surrounding Ambush of Houston-area Deputy,0,2,7,46,1,7,0,53,0
"English ""Lady in the Lake"" killer found dead in prison cell",0,1,3,44,2,10,0,47,0
Israel Completes Gaza Withdrawal,0,1,4,25,0,3,0,29,0
"'Lethal Weapon,' 'Goonies' actress Mary Ellen Trainor dead",0,2,6,40,5,7,0,46,0
How Fashion People Celebrate The Lunar New Year,0,2,8,32,0,7,0,40,0
"UK will not block closer EU defence ties, says Boris Johnson",0,2,6,43,1,10,0,49,0
"Prada, ""Illusionist"" among screen adaptations up for USC Scripter",0,1,6,48,3,8,0,54,0
"Albanian police sue opposition leader, say he urged violence ",0,3,1,50,1,9,0,51,0
"Cinnabon ""truly sorry"" for Carrie Fisher tweet after backlash",0,2,3,48,2,8,0,51,0
Chief Justice John Roberts Lauds Federal District Judges In Year-End Report,0,2,12,52,1,10,0,64,0
"Medical School Says Ex-Army Surgeon, Hid Medtronic Ties",0,1,9,37,2,7,0,46,0
Federal Regulators Close 3 Small Banks,0,1,5,27,0,5,1,32,0
Grandfather Shot While Playing Pokemon Go,0,3,6,30,0,5,0,36,0
London Terrorist Attack: Why Most U.K. Police Don’t Carry Guns,0,3,11,38,4,9,0,49,0
Trump: US doesn’t ’have to be bound’ by ’one China’ policy,0,2,4,38,6,10,0,42,0
China's Defense-Spending Confusion Highlights Strategic Worries,0,3,7,49,2,5,0,56,0
Arctic Sea Ice Is Freakishly Low Right Now,0,2,8,27,0,7,0,35,0
Breast cancer charity condemns 'disastrous' recommendation to block pioneering treatment,0,3,1,76,2,9,0,77,0
Truck Bomb Kills Dozens in Northern Iraq,0,1,6,28,0,6,0,34,0
South African Prosecutors May Drop Fraud Charges Against A.N.C. Leader Jacob Zuma,0,1,14,53,3,11,0,67,0
Stephen Colbert: Is Donald Trump Violating Laws Or Just Norms?,0,2,10,41,2,9,0,51,0
"Sorry Arian Foster, but you probably couldn't take down a wolf (we checked)",0,3,3,56,4,12,0,59,0
"In Buffalo, Owens and Evans Are as Different as Fire and Ice",0,1,8,40,1,11,0,48,0
Hurley wins Quicken Loans National the way only an officer and a gentleman can,0,2,4,61,0,13,0,65,0
Met investigates claims that officers punched detained suspect,0,3,1,54,0,7,0,55,0
"A Man With Everything, Including a Lot to Flee",0,1,7,30,1,8,0,37,0
Jeremy Corbyn says a second Scottish independence referendum would be 'absolutely fine',0,2,3,71,2,11,0,74,0
"Premier League’s Festive Slog: Adored by Fans, Endured by Players ",0,3,8,45,3,10,0,53,0
This is why PETA’s latest campaign may backfire,0,2,5,34,1,7,0,39,0
"Visiting the African-American Museum: Waiting, Reading, Thinking, Connecting, Feeling ",0,3,9,62,6,9,0,71,0
Justice Department will again use private prisons,0,3,2,41,0,6,0,43,0
NASCAR: Trevor Bayne wins the 2011 Daytona 500,0,1,9,22,1,7,7,31,0
Trump launches manufacturing initiative with business leaders,0,3,1,54,0,6,0,55,0
Stronger Recovery for Emerging-Market Funds,0,1,5,33,1,4,0,38,0
2 Somali-Americans Charged With Aiding Terror,0,1,6,32,1,5,1,38,0
Here's Why 2017 Could Be The Best Year In Wall Street History,0,3,11,34,1,11,4,45,0
"Aid pledges rise; Japan promises 500,000,000 USD",0,1,5,25,3,6,9,30,0
Britain set to be hotter than Saudi Arabia on warmest February 20th for 160 years,0,2,4,58,0,14,5,62,0
Jewish men attacked with hacksaw by men ‘shouting anti-Semitic abuse’ in Paris,0,2,3,61,3,11,0,64,0
"Majority of parents with children at home don't lock up prescribed opioids, study finds ",0,3,1,71,2,14,0,72,0
A Move to Lift Confidence in Money Market Funds,0,1,7,32,0,8,0,39,0
Us the Duo Re-Enters Social 50 Chart After Newest Year-End Song,0,3,11,38,2,10,2,49,0
A handful of nuts a day could slash risk of heart disease and cancer ,0,3,1,54,0,14,0,55,0
Some Marines being investigated for sharing nude photos ,0,3,2,46,0,8,0,48,0
911 Dispatcher Helps Save Woman Locked in Trunk of Moving Car in North Carolina ,0,3,10,53,0,14,3,63,0
"More than 30 dead in attack on Afghan military hospital, officials say",0,3,2,54,1,11,2,56,0
How Kate Spade And Everpurse Got Wearable Tech Right,0,2,9,35,0,8,0,44,0
"Madoffs Worth $823 Million, Court Filing Says",0,1,6,28,2,6,3,34,0
Disappointing Retail Sales Sends Shares Down,0,1,6,33,0,5,0,39,0
Why losing my Olympic dream was the best thing that ever happened to me,0,2,2,56,0,13,0,58,0
South China Sea dispute sees sea cucumber fishermen 'forced into Australian waters',0,3,4,66,2,11,0,70,0
Basque separatist group ETA declares ceasefire,0,1,4,37,0,5,0,41,0
Wisconsin Scores Overtime Upset Over Florida State,0,1,7,37,0,6,0,44,0
Contraceptive Sponge Makes a Return to Pharmacy Shelves,0,1,6,42,0,7,0,48,0
Does penalizing airlines for customer service infractions do any good?,0,2,1,59,1,9,0,60,0
How Jimmy Stewart Became George Bailey,0,2,6,27,0,5,0,33,0
Tennis Australia to set up help line for alleged victims of abuse,0,2,2,52,0,11,0,54,0
No Clear Accord on Stimulus by Top Industrial Nations,0,1,7,38,0,8,0,45,0
Check Out The-Dream's New EP 'Love You To Death',0,3,11,25,4,8,0,36,0
Puerto Rico's election for governer contested,0,1,2,37,1,5,0,39,0
WikiLeaks to give tech companies early access to next hacking docs: Assange ,0,2,3,60,1,12,0,63,0
2017 Stella Prize: What will be named Australia's best book by a female author?,0,2,4,55,3,13,4,59,0
"Perriello’s Va. governor bid kept afloat by few big donors, including George Soros",0,3,4,63,3,12,0,67,0
Bride's dance performance at her wedding is breaking the internet,0,2,1,54,1,9,0,55,0
Leapfrog Device Aimed at Littlest Readers,0,1,5,31,0,5,0,36,0
Watch: Jerusalem and Bethlehem celebrate Easter Sunday,0,2,5,42,1,6,0,47,0
Eva Green to play Virginia Woolf in film about lesbian love affair which inspired Orlando,0,3,5,70,0,14,0,75,0
Maxine Waters: Trump Is Trying to Start War - ’He Doesn’t Deserve To Be President’ - Breitbart,0,2,14,58,6,16,0,72,0
Mother and daughter die after getting stuck in a sauna,0,3,1,44,0,9,0,45,0
Suspect Arrested After 2 Officers Shot During Traffic Stop in Georgia ,0,3,9,49,0,11,1,58,0
Mom Blames 911 Response For Daughter's Death,0,3,6,28,1,6,3,34,0
"Fans Pay Tribute To Sir Christopher Lee, Who Has Died Aged 93",0,2,11,36,1,11,2,47,0
Golf Injury? Know the Rules of Thump,0,1,5,24,1,6,0,29,0
Unilever rejects Kraft Heinz mega-merger,0,3,3,32,1,4,0,35,0
Gatwick passengers face major disruption on rail link to airport,0,3,1,54,0,9,0,55,0
Athene Raises $1.08 Billion in 3rd-Biggest U.S. IPO of 2016,0,3,9,28,5,9,8,37,0
Justice Department Seeks New Financial Fraud Powers,0,1,7,38,0,6,0,45,0
How Adam Carolla Went From Manual Laborer To Media Mogul,0,3,10,37,0,9,0,47,0
"70 years after Dead Sea Scrolls were found, new discoveries await",0,3,3,49,1,10,2,52,0
Opportunities  Wasted as Mets Let  Sweep Slip Away,0,1,7,34,0,9,0,41,0
Ash from Iceland volcano could affect UK flights,0,1,4,37,0,7,0,41,0
Phoenix spacecraft launches towards Mars,0,1,2,34,0,4,0,36,0
'Daybreak' launches on ITV in UK,0,1,6,19,2,5,0,25,0
3 Red Cross Workers Abducted in Philippines,0,1,5,31,0,6,1,36,0
Navy Secretary Nominee Drew Notice Over Divorce,0,1,7,34,0,6,0,41,0
"As Financing Declines, the Future of Clean-Tech Start-Ups Is Uncertain",0,1,10,48,3,9,0,58,0
Assisted-living worker accused of filming residents having sex,0,3,1,53,1,7,0,54,0
"After the Stint Abroad, the Adjustments Begin",0,1,5,33,1,6,0,38,0
Anti-Putin protesters plan next move as jailed opponent considers election bid,0,3,2,65,1,10,0,67,0
Gwyneth Paltrow and Goop: how her vilified lifestyle brand - which is now a magazine - has defied its critics,0,3,3,84,3,19,0,87,0
"Special counsel is investigating Trump for possible obstruction of justice, officials say",0,2,2,75,1,11,0,77,0
Kate McKinnon slays on 'SNL' with more Cristiano Ronaldo jokes,0,3,8,43,2,9,0,51,0
Tense Dallas BLM Protest Yields No Violence,0,2,9,28,0,6,0,37,0
Samuel L Jackson hit out at black British actors in Hollywood. Was he right?,0,3,6,55,2,13,0,61,0
Fifth Harmony Just Made Camila’s Exit Official With A New Group Photo,0,3,12,45,1,11,0,57,0
Lars Ulrich on Metallica's Grammys Sound Issues: 'You Just Gotta Keep Playing',0,3,11,52,4,11,0,63,0
Beyoncé's pregnancy announcement breaks record,0,3,1,40,1,4,0,41,0
Major League Soccer: Beckham will miss game against Toronto,0,1,5,45,1,8,0,50,0
Game Changer? Electric Vehicle Chevy Bolt Named Car of the Year,0,3,9,43,1,10,0,52,0
Manchester United Faces Tough Test in Portugal,0,1,6,34,0,6,0,40,0
Ed Sheeran Holds Atop Hot 100 as Kendrick Lamar Debuts at No. 2,0,3,9,37,1,12,4,46,0
Financial stress: We're worrying ourselves sick over money Featured Stories Additional stories,0,3,5,76,2,11,0,81,0
Former Defense Chief Leon Panetta Heckled at DNC: No More War! Lies! - Breitbart,0,2,14,49,4,13,0,63,0
What’s the future of Roe v. Wade in a Trump administration? [Video],0,3,5,46,5,11,0,51,0
Security threats directed at US Democrats,0,1,4,32,0,5,0,36,0
Trump 'Historic' Defense Increase Is Barely Above What Obama Planned -- And Faces Similar Obstacles,0,3,14,67,4,14,0,81,0
U.S. Home-Price Growth Continued Accelerating in February,0,3,8,40,3,6,0,48,0
Donald Trump has spent almost a third of his time in office at Mar-a-Lago resort in Florida,0,3,5,68,2,16,0,73,0
Italy's Gentiloni Vows to Meet Trump NATO Spending Demand Slowly,0,2,12,42,1,9,0,54,0
Tom Hardy's Valentine's Day Bedtime Stories teaser sends hearts racing,0,3,6,53,2,9,0,59,0
"‘No one eats alone’: Muslim-owned restaurant offers free Christmas meal for homeless, elderly",0,2,3,73,5,12,0,76,0
‘Gay Panic’ Defense Abolished in Australian State,0,3,6,35,2,6,0,41,0
"If you find the sound of people chewing annoying, scientists just worked out why",0,2,1,65,1,13,0,66,0
BlackBerry Is Back With KEYone: Android Phone With Innovative Keyboard,0,2,13,47,1,9,0,60,0
Police hunt two men after seven shot at Christmas party ,0,3,2,44,0,10,0,46,0
Madonna Defends 'Blowing Up the White House' Comment: 'I Am Not a Violent Person' ,0,3,12,51,5,14,0,63,0
Queensland election candidates on Gold Coast back daylight saving,0,1,3,54,0,8,0,57,0
Romanian PM and Siemens discuss Electroputere privatisation,0,1,5,48,0,6,0,53,0
Mattis confirmed as defense secretary by Senate,0,2,2,39,0,6,0,41,0
Winter freeze claiming lives across Europe,0,3,2,35,0,5,0,37,0
Political ‘Pig’-skin: Lawmakers scuffle over controversial Capitol Hill painting ,0,3,5,63,4,9,0,68,0
"Centrelink debt-recovery 'compounding' Tasmanian financial pain, TasCOSS says",0,3,7,59,4,7,0,66,0
Obama Would Move Some Detainees to U.S.,0,1,7,24,2,6,0,31,0
Fehr Says Union Called to Have 2003 Drug Tests Destroyed,0,1,8,35,0,9,4,43,0
"NHS trust pays temporary boss £47,000 a month",0,3,3,28,2,7,5,31,0
Colts fire GM Ryan Grigson; Chuck Pagano to remain coach,0,3,7,39,1,9,0,46,0
Long Island-sized iceberg to ram Antarctic coast,0,1,3,38,1,6,0,41,0
"Hungarian camerawoman sentenced for kicking, tripping refugees",0,3,1,54,1,6,0,55,0
Amy Sherman-Palladino And Daniel Palladino Are Standing By The Final Four Words In “Gilmore Girls”,0,3,16,65,3,14,0,81,0
About Those Trump Conflict-of-Interest Worries...,0,2,6,34,5,4,0,40,0
The Complex Staff Lists Their Favourite Songs And Albums Of 2016,0,3,10,40,0,10,4,50,0
Fast-food ad targets voice-activated phones but tech 'blocked' before TV debut,0,3,3,61,4,10,0,64,0
Matt Drudge Suggests Government May Be Lying About Hurricane Matthew,0,2,10,49,0,9,0,59,0
Transgender sister of inauguration singer Jackie Evancho wins injunction in bathroom lawsuit,0,2,3,78,0,11,0,81,0
Oscars 2017: Live coverage,0,2,2,16,1,3,4,18,0
MiLB Player Gets Mustache-Style Haircut After Losing College World Series Bet,0,3,14,52,1,10,0,66,0
Watch 'The Voice' Coaches Cover TLC's 'Waterfalls',0,3,9,30,5,6,0,39,0
Gorsuch: Trump And I Talked About Abortion Being ’Divisive’ In Campaign,0,2,11,47,3,10,0,58,0
The Fake Reviews and Counterfeits That Amazon Is Trying to Quash,0,3,9,45,0,10,0,54,0
Britain's biggest buy-to-let landlord bans 'coloured people' because of 'the curry smell' ,0,2,1,70,7,12,0,71,0
Could Browns Find Savior in Own Backyard with Mitch Trubisky?,0,3,8,43,1,9,0,51,0
"Predators D P.K. Subban Sheds Tears, Gets Standing Ovation in Return to Montreal",0,3,12,53,3,12,0,65,0
"Blast kills 12 people, including senior Sri Lankan minister",0,1,3,45,1,8,2,48,0
The End of Banking as We Know It,0,1,6,19,0,7,0,25,0
Somali pirates launch attack on oil tanker,0,1,1,35,0,6,0,36,0
Alec Baldwin Says That Angry 2007 Voicemail Hurt Daughter In A 'Permanent' Way,0,2,12,48,2,12,4,60,0
"Top Gear review roundup: How did Matt LeBlanc, Rory Reid and Chris Harris do?",0,2,10,51,3,13,0,61,0
Why Severe Turbulence On Flights Could Be Much Worse In The Future,0,3,12,43,0,11,0,55,0
November Jobs Report Sets Table for Interest-Rate Rise | Fox Business,0,2,10,47,2,10,0,57,0
Beyoncé's pregnancy announcement breaks record,0,2,1,40,1,4,0,41,0
Delaware Corrections Officer 'Saved Lives' Before Dying in Hostage Situation: Union ,0,3,10,60,3,11,0,70,0
Migos on 'Culture' Hitting No. 1: 'We Speaking for the Young Generation of Music',0,3,9,52,6,13,1,61,0
US and UK diplomats detained in Zimbabwe,0,1,5,29,0,6,0,34,0
"Some fitness trackers may fall short in measuring heart rate accurately, study finds ",0,3,1,70,1,13,0,71,0
"Adrian Peterson Rumors: RB to Explore Options, Reportedly in 'No Rush' to Sign",0,3,11,51,4,12,0,62,0
Keurig and AB InBev team up on in-home booze maker,0,2,5,35,1,9,0,40,0
This Is Getting Brutal,0,2,4,15,0,3,0,19,0
Hawaii LGBTQ Couples Seek Equal Access to Fertility Treatment,0,2,12,41,0,8,0,53,0
This animated map shows every single earthquake in the past 15 years,0,3,1,54,0,11,2,55,0
Climate change: China calls US 'selfish' after Trump seeks to bring back coal,0,2,5,57,3,12,0,62,0
Pakistan: Woman sentenced to death for burning daughter alive,0,3,2,50,1,8,0,52,0
Billboard 200 Chart Moves: 3 Doors Down & Toby Keith Return After Trump Inauguration Concert,0,2,12,60,2,14,4,72,0
A Lot Of People Are Pissed That Amy Adams Didn’t Get Nominated For An Oscar,0,3,15,45,1,14,0,60,0
Parody Movie Trailer Presents 2016 as a Horror Film  Insider,0,2,7,39,0,10,4,46,0
18 illegal Afghan and Burmese immigrants killed in truck crash in Turkey,0,1,3,56,0,11,2,59,0
"Apple launches new music streaming service, takes aim at Pandora and Spotify ",0,3,3,61,1,12,0,64,0
Former governor of Illinois indicted on corruption charges,0,1,2,49,0,7,0,51,0
Browns' Hue Jackson wants WR Terrelle Pryor to cool the trash talk,0,2,7,47,1,11,0,54,0
Mark Cuban goes on extended tweetstorm about 'The Trump Conundrum',0,3,5,50,2,9,0,55,0
"Australian Labor Party leader urges supporters to ""take a cold shower"" over poll results",0,1,3,70,2,13,0,73,0
"Trump Seems to Retreat on Shutdown, But Secret Spending Bill Still Looms",0,3,10,50,1,11,0,60,0
Republicans explore curbing the Endangered Species Act,0,2,4,44,0,6,0,48,0
"74 bodies wash up on Libyan coast, Red Crescent says",0,2,3,37,1,9,2,40,0
Michael Moorcock: My family values,0,2,3,26,1,4,0,29,0
MEPs seek to exempt citizens with joint EU citizenship from US travel ban,0,3,7,54,0,12,0,61,0
La Liga: Barcelona v Leganés – live!,0,3,4,23,3,6,0,27,0
Kathmandu cravings: Top Nepal foods you can't miss,0,3,3,38,2,7,0,41,0
DJ Paul Oakenfold hosts Everest party,0,3,5,27,0,5,0,32,0
Miami Heat's Dwyane Wade Completes 4-Day Executive Course at Harvard,0,2,9,47,2,9,1,56,0
Kidnapped Romanian journalists return home,0,1,2,36,0,4,0,38,0
Seal in Japan falls in love with stuffed animal lookalike - Yahoo,0,3,3,50,1,11,0,53,0
Perseverance Is Paying Off for a Test of Relativity in Space,0,1,7,43,0,10,0,50,0
"Tamil Nadu Asks Modi To Revoke The Ban On Jallikattu, The Blood-Soaked Bull-Taming Sport",0,2,16,56,3,13,0,72,0
U.S. Hedge Fund Elliott Backs Deal to Buy AC Milan Soccer Club ,0,3,13,36,2,12,0,49,0
More people than ever before are single — and that’s a good thing,0,3,1,50,2,12,0,51,0
José Mourinho denies he is unhappy to be living in Manchester,0,3,3,48,0,10,0,51,0
"Trump's America Donald Trump knew for weeks that Michael Flynn was misleading over Russia, White House says",0,3,9,80,2,16,0,89,0
Report: Annan failed to fix Oil for Food program,0,1,4,35,1,8,0,39,0
British Airways cabin crew vote to strike in latest UK industrial action amid Southern Rail walkout,0,3,6,78,0,15,0,84,0
The Fastest Ride in Virtual Reality,0,3,5,25,0,5,0,30,0
Apple Will Open Its New 'Spaceship' Campus In April,0,3,9,32,2,8,0,41,0
Elon Musk Confirms Tesla Cars Are Coming To India This Year!,0,3,11,38,1,10,0,49,0
Manhunt on for gay bar attacker in Massachusetts,0,1,2,39,0,7,0,41,0
Plumber creates giant moving Star Wars AT-ACT in his garden for friend's son,0,2,8,54,2,12,0,62,0
"Australian rules football: Gippsland Football League heavyweights clash, Maffra go two games clear",0,1,5,79,2,12,0,84,0
UK police still think Westminster attacker acted alone ,0,3,3,44,0,8,0,47,0
Lewis Hamilton wins 2009 Singapore Grand Prix,0,1,5,30,0,6,4,35,0
Hawaii judge puts Trump's revised travel ban on hold ,0,3,2,41,1,9,0,43,0
Kris Jenner on Caitlyn Jenner's transition: 'Why would you not explain all this to me?',0,2,5,63,5,14,0,68,0
Russia hacking claims: Trump says no effect on election,0,3,2,44,1,8,0,46,0
"Everyone Is Super Confused About Trump’s ""Last Night In Sweden"" Comments",0,2,11,48,3,10,0,59,0
Boeheim as Fund-Raiser Outdoes Boeheim as Coach,0,1,6,34,1,6,0,40,0
Mont. police say they aware of planned white supremacist march,0,2,1,51,1,9,0,52,0
Hogwarts gets a magically realistic rendering in body paint timelapse,0,2,1,59,0,9,0,60,0
Michelle Obama's Natural Hair Is Our Favorite Thing on the Internet [Video],0,3,10,51,3,11,0,61,0
Hayden: Why Russia is more worried about war than US,0,2,5,37,1,9,0,42,0
"With Swipe at U.S., Iraq Builds Ties to French",0,1,8,27,3,8,0,35,0
Woman accidentally shot in head at wedding in New York's Waldorf Astoria,0,2,5,55,1,11,0,60,0
A Few Predictions for the ‘Westworld’ Season Finale,0,3,6,36,2,7,0,42,0
Author of Wikipedia character assassination takes responsibility,0,1,2,56,0,6,0,58,0
"Ginsburg Shares Views on Influence of Foreign Law on Her Court, and Vice Versa",0,1,10,54,1,13,0,64,0
"Art-House Fare Hopes for an Oscar-Nod Push, as ‘Split’ Rules North America - The New York Times",0,2,15,58,6,16,0,73,0
"7 'New' Features Apple Just Stole From Microsoft, Google, and Itself",0,3,9,44,4,10,1,53,0
The MLS Is Growing in Teams—Just Not Profits,0,3,10,26,1,7,0,36,0
"Helping Hands Keep Alberto Arroyo, Jogging Pioneer at Central Park, Going",0,1,10,51,2,10,0,61,0
"Letters From Einstein About God (and Toys) Sell for $420,625",0,3,7,34,4,9,6,41,0
NT youth detention royal commission looks to New Zealand model on observation trip,0,3,4,66,0,12,0,70,0
Kellyanne Conway says her Bowling Green interview won praise — before the ‘haters’,0,2,4,63,3,12,0,67,0
Brisbane storm: Bureau of Meteorology warns more on the way after early morning light show,0,2,3,72,1,14,0,75,0
This scientific breakthrough could reverse the aging process,0,2,1,52,0,7,0,53,0
"UK nears US in cyber-crime, ahead of Nigeria, Romania",0,1,6,36,3,8,0,42,0
Trump Poised to Wield Executive Power to Make Immigration Changes ,0,3,8,48,0,10,0,56,0
Weed Prices Are Falling Thanks to Legalization,0,3,6,34,0,6,0,40,0
"FA Cup: Portsmouth defeat West Brom, advance to final",0,1,6,37,2,8,0,43,0
"Woman Finds Rs 100 Cr In Her Jan Dhan Account, Writes To Modi After Bank Refuses To Help Her",0,2,18,52,1,18,3,70,0
"Nike Orders Fall 12%, Sending Shares Down 4.6%",0,1,6,25,4,7,4,31,0
Sight of plane circling Manhattan causes stir on social media,0,3,2,50,0,9,0,52,0
Gunmen kill seventeen at party in Mexico,0,1,2,32,0,6,0,34,0
Saudi Wealth Fund to Get Airports in Privatization Push,0,3,7,40,0,8,0,47,0
Donald Trump's inauguration: Schedule of the day,0,3,3,37,2,6,0,40,0
"Showdown looms between Trump administration, sanctuary cities ",0,3,2,52,1,7,0,54,0
Thieves reportedly use smoke bombs to target shop in Venice,0,2,2,48,0,9,0,50,0
Morgan Stanley and UBS to Increase Stakes in Mainland-China Joint Ventures ,0,3,11,52,1,11,0,63,0
"1 Address, 2,000 Companies, And The Ease Of Doing Business In The U.K.",0,2,12,36,5,12,5,48,0
‘Straw Hat Bandit’ Suspect Richard Boyle Robbed Banks in Past,0,2,9,41,2,9,0,50,0
Damon Lindelof believes Lost could return in the same way as Star Wars,0,3,5,53,0,12,0,58,0
UK mother cleared of attempted murder of ME-suffering daughter,0,1,4,49,1,8,0,53,0
Civil unrest in Iranian cities after Ahmadinejad declares victory,0,1,3,54,0,8,0,57,0
What I wish I could tell my boss: 'You only care about yourself',0,3,4,45,3,12,0,49,0
Crowds Clash in Seoul As South Korean Court Removes President,0,3,9,43,0,9,0,52,0
Knicks Getting in the Habit of Beating Good Teams,0,1,6,35,0,8,0,41,0
The Force Is Strong With This Family's BB-8 Snowman - Yahoo,0,2,11,34,3,10,1,45,0
Israeli PM Olmert to step down in September,0,1,5,31,0,7,0,36,0
School holidays row: supreme court grants council right to appeal,0,2,1,54,1,9,0,55,0
Wider Political Battles Play Out in Fight Over Supreme Court Pick Neil Gorsuch ,0,2,12,54,0,13,0,66,0
Trump Says U.S. Should Refuse to Take Back Drone Seized By China,0,3,12,39,2,11,0,51,0
Florida’s Forgotten ‘Above-Ground’ Railroad - Video - NYTimes.com,0,2,9,42,7,7,0,51,0
Facebook to roll out fake news tools in Germany,0,3,2,37,0,8,0,39,0
Sadiq Khan promised 'zero days of strikes' during London mayoral election campaign,0,3,3,66,2,11,0,69,0
Conditions Hold as Stricker Sets a 36-Hole Record at Colonial,0,1,7,42,1,9,2,49,0
"Beyoncé's Coachella performance will be pretty interesting, according to Twitter",0,2,3,66,2,9,0,69,0
Clean Coal Technologies Gaining Favor,0,1,5,28,0,4,0,33,0
"How to build your own moonshot lab, according to Astro Teller",0,2,3,47,1,10,0,50,0
"5 things for Tuesday, March 7, 2017: Health care, immigration, North Korea",0,3,5,47,5,11,6,52,0
"The devastating 1889 Johnstown Flood killed over 2,000 people in minutes",0,3,3,50,1,10,8,53,0
"Queen Elizabeth, Prince Philip delay Christmas travel plans because of 'heavy colds'",0,3,5,65,3,11,0,70,0
How Greylock VC Asheem Chandna Keeps Racking Up Billion-Dollar Outcomes,0,3,12,49,1,9,0,61,0
"Falcons QB Matt Ryan wins NFL MVP, Offensive Player of Year",0,2,14,34,1,10,0,48,0
Govt Planning Tax On Every 'Cash Transaction' To Push People For Cashless Economy,0,3,13,54,2,12,0,67,0
Cuba Gooding Sr found dead in LA,0,3,5,21,0,6,0,26,0
Israel rules victims of Jewish terrorist not entitled to lifelong support,0,1,2,61,0,10,0,63,0
Boston rings in the new year,0,1,1,22,0,5,0,23,0
Pink Floyd's $1.8m desk shows timeless appeal of analogue sound,0,3,2,47,3,9,2,49,0
Another Top Law Firm Pays Hires to Delay Start,0,1,8,30,0,8,0,38,0
Why the Senate Doesn’t Have to Act on Merrick Garland’s Nomination,0,2,8,46,2,10,0,54,0
The Hawaii Judge Who Stopped Trump's Travel Ban Has Been Receiving Death Threats,0,3,13,54,1,12,0,67,0
Qatar Air Plans to Establish Indian Carrier With 100 Planes,0,2,8,39,0,9,3,47,0
"Stocks End Mixed, Giving Top Indexes Weekly Loss",0,1,8,32,1,7,0,40,0
"At Army-Navy game, Trump says thought of leading US soldiers, sailors ’humbling’",0,2,6,58,5,11,0,64,0
"At base in Syria, U.S. forces helping Syrians prepare to liberate Raqqa",0,3,6,51,3,11,0,57,0
Private-Jet Booking App Lands $105 Million in Funding ,0,3,7,34,2,8,3,41,0
"Gerardo Ortiz & La Septima Banda Announce '2 Mundos, Una Historia 5' U.S. Tour",0,3,12,45,6,13,2,57,0
Giant Alligator Walks onto Golf Course During Celebrity Invitational Tournament,0,2,9,61,0,9,0,70,0
MDMA May Soon Be Approved For Treatment-Resistant PTSD,0,3,15,31,1,7,0,46,0
House votes to repeal country of origin label requirement for meat ,0,3,1,55,0,11,0,56,0
New Year’s Nails: 17 Manicure Ideas to Ring In 2017,0,3,7,27,2,9,6,34,0
Uber launches self-driving car fleet despite warning from regulator to 'cease the operation',0,3,1,76,3,12,0,77,0
India wins its first cricket Test in South Africa,0,1,4,37,0,8,0,41,0
"Church massacre, other killings strain forgiveness for many ",0,3,1,50,1,8,0,51,0
Dem Deb Blogging,0,2,3,11,0,2,0,14,0
"Oakland fire victims: teacher, students and local artists among the dead",0,3,1,59,2,10,0,60,0
This new interior design app was inspired by Tinder,0,2,2,41,0,8,0,43,0
California Braces For More Rain After Storm Kills At Least 7,0,3,10,39,0,10,1,49,0
"The Talk, and the Talk, and the Talk, of Austin",0,1,5,30,3,9,0,35,0
Katie Rich of ‘S.N.L.’ Is Suspended for Tweet Mocking Barron Trump ,0,3,11,40,5,11,0,51,0
Rick Perry Is Now A Big Fan Of The Energy Department,0,2,11,31,0,10,0,42,0
Grantchester star James Norton criticises trend for faith being portrayed as 'exorcisms and cults',0,3,3,80,2,13,0,83,0
Trump Time Capsule #67: ’Unfit’,0,2,4,17,4,4,2,21,0
Toyota recalls up to 1.8 million automobiles,0,1,1,34,1,6,2,35,0
Retired NASCAR star Tony Stewart returns to sprint cars ,0,3,9,38,0,9,0,47,0
U.K. Labels and Google Partner on Anti-Piracy Measure: Removing Links,0,3,10,46,4,9,0,56,0
Refugee deals: Government at odds over 'people swap' description of US-Australia resettlement,0,3,5,73,4,11,0,78,0
A Bird Quickly Learns to Tell Urban Friend From Foe,0,1,9,33,0,9,0,42,0
The Secret To Treating Autoimmune Disease May Lie In The Gut,0,3,11,39,0,10,0,50,0
Cisco’s Secretive AppDynamics Deal May Pave Way for Unicorns,0,2,9,42,1,8,0,51,0
Scottish judge criticises medical care of murdered baby,0,1,1,47,0,7,0,48,0
"In Cancer Trials, Minorities Face Extra Hurdles ",0,3,7,33,1,7,0,40,0
Obama The Obama-Biden bond is among the strongest in White House history,0,3,6,54,1,11,0,60,0
Luke Bryan on Brother's Death: 'It Makes You Appreciate Chasing Dreams',0,3,10,47,4,10,0,57,0
"In First Round With Gawker, Hulk Hogan Prevails",0,2,8,31,1,7,0,39,0
US may not have known of Sgrena rescue operation,0,1,3,37,0,8,0,40,0
12 style upgrades any guy can snag for under $60,0,3,0,34,1,9,4,34,0
"MMA Brock Lesnar Suspended 1 Year, Fined for Failed Drug Tests Around UFC 200",0,2,15,44,1,13,4,59,0
"Trump declares victory: Sprint will create 5,000 U.S. jobs",0,3,4,38,4,8,4,42,0
Bristol Palin Blasts Artists for Refusing to Perform at Trump Inauguration  Insider,0,3,9,62,0,12,0,71,0
Beyonce sings 'Love Drought' and 'Sandcastles' at Grammy Awards 2017,0,2,6,45,4,9,4,51,0
This Stunningly Racist French Novel Is How Steve Bannon Explains The World,0,3,12,51,0,11,0,63,0
"Pan Am pilots, still feeling victimized 28 years after Lockerbie, seek money from Libya fund",0,3,4,70,2,14,2,74,0
Congressman Thad McCotter ends bid for U.S. president,0,1,6,38,2,7,0,44,0
"Picture exclusive: Andrew Garfield rehearsing Angels in America, and how to enter the ticket ballot",0,3,5,78,2,14,0,83,0
Brain cancer survivor running 7 marathons on 7 continents in 7 days,0,2,1,52,0,11,3,53,0
Eminem proves there are lots of words that rhyme with orange The list,0,3,2,55,0,12,0,57,0
Shia LaBeouf Was Arrested At His Anti-Trump Protest,0,3,10,33,1,7,0,43,0
Intel to Invest Despite Drop in Quarterly Income,0,1,6,35,0,7,0,41,0
China Begins to Address a Coming Wave of Elderly,0,1,6,34,0,8,0,40,0
Republicans Say They Assume Trump Didn’t Mean To Promise Health Insurance For All,0,3,13,55,1,12,0,68,0
Alabama Set To Bar Judges From Putting People To Death When Juries Won't,0,3,13,46,1,12,0,59,0
Tomi Lahren Tells Glenn Beck: 'Let Me Go',0,3,8,23,3,7,0,31,0
Tesla's market value overtakes Ford,0,3,2,28,1,4,0,30,0
Senate Democrats threaten brief shutdown over policies they hope Trump will support,0,3,3,69,0,11,0,72,0
"Ryan Lochte Just Wants To Dance, Apparently — With The Stars!",0,2,10,38,3,10,0,48,0
Dion Waiters Shares Body Transformation Since Joining Heat,0,3,8,43,0,7,0,51,0
"John Mitchell, a Football Pioneer, Builds Big Men for the Steelers",0,1,8,46,2,10,0,54,0
Twenty-five million reasons the U.S. hasn’t struck North Korea,0,2,5,45,4,8,0,50,0
Send in the Bulls: 2017 Could Be a Banner Year for Stocks ,0,3,7,34,1,12,4,41,0
Man convicted of rape for taking off condom during sex,0,3,1,44,0,9,0,45,0
Zika: Aerial Spraying and Releasing Bats Approved - Breitbart,0,2,7,44,2,8,0,51,0
Trump’s Remarks on Trade Deficit Rattle Japan ,0,3,6,32,1,7,0,38,0
Heart failure drug shows promise in first human trial,0,3,1,44,0,8,0,45,0
College Football Best Signs from ESPN's 'College GameDay' from Week 14 in Indianapolis,0,3,13,56,3,12,2,69,0
"National Hockey League news: June 21, 2008",0,1,4,24,2,6,6,28,0
It’s Almost Dow 20000: Where’s the Party? Where Are the Hats?,0,3,8,33,5,10,5,41,0
Homeland Security chief wants border wall built in two years,0,2,2,49,0,9,0,51,0
Tamil party drops commitment to independence from Sri Lanka,0,1,3,48,0,8,0,51,0
'You've Got to Hit First': Draymond Green Reveals His Secrets to Stopping Stars,0,3,11,52,4,12,0,63,0
Xbox 360 console sales surge in America,0,1,2,28,0,6,3,30,0
"A driver passed out from a suspected drug overdose. From the back seat, a child was trying to wake him.",0,3,2,79,3,19,0,81,0
Japanese Car Expert Talks Weeknd's Mazda-Obsessed 'Party Monster' Video: Exclusive,0,3,11,57,5,9,0,68,0
Boeing unveils new 787 Dreamliner,0,1,2,24,0,4,3,26,0
"Woman ""videobombed"" by bright fireball during live-stream in Calif. backyard",0,3,2,61,4,9,0,63,0
United Airlines Kicks Couple Off Plane En Route to Their Wedding [Video],0,2,11,48,2,11,0,59,0
Politicians and protesters prepare for G20 summit,0,1,2,39,0,6,2,41,0
"Syrian girl, 7, tweets support for Donald Trump's missile strikes",0,3,3,49,3,9,1,52,0
Jennifer Lawrence visits Louisville children's hospital ,0,2,3,46,1,6,0,49,0
Everything's in Play After Day of Chaos in French Race,0,3,7,37,1,9,0,44,0
2015 NBA playoffs - Dellavedova winning bet,0,3,4,28,1,6,4,32,0
An Augusta green jacket was found at a Canadian thrift store and it can be yours,0,2,3,62,0,15,0,65,0
Jon Stewart warns America over Donald Trump presidency: 'F***ing buckle your seat belt',0,3,6,63,6,12,0,69,0
A Matter of Opinion?,0,1,3,13,1,3,0,16,0
Work Halted on Helicopter for President,0,1,4,30,0,5,0,34,0
"Apple, Google and Facebook warn Obama about smartphones",0,2,4,43,1,7,0,47,0
"Ukrainian president Yushchenko dismisses PM, cabinet",0,1,4,42,1,5,0,46,0
My grandfather died fighting for Hitler. What should we make of his legacy?,0,2,3,58,2,12,0,61,0
Syrian activists: ISIS has recaptured Palmyra ,0,3,6,33,1,6,0,39,0
Cloudy Outlook for Housing-Finance Overhaul,0,3,5,33,1,4,0,38,0
Brokers to Get New Tools to Fight Abuse of Senior Investors,0,3,8,41,0,10,0,49,0
Buster Olney Blog- ESPN,0,3,7,12,1,3,0,19,0
"Anzac Day: Large crowds, boosted police presence expected at Queensland services",0,3,4,64,2,10,0,68,0
Watch E! News Now Season 2016 Excerpt Free Online - Is This a Brand-New Kim Kardashian West? | Yahoo View,0,2,17,60,5,19,4,77,0
Kellyanne Conway to join the Trump White House as counselor to the president,0,2,5,59,0,12,0,64,0
Nevada Supreme Court Sends Onion the Dog Case Back to Las Vegas Court,0,1,11,46,0,12,0,57,0
Dad Posts Craigslist Ad to Sell Pothead Son’s Truck as Punishment - Breitbart,0,2,10,53,2,12,0,63,0
Daredevil Season 2: Walking Dead Alum Jon Bernthal Cast as The Punisher,0,2,10,48,1,11,1,58,0
White House refuses to release climate policy documents,0,1,2,46,0,7,0,48,0
Pittsburgh Pirates Debut Real-Life 'Super Mario Run' Game in Front of Scoreboard,0,3,11,55,3,11,0,66,0
I.R.S. Suspicions Grow on Secret Swiss Accounts,0,1,8,30,3,6,0,38,0
"Two Ships Return From Andaman With 120 Tourists Onboard, More Than 1,500 Still Stuck On The Cyclone-Hit Islands",0,3,17,67,3,17,7,84,0
Boeing 787 Dreamliner shows off vertical takeoff| Latest News Videos ,0,3,5,50,1,10,3,55,0
Pakistan activist Waqass Goraya: The state tortured me,0,3,4,42,1,7,0,46,0
No Jail Time for White High School Football Player Who Raped Black Mentally Disabled Teammate With Hanger,0,3,16,73,0,16,0,89,0
South Korea's Park leaves presidential palace after impeachment,0,3,3,52,1,7,0,55,0
Middle East Christians Fear Trump Ban Will Backfire ,0,3,8,36,0,8,0,44,0
Draymond Green expresses displeasure with NBA CBA deal,0,2,8,39,0,7,0,47,0
Philadelphia officers fired upon for 2nd night in a row,0,2,1,44,0,9,1,45,0
"Trump, Clinton rack up Super Tuesday wins; Cruz keeps foothold",0,2,5,46,2,9,0,51,0
BBC Trending,0,3,4,7,0,1,0,11,0
"The Millionaire's Wife Who Feeds 40,000 Children",0,3,6,29,2,6,5,35,0
Mexico Fireworks Market Explosion Death Toll Rises to 32,0,3,7,39,0,8,2,46,0
Tech Failure Ellen Pao To Write Memoir Blaming Everything On Sexism And Racism - Breitbart,0,2,14,61,1,14,0,75,0
"This football star loves his $4,500 Louis Vuitton backpack",0,2,3,41,2,8,4,44,0
"A Backstreet Boy named his new baby 'Lyric,' obviously",0,2,4,39,3,8,0,43,0
Indonesia Confounds Mining Industry With Export Policy Curveball,0,3,8,49,0,7,0,57,0
Venice hotel sells rooms for one cent a night after pricing error,0,1,1,53,0,11,0,54,0
Let's put the sac bunt to bed,0,2,1,21,1,6,0,22,0
Chicago Cop Loses Police Powers In Off-Duty Killing Of Unarmed Man,0,3,12,43,1,10,0,55,0
U.S. Annual Budget Deficit Smallest in Nearly Seven Years,0,2,9,38,2,8,0,47,0
"To Track Tigers, Software That Knows Them by Their Stripes",0,1,9,39,1,9,0,48,0
FDA Warns on Abbott’s St. Jude Pacemakers and Defibrillators   ,0,3,9,41,2,11,0,50,0
Marcinkiewicz's cabinet given vote of confidence,0,1,1,41,1,5,0,42,0
Bafta Awards 2017 - Why the Baftas wouldn’t be as British without Stephen Fry as host,0,2,7,57,2,15,4,64,0
Schröder loses motion of confidence,0,1,1,30,0,4,0,31,0
What led to the freeing of 226 Christians from ISIS,0,2,6,33,0,9,3,39,0
Australia commits more troops to Afghanistan,0,1,2,37,0,5,0,39,0
Oakland CF Billy Burns Makes a Pair of Outstanding Catches vs. Texas,0,3,10,46,1,11,0,56,0
Japan recalls ambassador to South Korea over comfort woman statue,0,3,3,53,0,9,0,56,0
8 Teams Threaten to Splinter From Formula One,0,1,6,31,0,7,1,37,0
Egyptian archaeologists announce discovery of marble statue and 132 new sites,0,1,1,63,0,10,3,64,0
"Questlove, Pete Rock, and More React to the Death of Influential Musician David Axelrod",0,3,10,62,2,13,0,72,0
Kanye West deletes all tweets defending Trump meeting,0,3,3,43,0,7,0,46,0
The Democratic Party has lost its mind — and its soul,0,2,3,39,1,10,0,42,0
"CSX Results, Off 20%, Beat Forecasts",0,1,7,19,3,5,2,26,0
Thai Queen attends protester cremation as report indicates explosive tear gas used,0,1,2,69,0,11,0,71,0
Ronnie Lee Gardner executed by Utah firing squad,0,1,4,37,0,7,0,41,0
"Odell Beckham, Jr. Was More Than Amused by Antonio Brown's Awesome TD Catch and Dance",0,3,14,54,3,14,0,68,0
Trump's America Donald Trump: Why do we care about the US President's first 100 days?,0,3,8,56,4,14,3,64,0
"Muslims in Congress, Democrats blast new Trump travel ban: 'Muslim Ban 2.0'",0,3,6,51,5,11,2,57,0
German police arrest two men suspected of planning shopping mall attack,0,3,1,60,0,10,0,61,0
Hate Hoax: Pro-Trump Students Cleared of Harassment Claims,0,2,8,41,2,7,0,49,0
Philadelphia Mayor Proposes Temporary Tax Increases,0,1,6,40,0,5,0,46,0
How Women Modernized The Disney Princess,0,3,6,29,0,5,0,35,0
Tiger Woods wins British Open,0,1,4,21,0,4,0,25,0
Sulfur Dioxide levels in Hawaii remain high,0,1,3,34,0,6,0,37,0
Jordan Peele's Barack Obama Impression Is Now Drunk And Angry At Donald Trump,0,3,13,51,1,12,0,64,0
Demanding and Direct: HSBC’s New Chairman Mark Tucker ,0,3,10,34,2,8,0,44,0
America's Richest Women 2016,0,3,3,17,1,3,4,20,0
Donald Trump Just Signed On to Send People to Mars,0,3,8,33,0,9,0,41,0
Metal singer Ronnie James Dio dies aged 67,0,1,4,29,0,7,2,33,0
Jacob Sartorius Will Sing You To Sleep In New Video For 'Last Text': Exclusive,0,3,14,48,3,13,0,62,0
Chugging Water Between Meals? You Could Be Harming Your Digestive System,0,3,11,50,1,10,0,61,0
Most Ideal Landing Spots for 2017 NBA Draft's Top Prospects,0,3,10,35,1,9,4,45,0
"On Hot Day, a Dash of Spice at Palmer Invitational",0,1,7,33,1,9,0,40,0
Oil spill reported in Gulf of Mexico,0,1,3,27,0,6,0,30,0
Troian Bellisario And Patrick J. Adams Got Married,0,2,8,34,1,7,0,42,0
Jeff Sessions asks dozens of US attorneys appointed by Obama to resign,0,3,5,54,0,11,0,59,0
"India v England, fourth Test: day four – as it happened",0,2,3,39,3,10,0,42,0
Afghanistan suicide attack wounds more than twenty,0,1,1,43,0,6,0,44,0
Trump Says Obama Administration Should Stop Guantanamo Releases,0,3,8,48,0,7,0,56,0
UC Berkeley ’Income Inequality’ Experts Are Among Wealthiest 2pc of Americans - Breitbart,0,2,11,62,3,12,1,73,0
Madoff jailed after pleading guilty to $50 billion fraud scheme,0,1,1,50,1,9,2,51,0
Ditch your backpack for this rolling assistant,0,3,1,39,0,6,0,40,0
Israel bans nonresidents from Gaza,0,1,2,28,0,4,0,30,0
"'Fascinating' and 'provocative' research examines genetic elements of bipolar, schizophrenia",0,1,1,77,5,9,0,78,0
Watch Leslie Jones Bait Donald Trump on 'Saturday Night Live',0,3,9,41,2,9,0,50,0
"First Drive: With 2018 Stinger, Kia Has A Worthy Challenger To German Premium Sedans",0,2,13,52,2,13,4,65,0
'Davos man' versus 'Camp Igloo'; 42nd World Economic Forum convenes in Swiss alps,0,1,7,55,5,12,2,62,0
Juno Awards Switching Networks After 16 Years on CTV,0,3,9,33,0,8,2,42,0
Bomb threat on UK–Egypt plane; diverted to Greece,0,1,5,35,2,7,0,40,0
Contestant in a wheelchair is a first for Miss Australia pageant,0,3,3,51,0,10,0,54,0
"Transcript: Obama’s end-of-year news conference on Syria, Russian hacking and more",0,3,4,63,5,10,0,67,0
Panteon Rococo & Antidoping Cancel L.A. Skanking Reggae Fest Appearance Due to Visa Issues,0,3,13,61,3,13,0,74,0
US Marines accused of sharing nude photos of female colleagues,0,3,3,50,0,9,0,53,0
Children living with autism face frustrating therapy gap waiting for NDIS,0,3,5,58,0,10,0,63,0
Ivanka Trump says she's 'complicit' in 'force for good' amid 'unprecedented situation' ,0,3,2,66,7,12,0,68,0
A Middle-Aged Couple Decides To Spice Up The Sex Life In This Adorable Short Film!,0,3,16,50,2,14,0,66,0
Trump's Camp Denies Struggling to Find Inauguration Performers,0,3,7,47,1,7,0,54,0
Trump vs. Congress: Now What? ,0,3,4,18,3,5,0,22,0
"Uncovered boxes shed light on Maggie Lena Walker, an African American icon and first woman to own a U.S. bank",0,3,8,79,3,19,0,87,0
Smells like a cover-up: Don’s Johns logo concealed on Trump inauguration toilets,0,3,4,62,3,11,0,66,0
"ISIS is manufacturing arms on industrial scale, report finds ",0,2,4,47,1,9,0,51,0
House approves renewal of the Patriot Act,0,1,3,32,0,6,0,35,0
"US Treasury Secretary: ""We need the ability to seize firms""",0,1,5,42,3,9,0,47,0
"Former President George HW Bush Admitted to ICU, Barbara Bush Hospitalized ",0,3,13,50,1,11,0,63,0
Sources: Sean Hannity once pulled a gun on Juan Williams,0,2,5,41,1,9,0,46,0
"Biloxi Crash: Four Killed, Over 30 Hurt After Train Hits Charter Bus",0,3,11,42,2,11,2,53,0
Fashion PR Firm LaForce Cancels Christmas Party Because Trump Won,0,2,12,44,0,9,0,56,0
Bernie Sanders stands by anti-abortion mayoral candidate,0,3,2,47,1,6,0,49,0
"The rise, then fall, then rise again of cleantech",0,2,1,38,2,8,0,39,0
Chinese rioters storm Japanese embassy in Beijing,0,1,3,40,0,6,0,43,0
Economics Are Transitioning America From Coal To Clean,0,3,8,39,0,7,0,47,0
Trump to Meet With Flint Mayor to Discuss Water Crisis,0,3,8,37,0,9,0,45,0
"Trump says China has turned back N. Korean coal ships, lauds it as 'big step'",0,3,4,55,4,14,0,59,0
Renowned Indian guru Śrī Satya Sai Baba dies aged 84,0,1,6,35,0,9,2,41,0
Snoop Dogg Says He Wants To Be Twitter's Next CEO,0,3,12,27,1,9,0,39,0
"Shooting at Cincinnati Nightclub Kills 1, Injures Several",0,3,6,42,1,7,1,48,0
"Japan Pays Foreign Workers to Go Home, Forever",0,1,7,31,1,7,0,38,0
Watch live: Spicer to address ObamaCare replacement in press briefing ,0,2,4,55,1,10,0,59,0
"Canadian CEO accused of fraud, suspected to have fled country",0,1,4,47,1,9,0,51,0
Belgium charges Antwerp suspect with 'attempted terrorist murder' over failed car attack on shopping crowd,0,3,2,88,2,14,0,90,0
Mike Zimmer Says He Has 'No Idea' If Teddy Bridgewater Will Play in 2017 Season,0,3,13,46,2,14,4,59,0
Hate crime charges filed in Chicago beating streamed on Facebook Live ,0,3,4,55,0,11,0,59,0
"Record Store Day Turns 10: Founders Break Down Its Past, Present and Future",0,3,11,48,2,12,2,59,0
4 Michigan Cities Will Lose Daily Papers,0,1,6,27,0,6,1,33,0
Google's DeepMind Has Developed An AI That Learns From Old Experiences,0,3,13,46,1,10,0,59,0
Getting 50-Somethings to Pay for Streaming Music,0,3,5,34,1,6,2,39,0
"Trump's America Donald Trump wasting his time complaining about media coverage, Malcolm Turnbull says",0,3,6,80,2,13,0,86,0
Winners and Losers of the 2017 NFL Draft Day 2,0,3,7,25,0,9,5,32,0
Paul Ryan pressed on Planned Parenthood,0,2,4,30,0,5,0,34,0
Brandeis Says It Plans to Sell Art Collection to Raise Cash,0,1,9,40,0,10,0,49,0
People are pissed about the sexist and ageist reaction to Madonna twerking,0,3,2,61,0,11,0,63,0
Nigerian Housing Minister fired in anti-corruption drive,0,1,3,46,1,6,0,49,0
The Breakout Stars of the 2017 Sundance Film Festival,0,3,6,35,0,8,4,41,0
"Franco-Belgian bank Dexia to restructure, lose 900 jobs",0,1,3,40,2,7,3,43,0
Nick Smith responds to claims he is New Zealand's worst behaved politician,0,1,4,58,1,11,0,62,0
"Who should direct Donald Trump: the Movie? Step forward, Werner Herzog",0,3,7,50,3,10,0,57,0
President Barack Obama to Join Kennedy Center Honors For Last Time,0,2,10,46,0,10,0,56,0
"Court Says Rapes Took Place At Murthal During Jat Protest In 2016, Directs Cops To Find Rapists",0,3,16,58,1,16,4,74,0
American philanthropist Brooke Astor dies at 105,0,1,3,36,0,6,3,39,0
Thai PM sues newspaper for 500 million baht,0,1,3,30,0,7,3,33,0
Donald Trump Shared a 'Very Nice' Holiday Letter From His New BFF Vladimir Putin,0,2,15,50,2,13,0,65,0
"Stricker Leaves Opening, and Clark Slips Into Lead at Colonial",0,1,8,44,1,9,0,52,0
British scientist shot dead in Ecuador was ‘unlawfully killed’,0,1,2,50,2,8,0,52,0
"Watch the Video for Iggy Azalea's New Single ""Mo Bounce""",0,3,8,36,3,9,0,44,0
"ESPN Is Laying Off 100 Employees, Including Many On-Air Personalities",0,3,13,42,2,9,3,55,0
"Zoe Saldana And Her Husband Welcomed Their Third Son, Zen, To The World",0,2,13,44,2,12,0,57,0
Government loses $2.2 billion in student loans to dodgy training providers,0,3,1,59,2,10,2,60,0
Conservatives could learn to love ‘Trump the builder’,0,2,2,42,2,7,0,44,0
David Njoku Is a Rare NFL-Bound Talent from a Rare Family,0,2,11,35,1,10,0,46,0
Fulton Fish Market leaves Manhattan after more than 180 years,0,1,4,45,0,9,3,49,0
Destroying Levees in a State Usually Clamoring for Them,0,1,6,41,0,8,0,47,0
Woman died from superbug resistant to all available antibiotics in U.S.,0,3,3,56,2,10,0,59,0
Egypt to open Gaza Strip crossing for humanitarian and medical aid,0,1,3,53,0,10,0,56,0
Watch Enrique Iglesias Film His 'SÃºbeme la radio' Video in Havana,0,3,9,45,2,10,0,54,0
Sweden torn over how to handle incoming terrorists ,0,3,1,42,0,8,0,43,0
President Trump’s First Weekly Address: Administration ‘Has Hit the Ground Running at a Record Pace’,0,2,12,70,4,14,0,82,0
Britain to test schools and hospitals after 75 out of 75 high-rise buildings fail fire safety tests,0,2,1,77,1,16,4,78,0
Another Foe of Chechen Leader Shot Dead Abroad,0,1,7,32,0,7,0,39,0
Big Sean Teases 'SNL' Debut in Promo With Aziz Ansari & Kate McKinnon,0,2,14,40,3,12,0,54,0
Innovative new breast pump a reminder of why we need more women in STEM,0,3,5,53,0,13,0,58,0
See How India’s Biker Gangs and Bollywood Stars are Boycotting Cash to Help the Needy - India Real Time,0,2,14,69,2,18,0,83,0
"Fiji ""running out of patience"" with Vanuatu over ban on Fijian biscuits",0,1,3,55,2,11,0,58,0
Single Shot at Doctor’s Office May Be Future of HIV Prevention,0,2,11,40,1,10,0,51,0
"New Grammy Museum to open in Newark, New Jersey",0,2,6,32,1,8,0,38,0
Marketers Lend Voices to Support the Disabled,0,1,5,34,0,6,0,39,0
Government expected to commit more than $1 billion to building inland rail,0,3,1,60,1,11,1,61,0
Arrested prison employee allegedly gave hacksaw blades to escaped killers,0,2,1,63,0,9,0,64,0
Tommy Thompson steps down as Secretary of Health and Human Services,0,1,6,51,0,10,0,57,0
Sunni Lawmaker Assassinated in Iraq,0,1,4,27,0,4,0,31,0
Yahoo Movies | Facebook,0,2,3,16,1,3,0,19,0
Ahok: Jakarta Governor's blasphemy trial to proceed in Indonesian court,0,3,4,56,2,9,0,60,0
"Recession Pain, Even in Palm Beach",0,1,5,23,1,5,0,28,0
Virginia Tech Earns Shot at North Carolina in A.C.C. Tournament,0,1,10,41,3,9,0,51,0
A Russian Critic of Putin Is Assassinated in Ukraine ,0,3,7,37,0,9,0,44,0
Trump Worked A Few Weeks On Health Care. White House Claims He Gave It 'His All.',0,2,16,46,4,15,0,62,0
"Britain would be 'literally erased from the face of the earth' if it launched a nuclear attack, warns Russian MP",0,3,4,86,3,19,0,90,0
FDA: Texas lethal injection drugs must be destroyed or exported ,0,3,4,49,1,10,0,53,0
Don’t tell us this pizza sucks,0,2,1,23,1,5,0,24,0
People Are Praising Chance The Rapper For Donating $1 Million To Chicago Public Schools,0,3,13,59,1,13,1,72,0
The North American movie box office raked in a record $11.4 billion in 2016,0,3,3,50,2,13,7,53,0
"Hungary Teaches Globalists a Lesson on Immigration, Borders, Democracy - Breitbart",0,2,8,61,3,10,0,69,0
Would You Buy a Car From a Vending Machine? | Fox Business,0,3,9,36,2,11,0,45,0
Diane Abbott refuses to say if she will swear an oath of allegiance to the Queen when she joins Privy Council,0,3,5,84,0,20,0,89,0
Republicans once again rely on a misleading Obamacare factoid,0,3,2,51,0,8,0,53,0
"White students hold 'Trump' sign, turn backs on black basketball team ",0,3,2,54,3,11,0,56,0
Yankee Candle Issues Recall: What You Need to Know  Insider,0,3,9,39,1,10,0,48,0
Man misdiagnosed as being in coma for 23 years,0,1,1,35,0,8,2,36,0
"Vestas plant in Newport, England shuts down",0,1,3,33,1,6,0,36,0
"Berkeley, Reversing Decision, Says Ann Coulter Can Speak After All ",0,3,10,45,2,10,0,55,0
The ruble is surging to its highest level since July 2015,0,2,2,41,0,10,4,43,0
"Republicans say ‘every American’ can understand their Obamacare bill. Except for me, apparently.",0,3,4,75,5,12,0,79,0
Pelosi to Fellow Dem Lawmaker at Protest: 'Tell Them You're a Muslim'  Insider,0,3,10,51,4,13,0,61,0
Kansas Democrats Show Just How Big The Anti-Trump Wave Actually Is,0,3,12,43,1,10,0,55,0
"Delta flight makes emergency landing at JFK, no injuries",0,1,4,43,1,8,0,47,0
Two suspects killed in UK bank robbery,0,1,3,29,0,6,0,32,0
"Jeremih Drops His New Track ""I Think Of You"" f/ Big Sean And Chris Brown",0,3,14,41,3,14,0,55,0
U.S. Considers Opening Network of Bases in Iraq,0,3,7,31,2,7,0,38,0
Traffickers get life in prison in India for torture and chopping off labourers' hands,0,2,2,69,1,13,0,71,0
Former Celtic kitman Jim McCafferty ‘confesses to sexual abuse in 1990s’,0,3,5,51,2,10,4,56,0
People Are Photoshopping the Hell Out of the New 'Star Wars: The Last Jedi' Poster,0,3,12,53,3,14,0,65,0
Green light for Swansea Bay's £1bn tidal lagoon,0,2,3,34,2,7,1,37,0
Bella and Edward fall hilariously in love in comedic 'Twilight' spin,0,2,3,53,2,10,0,56,0
France Announces $8.5 Billion Plan to Help Struggling Auto Industry,0,1,8,46,2,9,2,54,0
Rethinking the Widely Held 2% Inflation Target,0,3,5,33,1,6,1,38,0
Greece wildfires force thousands to evacuate,0,1,1,38,0,5,0,39,0
"Chance the Rapper, Stephen Colbert & Ziggy Marley Remake the 'Arthur' Theme Song: Watch",0,3,11,58,5,13,0,69,0
Deviate: The Science of Seeing Differently by Beau Lotto review – why we need brain control,0,2,7,67,2,15,0,74,0
The disappearance of Jonathan Spollen,0,2,3,30,0,4,0,33,0
"Trump's America Donald Trump says 'major, major conflict' with North Korea is possible, but prefers diplomacy",0,2,6,83,5,15,0,89,0
Hollywood Is Getting Outsized Credit For Seriously Small Moments Of LGBT Inclusivity,0,3,15,58,0,11,0,73,0
Where all 14 OPEC members stand ahead of November’s crucial meeting,0,2,6,48,1,10,2,54,0
Oakland Arts Community Reels From Warehouse Fire: 'This Is a Nightmare',0,2,10,48,3,10,0,58,0
The world's first 3-screen gaming laptop is mind-blowing,0,3,1,44,3,7,1,45,0
Video Slur Puts Prince Harry Back in Headlines,0,1,7,32,0,7,0,39,0
Tiger Woods Tweets Odd Photo of Himself as a Shirtless 'Mack Daddy Santa' for His Children,0,3,12,61,2,15,0,73,0
"Lightning rally past Blackhawks, 3-2, to take Stanley Cup Final series lead ",0,2,5,54,3,12,2,59,0
It's Time To Manage Expectations A Bit With 'Horizon Zero Dawn',0,3,11,39,3,10,0,50,0
Inter Milan cancels tour of England due to safety concerns,0,1,3,46,0,9,0,49,0
El Nino-linked floods and mudslides kill dozens in Peru,0,3,3,43,1,8,0,46,0
Monster waves make way for rare surfing competition,0,1,1,43,0,7,0,44,0
Iceland Airwaves festival day four – Björk’s the star in her home country,0,2,3,56,2,12,0,59,0
"Top officials emphasize diplomatic, economic pressure on North Korea in briefing",0,3,3,66,1,10,0,69,0
"There's a 2,000-person wait list for these $125 leggings",0,3,1,36,4,8,7,37,0
‘A Bit Irrational’: Theater Shooter James Holmes’ Ex-Girlfriend Asked Him to See Therapist,0,3,13,60,5,12,0,73,0
This photo series proves trans people are more than their gender identity,0,3,1,61,0,11,0,62,0
New Internet addresses tested on World IPv6 Day,0,1,6,33,0,7,1,39,0
"Nortel to Cut Another 3,200 Jobs",0,1,4,18,1,5,4,22,0
"Star Wars isn’t political, says Disney chief responding to boycott by Trump supporters. He’s wrong.",0,3,5,75,5,14,0,80,0
"‘It’s not about your age, it’s about your ideas’: the teen power list",0,2,1,50,6,12,0,51,0
Pope Studying Possible Trip to South Sudan,0,3,6,30,0,6,0,36,0
Biggest Wealth Fund Returns $53 Billion After Trump Rally,0,3,8,38,1,8,2,46,0
The Castle house saved with plans to relocate it to New South Wales,0,3,5,50,0,12,0,55,0
Ryan Reynolds gets real about watching wife Blake Lively kiss other actors,0,2,4,59,0,11,0,63,0
"For Ivanka Trump's brand, Nordstrom may be tip of the iceberg",0,2,4,45,2,10,0,49,0
Sean Spicer press conference live updates,0,3,2,34,0,5,0,36,0
"Intel Plans to Cut at Least 5,000 Jobs",0,1,5,21,1,7,4,26,0
Senior Aide to Hussein Sentenced to 15 Years,0,1,5,30,0,7,2,35,0
People In Antarctica Are Holding Their Own Women’s March,0,2,9,38,1,8,0,47,0
Humana pulls out of Obamacare for 2018,0,3,2,26,0,6,4,28,0
Russia: Syria establishes control over eastern Aleppo,0,3,3,43,1,6,0,46,0
"Bitcoin jumps above $1,000 for first time in 3 years",0,3,1,35,2,9,5,36,0
"John Oliver Has No Interest in Letting 'Last Week Tonight' Become 'All Trump, All the Time'",0,3,14,57,5,15,0,71,0
"Trump's America Iran defies Trump sanctions with military exercise, vows 'roaring missiles' if threatened",0,3,4,84,4,13,0,88,0
France calls on Libyan leader to step down,0,1,2,33,0,7,0,35,0
North Korea: Malaysia Investigation of Kim Jong Nam Killing Can’t Be Trusted,0,3,11,52,2,11,0,63,0
"In Trump's White House, CEOs are shaping economic policy",0,2,7,39,2,8,0,46,0
Contador wins 2009 Tour de France; Cavendish wins six stages,0,1,4,42,1,9,4,46,0
Canada's Astral Media Inc. to aquire Standard Radio,0,1,6,36,2,7,0,42,0
White House Gives Upbeat Forecast for Economy,0,1,6,33,0,6,0,39,0
Twitter Reacts to Tim Tebow Hitting a Home Run in First Minor League At-Bat,0,3,12,49,1,13,0,61,0
Questions for Mr. Tillerson,0,2,3,20,1,3,0,23,0
Japanese cargo ship captured by space station crew,0,3,1,42,0,7,0,43,0
Violence in Rio ends in 30 deaths,0,1,2,23,0,6,2,25,0
16 Foot Asteroid Passes Between Earth and Satellites,0,1,6,37,0,7,2,43,0
DNC Chief Won’t Apologize For Using Profanity To Slam GOP,0,3,14,33,1,9,0,47,0
Poll: Trump approval bumps up slightly to 40 percent,0,3,2,39,1,8,2,41,0
Party video game banned in UK for having offensive word,0,1,3,43,0,9,0,46,0
"As his stature grows, Isaiah Thomas is dreaming bigger",0,3,3,42,1,8,0,45,0
British turkey tycoon Bernard Matthews dies aged 80,0,1,3,39,0,7,2,42,0
"Suicide car bomber kills seven in Kohat, Pakistan",0,1,3,38,1,7,0,41,0
Northeast digs out from March snowstorm as ski areas revel ,0,3,2,47,0,10,0,49,0
American reported killed while walking on Caribbean beach with her husband,0,2,2,62,0,10,0,64,0
U.S. and Russia Clash at U.N. Over Syria Sanctions,0,3,9,29,4,8,0,38,0
Acclaimed Iranian director won’t attend Oscars due to ‘unjust conditions’ of Trump executive order,0,3,4,78,3,13,0,82,0
A new window into the extraordinary life of Sally Hemings,0,2,3,45,0,9,0,48,0
2016 Presidential Candidates & Election News ,0,3,4,30,1,6,4,34,0
Philippines’ Abu Sayyaf Militants Release Video Claiming to Show Beheading of German Hostage,0,3,11,68,1,12,0,79,0
Ross Kemp: Libya’s Migrant Hell review – a deeply powerful plea,0,3,5,45,3,10,0,50,0
Meet the Donald Trumps of Europe,0,3,4,23,0,5,0,27,0
"Trump Issues Executive Orders Freezing Federal Hiring, Targeting Trade",0,3,9,52,1,8,0,61,0
"Milo Yiannopoulos apologizes for remarks, quits Breitbart ",0,3,3,47,1,7,0,50,0
Broadway Market Café occupied against gentrification,0,1,3,44,0,5,0,47,0
Trump honors widow of fallen US Navy SEAL in emotional moment ,0,3,8,43,0,11,0,51,0
Even With A Struggling Economy Italians Are The World's Healthiest People. Here's What We Can Learn From Them!,0,3,18,71,4,17,0,89,0
Gordon Brown to push 'patriotic' third option for more powerful Scotland after Brexit,0,3,4,67,2,12,0,71,0
"Europe hit by storms, 45 deaths reported",0,1,1,30,1,6,2,31,0
"Jonathan Demme, director of The Silence of the Lambs and Philadelphia, dies aged 73",0,3,6,60,2,13,2,66,0
Western diplomats reportedly back off requiring Iran to promptly disclose pre-2003 nuclear weapons work ,0,3,2,83,1,14,4,85,0
Casey Stoner wins 2011 British MotoGP,0,1,6,22,0,5,4,28,0
Birds attack people in Houston,0,1,2,24,0,4,0,26,0
No Charges for the Texas Pool-Party Cop,0,2,6,26,1,6,0,32,0
"The irony of Derrick Rose, of all people, resisting Knicks’ offense",0,2,4,50,3,10,0,54,0
Tools That Leave Wildlife Unbothered Widen Research Horizons,0,1,8,45,0,7,0,53,0
Fiji suspended from Commonwealth,0,1,2,27,0,3,0,29,0
A Gif Of A White Guy Blinking Has Become A Huge Reaction Meme,0,3,13,36,0,12,0,49,0
Chinese Baby Bonus May Delay India on Population Title: Chart,0,2,9,42,1,9,0,51,0
IMF and EU approve aid for Georgia,0,1,6,22,0,6,0,28,0
Reddit cracking down on hundreds of toxic users,0,2,1,39,0,7,0,40,0
"How a bunny, baskets and eggs got connected with Easter ",0,3,2,43,1,10,0,45,0
Silicon Valley outraged by Apple tax bill: ’Europe is changing rules retroactively’,0,2,4,65,3,11,0,69,0
China posts weakest annual economic growth in 26 years,0,3,1,43,0,8,2,44,0
Jameis Winston Explains Controversial Speech at Elementary School,0,3,7,51,0,7,0,58,0
James Comey to Brief Donald Trump on Russian Hacking Friday ,0,3,8,42,0,10,0,50,0
"Trump: ’I’m Very, Very Strong on Israel’ - Breitbart",0,2,7,31,6,8,0,38,0
"Hillary Clinton’s special 4% tax on multimillionaires, explained",0,2,2,51,3,7,1,53,0
Badass ballerina Misty Copeland rebuts Under Armour CEO's praise of Trump,0,2,9,53,1,10,0,62,0
"Trump stakes out inward, protectionist vision for America",0,3,2,47,1,7,0,49,0
Newspaper Companies to Make More Cutbacks,0,1,5,31,0,5,0,36,0
Labor lashes 'callous' Cormann for saying paid domestic violence leave is 'another cost' to economy,0,3,2,79,4,14,0,81,0
Indian Hockey Captain Vandana Kataria Walks Out Of Movie Hall After It Didn't Play The National Anthem,0,3,17,68,1,16,0,85,0
Poland building collapse leaves three dead,0,3,1,36,0,5,0,37,0
"Even as a Support Rider, Armstrong Receives Most of the Attention",0,1,7,47,1,10,0,54,0
China blasts ‘petty’ Taiwan phone call with Trump,0,3,3,37,2,7,0,40,0
"Without Making a Right Turn, Montoya Wins Talladega Pole",0,1,8,39,1,8,0,47,0
"Anglo American Cuts 19,000 Jobs",0,1,4,17,1,4,5,21,0
A Paris exhibit of Nazi-looted art honors a Europe many fear is under threat again,0,3,4,63,1,14,0,67,0
Turning to the Public for Advice on a Budget,0,1,4,32,0,8,0,36,0
Obama urges Cameron to keep 2% defence spending target,0,3,2,42,1,8,1,44,0
West Virginia Governor Brings Out Actual Bulls**t To Show What He Thinks Of Budget Bill,0,3,15,56,2,14,0,71,0
"Where did this Gonzaga team come from? Well, everywhere",0,3,3,42,2,8,0,45,0
Hackers hold hotel's keys hostage for bitcoin ransom,0,3,1,43,1,7,0,44,0
'Leftovers' co-creator calls Trump an 'agent of destruction',0,2,2,46,5,7,0,48,0
"Amid Passion and Grief, Reminders That Italy Remains a Sleeping Giant",0,1,9,49,1,10,0,58,0
"AMD Acquires IP And Acquihires Nitero Team, Maker Of 60 Ghz Wireless Chips For VR/AR",0,2,20,46,2,14,2,66,0
Study: 30% of kids have two or more sugary drinks a day,0,2,1,39,2,11,2,40,0
Watch 65 years of TODAY fly by in 65 seconds,0,3,6,25,0,9,4,31,0
Welsh soap opera Pobol y Cwm celebrates 35 years on air,0,1,3,40,0,10,2,43,0
US suspects North Korea and Burma participating in 'covert military' activities,0,1,5,62,2,10,0,67,0
"‘Please press 1′ to leave a message about Donald Trump, says House Oversight voice mail",0,2,5,64,3,14,1,69,0
Watch Obama's devastating farewell speech in full,0,3,2,40,1,6,0,42,0
"For Apple’s iPhone Sales, Size Matters ",0,2,6,25,2,6,0,31,0
All Downtown Is Inbounds When 3-on-3 Basketball Invades Spokane,0,1,8,43,2,8,2,51,0
Netanyahu: Sec. Kerry’s Speech paid ‘lip service’ to ‘Palestinian Terrorism’,0,3,6,54,7,9,0,60,0
"Cops recover drugs, cash in underground casino bust",0,2,1,42,1,7,0,43,0
Abu Ghraib prison camp struck by tractor bomb,0,1,2,36,0,7,0,38,0
’Like A Bad Dream’: Turbulence On JetBlue Flight Injures 2 Dozen People,0,2,12,44,3,11,1,56,0
That didn't take long: Trump's press secretary is already a meme,0,2,2,49,3,10,0,51,0
Nettles and other 'thuggish' plants forcing out endangered wildflowers ,0,2,1,59,2,9,0,60,0
Donald Trump And America’s National Nervous Breakdown,0,3,7,39,1,6,0,46,0
'Rogue One: A Star Wars Story' Set to Bag $300 Million Worldwide Box Office Debut,0,3,13,47,4,14,3,60,0
Michigan Wears Practice Uniforms During Big Ten Tournament Game vs. Illinois,0,3,10,55,1,10,0,65,0
Cody Ransom Prepares to Start at Third Base,0,1,6,30,0,7,0,36,0
"Big Sean’s New Video For ""Halfway Off The Balcony"" Is Here",0,2,11,34,3,10,0,45,0
Woman gets evicted from house. Neighbour buys it back and hands her the keys The list,0,3,3,66,1,15,0,69,0
Australian Dollar reaches a 27 year high,0,1,2,30,0,6,2,32,0
"Redskins miss out on in-demand Wade Phillips, who agrees to terms with Rams",0,3,4,57,2,12,0,61,0
"Malcolm Turnbull dissolves Indigenous Advisory Council, but 'commitment remains'",0,3,5,64,3,8,0,69,0
"U.S. President Barack Obama calls North Korea a ""grave threat""",0,1,7,42,4,9,0,49,0
Republicans seek to reduce ethics rules,0,1,1,33,0,5,0,34,0
Twitter announces advertising platform,0,1,1,34,0,3,0,35,0
China Tightens Purse Strings in Guinea and Other African Nations,0,1,8,47,0,9,0,55,0
Video Shows Justin Bieber Getting Smashed Into the Glass at the NHL All-Star Celebrity Shootout,0,3,15,65,1,14,0,80,0
"Grammar schools are now giving priority to disadvantaged pupils, new study shows",0,2,1,67,1,11,0,68,0
"John Lynch Named 49ers GM: Latest Contract Details, Comments and Reaction",0,2,10,49,2,10,2,59,0
Trevor Noah Explains Why Alex Jones' 'Performance' Should Terrify You,0,2,10,47,3,9,0,57,0
Russia Ends Operations in Chechnya,0,1,4,26,0,4,0,30,0
"Trump focuses on first 100 day successes, triumphs in weekly address",0,3,1,53,1,10,3,54,0
Nigeria Super Falcons march on parliament to demand bonuses,0,2,3,48,0,8,0,51,0
21 Cozy And Useful Products That Will Help You Survive Winter,0,3,10,39,0,10,2,49,0
Twitter Star Jonathan Sun’s New Bot Wants to Make Sure You’re Doing OK,0,3,13,43,2,12,0,56,0
Nearly half of America’s overweight people don’t realize they’re overweight,0,2,2,61,3,9,0,63,0
La La Land on course to become UK box office's biggest Oscar winner in years,0,2,6,55,1,14,0,61,0
Bangladesh security tightened following Pilkhana massacre and Bashundhara City fire,0,1,4,70,0,9,0,74,0
Former Iranian President Rafsanjani Dies at 82,0,3,5,33,0,6,2,38,0
"Its Population Falling, Russia Beckons Its Children Home",0,1,8,40,1,7,0,48,0
FBI fears for teenage daughter of man found slain,0,2,3,38,0,8,0,41,0
Senate votes to undo Obama-era internet privacy rules,0,2,2,43,1,7,0,45,0
CIA head John Brennan warns Trump to watch his tongue,0,2,6,38,0,9,0,44,0
F. Scott Fitzgerald house struck by lightning,0,1,3,35,1,6,0,38,0
The train companies pocket millions in compensation for delays,0,2,1,53,0,8,0,54,0
"In Seeking Dollars, Nascar Goes Beyond Logos",0,1,7,30,1,6,0,37,0
"Sanders, Perez unity tour is off to a bumpy start",0,2,2,37,1,9,0,39,0
Pink Floyd has shrimp species named after it that emits a high-pitched snap,0,3,2,60,1,12,0,62,0
Regulators in Madoff Inquiry Defend Actions,0,1,5,33,0,5,0,38,0
"Drake, by starring in Top Boy, you are appropriating British working class culture",0,2,4,64,2,12,0,68,0
"Helicopter crash kills eight, injures one in Louisiana",0,1,2,44,1,7,0,46,0
U.K. Prosecutor Drops Two From Airbus GPT Saudi Investigation,0,3,12,39,2,8,0,51,0
"A Good Run for Mutual Funds, but Questions Remain",0,1,7,33,1,8,0,40,0
Governments Deal New Blow to Drought-Stricken California Farmers,0,1,8,48,1,7,0,56,0
The Resistance Now: activists say ’hell no’ to Republican healthcare bill,0,2,4,56,3,10,0,60,0
"Golf Shoes to Improve Your Style, and  Your Game",0,1,7,31,1,9,0,38,0
"SE Asia air pollution deaths could triple, report says",0,2,3,42,1,8,0,45,0
"Wall Street falls, snapping three-day rally; Wal-Mart weighs",0,2,4,45,4,7,0,49,0
Democratic Trade Union Members Warm To Donald Trump's Populist Pitch,0,3,10,48,1,9,0,58,0
Ex-IMF chief Strauss-Kahn acquitted of pimping charges in France ,0,3,7,47,2,9,0,54,0
Danish and Austrian embassies in Tehran attacked,0,1,3,39,0,6,0,42,0
"Happy Birthday, Pitbull! Here Are His 10 Most Popular Songs on Spotify",0,3,10,45,2,11,2,55,0
"U.S. Needs to Clarify Cyberwar Plans, Panel Says",0,1,8,30,3,7,0,38,0
"Sorry, Weed Probably Won’t Help You Sleep",0,2,7,26,2,6,0,33,0
Google Launches a YouTube Built for Gamers,0,2,6,30,0,6,0,36,0
Tom Coughlin Named Jaguars Executive VP of Football Operations,0,3,9,45,0,8,0,54,0
Bush has a rehearsed tele-conference with US troops in Iraq,0,1,4,45,1,9,0,49,0
The Oil Trade Showing Where OPEC’s Cuts Are Starting to Bite,0,3,13,36,1,10,0,49,0
Dubai Stocks Lead Middle East Gains as Traders Seek Dividends,0,2,9,43,0,9,0,52,0
UN attacks Gbagbo military positions in Ivory Coast,0,1,5,39,0,7,0,44,0
These Tiny Robots May Bring Big Change to Cancer Care,0,3,9,35,0,9,0,44,0
NAACP leader to speak out Monday amid furor over race ,0,2,6,38,0,10,0,44,0
"Despite memo, White House says Michelle Obama program unchanged",0,2,5,49,1,8,0,54,0
US Secret Service discovers third uninvited guest at White House dinner,0,1,6,55,0,10,0,61,0
It’s right for Britain to reach out to Africa – wrong to send Boris Johnson,0,2,5,54,2,14,0,59,0
NBA and Adidas Unveil 2017 NBA All-Star Game Uniforms,0,3,12,28,1,8,4,40,0
Four key Republicans say they will oppose Obamacare repeal if leaves millions uninsured,0,3,3,72,0,12,0,75,0
Alibaba Again Named ‘Notorious Market’ in Blow to Overseas Push,0,3,8,44,2,9,0,52,0
Anthony 'Rumble' Johnson Announces Retirement from MMA After Loss at UFC 210,0,2,13,47,2,11,3,60,0
Texas cop uses patrol car to push burning truck from restaurant ,0,3,1,52,0,11,0,53,0
Scientists have found a way of growing human tissue on apples,0,2,1,50,0,10,0,51,0
"GOP Congressman calls for ""new speaker"" unless Ryan changes course",0,3,5,50,2,9,0,55,0
Mobile ringtone tops the UK singles chart,0,1,3,32,0,6,0,35,0
"The Elm Tree, Spilsby, Lincolnshire: hotel review",0,3,5,35,3,6,0,40,0
DONNISON MANUS PNG PKG R4 by jondonnison,0,3,20,13,0,6,1,33,0
Dylann Roof's Lawyers Look to Have Death Penalty Tossed ,0,2,8,38,1,9,0,46,0
"Big Sean Drops His New Single ""Moves"" And Announces 'I Decided' Album",0,3,12,42,4,11,0,54,0
Photography project captures 'first hello' between parents and newborns - Yahoo,0,3,2,64,3,10,0,66,0
Mapping President Trump's Travel Ban Vs. His Business Interests In Muslim Countries,0,3,12,58,2,11,0,70,0
Jeurys Familia would be damning sign that athletes just don’t get it,0,2,2,54,1,11,0,56,0
Fifth bomb discovered in London after July 21 attacks,0,1,3,40,0,8,2,43,0
OPEC Backs Away From New Output Cuts,0,1,10,20,0,6,0,30,0
London policeman charged over G20 protest death,0,1,2,37,0,6,2,39,0
'Netflix Cheaterz' is the most relatable made-up reality show ever,0,3,2,52,3,9,0,54,0
Syria chemical attack: Andrew Wilkie questions Assad's role in strike,0,3,4,54,2,9,0,58,0
Major earthquake strikes Peru followed by multiple large aftershocks,0,1,2,58,0,8,0,60,0
"Robert Pirsig, Author Of 'Zen And The Art Of Motorcycle Maintenance,' Dead At 88",0,3,13,48,4,13,2,61,0
Volkswagen Executive Arrested for Alleged Role in Emissions 'Conspiracy' ,0,2,7,55,2,9,0,62,0
Trustee in Madoff Case Processing 100 Cases a Week,0,1,6,33,0,8,3,39,0
Citigroup May Find Few Bidders at Its Fire Sale,0,1,8,31,0,8,0,39,0
Beyoncé Might've Subtly Paid Homage To Adele At 'Beauty And The Beast' Premiere,0,3,13,51,3,12,0,64,0
Why Joe Girardi could be perfect fit for new Yankees prospects,0,2,4,48,0,10,0,52,0
North and South Korea to hold second summit,0,1,3,33,0,7,0,36,0
Church's Jesus Statue Beheaded for 2nd Time; Jewish Cemetery Vandalized   Insider,0,2,9,57,2,12,1,66,0
Venezuela asks UN for help as medicine shortages grow severe,0,3,3,48,0,9,0,51,0
Survey: Western Europe wary of supporting Russia’s NATO neighbors,0,3,8,47,2,8,0,55,0
"On Field, Ice or Court, Brothers Were Not Equals",0,1,8,30,2,8,0,38,0
Nick Xenophon's support for company tax cuts hinges on energy action,0,3,2,55,1,10,0,57,0
You'll soon be able to start a Ford via Amazon Echo,0,2,4,36,1,10,0,40,0
Deadly Christmas weekend in Chicago: 12 people fatally shot,0,3,3,45,1,8,2,48,0
Plea Deal Reached for Man Who Fired Shots Inside DC Pizzeria,0,3,11,39,0,10,0,50,0
Adidas Confirms Black/Red Yeezy Boost Release Date,0,2,8,35,1,6,0,43,0
United Airlines pilot removed after going on a bizarre political rant over the intercom,0,3,2,72,0,13,0,74,0
Animal Collective Share 'Kinda Bonkers' New Song: Listen,0,3,8,38,3,7,0,46,0
Record typhoon Chanchu batters south China,0,1,3,34,0,5,0,37,0
"The ""Grey’s Anatomy"" Cast Re-Created That Beyoncé Pregnancy Shoot, Because Why Not",0,3,13,53,5,11,0,66,0
Andrew Wiggins Knocks Down Game-Winning Jumper over P.J. Tucker vs. Suns,0,2,11,47,4,10,0,58,0
"Fire kills six, badly injures seven in Croatia",0,1,2,36,1,7,0,38,0
NFL Introduces Dodgeball as Part of Pro Bowl Skills Showdown,0,3,10,41,0,9,0,51,0
Microsoft just won a $927 million contract to provide tech support to the Department of Defense,0,3,3,73,1,15,3,76,0
Hampshire College returns US flag to full staff; president denies playing politics ,0,3,4,66,1,12,0,70,0
Facing the Reality That the Money Is Gone,0,1,6,28,0,7,0,34,0
‘Puppy Bowl XIII’: Meet the Puppy Players!,0,3,9,23,4,6,0,32,0
Boaty McBoatface is now a yellow submarine,0,3,3,33,0,6,0,36,0
"How Snapchat's first investor found Snapchat when it had less than 100,000 users",0,3,3,57,2,12,6,60,0
'Hollywood' sign changed to 'Hollyweed' in new year prank,0,3,2,43,4,8,0,45,0
"In Fake News Era, Facebook Still Struggling With Bogus Ads",0,3,10,38,1,9,0,48,0
Trump Declines To Publicly Declare His Support For Steve Bannon,0,2,10,44,0,9,0,54,0
The life of a football coach in China,0,3,2,28,0,7,0,30,0
Syria war: G7 rejects sanctions on Russia after 'chemical attack',0,3,3,49,3,9,1,52,0
"Bill Cosby Deposition Admitting Giving Women Drugs Can Be Used In Court, Judge Rules",0,3,14,56,1,13,0,70,0
"All hail the ACC, the new king of bowl season",0,3,4,31,1,9,0,35,0
Court Orders California to Cut Prison Population,0,1,6,36,0,6,0,42,0
Netflix Debuts 'Orange Is the New Black' Season 3 Early,0,2,8,35,2,9,1,43,0
"Man Stabs Guard At High-Security Louvre Museum In Paris, Cops Shoot Him",0,3,13,45,2,11,0,58,0
Obamacare favorability nears record propelled by independents: poll ,0,3,1,58,1,8,0,59,0
Mike Pence Says U.S. Backs NATO but Urges Europe to Boost Military Spending ,0,3,15,46,2,13,0,61,0
"Amid Hebridean vistas, Eigg celebrates its hard-won renewal",0,3,3,47,2,7,0,50,0
"As Tax Havens Acquiesce, Monaco Adopts Banking Standards",0,1,8,40,1,7,0,48,0
"Clear out African migrants, Lega Nord governor orders in stand-off with Rome",0,3,5,58,2,11,0,63,0
Jets' Brandon Marshall: Pain pills killed memories of 3-TD game,0,3,6,44,3,9,1,50,0
Grammy Producer of the Year Nominee Nineteen85 Reveals Stories Behind Drake's Smashes,0,3,10,61,1,11,2,71,0
NBA Top 22 Under 22: Ranking the League's Top Young Stars,0,3,10,31,2,10,4,41,0
Ex-NBA star Shaq furnishes home of Atlanta girl who survived dog attack ,0,3,6,53,1,12,0,59,0
CM Punk Calls Out Hulk Hogan for Twitter Comment After Lightning vs. Blackhawks,0,3,12,54,1,12,0,66,0
Guatemala fire kills 19 girls at shelter for abused teens,0,2,1,45,0,9,2,46,0
Parents reject claim Aboriginal man Jordan Anderson tried to kill himself in prison,0,2,4,67,0,12,0,71,0
"UW-Madison moves to expel Alec Cook, student accused in string of sex assaults",0,3,5,59,2,12,0,64,0
Senior Tibetan Cleric Faces Prison in China,0,1,6,31,0,6,0,37,0
Detroit Lions' late TD doubles sportsbook's loss,0,3,4,36,2,6,0,40,0
Johnson ousts Livingstone in London mayoral election,0,1,3,43,0,6,0,46,0
This Mom Is So Adorably Extra She Stages An Incredibly Stunning Baby Shoot Each Month,0,3,15,56,0,14,0,71,0
LeBron James Goes Off on Youth Basketball Coaches for Not Pushing Players Hard Enough,0,2,13,59,0,13,0,72,0
Prosecutors begin NY State Sen. Hiram Monserrate felony assault case,0,1,7,51,1,9,0,58,0
Fire rips through Russian 'nuclear town' built to supply weapons-grade plutonium,0,2,2,65,3,10,0,67,0
Oil in Alberta spill may be carcinogenic,0,1,2,32,0,6,0,34,0
30 Under 30 Asia 2017: Finance & Venture Capital,0,3,5,25,2,8,8,30,0
Guinness castle in Dublin on the market for $29.5M ,0,2,3,34,2,9,3,37,0
Putting ‘America First’ isn’t the problem. Trump’s version of it is.,0,3,4,48,6,10,0,52,0
Elon Musk Says He Steered Friday’s White House Talk to Travel Ban,0,3,11,42,1,11,0,53,0
"Working longer 'doesn't increase labour productivity', economists say of ATO hours",0,2,4,64,4,10,0,68,0
Billionaire buys $26 million private garage in London ,0,3,2,41,1,8,2,43,0
Google launches online RSS reader,0,1,4,25,0,4,0,29,0
DeMarcus Cousins Trade Rumors: Kings Shopping Star; Pelicans Interested,0,3,10,51,2,8,0,61,0
NBA star hurls profanities at reporter in outburst caught on camera,0,3,3,54,0,10,0,57,0
Russian plane crash: 13 bodies reportedly recovered in Black Sea,0,3,3,49,1,9,2,52,0
Thieves Broke Into Nick Young's House and Stole a Safe Full of Cash and Jewelry,0,3,11,53,1,14,0,64,0
"Amazon.com de-ranks LGBT books, blames ""glitch""",0,1,5,32,5,5,0,37,0
"A festival air, and unease, hang over pre-convention Cleveland",0,2,2,49,3,8,0,51,0
Gun battle between gang members and police kills 12 in Rio de Janeiro,0,1,3,52,0,12,2,55,0
Andrew Sayers resigns National Museum of Australia directorship,0,1,5,51,0,7,0,56,0
"A 9,500-year-old skull gets a 3D makeover",0,2,2,25,3,6,5,27,0
Woman attacked by shark in British territory St Helena,0,2,4,42,0,8,0,46,0
Kabul Hospital Attack: Afghanistan Authorities Detain 24 People,0,3,7,46,1,7,2,53,0
Boom lands $33 million to test supersonic aircraft,0,3,1,39,1,7,2,40,0
Amy Schumer's message to body shamers: I am strong and proud of how I live my life,0,3,4,60,2,16,0,64,0
"Hot air balloons cross Channel to France in a world record attempt, in pictures",0,3,3,62,1,13,0,65,0
"Carrie Fisher, Actress Who Played Princess Leia in ‘Star Wars,’ Dies",0,3,10,44,4,10,0,54,0
"Ignore Ann Coulter. She’s a boring performance artist, and she’s gaming us all.",0,2,4,58,5,12,0,62,0
Explosion sinks Indian Navy submarine,0,1,3,30,0,4,0,33,0
Romanian artists auction off their works for tsunami victims,0,1,1,51,0,8,0,52,0
North Korea Maintains Its Tough Stance,0,1,6,27,0,5,0,33,0
David Letterman to Induct Pearl Jam Into Rock Hall of Fame After Illness Forces Neil Young to Cancel,0,3,15,68,0,17,0,83,0
"Rhode Island offshore wind farm, first in the U.S., to power thousands of homes",0,2,4,58,4,13,0,62,0
David Moyes will face no action from Sunderland after threat to 'slap' female reporter,0,2,3,68,2,13,0,71,0
Clothing Makers Exceed Quarterly Expectations,0,1,5,36,0,4,0,41,0
"Robert L. Hulseman, Inventor of the Solo Cup, Dies at 84 ",0,2,7,34,3,11,2,41,0
"Woman killed in house fire in South Yorkshire, England",0,1,4,41,1,8,0,45,0
Bill Viola video installation heralds new national exhibition space for faith art,0,3,2,68,0,11,0,70,0
Internet Is Drooling Over This Incredible Love Story Of Two Babies Born In The Same Hospital,0,3,16,61,0,15,0,77,0
"For Alexandra Lebenthal, Sale of Family Business Marks End of Latest Chapter for a Storied Name ",0,3,12,67,1,16,0,79,0
The 30 Funniest Women in Hollywood History,0,3,5,29,0,6,2,34,0
Matchmaking a First Mate for Rachel Alexandra,0,1,5,34,0,6,0,39,0
NASA Crewed Mission To Venus Would Pave Way For Human Mission To Mars,0,2,16,41,0,12,0,57,0
Samsung releases its first tablet computer,0,1,1,36,0,5,0,37,0
Polish pilgrims killed in French bus crash,0,1,2,34,0,6,0,36,0
New Zealand Faces Leadership Battle After Shock Resignation of Prime Minister John Key,0,3,12,62,0,12,0,74,0
Here’s How Much Smaller The Crowd At Trump’s Inauguration Is Than Obama’s,0,3,12,47,3,11,0,59,0
Athletes Say Drug-Test Rule Violates Right to Privacy,0,1,8,37,1,7,0,45,0
Republicans Give Rich Investors a Tax Break in Obamacare Revamp,0,3,8,46,0,9,0,54,0
"In war-torn western Mosul, a determined few remain",0,2,2,39,2,7,0,41,0
Asia Gives Metro Haven From Economic Storm,0,1,7,29,0,6,0,36,0
Gen. Barry McCaffrey: Michael Flynn’s Tweets ‘Border on Demented’,0,3,9,43,5,8,0,52,0
Third union separates from AFL-CIO,0,1,7,22,1,4,0,29,0
Obama's Final Hawaiian Vacation as President ,0,3,5,33,1,6,0,38,0
WFCA's Svyatoslav Shabanov Knocks Out Ali Dikaev in 13 Seconds with Brutal Kick,0,2,13,51,1,12,2,64,0
Meet The Thai Trans Woman And Children Behind These Stunning Photos,0,3,11,46,0,10,0,57,0
A Haribo factory is coming to the U.S. because gummy bear dreams do come true,0,2,4,57,2,14,0,61,0
Space Shuttle Discovery launches on final mission,0,1,3,40,0,6,0,43,0
Marshawn Lynch Will Play a Villain in 'Call of Duty: Black Ops III',0,3,12,40,3,12,0,52,0
Democrats reject Obama on trade,0,3,2,25,0,4,0,27,0
Texas man pays traffic fine with two buckets full of pennies. Is he a hero — or a jerk?,0,2,2,64,3,18,0,66,0
999 call handling system crash left dispatchers scrawling down details of 2.5k emergencies,0,2,0,72,1,12,5,72,0
"Trump Targets Muslims, Refugees In New Executive Order Issued On Holocaust Remembrance Day",0,2,13,64,1,12,0,77,0
"Mashable on Periscope: ""The Mashable House at #SXSW is open! #MashHouse""",0,2,11,45,6,10,0,56,0
"Sarkozy makes Clint Eastwood's day; actor becomes ""Légion d'honneur"" Commander",0,1,5,59,5,9,0,64,0
Man Pretending To Be Justin Bieber Allegedly Extorted A Child Into Sending Him Nude Photos,0,3,15,61,0,14,0,76,0
"Bucks trade Miles Plumlee for Hornets' Spencer Hawes, Roy Hibbert",0,3,8,46,2,9,0,54,0
Here’s how vertical video is disrupting the filmmaking industry (Paid Content by Nespresso),0,3,4,72,3,12,0,76,0
Donald Trump 'lied to journalists about softening immigration stance to manipulate coverage',0,3,2,77,2,11,0,79,0
Top two aides quit US presidential candidate McCain's campaign,0,1,5,48,1,8,0,53,0
Samsung Makes Radical Galaxy Note 8 Design Changes,0,3,7,35,0,7,1,42,0
Tropical storm Otto moves into central Atlantic,0,1,3,38,0,6,0,41,0
Painting of Johann Sebastian Bach returns home to Leipzig,0,3,5,44,0,8,0,49,0
"Nigerian Jet Mistakenly Bombs Refugee Camp, Killing Scores ",0,3,8,42,1,8,0,50,0
"Girl found dead in truck in Northamptonshire, England",0,1,3,42,1,7,0,45,0
"Chuck Berry, rock 'n' roll legend, mourned by the world",0,2,2,40,4,9,0,42,0
Chinese Question Police Absence in Ethnic Riots,0,1,6,35,0,6,0,41,0
Dutch prosecutors seize gold bars and cars in 'tax evader' raids,0,2,1,51,2,10,0,52,0
"ESPN Is Laying Off 100 Employees, Including Many On-Air Personalities",0,2,13,42,2,9,3,55,0
"Marathon runner addresses Toronto, bringing attention to autism",0,1,2,53,1,7,0,55,0
Brexit Bulletin: A Snap Election,0,3,5,22,1,4,0,27,0
"McDonald's to launch ordering app, expand delivery",0,2,2,40,2,6,0,42,0
'Despicable Me 3' Trailer Introduces Gru's New Villain (And His '80s Dance Moves),0,2,11,49,6,12,3,60,0
How $500M of Yankees mistakes led to this new age,0,2,3,33,1,9,3,36,0
Marine veteran who lost both legs in Afghanistan sworn in as NY police officer ,0,3,4,61,0,14,0,65,0
"Kansas left early from the Big 12 tournament, and that might or might not mean anything",0,3,2,67,1,15,2,69,0
Stephen Curry passes Kobe Bryant for top jersey sales in China,0,3,5,47,0,10,0,52,0
Roy Keane has complete faith in Robbie Keane for Ireland’s qualifier,0,3,5,52,1,10,0,57,0
Granville train disaster: NSW Government to apologise to victims' families 40 years on,0,3,5,65,2,12,2,70,0
Gretchen Carlson Will Make First TV Anchoring Appearance Since Roger Ailes Lawsuit,0,3,13,58,0,11,0,71,0
Ruling Favors Jackie Evancho’s Transgender Sister in Bathroom Case ,0,2,8,49,1,9,0,57,0
President Obama speaks to U.S. troops in final Christmas visit,0,3,5,46,2,9,0,51,0
"Donald Trump Will Not Release Tax Returns, White House Adviser Says",0,3,11,45,1,10,0,56,0
South Korea Agrees to a Call for Talks From North Korea,0,1,8,37,0,10,0,45,0
Vote: Who will win Super Bowl LI?,0,2,6,19,2,6,0,25,0
"CSIRO, Energy Networks Australia back emissions trading scheme over RETs to lower power prices",0,2,11,69,1,13,0,80,0
First snowfall of the season impacts the Northeast US,0,1,4,41,0,8,0,45,0
Dave Chappelle Wants Comedians To Stop Making The Same Donald Trump Jokes,0,3,12,50,0,11,0,62,0
"Live updates: Decision day for health care, Trump and Russia",0,2,4,45,2,9,0,49,0
Some results released in recount of Zimbabwe election results,0,1,2,51,0,8,0,53,0
"Jimmy Butler, Dwyane Wade come off bench as discipline in defeat",0,3,4,49,1,10,0,53,0
GOP congressman: Reforming Dodd-Frank is a 'this-year priority' for Trump,0,3,7,52,5,9,0,59,0
"‘Homeland’ Season 6, Episode 1: Carrie’s a Civilian — and a Brooklynite ",0,3,6,46,6,12,2,52,0
Is year 12 worth it? High school students battle pressures after self-documenting final year,0,3,2,73,2,13,2,75,0
The NCAA tournament is about to wake up,0,2,5,27,0,7,0,32,0
Ryan Tedder & Camila Cabello Reveal That They're Collaborating,0,3,8,44,2,8,0,52,0
Chinese chemical plant explosion threatens water supply for major city,0,1,1,60,0,9,0,61,0
Boko Haram Terrorists Release 82 Kidnapped Chibok Girls,0,2,7,39,0,7,2,46,0
How a Pennsylvania teenager feels about the future under Donald Trump,0,3,4,55,0,10,0,59,0
This iconic 'Game of Thrones' actor will feature in 'Peaky Blinders' Season 4,0,3,6,54,4,12,1,60,0
Live San Bernardino shooting: multiple casualties in primary school 'murder-suicide' ,0,3,3,68,4,10,0,71,0
Jennifer Lopez Speaks Out Against Trump's Immigration Ban: 'We Are All Immigrants',0,3,12,55,4,11,0,67,0
US election recount: Greens change tactics in Pennsylvania bid,0,3,4,49,1,8,0,53,0
"After Affair, Senator Resigns Leadership Job",0,1,6,32,1,5,0,38,0
"Johnny Depp’s Exes: Actor a ’Soft Person,’ Would ’Never’ Physically Assault a Woman - Breitbart",0,2,12,61,8,14,0,73,0
Marian Hill Goes 'Down' Again & Again in New Video: Watch,0,3,9,34,4,10,0,43,0
Kurds Have Bigger Prize in Mind After Political Gains in Turkey ,0,2,9,44,0,11,0,53,0
We will deeply miss Carrie Fisher giving us the middle finger,0,2,3,48,0,10,0,51,0
"Trump to celebrate Andrew Jackson’s 250th birthday in Nashville, attend a rally",0,3,4,59,2,11,3,63,0
Melissa McCarthy makes a better Sean Spicer than Sean Spicer on 'SNL',0,3,10,46,2,11,0,56,0
Dave Grohl Broke His Leg During A Show And Continued Playing Like A Total Badass,0,2,15,51,0,14,0,66,0
"Sony Is Planning To Scrap The Kapil Sharma Show, Might Offer Sunil Grover His Own Show!",0,3,16,54,2,15,0,70,0
Shutdown threat returns after ObamaCare repeal meltdown ,0,2,3,46,0,7,0,49,0
Snapchat files for $3 billion IPO,0,3,4,22,1,5,1,26,0
How About a Stimulus for Financial Advice?,0,1,5,30,1,6,0,35,0
CargillVoice: 5 Things You Need To Know About Food Banks,0,3,10,35,1,9,1,45,0
"Monterey Pop, the Rock Festival That Sparked It All, Returns ",0,3,9,40,2,10,0,49,0
Blac Chyna and Rob Kardashian Have Reportedly Set a Wedding Date,0,3,9,45,0,10,0,54,0
Israel is relaxing its laws on marijuana use,0,2,1,36,0,7,0,37,0
Index of Economic Activity Declined in March,0,1,5,33,0,6,0,38,0
California rancher cleared to shoot mountain lion preying on his herds,0,2,1,59,0,10,0,60,0
Jennifer Lawrence apologises for Hawaii 'butt-scratching' story,0,3,3,51,3,6,0,54,0
McCain and Obama participate in Saddleback Church forum,0,1,5,43,0,7,0,48,0
"Renamed and shamed: taking on Britain's slave-trade past, from Colston Hall to Penny Lane",0,3,6,66,4,13,0,72,0
4 Pearls Of Wisdom From The Reigning Martial Arts Action Movie Star Of The West - Scott Adkins,0,3,16,59,1,17,1,75,0
West Virginia mom accused of killing young sons by setting fire to their beds,0,3,2,62,0,13,0,64,0
"For Hard-Liners, Even The Trump EPA Isn't Doing Enough To Undermine Climate Science",0,2,16,52,3,12,0,68,0
Report on Hope Solo's domestic violence charges raises new questions about U.S. Soccer,0,3,6,65,3,12,0,71,0
"Ivanka Trump's clothing is selling so poorly, the company making it secretly re-labelled it",0,3,2,73,3,13,0,75,0
A Photographer Took Photos Of Dying Mermaids To Show How Much We’re Polluting The Ocean With Plastic Bottles,0,3,18,72,1,17,0,90,0
Your internet data is absolutely a national security issue,0,3,1,49,0,8,0,50,0
Buffett Says Immigrants Help ‘Miraculous’ Story of America,0,3,7,42,2,7,0,49,0
Oregon set to double recycling rate to 10 cents a can ,0,3,1,40,0,11,2,41,0
How Jeremy Lin went from the Garden to the pages of the Hulk,0,2,5,43,0,12,0,48,0
DOJ stirs free-speech fight after demanding libertarian site turn over info on commenters ,0,2,3,73,1,13,0,76,0
Destinations The fascinating hidden history of London's lost rivers,0,3,3,55,1,8,0,58,0
Israel Lifts Restrictions On Settlement Building In East Jerusalem,0,3,9,49,0,8,0,58,0
Trump business terminates three overseas projects,0,3,1,43,0,5,0,44,0
Can the US break its cycle of gun control failure?,0,2,3,37,1,9,0,40,0
Business Leaders and the Mixed Feelings They Inspire,0,2,6,39,0,7,0,45,0
Obama commutes Chelsea Manning’s sentence [Video],0,3,4,37,3,5,0,41,0
Finger-Pointing Across Washington Over A.I.G. Bonuses,0,1,9,35,4,5,0,44,0
"The couple with a 63-year age gap: African bride, 29, comes under fire after marrying 'wealthy' 92-year-old businessman",0,2,2,86,8,17,6,88,0
US Supreme Court judge Ginsburg undergoes surgery for pancreatic cancer,0,1,5,57,0,9,0,62,0
"Brandon Phillips to Be Traded to Braves: Latest Details, Comments and Reaction",0,2,9,56,2,11,0,65,0
Trump calls judge’s halt on immigration 'ridiculous;' says will be 'overturned!' ,0,3,1,62,7,11,0,63,0
Some Find Hope for a Shift in Drug Policy,0,1,6,27,0,8,0,33,0
"This Cathedral’s Stairs Have Been Covered In 1,000 Cardboard Cutouts Of Nicki Minaj’s Ass",0,3,13,56,3,13,4,69,0
Carlos Santana rocks the National Anthem during NBA Finals Game 2 ,0,3,9,45,0,11,1,54,0
Trump's America Donald Trump's impact on the world after 100 days is yet to become clear,0,3,4,64,2,15,3,68,0
"Abducted four-year-old Missouri girl found alive, person of interest shoots himself",0,1,2,68,3,10,0,70,0
Ban Ki-moon Returns to South Korea in Bid to Lead It,0,3,8,33,1,10,0,41,0
The MMA fights we'd like to see in 2017,0,3,4,22,1,8,4,26,0
A Timeline of President Trump's Immigration Executive Order and Legal Challenges ,0,2,9,60,1,11,0,69,0
"Sugar silos at centre of Georgia, US refinery blast that killed 13 demolished",0,1,4,58,1,12,2,62,0
"High School Tries Shaming Boy, Demanding He ’Tolerate’ Undressing with Girls to ’Make it Natural’ - Breitbart",0,2,13,74,6,16,0,87,0
"One dead after bus and bicycle crash in Hampshire, England",0,1,3,45,1,9,0,48,0
EU mobile phone roaming cost-cuts 'a step closer',0,3,2,37,3,7,0,39,0
Ed Sheeran Has This To Say To Children Who Suffer From Stuttering: “Embrace Your Weirdness”,0,2,15,59,3,14,0,74,0
Mexico Vows $50 Million Legal Fund to Fight U.S. Deportations,0,3,9,38,3,9,2,47,0
London killer's final hours ,0,2,1,22,1,4,0,23,0
Alabama governor reportedly planning to resign over sex scandal ,0,3,1,54,0,9,0,55,0
Blair denies Iraq pullout,0,1,2,20,0,3,0,22,0
"Ric Marlow, 'A Taste of Honey' Songwriter, Dies at 91",0,2,7,31,4,9,2,38,0
European Stocks Trim 2016 Decline as FTSE 100 Closes at Record,0,3,10,35,0,10,7,45,0
"Companies Plow Ahead With Moves to Mexico, Despite Trump’s Pressure",0,3,9,47,2,9,0,56,0
Milo Yiannopoulos’s Trumpian rise shows how the GOP is stuck in opposition mode,0,2,6,60,1,12,0,66,0
Texas cops shut down girls' 'illegal' lemonade stand,0,2,1,41,3,7,0,42,0
"These two baby boys are twins, but an Italian court says they aren’t brothers",0,3,2,60,2,13,0,62,0
The Russian Ambassador To The UN Has Died Unexpectedly In New York,0,2,13,42,0,11,0,55,0
Nintendo’s Switch Console Has Strong First Month in the U.S. ,0,3,9,39,3,10,0,48,0
Napster founder Shawn Fanning introduces new file-sharing project,0,1,3,54,1,7,0,57,0
Jared Kushner And The Anti-Nepotism Statute That Might Keep Him From The White House,0,2,15,55,1,13,0,70,0
"Ontario Votes 2007: Interview with NDP candidate Sheila White, Scarborough-Rouge River",0,1,11,58,3,10,4,69,0
Malcolm Butler Reportedly Could Be Traded by Patriots to Land Brandin Cooks,0,3,10,54,0,11,0,64,0
2 Money Managers Held in New Wall St. Fraud Case,0,1,8,29,1,9,1,37,0
Pakistani journalist found dead in home,0,1,1,33,0,5,0,34,0
How Jaws misrepresented the great white,0,2,2,32,0,5,0,34,0
Women’s March Organizers Are Calling For A Women’s Strike,0,3,9,38,2,8,0,47,0
‘Rogue One: A Star Wars Story’ Rakes In $155 Million in North America,0,3,11,39,4,12,3,50,0
Horowitz: Dems Putting Gov't in 'A Civil War Situation' in Wake of Wiretap Allegations  Insider,0,3,12,64,4,15,0,76,0
"Trump loyalists sound alarm over ‘RyanCare,’ endangering health bill",0,2,3,54,3,8,0,57,0
"Boy, 17, wakes up on the way to his own FUNERAL in India after family assumed lethal dog bite had killed him ",0,3,9,74,2,22,2,83,0
LeBron James to Open Public School in Akron for At-Risk Children,0,3,10,43,1,10,0,53,0
Tinder trolls CES by pitching a regular reality headset,0,3,4,43,0,8,0,47,0
"New US UN envoy warns allies: 'For those that don't have our back, we're taking names'",0,3,6,59,6,15,0,65,0
Warren Buffett,0,3,2,11,0,1,0,13,0
Kendall Jenner And Cara Delevingne Pose Topless In Goofy Photo,0,3,10,43,0,9,0,53,0
Super Mario Run No Longer Highest Grossing App in Any Nation,0,2,10,40,0,10,0,50,0
The Eiffel Tower will go dark in solidarity with Aleppo,0,2,4,42,0,9,0,46,0
Trump Says United States Can ‘Solve’ North Korea Without China,0,2,10,41,2,9,0,51,0
Trump ready to address North Korea nuclear program with or without China ,0,3,4,57,0,12,0,61,0
Spotify to Host Podcast About Hip-Hop Exec Chris Lighty,0,3,9,37,1,8,0,46,0
Fans mourn death and celebrate life of Michael Jackson around the world,0,1,3,57,0,11,0,60,0
NBC Making the Most of Its Super Bowl Coverage,0,1,9,29,0,8,0,38,0
Woman’s Headphones Explode During Flight From China to Australia,0,2,8,47,1,8,0,55,0
Coroner Says George Michael Died of Natural Causes,0,3,7,36,0,7,0,43,0
Lawsuits in Madoff Case Add to Details About Fraud,0,1,7,35,0,8,0,42,0
China Struggles to Shake Up Salt Monopoly,0,2,6,29,0,6,0,35,0
Arena Football League Player Trucks Mascot in End Zone,0,3,8,38,0,8,0,46,0
"Massive Texas Sinkhole Swallows Two Cars, Killing Sheriff's Deputy",0,2,9,47,2,8,0,56,0
Football corruption: Who bought the Copa America?,0,2,4,37,2,6,0,41,0
"Digital Casting, Poised for a Role Beyond Hollywood",0,1,6,37,1,7,0,43,0
US state of Arizona signs into law controversial immigration bill,0,1,3,53,0,9,0,56,0
"Some car dealers misleading consumers over safety ratings, ANCAP tells ACCC",0,3,10,54,1,10,0,64,0
Kim Jong Un’s Estranged Brother Murdered in Malaysia,0,3,7,37,1,7,0,44,0
"To understand the Trump presidency, we must decipher Ivanka",0,2,3,47,1,8,0,50,0
White House chief strategist Stephen Bannon no longer part of National Security Council,0,3,7,68,0,12,0,75,0
Senior U.S. Diplomat Visits Myanmar,0,1,6,23,2,4,0,29,0
Rescuers hunt Brazilian plane carrying four UK passengers,0,1,4,46,0,7,0,50,0
"Sinkhole reported in Buffalo, New York",0,1,4,28,1,5,0,32,0
White Night Melbourne: City's iconic buildings and streets ablaze with light shows,0,2,4,65,2,11,0,69,0
$400 Billion Fund Manager Is Bullish on Trump-Proof India,0,2,8,36,2,8,3,44,0
Here’s Why The Left Is So Desperate To Defend The New Feminist Ghostbusters - Breitbart,0,2,14,57,2,14,0,71,0
"Sorry, “skeptics”: Global warming may not be so great for plant life after all",0,2,2,59,4,13,0,61,0
Deadly flooding in Pakistan kills hundreds,0,1,2,35,0,5,0,37,0
FBI investigates AT&T security breach,0,1,6,26,1,4,0,32,0
"SZA's Debut Album: How Rihanna, Rick Rubin & Sleepaway Camp Influenced It",0,3,13,45,4,11,0,58,0
US authorities refuse to reveal how Russian ambassador to the United Nations died,0,3,5,64,0,12,0,69,0
Racing 92 and Stade Francais merger off,0,2,3,28,0,6,2,31,0
Goldman Sachs Powers Dow to 20000 Milestone ,0,2,5,27,0,7,5,32,0
Europe is trolling the hell out of Trump one hilarious video at a time,0,3,2,55,0,13,0,57,0
This Big Short Threatens to Be a Big Bust,0,2,7,26,0,8,0,33,0
"Larry Sanders, Cleveland Cavaliers Reportedly Agree to Contract",0,3,7,48,1,7,0,55,0
Did BBC's Nick Robinson call Philip Hammond a very rude name? Listen for yourself,0,3,9,57,2,13,0,66,0
"Six people die in bus crash near Phoenix, Arizona",0,1,3,37,1,8,0,40,0
U.S. considers whether ISIS wives playing key role in operations,0,2,6,47,2,9,0,53,0
#Distractinglysexy Twitter campaign mocks Tim Hunt's sexist comments,0,3,4,55,2,7,0,59,0
Experts Agree Trump’s Ethics Plan Falls Short,0,3,7,31,1,6,0,38,0
"'Marvel vs. Capcom Infinite' teaser reveals Captain Marvel, Iron Man",0,3,7,48,4,9,0,55,0
Kurmanbek Bakiev sworn in as president of Kyrgyzstan,0,1,3,42,0,7,0,45,0
Cerberus Loads Up on European Property Debt ,0,3,6,31,0,7,0,37,0
Tencent Apologizes for Sexually Graphic Game at Annual Party,0,2,7,45,0,8,0,52,0
Over the Wall and Under the Microscope in the Bronx,0,1,5,37,0,9,0,42,0
Tiger Woods bows out of Masters just before 20th anniversary of his 12-shot triumph,0,3,3,62,1,13,4,65,0
The First House Antoni Gaudí Ever Designed Is Now An Incredible Museum,0,3,12,47,0,11,0,59,0
Treaty to Strengthen E.U. Gets Another Chance,0,1,7,30,2,6,0,37,0
DHS Draft Report Casts Doubt on Extra Threat From ‘Travel Ban’ Nationals in U.S.,0,3,15,48,4,13,0,63,0
Cheteshwar Pujara Breaks Gautam Gambhir's Record For Most Test Runs In A Season By An Indian,0,2,16,60,1,15,0,76,0
Every Bad Thing We Will Avoid By Rejecting the Paris Climate Accords - Breitbart,0,2,12,54,1,13,0,66,0
"Police identify British-born attacker, victim count rises to four",0,2,2,53,2,8,0,55,0
Depeche Mode's Martin Gore: 'The alt-right liking us is baffling',0,3,5,46,5,9,0,51,0
Ryan Reynolds Is Bringing Deadpool to Hugh Jackman's 'Logan' (UPDATE),0,3,14,41,5,9,0,55,0
Judgment day for South Korean President Park Geun-hye,0,3,6,39,1,7,0,45,0
Ivy league school accidentally emails nearly 300 acceptance notices ,0,2,1,55,0,9,3,56,0
The Top Movies Of The Last Four Years Star Women,0,3,10,29,0,9,0,39,0
Hereâs every law Trump has signed in his first 100 days,0,3,2,40,2,10,3,42,0
Andy Murray: Scot remains third in world tennis rankings,0,2,3,44,1,8,0,47,0
"‘Ninjas came to my home and killed my family,’ boy tells police after Alaska slayings",0,2,2,66,3,14,0,68,0
Here's what Absolut Vodka is looking for in their next 'billion dollar nose',0,3,3,58,3,12,0,61,0
Aled Carey: Australian produces the perfect over with six wickets in six balls,0,2,3,62,1,12,0,65,0
"After calling their votes a ‘whitelash,’ Van Jones finds a new role reaching out to Trump supporters",0,3,4,77,3,16,0,81,0
Andalusian Strawberry Harvest a Battleground,0,1,4,36,0,4,0,40,0
"Dylann Roof, Addressing Court, Offers No Apology or Explanation for Massacre ",0,2,9,55,2,11,0,64,0
Netflix is all set to hit a major milestone this weekend,0,3,1,45,0,10,0,46,0
Jennifer Lopez on Black Eye Photo: 'Sometimes Work Can Be Rough',0,2,10,41,3,10,0,51,0
Oil company BP to pay for Gulf of Mexico spill,0,1,5,32,0,9,0,37,0
The invasion of the yellow spiders! Clusters of hundreds of baby arachnids spotted up and down the country,0,2,2,86,1,17,0,88,0
China Emerges as Powerhouse for Biotech Drugs,0,3,5,34,0,6,0,39,0
NBA playoffs: Cavs-Warriors III?,0,2,8,18,3,3,0,26,0
Princess Diana lives on in her sons - what Prince Harry and William  have done this week proves that,0,2,5,75,1,19,0,80,0
Lost tomb of 'Gladiator' real life Roman inspiration found,0,1,3,45,2,8,0,48,0
Dad Of First Male Maybelline Model Has Perfect Response To Bigoted Blogger,0,3,12,51,0,11,0,63,0
What will immigration look like post-Brexit?,0,2,2,35,2,5,0,37,0
"Holiday shipping deadlines for UPS, FedEx and major retailers",0,3,6,46,1,8,0,52,0
Trump's America Donald Trump: White House bars several major news outlets from informal press briefing,0,2,6,80,2,14,0,86,0
Dudu Tassa and the Kuwaitis on Radiohead Tour: 'This Is a Chance That You Don't Miss',0,3,12,54,4,15,0,66,0
"Finding Purpose in Serving the Needy, Not Just Haute Cuisine",0,1,8,42,1,9,0,50,0
Someone Has Made The Trump Sandwich A Reality And It Matches His Personality Perfectly!,0,3,14,59,1,13,0,73,0
"Mike WiLL Made-It Enlists YG, Migos & 21 Savage for 'Gucci on My': Listen",0,3,14,38,6,13,2,52,0
Arrest of 'dreamer' immigrant could be first under Trump to defy DACA ,0,3,6,50,2,12,0,56,0
Friends Again? How Everyone Reacted to Kevin Durant Throwing Russell Westbrook an Alley-Oop,0,3,12,65,2,12,0,77,0
Mark Latham: Sky Australia host fired for offensive comments,0,3,4,47,1,8,0,51,0
I know what it’s like to care for a son with microcephaly. My child is 53 years old.,0,2,2,60,3,17,2,62,0
UFC 209 Woodley vs. Thompson: Bleacher Report Main Card Staff Predictions,0,3,11,47,2,10,3,58,0
Japan Post to Take $3.6 Billion Write-Down Over Toll Holdings,0,3,9,38,3,9,2,47,0
"Christmas Arrives Early For Saif-Kareena, The Couple Has Been Blessed With A Baby Boy!",0,3,15,55,3,13,0,70,0
2007 Twenty20 World Championship: West Indies vs South Africa,0,1,7,39,1,8,6,46,0
Sony/ATV Execs Focus on Songwriting Skills at Billboard Latin Music Conference 2017,0,2,12,55,1,11,4,67,0
Frank Ocean Premieres 'Chanel' & A$AP Rocky Remix on 'Blonded' Radio: Listen,0,2,12,46,7,11,0,58,0
Republicans warn that Trump’s critique of Clinton’s ‘look’ fuels accusations of sexism,0,2,3,68,4,11,0,71,0
King v. Burwell: How one Supreme Court case could unravel Obamacare,0,3,6,49,2,10,0,55,0
Suspect Arrested In Connection With Jewish Community Bomb Threats,0,3,9,48,0,8,0,57,0
A Newly Minted MacArthur Genius on the Financially ’Invisible’,0,2,8,44,2,8,0,52,0
Spectacular 'Super Bloom' Is Just Days Away In This California Desert,0,3,11,46,2,10,0,57,0
"Don't Eat If You Don't Want To Pay, Say Restaurant Owners After Government Made Service Charges Optional",0,3,17,68,3,16,0,85,0
Oil Companies’ Hottest Market Is Low on Fuel ,0,3,7,29,1,8,0,36,0
German President Re-elected,0,1,3,21,1,2,0,24,0
Indian Olympic body stirs storm over Suresh Kalmadi role,0,2,4,44,0,8,0,48,0
Kansas shooting: Widow of Indian man calls for hate crime action,0,2,3,50,1,10,0,53,0
President Obama renews his push to close Guantanamo detention facility,0,1,3,58,0,9,0,61,0
"Rolf Harris indecently assaulted blind, disabled woman in hospital, London court hears",0,3,3,70,2,11,0,73,0
Giants Respond to Report Eli Manning Was Involved in Memorabilia Scheme,0,2,9,52,0,10,0,61,0
Hillary Clinton forms presidential exploratory committee,0,1,2,49,0,5,0,51,0
6 things the president can do without needing anyone’s approval,0,2,0,52,1,9,1,52,0
Third person charged in stabbing death of Conn. man last seen at NYC party,0,3,5,55,1,13,0,60,0
"Armstrong Begins Comeback, Finishing 64th in Australia",0,1,5,40,1,6,2,45,0
A conversation with Mayim Bialik about her shy cat and pet adoption,0,3,3,53,0,11,0,56,0
This Ex-Child Soldier Went Undercover To Save The Gorillas,0,2,10,39,1,8,0,49,0
13 dead as cargo plane crashes in Congo,0,1,1,29,0,7,2,30,0
"Out of Many Televisions, One Common Experience",0,1,6,33,1,6,0,39,0
Bomb scare can’t dampen the festivities as Oxford vanquish Cambridge,0,3,3,55,1,9,0,58,0
Shift on Marijuana Policy Delays Sentencing,0,1,5,33,0,5,0,38,0
"During his political rise, Stephen K. Bannon was a man with no fixed address",0,3,4,57,2,13,0,61,0
Bishop Offers Apology for Holocaust Remarks,0,1,5,33,0,5,0,38,0
William Shatner's guide to Mars,0,3,3,23,1,4,0,26,0
There is nothing fair about the UK’s rising train fares,0,3,3,42,1,9,0,45,0
"Tom Hardy chases down moped thief, declares: 'I caught the c***'",0,2,3,44,7,10,0,47,0
"3 dead, 4 missing after Vietnamese cargo ship sinks in South China Sea",0,1,4,51,1,12,2,55,0
The forecast won’t budge — rain seems inevitable for Trump’s inauguration,0,3,2,58,3,10,0,60,0
Donald Trump Pays Respects to Navy SEAL Slain in Yemen,0,3,11,34,0,9,0,45,0
2007/08 Bundesliga: MSV Duisburg vs. Bayern Munich,0,1,7,28,3,6,6,35,0
Perth Glory demoralises Adelaide United in 5-0 A-League win,0,3,6,41,2,8,2,47,0
Israel to release activists arrested in flotilla raid,0,1,1,45,0,7,0,46,0
American film director John Hughes dies at age 59,0,1,3,36,0,8,2,39,0
Thirteen-year-old girl rescues four younger siblings from burning home,0,2,1,59,2,8,0,60,0
Miami man shot in the face after honking horn at other driver,0,3,1,49,0,11,0,50,0
Hacks to Survive a 20-Hour Flight—Without a Laptop or Tablet,0,3,7,40,2,9,2,47,0
"Saudi Arabia, US companies reach $55 billion in deals",0,2,4,37,2,8,2,41,0
Melanoma Rates Have Dropped in New England,0,2,6,30,0,6,0,36,0
Naomi Campbell testifies against former Liberian president,0,1,3,49,0,6,0,52,0
Afghan Villagers Describe Chaos of U.S. Strikes,0,1,7,32,2,6,0,39,0
NATO oil tanker torched in Pakistan,0,1,5,25,0,5,0,30,0
Brazil prison riot leaves at least 10 inmates dead,0,3,1,39,0,8,2,40,0
"Blake Griffin Trade Rumors: Celtics, Clippers Reportedly Discussed Possible Deal",0,3,10,59,2,9,0,69,0
Could you pass the test to become a US citizen?,0,2,3,34,1,9,0,37,0
Liberal groups get together on an anti-Trump strategy,0,2,2,43,1,7,0,45,0
Wimbledon 2015: John Inverdale dropped by BBC in favour of Clare Balding for highlights show,0,2,8,65,1,14,4,73,0
MLB fan survey: Is baseball boring and other burning questions,0,2,4,48,1,9,0,52,0
US Navy aircraft crashes after Afghanistan mission,0,1,4,40,0,6,0,44,0
The Christmas Story: Joy to the World,0,2,5,25,1,6,0,30,0
Existing home sales surge at fastest rate in a decade,0,3,1,43,0,9,0,44,0
Judge Approves $25 Million Settlement of Trump University Lawsuit,0,3,7,47,1,8,2,54,0
"Gastro outbreak hits 90 passengers on Sun Princess cruise ship, Queensland Health says",0,3,5,66,1,12,2,71,0
Suicide bomber kills twelve in northwest Pakistan,0,1,2,41,0,6,0,43,0
Live Berlin market attack: Suspect named as 23-year-old asylum seeker from Pakistan,0,3,4,63,3,11,2,67,0
Muslims Shouldn’t Have To Be “Good” To Be Granted Human Rights,0,3,11,38,3,10,0,49,0
South Korea's obsession with top marks is costing its youth,0,3,2,47,1,9,0,49,0
Facebook's VP of HR explains why he isn't impressed by your stories of success in a job interview,0,3,5,73,2,17,0,78,0
Lehman Brothers files for bankruptcy,0,1,2,30,0,4,0,32,0
"This $85,000 Gun Has A Piece Of The Statue Of Liberty In It",0,2,12,28,2,12,5,40,0
Historic Scottish island castle wins the lottery,0,1,2,40,0,6,0,42,0
US Supreme court to hear Guantanamo Bay cases,0,1,5,33,0,7,0,38,0
Prince Rainier III of Monaco has died,0,1,6,25,0,6,0,31,0
'Training Day': Watch the Show's Touching Dedication to Bill Paxton,0,2,8,46,4,9,0,54,0
30 Under 30 In Science 2017: Discovering New Things About Our World And New Ways To Save It,0,3,15,50,1,17,8,65,0
Fit To Fight: Watch Kangana Ranaut Speak About Her Life In An Award Show,0,3,14,44,1,13,0,58,0
Boil water advisory lifted in Vancouver,0,1,2,32,0,5,0,34,0
How Kosovo Was Turned Into Fertile Ground for ISIS - The New York Times,0,2,15,42,1,13,0,57,0
Got A Great Idea For Dealing With Poop In A Spacesuit? Let NASA Know,0,2,17,37,1,13,0,54,0
U.K. Judges Still Loved as EU Top Court Chief Laments Brexit,0,3,12,36,2,10,0,48,0
Montana Mines to Test Trump Team’s Appetite for China Deals,0,3,8,41,1,9,0,49,0
Trump-Taiwan call: China lodges protest,0,3,3,30,2,4,0,33,0
Why Zimbabwe Is Selling Its Wildlife,0,2,6,25,0,5,0,31,0
5 Key Moments From the Appeals Court Hearing on Trump's Travel Ban ,0,2,9,44,1,12,1,53,0
Farmer kills his girlfriend and has sex with her corpse because 'she wouldn't sleep with me when she was alive' ,0,3,1,88,3,20,0,89,0
Tesla Autopilot Appears To Predict Crash Moments Before It Happens,0,3,10,47,0,9,0,57,0
Morgan Tsvangirai to compete in run-off,0,1,2,31,1,5,0,33,0
NFL Combine 2017: Full Sunday Schedule and Predictions for Top Prospects,0,3,10,47,1,10,4,57,0
"Laura Dern, star of ‘Wilson,’ on embracing tough characters",0,3,3,44,4,8,0,47,0
Trump Aide Dan Scavino Calls for ‘Defeat’ of GOP Rep. Justin Amash,0,3,12,40,3,11,0,52,0
Judge Rules States’ Case Against Trump Travel Order Can Proceed,0,3,10,43,1,9,0,53,0
Here's Something You Probably Never Knew About 'Golden Girl' Rue McClanahan,0,2,12,50,3,10,0,62,0
What If U.S. Border Agents Ask for Your Cellphone?,0,3,9,30,3,8,0,39,0
Scientists turned an entire metal room into a wireless charger,0,3,1,52,0,9,0,53,0
5 Andra Day Songs You Should Know,0,2,6,20,0,6,1,26,0
Jackie Evancho's Transgender Sister Juliet Wins Federal Court Ruling Over School Bathrooms,0,3,12,66,1,11,0,78,0
New Zealand minister calls for ban on using mobile phones while driving,0,1,2,58,0,11,0,60,0
Wikinews interviews 0 A.D. game development team,0,1,3,36,2,6,1,39,0
Donald Trump's inauguration: Schedule of the day,0,2,3,37,2,6,0,40,0
Amy Schumer And Goldie Hawn Wild Out In First 'Snatched' Trailer,0,3,11,41,2,10,0,52,0
Germany Uses VR Model of Auschwitz-Birkenau to Catch Nazis,0,3,9,40,1,8,0,49,0
"UK company ""seriously considering"" GPS tracking devices in school uniforms",0,1,5,58,2,9,0,63,0
AbitibiBowater Said to Be Making Progress on Debt,0,1,7,35,0,7,0,42,0
New York Fashion Week: Six talking points,0,3,5,29,1,6,0,34,0
Russia expert: New US sanctions 'clearly meant to throw a wrench into' Trump's dealings with Moscow,0,2,6,74,4,15,0,80,0
"In England, Italy and Spain, Champions Crowned Without a Victory",0,1,8,45,2,9,0,53,0
Iowa Football Coach Shot at High School He Helped Rebuild,0,1,9,39,0,9,0,48,0
Ex-child soldier Dominic Ongwen denies war crimes at ICC trial,0,2,6,46,1,9,0,52,0
Tony Blair could work alongside Lib Dems in anti-Brexit election campaign,0,2,5,57,1,10,0,62,0
Congressman's Teen Son 'Grounded' After Dabbing During Swearing-In Photo With Speaker Ryan ,0,3,13,62,4,12,0,75,0
US Yemen raid: Bomb-making video 'mix-up',0,3,4,27,5,5,0,31,0
Swine Flu Migrates to China and Japan,0,1,5,26,0,6,0,31,0
‘Re-accommodate?’ United ridiculed for corpspeak response to passenger dragging.,0,3,2,65,5,8,0,67,0
Somalia Mogadishu car bomb: At least 16 people killed,0,2,3,39,1,8,2,42,0
"Uber Board Has Full Confidence in CEO Kalanick, Huffington Says",0,3,11,42,1,9,0,53,0
High school student tells Betsy DeVos exactly how her policies would hurt her,0,3,4,61,0,12,0,65,0
Ikea recalls 29m chests and dressers after six children die,0,2,1,47,0,9,2,48,0
"Unlike Donald Trump, Hillary Clinton Lacks A Simple, Clear Economic Message",0,2,11,52,2,10,0,63,0
Insiders Reportedly Think Drake And JLO Romance Is A Front To Sell Music,0,3,15,45,0,12,0,60,0
"Week 15 fantasy football inactives watch: Who's in, and who's out?",0,3,2,47,5,10,2,49,0
ISIS leader Abu Bakr al-Baghdadi 'critically injured in air strikes in northern Iraq',0,3,8,62,3,12,0,70,0
New Zealand Labour party spending in question,0,1,3,36,0,6,0,39,0
Taiwan culls 18000 chickens due to H5N2 virus outbreak,0,1,3,36,0,8,7,39,0
"Norma McCorvey, 'Jane Roe' in 'Roe v Wade' Case, Dies at 69",0,3,9,31,6,11,2,40,0
Madonna says we’re f**ked after Donald Trump’s election win,0,2,3,44,4,8,0,47,0
Great Leaders Don't Speak Ill Of Their Predecessors,0,3,8,35,1,7,0,43,0
New BBC Radio 2 boss announced,0,1,5,19,0,5,1,24,0
Inside the Deadly Pirate Corridor Where Migrants Escape to Europe,0,3,8,48,0,9,0,56,0
Fun Moments From Jio Filmfare Awards 2017 We Can’t Wait To Watch,0,3,11,37,1,11,4,48,0
Keith Richards Remembers Chuck Berry... And That Time the Rock Icon Punched Him,0,2,12,52,3,12,0,64,0
"What is Sarin? In Syria, potent gas believed to be behind fatal attack ",0,2,4,52,2,13,0,56,0
Resolution on Obama Stirs Debate,0,1,4,24,0,4,0,28,0
Lorde’s new heartbreak-fueled single is a surefire hit,0,2,1,44,2,7,0,45,0
"Japanese survivor of both Hiroshima and Nagasaki atomic bombings dies, aged 93",0,1,3,61,1,11,2,64,0
President Trump: I Get 4 to 5 Hours of Sleep ,0,3,6,26,1,10,2,32,0
Sir Michael Caine on old age: I know my days are numbered,0,3,4,41,1,11,0,45,0
Former Flemish Minister Paul Akkermans dies at 83,0,1,5,35,0,7,2,40,0
Campaign Aides Shout It Out in Post-Election Forum,0,2,8,34,1,7,0,42,0
Private guard kills Somali pirate in Gulf of Aden,0,1,4,37,0,8,0,41,0
Ericsson's CEO Tours Marconi Sites,0,1,7,22,1,4,0,29,0
Nicki Minaj’s Brother To Stand Trial For 2015 Rape Allegation,0,3,9,38,1,9,4,47,0
Guns N' Roses' 'Chinese Democracy' released after 15 years,0,1,5,39,4,8,2,44,0
Wells Fargo Sweating Stress Test,0,1,5,23,0,4,0,28,0
Kal Penn Shares Some Of The Racist Audition Scripts He Got At The Start Of His Career,0,3,17,52,0,16,0,69,0
Obama withdraws from Trinity United Church,0,1,4,33,0,5,0,37,0
That Time Joe Duffy Choked Out a Young Conor McGregor,0,3,10,34,0,9,0,44,0
7 Bombs Strike in Iraq as Violence Spreads,0,1,5,29,0,7,1,34,0
Watch How India’s Ambitious Aadhaar Identification Program Often Fails to Deliver - India Real Time,0,3,13,70,2,14,0,83,0
Trump’s charge that he was wiretapped takes presidency into new territory,0,3,1,61,1,10,0,62,0
Scarcity of Copters Fuels British Debate Over War,0,1,7,35,0,7,0,42,0
Obama gives $500 million to climate fund over GOP objections ,0,2,4,43,1,10,3,47,0
Britain's conservative pol Nigel Farage exults over Trump and Brexit wins at CPAC,0,3,9,59,1,12,0,68,0
"‘You, sir, shut up!’: Republican congressman shouts down a constituent at tense town hall",0,3,2,68,6,13,0,70,0
DON'T PANIC! That Bacon Shortage You Keep Hearing About Isn't Real,0,3,18,35,3,10,0,53,0
Benjamin Netanyahu wants pardon for Israeli soldier convicted for shooting wounded Palestinian man dead,0,3,4,86,0,13,0,90,0
North Korea's missile test: The view from Pyongyang,0,3,4,38,2,7,0,42,0
Mom spends holidays with teen who received son's donated heart ,0,2,1,51,1,10,0,52,0
"Far-right party still leading in Dutch polls, despite leader’s criminal guilt",0,2,2,62,3,10,0,64,0
"Roman palace's stunning ceiling destroyed 2,000 years ago is finally restored from flecks of paint",0,2,1,77,2,14,4,78,0
Son of Greggs founder jailed for more than 13 years for child sex abuse,0,2,2,54,0,13,2,56,0
Washington Monument to Remain Closed Until 2019,0,3,5,32,0,6,4,37,0
The Weeknd: Topping the Hot 100 With 'Starboy' Is an 'Honor' (Exclusive),0,3,9,42,7,11,3,51,0
Asbestos discovery triggers evacuation and closure of New Jersey middle school,0,1,3,65,0,10,0,68,0
Shakira Tells World Economic Forum: 'I'd Be an Amazing Doctor',0,3,9,40,4,9,0,49,0
Judge in Gambian court warns media not to cover case,0,1,2,41,0,9,0,43,0
Support Slips for Hong Kong Election Plan,0,3,6,29,0,6,0,35,0
Partial Transcript: Trump’s Interview With The Times ,0,3,7,37,2,7,0,44,0
Should Parents Use Retirement Savings for College Tuition? ,0,2,7,43,1,8,0,50,0
US man gets 30 years for helping plot IS attack in Texas,0,3,5,38,0,11,2,43,0
‘He is a thief’: Little League teammates go to war over fortune made in youth baseball,0,2,3,65,3,15,0,68,0
Clapper Denies Trump Wiretap as White House Demands a Probe,0,3,8,42,0,9,0,50,0
Kevin Durant leads US men’s basketball team to third straight Olympic gold,0,2,5,57,1,11,0,62,0
Peugeot-Citroën chief vows to save jobs in Vauxhall/Opel takeover,0,3,4,51,2,8,0,55,0
Week 16 NFL Power Rankings: Cowboys take away No. 1 from Pats,0,3,9,36,2,11,3,45,0
"CNN headquarters infected with computer worm, exaggerates global threat",0,1,3,59,1,8,0,62,0
Samsung Electronics Profit Growth Driven by Component Sales,0,2,7,45,0,7,0,52,0
"India v Australia: fourth Test, day one – live!",0,3,3,32,4,8,0,35,0
Critic of Kyrgyzstan Leader Is Believed Dead in a Suspicious Car Crash,0,1,9,50,0,11,0,59,0
Arizona Becomes Lowest Seed to Advance to Round of 16,0,1,6,36,0,9,2,42,0
"Two missing after severe thunderstorm in St. Paul, Minnesota",0,1,4,46,2,8,0,50,0
"Aldi to become highest-paying supermarket in the UK with pay rise for 3,000-strong workforce",0,2,3,69,3,13,4,72,0
People Are Ticked That Rory McIlroy Played Golf With Donald Trump,0,3,12,43,0,10,0,55,0
Trump’s Trade Pick to Pursue Stronger Relationship With Taiwan,0,3,8,45,1,8,0,53,0
"Melanie Oudin, a 17-Year-Old American, Reaches Third Round at Wimbledon",0,1,9,47,4,9,2,56,0
Refugees take shelter on rocky Italian seafront after being turned away from France,0,2,3,68,0,12,0,71,0
"Chuck Berry Sales Explode By More Than 10,000% Following His Death",0,3,10,39,2,10,5,49,0
Two winning British EuroMillions lottery tickets worth £45 million each claimed,0,1,4,62,1,10,2,66,0
Euro Disney SCA receives new CEO,0,1,8,19,0,5,0,27,0
"Solomon Islands brace for further tremors after magnitude-7.0 earthquake hits, tsunami threat eases",0,3,2,80,3,12,2,82,0
"Dam in Indonesia bursts, dozens killed",0,1,2,30,1,5,0,32,0
"13,000 people hanged in secret at Syrian prison, Amnesty says",0,3,2,43,2,9,5,45,0
Trump considers rearranging the seats at his table,0,3,1,42,0,7,0,43,0
"Stunning Spain and Soccer World, U.S. Advances to Final",0,1,8,36,3,8,0,44,0
EXCLUSIVE VIDEO: Clashes at Pro-Migrant Rally as Far Left Fight Nationalists in London,0,2,23,49,2,12,0,72,0
Sharp Increases OLED-Investment Plan to $878 Million,0,3,9,32,2,6,3,41,0
"Leader of Puerto Rican People’s Army shot, killed by FBI",0,1,8,37,2,9,0,45,0
"Berlin market attack: Australian witness describes shock, trauma and media pressure",0,3,2,69,2,10,0,71,0
"ObamaCare in 'death spiral,' Aetna CEO says ",0,2,6,28,3,7,0,34,0
Lauren Graham’s Fictional TV Daughters Finally Met In Real Life,0,2,11,42,1,9,0,53,0
Cocaine found at Kennedy Space Center,0,1,4,28,0,5,0,32,0
Does Melissa McCarthy Upset Trump More Than Alec Baldwin?,0,2,10,38,1,8,0,48,0
This Video Of Sachin Tendulkar And Tabla Maestro Zakir Hussain's Jugalbandi Is Winning The Internet,0,3,15,69,1,14,0,84,0
Clapper: 'No such wiretap activity mounted' on Trump,0,3,3,39,3,7,0,42,0
House of Commons and Westminster Bridge attack – in pictures,0,3,4,46,1,9,0,50,0
"Four found dead in Leicestershire, England",0,1,3,33,1,5,0,36,0
Making the Case for Climate as a Migration Driver,0,1,5,36,0,8,0,41,0
"Cyclone Debbie Slams Into Australia, Knocking Out Power To Thousands",0,2,10,48,1,9,0,58,0
Smart Play for Baseball and N.F.L. in Sirius Deals,0,1,8,31,3,8,0,39,0
Morgan Stanley and Goldman Sachs are facing the same question â but for very different reasons,0,2,4,75,2,15,0,79,0
New York officials blast Sessions for calling city ‘soft on crime’,0,3,3,51,2,10,0,54,0
Poll: 55% of Americans bothered by Russian election hacking,0,3,3,44,2,8,2,47,0
"Commuters Across Delhi NCR Likely To Get Some Relief As Ola, Uber Driver Strike Called Off Partially",0,3,19,64,1,16,0,83,0
Western Michigan Broncos WMU Basketball Player Joeviair Kennedy Charged with Murder of Fellow Student,0,3,14,74,0,13,0,88,0
"John Lynch's Daughter Cried After Hearing 49ers Hired Dad, Said Team Is Horrible",0,3,12,52,2,12,2,64,0
Michael Flynn Resigns as National Security Advisor Amidst Russia Controversy,0,3,9,58,0,9,0,67,0
RZA Directed an Episode of Netflix's 'Iron Fist',0,3,8,30,3,7,0,38,0
Good Riddance to the Filibuster,0,2,3,24,0,4,0,27,0
Alesis TapeLink Moves Songs From Cassette to CD,0,1,9,31,0,7,0,40,0
American soldiers accused of desecrating enemy bodies,0,1,1,46,0,6,0,47,0
The Oil Trade Showing Where OPEC’s Cuts Are Starting to Bite,0,2,13,36,1,10,0,49,0
HSBC Confirms Possible Sale of 3 Office Buildings,0,1,9,32,0,7,1,41,0
A&E ditches controversial series on the KKK,0,3,5,31,1,6,0,36,0
"Michael Flynn, Trump's national security adviser, resigns amid controversy over Russia call ",0,3,4,73,3,12,0,77,0
Saudi Arabia agrees with the US on joining the WTO,0,1,7,34,0,9,0,41,0
Donald Trump accuses Jewish reporter of lying and tells him to 'sit down' in response to anti-semitism question,0,3,3,88,3,17,0,91,0
Donald Trump's idea on how to pay for Mexico border wall sparks concerns avocado prices could be toast,0,3,3,81,1,17,0,84,0
Tennis: Andy Murray wins Montreal Masters 2009,0,1,5,30,1,6,4,35,0
Ephraim Kishon dies at 80,0,1,2,17,0,4,2,19,0
Ana Navarro Shuts Down Donald Trump Supporter Who Told Her To Stop Talking,0,3,13,49,0,12,0,62,0
Hacker Releases New Episodes of 'Orange Is the New Black',0,3,8,38,2,9,0,46,0
Andreas Lubitz's father says son 'wasn't depressed',0,3,2,39,4,6,0,41,0
Mavis Staples on Her Kennedy Center Honor and Fist-Bumping James Taylor ,0,3,10,50,1,11,0,60,0
European Union gives Iran two more weeks to comply with UN resolution,0,1,5,53,0,11,0,58,0
Six Flags in Talks to Avoid Filing for Bankruptcy,0,1,6,35,0,8,0,41,0
Birdman Addresses Rick Ross Diss Track: 'I Don't Get Caught Up in Hoe Sh*t',0,2,13,44,5,13,0,57,0
"School in Edinburgh, Scotland sealed off; put on radioactive alert",0,1,3,52,2,9,0,55,0
Trump: Syrian Chemical Attack an ‘Affront to Humanity’,0,3,6,38,3,7,0,44,0
Brookfield Finds Solar ‘Entry Point’ After SunEdison's Collapse,0,2,9,44,3,7,0,53,0
The Famous ‘Mary Tyler Moore Show’ House Is Up for Sale,0,2,10,33,2,10,0,43,0
Migos' 'Culture' Album Could Have A Big Debut At No. 1 (UPDATE),0,3,16,29,6,11,1,45,0
John Wall thinks he isn’t getting the calls he should. It’s pushing him to the edge.,0,3,3,62,4,15,0,65,0
Staples Explores Sale After Failed Office Depot Deal,0,2,8,37,0,7,0,45,0
"This Artist Will Teach You How To Draw Using ""The Penis Method""",0,3,12,38,2,11,0,50,0
Sulpicio Lines asks court to stop BMI investigation into 'Princess of the Stars' disaster,0,1,7,67,2,13,0,74,0
David Blunkett is not the father of Kimberly Quinn's son,0,1,4,42,1,9,0,46,0
Exeem Annonunced To Be Successor Of Suprnova,0,1,7,31,0,6,0,38,0
Thousands in Chechnya Protest After Lawyer Is Killed,0,1,7,38,0,7,0,45,0
"Jolted by Deaths, Obama Found His Voice on Race ",0,2,7,31,1,9,0,38,0
Illinois man named person of interest in wife's disappearance,0,1,1,51,1,8,0,52,0
"Chad declares border with Sudan a ""military operations zone""",0,1,2,48,2,8,0,50,0
Tunisia attack survivor reacts to coroner's conclusion,0,3,1,46,1,6,0,47,0
US and South Korea to conduct naval exercises in response to warship sinking,0,1,4,60,0,12,0,64,0
"Car crash on A37 near Bristol, two dead",0,1,3,26,1,7,2,29,0
Land And Air Travel Aren't Enough For Elon Musk. He's Going Underground,0,2,12,45,3,11,0,57,0
Want Social Change? Run for Office (It's Not As Hard As You Think),0,3,12,38,4,12,0,50,0
A Gorgeous Green Meteor Lit Up The Indian ‘Sky Islands’ And We Had No Clue About It,0,3,17,48,2,16,0,65,0
"Russian tour boat sinks, killing over 100",0,1,1,30,1,6,3,31,0
Someone made a map of the world according to Donald Trump The list,0,2,4,50,0,12,0,54,0
This Is a Dangerous Time to Own Emerging Markets,0,2,7,33,0,8,0,40,0
Donald Trump Is Said to Intend to Keep a Stake in His Business ,0,3,9,41,0,13,0,50,0
6.9 magnitude earthquake hits western China,0,1,1,34,1,5,2,35,0
Elections held in Bulgaria,0,1,2,21,0,3,0,23,0
US Federal Reserve Chairman gives first news conference,0,1,5,43,0,7,0,48,0
Corporate Japan Looks for Outside Advice,0,3,5,30,0,5,0,35,0
'Tragedy' on the Great Barrier Reef as coral bleaching devastates for second straight year,0,3,4,71,2,13,0,75,0
"United Nations estimates 20,000 refugees affected by Trump ban",0,3,3,45,1,8,5,48,0
"From ThinkPad, a Double-Screened Laptop",0,1,6,27,2,4,0,33,0
Abramoff begins prison sentence,0,1,1,27,0,3,0,28,0
5 Things About China-Taiwan Relations ,0,3,5,26,1,5,1,31,0
$125 Million Is Pledged to Big Medical Center,0,1,6,28,1,7,3,34,0
"WWE Raw Results from Memphis, TN for September 15, 2008",0,1,9,29,2,9,6,38,0
DHS will continue to enforce Trump's travel ban ,0,2,4,35,1,8,0,39,0
"Andre Drummond, Reggie Jackson's Trade Value Reportedly Explored by Pistons",0,3,9,55,2,9,0,64,0
American Injured in Clash at Israeli Barrier,0,1,5,33,0,6,0,38,0
Toyota to suspend sales of Lexus GX 460 over new safety fears,0,1,4,43,0,11,3,47,0
Vimy Ridge: Royals to commemorate defining WW1 battle,0,2,5,39,1,7,1,44,0
Patriots will need better performance in AFC title game,0,2,4,43,0,8,0,47,0
British Postage Service Honors David Bowie with 10 Commemorative Stamps,0,2,8,52,0,9,2,60,0
Space Shuttle Endeavour's launchpad struck by lightning delaying launch,0,1,3,59,1,8,0,62,0
Fmr. Defense Sec. Gates: No Sense of Urgency From U.S. Leaders on Russian Hacks,0,3,13,48,5,13,0,61,0
Two deaths unreported in Natrecor study,0,1,2,32,0,5,0,34,0
"Louisville Pitcher Josh Rogers Catches Line Drive, Hits the Shimmy",0,3,9,47,1,9,0,56,0
London Theater Pranks ‘Moonlight’ Audience by Playing ‘La La Land’,0,3,9,44,4,9,0,53,0
DeMarcus Cousins Apologizes For Bullying a Columnist Who Wrote About His NYC Nightclub Lawsuit,0,3,16,65,0,13,0,81,0
Myanmar's lost royals,0,3,1,17,1,2,0,18,0
Taylor Swift's home has been designated as a historic landmark - Yahoo,0,3,3,54,2,11,0,57,0
Gorillas and the kissed: Mother ape plants a kiss on her two-month-old baby's cheek ,0,3,2,64,4,14,0,66,0
"American Indians to protest Trump, pipeline in Washington ",0,2,4,45,1,8,0,49,0
Paris Shooting: Soldier Near Louvre Museum Fires on Attacker IDd as Egyptian,0,2,11,53,1,11,0,64,0
Officials Share Video Showing Shooting of Boston Terror Suspect Usaamah Rahim,0,2,10,57,0,10,0,67,0
Don Dale female detainees given morning-after pill following alleged sex during riot,0,2,2,70,1,11,0,72,0
Natural gas discovered in Chile according to President Ricardo Lagos,0,1,5,54,0,9,0,59,0
"Moderate earthquake hits Crete, Greece",0,1,3,30,1,4,0,33,0
Firefighters name kitten ‘Porsche’ after rescuing her from a car engine - Yahoo,0,3,3,61,3,12,0,64,0
Dwyane Wade Injury: Updates on Bulls Star's Wrists and Return,0,3,8,42,2,9,0,50,0
Mother Nature Is Brought to You By ... ,0,3,6,22,3,8,0,28,0
Donald Trump Calls Intel Briefing on Alleged Russian Hacking 'Constructive Meeting' ,0,3,10,61,2,11,0,71,0
"Study links pot use to higher risk for stroke, heart failure",0,3,1,48,1,10,0,49,0
"As Oil and Gas Prices Plunge, Drilling Frenzy Ends",0,1,8,33,1,8,0,41,0
Ukip leader Paul Nuttall admits his website claim of losing 'close personal friend' at Hillsborough are false,0,3,4,87,2,16,0,91,0
Queen appears in public for first time in a month after suffering heavy cold,0,2,1,62,0,13,0,63,0
Killer Mike Defends Kanye West's Decision to Meet With Trump: 'Why Wouldn’t You?',0,3,12,51,6,12,0,63,0
Politicians have ignored the working class for too long,0,3,1,46,0,8,0,47,0
Woe Is the Washington Metro,0,2,4,19,0,4,0,23,0
Expert: Watch to see if Kim Jong-Un goes into hiding after Syria strike ,0,3,6,51,2,13,0,57,0
Spicer Says Trump Had 'Every Right' to Defend Ivanka About Nordstrom ,0,2,10,46,2,11,0,56,0
Judge Allows Madoff to Remain Free on Bail,0,1,6,29,0,7,0,35,0
Lloyds to shrink hundreds of UK branches to two staff,0,3,3,41,0,9,0,44,0
US government shutdown averted in last-minute deal,0,1,2,41,1,6,0,43,0
Michael Skakel’s Murder Conviction Has Been Reinstated ,0,3,7,40,1,7,0,47,0
Olympic flame for Beijing Games lit amidst protest,0,1,3,40,0,7,0,43,0
"Three Trump nominees confirmed, but still no deal for the others",0,3,2,51,1,10,0,53,0
"Jordan attack: Foreign tourist among nine killed in medieval castle attack, nearby shootings",0,2,2,76,2,12,0,78,0
"Trump’s Travel Ban Is Frozen, But the Fallout Isn’t",0,3,8,32,3,8,0,40,0
Afghans riot after civilians die in crash,0,1,1,34,0,6,0,35,0
White House calls reported Trump meeting with Russian ambassador 'absurd' ,0,2,4,58,2,10,0,62,0
S. Korean President Reshuffles Cabinet,0,1,5,28,1,4,0,33,0
Internet quickly turns GOP's Obamacare replacement plan into a meme,0,2,5,52,1,9,0,57,0
Iran vows not to let Trump destroy nuclear deal ,0,2,2,37,0,9,0,39,0
San Francisco Giants rookie pitcher throws no-hitter against New York Mets ,0,2,6,57,1,11,0,63,0
Derrick Rose Disappeared Before a Knicks Game and No One Knew Where He Was (UPDATED),0,2,19,49,2,14,0,68,0
HP Inc.Voice: Three Ways To Reinvent For The Fourth Industrial Revolution,0,2,13,48,2,10,0,61,0
"For older people living alone, daily automated calls can mean safety",0,3,1,56,1,10,0,57,0
The Powerball jackpot is at a record high — here’s what we’d do if we won,0,2,2,53,3,15,0,55,0
Britain to celebrate pioneering women with three new statues,0,3,1,51,0,8,0,52,0
Incentives Attract Healthier Food to Low-Income Areas,0,1,7,39,1,6,0,46,0
Wikinews interviews Dr. Michael Mazilu on creating world's fastest spinning manmade object,0,1,4,73,2,11,0,77,0
New Mexico Legislature Passes Caps on Contributions,0,1,6,39,0,6,0,45,0
The Trump-Like Figures Popping Up in Central Europe ,0,3,8,35,1,8,0,43,0
"Across Asia, Dalliances Are News",0,1,5,22,1,4,0,27,0
Oscar Pistorius to be released from prison on Aug 21,0,2,3,38,0,9,2,41,0
Armenian Journalists Facing Prison Sentences in Turkey,0,1,6,42,0,6,0,48,0
"Keep visiting relatives with dementia even if they don't remember you, urges Carey Mulligan",0,3,3,73,2,13,0,76,0
Are U.S. jobs vulnerable to workers with H-1B visas?,0,3,5,34,4,8,1,39,0
"Wal-Mart, America’s Largest Grocer, Is Now Selling Ugly Fruit And Vegetables",0,2,12,50,4,10,0,62,0
"Civil Rights Hero, Now a Judge, Is Indicted in a Bribery Case",0,1,9,39,2,11,0,48,0
Dakota Access Pipeline plan still on despite protests across the US and world,0,2,5,60,0,12,0,65,0
Mike Shinoda Is Heading to Cannes: Midem Taps Linkin Park Artist as Keynote,0,3,11,51,1,12,0,62,0
Stephen Colbert Says Moby Is Just As Credible As Kellyanne Conway,0,2,11,44,0,10,0,55,0
12-Year-Old Drives 800 Miles Across Australia Before Police Stop Him,0,3,10,42,2,9,5,52,0
Downturn Hurts Expectations in Portland,0,1,4,31,0,4,0,35,0
"For Trump Tax Cuts, Pay Legal & Other Bills In 2016",0,2,9,26,2,10,4,35,0
Is this the year? Northwestern and the search for the NCAA tournament,0,3,6,51,1,11,0,57,0
"The Dodgers Left My Father, the Stadium Left Me",0,1,8,30,1,8,0,38,0
Shark kills teen girl surfing off Australia's coast,0,3,2,41,1,7,0,43,0
What Is a Populist?,0,2,3,12,1,3,0,15,0
Cooler than all of us: how the Obamas upheld African American pop culture,0,3,4,56,1,12,0,60,0
Hartmarx Accepts Buyout Offer From Emerisque,0,1,6,33,0,5,0,39,0
Rupert Murdoch preparing to step down as CEO from 21st Century Fox,0,2,7,46,0,11,2,53,0
Davis Cup: Denis Shapovalov 'ashamed' after default for hitting umpire with a ball,0,3,4,63,3,12,0,67,0
California immigrant families brace for possibility of sudden deportation,0,3,1,64,0,8,0,65,0
Arnold Schwarzenegger fires back at Trump jab: How about 'I take over your job'?,0,3,5,58,4,13,0,63,0
"Jesse & Joy Win First Grammy, Dedicate Award to 'All Hispanics Out There'",0,3,11,46,4,12,0,57,0
Aleppo battle: Syria rebels call for truce to evacuate civilians,0,2,2,52,1,9,0,54,0
"Document reveals U.S., Taliban discussed bin Laden assassination",0,1,5,49,3,7,0,54,0
The worst-case scenario of the apparent nerve toxin murder of Kim Jong Nam,0,3,4,57,1,12,0,61,0
"Katy Perry's 'Bon Appetit,' Featuring Migos, Tops Billboard + Twitter Trending 140 Chart",0,3,11,56,6,12,3,67,0
"Britain's May Visits Turkey, Reaches Fighter Jet Deal ",0,3,8,36,2,8,0,44,0
Militant group 'protests' placards used in Armenian-Turkish journalist's funeral,0,1,3,65,4,8,0,68,0
Donald Trump May Not Actually Know Who's Running North Korea,0,3,10,40,1,9,0,50,0
Waking Up From the N.B.A. Draft and Wimbledon,0,1,8,27,3,7,0,35,0
Drunk coach driver arrested after crash injures at least 30,0,1,1,47,0,9,2,48,0
Super Bowl LI preview: the Atlanta Falcons face the New England Patriots – video,0,3,9,56,2,13,0,65,0
Bitcoin dives after China's 3 biggest exchanges say they'll keep blocking withdrawals,0,3,2,69,2,11,1,71,0
CFTC Chairman Timothy Massad to Step Down Jan. 20,0,3,10,28,1,8,2,38,0
Philippines facing HIV epidemic after restricting gay men’s access to condoms,0,2,4,62,1,10,0,66,0
OutFront: Entrepreneur Creates Inclusive Camp for LGBTQ Youth,0,2,12,41,1,7,0,53,0
"Iran to hold naval war games with ships, subs, and helicopters after being put âon noticeâ by the US",0,3,3,77,6,18,0,80,0
Australian government commits AU$60 million to cut greenhouse emissions,0,1,3,57,1,8,2,60,0
Wreck of August 6 airliner crash recovered from sea off Italy,0,1,3,47,0,10,1,50,0
Racer Ashwin Sundar And His Wife Killed After Their BMW Catches Fire In Chennai,0,2,16,50,0,13,0,66,0
"Malaysia passes child sex crimes law, but says child marriage is OK",0,2,3,52,1,11,0,55,0
Sources: Enes Kanter could miss up to 2 months after X-rays reveal fractured forearm,0,3,4,64,2,13,1,68,0
Man who admitted downloading baby rape video is spared jail,0,3,1,49,0,9,0,50,0
Russian minister: South Ossetia reporting biased in Western media,0,1,4,52,1,8,0,56,0
Stacey Dash's Ouster From Fox News Delights Twitter,0,3,8,35,1,7,0,43,0
Gas prices surge in Northeast US,0,1,4,23,0,5,0,27,0
A Third Of Americans Want Donald Trump To Swap Roles With Arnold Schwarzenegger: Poll,0,3,14,57,1,13,0,71,0
At least 12 people dead after night of looting and violence in Venezuela,0,3,2,56,0,12,2,58,0
India road victim bleeds to death as bystanders film,0,3,1,43,0,8,0,44,0
Iraqi Soccer Team Finally Returns Home,0,1,6,27,0,5,0,33,0
"In Israel, Trump urges new Middle East harmony but faces old suspicions",0,2,5,54,1,11,0,59,0
Dave Koz to Reunite With Original Christmas Tour Lineup for 20th Anniversary Concerts,0,3,10,61,0,12,2,71,0
Inside a Multinational Cyber Weapons Deal That Went Bust,0,3,8,40,0,8,0,48,0
Watch Niall Horan's Confident Performance of 'This Town' on 'Tonight Show',0,2,9,50,5,10,0,59,0
World Leaders Condemn Manchester Terror Attack - Breitbart,0,2,7,43,1,7,0,50,0
Mayim Bialik Is Adorably Clueless When It Comes To Dating,0,3,10,38,0,9,0,48,0
Manchester by the Sea director defends Casey Affleck over sexual harassment allegations,0,2,4,72,0,11,0,76,0
Some Big Names Got a Measure of Mercy From President Obama,0,3,9,39,0,10,0,48,0
16-year-old Laurie Hernandez winked at the judges before one of the biggest routines of her life,0,2,2,75,2,15,2,77,0
"North Korea warns Australia of 'blindly toeing US line', warns of nuclear strike",0,3,5,60,3,12,0,65,0
Craig Venter Mapped The Genome. Now He's Trying To Decode Death,0,3,11,40,2,10,0,51,0
Duhon Finishes With Style to Relief of Knicks,0,1,6,32,0,7,0,38,0
Ask Carrie Fisher: I’m bipolar – how do you feel at peace with mental illness?,0,2,4,56,4,14,0,60,0
Donald Trump Will Be A Disaster For Autistic People,0,3,9,34,0,8,0,43,0
Mitt Romney Robotically Repeats Marco Rubio’s Robotic Talking Points to Attack Donald Trump - Breitbart,0,2,13,74,2,14,0,87,0
The Bust Is Back! Trump Restores Winston Churchill Likeness to Oval Office  Insider,0,3,12,57,1,13,0,69,0
US declares public health emergency over spread of swine flu,0,1,2,49,0,9,0,51,0
Mongolians protest over air pollution: 'Wake up and smell the smog',0,3,2,52,3,10,0,54,0
Good for the Bruins for putting hockey before PR — or Patriots,0,2,5,45,1,11,0,50,0
Lululemon is soaring after beating on earnings and raising its guidance,0,3,1,60,0,10,0,61,0
Riot Fest Co-Founder Sean McKeough Dies at Age 42,0,2,9,29,1,8,2,38,0
Donald Trump inauguration: How to watch and stream the Presidential ceremony online,0,2,4,67,1,11,0,71,0
Nusra Front Militants Kill Druze Villagers In Syria,0,2,8,36,0,7,0,44,0
Jury Delivers Guilty Verdict in Murder of Police Officer - The New York Times,0,2,11,52,1,13,0,63,0
"Millions Risk Losing Health Insurance in Republican Plan, Analysts Say ",0,3,9,51,1,10,0,60,0
"Scottish independence support at highest ever levels, survey suggests",0,3,1,59,1,8,0,60,0
LuLaRoe Offering Refunds for Leggings That ‘Rip Like Wet Toilet Paper’ — But Is That Enough? [Video],0,3,17,61,6,16,0,78,0
Congress Confirmed Mattis — Now It Should Heed His Advice,0,2,9,38,1,9,0,47,0
Darrelle Revis Turns Himself in to Police After Alleged Pittsburgh Altercation,0,2,9,59,0,10,0,68,0
"Ukip wars: Arron Banks asks for his money back and submits invoice to Ukip for £200,000",0,2,4,59,3,15,6,63,0
The cost of unifying North and South Korea,0,3,4,31,0,7,0,35,0
Target Hires Former La Raza Executive as Latest Board Member,0,2,9,42,0,9,0,51,0
Minor tears found in Gordon Brown's retina,0,1,3,32,1,6,0,35,0
Rain-Delayed Wrigley Field Erupts After Chicago Blackhawks Win Game 5,0,3,10,48,1,9,1,58,0
"Which U.S. players does ""Japan's Babe Ruth"" want to go up against?",0,2,6,43,6,11,0,49,0
"June 9, 2015 — Pictures of the Day ",0,3,3,17,2,8,5,20,0
Pacers make 2017 first-round pick available in push to aid Paul George,0,3,3,51,1,11,4,54,0
Kellyanne Conway: Electors’ concern over Russian hacking allegations is ‘nonsense’,0,3,4,65,4,9,0,69,0
Brexit: Tusk says UK trade deal not a priority,0,3,4,33,1,8,0,37,0
"Um, If You Need To Procrastinate Today, Play This Beyoncé-Themed Game",0,2,12,44,3,10,0,56,0
"After Price Cap On Stents, Government To Regulate Prices Of Artificial Heart Valves And Syringes",0,2,15,66,1,14,0,81,0
"In His Last Press Conference, Obama Warned Putin, Advised Trump And Defended the US Role In Syria",0,3,17,62,2,16,0,79,0
Two Jawans Martyred And Four Terrorists Dead As Encounter Rages In Kashmir's Kulgam,0,3,13,57,1,12,0,70,0
Tropical Storm Dolly kills seventeen in Guatemala,0,1,4,39,0,6,0,43,0
Here Are The 2017 Grammy Nominations,0,2,5,22,0,5,4,27,0
LISTEN: Green Day Single Focuses on American ’Culture of Mass Shooting’ - Breitbart,0,2,15,52,4,12,0,67,0
Donald Trump Shuffles National Security Council,0,3,6,36,0,5,0,42,0
"Bob Barker retires as US host of ""The Price is Right""",0,1,7,34,2,10,0,41,0
Suspended letterbox for sale on New Zealand auction site,0,1,3,45,0,8,0,48,0
After Fukushima: the tenants rebuilding a destroyed community,0,2,2,51,1,7,0,53,0
How are the Obamas spending their Christmas weekend?,0,3,3,41,1,7,0,44,0
"Frank Ocean, Lady Gaga, Sia & More Among GLAAD Media Awards Nominees",0,3,15,39,3,11,0,54,0
"Few surprises for banks, financials in U.S. budget deal",0,2,3,41,3,8,0,44,0
Justin Bieber Impersonator Accused of 900 Child Sex Crimes,0,3,7,40,0,8,3,47,0
Trevor Noah Explains Why Jared Kushner Is 'The Real President',0,3,10,41,2,9,0,51,0
Chelsea striker Diego Costa dropped following bust-up with Antonio Conte and fitness coach,0,3,5,72,1,12,0,77,0
Donald Trump Nominates Vincent Viola for Secretary of the Army - Breitbart,0,2,8,54,1,11,0,62,0
Californians are calling for a ’Calexit’ from the US — here’s how a secession could work,0,2,4,65,4,15,0,69,0
Three Yemeni troops killed in shooting,0,1,2,31,0,5,0,33,0
US Army responds to theory claiming military owes Captain America $3 million,0,2,5,58,1,11,1,63,0
Former PM Thaksin returns to Thailand,0,1,5,27,0,5,0,32,0
What are executive actions?,0,3,1,22,1,3,0,23,0
John Lewis: Trump slammed for attack on rights icon,0,3,3,39,1,8,0,42,0
Investors See a Glimmer and Send Shares Higher,0,1,6,33,0,7,0,39,0
Past Corruption Taints New India,0,1,5,23,0,4,0,28,0
Riots in Île-de-France : 70 arrested after 200 cars burned,0,1,3,38,3,9,5,41,0
Federal Reserve raises interest rates by another quarter-point,0,3,2,52,1,7,0,54,0
"Hands-on with the Samsung Galaxy S8 and S8 Plus: As first impressions go, this is a doozy",0,3,7,61,3,16,2,68,0
Another Killing in Region Bordering Chechnya,0,1,5,34,0,5,0,39,0
Mike Krzyzewski to Return vs. Pitt: Latest Comments and Reaction,0,2,7,46,2,9,0,53,0
Bhagat Singh's Letter To His Brother From Lahore Jail Shows Every Bit Of A Poet That He Was,0,3,18,55,1,17,0,73,0
Judge rules to keep Virginia man in jail until trial on aiding terror charge ,0,2,2,61,0,14,0,63,0
Human Rights Watch: Israel used white phosphorus on densely populated areas in Gaza,0,1,5,65,1,12,0,70,0
"Donald Trump tweets on Obamacare, promising ""far better"" alternative",0,3,3,54,3,8,0,57,0
Donald Trump Tests New Nickname for Clinton: ’Heartless Hillary’,0,2,8,45,3,8,0,53,0
Paul Richardson Makes Wild 1-Handed TD Catch vs. Lions,0,3,9,34,2,8,1,43,0
Hawaii Debates Same-Sex Unions,0,1,5,21,1,3,0,26,0
'Deadpool 2' and Two New 'X-Men' Movies Just Got 2018 Release Dates,0,3,10,36,5,11,5,46,0
US drops biggest non-nuclear bomb ever used on Islamic State in Afghanistan,0,3,5,58,1,11,0,63,0
10 wellness retreats to clear your head for 2017,0,3,0,34,0,8,6,34,0
"Poet, 81, faces eviction from £3m Belgravia flat by 'boring middle classes’ as she is accused of running B&B",0,3,4,77,6,18,3,81,0
Neda Agha-Soltan Becomes a Symbol of Iran Protests Through Video,0,1,9,45,1,9,0,54,0
Sony faces class action lawsuits for DRM,0,1,4,30,0,6,0,34,0
Ivory Coast's former first lady Simone Gbagbo acquitted,0,2,4,43,1,7,0,47,0
Former Japan Prime Minister Kiichi Miyazawa dies at 87,0,1,6,38,0,8,2,44,0
"Fast & Furious Films Would Have Caused Rs 3,400 Cr Of Damage If Stunts Were Performed For Real!",0,3,16,55,3,17,4,71,0
France election: New far right leader quits in Holocaust row,0,3,3,47,1,9,0,50,0
Data Dive: The check is in the mail,0,2,3,24,1,7,0,27,0
Australia proposes new anti-terror laws,0,1,1,33,1,4,0,34,0
Chile's worst wildfires destroy town as death toll rises to 11,0,3,1,48,1,10,2,49,0
Mariah Carey Shuts Down Custody Battle Rumors & Defends Nick Cannon: 'We Will Always Remain a Strong Family',0,3,16,71,4,17,0,87,0
Timeline of Aaron Hernandez’s legal problems ,0,3,3,35,1,6,0,38,0
'La La Land' Has Hollywood Singing A Different Tune About Musicals,0,3,11,43,2,10,0,54,0
How a single equipment malfunction grounded Delta Air Lines,0,2,4,47,0,8,0,51,0
Here Are The 2017 Grammy Nominations,0,3,5,22,0,5,4,27,0
"Donald Trump Is Sworn In as President, Capping His Swift Ascent ",0,3,10,42,1,11,0,52,0
Kobe Bryant Gifts Oregon Ducks with New Nike Kobe A.D. NXT Shoe,0,2,14,36,2,11,0,50,0
Stop Picking So Many NCAA Tournament Upsets,0,3,10,27,0,6,0,37,0
New York Is Benefiting From Movie Incentives,0,1,7,31,0,6,0,38,0
Two Australians charged after burning flag during riot,0,1,2,45,0,7,0,47,0
Macklemore Didn't Submit 'This Unruly Mess I Made' to the Grammys: Source,0,3,10,48,4,11,0,58,0
Hurricane Matthew slams Bahamas as rescuers try to reach Haiti,0,2,4,49,0,9,0,53,0
Somali pirates release Greek-owned ship,0,1,2,32,1,4,0,34,0
Group Offers 100 Days of Free Naturalization Help for Legal Residents,0,3,8,48,0,10,3,56,0
Robert Pirsig: Zen and the Art of Motorcycle Maintenance author dies aged 88,0,3,6,55,1,12,2,61,0
President Lula opens U.N. forum to combat corruption,0,1,4,39,2,7,0,43,0
Briton fighting with Kurds against Islamic State defends actions,0,3,4,52,0,8,0,56,0
Texas executes Mexican-born killer despite international appeals,0,1,2,55,1,6,0,57,0
EXCLUSIVE - Ted Cruz on School Choice Week: Let’s Unleash American Exceptionalism for Every Child - Breitbart,0,2,21,68,4,16,0,89,0
The Best Movies of 2016 ,0,3,3,12,0,5,4,15,0
Shuttle Discovery given 'go' for landing at Edwards AFB,0,1,6,39,2,8,0,45,0
Woody Johnson under consideration for U.K. ambassadorship,0,3,4,45,2,6,0,49,0
Joel Embiid Injury: Updates on 76ers Center's Foot and Recovery,0,2,7,43,2,9,2,50,0
Berlin Christmas Market Reopens After Terrorist Truck Attack,0,2,8,45,0,7,0,53,0
"Post-probe, problematic peanut paste products pulled",0,1,1,44,2,5,0,45,0
"Vincent Viola, Nominee for Army Secretary, Drops Out ",0,3,7,36,2,8,0,43,0
"Inspired By Ranveer Singh's ‘Ladies Vs Ricky Bahl’, Afghan Man Dupes US Women Of 60 Lakh",0,3,16,51,4,15,2,67,0
"U.S. Will 'Take Action' on Russian Hacking, Obama Promises",0,3,9,36,5,8,0,45,0
'Wells Fargo has been out of order for years!': Wells Fargo's shareholder meeting gets rowdy,0,3,4,69,5,14,0,73,0
Hyderabad Blast Prime Accused Riyaz Bhatkal Lives A Life Of Luxury In Karachi All Thanks To ISI,0,3,19,60,0,16,0,79,0
Vandals deface family crypt of Pierre Elliott Trudeau,0,1,4,42,0,7,0,46,0
Radio Links to Go Silent for a Tour De France Test,0,1,8,32,0,10,0,40,0
First-ever baby born using ‘three parent’ genetic engineering technique,0,2,1,59,3,8,0,60,0
"US abstains in key Israel vote, clearing way for condemnation of settlements ",0,2,3,61,1,12,0,64,0
Tresor Riziki: Fresh face of African music,0,2,4,31,1,6,0,35,0
"Ikutaro Kakehashi, Founder of Roland, Dies at 87",0,3,5,32,2,7,2,37,0
Vice President Mike Pence makes surprise visit to Korean Demilitarized Zone ,0,3,7,58,0,11,0,65,0
Off-duty New York correction officer shot and killed while sitting in car ,0,2,3,58,1,12,0,61,0
Grenade set off outside Tajik ministry,0,1,2,31,0,5,0,33,0
Roy Williams Reaches 800 Career Victories with UNC's Win vs. Syracuse,0,3,10,44,2,10,3,54,0
Founder of N.J. School for Disabled Charged in Theft of Public Funds ,0,3,9,46,2,12,0,55,0
Quebec to appeal long-gun registry destruction to the Supreme Court,0,1,3,54,1,9,0,57,0
Watch Denzel Washington Get Grilled About His Classic Movie Lines on 'Jimmy Kimmel Live',0,3,13,60,2,13,0,73,0
Two Men Kicked Off Plane for Reportedly Harassing Ivanka Trump,0,3,9,44,0,9,0,53,0
Truck carrying 12 million bees overturns in New Brunswick,0,1,3,44,0,8,2,47,0
Canadian victims of terrorism will be able to sue perpetrators,0,1,1,52,0,9,0,53,0
Concern Rises Over Behavioral Targeting and Ads,0,1,6,35,0,6,0,41,0
"Bergdahl requests pardon from President Obama, US officials ",0,3,5,46,1,8,0,51,0
"Donald, This I Will Tell You ",0,3,6,16,1,6,0,22,0
32 Texts From 2016 That Are Just Really Fucking Funny,0,3,8,30,0,9,6,38,0
Cairo church bombing: Amateur footage shows aftermath,0,3,2,44,1,6,0,46,0
US official warns of Hezbollah missile threat,0,1,3,36,0,6,0,39,0
Sad YouTuber finds a way to express her sorrow over her VR-distracted boyfriend,0,2,5,61,1,12,0,66,0
Jauz Announces Off The Deep End Series for 2017: Exclusive,0,2,8,36,1,9,4,44,0
Express Scripts Buys WellPoint Pharmacy Unit for $4.7 Billion,0,1,8,41,2,8,2,49,0
Unwinding Fed Support,0,1,3,16,0,2,0,19,0
"Foreclosing on a Plane, Then Flying It Away",0,1,6,29,1,7,0,35,0
Angela Merkel: We must make an effort for the EU we love,0,3,5,39,1,11,0,44,0
Investors cheer as Macron emerges as favorite to lead France,0,2,3,48,0,9,0,51,0
Sydney Opera House listed on World Heritage List,0,1,6,35,0,7,0,41,0
Clemson shocks Alabama to win first national title in 35 years,0,2,2,48,0,10,2,50,0
Man arrested over prostitutes' murders in Great Britain,0,1,3,44,1,7,0,47,0
Treasure hunter vanishes searching for $2 million in gold,0,2,1,46,1,8,1,47,0
Barack Obama cracked a joke as he left the Oval Office for the very last time,0,3,4,58,0,15,0,62,0
A Subdued Vladimir Putin Calls for ‘Mutually Beneficial’ Ties With U.S. ,0,2,11,46,4,11,0,57,0
Australia wins dramatic second Ashes Test,0,1,3,33,0,5,0,36,0
"NHS trust pays temporary boss £47,000 a month",0,2,3,28,2,7,5,31,0
Where Iron Is Bigger Than Oil or Gold,0,1,7,23,0,7,0,30,0
Fetus Found in Clogged Drain Pipe of Brooklyn Home: NYPD,0,2,11,35,1,9,0,46,0
Nelson Mandela dies aged 95,0,1,2,19,0,4,2,21,0
John Cena's Muscular Frame Made for a Poor Game Show Host on 'SNL',0,3,12,39,3,12,0,51,0
MILO Speech Cancelled After Violent North Dakota Pipeline Protesters Threaten Event - Breitbart,0,2,15,67,1,12,0,82,0
Riot Fest Co-Founder Sean McKeough Dies at Age 42,0,3,9,29,1,8,2,38,0
Spain legalizes same-sex marriage,0,1,1,28,1,3,0,29,0
"Shaq Challenges JaVale McGee to Go Three Games Without Doing Something to Make ""Shaqtin' A Fool""",0,2,16,62,3,15,0,78,0
Even the LA Chargers' new coach calls the NFL's lamest team the San Diego Chargers,0,3,10,56,2,14,0,66,0
Queen thanks military who helped bring 'peace' to Iraq and Afghanistan at national memorial service,0,3,3,80,2,14,0,83,0
Official Defends Signing Interrogation Memos,0,1,5,35,0,4,0,40,0
Dead Bat Discovered in Salad Mixes Prompts Recalls From Walmart,0,3,9,45,0,9,0,54,0
Islamic TV channel airs hardcore PORN in the middle of the day after falling for a 'satanic trick' in Senegal,0,3,8,80,2,19,0,88,0
Trump Orders Wall at Mexican Border,0,3,5,25,0,5,0,30,0
Illinois tollway worker jailed for stealing fines,0,1,1,42,0,6,0,43,0
Trump’s bogus claim that intelligence report says Russia didn’t impact the 2016 election outcome,0,3,2,75,2,13,4,77,0
"Hotel tax battle: Florida court sides with Expedia, Priceline, other travel companies",0,3,4,67,3,11,0,71,0
Police raid filesharing resources,0,1,1,29,0,3,0,30,0
C.I.A. Had Evidence of Russian Effort to Help Trump Earlier Than Believed ,0,3,12,47,3,12,0,59,0
Redskins Safety Duke Ihenacho Uses Tape to Make Cleats Look Like Chuck Taylors,0,3,12,54,0,12,0,66,0
"Hong Kong Regulator Sues StanChart, UBS Over 2009 Timber IPO",0,3,14,32,1,9,4,46,0
"Elizabeth II begins state visit to Ireland amid protests, security fears",0,1,4,57,1,10,0,61,0
Syrian Government And Opposition Forces Agree To Attend New Round Of Peace Talks,0,2,13,55,0,12,0,68,0
Treasury Boss Taking Fire in Europe Over Stimulus,0,1,7,35,0,7,0,42,0
"Robert James Waller, “Bridges of Madison County"" author, is dead at 77",0,2,6,47,4,11,2,53,0
Maroon 5 & Kendrick Lamar's 'Don't Wanna Know' Tops Pop Songs Chart,0,2,10,40,5,11,1,50,0
"9 ways to explain Brexit to kids – using Minecraft, sausages and cake",0,3,2,52,2,12,1,54,0
"Will Napoli beat Real Madrid? With Marek Hamsik, anything is possible",0,2,7,50,2,10,0,57,0
Forbes Names Scarlett Johansson As 2016's Highest Grossing Actor,0,3,8,43,1,8,4,51,0
Scotland's Grangemouth oil refinery catches fire,0,1,2,40,1,5,0,42,0
Clippers' Chris Paul to miss 6-8 weeks following thumb surgery,0,3,3,46,2,9,2,49,0
Michael Sweetney tried to kill himself as a Knicks rookie,0,2,3,45,0,9,0,48,0
Audi USA's innovative tail lights are mesmerizing,0,3,4,38,1,6,0,42,0
Samantha Bee 'Fixed' Bill O'Reilly's Fox News Exit Statement,0,2,10,38,4,8,0,48,0
Lady Gaga Opens Super Bowl LI Halftime Show With Tribute to America ,0,2,12,44,0,12,0,56,0
Trump's America Donald Trump jokes about wire-tapping during Angela Merkel press conference,0,2,6,72,2,11,0,78,0
"MP Returns Salary For Wasted Winter Parliament Session, Other MPs Refuse To Support Him!",0,3,16,57,2,13,0,73,0
"Adani plans to export low quality, high ash coal to India, court told",0,2,2,53,2,12,0,55,0
Ellen Asks George W. Bush About His Inauguration Poncho: 'Had You Put One On?',0,3,14,46,5,13,0,60,0
"At 30, Rams' Sean McVay Joins List Of Youngest Coaches Ever In Major Pro Sports",0,3,15,46,2,14,2,61,0
GOP Senate to move forward on ObamaCare repeal ,0,2,6,33,0,8,0,39,0
Seth Meyers Takes a Closer Look at Trump's White House Full of Climate Change Deniers,0,2,12,58,1,14,0,70,0
"Blake Griffin Uses Kevon Looney's Head for Leverage, Posterizes Him",0,3,9,47,2,9,0,56,0
Algerian driver released by hostage takers in Niger,0,1,2,42,0,7,0,44,0
26 Tweets Prove #WhatFeministsWear Is ‘Anything They F*cking Want',0,2,10,42,4,8,2,52,0
Australia Ends Ban on Shorting Financial Stocks,0,1,6,35,0,6,0,41,0
Inside Camila Cabello's Fifth Harmony Exit: Where Did It All Go Wrong?,0,2,12,44,3,11,0,56,0
Accused Florida Airport Shooter Enters Not Guilty Plea in Federal Court,0,2,10,51,0,10,0,61,0
"Fox News Poll: Confidence in military remains high, in media low ",0,3,4,48,2,11,0,52,0
Women's World Cup Live: United States vs. Australia,0,2,7,34,3,7,0,41,0
Mass protest grows against Kudankulam nuclear power plant in India,0,1,3,54,0,9,0,57,0
Foam Fills Philadelphia Streets After Substation Incident ,0,3,7,44,0,7,0,51,0
Alleged Chicago Gang Boss Denies Ordering Hit on Informant ,0,2,8,42,0,9,0,50,0
"As Factories Close, Graduates Focus More on College",0,1,7,36,1,7,0,43,0
Moldovan mobile phone growth results in more than 2 million users,0,1,1,53,0,10,1,54,0
"John McCain, Chuck Schumer Call For Select Committee To Investigate Russia Hacks",0,2,13,55,1,11,0,68,0
How big a problem is crime committed by immigrants?,0,3,1,41,1,8,0,42,0
"Tencent Hires Baidu’s Big-Data Director, Betting on Artificial Intelligence",0,2,9,55,3,8,0,64,0
Bruno Mars Teaches James Corden All About Fashion and Elvis on 'Carpool Karaoke': Watch,0,3,12,59,3,13,0,71,0
Doctors say Florida stem cell clinic left 3 women blind,0,3,2,43,0,9,1,45,0
"Hot on the Trail of ‘La La Land,’ Here Come More Movie Musicals ",0,3,10,38,3,13,0,48,0
"MTV, Warner Music agree on licensing deal",0,1,5,29,1,6,0,34,0
Netanyahu: Obama ’Failed to Protect Israel Against This Gang-Up at the UN’ - Breitbart,0,2,12,56,5,13,0,68,0
Pro-Trump rally in Berkeley turns violent as protesters clash with the president’s supporters,0,3,3,76,2,12,0,79,0
Microsoft offers to pay blogger to 'correct' Wikipedia article,0,1,2,50,2,8,0,52,0
Janet Jackson gives birth to baby boy,0,3,2,29,0,6,0,31,0
Astronomers discover largest star on record,0,1,1,37,0,5,0,38,0
Indian foreign minister criticized after reading wrong speech at UN summit,0,1,3,61,0,10,0,64,0
"Paul Winchell, voice of Tigger, Gargamel, dead at 82",0,1,4,35,3,8,2,39,0
December blizzard slams Northeastern United States,0,1,4,41,0,5,0,45,0
"Zoe Saldana says Trump opponents “became bullies,” helping him win",0,2,3,51,3,9,0,54,0
Pakistan's parliament elects first female speaker,0,1,1,42,1,5,0,43,0
Rockets GM Daryl Morey Throws Shade at Russell Westbrook's NBA MVP Candidacy,0,3,16,48,1,11,0,64,0
Israeli Burger King gives out 'adult toys' for Valentine's Day,0,2,5,45,3,9,0,50,0
Concrete Being Remixed With Environment in Mind,0,1,6,35,0,6,0,41,0
Criticism of Afghan War Is on the Rise in Britain,0,1,6,34,0,9,0,40,0
"Adele, Rihanna, Beyonce Headline Highest-Paid Grammy Nominees",0,3,8,44,3,6,0,52,0
"Costs Soar as Iraq Falls Behind on Training Plan, Audit Says",0,1,9,40,1,10,0,49,0
Norfolk youths banned from buying eggs and ketchup,0,1,1,42,0,7,0,43,0
Dramatic moment plane lands on MOTORWAY after suffering 'engine fault' in mid-air ,0,2,9,58,3,12,0,67,0
The Dutch Are Stunning the World at the Classic,0,1,6,33,0,8,0,39,0
UN chief Ban Ki-moon hints he could run for South Korea's presidency,0,3,6,49,2,11,0,55,0
Sri Lanka Rejects Tamil Call for Cease-Fire,0,1,7,29,1,6,0,36,0
Burial site for Polish president Lech Kaczynski draws objections,0,1,4,52,0,8,0,56,0
The Koch brothers and the Republican Party go to war — with each other,0,2,4,52,1,13,0,56,0
TOP TRUMP CONFIDANT: Trump should make a deal with Ruth Bader Ginsburg,0,3,21,37,1,11,0,58,0
787 Dreamliner has eyepopping rehearsal for Paris Air Show,0,2,4,43,0,8,3,47,0
Russia expels four UK diplomats,0,1,3,24,0,4,0,27,0
Carrie Fisher's brother says actress is in stable condition,0,3,2,48,1,8,0,50,0
Argentina Decides to Move Up Its Elections,0,1,6,30,0,6,0,36,0
"Bright Lights, Big Sales: The Most Expensive Homes Sold In America's Biggest Cities This Year",0,2,15,61,3,14,0,76,0
China Orders Patches to Planned Web Filter,0,1,6,30,0,6,0,36,0
"In Their Final Push For The Control Of Aleppo, Syrian Army Has Killed At Least 82 Civilians, Says UN",0,3,19,59,2,18,2,78,0
Joe McElderry wins UK X Factor final,0,1,7,23,0,6,0,30,0
NHS chief Simon Stevens refuses to buckle under No 10 pressure,0,3,6,44,0,10,2,50,0
Pope Benedict XVI confirms visit to Scotland as part of his UK tour,0,1,8,47,0,12,0,55,0
Even Germany’s Post Office Is Building an Electric Car,0,3,8,37,1,8,0,45,0
High-level Defence meetings with Japan postponed over Minister Marise Payne's health,0,3,6,66,2,10,0,72,0
Donald Trump presidency could 'lead to a world war' Iran's defence minister warns,0,3,3,63,3,12,0,66,0
Red Cresent workers kidnapped as Blair visits Iraq,0,1,4,39,0,7,0,43,0
There has been a shake-up in trading at the world's largest hedge fund,0,2,1,55,2,12,0,56,0
The Ruling that Wisconsin’s Right-to-Work Law Is Unconstitutional Will Not Survive Appeal.,0,2,12,63,4,11,0,75,0
India To Become The World's Youngest Nation By 2020 With An Average Age Of 29!,0,3,13,43,2,14,6,56,0
Massive Turtle Has No Idea How Awesome He Is,0,3,9,27,0,8,0,36,0
"Seven-year-old raises £100,000 for Haiti in sponsored bike ride",0,1,2,43,4,8,6,45,0
Waymo Taps Phoenix For A Big Public Test Of Google Self-Driving Car Tech,0,3,14,45,1,12,0,59,0
"McCain: Yemen Raid Was Meant to Capture, Kill Al Qaeda Terrorists",0,3,11,42,2,10,0,53,0
Fifteen flu sufferers die in Wales in one week,0,1,2,36,0,8,0,38,0
Lindsay Lohan Claims She Was Racially Profiled for Wearing a Headscarf,0,3,9,51,0,10,0,60,0
SNEAK PEEK: President Trump Sits Down with Hannity at White House  Insider,0,3,17,44,1,12,0,61,0
"In Their Final Push For The Control Of Aleppo, Syrian Army Has Killed At Least 82 Civilians, Says UN",0,2,19,59,2,18,2,78,0
"Eight killed in Virginia shooting, suspect surrenders",0,1,2,44,1,6,0,46,0
Andre Johnson Breaks Down Crying During NFL Retirement Speech,0,3,11,42,0,8,0,53,0
This Woman Seemingly Convinced Her Husband She Adopted a Coyote and He Actually Believed Her,0,3,13,65,0,14,0,78,0
‘What’s the Big Deal?’ Ask Trump Voters on Russia Hacking Report ,0,3,9,41,4,11,0,50,0
"Thunder Fan Wins $20,000 by Sinking Half-Court Shot at Halftime",0,2,8,38,3,9,5,46,0
Suspect in Madeleine McCann case Robert Murat has confiscated possessions returned,0,1,6,66,0,10,0,72,0
'Climate change is real': companies challenge Trump's reversal of policy,0,3,2,57,4,9,0,59,0
Dutch MP advocates proscription of Koran,0,1,4,31,0,5,0,35,0
"Koosman, Former Met, Pleads Guilty to a Charge of Tax Evasion",0,1,8,41,2,10,0,49,0
Gummy bear giant set to open its first U.S. factory,0,3,3,37,2,9,0,40,0
UN offices in Pakistan hit by suicide bomber,0,1,3,34,0,7,0,37,0
One of two missing Sydney crocodiles is found by family on Easter Sunday stroll,0,3,4,62,0,13,0,66,0
SpaceX successfully launches rocket after Saturday setback,0,3,3,49,0,6,0,52,0
Luis Soltren surrenders in 1968 hijacking of Pan Am 281,0,1,4,35,0,9,7,39,0
Building collapses in Mecca at eve of Hajj pillgrimage,0,1,3,43,0,8,0,46,0
White House blasts Trump team for secrecy that 'only serves to sow public doubt',0,2,3,62,2,13,0,65,0
2008 Taiwan Tourism Exposition to encourage tourism industry after Sichuan earthquake,0,1,4,67,0,10,4,71,0
World leaders react to Obama's victory,0,1,2,30,1,5,0,32,0
Jerry Collins' Former Team-Mates Gather for Emotional Haka at Scene of Accident,0,3,10,56,2,11,0,66,0
Rare parchment copy of Declaration of Independence found by Harvard researchers ,0,3,4,65,0,11,0,69,0
Judge cleared of misconduct in Brock Turner sexual-assault case,0,3,3,51,1,8,0,54,0
"Over 13,500 evacuated after wildfire in California",0,1,2,36,1,6,5,38,0
One of the best low-cost airlines in the world is finally coming to America,0,3,2,59,1,13,0,61,0
Pope Francis: Europe migrant centres 'concentration camps',0,3,3,46,3,6,0,49,0
Arkansas Pushes For Voter ID Law That State Supreme Court Already Ruled Unconstitutional,0,3,14,62,0,12,0,76,0
Angel McCoughtry Leads Louisville to Its First Final Four,0,1,9,40,0,8,0,49,0
Classic Bobby Valentine: Waiting for a Call,0,1,5,31,1,6,0,36,0
Schiff says Russia is absolutely 'complicit' in Syrian chemical attack ,0,2,3,56,2,10,0,59,0
"Trump can now tap money from his business, raising ethics concerns",0,3,1,54,1,10,0,55,0
Swine Flu Is Confirmed in 67 Cadets at the Air Force Academy,0,1,8,39,0,11,2,47,0
Capuchin Monkeys Pick Right Tool for a Tough Nut,0,1,7,33,0,8,0,40,0
Court photos show FLDS leader Warren Jeffs with child brides,0,1,7,44,0,9,0,51,0
Shares Slide on Worries Over Rising Interest Rates,0,1,7,36,0,7,0,43,0
National Museum of Scotland reopens after three-year redevelopment,0,1,3,55,1,7,0,58,0
"Candice Wiggins says was targeted for being heterosexual in ""toxic"" WNBA",0,3,6,54,2,10,0,60,0
U.S. strikes Syrian military airfield in first direct assault on Bashar al-Assad’s government,0,2,5,72,4,12,0,77,0
"Jobs Growth Slowed in March, 98,000 vs 180,000 Expected",0,2,5,28,3,8,11,33,0
British ISPs restrict access to Wikipedia amid child pornography allegations,0,1,5,62,0,9,0,67,0
Islamabad on red alert for possible terrorist attack,0,1,1,44,0,7,0,45,0
"Guantanamo detainee David Hicks pleads guilty to providing ""material support""",0,1,3,63,2,9,0,66,0
Celebs to descend on Washington for anti-Trump mega-rally ,0,2,3,45,2,8,0,48,0
Obama Promises the World a Renewed America,0,1,5,31,0,6,0,36,0
"Bombs kill US Marines, civillians in Iraq",0,1,5,29,1,6,0,34,0
Donald Trump Shares Chocolate Cake and ‘Great Chemistry’ With China’s Xi,0,2,10,49,3,10,0,59,0
Indianapolis remains undefeated with win in Jacksonville,0,1,2,48,0,6,0,50,0
Zurich shooting: Swiss police say gunman is dead after mosque attack,0,3,2,55,1,10,0,57,0
Ireland votes 'Yes' to Lisbon Treaty,0,1,4,25,2,5,0,29,0
Chuck Schumer: Democrats Could Work With Trump If He Ditches His Hard-Right Policies,0,2,14,56,2,12,0,70,0
"'This Is Not A Muslim Ban,' Donald Trump Claims After Controversial Immigration Move",0,3,13,56,3,12,0,69,0
Afghan Taleban attacks NATO base; several dead,0,1,6,33,1,6,0,39,0
Arkansas Executions,0,3,2,16,0,1,0,18,0
6.5 magnitude earthquake hits off coast of Taiwan,0,1,1,38,1,7,2,39,0
Recap: President Trump’s address to Congress [Video],0,3,5,37,4,6,0,42,0
Donald Trump says meeting with Chinese President Xi Jinping will be ‘very difficult’,0,3,6,64,2,12,0,70,0
Subject of high-profile Italian euthanasia case dies,0,1,2,43,1,6,0,45,0
Israeli forces begin evacuation of West Bank outpost as residents barricade in their homes,0,3,3,74,0,13,0,77,0
Disney’s ‘Rogue One’ Surges With $155 Million Weekend Haul,0,3,8,35,4,8,3,43,0
Zimbabwean cargo plane crashes in Shanghai; three dead,0,1,2,44,1,7,0,46,0
U.S. Sues Railroad Over Smugglers,0,1,6,21,2,4,0,27,0
Zimbabwe opposition claims early victory in election,0,1,1,45,0,6,0,46,0
"Everyone Pays A Hefty Price For Segregation, Study Says",0,2,9,37,1,8,0,46,0
"Ukip is Europe's laziest party, researchers reveal",0,3,2,40,2,6,0,42,0
Twin bombings hit Baghdad's Green Zone,0,1,4,28,1,5,0,32,0
Picture | Betty White Through the Years ,0,3,5,27,1,7,0,32,0
How the controversial DACA deportation case landed with Judge Curiel ,0,3,7,52,0,10,0,59,0
"Feeling Unwanted In Germany, Some Afghan Migrants Head Home",0,2,9,41,1,8,0,50,0
Manufacturing in U.S. Kept Expanding at Robust Pace in March,0,3,8,41,2,9,0,49,0
'George Davis is innocent - OK': UK court partially vindicates campaign after 36 years,0,1,6,61,4,13,2,67,0
IG report: TSA failed to identify 73 workers 'linked to terrorism' ,0,2,5,46,3,11,2,51,0
Battle Against ISIS In Mosul: Iraqi Forces Advance on Airport,0,2,12,39,1,9,0,51,0
BREAKING NEWS: Three killed as a bus carrying 50 school children flips on a road in northern Sweden ,0,3,14,65,1,18,2,79,0
Samsung mobile recovery suffers blow as Galaxy Notes ’catch fire’,0,2,3,51,2,9,0,54,0
Sony Boosts Full-Year Earnings Estimate by $430 Million,0,3,7,36,2,7,3,43,0
Second carrier to join US ships near Korean Peninsula,0,2,5,40,0,8,0,45,0
Burnett Humbles Rays; Nady Leaves Game With Injury,0,1,8,34,1,7,0,42,0
"Review: ‘Come From Away,’ a Canadian Embrace on a Grim Day ",0,2,8,36,4,11,0,44,0
U.S. Soldier and 11 Iraqis Die in Attacks,0,1,6,24,2,7,2,30,0
Who is Elizabeth Warren's refugee guest for Trump's joint address?,0,3,4,50,3,9,0,54,0
Former Mexican President Vicente Fox Warns Donald Trump: 'Don’t Mess Around With Us',0,3,13,55,4,12,0,68,0
Backstreet Boy Brian Littrell: ‘Hollywood Needs to Chill Out’ on Trump,0,2,9,48,3,10,0,57,0
"For Somalia, Chaos Breeds Religious War",0,1,6,27,1,5,0,33,0
"William Peter Blatty, Author Of 'The Exorcist,' Dead At 89",0,2,9,34,4,9,2,43,0
"Copeland defeat fallout: Labour leadership must take ‘long hard’ look at itself, Tom Watson says ",0,3,4,74,4,15,0,78,0
Tax credit 'rape clause' becomes law without parliamentary vote,0,2,1,52,2,8,0,53,0
"Army life is 'boring' and that’s why I was a terrible soldier, says new armed forces minister",0,3,2,71,4,16,0,73,0
Trump's vineyard is hiring -- foreign workers,0,2,1,35,3,6,0,36,0
Why we should all be worried by Mr Cameron's muddle,0,3,3,38,1,9,0,41,0
Canadian track and field coach Charlie Francis dies at age 61,0,1,3,46,0,10,2,49,0
"On Obamacare, a Party-Wide Failure",0,2,5,23,2,4,0,28,0
Undocumented immigrant's FB post on paying taxes draws social media ire,0,3,3,57,1,10,0,60,0
Lenders in Need of Financial Help,0,1,4,24,0,5,0,28,0
Ed Sheeran Has This To Say To Children Who Suffer From Stuttering: “Embrace Your Weirdness”,0,3,15,59,3,14,0,74,0
Brown University to drop fee for low-income applicants ,0,3,2,44,1,8,0,46,0
These Nobel Prizewinners Show Why Immigration Is So Important For American Science,0,2,12,59,0,11,0,71,0
Indonesians Pray Ahead of Fraught Election ,0,2,5,32,0,6,0,37,0
"Mount Etna, Europe’s Most Active Volcano, Puts On a Show ",0,3,9,35,3,10,0,44,0
"The timing might be odd, but extending Jay Gruden is the right call for the Redskins",0,3,4,64,1,15,0,68,0
Earth Day picked as date for science march on Washington,0,2,3,44,0,9,0,47,0
Census Says U.S. Population Grew at Lowest Rate Since Great Depression This Year,0,3,13,53,2,12,0,66,0
ABC News quiz: How much have you retained?,0,3,5,28,2,7,0,33,0
Ruble Staging a Rally on Russia's Surprise Rate Cut Has Trend on Its Side,0,2,11,48,1,13,0,59,0
Source: Killer fugitives likely on foot - CNN Video,0,2,6,35,2,8,0,41,0
"For Cleveland State, Healing Begins With Another N.C.A.A. Bid",0,1,12,36,5,8,0,48,0
Fox News Poll:  A majority says 'move on' from protesting Trump ,0,3,5,44,3,12,0,49,0
A Reluctance to Break the Large Bills,0,1,5,26,0,6,0,31,0
"Iraqi insurgents guilty of war crimes, says Human Rights Watch",0,1,4,48,1,9,0,52,0
AMD Betting on Wi-Fi to Open Up Virtual Reality,0,3,10,28,1,8,0,38,0
Stephen Colbert Shreds GOP For Scrapping Internet Privacy Rules,0,3,11,44,0,8,0,55,0
Mark Few on late non-call: 'Had no idea ... nobody made me aware',0,2,3,43,7,12,0,46,0
France confirms deportation of illegal Afghan immigrants,0,1,2,48,0,6,0,50,0
Detroit’s Resurgence Brings New Housing Concerns,0,3,6,36,1,5,0,42,0
Donald Trump Can Clear Up Questions About His Ties To Russia By Releasing His Tax Returns,0,3,16,58,0,15,0,74,0
Toyota Said to Weigh Reorganizing U.S. Operations,0,1,7,34,2,6,0,41,0
Appeals Court Rejects Immigrants’ Right to a Lawyer in Expedited Cases,0,3,8,51,1,10,0,59,0
Iran Hangs 22 in Executions This Week,0,1,5,24,0,6,2,29,0
"In Mexico, Obama Seeks Curbs on Arms Sales",0,1,7,27,1,7,0,34,0
Floyd Mayweather Jr.'s car set on fire during Birmingham tour stop,0,2,4,50,2,10,0,54,0
Flynn in 2016: When you are 'given immunity' that probably means you committed a crime ,0,3,2,63,3,15,4,65,0
"J.T. Barrett Announces He Will Return to OSU in 2017: Latest Details, Reaction",0,3,13,45,4,12,4,58,0
At least 1 dead after shooting near mall in South Florida ,0,2,3,43,0,11,1,46,0
"Boat in DR Congo capsizes, 80 feared dead",0,1,4,27,1,7,2,31,0
MSN Encarta introduces wiki-like enhancements,0,1,4,36,1,4,0,40,0
Phoenix Mom’s Deportation May Point Toward Trump Immigration Changes,0,3,9,50,1,8,0,59,0
We need to stop being hysterical about President Erdogan – he is not all Turkey has to offer,0,3,4,70,1,17,0,74,0
"Myron Cope, Pittsburgh Steelers color commentator, retires after a 35 year career",0,1,4,62,2,11,2,66,0
Flint water crisis: New criminal charges filed,0,2,2,37,1,6,0,39,0
MyBook Disk Drive Handles Lots of Easy Backups,0,1,8,31,0,7,0,39,0
FX Announces Premiere Date for 'X-Men' Series 'Legion' With Trippy New Trailer,0,2,13,49,5,11,0,62,0
Carmelo Anthony Buys NASL Team Puerto Rico FC,0,2,12,26,0,7,0,38,0
Alabama residents and geologists perplexed by spate of earthquakes,0,3,1,57,0,8,0,58,0
Charlie Murphy's Prince sketch was a work of genius,0,2,3,39,1,8,0,42,0
Salvador: The city where children fend for themselves on the streets,0,2,2,55,1,10,0,57,0
The Drake Relays: a Big-Time Meet in a Small-Town Atmosphere,0,1,9,39,3,9,0,48,0
The Democrats’ Days of Rage and Denial,0,2,5,26,1,6,0,31,0
Icelandic Hekla volcano shows signs of activity,0,1,2,39,0,6,0,41,0
College Student Suffers Severe Reaction After Hazing Involving Peanut Butter ,0,3,10,57,0,10,0,67,0
"G.M. Said to Pick Michigan, Saving 5,000 Jobs",0,1,7,23,4,7,4,30,0
"Gul Panag Sets Another Record, Becomes The First Indian Woman To Drive Formula E Racing Car",0,3,16,59,1,15,0,75,0
"No, Trump's victory was not the biggest Electoral College win since Reagan",0,3,5,56,2,11,0,61,0
Republicans Debate Risks of Supreme Court Battle,0,1,6,36,0,6,0,42,0
"European Middleman Haschke Has Admitted To Swiss Authorities About SP Tyagi's Bribe Share, Says CBI",0,2,18,65,2,14,0,83,0
Baseball player Manny Ramirez retires after testing positive for performance-enhancing drug,0,1,3,77,1,10,0,80,0
Gunmen Kill Iraqi Cleric Campaigning for Council,0,1,6,36,0,6,0,42,0
Judge in Brock Turner case cleared of misconduct allegations,0,3,3,49,0,8,0,52,0
"Maureen Braddy, Allan Whyte disappearance: $1 million reward offered in case of missing Bendigo teenagers",0,3,5,82,3,14,1,87,0
The Real Goal Of Trump's 'Merit-Based' Immigration Plan May Just Be Fewer Immigrants,0,3,14,54,4,12,0,68,0
Opening Ceremony Presented a Protest-Inspired Ballet,0,3,6,40,1,5,0,46,0
"Late-night hosts demolish Trump administration’s Russia denials, taking jabs at Jeff Sessions",0,2,5,74,3,11,0,79,0
"Todd Fisher shares details about Debbie Reynolds, Carrie Fisher memorial ",0,3,6,56,1,10,0,62,0
US considers banning laptops on flights from UK airports,0,2,4,44,0,8,0,48,0
The Bombs of Steve Bannon ,0,2,4,17,0,5,0,21,0
"Tamil Nadu: Traders ban Pepsi, Coca-Cola to support local products",0,2,6,48,3,9,0,54,0
"Court Refuses to Reinstate Travel Ban, Dealing Trump Another Legal Loss ",0,3,10,50,1,11,0,60,0
The First Single From the Faith-and-Biggie Duets Album is Here,0,2,9,42,2,9,0,51,0
Surrey County Council announces referendum on 15% tax hike to fund social care,0,2,3,60,1,12,2,63,0
11 Republican Lawmakers Sign Letter In Support Of Arts Funding,0,2,9,42,0,9,2,51,0
Ronda Rousey's nemesis on Friday's bout: 'She'd better be ready' ,0,3,4,45,6,10,0,49,0
Scientists Want to Give the Atmosphere an Antacid to Relieve Climate Change,0,3,8,56,0,11,0,64,0
"Hincapie and Armstrong, Former Teammates, Take on New Roles",0,1,7,42,2,8,0,49,0
United Airlines to now offer voluntarily bumped fliers up to $10G after review ,0,3,3,60,1,13,2,63,0
Here are the photos that show Obama’s inauguration crowd was bigger than Trump’s,0,3,3,63,2,12,0,66,0
"DJ Khaled Discusses His Book, Fatherhood & The Time Obama Used His Song With Stephen Colbert",0,3,16,59,2,15,0,75,0
Twitter has a grand old time with Trump's unfinished sentence,0,3,2,49,1,9,0,51,0
"""Silicon Valley"" Finished Its Homework And Now It Gets To Have Some Fun",0,2,13,44,2,12,0,57,0
Oregon Ducks to Debut 'Electric Green' Uniforms vs. Utah,0,2,7,38,3,8,0,45,0
Nigeria bill has Taylor implications,0,1,2,30,0,4,0,32,0
Canadian loses health benefits after company finds joyful Facebook pictures,0,1,2,64,0,9,0,66,0
Pierre Cardin Won’t Get Out of Bed for Less Than a Billion Euros,0,2,10,41,1,12,0,51,0
Kenya's vinyl king keeps on spinning,0,3,1,29,1,5,0,30,0
Israel Approves Legislation Retroactively Legalizing Settlements ,0,3,6,53,0,6,0,59,0
John Glenn Lies in Honor at Ohio Capitol for Public Goodbye ,0,2,8,41,0,11,0,49,0
Inauguration Day: Live Coverage ,0,3,4,23,1,4,0,27,0
Pro Bowl Roster 2017: Full List of Super Bowl 51 and Injury Replacements,0,2,9,44,1,12,6,53,0
Grammar school floods on Queensland's Sunshine Coast,0,1,4,41,1,6,0,45,0
Mark Levin has warned before of Obama’s ‘silent coup.’ Now he has a follower in the Oval Office.,0,3,6,68,5,17,0,74,0
Climate change: China calls US 'selfish' after Trump seeks to bring back coal,0,3,5,57,3,12,0,62,0
Mother and daughter die after becoming locked in Czech sauna,0,3,2,49,0,9,0,51,0
"Proposed NYC Teacher Evaluation Plan Emphasizes Classroom Work, Projects",0,2,11,52,1,8,0,63,0
"Privacy Shield Seems Safe, but Have a Backup Plan",0,3,7,33,1,8,0,40,0
Afghan Lawmakers Accuse a Governor of Graft,0,1,5,32,0,6,0,37,0
Police Say ‘Car Surfing’ to Blame in Iowa Teen’s Death,0,2,8,34,3,9,0,42,0
Canadian top court strikes down private medicare ban in Quebec,0,1,2,51,0,9,0,53,0
Tory MP Crispin Blunt questions PM's criticism of John Kerry on Israel,0,3,10,48,1,11,0,58,0
Bird Slams Into Man's Face In Bloody Roller Coaster Accident,0,3,10,40,1,9,0,50,0
Swatch CEO Nick Hayek Sees Swiss Watch Turnaround in 2017,0,3,10,34,0,9,4,44,0
"Following Universal Deal, Spotify Locks Down Indies in Long-Term Licensing Pact With Merlin",0,3,13,64,2,12,0,77,0
"Amina Blue, Kanye West's Muse, Breaks Down the Yeezy Season 5 Show",0,3,10,41,3,11,1,51,0
"Isil slave markets sell girls for as little as 'pack of cigarettes', says UN",0,2,3,57,3,13,0,60,0
UK Government announce same-sex weddings to start from March 29,0,1,4,47,1,9,2,51,0
Switch to Digital TV Broadcasts Is a Work in Progress,0,1,8,36,0,9,0,44,0
Jenson Button wins Hungarian Grand Prix,0,1,5,29,0,5,0,34,0
Watch WizKid's Kaleidoscopic 'Come Closer' Video Featuring Drake,0,3,9,45,3,7,0,54,0
A Dude Tried To Troll This Supermarket’s Twitter Account And Things Got Weird Fast,0,2,14,54,1,13,0,68,0
France’s Political Upstart Tested in Election Debate,0,3,6,39,1,6,0,45,0
"Meet The New Kid On 'Sesame Street': Julia, A Muppet With Autism",0,3,12,37,4,11,0,49,0
Dude trolls Starbucks baristas with a bunch of weird containers to fill up with coffee,0,3,2,70,0,14,0,72,0
Ivory Coast mutiny: President Ouattara dismisses security chiefs,0,3,4,52,1,7,0,56,0
Advantages of Traveling With Multiple Passports,0,1,5,37,0,5,0,42,0
David Cameron orders crackdown on summer surge of FGM cases,0,3,5,45,0,9,0,50,0
Mixed reception on Capitol Hill to Trump's proposed budget,0,3,4,45,1,8,0,49,0
"Cuban-Americans, Young And Old, Celebrate Castro’s Long-Awaited End",0,2,10,45,5,7,0,55,0
British voice artist Roy Skelton dies at age 79,0,1,3,34,0,8,2,37,0
Dow Jones Has Best Week Since 2011 Due to Trump Election Win,0,2,10,35,0,11,4,45,0
"As Rodriguez Went Pro, His Teammate Went to College",0,1,8,34,1,8,0,42,0
"Four U.S. Tourists, Australian Pilot Killed After Plane Crashes Into Shopping Center",0,2,13,57,3,11,0,70,0
Madrid enacts temporary car ban to help fight rising pollution levels,0,3,1,58,0,10,0,59,0
NASA Releases A View Of How Carbon Dioxide Is Moving Over The Earth And You're Going To Be Scared,0,3,22,56,1,18,0,78,0
"Thor and his Aussie roommate are back, dealing with real life struggles",0,3,2,57,1,11,0,59,0
Watch Shirtless Vladimir Putin Replace Alec Baldwin's Trump in Post-Inauguration 'SNL' Opening,0,3,14,65,4,11,0,79,0
US frees Mexican man who was arrested despite work permit,0,2,3,45,0,9,0,48,0
Blinded by Science in the Online Dating Game,0,1,5,32,0,7,0,37,0
Tear Down Old Yankee Stadium and Build Up the Bronx,0,1,8,34,0,9,0,42,0
Aaron Hernandez Death: Judge Orders Release of Suicide Notes to Family,0,2,9,50,1,10,0,59,0
Merkel’s Run for Fourth Term Just Got More Complicated,0,3,8,37,1,8,0,45,0
"Mattis' Pentagon pick seen as supporter of Muslim Brotherhood, group Trump may outlaw ",0,3,5,66,2,13,0,71,0
Brazil passes the mother of all austerity plans,0,3,1,39,0,7,0,40,0
Segregated schools persist because parents maintain the divide,0,3,1,54,0,7,0,55,0
A New Jersey town is panicking because it's about to become Trump's summer getaway,0,3,4,63,2,13,0,67,0
United Kingdom economy triple dip recession 'to be avoided' says British Chambers of Commerce,0,1,5,73,2,13,0,78,0
"Dolly Parton, Cyndi Lauper, Kenny G & More Share Their Favorite Christmas Songs",0,3,12,52,3,12,0,64,0
Sri Lankans vent anger as toll rises in rubbish dump collapse,0,3,2,49,0,10,0,51,0
Pastor Invites  Flock to Bring Their Guns to Church,0,1,7,35,0,9,0,42,0
Why fashion bloggers Tom and Lorenzo won’t critique Melania Trump: They fear Trump’s ‘followers’,0,3,7,71,5,13,0,78,0
Divisions Arose on Rough Tactics for Qaeda Figure,0,1,6,36,0,7,0,42,0
Three dead infants found in Canadian home,0,1,2,33,0,6,0,35,0
UK judge reveals gang warfare crimes of policeman,0,1,2,40,0,7,0,42,0
Peanut Company Files to Liquidate Its Assets,0,1,6,32,0,6,0,38,0
New moth named in honor of Donald Trump,0,2,3,29,0,7,0,32,0
Hoosiers' Kevin Wilson resigns; Tom Allen named new coach,0,3,5,42,2,8,0,47,0
"Donald Trump, Federal Reserve, Dutch Elections: Your Thursday Briefing ",0,2,9,50,3,9,0,59,0
Muslim Women in Hijab Break Barriers: ‘Take the Good With the Bad’ ,0,3,9,43,3,12,0,52,0
"Flat-pack fashion: Ikea takes swipe at Balenciaga's $2,150 shopping bag",0,2,3,50,5,9,4,53,0
Death of candidate will delay final results for German federal election by weeks,0,1,2,66,0,12,0,68,0
Why 5 Trump Voters Are Going to the Inauguration ,0,3,6,33,0,9,1,39,0
"After 100 days, Donald Trump’s new world order looks like the old one",0,2,3,49,2,12,3,52,0
"New Mexico-based charismatic leader fails to predict doomsday, again",0,1,2,56,2,8,0,58,0
Former Louisiana governor Buddy Roemer announces run for president,0,1,4,54,0,8,0,58,0
A $31.6 billion hedge fund is calling for a major overhaul of laws meant to prevent another financial crisis,0,3,1,84,2,18,3,85,0
Mercedes-Benz adds Alexa and Google Home integration,0,3,5,40,1,6,0,45,0
WEST OAKLAND FIRE: Inspectors found building lacked sprinklers before deadly blaze ,0,3,16,55,1,11,0,71,0
Trump Draws the Line: It’s ’Hollywood vs. Georgia’ in June Runoff Election,0,2,9,49,5,11,0,58,0
Facebook Mounts Effort to Limit Tide of Fake News ,0,2,7,34,0,9,0,41,0
Ikea expanding parental leave; crib assembly still your job,0,3,1,49,1,8,0,50,0
"Move Over, Acai. Here Comes the Maqui Berry",0,3,7,27,2,7,0,34,0
"Erin Moran, Who Played Joanie on ‘Happy Days’, Dead at 56",0,3,8,33,4,10,2,41,0
Europe's harsh winter blamed for more than a dozen deaths in three countries,0,3,1,62,1,12,0,63,0
Ukraine implements tougher rules on Russian navy,0,1,2,40,0,6,0,42,0
Blagojevich Makes a Day of It on Way Out,0,1,6,26,0,8,0,32,0
New Witness Account Undermines Mexican Government Narrative Of Missing Students,0,3,10,60,0,9,0,70,0
Kardashian West robbery: First suspects under formal investigation,0,2,3,55,1,7,0,58,0
McDonald’s Wants to Woo You With Two New Big Macs,0,3,10,29,1,9,0,39,0
Amazon Reef: First images of sponge and coral system discovered at mouth of river released,0,3,3,72,1,14,0,75,0
"Trump supporters declare pride in president, slam opponents ",0,3,1,50,1,8,0,51,0
Lady Gaga Filming 'A Star is Born' Scenes at Coachella with Bradley Cooper,0,3,10,50,2,12,0,60,0
Boston Mayor Says Trump's Victory Is In Part Backlash To African-American Progress,0,2,13,56,2,11,0,69,0
The Guardian view on Philip Hammond: more honesty is needed about budget pain to come,0,2,4,66,1,14,0,70,0
Israel undergoes major emergency drill,0,1,1,33,0,4,0,34,0
Redditors Gleefully Spoof Donald Trump’s Awkward Photo-Op With Angela Merkel,0,3,11,54,2,9,0,65,0
Migos-mania: How the Atlanta rap trio mastered the sound of silence,0,3,3,52,2,10,0,55,0
Canadian government apologizes to deportation victim Arar,0,1,2,49,0,6,0,51,0
'Proud' Barack Obama surprises spokesman Josh Earnest on his last day ,0,3,5,52,2,11,0,57,0
Phones without Internet access join the Facebook revolution,0,1,3,49,0,7,0,52,0
Mount Abu Based Ponzi Scheme Dupes Hundreds Of People Across Gujarat And Rajasthan For Rs 100 Crore,0,2,16,64,0,16,3,80,0
Palmeiro benched on return to Major League Baseball,0,1,4,40,0,7,0,44,0
Wreckage of crashed plane in Africa found,0,1,2,33,0,6,0,35,0
EU report in favour of adopting open source software,0,1,2,42,0,8,0,44,0
Jarring Image of Police’s Use of Force at Texas Pool Party ,0,2,8,39,1,11,0,47,0
’We Can’t Understand That Kind of Hate’,0,2,6,24,3,6,0,30,0
NSW heatwave: How some of the hottest towns in Australia dealt with the heat,0,3,5,57,1,13,0,62,0
A Small Guard Upends UConn and ‘Breathes a Little Life’ Into Her Sport ,0,3,12,44,2,13,0,56,0
Snoop Dogg's Puff Puff Pass Tour Salutes Weed & West Coast Hip-Hop in Los Angeles,0,2,14,50,3,14,0,64,0
U.S. fighter jet crashes in Libya,0,1,3,23,2,5,0,26,0
David Cassidy says he has dementia a day after appearing to fall off stage during concert,0,2,2,72,0,15,0,74,0
"‘It was heartbreaking’: Oakland warehouse fire leaves 36 dead, officials say",0,3,2,58,4,10,2,60,0
My life with Oliver Sacks: ‘He was the most unusual person I had ever known’,0,2,5,54,3,14,0,59,0
Smiling Queen charms Maundy Money recipients at Leicester Cathedral,0,3,6,53,0,8,0,59,0
"How Marco Rubio Won Nikki Haley’s Endorsement, and Clinched Second in South Carolina",0,2,11,59,2,12,0,70,0
"WH financial disclosures: Kushner, Ivanka Trump could exceed $700M in worth",0,3,6,53,3,10,3,59,0
Hedge Funds Agree to Return $235 Million in Madoff Case,0,1,7,35,1,9,3,42,0
UK mobile provider begins TV-on-phone trial,0,1,4,32,2,5,0,36,0
Chance the Rapper’s New Year’s Eve Headlining Show Canceled Due to Technical Issues,0,3,11,58,2,12,0,69,0
VX Nerve Agent Detected in Kim Jong Nam Death Probe: Malaysian Police,0,3,12,45,1,11,0,57,0
Anzac Day: Indigenous soldiers thought 'when we got back we'd be treated differently',0,2,3,66,4,12,0,69,0
Red Bull Racing F1 team must prove safety after David Coulthard suffers crash,0,1,6,58,0,12,1,64,0
Chopard Maintains a Bold Outlook,0,1,4,24,0,4,0,28,0
France sends special envoy to North Korea,0,1,3,32,0,6,0,35,0
"Ko Ni: Murder of Suu Kyi's political advisor intended to 'destabilise' Myanmar, President's office says",0,2,7,76,6,14,0,83,0
ERDOGAN: Turkey's emergency rule will continue 'until everything settles down',0,3,8,57,4,9,0,65,0
It’s nearly impossible to stop terrorists from using trucks as weapons. Here’s what cities are trying.,0,3,2,81,4,15,0,83,0
"Melbourne Christmas Day 'terror attack' foiled, say Australia police",0,2,4,53,3,8,0,57,0
United Airlines Faces Questions Over Death of Giant Rabbit ,0,3,8,42,0,9,0,50,0
China fighter plane spotted on South China Sea island: think tank,0,2,4,50,1,10,0,54,0
Trump’s budget shows a GOP trapped between its past and its future,0,3,4,50,1,11,0,54,0
Heartwarming video of brave dog protecting injured friend stuck on train track in Ukraine goes viral,0,3,2,83,0,15,0,85,0
Billboard 200 Chart Moves: Pentatonix's 'That's Christmas to Me' Surpasses 2 Million Sold in U.S.,0,3,12,60,7,14,4,72,0
Soul Singer Cuba Gooding Sr. Reportedly Died of an Overdose,0,3,8,41,1,9,0,49,0
"Utopian thinking: to ‘take back control’ of England, we must find out who owns it",0,2,2,61,4,14,0,63,0
"Paul Millsap Trade Rumors: Latest News, Speculation Surrounding Hawks PF",0,3,11,50,2,9,0,61,0
London bombing death toll rises to 'more than 50',0,1,1,36,2,8,2,37,0
Report: Dem Staffers Boo Trump at Unity Baseball Game - Breitbart,0,2,9,44,2,10,0,53,0
U.K. Rejects 1.8 Million-Signature Petition Seeking Ban on Trump,0,2,9,41,4,8,2,50,0
Crossing the Border? Here’s How to Safeguard Your Data From Searches ,0,3,9,47,2,11,0,56,0
March sadness: Faces of defeat,0,3,2,23,1,4,0,25,0
Qualcomm Launches The First 10nm Server Chip,0,2,6,30,0,6,2,36,0
Pro-Kremlin Politicians Warn Trump Could Unleash New Arms Race,0,3,10,43,1,8,0,53,0
Hillary Clinton’s Campaign Team Accuses Trump Strategists of Appealing to White Supremacists ,0,2,10,70,1,12,0,80,0
"Amazon closes in on $1,000 per share",0,3,1,23,2,6,4,24,0
"California Today: On Catalina, the Drought Is Far From Over - The New York Times",0,2,13,50,3,14,0,63,0
Canadian professional wrestler Luna Vachon dies aged 48,0,1,3,43,0,7,2,46,0
"Fear and loathing on the campaign trail, June 2008",0,1,2,35,1,8,4,37,0
Lib Dems bid to widen law on revenge porn,0,3,2,31,0,8,0,33,0
FIFA suspends the World Cup 2026 bidding process,0,3,6,31,0,7,4,37,0
Duisburg hostage crisis: Two arrested as police say threat over,0,3,2,51,1,9,0,53,0
Jaguar Pushes Cool Cars as Automakers Seek Answers to Trade Wars,0,3,9,45,0,10,0,54,0
Urine Samples Said to Link Bonds to  Steroids,0,1,6,31,0,8,0,37,0
German Physical Society demands nuclear disarmament,0,1,3,43,0,5,0,46,0
Jeb Bush Says Before 2016 Campaign Launch: ‘It’s Going to Be Fun’,0,2,10,36,4,11,4,46,0
Here’s One Industry Where the U.S. Is Already Catching China—Fertilizers ,0,3,11,48,4,10,0,59,0
James Corden and Kristen Bell's high-flying duet went a bit haywire,0,3,4,51,2,10,0,55,0
"Israel's Prime Minister Netanyahu to speak with Trump on Sunday about Iran, Syria, and Palestinian issue",0,3,9,77,3,15,0,86,0
Rights groups lead Paris rally against police brutality,0,2,2,46,0,7,0,48,0
Funeral held for former Zambian President Frederick Chiluba,0,1,5,47,0,7,0,52,0
"As Trump Makes Threats, Iran Makes Friends",0,3,7,28,1,6,0,35,0
A New BlackBerry Curve Loaded With Features,0,1,8,29,0,6,0,37,0
Arizona Bill Would Let City Dwellers Shoot Snakes in Yards ,0,3,9,40,0,10,0,49,0
Alphabet's Waymo unveils its autonomous Chrysler minivan,0,3,3,46,1,6,0,49,0
Nine killed as Russian cargo plane crashes in Siberia,0,1,3,42,0,8,0,45,0
Lily Collins Writes an Open Letter to Dad Phil Collins: ‘I Forgive the Mistakes You Made’,0,2,13,58,3,15,0,71,0
Detained AIDS activist Phyu Phyu Thin released in Myanmar,0,1,9,40,0,8,0,49,0
"British gemstone expert killed by mob in Voi, Kenya",0,1,3,39,1,8,0,42,0
Six people killed in Memphis home,0,1,2,26,0,5,0,28,0
Shark kills teen girl surfing off Australia's coast,0,2,2,41,1,7,0,43,0
Leaked cables cause Australian concern,0,1,2,32,0,4,0,34,0
Possible Errors in Exit Polls Suggest More Election Surprises Ahead,0,2,9,49,0,9,0,58,0
"Mount Everest: Nepali Man, 85, Aims to Become Oldest Person to Climb Peak",0,3,10,46,3,12,2,56,0
"Italy plucks 2,000 migrants from the Mediterranean Sea ",0,3,3,39,1,8,4,42,0
Stop looking at me! Confused rooster has a staring contest with its own reflection and then tries to ATTACK it,0,3,8,82,1,19,0,90,0
Rich New Yorkers ask state to raise their taxes ,0,3,3,36,0,9,0,39,0
The new 'Silicon Valley' season exposes a common dilemma in the tech industry,0,2,3,60,2,12,0,63,0
Former US Vice President Dick Cheney: 'Barack Obama is a one-term President',0,1,10,51,4,11,0,61,0
New primate discovered in Angola -- and it's already in danger,0,3,2,47,3,10,0,49,0
Snow blankets Hawaii summits amid winter storm warning,0,3,2,45,0,7,0,47,0
"As Scandal Roils South Korea, Fingers Point to Mixing of Politics and Business ",0,3,10,55,1,13,0,65,0
Time Warner chief: We’re more than just HBO,0,2,6,28,2,7,0,34,0
"K-Pop Gears Up for Competitive February, With New Releases From Red Velvet, Block B & More",0,3,15,56,4,15,0,71,0
Russia hacking claims: Trump says no effect on election,0,2,2,44,1,8,0,46,0
"In Southeast Alaska, The Ferry System Is A Lifeline",0,2,9,33,1,8,0,42,0
The NFL is pushing the Super Bowl to China,0,2,7,27,0,8,0,34,0
Trump announces revisions to parts of Obama’s Cuba policy,0,2,3,45,1,8,0,48,0
Football: PFA release award nominations,0,1,4,30,1,4,0,34,0
A Few Predictions for the ‘Westworld’ Season Finale,0,2,6,36,2,7,0,42,0
Small earthquake reported in Solomon Islands,0,1,3,36,0,5,0,39,0
Iraqi vote remains in doubt,0,1,1,22,0,4,0,23,0
"Jimmy Carter Makes a Stand for Solar, Decades After the Cardigan Sweater ",0,2,9,51,1,12,0,60,0
PewDiePie decides against deleting YouTube channel,0,3,5,40,0,5,0,45,0
"Bangkok, Celebrated For Its Street Food, Is Ordering Vendors To Get Off The Road",0,3,14,51,2,13,0,65,0
"For Iraqi Journalists, Free Press vs. Free Land",0,1,7,31,2,7,0,38,0
Huntsman Wins Right to Sue Banks Over Failed Deal,0,1,8,33,0,8,0,41,0
Actress Yara Shahidi Shared A Beautiful Post About Being Iranian And Black,0,2,12,51,0,11,0,63,0
Manhattan Office Owners Pay to Keep Tenants as Demand Falls,0,3,8,42,0,9,0,50,0
Donald Trump addressed alleged lurid sexual acts by saying he's a 'germaphobe',0,3,2,62,3,11,0,64,0
Twelve injured in Washington after ride at fair topples over,0,1,2,49,0,9,0,51,0
Fire in Alpine road tunnel between Italy and France,0,1,4,39,0,8,0,43,0
Pentagon Says Civilians Were Likely Killed in Yemen Raid ,0,3,8,40,0,9,0,48,0
A Rare Deep Freeze Warms the Dutch Soul,0,1,7,25,0,7,0,32,0
Singer George Michael Dies at Age 53,0,2,5,23,0,6,2,28,0
Irish Win Again as Leinster Takes European Cup,0,1,7,32,0,7,0,39,0
Why Obama is right to urge Britain to stay in the E.U.,0,2,5,36,2,11,0,41,0
Power Rankings: How high can streaking Rockets soar?,0,2,4,39,2,7,0,43,0
California's same-sex marriage ban ruled unconstitutional; appeal expected,0,1,1,63,3,7,0,64,0
Alec Baldwin Goes In on Donald Trump for Spelling Gaffe in 'SNL' Teaser,0,3,12,45,2,12,0,57,0
Trump's DOJ lays out travel ban defense,0,2,4,28,1,6,0,32,0
Lyft is about to launch a massive expansion across the US,0,3,3,44,0,10,0,47,0
Roku Can Now Get Access to a Larger Film Library,0,1,8,31,0,9,0,39,0
Katy Perry took a selfie in an Infinity Mirror room. Should you do it too?,0,3,5,53,2,14,0,58,0
More than one in four US kids exposed to weapon violence ,0,3,3,43,0,11,0,46,0
Jusuf Nurkic Will Play in Game 3 vs. Warriors After Recovering from Leg Injury,0,3,10,53,1,13,1,63,0
Trump's America Donald Trump: Who is 'travel ban judge' James L Robart and why did he block the immigration order?,0,3,8,82,5,19,0,90,0
Hurdles to Voting Persisted in 2008,0,1,3,23,0,5,4,26,0
Watch Joey Bada$$' Powerful New Video for 'Land of the Free',0,2,8,37,5,10,0,45,0
Netherlands bars Turkish ministers as rally dispute escalates,0,2,2,52,0,7,0,54,0
Israel Says Attack That Killed 4 Children On Gaza Beach Was Accidental,0,3,11,47,0,11,1,58,0
"ABC's ""Alias"" to end run in May 2006",0,1,5,17,3,7,4,22,0
"New Heyday for an Old Giant, the Golem",0,1,5,25,1,7,0,30,0
Oklahoma trooper on leave after altercation with ambulance personnel,0,1,1,59,0,8,0,60,0
New court documents suggest others at Penn State knew of Jerry Sandusky abuse,0,2,5,60,0,12,0,65,0
Surprise: Robots Aren't Replacing Humans In Key Areas Of Manufacturing,0,3,10,49,2,9,0,59,0
"Nothing honourable in honour killings, says Indian court",0,1,2,46,1,7,0,48,0
Support for Finnish anti-EU party slumps in local election,0,2,4,45,1,8,0,49,0
Village Raids Kill Over 200 in the South of Sudan,0,1,6,31,0,9,3,37,0
Supreme court nominee Neil Gorsuch calls Trump judge attacks 'demoralizing',0,3,4,60,2,9,0,64,0
First Chinese tourists arrive in the UK,0,1,4,29,0,6,0,33,0
Updated NFL Division-by-Division Team Rankings After Early Free Agency,0,3,12,48,2,8,0,60,0
Trump adds Washington lawyer John Dowd to his legal team,0,2,4,43,0,9,0,47,0
South Africans Rally in Call for President Zuma’s Removal,0,3,7,41,1,8,0,48,0
U.S. and Russia Begin Arms Talks With a December Deadline,0,1,9,37,2,9,0,46,0
Q&A: Student Loan Forgiveness ,0,2,5,19,2,4,0,24,0
Blown for Good author discusses life inside international headquarters of Scientology,0,1,3,72,0,10,0,75,0
Paul Manafort to Voluntarily Go Before House Intel Committee in Russia Probe,0,3,10,55,0,11,0,65,0
"Anti-censorship developers targeting China's ""Great Firewall""",0,1,4,48,4,5,0,52,0
"Children suffer from lead poisoning in 3,000 U.S. neighborhoods",0,3,3,45,3,8,4,48,0
"Nicki Minaj Challenges Remy Ma to Drop a Hit in 72 Hours, Offers Half a Million Dollars",0,3,12,56,1,16,2,68,0
South Korea and Japan sign military intelligence-sharing deal,0,2,3,50,1,7,0,53,0
Why Somalia’s New President ‘Farmajo’ Is Being Cheered in Buffalo,0,3,9,44,3,9,0,53,0
Los Angeles Rams Jeff Fisher Ties Dan Reeves for Most Losses in NFL History,0,3,14,48,0,13,0,62,0
Gutfeld: 'Trump Is Treating the Presidency Like an Actual Job'  Insider,0,3,9,48,3,11,0,57,0
Bill O'Reilly is out at Fox News,0,3,5,20,1,6,0,25,0
Subway commuters scrub anti-Semitic graffiti,0,3,2,37,1,4,0,39,0
"Greeks prepare to evacuate 75,000 to defuse WWII bomb ",0,3,5,34,1,9,5,39,0
"Aleksei Navalny, Viable Putin Rival, Is Barred From a Presidential Run ",0,3,10,48,2,11,0,58,0
Ivanka Trump clothing brand sales 'boom',0,3,2,31,2,5,0,33,0
An exhibition of Princess Diana dresses opens to the public Photos ,0,3,4,52,0,11,0,56,0
A raptor strikes at sunset,0,3,1,21,0,4,0,22,0
Fans Create Impromptu Hollywood Star For Carrie Fisher,0,2,8,39,0,7,0,47,0
Nokia scales back prediction for global mobile phone sales,0,1,1,49,0,8,0,50,0
Kellyanne Conway and the White House’s 100-day alternative facts,0,3,4,47,2,8,3,51,0
Warning to parents after newborn baby girl dies in bed with mother,0,3,1,54,0,11,0,55,0
"28 Movies And TV Shows To Watch If You Loved ""Big Little Lies""",0,2,13,33,2,12,2,46,0
Oil spill in Alaska closes 800 miles of pipeline,0,1,2,35,0,8,3,37,0
Dancing officer helps usher in donations for the Salvation Army,0,3,3,51,0,9,0,54,0
Trillions of Dollars Are at Stake When Trump Speaks to Congress,0,3,8,45,0,10,0,53,0
Mariah Carey Drops New YG Collab 'I Don't': Listen,0,2,10,28,4,8,0,38,0
Trump's America US Vice-President Mike Pence to meet key leaders on Australian visit,0,3,9,61,2,12,0,70,0
Madonna Shares Video Rehearsing Dance Moves With Ariana Grande Backstage: Watch,0,3,11,57,1,10,0,68,0
Joseph Kabila declared winner of Congo Presidential election,0,1,4,49,0,7,0,53,0
"Nets former second-round pick arrested for alleged kidnapping, robbery, assault",0,3,1,66,3,9,0,67,0
‘Legion’ Murked Every Comic Book Show Moving,0,2,7,29,2,6,0,36,0
"Carrie Fisher, Mark Hamill and Oprah named among this year's Disney Legends",0,2,7,55,2,11,0,62,0
NASA: Old Arctic sea ice continues to melt,0,1,6,28,1,7,0,34,0
"Hospitals declare ""code red"" in Wellington, New Zealand",0,1,4,41,3,7,0,45,0
Database May Help Identify Veterans on the Edge ,0,3,6,34,0,8,0,40,0
12 Surya Namaskar Steps You Should Practice Every Morning To Kill That Fat,0,3,12,48,0,12,2,60,0
Palin Signs Deal to Write a Memoir,0,1,5,23,0,6,0,28,0
"Aircraft crashes during mock dogfight at Shoreham Airshow, United Kingdom",0,1,5,58,1,9,0,63,0
"MSNBC, ABC hosts deem Trump inaugural address as 'militant,' 'anti-Semitic' ",0,3,10,49,7,10,0,59,0
2007 Twenty20 World Championship: England vs Australia,0,1,5,36,1,6,6,41,0
The U.S. government has withdrawn its request ordering Twitter to identify a Trump critic,0,3,5,69,2,13,0,74,0
Protesters in Thailand Challenge Premier,0,1,4,32,0,4,0,36,0
Syria affirms withdrawal intentions,0,1,1,31,0,3,0,32,0
Richard Branson offers new dads up to 12 months paternity leave on full pay,0,2,2,58,0,13,2,60,0
Trump claims he saved a billion dollars on Air Force One. The military don't know what he's talking about,0,2,5,79,3,18,0,84,0
Detached but Sympathetic: Prosecutor’s Dual Response to Imam’s Killing - The New York Times,0,2,11,63,4,13,0,74,0
Why the Civilian Toll After D-Day Is Different From That in Afghanistan,0,1,11,48,1,11,0,59,0
Seattle's oldest newspaper to become online-only,0,1,1,40,2,5,0,41,0
California just added four more ‘discriminatory’ states to its travel ban,0,2,1,60,2,10,0,61,0
Fourth 21 July bomb suspect held in Rome,0,1,3,28,0,7,2,31,0
"Ryan Adams Covers Radiohead's 'Karma Police,' Calls Trump 'A Pretty Awful Person'",0,3,12,52,6,11,0,64,0
New initiative to tighten up tackle law may be rugby’s big-bang moment,0,3,1,56,2,11,0,57,0
"Deshaun Watson has left a Legacy (yes, a capital L)",0,3,4,35,3,9,0,39,0
"Latin Connection Podcast: Maluma on U.S. Tour, 'Cuatro Babys' Controversy & More",0,3,11,51,7,11,0,62,0
Here's a Throwback Picture of a Young Draymond Green with a Huge Afro,0,3,8,48,1,12,0,56,0
Mobileye Wants To Teach Your Robotic Car To Merge In Heavy Boston Traffic,0,3,13,48,0,12,0,61,0
Trump’s U.N. ambassador emerges as fierce but unnuanced voice on foreign policy,0,3,3,62,3,11,0,65,0
"In Hollywood, the Easy-Money Generation Toughens Up",0,1,7,36,2,6,0,43,0
Trump Takes Credit for Bump in Consumer Confidence ,0,3,6,37,0,8,0,43,0
"Inventory of Prince's Estate Lists Cash, Property and Gold Bars",0,2,8,44,2,9,0,52,0
Reykjavik time-lapse captures overnight snowfall,0,3,1,42,1,4,0,43,0
"At Turkish Border, Armenians Are Wary of a Thaw",0,1,7,31,1,8,0,38,0
Rahlves Fails to Retain Winter X Games Title,0,1,7,30,0,7,0,37,0
"J.R. Smith needs surgery on fractured thumb, Cavaliers say",0,2,4,43,3,8,0,47,0
"Meet Mango, The Adorable Pomeranian Who Will Just Melt Your Heart",0,3,11,43,1,10,0,54,0
"Tamil Nadu: Traders ban Pepsi, Coca-Cola to support local products",0,3,6,48,3,9,0,54,0
Bob Knight says he will never return to Indiana University and he hopes the school leaders 'are all dead',0,3,4,81,2,18,0,85,0
Elena Delle Donne is half of The Knot’s first same-sex ‘Dream Wedding’ couple,0,2,7,54,4,12,0,61,0
Trump Wiretapping Claims Rejected by Senate Intelligence Chiefs,0,2,7,49,0,7,0,56,0
John Lewis to skip inauguration for second time in congressional career,0,3,2,59,0,10,0,61,0
Boy arrested over Bradford teacher stabbing,0,3,2,36,0,5,0,38,0
Long Line at the N.B.A. Complaint Desk,0,1,7,22,3,6,0,29,0
Boston Mayor Opposes Assault Weapons for Patrol Officers,0,1,7,42,0,7,0,49,0
Have the Best (Single) Valentine’s Day ,0,3,5,25,3,6,0,30,0
U.K. Election Raises Prospect of Another Scottish Independence Vote,0,3,9,48,2,8,0,57,0
China's latest robot police officer can recognise faces,0,3,1,46,1,7,0,47,0
Perrigo CEO Faces Mounting Pressure as Investors Sound Alarms,0,3,10,43,0,8,0,53,0
Basketball: UAAP opens 2008-2009 season with new rules,0,1,5,32,2,7,8,37,0
Samantha Bee: How the Republican 'lie' of massive voter fraud started,0,3,4,52,3,10,0,56,0
Pentatonix Transforms Into Lego Characters in Fun 'Up on the Housetop' Video,0,3,9,54,2,11,0,63,0
Critic of High C.E.O. Pay Is Vindicated,0,1,8,22,3,6,0,30,0
"Jimmy 'Superfly' Snuka, former professional wrestler, dies at 73",0,3,3,47,4,8,2,50,0
As it happened: Reaction to Trump strikes,0,3,3,31,1,6,0,34,0
Dallas Mayor Calls for Criminal Probe of City’s Police and Fire Pension System ,0,3,10,55,1,13,0,65,0
The Cost Of An AK-47 On The Black Market Around The World [Infographic],0,3,14,40,3,12,2,54,0
Football corruption: Who bought the Copa America?,0,3,4,37,2,6,0,41,0
Secret Service: Guns banned from Trump's NRA speech,0,3,7,35,2,7,0,42,0
Martin Shkreli And The Case For Twitter Transparency,0,3,8,37,0,7,0,45,0
Kentucky Coach John Calipari Heckled by Missouri Crowd During Halftime Interview,0,3,10,60,0,10,0,70,0
"Grammys producer addresses Justin Bieber, Kanye West boycott rumors",0,3,5,53,1,8,0,58,0
China Becomes More Choosy in Buying U.S. Debt,0,1,8,28,2,7,0,36,0
Betsy DeVos Cites Grizzly Bears During Guns-in-Schools Debate,0,3,10,42,2,7,0,52,0
MMA Fighter DQ'd After He Refused to Stop Punching His Opponent After He'd Won,0,2,16,47,2,13,0,63,0
Davos 2017 Watch WSJ Editor in Chief Gerard Baker Discuss the Future of Monetary Policy,0,3,13,56,0,14,4,69,0
Carrie Fisher: A Look at Her Life Beyond ‘Star Wars’ ,0,3,9,31,3,10,0,40,0
Deflating ‘Deflategate’ ,0,2,2,18,2,2,0,20,0
"Man attacks people, kills 7 in Akihabara, Tokyo",0,1,3,34,2,7,1,37,0
The OA season 2 announced by Netflix,0,3,4,25,0,6,1,29,0
House Heavyweight Feels Threat to Power,0,1,5,29,0,5,0,34,0
"Trump Threatens Federal Intervention in Chicago, Citing ‘Carnage’ ",0,3,7,48,3,8,0,55,0
Most Undocumented Immigrants Live in 20 Metro Areas ,0,2,6,36,0,8,2,42,0
Creationist sentiments affect Imax business strategy,0,1,2,45,0,5,0,47,0
"Syria missile strike: Assad regime change Trump administration priority, Nikki Haley says",0,3,5,71,2,11,0,76,0
"Stephen Gay, Queensland Government staffer, quits after refusing police breath test",0,2,4,67,2,10,0,71,0
Raging blaze burns a dozen storefronts in New York; 3 firefighters injured ,0,3,3,58,1,12,1,61,0
Sadiq Khan promised 'zero days of strikes' during London mayoral election campaign,0,2,3,66,2,11,0,69,0
An MGM Partner Sues Over Project,0,1,8,19,0,5,0,27,0
Developing an aeroplane that can fly itself,0,3,1,36,0,6,0,37,0
"Airplane that crashed near Buffalo, New York 'was on autopilot'",0,1,4,47,3,9,0,51,0
Martin Shkreli Wins Ruling Splitting Fraud Trial From Ex-Lawyer,0,3,10,44,1,8,0,54,0
LaVar Ball Blames UCLA's 'Slow' White Players for NCAA Tournament Loss to Kentucky,0,3,18,49,3,12,0,67,0
David Abraham appointed as new chief executive of British Channel 4,0,1,4,52,0,10,1,56,0
Mass poultry vaccination planned by China,0,1,2,34,0,5,0,36,0
Theresa May lays down independence vote challenge to Sturgeon,0,2,3,50,0,8,0,53,0
Donald Trump Declines to Fill Out 2017 NCAA Tournament Bracket on ESPN,0,2,15,40,0,11,4,55,0
Concert Halls From Kansas City to Hamburg Call on This Japanese Engineer to Shape Sound,0,3,12,61,0,14,0,73,0
Aleppo battle: Raids on Syria city 'probably war crime' UN says,0,2,5,45,3,10,0,50,0
Trump’s Previous View of NATO Is Now Obsolete ,0,3,10,27,1,8,0,37,0
Waterboarding Used 266 Times on 2 Suspects,0,1,4,28,0,6,4,32,0
10 things you need to know before the opening bell,0,2,0,39,0,9,2,39,0
"Leading Figure, Defiant, Re-Emerges in Stanford Case",0,1,7,36,3,6,0,43,0
What Makes The Investors Bite: The Industries That Get The Most Deals On 'Shark Tank',0,3,15,53,3,14,0,68,0
Damien Chazelle on the Secrets of 'La La Land',0,3,6,30,2,8,0,36,0
"For Fed Policy-Making, Murky Era Lies Ahead",0,1,8,27,2,6,0,35,0
UN official: DR Congo is ‘rape capital of the world’,0,1,5,35,3,9,0,40,0
Former NSA contractor accused of stealing top secret documents says he was just a hoarder,0,3,4,71,0,14,0,75,0
We Have A Record Number of Global Billionaires. But The Real Question Is Why Don't We Have More?,0,3,17,59,3,17,0,76,0
Donald Trump Pays Respects to Navy SEAL Slain in Yemen,0,2,11,34,0,9,0,45,0
French left stakes its hopes on Manuel Valls in presidential race,0,2,3,52,0,10,0,55,0
Going To The Women's March? Here's What You Need To Know And Bring,0,2,13,38,3,12,0,51,0
Louisville Brings Syracuse to Its Knees,0,1,5,29,0,5,0,34,0
Snapchat's parent company Snap sees stocks surge after Wall Street debut,0,3,4,57,1,10,0,61,0
Dow falls 340 points amid unemployment and retail sales rates news,0,1,1,52,0,10,3,53,0
French Election: Macron and Le Pen Through to Final Round,0,3,8,39,1,9,0,47,0
"Missing boy from Glynn County, Georgia found dead",0,1,4,37,1,7,0,41,0
WATCH: Radical Left Students Burn Effigy In London Streets - Breitbart,0,2,14,44,2,10,0,58,0
China calls on US to be 'cool-headed' over North Korea as Tillerson warns tensions at 'dangerous levels',0,3,6,77,5,16,0,83,0
"Truly Nolen, Pest-Control Magnate, Deployed His Odd Name and Funny Cars ",0,2,11,47,3,11,0,58,0
Doctor accused of mutilating genitals of young girls defends procedure as religious practice,0,2,1,79,0,12,0,80,0
Austin Mahone's 5 Best Songs,0,3,4,18,1,4,1,22,0
Violence in Kenya kills at least thirteen,0,1,2,33,0,6,0,35,0
"Here's why the blizzard forecast fizzled to a sleety mess in NYC, Philly",0,2,5,53,2,12,0,58,0
Geffen Said to Be Still Interested in The New York Times,0,1,9,37,0,10,0,46,0
John Green hopes to 'amplify the voices of people who are not traditionally heard' through YouTube,0,2,4,77,2,15,0,81,0
Dixie Chicks show documentary at TIFF,0,1,6,26,0,5,0,32,0
'Legion' episode 1 recap: We all go a little mad sometimes,0,3,2,42,3,10,1,44,0
Can French presidential candidate Emmanuel Macron deliver on his promise to remake the country?,0,3,4,77,1,13,0,81,0
Authors question CIA redaction of NYT Op-Ed on Iran policy,0,1,10,38,1,9,0,48,0
Wall Street Falters Late in Trading Day,0,1,6,27,0,6,0,33,0
Southwest Inspects Its Jets After Hole Forces Landing,0,1,8,38,0,7,0,46,0
"David Sweat and Richard Matt, Escaped Inmates, ‘Will Do Whatever It Takes,’ Governor Warns",0,2,13,59,5,13,0,72,0
"Hamza bin Laden, Son of Osama, Put on U.S. Terror Blacklist",0,3,9,36,4,10,0,45,0
Bolivia Detains Airline Boss in Chapecoense Soccer Team Crash Probe,0,3,9,49,0,9,0,58,0
ANALYSIS: Retail takes a hit in disappointing jobs report ,0,3,9,39,1,9,0,48,0
Woman Linked to Sanford Comments on E-Mail,0,1,6,29,1,6,0,35,0
Hollywood sign vandalized to read 'Hollyweed',0,3,2,36,2,5,0,38,0
Rachel Alexandra Has Little Competition in Mother Goose,0,1,7,41,0,7,0,48,0
House GOP abruptly scraps health care vote,0,3,4,32,0,6,0,36,0
"Trump and Paul Ryan Head for a Clash Over the Budget, and Ideology ",0,2,8,45,1,13,0,53,0
Should Airport Passengers Be Allowed to Travel with Guns & Ammo? | Fox Business,0,3,10,53,3,13,0,63,0
Wait ... when was the last time Mookie Betts struck out?,0,3,3,39,4,10,0,42,0
Japan Is Caught in the Crossfire of Trump’s Assault on Mexico,0,3,7,43,1,10,0,50,0
5 takeaways from new book about Hillary Clinton's failed campaign ,0,3,2,52,1,10,1,54,0
Child mummies uncovered,0,2,1,20,0,2,0,21,0
Alec Baldwin Gives Stephen Colbert Trump Impression Tips,0,2,8,41,0,7,0,49,0
"'Get Out' Star Daniel Kaluuya Talks the ""Horror of Racism""",0,3,8,37,4,9,0,45,0
Australian Governor-General travels to Kuwait amidst terror threats,0,1,4,55,1,7,0,59,0
J.Crew cuts deal with Nordstrom to sell some signature items,0,2,3,47,1,9,0,50,0
The Oscar-Nominated Film With $0 in Ticket Sales,0,3,7,31,2,7,1,38,0
Libyan city of Misrata reported to be secure after Gaddafi forces retreat,0,1,3,59,0,11,0,62,0
As it happened: Protests over Trump travel ban,0,3,3,35,1,7,0,38,0
"Bus bombing in Myanmar kills man, wounds another",0,1,2,38,1,7,0,40,0
Civilians Flee as Pakistani Forces Hit Resistance,0,1,6,37,0,6,0,43,0
Egypt court acquits charity worker Aya Hijazi,0,2,3,36,0,6,0,39,0
Suspected Russian air strikes kill at least 46 Syrians in fierce raids on rebel-held areas of Aleppo ,0,2,4,77,1,17,2,81,0
Freman Hendrix eclipses Kwame Kilpatrick in Detroit mayoral race,0,1,5,51,0,8,0,56,0
Rat Boy responds to Kendrick Lamar sampling him on 'LUST',0,2,8,38,2,9,0,46,0
WINNING: Gallup Reports U.S. Job Creation Index Continues to Hit Record Highs,0,3,18,45,3,11,0,63,0
Tour de France: Alexander Vinokourov wins stage 13,0,1,4,36,1,7,2,40,0
"Trump's America 'Malcolm Turnbull, you're not on your own': My own spray from Donald Trump",0,3,7,63,6,14,0,70,0
"Syrian bus convoy hit by blast, several reported killed or injured",0,3,1,54,1,10,0,55,0
Carmelo Anthony Laughs at Phil Jackson's Criticisms in Instagram Post,0,3,8,51,1,9,0,59,0
Trump's America Donald Trump: Why do we care about the US President's first 100 days?,0,2,8,56,4,14,3,64,0
"Five or Six Things I Didn’t Know About Brad Pitt, by Marlon James - The New York Times",0,2,15,51,3,17,0,66,0
"Bill O’Reilly accuser reveals identity, feels ‘triumphant’ he won't return to Fox News ",0,2,5,64,5,13,0,69,0
SoftBank Drops $100 Million Investment in iPhone Rival ,0,3,7,36,1,8,3,43,0
"Indigenous Australians told to ""wash for fuel""",0,1,2,36,2,6,0,38,0
They’re Trapped in His Lies,0,2,4,18,1,4,0,22,0
Trump and Brexit left progressives aghast – they should be emboldened,0,2,2,56,1,10,0,58,0
"Millennials Want To Be Entrepreneurs, But A Tough Economy Stands In Their Way",0,2,13,51,1,12,0,64,0
Creator of website satirizing Glenn Beck on winning domain name case,0,1,3,55,0,10,0,58,0
This perfect sports Vine is a comedy in three acts,0,3,2,39,0,9,0,41,0
Dylann Roof to Judge: Let Lawyers Back on Death Penalty Case ,0,3,9,40,1,11,0,49,0
Battle Against ISIS In Mosul: Iraqi Forces Advance on Airport,0,3,12,39,1,9,0,51,0
Tour de France: Cancellara wins 7.9 km time trial prologue,0,1,3,42,2,9,2,45,0
"A Comeback, a Controversial Call and Some Crackle at the N.C.A.A.s ",0,2,10,41,5,11,0,51,0
Trump to Union Leaders: 'We're Gonna Put People Back to Work',0,3,9,38,4,10,0,47,0
Evercore ISI Switches Fed Call to March Hike After Dudley,0,3,11,37,0,9,0,48,0
FCC Chief to Roil the Capital With Net Neutrality Rollback,0,3,10,39,0,9,0,49,0
"Telltale heart: Pacemaker data leads to arson, fraud charges ",0,3,2,48,2,9,0,50,0
6.0 magnitude earthquake rocks eastern Turkey,0,1,1,36,1,5,2,37,0
Australian Senator arrives at Parliament dressed as a beer bottle,0,1,3,53,0,9,0,56,0
Jose Abreu testifies he ate fake passport on way to U.S. to cover up his part in smuggling operation,0,3,4,76,2,18,0,80,0
Academy of Motion Picture Arts and Sciences apologizes for Oscars mix-up ,0,2,6,55,1,11,0,61,0
"""My life is made here"": Undocumented students fear fate under Trump",0,2,3,51,3,10,0,54,0
Super Bowl LI Highlights and Analysis ,0,2,6,26,0,6,0,32,0
"'Apple's data is dirtiest,' says Greenpeace",0,1,2,32,4,5,0,34,0
"On Hand for Space History, as Superpowers Spar",0,1,6,32,1,7,0,38,0
Polar bears 'have started eating dolphins due to climate change',0,3,1,52,2,9,0,53,0
’F*ck Israel’ Graffiti Discovered at UK Campus After Ambassador’s Visit - Breitbart,0,2,11,56,5,11,0,67,0
Christine: Exclusive clip from the true story of a televised suicide,0,3,2,55,1,10,0,57,0
67-Year-Old Ric Flair Shows He's Still Going Strong by Deadlifting 400 Pounds,0,3,11,47,3,11,5,58,0
Escaped NY prisoners reportedly were planning to kill prison worker's husband ,0,2,3,63,1,11,0,66,0
"Billboard Dance Chart Upstarts: Kris Kross Amsterdam, Rain Man & a Remixed Summer/Streisand Classic",0,3,13,69,4,13,0,82,0
President Obama Gives Final Weekly Address: ‘We Can’t Take Our Democracy For Granted’ ,0,2,13,56,4,13,0,69,0
Brexit and the End of International Progressive Inevitability,0,2,5,49,0,7,0,54,0
Wikinews interviews Mr. Orange of IWL in Taiwan about wrestling,0,1,7,46,1,9,0,53,0
Life insurers get a new lifeline,0,3,1,26,0,5,0,27,0
Donald Trump just used his presidential power to advertise L.L. Bean,0,2,5,51,2,10,0,56,0
Your Boss’s Pay Check May Be Boosting Populism,0,3,8,30,1,7,0,38,0
Ford says profit will fall 50%,0,3,1,21,1,5,2,22,0
"UK Government Loses Brexit Case, Must Consult Parliament ",0,3,9,39,1,8,0,48,0
"Fund NHS entirely with National Insurance, Labour MP Frank Field suggests",0,3,11,51,1,10,0,62,0
Amtrak owes commuters explanations — a lot of explanations,0,2,1,48,1,8,0,49,0
NASA Troubleshooting Drill Problem on Mars Curiosity Rover,0,2,10,41,0,7,0,51,0
"'High Likelihood' Berlin Terror Suspect Is the Perpetrator, German Authorities Say ",0,2,10,59,3,11,0,69,0
Is It Time For Hearing Aids To Be Sold Over The Counter?,0,2,12,32,1,11,0,44,0
Blasts in Mexico rips gas and oil pipelines,0,1,2,34,0,7,0,36,0
Inspector General Will Investigate Assistant Attorney General for Leaks to Clinton Campaign,0,3,10,70,0,11,0,80,0
Marquette Too Much for Crowd Favorite Utah State,0,1,7,34,0,7,0,41,0
Redditors planning to hide hundreds of 3D-printed toys in citywide scavenger hunt,0,3,2,66,1,11,1,68,0
Former Libyan leader Gaddafi killed,0,1,3,28,0,4,0,31,0
Seabin founder Pete Ceglinski battles hard to make ocean-cleaning dream a reality,0,3,3,66,1,11,0,69,0
Oil hits highest since mid-2015 on non-OPEC cut agreement,0,2,5,38,2,8,4,43,0
EU leaders will meet for first 'Brexit summit' on April 29 ,0,3,4,40,2,11,2,44,0
Video Emerges of Aftermath of Fight Allegedly Involving Darrelle Revis,0,3,8,53,0,9,0,61,0
"Brought down by an affair, Alabama Gov. Robert Bentley expected to resign today, according to news reports",0,3,5,82,3,16,0,87,0
"Angry Cleveland Weatherman Returns, Whips out Weed Wacker on Set",0,3,8,46,1,9,0,54,0
Tensions Grow in Georgia Over Accusations of a Plot,0,1,6,37,0,8,0,43,0
"Mom Didn’t Sell Any Knitted Goods At A Fair, So Twitter Bought It All",0,3,14,40,2,13,0,54,0
Bloomberg and Clinton create green alliance,0,1,2,36,0,5,0,38,0
Michelle Obama's Natural Hair Is Our Favorite Thing on the Internet [Video],0,2,10,51,3,11,0,61,0
Manhunt for escaped murderers focuses on small New York town ,0,2,3,48,0,10,0,51,0
South African lawyer and anti-apartheid leader Harry Schwarz dies age 85,0,1,4,55,1,10,2,59,0
Use Their Work  Free? Artists Say No to Google,0,1,8,28,1,9,0,36,0
Canada's Donald Trump? 'Shark Tank' star Kevin O'Leary runs for Tory leadership,0,2,9,54,5,11,0,63,0
26 Baby Steps For Representation In Hollywood In 2016,0,3,7,32,0,8,6,39,0
"Tony Awards 2015: ‘Fun Home,’ ‘Curious Incident’ Take Home Awards - Speakeasy",0,3,10,45,7,11,4,55,0
Cleric Who Led Militants in Pakistan Is Released,0,1,7,34,0,7,0,41,0
"The Hill: Anger, Disbelief in Clinton Camp - Breitbart",0,2,7,36,3,8,0,43,0
New Zealand woman survives being run over by train,0,1,2,40,0,8,0,42,0
The World Loves 'Made In Germany' [Infographic],0,3,7,30,4,6,0,37,0
Emerging Markets Regain Their Footing,0,1,5,28,0,4,0,33,0
"Manus refugees not accepted by US to remain in PNG, Dutton says",0,3,7,44,1,11,0,51,0
"George Clinton at Coachella 2017: 'The Older You Get, The Fresher Funk Gets'",0,2,11,45,4,12,4,56,0
"Swimmers could be surrounded by 50 gallons of urine, study finds",0,2,1,50,1,10,2,51,0
"Sonic Reports Lower Sales, Projects Results to Pick Up in Back End of Year",0,2,11,49,1,13,0,60,0
Same-sex marriage legalized in Argentina,0,1,2,33,1,4,0,35,0
"1 in 4 workers have less than $1,000 saved for retirement",0,3,0,39,2,10,6,39,0
Five myths about the cross,0,2,1,21,0,4,0,22,0
Democrats Wary of Icahn Self-Dealing as Trump Regulatory Adviser ,0,3,8,47,1,9,0,55,0
Snapchat Parent Sets Valuation of Up to $22.2 Billion,0,2,6,34,2,8,3,40,0
New Zealand's worst behaved politicians list released,0,1,2,44,1,6,0,46,0
US to alter aviation security policy,0,1,2,29,0,5,0,31,0
"Last in the N.F.L. Draft, but Getting More Relevant All the Time ",0,3,10,39,4,12,0,49,0
Woman gives birth to own grandson as surrogate for her cancer survivor daughter,0,2,1,66,0,12,0,67,0
Michael Jackson Urban Myths episode cancelled after family's outrage over 'shameful portrayal',0,3,4,76,3,11,0,80,0
Apple executive Steve Jobs resigns,0,1,3,27,0,4,0,30,0
A Top Sunni Survives an Attack in Iraq,0,1,6,25,0,7,0,31,0
More Home Buyers Backed Out of Offers in 2016,0,2,6,27,0,8,4,33,0
Kim Kardashian West: French arrests over Paris robbery,0,3,5,41,1,7,0,46,0
Trump Team Leery of Having Too Many ‘Goldman Guys’ in Top Posts,0,2,10,40,2,11,0,50,0
"Trevor Noah: 'When I See Trump, I See a Stand-Up Comedian'",0,2,11,32,5,10,0,43,0
Christian Science Monitor to cease daily print publication,0,1,3,48,0,7,0,51,0
High school student sends powerful message with a simple t-shirt,0,3,1,53,1,9,0,54,0
Impeachment vote looms for South Korean President,0,2,4,39,0,6,0,43,0
Angela Merkel Calls for Ban on Full-Face Veils in Germany ,0,2,8,39,1,10,0,47,0
"Lessons from the first ‘tiny house’ evangelist, Henry David Thoreau",0,2,4,51,3,9,0,55,0
Two nuclear submarines collide in the Atlantic Ocean,0,1,3,42,0,7,0,45,0
"Mongolia Pegs $1 Billion From India for Oil Refinery, Pipelines",0,2,8,43,2,9,1,51,0
"Hunt for Missing Laura, 28, Finds Car in High Desert",0,3,7,32,2,9,2,39,0
Thailand floods: Twelve killed after record rainfall,0,3,2,43,1,6,0,45,0
James Franco Joins 'Alien: Covenant',0,2,5,24,3,4,0,29,0
Man takes armoured vehicle on rampage through Western Sydney,0,1,3,49,0,8,0,52,0
Attention-deficit/hyperactivity disorder is linked to delayed brain development,0,2,1,69,2,7,0,70,0
Dramatic moment plane lands on MOTORWAY after suffering 'engine fault' in mid-air ,0,3,9,58,3,12,0,67,0
Nigerian defender David Oniya collapses on pitch and pronounced dead 30 minutes later,0,2,3,68,0,12,2,71,0
Blog Geared to Women Yields New Site for Slate,0,1,7,31,0,8,0,38,0
Flight Attendants Train to Spot Human Trafficking,0,3,6,37,0,6,0,43,0
Eurozone economy did not grow at all in last quarter of 2009,0,1,1,44,0,11,4,45,0
Jeffrey Ubben is stepping down as ValueAct’s investment chief,0,2,4,48,1,8,0,52,0
Austin Area Becomes Immigrant 'Sanctuary' As Trump Inaugurated,0,3,8,45,2,7,0,53,0
Australian woman found dead in Bali after scooter crash,0,3,2,45,0,8,0,47,0
Libyan hijackers surrender after release of hostages from plane diverted to Malta,0,3,2,68,0,11,0,70,0
The Death Of Trumpcare Is The Ultimate Proof Of Obamacare's Historic Accomplishment,0,3,12,59,1,11,0,71,0
A Drive Through Inaugural Parades of the Past ,0,3,6,32,0,8,0,38,0
A Hustler's Spirit: What It Takes To Be An Influencer,0,3,10,32,2,9,0,42,0
US President Obama proposes financial reform,0,1,4,35,0,5,0,39,0
Donald Trump makes it legal to shoot hibernating bears,0,3,2,44,0,8,0,46,0
"Tom Brady won this Super Bowl for his mother, who has cancer",0,2,4,44,1,11,0,48,0
This Is a Dangerous Time to Own Emerging Markets,0,3,7,33,0,8,0,40,0
Acting FBI Head: Comey-Trump Talks Could Be Part Of Special Counsel Probe,0,2,15,45,2,11,0,60,0
Terrifying moment firefighter squeezes through gap in search of Italian avalanche survivors,0,3,2,78,0,11,0,80,0
Britain Condemns Russia Over Litvinenko But Is Reluctant To Impose Sanctions,0,2,11,55,0,10,0,66,0
Sources: A.J. Green unhappy with team's decision not to play him,0,3,4,46,4,10,0,50,0
California state legislature passes same-sex marriage bill,0,1,1,50,1,6,0,51,0
Auto Aid Might Flow To Parts Suppliers,0,1,7,25,0,6,0,32,0
"Biloxi, Mississippi, Refers to ‘Great Americans Day’ Instead of MLK Day",0,3,11,46,4,10,0,57,0
"Netanyahu, Once Hawkish, Now Touts Pragmatism",0,1,6,32,2,5,0,38,0
Alcoa Lost $1.19 Billion as 4th-Quarter Sales Fell,0,1,6,30,3,7,4,36,0
Sony Entertainment CEO Michael Lynton Stepping Down to Focus on Snap,0,3,11,47,0,10,0,58,0
"In Kim Jong-nam Killing, a Common Migration Tale Takes a Dark Turn ",0,2,10,43,2,12,0,53,0
Death Toll in Australian Fires Rises to 200,0,1,5,28,0,7,3,33,0
Beyonce is Wanted For Voicing Nala in 'Lion King' Remake,0,3,8,37,2,9,0,45,0
Raccoon that hitched a ride on a Virginia trash truck is caught by police and set free,0,3,2,68,0,16,0,70,0
Trade Group Meets to Curb Protectionism,0,1,5,29,0,5,0,34,0
Founder of N.J. School for Disabled Charged in Theft of Public Funds ,0,2,9,46,2,12,0,55,0
John Kasich to Electoral College: Don't cast your vote for me,0,2,5,44,2,10,0,49,0
U.S. Strikes Kill ISIS Militants in Libya,0,3,10,23,2,6,0,33,0
Pakistan security forces airstrikes kill several Taliban militants,0,1,2,57,0,7,0,59,0
The Revenge of the Discouraged ‘Deplorables’,0,2,4,33,2,5,0,37,0
DNA tests confirm bones found are Steve Fossett's,0,1,5,36,1,7,0,41,0
Former NBA ref surrenders to charges he bet on games he officiated,0,1,4,51,0,11,0,55,0
"Akshay Kumar's Visionary Idea Comes To Life, Insurance Scheme For Stuntmen & Stuntwomen Launched",0,3,13,67,3,13,0,80,0
Nevada is close to passing a landmark bill to tackle high drug prices,0,2,1,56,0,12,0,57,0
Cops: Ex-soldier kills her service dog while her boyfriend videotapes,0,3,2,56,2,9,0,58,0
Escaped circus elephant kills 65-year-old man in woods in Germany,0,2,2,50,2,9,2,52,0
Minor league baseball players fight for right to OT pay,0,3,3,43,0,9,0,46,0
"Employers 'short-changing' Australian workers by withholding superannuation payments, report says",0,3,2,82,4,9,0,84,0
Tomahawk missiles: Explaining the weapons the US used to strike Syria,0,3,5,53,1,10,0,58,0
A day in the life of a Crufts dog – photo essay,0,3,2,33,1,11,0,35,0
Apple Pledges New R&D Centers in China    ,0,2,7,24,1,10,0,31,0
Kendrick Lamar Announces The Damn Tour,0,3,6,27,0,5,0,33,0
28-year-old tight end who just retired from the NFL after 6 seasons says 'a lot of guys don't really love' football,0,3,3,84,5,20,3,87,0
Twin Peaks actor Warren Frost dies at 91,0,2,4,27,0,7,2,31,0
Exxon Mobil denied permission to resume Russian oil work,0,3,3,45,0,8,0,48,0
Arkansas Democratic party chairman assassinated by gunman,0,1,2,49,0,6,0,51,0
U.S. Moves Against Top Mexican Drug Cartel,0,1,8,26,2,6,0,34,0
Canadian PM cabinet shuffle results,0,1,3,28,0,4,0,31,0
"Reversing Course, E.P.A. Says Fracking Can Contaminate Drinking Water ",0,3,11,46,4,9,0,57,0
New Year's Videos at ABC News Video Archive at abcnews.com,0,2,9,38,2,9,0,47,0
Breitbart News Daily: Trump Unshackled - Breitbart,0,2,6,36,2,6,0,42,0
Sheriff: Baby Abducted from FL Hospital 18 Years Ago Found Alive in SC  Insider,0,2,13,49,1,14,2,62,0
"Sergio Garcia on Masters victory: ""I was just screaming""",0,3,4,41,3,8,0,45,0
Donald Trump Launches Trade Fairness: ‘I’ve Been Looking to Do This for Years’,0,2,11,51,4,12,0,62,0
Can Bernie Sanders’s ‘revolution’ break the GOP?,0,2,6,32,4,6,0,38,0
"Explosive Report Indicates More Than 1,000 Russian Athletes Were Involved in Organized Doping",0,2,11,65,1,12,4,76,0
"They made him eat cat litter before killing him — and posted it all on Snapchat, police say",0,3,2,70,2,17,0,72,0
"The GOP’s crusade to defund Planned Parenthood nationwide, explained",0,2,6,52,2,8,0,58,0
Dr. Hadiyah Green Wants to Use Lasers to Kill Cancer Cells,0,2,9,38,1,10,0,47,0
Special Counsel’s Trump Probe Adds Manafort Case,0,2,7,34,1,6,0,41,0
Literally Just 10 Photos Andrew Garfield Chilling On A Paddle Boat,0,3,10,44,0,10,2,54,0
US drone strike kills eight in Pakistan's tribal region,0,1,3,43,1,8,0,46,0
Pay-Per-Click Web Advertisers Fight Costly Fraud,0,1,8,33,2,5,0,41,0
"Nona Hendryx, Wolf Eyes, 'Stranger Things' and More Set for Moogfest 2017",0,3,9,45,4,11,4,54,0
"Senate GOP Bypasses Dem Boycott of Mnuchin, Price By Suspending Rules",0,2,12,46,1,10,0,58,0
Nick Cannon on Ex Mariah Carey's New Year's Eve Flub: 'She Got a Little Flustered',0,2,13,50,5,14,0,63,0
Wikileaks to release thousands of secret documents; 'international embarrassment' likely,0,1,1,75,3,9,0,76,0
US indicts eleven alleged pirates from Somalia,0,1,3,37,0,6,0,40,0
10 stunning side-by-side photos show just how destructive Japan's 2011 earthquake and tsunami were,0,2,1,75,3,13,6,76,0
Looking to Add Diversity in Environmental Movement,0,1,5,39,0,6,0,44,0
19 Kenyans arrested for 'witch' killings,0,1,1,30,2,5,2,31,0
The Year in Latin Charts: Juan Gabriel & Nicky Jam Lead,0,3,9,34,2,10,0,43,0
"Finding America, Both Red and Blue, in the ‘Little House’ Books ",0,2,8,41,4,11,0,49,0
Here's everything you should have in your car at all times,0,2,1,46,1,10,0,47,0
"No, there is no spike in missing girls in D.C.; how tweets created a crisis",0,3,3,54,4,14,0,57,0
Young Thug Reflects on His Demons in 'Safe' Video: Watch,0,2,8,36,3,9,0,44,0
Conor McGregor's Coach Reveals How the UFC Fighter Is Training for Floyd Mayweather,0,2,14,56,1,12,0,70,0
A woman went to a furry convention with her dog thinking it was for pets The list,0,3,2,63,0,16,0,65,0
"Ignore Ann Coulter. She’s a boring performance artist, and she’s gaming us all.",0,3,4,58,5,12,0,62,0
"Dolphins QB Ryan Tannehill has ACL, MCL sprains in left knee",0,3,11,38,1,10,0,49,0
Homeless Across Country Fall Victim to Synthetic Marijuana ,0,2,7,44,0,8,0,51,0
"North Korea, Malaysia Impose Departure Bans ",0,2,6,31,1,6,0,37,0
'We have grave concerns': There could be trouble ahead for the NDIS if the ACT's problems go national,0,2,9,71,4,17,0,80,0
"Teen escapes father's killing rampage, calls police ",0,2,1,42,2,7,0,43,0
Row over size of crowd at Trump inauguration escalates as press secretary Sean Spicer rounds on press,0,3,4,81,0,16,0,85,0
US lawmakers want North Korea put back on terrorism blacklist,0,3,4,48,0,9,0,52,0
Mets fans and David Wright loved his 2017 debut,0,2,3,32,0,8,4,35,0
South Korean court to begin considering President Park Geun-hye’s impeachment,0,3,5,61,2,9,0,66,0
Obama Ranks High Among U.S. Presidents For Granting Clemency [Infographic],0,3,11,50,4,9,0,61,0
Viola Davis makes history with her third Oscar nod. We might be in for an epic speech.,0,2,4,64,2,16,0,68,0
Body found in frozen Colo. pond identified as missing 6-year-old boy,0,2,2,52,3,10,1,54,0
Britain’s Mainstream Media Blames ’Racism’ for Westminster Attack,0,2,7,48,3,7,0,55,0
Why Indie Artists Can't Afford to Skip Streaming: Guest Post,0,2,9,40,2,9,0,49,0
The intriguing conspiracy theory why the White House would only leak Trump's 2005 taxes The list,0,3,5,71,1,15,4,76,0
Yemeni Bodega Owners Say They’re Shutting Down To Take A Stand,0,3,11,40,1,10,0,51,0
Sexual harassment allegations emerge in Sterling Jewelers pay discrimination case - Yahoo,0,2,4,73,1,11,0,77,0
Recovering heroin addict explains why so many people fail out of rehab after a few days,0,2,1,71,0,15,0,72,0
"Joey Bada$$ Reveals Title, Release Date for Sophomore Album",0,2,8,40,3,8,0,48,0
Trump Disparages ’Dumb’ Deal With Australia On Refugees,0,2,8,38,2,7,0,46,0
FAA Issues Biggest Fine Ever for Unauthorized Drone Flights,0,3,10,41,0,8,0,51,0
"Trump, Boeing CEO Discuss Air Force One Requirements ",0,2,10,34,1,8,0,44,0
"In Order To Discourage Cash Transactions, Banks Revise Charges. Here’s How Much You Have To Pay Now",0,3,17,63,3,16,0,80,0
Report: Chuck Berry Died of Natural Causes,0,2,6,29,1,6,0,35,0
Really mean tournament organizers troll 'Smash Bros.' fans with fake Switch announcement,0,3,4,70,3,11,0,74,0
Scottish singer Jai McDowall wins fifth Britain's Got Talent series,0,1,7,50,1,9,0,57,0
Pope's prayers for Syrian refugees,0,3,2,27,1,4,0,29,0
A Series of Unfortunate Events: Count Olaf reveals all in a hilarious new interview,0,2,6,63,1,13,0,69,0
Prince (27 Points) and Scarlet Knights Turn Back No. 2 Seed,0,1,8,35,3,10,3,43,0
Bolivian president announces legal action over Obama's 'crimes against humanity',0,1,2,66,3,9,0,68,0
NASA's new searchable library lets you get your space fix big time,0,2,4,50,1,11,0,54,0
Donald Trump brands Democrats ‘hypocrites’ over Russian links ,0,3,4,48,2,8,0,52,0
"Wikinews interviews Jeremy Hanke, editor of MicroFilmmaker Magazine",0,1,6,53,1,7,0,59,0
Rupert Murdoch returns for Sky as Fox makes £18.5bn takeover approach,0,2,4,50,2,10,3,54,0
German anti-refugee MEP blames Angela Merkel for Berlin attack: 'Those are her dead!',0,3,8,60,5,12,0,68,0
Bush calls for US offshore oil exploration,0,1,3,33,0,6,0,36,0
Worth Magazine to Reinvent Itself,0,1,4,25,0,4,0,29,0
Sweden’s Telia Has Another Problem at Turkcell: Free Speech,0,3,8,41,2,8,0,49,0
No Mechanical Problems Found After Boston Train Crash,0,1,8,38,0,7,0,46,0
"Trump Thinks Russia Hacked DNC, Slams 'Sick People' For Salacious Kremlin Stories",0,3,14,53,3,11,0,67,0
Suicide bomber attacks US base in Afghanistan,0,1,4,35,0,6,0,39,0
The Iowa Straw Poll Is No More,0,2,7,17,0,6,0,24,0
Tribune Has a Favorite to Buy Cubs,0,1,5,23,0,6,0,28,0
China’s GDP report might deliver good news to investors,0,2,4,42,1,8,0,46,0
Bill Nye Boosts Science Guys and Girls: ‘Kids Are Natural Scientists’,0,2,10,46,3,10,0,56,0
Hillary Clinton Gets Standing Ovation at Broadway’s ‘The Color Purple’,0,2,9,49,3,9,0,58,0
What is a sanctuary city? And what happens now?,0,3,2,35,2,8,0,37,0
Fox News movie reviewer fired for downloading film,0,1,2,41,0,7,0,43,0
DJ Khaled Tries to Impress Audience With Basketball Skills at Antonio Brown Celebrity Game,0,3,13,64,0,13,0,77,0
Florida man arrested for plotting to bomb Target stores so company's stock would plunge ,0,3,2,71,1,14,0,73,0
Australia records hottest year on record,0,1,1,34,0,5,0,35,0
"Minimum wage: ACTU pushing for $45-a-week increase, employers want lower pay rise",0,2,5,58,5,11,2,63,0
Who Should Win Album Of The Year at the 2017 Grammys? Vote!,0,3,9,33,2,11,4,42,0
Persian Station in Britain Rattles Officials in Iran,0,1,6,39,0,7,0,45,0
REACTION: Top Dems Urging Hillary Clinton to Run for New York City Mayor  Insider,0,2,19,47,1,14,0,66,0
Why Long Voting Lines Could Have Long-Term Consequences - The New York Times,0,2,13,49,2,12,0,62,0
Tillerson tells State Department employees that budget cut reflects new priorities,0,2,3,69,0,10,0,72,0
Commander of US Naval forces implies that Chinese navy ships can't 'fight their way out of a wet paper bag',0,3,5,80,3,19,0,85,0
CRPF Sniffer Dog 'Cracker' Who Was Killed In An IED Explosion In Chhattisgarh Laid To Rest,0,3,21,52,2,15,0,73,0
The Top 5 Bollywood Films You Can't Miss This Summer,0,3,9,32,1,9,1,41,0
Mistrial for South Carolina Officer Who Shot Walter Scott - The New York Times,0,2,12,52,1,13,0,64,0
Ivan Nova determined to crash Yankees rotation: ‘Not a reliever’,0,2,4,48,3,9,0,52,0
One of the largest energy companies says American drillers are splurging again,0,3,2,65,0,11,0,67,0
"Congress Twitter Account Hack, Smart Fence At India-Pak Border And Other Must Read Stories",0,2,15,60,2,13,0,75,0
Mel B: 'You get to laugh your pants off at people who are delusional',0,3,3,50,3,13,0,53,0
"Shiv Sena Pitches RSS Chief Mohan Bhagwat's Name For President, Says He Will Make India A Hindu Rashtra",0,3,20,64,2,17,0,84,0
"Obama Praises Labor Secretary Perez, Who's Weighing DNC Bid ",0,3,11,38,2,9,0,49,0
North Korea threatens nuclear strike against Australia if it doesn't stop 'blindly toeing US line',0,3,5,76,3,14,0,81,0
Charter Communications Files for Reorganization,0,1,4,39,0,4,0,43,0
"Derek Jeter, wife Hannah expecting their first child",0,3,3,41,1,7,0,44,0
Wells Fargo to Pay $110 Million to Settle Fake Accounts Lawsuit,0,3,8,41,1,10,3,49,0
South Korea’s Acting President Rejects Extension of Scandal Probe,0,3,8,48,1,8,0,56,0
"Gary Kubiak brings end to Broncos' locker room squabble, report says",0,2,3,53,2,10,0,56,0
ASX: Australian shares drop steeply on US sell-off,0,3,6,35,2,7,0,41,0
U.N. Reaches Deal on Aleppo Monitoring     ,0,3,6,25,2,10,0,31,0
Hannity: Susan Rice 'Has a Lot of Explaining to Do' About Intel 'Unmasking'  Insider,0,3,11,54,5,14,0,65,0
Abductors of American journalist Jill Carroll release videotape with demands,0,1,4,63,0,9,0,67,0
Madonna's Albums Ranked From Worst to Best,0,3,6,29,1,6,0,35,0
"Washington Metro collision kills nine, injures many",0,1,2,42,1,6,0,44,0
Most Overhyped NBA Players at the End of 2016-17 Season,0,3,8,31,1,9,6,39,0
"The best music of 2016: YG, Beyoncé, Maren Morris and more",0,3,6,35,3,10,4,41,0
Golden Globes Ratings Up As A Political Meryl Streep Steals The Show,0,3,12,45,0,11,0,57,0
Moscow 30 under 30: the people’s power list,0,3,1,29,2,7,4,30,0
"Oldest user of Twitter, Ivy Bean, dies at 104",0,1,4,28,2,8,3,32,0
Isle of Man Plans Unlimited Music Downloads,0,1,6,31,0,6,0,37,0
A surprising group affected by Trump's travel ban: airline crews,0,3,2,51,2,9,0,53,0
Ailing Vermont Town Pins Hopes on Mideast Refugees ,0,2,7,36,0,8,0,43,0
Chelsea Clinton leaves door open for possible 2020 White House run ,0,2,4,48,0,11,4,52,0
Iranian Baby With Heart Defect to Undergo Surgery Soon ,0,3,8,38,0,9,0,46,0
The Latest: Governor Declares State of Emergency in Fulton ,0,3,7,42,1,9,0,49,0
The Inside Story Of How J. Cole's 'Eyez' Documentary Was Made,0,2,11,36,4,10,0,47,0
Who's with the US on Syria airstrike and who isn't,0,3,4,35,2,9,0,39,0
Rex Tillerson Suggests The U.S. Should Stay In Paris Climate Agreement,0,3,12,46,2,10,0,58,0
Finding a Home on the Tree of Life for a Tentacled Ice Cream Cone With a Lid ,0,3,10,50,0,17,0,60,0
"Here's the best piece of advice Khan Academy founder, Sal Khan, received from billionaire Bill Gates",0,2,7,75,3,15,0,82,0
US Senate unanimously passes genetic nondiscrimination bill,0,1,3,50,0,6,0,53,0
Top Trump aide calls Guantanamo Bay 'incredibly important intelligence asset' ,0,2,4,62,2,10,0,66,0
Barack and Michelle Obama donate swing set to Washington shelter,0,3,4,51,0,9,0,55,0
Former northeastern US Republican campaign director charged with conspiracy,0,1,4,63,0,8,0,67,0
This Picture Of Mariah Carey Leaving A Weed Dispensary Is Truly Ridiculous And Amazing,0,3,14,59,0,13,0,73,0
France election: Fillon lawyers demand dropping of payments probe,0,3,2,54,1,8,0,56,0
Germanwings Plane Crash: Prosecutor Says Doctors Felt Co-Pilot Unfit to Fly,0,2,11,52,2,10,0,63,0
U.S. EPA submits 2003 greenhouse gas inventory to U.N.,0,1,7,31,4,8,4,38,0
Euro Volatility Spread Steepens to Record High on France: Chart,0,2,8,45,1,9,0,53,0
Netflix wants to start selling you merch,0,3,1,33,0,6,0,34,0
Civil defence thwarts Israeli air strike on Gaza refugee camp,0,1,3,49,0,9,0,52,0
'Deadpool' was the most illegally downloaded movie in 2016,0,3,1,43,2,8,4,44,0
‘A wonderful day’: A veteran’s undocumented wife won’t be deported by ICE,0,3,5,52,5,11,0,57,0
US unemployment rate falls to nine-year low,0,3,2,34,1,6,0,36,0
"Court Temporarily Blocks Trump’s Travel Ban, and Airlines Are Told to Allow Passengers ",0,3,11,61,2,13,0,72,0
Profit Down 77% at American Eagle,0,1,4,21,1,5,2,25,0
Europe cold weather death toll rises,0,2,1,30,0,5,0,31,0
French Workers Ratchet Up Threats,0,1,5,24,0,4,0,29,0
"MIT's ""$100 laptop"" to be unveiled in November",0,1,4,28,4,7,3,32,0
Democratic Governors Vow To Hold The Line Against Donald Trump,0,3,10,43,0,9,0,53,0
Good Times with Guns,0,2,3,14,0,3,0,17,0
"Residents, rebels leave besieged Syrian city",0,2,2,36,1,5,0,38,0
WA election: Bob Hawke calls for unity as Labor rallies for final campaign week,0,3,5,60,1,13,0,65,0
"Obnoxious Steelers Fan Videobombs New England Broadcast, Gets Shoved Off Camera",0,3,11,57,1,10,0,68,0
Bill Gates Thinks You Should Read These 5 Books This Summer,0,2,10,38,0,10,1,48,0
GOP outlines its Obamacare repeal plan,0,3,4,29,0,5,0,33,0
Paris Hilton released from jail,0,1,2,25,0,4,0,27,0
"Girl shot in head leaves hospital: ""I am tougher than a bullet""",0,2,2,47,3,11,0,49,0
"La Jeune Rue Project, and Its Founder, Slide Toward Failure in Paris ",0,2,10,45,2,12,0,55,0
The Funniest Tweets From Parents This Week,0,3,7,29,0,6,0,36,0
Republican leaders in US want more tax relief in economic stimulus,0,1,3,53,0,10,0,56,0
Lexmark releases printer with built-in CD burner,0,1,3,38,1,6,0,41,0
Ever Hear Of Funko? They Plan To Be A Billion-Dollar Toy Company,0,3,13,38,2,11,0,51,0
The Drumbeats Don’t Add Up to Imminent War With North Korea ,0,3,10,38,1,11,0,48,0
Cheetahs Are Far Closer To Extinction Than We Realized,0,3,9,37,0,8,0,46,0
E.U. Warns Internet Companies on User Privacy,0,1,7,30,2,6,0,37,0
Model Students! Cindy Crawford and Rande Gerber’s Kids Make the Honor Roll,0,3,10,51,2,11,0,61,0
U.K. May Start Construction of Fewer Offices Over Brexit: Chart,0,3,10,41,3,9,0,51,0
"A Trump Administration, With Obama Staff Members Filling In the Gaps ",0,3,10,47,1,11,0,57,0
Video shows police tackling and beating a black man suspected of stealing a car. It was his.,0,2,2,72,2,16,0,74,0
A.M.D. Reports Narrower Loss,0,1,6,16,3,3,0,22,0
"Judge orders residents and city to come to agreement on partially collapsed building in Buffalo, New York",0,1,4,84,1,16,0,88,0
"2 killed, 14 injured when van hit NJ guardrail, flipped over",0,2,2,43,2,10,3,45,0
Moussa Dembélé scores as Celtic beat Hamilton for 21st straight win,0,2,4,51,0,10,2,55,0
Report: Harrison Ford has jet run-in at California airport ,0,3,4,44,2,9,0,48,0
Sen Angus King: We Are 20 Percent Into Russian Collusion Investigation - Breitbart,0,2,11,55,2,12,2,66,0
Twitter to raise 140-character limit for direct messages,0,3,1,44,1,7,3,45,0
"New military plans against ISIS to be presented to Trump, US officials ",0,3,8,50,1,12,0,58,0
France's state of emergency may be extended to protect 2017 elections,0,3,1,53,1,10,4,54,0
The one thing rich parents do for their kids that makes all the difference,0,2,1,60,0,13,0,61,0
Lenin and Trump bear little similarity,0,3,2,31,0,5,0,33,0
Britain launches 2012 Olympic Lottery games,0,1,3,31,0,5,4,34,0
Park Geun-hye: Court ousts South Korea's scandal-hit president,0,3,5,46,4,7,0,51,0
Facebook has a new app for the Apple TV â here's what it looks like,0,2,4,48,3,14,0,52,0
Golden Globe Virgins: A Look at This Year’s First-Time Nominees [Video],0,3,11,45,5,10,0,56,0
Cheteshwar Pujara Breaks Gautam Gambhir's Record For Most Test Runs In A Season By An Indian,0,3,16,60,1,15,0,76,0
UK work secretary David Blunkett resigns,0,1,4,31,0,5,0,35,0
Evacuations Set to Begin as Assad Reclaims Aleppo,0,3,6,36,0,7,0,42,0
"No Stork Involved, but Mom and Dad Had Help",0,1,7,27,1,8,0,34,0
Apple gains amid predictions of an upcoming iPhone upgrade cycle,0,3,2,53,0,9,0,55,0
‘I’m finally a weather girl’: Woman with Down syndrome fulfills a lifelong dream,0,3,3,61,4,12,0,64,0
Donald Trump Adviser Kellyanne Conway Joining White House Team ,0,3,9,45,0,9,0,54,0
Nothing Will Redeem the Ruined Reputations of Trump’s Republican Collaborators,0,2,8,60,1,9,0,68,0
Listeria fears prompt Sargento cheese recall,0,3,2,37,0,5,0,39,0
Mike + the Mechanics Premiere 'Let Me Fly' Title Track: Listen,0,2,9,39,4,10,0,48,0
Five New Power Centers: A Guide to the Fractured Democrats,0,2,8,40,1,9,0,48,0
Australian Aborigines sprayed by crop-duster,0,1,2,37,1,4,0,39,0
Belgium train crash: Several hurt in Leuven derailment,0,3,3,43,1,7,0,46,0
Clinton Global Initiative to Close Amid Drop in Foreign Donations  Insider,0,3,9,54,0,11,0,63,0
Morning brief: Trump to take center stage at CPAC ,0,3,6,34,1,9,0,40,0
Herding Reindeer a Way of Life in Remote Arctic,0,3,6,33,0,8,0,39,0
Super Bowl 51: Expert Consensus Picks for the Title Game,0,3,7,37,1,9,2,44,0
Jeb Bush to call for closer ties with Europe in Berlin speech ,0,2,4,46,0,12,0,50,0
Trump China talks: Why Mar-a-Lago? Experts weigh in on host site ,0,2,6,44,4,11,0,50,0
Christchurch fire halted as residents count losses,0,3,1,43,0,6,0,44,0
Trevor Noah explains how aliens have invaded Earth and it has to do with Trump's hair,0,3,4,65,1,15,0,69,0
"LL Bean recalls 3,000 pairs of adjustable snowshoes ",0,3,3,36,1,8,4,39,0
Never Remember: City Laughs Along at Massacre That Wasn't ,0,2,8,39,2,9,0,47,0
This Mom Is So Adorably Extra She Stages An Incredibly Stunning Baby Shoot Each Month,0,2,15,56,0,14,0,71,0
Reports: Parents of missing girl Madeleine McCann are suspects in her disappearance,0,1,5,66,1,11,0,71,0
The Best Head-to-Head Matchups in the Sweet 16,0,3,6,29,2,7,2,35,0
"Americans Agree on Paid Leave, but Not on Who Should Pay ",0,3,8,37,1,11,0,45,0
Schwarzenegger to Senate believers: I won't be back,0,3,3,39,2,7,0,42,0
U.S. Postal Service running out of money,0,1,4,28,2,6,0,32,0
Inventor Ronald Howes dies at age 83,0,1,3,25,0,6,2,28,0
Watch A Magician Give Drake And Jennifer Lopez All The Magic They Can Handle,0,3,14,49,0,13,0,63,0
Suicide bomber kills sixteen in Afghanistan,0,1,2,36,0,5,0,38,0
Airbus offers funding to search for black boxes from Air France disaster,0,1,3,58,0,11,0,61,0
Watch the Red Carpet Live Stream at Billboard Women in Music 2016,0,2,8,42,0,11,4,50,0
Cyprus reunification talks: Everything you need to know about one of the world's most intractable disputes,0,2,2,87,2,15,0,89,0
Some Marines being investigated for sharing nude photos ,0,2,2,46,0,8,0,48,0
"NDIS: Report warns workforce understaffed in major cities, raises concerns over readiness",0,3,5,71,2,11,0,76,0
Emerging Powers Prepare to Meet in Russia,0,1,5,30,0,6,0,35,0
Mubarak refused permission to leave Egypt for treatment after heart attack,0,1,2,62,0,10,0,64,0
Lawyer Says Reporter Had Iran Document,0,1,6,27,0,5,0,33,0
Israel Lets Reporters See Devastated Gaza Site and Image of a Confident Military,0,1,10,58,0,12,0,68,0
"1 murder suspect dead, 1 in custody after Ga. motel standoff, authorities say",0,3,1,59,3,12,2,60,0
Here's why maple syrup jugs have teeny tiny handles,0,3,1,41,1,8,0,42,0
Chris Pratt Says His Blue-Collar America Remark Was ‘Pretty Stupid’,0,3,11,44,3,9,0,55,0
Turkish shopkeeper saves falling toddler,0,1,1,35,0,4,0,36,0
Philippines Supreme Court to probe leak of draft judgment in election case,0,1,3,60,0,11,0,63,0
Colorado landlord accused of using tenant’s home as sex pad ,0,3,1,48,1,10,0,49,0
"People Keep Talking About ’The Establishment.’ What Is It, Anyway?",0,2,10,42,5,9,0,52,0
Peruvian Santa in gung-ho-ho drugs bust,0,3,2,30,2,5,0,32,0
5 Changes That Could Come From Leaving The Paris Climate Deal,0,2,10,40,0,10,1,50,0
Executive Hired to Salvage A.I.G. Becomes a Target,0,1,8,32,3,7,0,40,0
"'SNL' mocks Trump, Putin and ties with Exxon CEO",0,3,9,28,3,8,0,37,0
British Cycling announces a review into its medical practices following UKAD investigation fallout,0,2,6,80,0,12,0,86,0
Inauguration Singer Jackie Evancho 'Disappointed' in Trump  Insider,0,3,7,50,2,8,0,57,0
The Governor Sends Regards,0,1,4,19,0,3,0,23,0
States Reluctantly Move to Raise Tax on Cigarettes,0,1,6,37,0,7,0,43,0
Texas police officer dies falling into massive sinkhole,0,3,1,47,0,7,0,48,0
Department of Defense report lambasts communication failure in US War on Terror,0,1,6,62,0,11,0,68,0
U-Md. president calls sanctuary campus designation ‘unnecessary’,0,3,2,52,4,6,0,54,0
China Slaps GM With $29 Million Fine Amid Growing Tensions,0,3,10,36,1,9,2,46,0
Winners and losers on UK's East Coast rail line,0,1,5,33,1,8,0,38,0
House of Supreme Court Justice threatened,0,1,4,32,0,5,0,36,0
"Maggie Rogers, Nicky Jam & More Are Spotify Editors' Picks for New Music Friday",0,2,12,51,3,13,0,63,0
"Police ease rules on tattoos, turbans, beards ",0,2,1,36,2,7,0,37,0
Well-wishers raise thousands for teenage asylum seeker attacked in Croydon,0,3,2,62,1,9,0,64,0
"Most People Diagnosed With Asthma May Not, In Fact, Have The Problem, Says New Study",0,2,15,52,3,14,0,67,0
Super Bowl LI coverage: Patriots complete epic comeback,0,3,5,42,1,7,0,47,0
Long-Lost Lincoln Letter Is Returned to Archives,0,1,7,34,1,6,0,41,0
UN Security Council imposes more sanctions against Iran,0,1,5,43,0,7,0,48,0
Amanda Seyfried among several stars to have private photos leak online ,0,3,2,58,0,11,0,60,0
Andrey Pavlov scores nightmare 17 on a single hole at Lyoness Open,0,3,4,49,0,11,2,53,0
"The Beatles, Aerosmith & Godsmack: A History of 'Come Together' on the Charts",0,3,9,51,5,12,0,60,0
U.K. Said to Favor Voluntary Action to Control Utility Bills,0,2,9,40,2,9,0,49,0
Social worker criticised after saying christening a baby would 'hinder chance of adoption',0,3,1,75,2,12,0,76,0
Barack and Michelle Obama Leave Tahiti as They Continue Post-White House Tropical Tour,0,2,12,61,1,12,0,73,0
"Earthquake south of Medan, Indonesia",0,1,3,28,1,4,0,31,0
Examining the Miami Dolphins owner's 'No' vote on Las Vegas Raiders,0,2,7,47,3,10,0,54,0
Why The Republican Plan To Tax Imports Won't Create More American Jobs,0,3,12,46,1,11,0,58,0
Britons' Drinking Habits Are Ginning Up the Inflation Data,0,2,8,41,1,8,0,49,0
Stranded Afghans queue to leave Pakistan,0,2,3,32,0,5,0,35,0
Trump's America Donald Trump vows military build-up in feisty speech at conservative summit,0,3,4,73,2,12,0,77,0
DNA Deciphers Roots of Modern Europeans ,0,3,7,27,0,6,0,34,0
North Korea: Pentagon addresses confusion over strike group,0,3,3,48,1,7,0,51,0
U.S. Farm Income Seen Falling for Fourth Straight Year ,0,3,9,35,2,9,0,44,0
What Parents of Early-Teen Boys Need to Know,0,3,7,29,1,7,0,36,0
Egyptian voters approve constitutional changes,0,1,1,41,0,4,0,42,0
Mario Draghi succeeds Antonio Fazio as Bank of Italy governor,0,1,6,46,0,9,0,52,0
A Better Way to Walk On Ice: Think Like a Penguin,0,2,9,29,1,10,0,38,0
"This Doll May Be Recording What Children Say, Privacy Groups Charge",0,2,11,45,1,10,0,56,0
Trump reportedly 'yelled' at CIA director over response to reports about US intelligence being withheld,0,3,6,81,2,14,0,87,0
Number waiting more than 18 weeks for NHS surgery 'set to double',0,3,4,46,2,11,2,50,0
Officials: Iraqi forces in control of Baiji city,0,2,3,37,1,7,0,40,0
North Carolina May Lose More NCAA Games Amid Bathroom Bill Deadlock ,0,3,14,43,0,11,0,57,0
China Takes Another Step Towards A Service Economy,0,3,8,35,0,7,0,43,0
English actress Elizabeth Taylor dies at age 79,0,1,3,35,0,7,2,38,0
"Copenhagen hotel explosion may have been terror attack, say officials",0,1,1,58,1,9,0,59,0
The entire coal industry employs fewer people than Arby’s,0,3,2,46,1,8,0,48,0
Chris Christie on Eating Meatloaf: Trump Made Me Do It,0,3,9,35,1,9,0,44,0
"Veteran Allegedly Kills 5 at Fort Lauderdale Airport Shooting, Terrorism Not Ruled Out ",0,2,11,61,1,13,1,72,0
English footballer Beckham visits British troops in Afghanistan,0,1,4,52,0,7,0,56,0
Jeb Bush Stresses Military Might in Europe,0,2,6,30,0,6,0,36,0
Turkey referendum: Australian Turkish voters split over 'premature' result,0,3,3,60,3,8,0,63,0
Customers are developing new habits and it's killing Applebee's and Buffalo Wild Wings,0,2,5,67,2,12,0,72,0
Office 'cake culture' is fueling obesity crisis and treats should be swapped for hugs ,0,3,1,69,2,14,0,70,0
Truck Bomb At Libyan Security Training Camp Kills Dozens,0,2,9,39,0,8,0,48,0
Bani J Has A Message For People Who Body-Shame Women And It's A Must Read For Everyone!,0,3,18,50,3,16,0,68,0
He's how tall?! Birth stats for April the giraffe's calf,0,3,3,40,4,9,0,43,0
Their Lines Are Softening,0,2,4,18,0,3,0,22,0
Pennsylvania mother who hiked 26 miles to save family describes ordeal,0,3,1,57,0,10,2,58,0
Police Chief Plays Down I.R.A. Groups in Ulster,0,1,9,28,3,7,0,37,0
New Women-Only Salon Caters to Hijab-Wearing Clients,0,3,8,36,2,6,0,44,0
"Kendrick Lamar, Rihanna, Adele And More Say Farewell To Obama",0,3,10,40,2,9,0,50,0
"For Former Soviet Republics, Moscow Has a New Playbook",0,3,8,37,1,8,0,45,0
American Airlines Co-Pilot Dies After Medical Emergency on New Mexico-Bound Flight,0,3,12,58,2,10,0,70,0
Immigrant rights groups brace for more deportation raids: 'This is the beginning',0,2,2,65,3,11,0,67,0
I did my best to understand Donald Trump’s foreign policy. Here’s what I came up with.,0,2,5,62,4,15,0,67,0
AXA participates in insurtech's $20M round,0,3,4,29,2,5,2,33,0
Jobs unveils new products after cloud of secrecy and lawsuits,0,1,1,51,0,9,0,52,0
Oakland Warehouse Fire: Names of Seven Victims Released,0,3,7,40,1,7,0,47,0
John Oliver Takes Out More Ads to Explain the Health Care Bill to Trump,0,3,11,47,0,13,0,58,0
Site of Somali Government Is Put Under Islamic Law,0,1,8,34,0,8,0,42,0
IOC denies covering up 2008 Olympic doping cases ,0,3,4,33,0,8,4,37,0
'Freedom': A Martin Luther King Jr. Day Spotify Playlist,0,3,9,35,4,8,0,44,0
"US president Obama, Congress call for blocking of executive bonuses at AIG insurance company",0,1,7,71,1,13,0,78,0
Ralph Lauren just became the latest victim of America's retail apocalypse,0,3,3,59,1,10,0,62,0
"NBA Power Rankings: As Cavaliers slide, Warriors claim the throne",0,3,8,46,2,9,0,54,0
Woman Accused Of Murdering Kim Jong Un's Half Brother Thought It Was A TV Prank!,0,3,16,48,2,14,0,64,0
New technology brings Star Wars-style desert moisture farming a step closer,0,3,3,61,1,10,0,64,0
Listen to Ed Sheeran & Zion y Lennox's 'Shape of You' Latin Remix,0,3,9,40,4,12,0,49,0
Putin’s Sassy Trolling Was Sending Message to Trump: Experts,0,3,8,42,2,8,0,50,0
A Guide to Watching the Golden Globes,0,2,5,26,0,6,0,31,0
Somali al-Shabaab group seizes three towns,0,1,2,34,1,5,0,36,0
James Corden Adds a 'Touch' of Little Mix to 'Late Late Show',0,2,9,37,4,11,0,46,0
Emma Stone: directors gave my improv jokes to male co-stars,0,3,2,46,2,9,0,48,0
TWO MINUTE MONEY: Traditional IRAs vs Roth IRAs,0,3,22,17,1,7,0,39,0
"For Trump, Everything Is a Rating - The New York Times",0,2,9,33,2,10,0,42,0
Emma's Imagination declared winner of UK's 'Must Be The Music',0,1,8,41,4,9,0,49,0
Parents speak out about backlash over YouTube prank videos: 'We were going for shock value',0,2,4,70,3,14,0,74,0
Pick for Protocol Post Corrects Failure to File Taxes in 2 Years,0,1,8,44,0,11,1,52,0
Nobody Knows Why Fortysomethings Are Driving U.S. Productivity,0,3,9,44,2,7,0,53,0
Falkland Islands: Argentina protests to Brazil about RAF using its airports,0,3,7,57,1,10,0,64,0
13 missing from ship off coast of Madagascar; two rescued,0,1,1,44,1,9,2,45,0
Typhoon kills two in southern China,0,1,2,28,0,5,0,30,0
Attack on Westminster: how the papers reported a deadly day,0,3,2,47,1,9,0,49,0
"Toxic Emissions Fell in 2007, E.P.A. Says",0,1,7,20,4,6,4,27,0
"Trump White House vows it won’t coddle ‘the rioter, the looter, or the violent disrupter’",0,3,3,67,5,14,0,70,0
"No Trump or Goodell at Super Bowl, at Least According to N.F.L. Transcripts ",0,3,11,48,4,13,0,59,0
George H.W. Bush and wife Barbara take part in Super Bowl coin toss - a week after being released from hospital ,0,3,7,81,3,21,0,88,0
If the Payment on Your Home-Equity Line of Credit Is About to Jump - Total Return,0,2,12,52,2,15,0,64,0
Who Are These Guys Aaron Rodgers Is Making Look Like Stars?,0,3,11,37,1,10,0,48,0
US congresswoman Gabrielle Giffords shot at Arizona supermarket,0,1,5,51,0,7,0,56,0
Watch Steve Aoki's Miami Music Week Interview Get Crashed by Hardwell,0,3,10,48,1,10,0,58,0
If Donald Trump delivered his own inauguration speech on Twitter...,0,3,4,51,3,9,0,55,0
Senate committee not investigating Trump wiretapping claims yet,0,3,2,54,0,7,0,56,0
What color is this dress?,0,2,1,19,1,4,0,20,0
It Takes a Small Army to Equal Arnie ,0,3,6,23,0,8,0,29,0
"For Iraqi Christians After Islamic State, Hope Amid the Ruins",0,2,9,42,1,9,0,51,0
College Basketball ASU Forward Obinna Oleka Finishes 1-Handed Alley-Oop Jam over Purdue Defender,0,3,15,66,2,12,1,81,0
Sheriff David Clarke on Violent Philly Protests: 'This Stuff Is Disastrous'  Insider,0,2,11,58,3,12,0,69,0
Gavin Grimm case: Supreme Court scraps case on transgender bathroom rights,0,3,4,59,1,10,0,63,0
Kanye West Reportedly Suffering From Memory Loss After 2016 Hospitalization,0,3,9,53,0,9,4,62,0
Syria war: G7 seeks united front on Assad and Russia,0,3,4,37,1,9,1,41,0
G.M. May Offer Only Stock to Bondholders,0,1,7,25,2,6,0,32,0
Rohingya woman: 'They tore all my clothes',0,3,2,31,3,6,0,33,0
Key points of budget 2017 – at a glance,0,3,1,25,1,8,4,26,0
Anti-Bush protests turn violent in Argentina,0,1,3,35,1,5,0,38,0
The Trump administrationâ€™s most disturbing trait,0,2,2,41,2,5,0,43,0
"Carrie Fisher will not be digitally recreated in upcoming ""Star Wars"" films",0,3,4,58,2,11,0,62,0
An appeals court just blasted a judge who tried to stop same-sex marriages in Puerto Rico,0,2,3,70,1,15,0,73,0
"Dear 'SNL,' Please Let Christine Baranski Play Education Secretary Betsy DeVos",0,3,14,51,3,10,0,65,0
Megyn Kelly Doesn’t Deny Report About Leaving Fox News for CNN,0,3,12,39,1,10,0,51,0
San Francisco Giants rookie pitcher throws no-hitter against New York Mets ,0,3,6,57,1,11,0,63,0
Democratic attorneys general seek to intervene in Obamacare case,0,2,2,54,0,8,0,56,0
Birdman Compares Young Thug To Michael Jackson And Prince,0,3,9,40,0,8,0,49,0
"Historical Trove, Freed From Storage, Gets a Home",0,1,7,33,2,7,0,40,0
Swedish 'bikini cop' who stopped pickpocket quits job after photo fame ,0,3,1,57,2,11,0,58,0
The Cities Creating The Most Tech Jobs 2017,0,2,7,25,0,7,4,32,0
Wikimania jury chooses Buenos Aires for 2009 location,0,1,3,39,0,7,4,42,0
British Report Urges New Rules on Bank Pay,0,1,7,28,0,7,0,35,0
"Kristen Bell on why her daughters don't watch ""Frozen,"" holiday plans",0,2,3,52,4,10,0,55,0
Johnny Manziel deleted his Twitter account after offering Trump advice on using social media,0,2,4,75,0,13,0,79,0
"‘Demonic activity was palpable’ at Trump’s rally, pastor says",0,3,2,47,4,8,0,49,0
Zika Economics: Brazil Calls Emergency Mercosur Meeting,0,2,7,41,1,6,0,48,0
South Korea City Hit Hard by MERS Seeks Return to Normal,0,2,12,34,0,10,0,46,0
Australian Labor Party shelves government oversight of media legislation,0,1,3,61,0,8,0,64,0
Wake Forest Redeems Itself Against Duke,0,1,6,28,0,5,0,34,0
"500 Members Of The Same Family Click The Most Awesome Photo Ever, Fit Into One Single Frame!",0,3,16,55,2,16,3,71,0
Donald Trump Reportedly Working to Transfer Businesses to His Children - Breitbart,0,2,9,61,1,11,0,70,0
"Homeland Security fields 1,000 sex abuse complaints, group says ",0,3,2,47,2,9,4,49,0
Tories’ ‘imperial vision’ for post-Brexit trade branded disruptive and deluded,0,3,2,63,4,9,0,65,0
No Illinois Perjury Charge for Burris,0,1,5,27,0,5,0,32,0
Californians foot $25G bill for 40 hours of Holder's anti-Trump time ,0,3,4,47,3,11,4,51,0
G.O.P. Health Bill Faces Revolt From Conservative Forces ,0,3,10,36,3,8,0,46,0
"Pets can help people manage serious mental illness, study finds",0,3,1,52,1,9,0,53,0
CMO Today: United Grapples With PR Disaster,0,3,10,26,1,6,0,36,0
Russian spies and cyber expert charged with treason for 'cooperating' with US,0,3,3,61,2,11,0,64,0
Northern Japan hit by strong quake,0,1,2,27,0,5,0,29,0
H5N1 hits Britain,0,1,3,10,0,2,2,13,0
Roadside Bomb Kills 3 Aid Workers in Northern Afghanistan,0,1,7,41,0,8,1,48,0
"Harry Potter actress poses for Playboy, says 'naked is normal'",0,3,3,47,3,9,0,50,0
"Rex Tillerson Used Alias Email at Exxon to Discuss Climate Change, New York Says ",0,3,12,54,1,14,0,66,0
"Wikinews interviews Corrado Giustozzi, security consultant and author",0,1,3,58,1,7,0,61,0
How to Deal With Work Burnout,0,3,5,19,0,5,0,24,0
House Clears Path for Repeal of Health Law ,0,3,6,29,0,8,0,35,0
All Signals Point Once Again to War in Gaza,0,2,7,28,0,8,0,35,0
"11 Clever, Untraditional Ways People Have Wrapped Gifts This Holiday Season",0,2,10,52,1,10,2,62,0
Italy earthquakes: Many feared dead in hotel buried by avalanche,0,3,2,52,1,9,0,54,0
A Border Adjustment Tax Threatens Disruption For U.S. And Its Neighbors,0,3,12,47,2,10,0,59,0
Ravindra Jadeja's 7/48 Helps India Complete Demolition Job By Inflicting 4-0 Series Loss On England In Chennai,0,2,15,71,3,16,5,86,0
Gordon Ramsay's father-in-law admits to computer hacking ,0,2,2,45,3,7,0,47,0
"Dr. Luke Out As Kemosabe CEO, But Remains At Sony Music",0,2,13,30,2,10,0,43,0
"Aleppo evacuation halted after rebels fire on convoy, Syrian media report ",0,3,2,60,1,11,0,62,0
Tina Brown: Clinton's loss was 'wake up call for feminism',0,3,3,42,4,9,0,45,0
Trump Winery Looking to Add Foreign Workers ,0,2,6,31,0,7,0,37,0
"Oversaving, a Burden for Our Times",0,1,4,24,1,5,0,28,0
No. 2 Duke Routs Maryland,0,1,4,15,1,4,1,19,0
Trump team disavows climate change questionnaire to Energy Department,0,3,3,58,0,8,0,61,0
Trump to Cancel Obama's Policies Aimed at Paris Climate Pledge,0,2,8,44,1,9,0,52,0
Tube strike: Government accuses union bosses of co-ordinating action to inflict 'maximum pain' on commuters,0,2,2,87,4,14,0,89,0
"Jack Straw, Leader of the British House of Commons urges Muslim women to drop full veil",0,1,7,64,1,15,0,71,0
Why Do Our Minds Wander?,0,2,5,14,1,4,0,19,0
Telecom policy tilts in favor of industry under Trump's FCC ,0,3,5,44,1,10,0,49,0
"Nitish wins in Bihar, India",0,1,3,19,1,4,0,22,0
"This UP Couple Wanted To Adopt PM Modi, But Their Application Got Rejected!",0,3,15,46,2,12,0,61,0
"What next for Syria, its allies and foes after fall of Aleppo?",0,3,3,46,2,11,0,49,0
Blair: G8 leaders announce $50 billion aid increase; talks on trade and climate change,0,1,2,65,3,13,3,67,0
John Wick Is An Action Hero As Unhappy Workaholic,0,2,9,32,0,8,0,41,0
"Fed, Economists and Investors Show Rare Harmony on Rate Outlook",0,3,8,45,1,9,0,53,0
"A Man Is Shot in the Back, and Only the Police Are Kept in the Dark ",0,2,10,41,1,16,0,51,0
"Boat in Bangladesh sinks, at least twelve dead",0,1,2,36,1,7,0,38,0
French author Le Clézio wins the 2008 Nobel Prize in Literature,0,1,6,43,0,10,4,49,0
Why Chobani Gave Employees A Financial Stake In Company’s Future,0,2,10,44,1,9,0,54,0
300 Laid Off at Sears,0,1,3,11,0,4,3,14,0
"Brush fire threatens Molokai, Hawaii",0,1,3,28,1,4,0,31,0
How Google Decides to Pull the Plug,0,1,5,24,0,6,0,29,0
"Annie Glenn: ‘When I called John, he cried. People just couldn’t believe that I could really talk.’",0,3,7,69,7,16,0,76,0
Samuel L. Jackson revives debate on British black actors in American roles,0,3,5,57,1,11,0,62,0
Watch Melissa McCarthy Ruin Sean Spicer's Week on 'Saturday Night Live',0,2,11,47,3,10,0,58,0
Major Garrett: Ronna Romney McDaniel top contender for RNC chair,0,2,9,45,1,9,0,54,0
"Hurricane Katrina strikes Florida, kills seven",0,1,3,37,1,5,0,40,0
"Who needs roses? Man declares his love to his girlfriend with a £1,100 bouquet made of banknotes",0,3,2,71,3,16,4,73,0
"A Terror Attack Didn't Sway France's Election, But That's No Surprise",0,3,11,44,4,10,0,55,0
"Demonetisation Was Government's Idea Not Ours, RBI Tells Parliamentary Panel",0,2,12,53,2,9,0,65,0
K.H.L. Leader Chides N.H.L. On 2014 Games,0,1,10,15,6,6,4,25,0
First fifty-star United States flag up for sale,0,1,3,36,1,7,0,39,0
Andrey Pavlov scores nightmare 17 on a single hole at Lyoness Open,0,2,4,49,0,11,2,53,0
Hartmarx Is Said to Choose London Firm Emerisque as Buyer,0,1,8,40,0,9,0,48,0
Farewell to Vera Rubin: Badass astronomer and feminist icon,0,3,4,46,1,8,0,50,0
"More in U.S. Like ‘Obamacare,’ as Ax Hovers Over It: Poll",0,2,10,31,6,10,0,41,0
Here's an Unbelievable Twitter Catfish Story to Get You Through Monday,0,3,9,50,1,10,0,59,0
The GOP’s passage of Trumpcare is one of the cruelest things the party has ever done,0,2,5,63,1,15,0,68,0
Betsy DeVos clears another hurdle in early morning Senate vote,0,3,4,49,0,9,0,53,0
Congress Loves The Syria Strike. But Senators Can't Say Why Trump Thinks It's Legal.,0,2,14,53,4,13,0,67,0
"World’s Billionaire Ranks Fell in 2016, as Did Their Combined Wealth ",0,3,8,44,2,11,4,52,0
"With WorldStarHipHop, Q Gave The People What They Wanted",0,3,12,35,1,8,0,47,0
British people are now applying for jobs in Poland The list,0,2,3,46,0,10,0,49,0
Hawaii to spend $4.9M on coqui frog eradication,0,1,2,34,2,7,2,36,0
Bitcoin Trounced the Dow This Year  ,0,2,5,24,0,7,0,29,0
Blockbuster Reports Loss and Restructures Its Debt,0,1,6,38,0,6,0,44,0
Leah Remini Says She Needs To Continue Her Mission To Expose Scientology's Dark Side,0,3,14,56,1,13,0,70,0
After ISIS: Life and Commerce in Mosul,0,3,8,23,1,6,0,31,0
New Zealand political party asks for names of schools under NZQA investigation,0,1,6,61,0,11,0,67,0
Frito-Lay Makes a New Pitch to Women,0,1,6,23,1,6,0,29,0
Beasts of Balance review: Jenga crossed with Skylanders with tablet-augmented scoring,0,3,4,69,2,10,0,73,0
Arsenal 2-1 Manchester City: FA Cup semi-final – as it happened,0,3,6,41,4,10,2,47,0
China's first big jetliner clears final hurdle before flying,0,3,1,50,1,8,0,51,0
"Trump national security adviser wants to avoid term ’radical Islamic terrorism’, sources say",0,2,2,75,3,12,0,77,0
Advertisers Boycotting Bill O'Reilly Ignored Years Of Offensive Comments,0,2,10,53,1,8,0,63,0
Barnes & Noble Lays Off 100,0,1,4,14,1,5,3,18,0
Couple jailed for holding disabled woman in their home as sex slave,0,2,1,55,0,11,0,56,0
Which executive orders did Trump sign on Day One?,0,3,4,36,1,8,0,40,0
The hyped hair that captivates — and tests? — Yankees camp,0,2,2,43,3,10,0,45,0
77 holiday packages were stolen from several homes. Now police are redelivering them.,0,3,1,68,2,12,2,69,0
Justice Dept. Denies Plan to Settle UBS Tax Case,0,1,10,29,1,8,0,39,0
‘Not My President’s Day’: Thousands Plan Anti-Trump Rallies Across U.S.,0,2,12,43,7,9,0,55,0
Paris shooting: home linked to suspect searched as Isis claims responsibility,0,3,2,64,1,10,0,66,0
"A bright new star will burst into the sky in five years, astronomers predict",0,3,1,61,1,13,0,62,0
Netflix Changes Rating System Because ‘5 Stars Feels Very Yesterday',0,3,9,47,2,9,1,56,0
Skepticism Mounts Over Paul Ryan's Obamacare Fix,0,3,7,34,1,6,0,41,0
Larry Ellison's Net Worth Drops $1.9 Billion In A Day As Oracle Misses Revenue Estimates,0,3,14,55,3,14,2,69,0
There is some truth in Donald Trump's cry of 'fake news' – it is an historical norm,0,2,3,60,4,16,0,63,0
Medical Student Is Indicted in Craigslist Killing,0,1,6,37,0,6,0,43,0
Security guards increasingly being treated poorly by employers: union,0,2,1,59,1,8,0,60,0
"Apple Speeds Up, Refines OS X With ‘El Capitan’",0,3,10,26,3,8,0,36,0
"Accused Orlando Cop Killer Markeith Loyd Makes First Court Appearance, Goes on Profane Tirade",0,3,13,66,1,13,0,79,0
The Fall Guy by James Lasdun review – shades of Hitchcock and Highsmith,0,3,7,51,1,12,0,58,0
Rambus Settles European Inquiry Over Chip Patents,0,1,7,36,0,6,0,43,0
Obama trade push runs aground as House Democrats derail key bill ,0,2,3,51,0,11,0,54,0
Week 16 NFL Power Rankings: Cowboys take away No. 1 from Pats,0,2,9,36,2,11,3,45,0
Muslim students tried to meet with a lawmaker. They were first asked: ‘Do you beat your wife?’,0,2,3,70,5,16,0,73,0
Fans launch petition to keep Neighbours on British TV after fears it could be axed,0,3,5,63,0,14,0,68,0
Bannon/Navarro 0; Auslanders 1,0,2,3,20,2,3,2,23,0
"Trump, Asked About Accusations Against Bill O’Reilly, Calls Him a ‘Good Person’ ",0,3,12,51,5,12,0,63,0
Noncitizen Sentenced to 8 Years for Illegal Voting  Insider,0,2,6,43,0,9,1,49,0
Quiznos restaurant chain airs controversial commercial,0,1,1,48,0,5,0,49,0
Philadelphia Police Investigate Viral Video Showing Cop Repeatedly Hitting Teen,0,3,10,60,0,9,0,70,0
Stem cells offer hope for autism,0,3,1,26,0,5,0,27,0
Uber orders 'urgent investigation' into sexual harassment claims,0,3,1,54,2,7,0,55,0
Trump by the Numbers: Inaugural Speech Takes Campaign to Capitol,0,2,7,47,1,9,0,54,0
New Zealand ATM gives out double the money,0,1,5,30,0,7,0,35,0
Beyonce Drops New 'Die With You' Video & Playlist on Tidal in Honor of Jay Z Wedding Anniversary,0,2,14,62,3,17,0,76,0
The Voice-Activated iLane Sorts Mail as You Drive,0,1,8,33,1,7,0,41,0
"Conflicting reports, mounting fear, over Japanese nuclear disaster",0,1,2,55,2,7,0,57,0
Record $13 Billion Pulled From Biggest Public U.S. Hedge Fund Och-Ziff ,0,3,12,42,4,11,2,54,0
"Coachella Day 2 Midday Report: Banks & Steelz Bring Rap-Rock, Sarah Barthel Joins Local Natives",0,2,14,62,4,14,1,76,0
Police describe bloody evidence in NY Sen. Monserrate assault trial,0,1,5,52,1,9,0,57,0
Sheffield pub is CAMRA's Pub of the Year,0,1,8,24,1,7,0,32,0
Bringing Order to the Chaos of Notes,0,1,4,26,0,6,0,30,0
Princes William and Harry host the Concert for Diana,0,1,5,39,0,8,0,44,0
Soft toy tiger nurses orphaned cubs back to health,0,2,1,41,0,8,0,42,0
Review: Loving's Joel Edgerton and Ruth Negga speak volumes with few words,0,2,6,55,2,11,0,61,0
Your Smartphone Is Changing the Human Race in Surprising Ways,0,3,8,44,0,9,0,52,0
Ancestral Climates May Have Shaped Your Nose ,0,3,7,31,0,7,0,38,0
Girls soccer team booted from tourney because player ‘looks like a boy’,0,2,1,57,2,11,0,58,0
Why The Pay Gap Widens As Women Get Older,0,3,9,24,0,8,0,33,0
Republican Gianforte Wins Montana House Race Despite Assault Charge,0,2,9,50,0,8,0,59,0
British actress Emily Perry dies at 100,0,1,3,27,0,6,3,30,0
"A More Upbeat, if Vulnerable, Serena Williams Wins Wimbledon Opener",0,1,9,47,2,9,0,56,0
"Past Eurovision contestants give advice to this year's performers, speculate on who will win",0,1,2,75,2,13,0,77,0
"DHS secretary on homegrown terror: “I don't know how to stop that""",0,2,4,47,4,11,0,51,0
Trump in office: What are presidential executive orders?,0,3,2,45,2,7,0,47,0
"Without Gas, Bulgarians Turn Icy to Old Ally",0,1,7,29,1,7,0,36,0
Mike Rodgers and Carmelita Jeter Win U.S. Titles in 100,0,1,8,33,2,9,3,41,0
MH370: Families express dismay as search ends after three years with mystery unsolved,0,3,3,66,1,12,3,69,0
Tour de France: Daniele Bennati wins stage 17,0,1,4,31,1,7,2,35,0
Trial Opens in Germany for 4 Suspected of Plotting Bombings,0,1,6,43,0,9,1,49,0
Dr. Price’s marvelous medicine for your stock portfolio,0,3,2,44,2,7,0,46,0
"Józef Rotblat, 1995 Nobel Peace Prize winner, dies",0,1,5,32,2,7,4,37,0
Two US Navy vessels collide in the Strait of Hormuz; 15 lightly injured,0,1,6,50,1,12,2,56,0
Katie Holmes Shares The 'Heartbreaking' Part Of Watching Suri Grow Up,0,3,11,46,2,10,0,57,0
Trump's America Donald Trump's impact on the world after 100 days is yet to become clear,0,2,4,64,2,15,3,68,0
Marc Stein's picks for NBA All-Star reserves,0,3,7,29,2,6,0,36,0
"From One Genome, Many Types of Cells. But How?",0,1,8,27,3,8,0,35,0
Why Charles Schumer meeting Vladimir Putin doesn’t give Trump & Co. a pass,0,3,7,52,3,12,0,59,0
"Sarah Palin’s treatment at Fox News: Ailes called her ’hot’, Wallace hoped she would sit in his lap",0,2,6,71,5,17,0,77,0
Erin Moran's Neighbors Say She Was 'Full of Energy' Before She Died in Her Mother-in-Law's Trailer,0,3,15,62,6,15,0,77,0
"Patient in Buckinghamshire hospital was treated in toilet, inquiry hears",0,1,2,60,1,9,0,62,0
Wedding dress made from Taco Bell burrito wrappers is anything but mild,0,3,3,57,0,11,0,60,0
The ‘Game of Thrones’ live concert is bonkers,0,2,3,33,2,7,0,36,0
These six foods could send you to the ER,0,2,3,29,0,8,0,32,0
"The week in finance: US banks jump on deregulation, China tightens and RBA to hold",0,2,7,59,2,14,0,66,0
White House press room evacuated during briefing,0,2,2,40,0,6,0,42,0
FreedomWorks Opposes Speaker Ryan’s Obamacare 2.0 Plan,0,3,7,37,2,6,2,44,0
Oscars 2017: Celebrities react to 'Moonlight' actually winning best picture after mix-up ,0,3,3,66,4,12,4,69,0
Chinese transgender man wins landmark wrongful dismissal case,0,3,1,53,0,7,0,54,0
"Spike TV is getting a huge rebrand, but what happens to its programming?",0,3,3,55,2,12,0,58,0
Students Send Hilarious Tweets To Superintendent Thanking Him For Snow Day,0,3,11,53,0,10,0,64,0
New 'Mighty Mouse' from Apple debuts,0,1,4,25,2,5,0,29,0
"Facing Conservatives, Israel’s Leader Takes Harder Stance on Settlements ",0,3,8,54,2,9,0,62,0
Fyre Festival organisers promise refunds and 2018 VIP passes,0,3,5,43,0,8,4,48,0
Bush nominates John G. Roberts for U.S. Supreme Court,0,1,8,34,3,8,0,42,0
"Invoking the Sputnik Era, Obama Vows Record Outlays for Research",0,1,8,46,1,9,0,54,0
"President Trump’s Immigration Order, Annotated ",0,3,5,35,2,5,0,40,0
Republicans hang on for Donald Trump's wild ride,0,3,3,37,1,7,0,40,0
Divers search for victims of Russian plane crash,0,2,2,39,0,7,0,41,0
British court 'threatened' by United States,0,1,3,33,2,5,0,36,0
Maluma Announced as First 2017 Billboard Latin Music Conference Panelist,0,3,8,51,0,9,4,59,0
Two more arrested in Michigan in first FGM prosecution in US,0,2,7,43,0,10,0,50,0
A Walk Through a Crop of Electronic Readers,0,1,6,30,0,7,0,36,0
Magic Johnson's Old Tweets Gain New Life After Lakers Name Him Executive,0,3,12,48,1,11,0,60,0
"Sentence for ex-teacher who was impregnated by student, 13",0,3,1,45,2,8,2,46,0
Italy president pledges to solve government crisis fast,0,2,1,47,0,7,0,48,0
NFL Players Tackle People's Mean Tweets,0,3,8,25,1,5,0,33,0
Four Croydon tram drivers admit falling asleep at controls,0,3,2,48,0,8,0,50,0
Trump Says Putin ‘Smart’ for Not Retaliating Against U.S. Sanctions,0,3,10,44,4,9,0,54,0
"Driver who shot at Arizona officer was in US illegally, investigators say ",0,3,4,57,1,12,0,61,0
Ex-MTV Officer to Lead an Oprah  Network,0,1,8,24,1,7,0,32,0
U.S. Holds Recent Advantage in Meetings With Mexico,0,1,8,34,2,7,0,42,0
A mugwump? Boris Johnson’s use of insult against opposition leader leaves Britain perplexed,0,3,4,73,2,12,0,77,0
"TJ Leaf Ascends, Finishes Lonzo Ball Alley-Oop with 1-Handed Slam",0,3,11,41,3,9,1,52,0
British actor and comedian Sir Norman Wisdom dies aged 95,0,1,4,42,0,9,2,46,0
Venezuela: Maduro Claims Opposition Is ’Murdering Their Own Protesters’ - Breitbart,0,2,10,59,4,10,0,69,0
"Airlines, Now More Proactive on Weather, Allow Fliers to Shift Own Travel Plans ",0,3,11,54,2,13,0,65,0
"‘Please press 1′ to leave a message about Donald Trump, says House Oversight voice mail",0,3,5,64,3,14,1,69,0
Let the Red Carpet Knockoff War Begin,0,3,6,25,0,6,0,31,0
"Accident in Jacksonville, Florida, releases low-radioactive gas",0,1,3,51,3,6,0,54,0
Only A Handful Of Lawmakers Bother To Question Trump's Strike On Syria,0,2,12,46,1,11,0,58,0
"In Donald McGahn, Donald Trump Gets a Combative White House Counsel ",0,3,11,45,1,11,0,56,0
Malcolm Turnbull dismisses climate change policy review criticisms from colleagues,0,3,2,71,0,9,0,73,0
Venezuelan president Nicolas Maduro delays withdrawing 100 bolivar note amid protests,0,3,3,69,0,10,3,72,0
Martin Garrix and Dua Lipa Drop New 'Scared to Be Lonely' Video: Watch,0,3,11,44,3,12,0,55,0
"Canny and confrontational, Miley Cyrus is this generation’s Madonna",0,2,4,53,2,8,0,57,0
Turkish president Tayyip Erdogan claims to have concrete documentary proof that the West is backing ISIS,0,3,8,81,0,15,0,89,0
13-year-old girl forced to marry her 'rapist' step-brother,0,3,0,44,5,7,2,44,0
"SpaceX successfully launches Falcon 9 rocket, months after launch-pad blast",0,3,3,60,2,9,1,63,0
Justise Winslow Injury: Heat Wing Undergoes Shoulder Surgery on Torn Labrum,0,2,10,54,1,10,0,64,0
Resignation and reshuffle: Unpicking Malcolm Turnbull's summer of discontent,0,3,4,62,2,8,0,66,0
Euro 2008 Qualification: Finland defeats Kazakhstan 2-1 in Euro 2008 qualifier,0,1,5,51,2,10,10,56,0
Annual rich list shows Ireland now has six billionaires,0,1,2,45,0,8,0,47,0
"Russia recognizes passports from Ukrainian separatists, stoking annexation fears ",0,3,2,69,1,9,0,71,0
At Least 4 Dead as Tornadoes Batter the Southeast ,0,2,6,34,0,9,1,40,0
Utah couple's life transformed by quadruplets,0,2,1,38,1,5,0,39,0
Irish Whiskey Gains Popularity and New Cachet ,0,2,6,33,0,7,0,39,0
Euro Jumps as Investors Cheer French Election Results,0,3,7,39,0,7,0,46,0
Twitter Is Convinced That Troy Aikman Looks Like Jay Z,0,3,10,35,0,9,0,45,0
"Four Killed, Including Three Soldiers, As Terrorists Attack Army Convoy In Jammu And Kashmir's Chitragam",0,3,15,72,3,14,0,87,0
Hundreds of Thousands Protest in France,0,1,4,30,0,5,0,34,0
"1 in 10 pregnant women with Zika had a fetus or infant with birth defects, CDC says ",0,3,4,59,1,17,3,63,0
"Georges St-Pierre to face Michael Bisping; date, venue still TBD",0,2,8,44,3,9,0,52,0
"China’s Stocks, Bonds, Yuan Slump in Unison on Liquidity Concern",0,2,8,44,3,9,0,52,0
Russell Westbrook Partners with NBA to Make High-End Frames for Teams,0,2,11,47,1,10,0,58,0
Spoon's Three-Night SXSW Residency Ends on a High Note,0,3,11,33,2,8,0,44,0
Hugh Jackman has another skin cancer removed from nose,0,3,2,44,0,8,0,46,0
Tour de France: Alexander Vinokourov fails blood test,0,1,4,41,1,7,0,45,0
Ex-Giant opens up on drug addiction: ‘125 Vicodin a day’,0,2,3,37,4,9,3,40,0
People at NYFW Thought This Man Was Sisqó,0,3,10,24,0,7,0,34,0
New York prison employee arraigned for allegedly helping killers escape,0,3,2,60,0,9,0,62,0
Israel rejects U.S. call for freeze on West Bank settlements,0,1,5,44,2,9,0,49,0
"The case for a bright American future, according to billionaire Warren Buffett",0,2,4,62,1,11,0,66,0
"On This Day, Players Rule the L.P.G.A.",0,1,9,18,5,6,0,27,0
Michigan State suspends coach linked to sex abuse complaints,0,3,2,50,0,8,0,52,0
"Louis C.K.: Trump is 'a gross, crook, dirty, rotten, lying sack of s---'",0,3,4,44,12,12,0,48,0
Montreal Canadiens Defenseman P.K. Subban Joins Kids in Street Hockey Game,0,2,11,51,2,10,0,62,0
"Enormous purple sea blobs invading East Bay beaches, waterways",0,2,3,50,1,8,0,53,0
Prepare for Erika Jayne's 'Xxpensive' Video With Exclusive Behind-the-Scenes Footage,0,3,10,60,5,9,0,70,0
GM posts first annual loss since 1992,0,1,2,25,0,6,4,27,0
Why More Than a Million Taxpayers Are Reaching for Refund Loans ,0,3,9,44,0,11,0,53,0
NFL playoff picture: Cowboys are first team to clinch,0,3,4,40,1,8,0,44,0
William Morris and Endeavor Explore a Merger,0,1,5,33,0,6,0,38,0
Prosecutors claim conspiracy by Oregon militants in standoff,0,2,2,51,0,7,0,53,0
"Billy Mays Is Gone, but His Infomercials Go On",0,1,8,29,1,8,0,37,0
"Pledge aside, dead billionaires don't have to give away half their fortunes",0,3,1,61,2,11,0,62,0
The Times Company Suspends Its Dividend,0,1,6,28,0,5,0,34,0
New Zealand runs low on 20 cent coins,0,1,2,26,0,7,2,28,0
California class commemorates Holocaust,0,1,2,34,0,3,0,36,0
"Trump’s Company Has No Plans to Invest in Taiwan, Aides Say     ",0,3,9,38,2,15,0,47,0
Saudi Arabia Plans Payouts to Offset Subsidy Cuts in 2017,0,3,7,37,0,9,4,44,0
"Biggest Threat to Mexico’s Economic Well-Being Isn’t Trump, Say Some of the Country’s Economists",0,3,12,66,5,13,0,78,0
The Yordano Ventura you never knew,0,2,3,26,0,5,0,29,0
LOOK: Gator Struts Across Golf Course With Huge Fish in Mouth  Insider,0,3,14,43,1,12,0,57,0
"9 Dead, 20 Missing After Fire Engulfs Oakland Rave",0,3,7,31,1,8,3,38,0
'It could be disastrous': Labour MPs nervous as poll countdown starts,0,3,4,52,3,10,0,56,0
Gowanus Canal in Brooklyn May Get Superfund Status,0,1,7,36,0,7,0,43,0
Labor demands Malcolm Turnbull explain negative gearing comments,0,3,3,54,0,7,0,57,0
"How To Train A Machine Brain, Pentaho's 4 Pillars Of AI",0,2,11,31,2,10,1,42,0
U.S. military denies reports helicopter opened fire on Libyan civilians during rescue mission,0,1,3,76,2,12,0,79,0
Quick-thinking pedestrians extinguish a lorry fire by throwing SNOWBALLS at it,0,3,10,57,1,10,0,67,0
China Exceeded U.N. Cap on North Korean Coal Imports in December,0,2,10,42,2,10,0,52,0
7th grader is fighting cancer with green tea,0,2,0,36,0,7,1,36,0
Iraqi Officials Concerned That Absence of Shiite Pilgrims Could Affect Elections,0,1,10,60,0,10,0,70,0
"Automaker GM to cut 10,000 jobs at Opel",0,1,4,22,1,7,5,26,0
Foreign Investors Spurn China’s Markets ,0,2,5,29,1,5,0,34,0
"While Nobody's Watching, Paul Ryan Is Taking A Sledgehammer To Medicaid's Promise To Seniors",0,2,14,62,3,13,0,76,0
"Gold mine in Tanzania collapses, at least 20 dead",0,1,2,36,1,8,2,38,0
"Carolina Panthers Cam Newton Benched for 1st Play vs. Seahawks, Derek Anderson Given Start",0,3,11,63,2,13,1,74,0
This Woman Chose To Have An Abortion So She Wouldn’t Have To Carry Her Deceased Daughter,0,3,16,56,1,15,0,72,0
Rick Ross Recruits Gucci Mane for 'She On My D--k',0,3,9,28,4,9,0,37,0
U.S. Republican Party television ad bashes Canada,0,1,5,36,2,6,0,41,0
9/11 conspirator Moussaoui ejected from court,0,1,1,35,1,5,3,36,0
"Camila Cabello Teams Up With J Balvin & Pitbull, Teases Collab on Social Media",0,2,12,51,2,13,0,63,0
Sony and Toshiba Shares Fall Sharply,0,1,5,26,0,5,0,31,0
Son Is Said to Rise in North Korea,0,1,6,21,0,7,0,27,0
Jason Pierre-Paul Reportedly Franchise-Tagged by Giants,0,2,7,41,2,5,0,48,0
"As Confrontation Deepens, Iran's Path Is Unclear",0,1,7,33,2,6,0,40,0
"‘The end of humanity:’ Syrian government carried out mass hangings at military prison, report claims ",0,3,2,80,4,15,0,82,0
"NRMA stands by ""unsafe"" smash repair system",0,1,4,31,2,6,0,35,0
Man cleared of Belfast bomb attempt on retrial after eleven years,0,1,2,53,0,10,0,55,0
Butlins it ain't! Bored with Brexit? Feast your eyes (and weep with envy) at the world's priciest holiday villas ,0,3,4,84,6,19,0,88,0
Cardinals Star Adam Wainwright Throws Awful Wild Pitch vs. Cubs,0,3,9,44,1,9,0,53,0
Kellyanne Conway Seems to Evade Wiretapping Questions,0,3,6,41,0,6,0,47,0
This real-life giant walking robot is like something out of a sci-fi movie,0,3,1,59,2,12,0,60,0
Gov. Paul LePage on Trump: ’We got to tell him that the TV show’s over and he’s gotta move on now’,0,2,8,64,6,20,0,72,0
Resignation of JetBlue flight attendant Steven Slater announced,0,1,5,51,0,7,0,56,0
Robin Hood Event Adjusts to Tough Times,0,1,6,27,0,6,0,33,0
13 Indian Army Quotes That Will Inspire You No End,0,3,9,30,0,9,2,39,0
Landmarks Turn Blue For World Autism Awareness Day,0,3,8,35,0,7,0,43,0
Donald Trump yet to make a nomination to 94 per cent of federal roles,0,2,2,52,0,13,2,54,0
Trump Vs. Retailers: A Timeline Of Corporate Reactions To Consumer Boycotts,0,3,11,52,2,10,0,63,0
These Are All the Ways a Saudi Aramco IPO Could Impact Markets,0,2,12,39,0,11,0,51,0
Trump fires top aide in an urgent move to reboot his floundering campaign,0,2,1,60,0,12,0,61,0
Mars Rover Doing Well After Memory Glitch,0,1,7,28,0,6,0,35,0
President of Costa Rica contracts H1N1 swine flu,0,1,5,34,0,7,2,39,0
ISIS boss al-Baghdadi reportedly escaped capture by minutes ,0,3,5,46,1,8,0,51,0
Here's why everyone should be paying attention to China's ambitious space program,0,3,2,66,2,11,0,68,0
"Trump blasts ""disgraceful decision"" by appeals court over travel ban",0,3,1,56,2,9,0,57,0
English Wikipedia publishes 3 millionth article,0,1,2,39,0,5,1,41,0
Barking mad! Besotted dog owners capture their pets’ bizarre antics in hilarious Snapchat posts ,0,3,3,77,2,14,0,80,0
"Joey Badass Strives For Glory On New Song ""Victory""",0,3,9,32,2,8,0,41,0
A second climate-change skeptic is leaving the EPA and will return to Heritage,0,2,5,60,1,12,0,65,0
"Couples thrashed for sitting in a park in Meerut, India",0,1,3,42,1,9,0,45,0
Police arrest at least 20 as protesters clash at pro-Trump rally in Berkeley ,0,2,3,58,1,13,2,61,0
The unbelievable numbers behind Russell Westbrook's historic season,0,2,3,56,1,7,0,59,0
3 Lawmakers Will Return Money Tied to Lobbyist,0,1,6,32,0,7,1,38,0
This Vintage Children’s Book Leaves Nothing To The Imagination,0,3,9,44,1,8,0,53,0
Sasha Obama slays as she raps along with Chance the Rapper,0,3,4,44,0,10,0,48,0
Calibre 50 Renews Contract With Universal Music Latin Entertainment's Disa: Exclusive,0,3,10,61,2,10,2,71,0
L.P.G.A. Will Seek Out New Leader to Chart Its Future,0,1,12,28,4,9,0,40,0
Amazon shares data with Arkansas prosecutor in murder case ,0,3,2,48,0,9,0,50,0
Cops Hunt Accused Gun Thief Who Sent Anti-Government Manifesto To Trump,0,2,12,48,1,10,0,60,0
"The entire British public, not just the Brexiteers, deserve a vote on the terms of Brexit",0,3,4,68,2,15,0,72,0
"Trump blames Democrats for confirmation delays, but red tape is real culprit ",0,2,2,62,1,12,0,64,0
4 English Clubs Advance to Champions League Quarterfinals,0,1,6,43,0,7,1,49,0
Australians warned to evacuate ahead of cyclone Debbie,0,3,2,45,0,7,0,47,0
Nineteenth Maccabiah Games open in Jerusalem,0,1,4,35,0,5,0,39,0
New York Times Is Devoting $5 Million More Into Covering Donald Trump,0,2,11,45,1,11,1,56,0
"Cyclone Debbie hits north Queensland coast bringing winds of 260kph, BOM says",0,3,6,56,1,11,3,62,0
Emma Thompson says President Donald Trump once asked her out,0,3,5,46,0,9,0,51,0
Nicola Sturgeon is 'tempted' to stand SNP candidates in England,0,3,6,46,2,9,0,52,0
"Did President Trump save 77,000 coal mining jobs?",0,3,3,32,2,7,5,35,0
Art market shrugs off forgery case but finders of fakes still flourish,0,2,1,58,0,11,0,59,0
Helicopter crash kills sixteen at NATO base in Afghanistan,0,1,6,44,0,8,0,50,0
Pakistani military launches ground offensive against Taliban and al-Qaeda,0,1,3,61,1,8,0,64,0
Welcome to New Money,0,2,3,14,0,3,0,17,0
Jon Stewart SHREDS The New York Times Over Marco Rubio Coverage,0,2,16,37,0,10,0,53,0
"Germanwings co-pilot Andreas Lubitz feared going blind, visited many doctors",0,2,3,62,2,9,0,65,0
How Nepal quake turned women into builders,0,3,2,34,0,6,0,36,0
We managed tax transparency in Pakistan. Why not everywhere else?,0,2,3,51,2,9,0,54,0
First of Two Baby Bald Eagles Hatches on Camera,0,3,7,32,0,8,0,39,0
Kanchi Shankaracharya Jayendra Saraswathi in custody,0,1,4,43,0,5,0,47,0
Times Co. Raises $225 Million in Building Deal,0,1,6,28,2,7,3,34,0
"In Indonesia, Islamists Lost Political Ground",0,1,6,33,1,5,0,39,0
China Releases Human Rights Plan,0,1,5,23,0,4,0,28,0
How the Republican Health Plan Could Affect You ,0,3,7,33,0,8,0,40,0
"Immigration Agents Won't Stop Making Arrests In Courts, Trump Officials Tell Judge",0,3,12,57,2,11,0,69,0
"Basketball: Greece beats the United States, 101-95 on semi-final",0,1,4,43,4,8,5,47,0
We're better together! Hilarious and heart-warming displays of teamwork captured from around the world,0,3,2,84,3,13,0,86,0
"Actor John Fiedler, voice of Piglet and ""Bob Newhart"" regular, dead at 80",0,1,6,49,4,12,2,55,0
Rihanna shined bright like a diamond in her one of kind Coachella outfit,0,2,2,58,0,12,0,60,0
Gravitational waves: breakthrough discovery after a century of expectation,0,2,1,64,1,8,0,65,0
The 25 highest-paid NBA players of all time,0,3,4,29,1,7,2,33,0
Bernie Ecclestone attacked outside London headquarters; no arrests made,0,1,3,59,1,8,0,62,0
Sun Unveils Java 6.0,0,1,3,11,1,3,2,14,0
Sandra Fluke nominated by Time magazine for Person of the Year,0,1,5,47,0,10,0,52,0
Happy Days star Scott Baio defends himself after backlash over Erin Moran: 'You bash me because I support Trump',0,3,9,82,3,18,0,91,0
NHS commissioners risk losing sight of human cost of their decisions,0,3,3,55,0,10,0,58,0
"How Lionel Messi showed he is the most complete player ever: the guts, the glory, the goals",0,2,3,69,3,16,0,72,0
"The Walking Dead season 7: All 8 episodes, ranked",0,2,4,33,2,8,2,37,0
Brazil threatens to break patent on AIDS drugs,0,1,5,34,0,7,0,39,0
Aqib Talib Reportedly Won't Face NFL Punishment for 2016 Shooting Incident,0,2,11,48,1,10,4,59,0
U.K. Manufacturing PMI Rises to Two-and-a-Half Year High ,0,3,11,33,5,8,0,44,0
It's Time To Manage Expectations A Bit With 'Horizon Zero Dawn',0,2,11,39,3,10,0,50,0
"LeBron James Gets Blocked by Andrew Bogut, Draymond Green on Back-to-Back Shots",0,2,12,53,3,11,0,65,0
Nivea Pulls ‘White Is Purity’ Ad After Online Uproar ,0,3,9,33,2,9,0,42,0
O'Reilly: Dems' Blind Opposition to Trump Is 'Harmful to America'  Insider,0,3,10,48,5,11,0,58,0
The Very British Problems author and the dodgy haircut that led to Twitter fame,0,3,5,61,0,13,0,66,0
Japan weathers Typhoon Nabi,0,1,3,21,0,3,0,24,0
Rio Tinto agrees to sell Australian coal unit to China's Yancoal for $3.2b,0,3,5,52,3,12,2,57,0
"As Passengers Run Out Of Cash, Banks Ask Autowalas To Use Card Swipe Machines",0,3,14,49,1,13,0,63,0
Queensland Premier aims for a move to Australian federal politics,0,1,3,53,0,9,0,56,0
Clarendon Ballroom gets harassing calls after declining to host Trump backers’ ‘DeploraBall’,0,3,5,73,3,11,0,78,0
"Israel approves 3,000 new settler homes as Amona evacuation begins",0,3,2,50,1,9,4,52,0
"After Promising Not To Talk Business With Father, Eric Trump Says He'll Give Him Financial Reports",0,3,16,65,2,15,0,81,0
Turkey referendum: Campaign on Erdogan powers 'unequal',0,3,3,43,3,6,0,46,0
Free Airline Meals In Coach May Be Coming Back,0,2,9,29,0,8,0,38,0
"Florida Airport Assailant May Have Heard Voices Urging Violence, Officials Say ",0,3,11,56,1,11,0,67,0
"Schumer: GOP Lawmakers Have 'Real Problems' With Trump, Will 'Break' Away  Insider",0,3,14,50,6,12,0,64,0
Sushma Swaraj Guarantees Help To A Woman Who Suffered A Heart Problem On Flight,0,3,14,52,0,13,0,66,0
State department issues presidential permit for Keystone pipeline ,0,3,2,56,0,8,0,58,0
Twitter blocks government ’spy centers’ from accessing user data,0,2,1,53,2,8,0,54,0
New cookie dough shop opens in NYC to be your best friend,0,3,4,42,0,11,0,46,0
Derrick Rose's Agent Says PG Wants to Stay with Knicks,0,3,9,35,1,9,0,44,0
Manchester City agree big money for Shaun Wright-Phillips to move to Chelsea FC,0,1,8,58,1,12,0,66,0
Myanmar dissident Suu Kyi to run for parliament in by-elections,0,1,3,50,1,9,0,53,0
"They’re Filming The ""Love Actually"" Reunion Already And The Turtlenecks Are Back",0,3,12,54,3,11,0,66,0
"Device to Trace State Vehicle Was Disabled, Official Says",0,1,8,40,1,8,0,48,0
Kim Jong-nam: More arrests over airport poisoning,0,3,3,38,2,6,0,41,0
Thousands attend anti-war protests in London and Glasgow,0,1,3,45,1,7,0,48,0
Danilo Gallinari Hits off-the-Opposing-Backboard Shot,0,3,6,40,3,4,0,46,0
Huge gold coin worth $1m stolen from museum,0,3,1,33,1,7,1,34,0
Obama to Tell Congress How Agenda Will Aid Economy,0,1,8,34,0,8,0,42,0
"President Bush of the United States authorized NSA surveillance of citizens, bypassing court warrants",0,1,7,80,1,13,0,87,0
'Girlfriend's Day' is the bleak Netflix comedy you need today,0,3,3,46,3,9,0,49,0
The Obamas got real emotional at the president's farewell address,0,3,2,53,1,9,0,55,0
Exxon Mobil Shareholders Reject Proposals,0,1,5,32,0,4,0,37,0
IKEA’s ‘Open Source’ Sofa Invites Customization ,0,2,9,30,3,6,0,39,0
'The future is female': Watch Hillary Clinton's first video statement since Trump's inauguration,0,3,5,74,5,12,0,79,0
Speaker At Group Supported By Betsy DeVos Says Hitler Was Good At Reaching Children,0,3,15,55,0,13,0,70,0
Abuse of baby 'could have been identified earlier by medical staff',0,3,1,54,2,10,0,55,0
Ed Sheeran to make guest appearance in Game of Thrones,0,2,4,41,0,9,0,45,0
"2008 SecuTech Expo starts in Taipei, Taiwan for grasping global security industry",0,1,5,60,1,11,4,65,0
Red Sox Minor League Club Plans to Make Tim Tebow Focus of Strikeout Giveaway,0,3,12,52,0,13,0,64,0
Possible MH370 debris found by relative of disappeared passenger,0,3,3,50,0,8,3,53,0
"Plane Passengers Only Want Thin Flight Attendants, Airline Council Members Claim",0,3,11,58,1,10,0,69,0
Isiah Thomas Takes Coaching Job at Florida International University,0,1,8,51,0,8,0,59,0
EY CybersecurityVoice: Why Cybersecurity Should Be A No. 1 Business Priority For 2017,0,3,13,53,2,12,5,66,0
"Mayor under investigation in San Jose, CA, USA for spending without consent",0,1,8,54,2,11,0,62,0
Starbucks’ Howard Schultz hands the keys to his successor in an emotional investor meeting,0,3,3,73,1,13,0,76,0
Graner found guilty of mistreatment at Abu Ghraib,0,1,3,39,0,7,0,42,0
Gorsuch: Oregon Sen. Jeff Merkley Leads Bid to Block SCOTUS Pick,0,2,15,37,2,10,0,52,0
House Republicans Vote To Keep Trump's Tax Returns Secret For The Third Time,0,3,13,50,1,12,0,63,0
"With WorldStarHipHop, Q Gave The People What They Wanted",0,2,12,35,1,8,0,47,0
South Africa's Pravin Gordhan Says He Is ‘Not Indispensable’,0,3,9,40,3,8,0,49,0
Bloomberg Daybreak,0,2,2,15,0,1,0,17,0
Portuguese writer José Saramago dies at 87,0,1,3,31,0,6,2,34,0
Russian journalist beaten by police officer dies,0,1,1,41,0,6,0,42,0
'Madam President' Newsweek Copies for Sale Online — But Buyer Beware,0,3,9,46,3,10,0,55,0
‘Merry Christmas Everybody’: Obamas Share Final Holiday Address,0,2,8,45,3,7,0,53,0
A Rising Black Leader Who Pulled Off His Own Fake Obituary ,0,2,11,37,0,11,0,48,0
British military secrets leaked on social networking sites,0,1,1,50,0,7,0,51,0
Amnesty International tells Iran to free imprisoned journalists,0,1,3,53,0,7,0,56,0
Norwegian Hockey Playoff Game Goes into Record 8 Overtimes,0,3,7,42,0,8,1,49,0
Former President Bush moved to intensive care as wife Barbara also hospitalized ,0,3,4,64,0,12,0,68,0
’Profoundly sad day’: Top members of Never Trump movement react to Cruz’s endorsement of Trump,0,2,6,70,4,14,0,76,0
U.K. Treasury Chief: Economic Model Could Change in Absence of EU Trade Deal,0,3,13,48,3,12,0,61,0
Suspect in Ponzi Scheme Surrenders on Long Island,0,1,6,36,0,7,0,42,0
Nasa test of radical 'flying saucer' that could help people land on Mars in 2035 ends in disaster,0,3,2,72,2,17,4,74,0
US election recount: Greens change tactics in Pennsylvania bid,0,2,4,49,1,8,0,53,0
NASA Just Shared An Amazing Video That Shows Landing On 'Pluto' And It's Very Captivating!,0,3,18,54,4,14,0,72,0
What Conservatives Can Learn from Gary Johnson,0,2,6,34,0,6,0,40,0
'Growing Pains' star Alan Thicke dies at 69,0,3,4,28,2,7,2,32,0
Ex-head of Qantas freight operations in US jailed for price fixing,0,1,4,51,1,10,0,55,0
Morgan StanleyVoice: The Demanding World Of Sustainable Investing [Infographic],0,3,10,58,3,8,0,68,0
"Deutsche Bank to investors: No, really, we’re fine",0,2,3,36,4,7,0,39,0
Hollywood-like car hijacking in Belgrade,0,1,2,33,1,4,0,35,0
Joy Villa makes political statement with Donald Trump dress at the Grammys,0,2,5,58,0,11,0,63,0
Celine Dion Remembers Late Husband Nearly a Year After His Death ,0,3,10,44,0,11,0,54,0
Sweden’s ‘feminist’ government criticized for wearing headscarves in Iran,0,3,2,60,3,8,0,62,0
"Airbnb Leads By Example, Offers Free Houses To Refugees Affected By Trump's Muslim Ban",0,3,14,57,2,13,0,71,0
Kenya herdsmen clash with police in land conflict,0,3,1,41,0,7,0,42,0
The Most Momentous Event of 2016 Happened In Between Brexit and Trump,0,3,9,45,0,11,4,54,0
Radio Giant Is Planning to Revamp Its Debt Load,0,1,8,31,0,8,0,39,0
SEC Investigates Possible Insider Trading in Fortress-SoftBank Deal ,0,3,11,48,1,8,0,59,0
Plunging Cocoa Prices Mean You Can Splurge on Christmas Chocolate,0,3,9,47,0,9,0,56,0
"I Planned My Wedding in 5 Days. You Could, Too. - The New York Times",0,2,12,37,4,14,1,49,0
Eric Gill: can we separate the artist from the abuser?,0,2,2,41,2,9,0,43,0
Here's How Snap Compares To Facebook And Twitter On Its First Day As A Public Company,0,3,16,53,1,15,0,69,0
Tsvangirai released by Zimbabwean police,0,1,2,34,0,4,0,36,0
Here's Why Ann Coulter Gives Trump an 'A+' for His First Month in Office  Insider,0,3,12,50,4,15,0,62,0
Malaysia: Premier Announces Resignation,0,1,4,31,1,3,0,35,0
Mexico warns citizens in US after woman deported,0,3,3,38,0,7,0,41,0
Labor Sees Green in Solar Plants in California,0,1,6,33,0,7,0,39,0
Delta Plans More Cuts on International Routes,0,1,6,33,0,6,0,39,0
Internet Sales Tax Clash Turned Away by U.S. Supreme Court,0,3,10,37,2,9,0,47,0
BBC Resists Effort to Share Its License Fee,0,1,9,27,0,7,0,36,0
"Feeling Secure, Some Banks Want to Be Left Alone",0,1,8,31,1,8,0,39,0
US troops in Iraq operating closer to front lines ,0,3,3,38,0,9,0,41,0
How Ukip's collapse will help the Tories capture 45 Labour seats,0,3,4,47,1,10,2,51,0
Quirky Homes Show Their True Colors,0,2,6,24,0,5,0,30,0
Which NBA Rookies Will Break out as Sophomores?,0,3,8,31,1,7,0,39,0
Shimla Is Covered In A Thick Blanket Of Snow And We Want Nothing More Than To Be There!,0,3,18,51,1,17,0,69,0
Copycake: When Food Art Ideas Get Swiped,0,2,7,26,1,6,0,33,0
Record sales of gin as Britain knocks back over 1 billion g&t's,0,3,2,47,2,11,1,49,0
A psychologist reveals the key to great ideas and having lots of them,0,3,1,56,0,12,0,57,0
Trump plans to cut funding for most government agencies,0,3,1,46,0,8,0,47,0
Turkish election board rejects calls to annul referendum result,0,2,1,54,0,8,0,55,0
BT fined £42m over delays to high-speed cable installation,0,3,2,44,2,8,2,46,0
Defence Force chief promotes gender diversity as crucial to Australia's military capability,0,3,3,76,1,11,0,79,0
Florida suffers from summerlike conditions ahead of cold front,0,1,1,53,0,8,0,54,0
"Republican Party, WikiLeaks, International Women’s Day: Your Wednesday Briefing ",0,3,10,57,4,9,0,67,0
Venezuelan economy shrank by 5.8% in fourth quarter of 2009,0,1,1,41,2,9,6,42,0
ITMS Canada launched,0,1,5,13,0,2,0,18,0
US Supreme Court relaxes strict interpretation of self incrimination ruling,0,1,4,62,0,9,0,66,0
Gates Promises to Reduce Afghan Civilian Deaths,0,1,6,35,0,6,0,41,0
"Authorities: Florida Girl, 5, Killed in Accidental Shooting ",0,3,6,42,3,8,1,48,0
Record rainfall closes Australia's Uluru national park,0,2,3,44,1,6,0,47,0
"To promote film, 20th Century Fox created fake news sites with fake anti-Trump stories",0,3,4,65,2,13,2,69,0
Fernando Llorente and Tom Carroll seal Swansea’s vital win over Stoke,0,3,6,52,1,10,0,58,0
Trump’s EPA Cuts To Lead Paint Programs Are Going To Hit Black People The Hardest,0,3,17,49,1,14,0,66,0
"Trump claims media is covering up terror attacks, citing no evidence",0,3,1,56,1,10,0,57,0
President Trump plays 18 holes with pro golfer Rory McIlroy,0,3,5,43,0,9,2,48,0
TV Land Tries to Spice Things Up With Reality Show,0,1,10,31,0,9,0,41,0
Deputy helps girl build snowman while mom with cancer recuperates - Yahoo,0,2,2,59,1,11,0,61,0
Penn State Ex-Officials Plead Guilty in Sandusky Case ,0,3,8,37,1,8,0,45,0
"Retail sales tick higher, ANZ job ads dip",0,3,4,29,1,7,0,33,0
With E-Readers Comes Wider Piracy of Books,0,1,7,28,1,6,0,35,0
Israeli military launches airstrikes into Gaza Strip,0,1,3,43,0,6,0,46,0
The Lonely Towns of Fukushima ,0,3,4,21,0,5,0,25,0
'Onsen summit': Vladimir Putin meets with Japan's Shinzo Abe to 'heal rifts',0,2,6,53,6,11,0,59,0
Can immigrants be deported without a court hearing?,0,2,1,42,1,7,0,43,0
Wall Street loses ground after Trump rally,0,2,3,33,0,6,0,36,0
"On The Comeback Trail, Rohit Sharma Admits That It Was Frustrating To Sit Out And Watch Team India Play",0,3,19,65,1,18,0,84,0
"Impairing the European Union, Gibe by Gibe",0,1,5,30,1,6,0,35,0
Trump's budget director says an agreement to avoid a government shutdown could come today,0,3,1,74,1,13,0,75,0
Catholic Church prepares for papal election conclave,0,1,2,44,0,6,0,46,0
Four MS-13 Members Convicted in Racketeering Case,0,2,7,33,1,6,2,40,0
New York man pleads guilty in New York City subway bomb plot,0,1,5,44,0,11,0,49,0
The road to repealing and replacing Obamacare ,0,3,2,37,0,7,0,39,0
Pope defends economic message,0,2,1,25,0,3,0,26,0
Milan fashion week: Gucci embraces its brilliant absurdity with fluid show,0,3,2,61,1,10,0,63,0
"John Carroll, Editor Who Reinvigorated The Los Angeles Times, Is Dead at 73 ",0,2,11,48,2,13,2,59,0
Telling Twins Apart Takes New Meaning in Berlin  Heist,0,1,8,37,0,9,0,45,0
SADC calls for transparent Mozambique elections,0,1,5,37,0,5,0,42,0
Donald Trump: Former US ambassador Jeff Bleich condemns 'illegal and cruel' immigration bans,0,3,7,70,3,12,0,77,0
Tom Hiddleston apologizes for ‘inelegantly expressed’ Golden Globes speech,0,3,4,60,2,8,0,64,0
Jude Law to Play Young Dumbledore in 'Fantastic Beasts' Sequel,0,2,8,43,2,9,0,51,0
How India's Demonetization Is Affecting Bitcoin Startups,0,2,7,42,1,6,0,49,0
Police warn Sydneysiders to stay away from Eastern beaches,0,1,3,47,0,8,0,50,0
"Merkel, Abe Call for EU-Japan Deal to Stem Trade Barriers",0,3,10,36,2,9,0,46,0
Amazon India Starts Allowing Individuals To Buy & Sell Used Goods Online,0,2,11,49,1,11,0,60,0
Race Is on for Florida Governorship,0,1,4,26,0,5,0,30,0
"Sit-in at Washington University, St. Louis enters ninth day",0,1,5,43,3,8,0,48,0
Trump cited a nonexistent incident in Sweden during his rally on Saturday,0,3,3,59,0,11,0,62,0
Senate Confirms Rick Perry as Energy Secretary ,0,3,6,34,0,7,0,40,0
UN reports Rwandan refugees repatriated by force,0,1,3,39,0,6,0,42,0
Lenders Challenge Delphi Plan to Exit Bankruptcy,0,1,6,36,0,6,0,42,0
Tucker Carlson Taking Megyn Kelly's Job Is The Perfect Metaphor For These Times,0,3,13,53,1,12,0,66,0
"2008 Tour de Taiwan, TaiSPO, and Taipei Cycle: 3-in-1 preview",0,1,8,33,5,9,6,41,0
Britain's GCHQ agency denies wiretapping Donald Trump,0,2,7,39,1,6,0,46,0
Theresa May uses Easter message to suggest there is a ‘sense of coming together’ after Brexit divisions,0,3,4,81,2,16,0,85,0
Why we voted to get rid of Zac Goldsmith,0,3,3,29,0,8,0,32,0
'The Basketball Tournament' Offers $1 Million with Ex-NBA Players on 97 Teams,0,3,11,48,4,11,3,59,0
Knicks May Lose Gallinari for Season,0,1,5,26,0,5,0,31,0
Newly arrived Afghan family freed after being detained four days,0,2,2,53,0,9,0,55,0
Wife of missing soldier receives green card,0,1,1,36,0,6,0,37,0
Stranded seal pup rescued after being spotted by US Coast Guard on New Jersey beach ,0,3,7,62,0,15,0,69,0
American console sales continue to decline throughout April,0,1,2,50,0,7,0,52,0
What MLK might say to Donald Trump,0,3,6,22,0,6,0,28,0
"Twitter Just Can't Decide Whether It's Happy Or Sad About The Rs 3,600 Crore Shivaji Memorial",0,3,15,56,3,15,4,71,0
Kevin Durant Hires Extra Security for Return to Oklahoma City,0,2,8,44,0,9,0,52,0
Argentina defeats Scotland 21-15 in rugby test match,0,1,2,38,1,7,4,40,0
France’s President Criticizes Trump Over Paris Remarks ,0,3,7,40,1,7,0,47,0
Reince Priebus is having a very good week,0,3,2,32,0,7,0,34,0
Austria Rejects Far-Right Presidential Candidate Norbert Hofer - The New York Times,0,2,12,58,2,11,0,70,0
"Al-Qaida claims attack on Burkina Faso hotel, cafe",0,2,4,37,2,7,0,41,0
"WikiLeaks Offer $20,000 Reward for Information on Murdered DNC Staffer - Breitbart",0,2,11,52,3,11,5,63,0
Scientists just invented a smartphone screen material that can repair its own scratches,0,3,1,74,0,12,0,75,0
Daily Mail: Scotland Yard offered Menezes family US$1m,0,1,7,37,2,7,1,44,0
"For Many People, Medical Care Works Best When It’s Incremental",0,2,10,41,2,9,0,51,0
U.S. government proposes removing Yellowstone grizzlies from endangered species list,0,1,3,70,2,9,0,73,0
Opposite-sex marriages among over-65s increase by nearly half,0,3,1,49,2,7,2,50,0
"Broke a Glass, Got an Invoice ",0,3,4,19,1,6,0,23,0
Man Caught Stealing More Than 100 Iphones At The Coachella Music Festival!,0,3,11,48,1,11,3,59,0
Styx Flies to Mars With New Album 'The Mission': Exclusive Premiere of 'Gone Gone Gone' Track,0,3,14,59,5,15,0,73,0
WPP Shares Slide as Advertising Giant Posts Slowest Revenue Growth in Years,0,3,12,52,0,11,0,64,0
Soldiers could be 'shut out of justice' under combat immunity plans,0,3,1,54,2,10,0,55,0
Indian athlete who got high-level help for U.S. visa now accused of sexual assault,0,3,3,63,3,13,0,66,0
Detroit Mayoral Candidate Admits Making False Claims About His Education,0,1,10,53,0,9,0,63,0
"Man admits killing Food Network contestant and husband, burning bodies in wood stove",0,3,3,68,1,12,0,71,0
’Total War: WARHAMMER 2’ – Announcement Cinematic Trailer - Breitbart,0,2,15,39,5,9,1,54,0
Adrian Peterson Rumors: Free-Agent RB Reportedly Will Meet with Seattle Seahawks,0,3,12,56,2,10,0,68,0
The Friendship Bench Can Help Chase The Blues Away,0,2,9,33,0,8,0,42,0
Even Forbes Is Pinching Pennies,0,1,5,22,0,4,0,27,0
The SEC might be about to wade into a war between Wall Street traders,0,2,6,50,0,13,0,56,0
Obama Bans Drilling in Parts of the Atlantic and the Arctic ,0,3,6,43,0,11,0,49,0
Australian refugee activists plan protest during minister's speech,0,1,1,57,1,7,0,58,0
Scientology: What exactly is it?,0,2,2,24,2,4,0,26,0
Pedro Martinez Signs With Phillies and Goes on D.L.,0,1,8,33,2,8,0,41,0
54 killed by suicide bomber at Musayyib gas station,0,1,1,40,0,8,2,41,0
A Trump Economic Boom? The Fed May Stand in the Way ,0,3,9,31,1,11,0,40,0
"Former journalist arrested for cyberstalking woman, making bomb threats to Jewish Centers",0,3,3,74,1,11,0,77,0
"GM Laying off 1,100 Workers After Eliminating Shift at Michigan Plant",0,3,9,45,1,10,4,54,0
U.S. House Republicans continue speaking after lights turn off,0,1,4,48,2,8,0,52,0
These Are The Most-Coveted Beauty Gifts In America,0,2,9,33,1,7,0,42,0
David Cameron's 'cronies' attempt to receive honours in secret ,0,3,2,49,3,9,0,51,0
Thandie Newton says historical dramas 'limit' black British actors,0,3,3,53,2,8,0,56,0
'Black boxes' pulled from Air India plane wreckage,0,1,3,38,2,7,0,41,0
Britain Sets Historic Brexit Process in Motion,0,3,6,34,0,6,0,40,0
"Bruno Mars Declares American Music Is ""Black Music""",0,2,8,34,2,7,0,42,0
"To so many Africans, Fidel Castro is a hero. Here’s why",0,2,5,37,3,10,0,42,0
Civilian Jury Considers Death Penalty for Ex-G.I.,0,1,8,32,3,6,0,40,0
"2009 was worst year for airlines, says International Air Transport Association",0,1,4,59,1,10,4,63,0
India Is Home To Over 3 Lakh Refugees From More Than 30 Countries Including US And UK,0,3,17,49,0,16,3,66,0
Pence said Michael Flynn Jr. ‘has no involvement in the transition.’ But he did.,0,2,5,57,5,13,0,62,0
Presidential debate breaks US ratings record in Clinton-Trump face-off,0,2,5,55,2,8,0,60,0
Signs of ancient hydrothermal vents found on Mars,0,1,2,40,0,7,0,42,0
"7 Baltimore officers accused of abusing power, robbing citizens",0,3,1,52,1,8,1,53,0
India’s Massive State Elections in Uttar Pradesh – The Numbers ,0,3,8,43,2,10,0,51,0
Season 2 of 'Better Call Saul' Might See the Return of a Major 'Breaking Bad' Character,0,3,11,56,4,15,1,67,0
"Enormous purple sea blobs invading East Bay beaches, waterways",0,3,3,50,1,8,0,53,0
"Bob Weir Ropes Grateful Dead Classics, Dylan Covers & Cowboy Songs Into MusicNOW Festival Kick-Off Show",0,2,19,66,3,15,0,85,0
Florida judge denies 'stand your ground' defense in shooting ,0,3,1,49,2,9,0,50,0
Formula One set to see standardised engines,0,1,2,35,0,6,0,37,0
Comedian Jon Stewart to host 78th Academy Awards,0,1,5,34,0,7,2,39,0
"A Real Life Mowgli In UP? 8-YO Girl Found Living With Monkeys, She Doesn't Behave Like Humans",0,2,19,53,4,16,1,72,0
Obama Speaks at N.A.A.C.P. Celebration,0,1,8,21,5,4,0,29,0
How PPG lost its $29.5 billion bet on Dulux paint,0,2,5,30,2,9,3,35,0
Protesters Urge Electoral College To Stop Donald Trump,0,3,8,39,0,7,0,47,0
This is what Trump sees when he opens his Twitter feed,0,2,3,41,0,10,0,44,0
"Seth Rogen, Lonely Island Hint at Movie About Musical Fest That Goes 'Horribly Wrong'",0,2,13,56,3,13,0,69,0
UK mathematician Nick Higham wins Fröhlich Prize,0,1,6,36,0,6,0,42,0
"Despite Major Plans, Obama Taking Softer Stands",0,1,7,33,1,6,0,40,0
2 hurt as gun goes off during French President's speech,0,3,2,42,1,9,1,44,0
UFC 209 Woodley vs. Thompson: Bleacher Report Main Card Staff Predictions,0,2,11,47,2,10,3,58,0
Mass protests in Nicaragua as farmers claim planned canal will 'sell country to the Chinese',0,3,3,73,2,14,0,76,0
Did Kuwait Copy Trump’s Travel Ban? Not Quite ,0,3,8,28,2,8,0,36,0
Nas' New Clothing Line Will Benefit The National Black Child Development Institute,0,3,12,58,1,11,0,70,0
Trump attack on judges 'demoralising' says Supreme Court pick,0,3,3,48,2,8,0,51,0
Twitter Users Recall All The #TrumpFirsts That America Is Enduring,0,3,11,45,1,9,0,56,0
"After Sex Video, South Korea Accused of Targeting Gay Soldiers",0,3,9,43,1,9,0,52,0
"James Comey Could Shed Light on Russia, Trump’s Wiretap Charge",0,3,9,42,2,9,0,51,0
Pushed Into the Future When Illness Strikes (in an Unlikely Place) ,0,3,8,46,2,11,0,54,0
Camila Cabello Looks Ahead to Post-Fifth Harmony Solo Career: 'My Fans Are Really Going to Know Me',0,3,16,63,4,16,0,79,0
"Japan facing 'most severe crisis since World War II', says prime minister",0,1,5,54,3,11,0,59,0
Kangaroo stuns couple by smashing through window and jumping on bed,0,3,1,56,0,10,0,57,0
"On The Appalachian Trail, Combat Veterans Learn To Let Things Go",0,2,11,42,1,10,0,53,0
Bryce Harper Is Already Earning Back the Hype After Failed MVP Encore,0,3,13,45,0,11,0,58,0
Women in South Africa advancing in fields of science and technology,0,1,3,54,0,10,0,57,0
"In challenge to Trump, 17 Republicans join fight against global warming",0,2,3,55,1,10,2,58,0
Aaron Hernandez’s hanging underscores widespread suicide problem in Massachusetts prisons,0,3,3,76,1,9,0,79,0
Pakistan and Taliban Battling for Key City,0,1,5,31,0,6,0,36,0
Mongolia's ex-communists ahead going into Sunday's election,0,1,2,48,3,6,0,50,0
Trump's brilliant cybersecurity solution is to send messages by courier,0,2,1,60,1,9,0,61,0
"NASCAR driver Kyle Busch wins 2011 spring race in Richmond, Virginia",0,1,10,43,1,10,4,53,0
Critics warn Trump budget cuts could hurt terrorism fight,0,3,2,47,0,8,0,49,0
Special Immigrant Visa Worth Billions Faces D-Day,0,3,8,34,1,6,0,42,0
Nine Things You’re Doing Wrong in a Cocktail Bar,0,3,7,32,1,8,0,39,0
"Duolingo raises $45 million, now valued at nearly half a billion dollars",0,3,1,56,2,11,2,57,0
"Report: In a 'humiliating' and 'threatening' tone, Trump lambasted Mexico's president during a phone call",0,3,4,80,7,14,0,84,0
Matthew Dellavedova Injury: Updates on Cavaliers Guard's Cramps,0,2,7,47,2,7,0,54,0
Mexican women urge men to boycott all-male forums,0,3,1,40,1,7,0,41,0
Jim Jones Gets Emotional About Dipset: 'I Put Everything On The Line For This',0,3,14,48,3,13,0,62,0
Doctor accused of mutilating genitals of young girls defends procedure as religious practice,0,3,1,79,0,12,0,80,0
Delightfully geeky beanies are the perfect headwear for scientists of the resistance,0,3,1,72,0,11,0,73,0
Nations begin to offer aid to regions afflicted by Indian subcontinent earthquake,0,1,2,68,0,11,0,70,0
Serie A 2008–09: Inter Milan hire Mourinho as new Head Coach,0,1,7,35,2,10,6,42,0
"Televangelist Pat Robertson compares same-sex marriage to child molestation, pedophilia",0,1,3,73,2,9,0,76,0
Intruder inside Drake's home only raided rapper's fridge ,0,3,2,45,2,8,0,47,0
Lucky toddler stars in her very own 'Beauty and the Beast' photoshoot,0,3,3,53,2,11,0,56,0
Geller: Why Trump Is Failing,0,2,5,18,1,4,0,23,0
Schwarzenegger's 'Apprentice' makes its debut,0,3,2,36,3,4,0,38,0
Whitehall leak shows plans for seven separate Brexit bills,0,3,2,48,0,8,0,50,0
"Trump's Hindu, Sikh and Muslim power brokers",0,3,4,32,2,6,0,36,0
"Earth is overdue for collision with 'dinosaur-killer' asteroid, Nasa warns",0,3,2,59,4,9,0,61,0
China just opened a massive floating walkway that's twice as long as Manhattan,0,3,2,63,1,12,0,65,0
Russia and Turkey push Syria’s warring sides to seal truce,0,2,3,45,1,9,0,48,0
"London Underground fined £500,000 after maintenance worker injured in a fall",0,3,2,56,2,10,6,58,0
Britain's Queen Elizabeth II Attends First Official Engagement of 2017,0,2,9,47,1,9,4,56,0
Australia Day lamb advertisement draws criticism from Indigenous groups,0,2,3,60,0,8,0,63,0
Belarus v Spain: Euro 2016 qualifier – as it happened,0,3,3,35,2,9,4,38,0
Uproar Over United Video Imperils Chicago Airport Police,0,2,8,41,0,7,0,49,0
"New York man, jailed for 3 years without trial, kills himself  ",0,2,2,46,2,12,1,48,0
Strauss-Kahn case dismissed,0,1,2,22,1,2,0,24,0
At least 12 people dead after night of looting and violence in Venezuela,0,2,2,56,0,12,2,58,0
YouTube user gets instant fame for video defending Britney Spears,0,1,4,52,0,9,0,56,0
"iPad magician strikes again, this time using the Apple Watch",0,3,3,47,1,9,0,50,0
"Calls for aid to help feed millions, as East Africa plunges into drought",0,1,3,56,1,12,0,59,0
Said & Done: ‘I am only guilty of one thing: protecting Leeds United’,0,3,5,47,5,12,0,52,0
Donald Trump 'Went Ballistic' on Senior Staffers in Heated White House Meeting,0,3,10,55,2,11,0,65,0
Russia 'determined to fight terror' after envoy's assassination,0,2,1,52,3,7,0,53,0
"Sunderland relegation ‘my worst day in football’, says David Moyes",0,3,3,51,3,9,0,54,0
European Games: Vanessa Sahinovic in coma after collision,0,2,4,45,1,7,0,49,0
LaVar Ball on UCLA losing in March Madness: 'You can't win no championship with 3 white guys',0,2,10,62,4,16,1,72,0
F.B.I. Arrests Volkswagen Executive on Conspiracy Charge in Emissions Scandal ,0,3,10,55,3,10,0,65,0
Demi Lovato Says She's 1 Percent African -- And Twitter Absolutely Loses It,0,2,11,48,3,12,1,59,0
Aaron Hernandez's Death Highlights A Serious Problem,0,2,7,38,1,6,0,45,0
17-Point Play Waved Off in California,0,1,5,24,1,5,2,29,0
Five Things You Need to Know to Start Your Day,0,2,8,29,0,9,0,37,0
"For G.M. and Chrysler, Aid Tied to Restrictions",0,1,7,30,3,7,0,37,0
France Opens First Military Bases in the Gulf,0,1,6,32,0,7,0,38,0
Armstrong Finishes Off the Pace in His Return,0,1,6,32,0,7,0,38,0
Police: Man charged in deadly shooting on train in Atlanta ,0,2,3,45,1,10,0,48,0
"EU referendum: Ministers could still be allowed to campaign for British exit, admits Downing Street",0,2,6,77,2,14,0,83,0
North Dakota congressman: Spicer Hitler comment 'not without some validity',0,3,4,59,3,9,0,63,0
Selling Junkless Junk Food to the Masses,0,1,5,29,0,6,0,34,0
Texas Teacher Arrested for Allegedly Recording His Students Undressing,0,3,8,54,0,8,0,62,0
"Here’s everything we know so far about Faraday Future’s FF91 electric, self-driving car",0,2,5,64,4,12,2,69,0
"Five biggest US banks told to raise $74.6 billion; fail ""stress tests""",0,1,3,48,5,11,3,51,0
Teens Are Now Throwing Backpacks At Each Other For — You Guessed It — The Backpack Challenge,0,3,15,59,2,16,0,74,0
Colin Kaepernick’s Continuing Protest,0,2,4,29,1,3,0,33,0
"Earthquake reported near Rome's coast, no damage caused",0,1,2,44,2,7,0,46,0
New York Pension Scandal Prompts Firing of Second Employee ,0,3,8,42,0,9,0,50,0
"Holidaymakers will be given more detail on likelihood of terror attacks abroad, Boris Johnson reveals",0,3,3,83,1,14,0,86,0
Wikimania 2007 Exhibitions shows the culture of freedom,0,1,2,42,0,7,4,44,0
Chaos ensues when these snow tubers don't follow conveyor belt rules,0,3,1,56,1,10,0,57,0
Hotpoint tells tumble dryer owners: unplug faulty machines due to fire risk,0,3,1,62,1,11,0,63,0
Myanmar criticised for hampering aid; UN resumes relief efforts,0,1,3,51,1,8,0,54,0
More than 100 diners flee Spanish restaurant without paying,0,3,2,46,0,8,3,48,0
"Franken Had Most Votes, Court Says",0,1,6,22,1,5,0,28,0
Obama Voices Optimism on the Economy,0,1,4,27,0,5,0,31,0
Job Losses Pose a Threat to Stability Worldwide,0,1,6,34,0,7,0,40,0
TED CRUZ DROPS OUT,0,2,15,0,0,3,0,15,0
"Before Kentucky Derby History Along the Rail, a Partnership Began in a Bar",0,1,9,52,1,12,0,61,0
Florida panther deaths still at record high for 2016,0,3,1,39,0,8,4,40,0
"Nordstrom, Neiman Marcus Drop Ivanka Trump's Fashion Collection, Citing Brand's Performance ",0,2,11,66,4,11,0,77,0
Wikinews interviews manager of site 'Lose The Game',0,1,4,38,2,7,0,42,0
Hank Williams: The Hillbilly Shakespeare,0,3,5,30,1,4,0,35,0
Myer raid could trigger David Jones merger: analyst,0,2,3,40,1,7,0,43,0
Debt Doesn't Have To Be A Dirty 4-Letter Word,0,3,9,25,2,8,1,34,0
13 killed in U.S. air strike in Pakistan,0,1,3,26,2,7,2,29,0
Trump Said to Not Shy Away From Sudden Strike on North Korea,0,2,10,39,0,11,0,49,0
"Rodriguez Offers Apology, but Is It the Whole Truth?",0,1,7,35,2,8,0,42,0
Eurovision Song Contest 2017: Former X Factor contestant Lucie Jones to represent UK,0,3,10,57,1,12,4,67,0
The White House’s wiretapping shell game,0,3,3,31,1,5,0,34,0
"Lorde Talks Taking a Long Break, David Bowie Influence on 'Melodrama'",0,3,9,47,3,10,0,56,0
Travel chaos on the way as Southern rail walkout coincides with London Underground strike ,0,3,4,72,0,14,0,76,0
"Mike Pompeo Is Confirmed to Lead C.I.A., as Rex Tillerson Advances ",0,3,11,41,4,11,0,52,0
Bollore makes first step to merge Vivendi and Havas with 2.4 billion euro deal,0,2,3,59,1,13,2,62,0
Cadillac tries to unite a 'divided nation' with Oscars ad,0,3,2,44,2,9,0,46,0
Smartphone Debut Helps Palm Beat Estimates,0,1,6,31,0,5,0,37,0
Jose Abreu testifies he ate his fake passport on the way to the U.S.,0,3,4,49,2,13,0,53,0
Business Schools That Will Dominate In The 21st Century,0,3,8,37,0,8,2,45,0
Missing Tennessee teen's father seeks to depose witnesses in hopes of finding daughter ,0,2,2,71,1,13,0,73,0
Philippines earthquake kills four on Mindanao,0,3,2,38,0,5,0,40,0
"11 Clever, Untraditional Ways People Have Wrapped Gifts This Holiday Season",0,3,10,52,1,10,2,62,0
3 in Beijing Set Their Car on Fire in Apparent Protest,0,1,7,36,0,10,1,43,0
Polio vaccination campaign targets 85 million African children,0,1,2,51,0,7,2,53,0
Inside Carrie Fisher’s Weight Loss and Healthy Living Prior to Her Heart Attack,0,3,11,55,1,12,0,66,0
Anna Nicole Smith dies,0,1,3,16,0,3,0,19,0
Astronauts Replace 16-Year-Old Camera on Hubble,0,1,6,32,2,5,2,38,0
County round-up: Jonathan Trott century for Warwickshire holds up Surrey,0,3,5,56,2,9,0,61,0
Paul Ryan Calls Trump’s Handling of Immigration Order ’Regrettable’,0,2,8,48,3,8,0,56,0
Budweiser's Super Bowl LI Ad Is A Story Of Overcoming Xenophobia,0,3,12,41,1,10,0,53,0
Google’s moonshot boss reportedly huffed out of a meeting with the writers of HBO’s ’Silicon Valley’,0,2,6,75,4,15,0,81,0
NBA Power Rankings: Warriors pass the test; Sixers made sudden rise,0,3,7,48,2,10,0,55,0
Fifth Harmony's Ally Brooke Shares a Soulful Cover of 'Mad World': Watch,0,3,10,47,4,11,0,57,0
Trump sons distance themselves from fundraiser selling access,0,3,1,53,0,7,0,54,0
"Chance the Rapper, Little Big Town, Sturgill Simpson Join Lineup of Grammy Performers",0,3,11,60,2,12,0,71,0
"Dave Chappelle, Jerry Seinfeld, and Jimmy Fallon Bid Farewell to Michelle Obama on 'Tonight Show'",0,3,12,67,4,14,0,79,0
"Granddad, the world's oldest aquarium fish, dies ",0,3,1,38,3,7,0,39,0
'Orange is the New Black' is quickly becoming a feminist classic,0,3,3,49,2,10,0,52,0
Berlin Truck Crash Unnerves Europe’s Center,0,3,6,31,1,5,0,37,0
Teen Vogue Writer Twists Knife After Taking Down Tucker Carlson,0,3,10,44,0,9,0,54,0
Baylor coach walks back her tone-deaf message about sexual-assault scandal,0,3,1,62,2,9,0,63,0
Paris to Increase Security Around Eiffel Tower ,0,3,6,34,0,7,0,40,0
It’s Time to Recognize a Few Truths About These Giants ,0,3,8,36,1,10,0,44,0
Officials investigating cause of massive Boston-area fire,0,2,2,48,1,6,0,50,0
Irish Government sends team of officials in hunt for Journalist,0,1,3,51,0,9,0,54,0
U.S. Presidential candidate Fred Karger denied place at Fox News debate,0,1,7,52,2,10,0,59,0
Australia Day lamb advertisement draws criticism from Indigenous groups,0,3,3,60,0,8,0,63,0
"Portions of Wikileaks, Wikipedia blocked in Australia",0,1,4,42,1,6,0,46,0
Duterte Says Trump Wished His Drug Crackdown ‘Success’,0,3,8,37,2,7,0,45,0
"Alexei Navalny, Russian opposition leader, arrested in Moscow",0,3,4,48,2,7,0,52,0
Do You Want Reagan’s Economy or Obama’s?,0,3,6,25,3,6,0,31,0
I.R.S. to Ease Penalties for Some Offshore Tax Evaders,0,1,9,34,3,8,0,43,0
New Orleans officials confiscating guns,0,1,2,33,0,4,0,35,0
Kansas Governor Signs Bill on Offering Ultrasounds Before Abortion,0,1,8,50,0,8,0,58,0
Muslim businessman erects tallest Christmas tree in Baghdad as symbol of solidarity ,0,3,3,69,0,12,0,72,0
The Dallas Stars brilliantly troll Donald Trump,0,3,5,36,0,6,0,41,0
"Donald Trump Sticks To Claim Of Widespread Voter Fraud, Despite Having No Proof",0,3,13,53,1,12,0,66,0
Nevada’s Joe Heck Aims to Keep the Senate Republican,0,2,7,36,1,8,0,43,0
"Kylie Jenner Remembers She's 19, Crashes High School Prom",0,3,8,37,2,8,2,45,0
First Lady in Control of Building Her Image,0,1,6,30,0,7,0,36,0
Football: Fulham FC sacks coach Chris Coleman,0,1,6,32,1,6,0,38,0
Lawyer calls to investigate Arkansas execution after inmate convulsed before dying ,0,2,2,70,0,11,0,72,0
Vince Carter Turns Back the Clock During Historic Performance for Grizzlies,0,2,9,56,0,10,0,65,0
Pokemon Go: Exercise impact 'short-lived',0,2,3,30,4,4,0,33,0
Manpreet Singh Inspired To Be Playing For MS Dhoni's Franchise Ranchi Rays In Hockey India League,0,3,17,64,1,15,0,81,0
Times Co. May Include 2nd Paper in Globe Sale,0,1,7,28,1,8,1,35,0
UK loses appeal to conceal Binyam Mohamed torture,0,1,4,38,0,7,0,42,0
"Jrue Holiday voices appreciation for support from LeBron James, others",0,3,5,55,1,9,0,60,0
Jared Cook Reportedly to Meet with Seattle Seahawks,0,3,6,38,0,7,0,44,0
Zimbabwe Opposition Party Official Arrested,0,1,5,34,0,4,0,39,0
Twitter Absolutely Lit Up the Warriors for Their All-Star Photo Shoot,0,3,10,48,1,10,0,58,0
Growing Number of G.O.P. Lawmakers Criticize Trump’s Refugee Policy ,0,3,10,45,4,9,0,55,0
Betsy DeVos Says It's 'Possible' Her Family Has Donated $200M To Republicans,0,3,13,45,4,11,3,58,0
S.E.C. Faces Fresh Scrutiny Over Trading Inquiry at Lehman,0,1,10,37,3,8,0,47,0
"Over 55s hardest hit by 'invasive' identity theft, Scamwatch figures show",0,3,2,56,3,10,2,58,0
Syria Rejects Amnesty's Report of Mass Hangings as 'Untrue',0,3,7,41,3,8,0,48,0
Debbie Reynolds’s Fans Join Celebrities in Mourning Actress’s Death ,0,3,8,49,2,9,0,57,0
Judge Sentenced to Prison for Lying About Harassment,0,1,6,39,0,7,0,45,0
Northwestern savors its turn as NCAA tournament darling,0,3,5,43,0,7,0,48,0
Love on the spectrum: Meet Ruth and Thomas,0,3,4,30,1,7,0,34,0
Fund Managers Burned by Last Commodity Slump Want Back In,0,3,9,39,0,9,0,48,0
Listen to Spencer Ludwig Bring the Groove on 'Legend' and 'Fuel To The Fire': Exclusive,0,3,11,57,5,14,0,68,0
What to expect from Carrie Fisher and Debbie Reynolds' public memorial - Yahoo,0,3,6,58,2,12,0,64,0
Wham! star Andrew Ridgeley attacks 'mucky' Channel 5 documentary about George Michael,0,3,6,64,3,11,1,70,0
Princess Diana lives on in her sons - what Prince Harry and William  have done this week proves that,0,3,5,75,1,19,0,80,0
Pittsburgh Penguins superstars just too much for overwhelmed Columbus Blue Jackets,0,3,5,67,0,10,0,72,0
Gabrielle Union Launches Hair Care Line For Women With Textured Hair,0,3,11,47,0,10,0,58,0
Carrie Underwood's Biggest Hot 100 Hits,0,3,5,25,1,5,3,30,0
Michael Jackson's daughter Paris Jackson signs with modeling agency - Yahoo,0,3,5,58,2,10,0,63,0
Danny Dyer takes a break from EastEnders to 'sort his life out' after struggling to give up alcohol,0,3,4,76,2,17,0,80,0
Joy Villa's Grammy Trump Dress Boosts Album Sales,0,2,8,33,1,7,0,41,0
"Britain to Leave the EU, but ‘Brexit’ to Join the Oxford English Dictionary",0,2,9,51,3,12,0,60,0
One dead as Super Typhoon Megi makes landfall in Philippines,0,1,5,46,0,9,0,51,0
EU council president Donald Tusk tells Britain: 'We miss you already',0,2,6,50,3,10,0,56,0
The New Congress Is 91% Christian. That’s Barely Budged Since 1961. ,0,2,9,38,4,11,6,47,0
"Katy Perry, Nick Jonas, and Other Stars You Can Buy Shoes From [Video]",0,2,12,42,4,12,0,54,0
Baghdad TV station shut down for showing Saddam mourners,0,1,4,44,0,8,0,48,0
"Iran, NKorea officials: Let's strengthen relationship ",0,3,4,41,3,6,0,45,0
"Body found on M1 in Northamptonshire, closing northbound motorway",0,3,3,52,1,8,1,55,0
Iran’s Ayatollah Khamenei: Donald Trump ‘Shows Real Face of America’,0,2,9,46,4,9,0,55,0
'HNDRXX' Keeps Future at No. 1 on Billboard Artist 100 Chart,0,2,12,31,3,10,4,43,0
Olney: Slow start might force Blue Jays to tear down,0,3,4,38,1,9,0,42,0
Athletes prepare for 2012 Summer Paralympics at the Paralympic Fitness Centre,0,1,6,57,0,10,4,63,0
Seth Meyers shuts down Trump's wall by exposing the inconsistencies,0,3,3,54,1,9,0,57,0
In pictures: Japan earthquake and tsunami,0,1,2,33,1,5,0,35,0
Search Resumes for Plane That Disappeared Over Lake Erie With CEO and Family ,0,3,13,51,0,13,0,64,0
U.K. Election Raises Prospect of Another Scottish Independence Vote,0,2,9,48,2,8,0,57,0
Dieses Video ist nicht verfügbar. Political Barflies: Christmas Cheers,0,3,6,54,2,8,0,60,0
Disney Finds Its 'Frozen' Princesses For Broadway,0,3,7,34,2,6,0,41,0
Takeover Tuesday: Iggy Azalea's 'Mo Bounce' Playlist,0,2,7,35,4,6,0,42,0
Loud and Clear: Sharapova Is Back With a Victory,0,1,7,32,1,8,0,39,0
China orders inquiry into deaths of children who swallowed pesticide,0,3,1,58,0,9,0,59,0
'Wonder Woman' Love Story Explored in New Footage at CinemaCon,0,3,9,42,2,9,0,51,0
Iranian baby will be allowed into US for emergency procedure ,0,2,3,48,0,10,0,51,0
Chaos at Calais as builders unearth two WWII RAF bombs and are forced to close port,0,3,9,59,0,15,0,68,0
South Korean police clamp down on protests against US beef,0,1,4,45,0,9,0,49,0
Treasury Sets Up Procedure to Sell Bank Warrants,0,1,7,34,0,7,0,41,0
The first American hoverboard fire deaths are now part of a federal investigation,0,3,2,67,0,12,0,69,0
Global markets surge in value,0,1,1,24,0,4,0,25,0
Woman to airline: That’s not my son!,0,2,2,25,3,6,0,27,0
How Fidel Castro's jeep broke down mid ceremony as it carried his ashes to final resting place ,0,2,3,74,1,17,0,77,0
"San Francisco's withdrawal from national terror intelligence network hikes risks, officials say ",0,3,2,80,2,12,0,82,0
"Yes, Italy’s constitution needs fixing. But not as urgently as its banks do",0,3,3,57,3,12,0,60,0
"Woman Trapped Under 1,500 Pound Boulder Rescued",0,3,6,30,1,6,4,36,0
Google mobile phone rumours ramp up,0,1,1,29,0,5,0,30,0
What you need to stream on Thanksgiving weekend,0,2,2,38,0,7,0,40,0
You Could Have Bought A Ticket To Donald Trump's New Year's Eve Party,0,3,13,42,2,12,0,55,0
Delphi in Talks to Emerge From Bankruptcy,0,1,5,30,0,6,0,35,0
"International students studying in Australia reach record number, Education Department figures show",0,3,4,83,1,11,0,87,0
"To Bahais in U.S., Iranian Crackdown Is Nothing New",0,1,9,31,3,8,0,40,0
Brazil judge who played key role in corruption investigation dies in plane crash,0,3,1,67,0,12,0,68,0
Bill O'Reilly's Name Has Already Been Scrubbed From 'The Factor',0,3,11,40,4,9,0,51,0
Kansas Holds Off Upset-Minded Bisons,0,1,6,25,1,4,0,31,0
"In The West Wing’s Debate Episode, Politics Is a Game",0,2,9,33,2,9,0,42,0
Carrie Fisher Will Grace The Big Screen Again In 'Star Wars: Episode VIII',0,3,16,43,3,12,0,59,0
Warming oceans make it harder for fish to breathe,0,1,1,40,0,8,0,41,0
Gunman holds hostage in U.S. television station offices,0,1,3,43,2,7,0,46,0
Prince’s Posthumous Year In Business Was Full Of Weirdos And Chaos,0,2,11,44,1,10,0,55,0
Northeast blizzard could dump 18 inches of snow on New York ,0,3,3,44,0,11,2,47,0
"Jerusalem attack: Four Israeli soldiers dead, 17 injured, after truck ram into crowd",0,3,3,64,3,12,2,67,0
Computer Makers Prepare to Stake Bigger Claim in Phones,0,1,7,40,0,8,0,47,0
The Best-Paying Jobs Of 2016,0,2,5,14,1,4,4,19,0
FBI being sued over role in Donald Trump US presidential election victory,0,3,7,55,0,11,0,62,0
Jimmy Kimmel Nails Donald Trump On Severity Of Paul Manafort's Russian Ties,0,2,12,51,1,11,0,63,0
Chavez wants UN uprooted from New York,0,1,5,27,0,6,0,32,0
Red faces at Fed Cup as Nazi-era anthem played before US-Germany match,0,3,7,50,2,11,0,57,0
Report on Hope Solo's domestic violence charges raises new questions about U.S. Soccer,0,2,6,65,3,12,0,71,0
Man found dead in Edinburgh House of Fraser,0,3,4,32,0,7,0,36,0
"$20,000 reward offered as cops hunt road rage killer of 3-year-old boy ",0,3,0,49,4,12,6,49,0
Death Sentences in Chinese Milk Case,0,1,5,26,0,5,0,31,0
"In the Genes of a Hereford, the Essence of Cow",0,1,5,31,1,9,0,36,0
Facing the future: Gillian Wearing digitally ages herself in new artwork,0,2,3,58,1,10,0,61,0
This IHOP Waiter Helps Woman With A Disability Eat Breakfast And People Are Beyond Touched,0,3,18,58,0,14,0,76,0
"2 dead in shooting at San Bernardino elementary school, police say ",0,3,2,52,1,11,1,54,0
U.S. Navy deploys guided missile destroyer USS Cole off coast of Yemen,0,3,8,49,2,11,0,57,0
"Lil Yachty Trades Bars With ASAP Ferg On ""Terminator""",0,3,12,31,2,8,0,43,0
Eni to Sell Gas Operations to Italian Grid Owner,0,1,7,33,0,8,0,40,0
"Trump says ‘torture’ works, but he’ll defer on decision over tactics to his defense secretary",0,2,1,74,4,14,0,75,0
"Trump Tweet Hyping ‘Judge Jeanine’ Show Wasn’t Criticism of Paul Ryan, Aides Say",0,2,12,52,4,12,0,64,0
Bangladesh storms kill at least 23,0,1,1,26,0,5,2,27,0
Proposed United States doctrine would expand possible use of nuclear weapons,0,1,3,63,0,10,0,66,0
"Stephen Colbert Parodies Stephen Miller’s Vow To 'Go On Any Show, Anywhere, Any Time'",0,3,14,53,5,13,0,67,0
Send kisses to a loved one via iPhone with this 'kiss messenger',0,2,2,49,2,11,0,51,0
40 Die as Ferry Sinks in Vietnam,0,1,4,20,0,6,2,24,0
Earth Day picked as date for science march on Washington,0,3,3,44,0,9,0,47,0
Mew 2! The cat with a goatee who looks just like The Edge,0,3,4,39,1,12,1,43,0
No-Hit Streak for High Schooler Schuster Ends,0,1,7,31,1,6,0,38,0
Race for Life’s branding is cliched and infantile. It’s time to sink the pink,0,3,3,58,3,13,0,61,0
Ex-IMF chief Rodrigo Rato gets 4.5 years for embezzlement,0,3,6,39,2,8,2,45,0
Budget 2017: Tax increase announced for self-employed workers by Chancellor Philip Hammond,0,3,5,68,2,11,4,73,0
Little maestro expertly commands the band in an Istanbul subway,0,2,2,52,0,9,0,54,0
‘Jurassic World’ is Feminist Because of the Dinosaurs,0,3,5,39,2,7,0,44,0
'American Idol' Season 10 Winner Scotty McCreery Cheers on the Patriots at Super Bowl Rally,0,2,12,61,2,14,2,73,0
Russia withdraws from Georgia,0,1,2,24,0,3,0,26,0
Pat Buchanan: Trump Can Still Win if Republicans Come Together to Defeat Hillary - Breitbart,0,2,12,64,2,14,0,76,0
30 people die in bombing in northwestern Pakistan,0,1,1,39,0,7,2,40,0
Anti-war protestors arrested outside White House,0,1,3,39,1,5,0,42,0
Mass prayer rally in Jakarta against governor 'Ahok',0,3,3,40,2,7,0,43,0
Yellen signals the Fed will likely raise rates this month ,0,3,2,46,0,10,0,48,0
Donors pledge $672m at Oslo summit to avert famine in Nigeria and Lake Chad,0,3,5,53,1,13,3,58,0
Symbol of faith helps Georgia city recover from deadly tornado ,0,3,2,51,0,10,0,53,0
Syrian attack strongly suggests exposure to toxic nerve agent,0,2,1,52,0,8,0,53,0
"Scandal, radicals and insurgencies – all bets are off for the French presidency",0,2,2,63,2,12,0,65,0
Deutsche Bank reaches $7.2 billion deal with U.S. over toxic mortgages,0,3,4,50,4,10,2,54,0
Warning in Colombia about possible volcanic eruption,0,1,2,44,0,6,0,46,0
Eight Feared Dead as Avalanche Hits Japan Ski Resort,0,2,8,36,0,8,0,44,0
"Two small planes collide in Wyoming, USA, killing three",0,1,5,40,2,8,0,45,0
"Wales railway upgrade proposals would cost £5bn, says expert",0,1,1,48,2,8,1,49,0
Kyle Edmund battles bravely in defeat to Stan Wawrinka at the Brisbane International,0,3,6,66,0,12,0,72,0
"Sources close to both sides say NHL, NHLPA agree on Salary Cap structure",0,1,11,48,1,12,0,59,0
One Nation strike over sugarcane dispute to derail Government agenda,0,3,3,56,0,9,0,59,0
Giant megalodon shark teeth may have inspired Mayan monster myths,0,3,2,54,0,9,0,56,0
Elon Musk hints at new Tesla feature for Easter eggs,0,3,4,39,0,9,0,43,0
"No matter how many Republicans denounce Trump, the racism charge sticks",0,2,3,57,1,10,0,60,0
Robert Xie found guilty of murdering five members of extended family,0,3,2,56,0,10,0,58,0
"Wikinews interviews Donald K. Allen, independent candidate in US presidential elections",0,1,6,69,2,10,0,75,0
Malaysian Home Ministry ban approved documentary,0,1,3,40,0,5,0,43,0
Richard Thole: Hopes fade for boy lost in SA mineshaft,0,3,5,39,1,9,0,44,0
U.S. Capitol Police kill man during traffic stop turned chase,0,1,4,46,2,9,0,50,0
Police: Former student who fathered son with teacher killed both ,0,2,2,52,1,10,0,54,0
French Presidential Candidates Take Positions on Paris Attack,0,3,7,47,0,7,0,54,0
Feds Find $20 Million Hidden Under A Mattress In Massachusetts,0,2,9,41,1,9,2,50,0
Meet the fluorescent tree frogs of South America,0,3,3,38,0,7,0,41,0
Argentina: TV channel taken off the air in Mendoza at rival’s request,0,1,4,52,2,11,0,56,0
"Obama Administration to End ‘Wet Foot, Dry Foot’ Policy for Cubans",0,2,9,44,3,10,0,53,0
Turkey's southern border is becoming a key hub for refugees fleeing Aleppo,0,2,2,60,1,11,0,62,0
U.S. Housing prices down 9% since February,0,1,4,28,3,6,1,32,0
Australian Thomas Keating charged over fatal jet ski collision in Thailand,0,2,4,60,0,10,0,64,0
"Film Channel Has Name, but No Network Carrier",0,1,7,30,1,7,0,37,0
Atomic Agency Examines Candidates to Replace ElBaradei,0,1,7,41,0,6,0,48,0
An Alabama Prison’s Unrelenting Descent Into Violence ,0,2,7,39,1,7,0,46,0
Technology innovations unveiled on Research at Intel Day 2008,0,1,4,45,0,8,4,49,0
Peru-Chile rivalry erupts into Cyberspace,0,1,3,33,1,4,0,36,0
"Get set for December supermoon, Geminid meteor shower ",0,3,3,42,1,8,0,45,0
FBI's Awlaki surveillance footage revealed ,0,2,4,33,1,5,0,37,0
A big winner in Trump's first 100 days? 'Fox & Friends',0,3,4,33,5,10,3,37,0
GOP returns to daunting task of dismantling Obamacare,0,3,4,42,0,7,0,46,0
Obama’s Stark Options on ISIS: Arm Syrian Kurds or Let Trump Decide ,0,3,13,41,2,12,0,54,0
How Teen Vogue Is Tackling Hot Button Issues Without Losing Its Fashion Edge,0,3,13,51,0,12,0,64,0
Obama Signs Spending Bill but Criticizes Earmarks,0,1,6,37,0,6,0,43,0
Scott Morrison says Trump travel ban shows 'world is catching up' to Australia,0,3,4,60,2,12,0,64,0
Oscar Nominee Spotlight: 'Fences' Star Viola Davis's Busy Awards Season,0,3,10,48,4,9,0,58,0
Kourtney Kardashian Got Dragged on Twitter After Tweeting About 'Get Out',0,3,10,51,2,10,0,61,0
Singapore Slingers defeat Darwin All-Stars in eighth Singapore Challenge Series game,0,1,8,65,1,10,0,73,0
Watch Live: Biden Delivers Address on Nuclear Weapons,0,3,7,38,1,7,0,45,0
"Netflix's Making a Murderer subject Brendan Dassey's confession legal, prosecutors say",0,3,5,68,3,10,0,73,0
James Van Der Beek Endures Awkward Interview With 'Dawson's Creek'-Obsessed Co-Hosts,0,3,13,56,5,10,0,69,0
Treasury’s Mnuchin: ’We do not support breaking up banks’,0,2,3,42,4,8,0,45,0
Do Oklahoma City Thunder have a rivalry with the Warriors? Absolutely,0,2,6,52,1,10,0,58,0
Chelsea Handler to lead 'Women's March' at the Sundance Film Festival,0,3,7,49,3,10,0,56,0
General relativity effect confirmed: satellite experiment,0,1,1,50,1,5,0,51,0
Blood recipients contract HIV in Peru,0,1,5,27,0,5,0,32,0
"Militants, pirates may fight over Saudi oil tanker",0,1,2,40,1,7,0,42,0
Britney Spears' Piece of Me Show Tops $100 Million in Ticket Sales,0,3,9,41,2,11,3,50,0
South Korea Keeps Record-Low Rates on Hold,0,1,7,28,1,6,0,35,0
Marine vet speaks out about viral video supporting Trump travel ban ,0,3,2,55,0,11,0,57,0
New airplane electronics rules stem from ISIS-associated threat ,0,3,5,50,1,8,0,55,0
Watch Metallica Crush Their Biggest Fan in 'Who Knows' Trivia Contest on 'Jimmy Kimmel Live!',0,3,13,61,5,14,0,74,0
Name Hurting Largest Unit of A.I.G.,0,1,7,20,3,5,0,27,0
One stock helped decimate billionaire Bill Ackman's hedge fund performance,0,3,3,61,1,9,0,64,0
Trump has set the US up to botch a global health crisis,0,2,3,41,0,11,0,44,0
Sondhi may face legal action from Thai Rak Thai party,0,1,4,40,0,9,0,44,0
Chike Okeafor Brings Fourth Dimension to Cardinals,0,1,6,38,0,6,0,44,0
New 'Beauty And The Beast' Teaser Showcases Emma Watson Singing 'Belle (Reprise)',0,3,12,52,6,11,0,64,0
Connecticut Hunts for a Fix to Its Bear Problem,0,3,6,33,0,8,0,39,0
Pence did not learn that Flynn misled him on Russia until last week,0,3,3,52,0,12,0,55,0
New Doritos bag will play you the entire 'Guardians 2' soundtrack. Really.,0,3,4,54,4,11,1,58,0
"Soulja Boy Takes Shots At Quavo On New Diss Track ""Beef""",0,3,11,33,2,10,0,44,0
Rebellion in Brazilian State Prison is over,0,1,4,33,0,6,0,37,0
Teaching my daughter that God might be a girl,0,3,2,35,0,8,0,37,0
DePaul Edges No. 21 Rutgers With a Strong Finish,0,1,8,29,1,8,2,37,0
"Millennials do not consider themselves 'grown up' until they are 27, survey finds",0,3,1,63,3,12,2,64,0
Shawn Mendes Performs 'Mercy' & 'Treat You Better' on 'Saturday Night Live',0,3,10,47,7,11,0,57,0
Donald Trump Dismisses ‘Golden Showers’: ‘I’m Very Much a Germaphobe’,0,3,9,45,6,9,0,54,0
deadmau5 Files Trademark Petition to Protect His Cat Meowingtons' Brand,0,2,8,52,1,9,1,60,0
"Little Rock boy, 3, dies in road rage shooting",0,3,2,33,2,8,1,35,0
New-elected W.Va. sheriff charged with stealing meth from evidence room,0,3,3,56,3,9,0,59,0
Malaysia expects more arrests for the murder of Kim Jong Un's half-brother â including an 'important person',0,3,4,84,6,16,0,88,0
Trump vs. Congress: Now What? ,0,2,4,18,3,5,0,22,0
Turkish Police Hunt for Gunman in Istanbul Nightclub Terror Attack,0,3,8,49,0,9,0,57,0
Woman Claims Popeyes Served Her Flesh-Eating Worms in $1 Million Lawsuit,0,2,10,49,2,10,1,59,0
Green light for Swansea Bay's £1bn tidal lagoon,0,3,3,34,2,7,1,37,0
Brandon Jennings Has a Slow Start in Italy,0,1,6,29,0,7,0,35,0
President Donald Trump Has Historically Low Approval Ratings As He Nears 100-Day Mark,0,2,13,56,1,12,3,69,0
Study Finds How Your Birth Month Affects Your Health,0,2,9,35,0,8,0,44,0
Creep offered son for sex in Central Park,0,2,3,31,0,7,0,34,0
Donald Trump slams CIA Director Brennan over plea for 'appreciation' of intel community,0,2,7,66,2,12,0,73,0
Kodak to Lose Up to 18% of Work Force,0,1,5,21,1,8,2,26,0
British army bomb disposal expert killed in Afghanistan,0,1,2,46,0,7,0,48,0
Drake And Jennifer Lopez Share A Moment On Instagram,0,3,9,35,0,8,0,44,0
"British Liberal Democrat Patsy Calton, 56, dies of cancer",0,1,5,40,2,8,2,45,0
'Harry Potter' Alums Help Preview London Studio Tour's New 'Forbidden Forest' Attraction (Spider Alert!),0,3,14,69,8,13,0,83,0
Emmy Rossum wants equal pay and more for “Shameless”,0,3,3,39,2,8,0,42,0
Waymo's Uber Lawsuit May Be Start Of A Google Patent War,0,3,11,34,1,10,0,45,0
Arkansas can't find enough volunteers to witness back-to-back executions,0,3,1,60,3,8,0,61,0
North Korea: Experts Warn Only Way Forward May Be Diplomacy,0,3,10,39,1,9,0,49,0
Ed to wed: UK Labour leader Miliband announces engagement to Justine Thornton,0,1,7,58,1,11,0,65,0
Super Bowl Media Fail: ‘My God. It’s Election Night All Over Again’,0,3,12,39,5,11,0,51,0
North Korea to Press Ahead With Missile Launch,0,1,7,32,0,7,0,39,0
Court ruling upholds expulsion of New York Senator convicted of assault,0,1,4,57,0,10,0,61,0
Mark Webber wins 2009 German Formula One Grand Prix,0,1,7,32,0,8,4,39,0
Drop the Target: Theresa May must drop the tens of thousands net migration cap – sign our petition now,0,3,4,78,2,18,0,82,0
Hen dos are a deeply sad and conservative tradition – like marriage itself,0,3,1,60,1,12,0,61,0
Michael Sheen Leaving Hollywood to Fight Rise of Populism (Update),0,3,8,47,2,9,0,55,0
Demi Lovato Is Hit With A Truly Aggressive Amount Of Slime At Kids' Choice Awards,0,3,15,51,1,14,0,66,0
"Ramesses II, victor of Kadesh: a kindred spirit of Trump?",0,3,5,40,3,9,0,45,0
Russia Warns U.S. Not to Use Force Unilaterally Against N. Korea,0,3,11,40,3,10,0,51,0
Violence erupts after game at 2007 FIFA U-20 World Cup,0,1,8,30,1,9,6,38,0
Silvio Berlusconi convicted of sex with underage prostitute,0,1,2,50,0,7,0,52,0
Romania plans to send more troops to Iraq,0,1,2,32,0,7,0,34,0
Northwestern Football Players Re-enact Basketball Game-Winner vs. Michigan,0,3,8,56,3,7,0,64,0
Squirrel banned from Finnish supermarket,0,1,2,34,0,4,0,36,0
Trump’s claim that it is ‘very tough’ for Christian Syrians to get to the United States,0,2,5,64,3,15,0,69,0
Ice hockey: Blackhawks score two goals in 28 seconds to gain 2-0 series lead in the 2010 Stanley Cup Finals,0,1,5,73,2,19,8,78,0
'Nuclear option' expected after Democrats filibuster Neil Gorsuch Supreme Court nomination ,0,2,6,72,2,11,0,78,0
College Lecturer Punched In The Face And Knocked Into Freezing Canal For ’Being White’,0,2,14,57,2,13,0,71,0
March Madness 2017: How to stream NCAA tournament games,0,3,7,35,1,8,4,42,0
College Football Teams Having the Most Success on the 2018 Recruiting Trail,0,3,8,52,0,11,4,60,0
China launches app to aid reporting of child trafficking,0,3,1,47,0,8,0,48,0
"One shop defies court order, one shop returns to work in Dublin Thomas Cook occupation",0,1,4,67,1,14,0,71,0
Sessions once asked Yates about AG's responsibility to say 'no' to a president ,0,2,4,59,3,13,0,63,0
Stephen Curry Passes Kobe Bryant for 11th Most 3-Pointers in NBA History,0,2,11,46,1,11,3,57,0
"Looking You Over, With a Shameless Gaze",0,1,6,26,1,6,0,32,0
San Francisco hit-and-run suspect caught after lying,0,1,2,42,2,6,0,44,0
Police launch murder inquiries after two men die in unrelated shootings,0,3,1,60,0,10,0,61,0
Dibaba’s comeback: Long-distance track star wins her first World Championship title since 2007,0,1,4,71,3,12,4,75,0
Apple Announces iOS 9 with Smarter Siri & Real Multitasking,0,2,8,40,1,9,1,48,0
Toxic wetlands may be cause of thousands of bird deaths in Western Australia,0,1,3,61,0,12,0,64,0
Farmers Lead a Bid to Create 2 Californias,0,1,5,29,0,7,1,34,0
Escaped Alone Finds Comfort at the End of the World,0,2,6,36,0,9,0,42,0
Ohio father overdoses in car with infant while mother overdoses at home with kids ,0,2,1,67,0,14,0,68,0
"Steph Curry's Secrets to Success: Brain Training, Float Tanks and Strobe Goggles",0,3,10,56,3,11,0,66,0
New Bid to Find Missing Ex-F.B.I. Agent,0,1,9,20,4,6,0,29,0
"A Mexican politician demonstrated how to put on a condom with your mouth, and people are furious The list",0,3,3,83,1,18,0,86,0
Duck boat tours are ear-bleeding fun,0,3,1,29,1,5,0,30,0
Family fears British girl who went to Syria is dead,0,2,3,39,0,9,0,42,0
"No hug, but Tom Brady and Roger Goodell still effectively bury Deflategate",0,3,6,56,1,11,0,62,0
Naked Miley Cyrus attempts to outdo Kim Kardashian's Paper magazine cover by posing with her pet pig,0,3,6,77,1,16,0,83,0
United States National Soccer Teams Get New Red Nike Uniforms for 2017,0,3,10,45,0,11,4,55,0
VMwareVoice: A CIO Perspective,0,3,8,18,1,3,0,26,0
Basketball-Playing Brothers Are Together and Apart on the Court,0,1,7,47,1,8,0,54,0
The Many Sources Governing Warfare,0,1,5,25,0,4,0,30,0
"Options, and Hurdles, in Speeding Vaccines",0,1,4,31,2,5,0,35,0
Trump starts healthcare judgment day by attacking the conservative Freedom Caucus in Twitter tirade,0,2,4,82,0,13,0,86,0
Is the Pope worried about hackers? Snap shows pontiff reading from an iPad with camera blocked by a sticker,0,3,4,84,1,18,0,88,0
A Polite Forum for a Careful Confession,0,1,5,28,0,6,0,33,0
Indonesian anti-corruption chief convicted of murder,0,1,1,45,1,5,0,46,0
Anthony Bourdain bashes fellow ‘privileged Eastern liberals’ for making Trump win possible,0,2,4,73,2,11,0,77,0
Istanbul attack: Turkish police detain two foreigners at city's airport after nightclub shooting,0,2,2,80,2,12,0,82,0
"Greeks prepare to evacuate 75,000 to defuse WWII bomb ",0,2,5,34,1,9,5,39,0
Nebraska Farmer Politely Schools Fox News Host On Dangers Of Keystone XL Pipeline,0,3,14,55,0,12,0,69,0
Watch La Banda Sinaloense MS de Sergio Lizarraga Perform at the 2017 Billboard Latin Music Awards,0,2,13,65,0,15,4,78,0
Miles Franklin Literary Award nominates only women for potential winners,0,1,4,59,0,9,0,63,0
A 24-year-old's 'death from overwork' causes Japan to rethink work-life balance,0,3,2,59,6,10,2,61,0
Girl Guides Of Canada Halts Travel To U.S. Over Border Concerns,0,2,12,39,2,10,0,51,0
Tupac Shakur's Hail Mary makes surprise appearance at carol service,0,2,4,53,1,9,0,57,0
Law Enforcement K-9 Can't Hide How Much He Loves His Partner,0,3,11,36,2,10,1,47,0
Duke of Edinburgh leaves UK hospital following exploratory surgery,0,1,4,54,0,8,0,58,0
The Awards That Should've Been Given Out at the 2017 Grammys,0,2,8,37,1,10,4,45,0
Labour MP claims it's 'highly probable' Russia interfered with Brexit referendum,0,3,5,62,3,10,0,67,0
McCain: A Lot of Media Coverage of Obama Was 'Borderline Propaganda'  Insider,0,3,11,51,3,12,0,62,0
Trump blasts foreign worker program at company that pays below-average wages to foreign workers,0,2,1,80,1,13,0,81,0
"UK among top five countries best equipped for the post-Brexit era, new study shows",0,3,3,64,2,13,0,67,0
"Dumpster Fires, Fishing And Travel: These Republicans Are Sitting Out The RNC",0,2,14,50,2,11,0,64,0
"What are the odds? Mom, dad, son all share a birthday",0,2,2,38,3,10,0,40,0
Liberty Mutual Makes Its Point With a Family Drama,0,1,8,34,0,8,0,42,0
World Cup Power Rankings After Latest Round of Qualifiers,0,3,8,41,0,8,0,49,0
United Airlines flight reportedly makes emergency landing after engine issue ,0,3,2,65,0,10,0,67,0
Outrage as Italian judge clears man of raping a woman on a hospital bed because she didn't SCREAM,0,2,8,71,1,17,0,79,0
MasterChef episode 1 review: Maria oozed self-confidence – but will her cooking match up? ,0,3,3,68,4,14,1,71,0
Joseline Peña-Melnyk for Congress,0,2,4,25,1,3,0,29,0
"Sen. Jeff Sessions Blamed Culture, Not Guns, For Columbine Massacre",0,2,10,45,3,9,0,55,0
Warren Buffett Lists Longtime Laguna Beach Home for $11 Million,0,3,8,43,1,9,2,51,0
Parole panel delays decision on whether to release Charles Manson follower ,0,2,3,61,0,11,0,64,0
Tory councillor suspended over 'completely unacceptable' racist tweet depicting Diane Abbott as ape,0,3,3,82,2,12,0,85,0
Australian model Ethan Turnbull saves New York teens from icy Central Park pond,0,3,7,60,0,12,0,67,0
Singapore sings for return of Terrex army vehicles,0,3,2,41,0,7,0,43,0
The Most Popular Pro-Life Law,0,2,6,18,1,4,0,24,0
This Tiny Camera Could Give Micro-Drones Some Amazing Abilities,0,2,10,44,1,8,0,54,0
Soul singer Sharon Jones dead at 60,0,2,3,24,0,6,2,27,0
Controversy spreads over Libertarian U.S. presidential nominee Bob Barr,0,1,6,55,2,8,0,61,0
Death of Teen Athlete a Reminder That Flu Can Kill Anyone,0,3,9,38,0,10,0,47,0
Settlement Clears Way for Aid to Sacramento,0,1,5,32,0,6,0,37,0
Patriots owner Bob Kraft explains the reason behind his loyalty to Donald Trump,0,3,5,62,0,12,0,67,0
Viral Cooking Sensation Auntie Fee Dead at 59,0,3,6,30,0,7,2,36,0
"After deadly Italian avalanche, a glint of ‘hope’ — 3 puppies rescued from the rubble",0,3,2,64,4,14,1,66,0
Anger over corrupt politicians could open door to ’Bulgaria’s Trump’,0,2,3,53,3,9,0,56,0
3 Die in Turkey in Shootout Between Police and Militant,0,1,6,39,0,9,1,45,0
The Justice Department will file an appeal challenging a judge's block of Trump's travel ban,0,2,4,72,2,14,0,76,0
Phil Jackson and Jeanie Buss Announce the End of Their Engagement,0,3,8,47,0,10,0,55,0
Cruises Cunard's Queen Victoria cruise ship is getting a £34m facelift – here's how it will look,0,3,4,70,4,16,2,74,0
‘The Comedian’ Review: Graying Performer Works Blue,0,2,7,35,3,6,0,42,0
"Texas Mom, 92, Finally Adopts Daughter, 76, After 6 Decades of Waiting - Yahoo",0,2,9,46,5,13,5,55,0
Fox News and Bill O’Reilly reportedly paid out $13 million to women who accused him of sexual harassment,0,2,5,78,2,17,2,83,0
Shakira Invites Fans to Show Off Their 'Chantaje' Dance Moves,0,3,9,41,2,9,0,50,0
Suicide bombers blast two Bangladeshi cities,0,1,2,37,0,5,0,39,0
"Debt collection, impostor scams top consumer complaints ",0,2,1,47,1,7,0,48,0
Israel Can't Avoid the Settlement Talk Anymore,0,2,6,33,1,6,0,39,0
Meet Twitter’s new product chief: Jack Dorsey,0,2,4,33,2,6,0,37,0
Trump Picks Lt. Gen. H.R. McMaster as New National Security Adviser,0,2,12,41,4,10,0,53,0
Germany migrants: Record number opt to leave - most to Balkans,0,3,3,47,2,10,0,50,0
Allies Ponder How to Plan Elections in Afghanistan,0,1,6,37,0,7,0,43,0
Money Doesn’t Buy Happiness (In America),0,2,6,26,3,5,0,32,0
Australian Prime Minister denies striking a deal with predecessor,0,1,3,54,0,8,0,57,0
"Second Turk dies from bird flu, more suspected to be infected",0,1,2,48,1,10,0,50,0
After Jo Cox: the unsung MPs quietly making Britain better,0,2,6,42,1,9,0,48,0
"Manus Island medical clinic may be shut down, PNG Government says",0,3,6,48,1,10,0,54,0
Brazil ordered to pay $5m to workers formerly enslaved on cattle ranch,0,3,1,56,1,11,1,57,0
Justin Bieber Wants You To Know He Didn't Piss His Pants,0,3,11,34,1,10,0,45,0
"Jason Collins, John Amaechi fire back at homophobic comments from Amar’e Stoudemire",0,2,6,64,2,11,0,70,0
The Week in Pictures: Jan. 13 - 20,0,2,4,16,3,7,4,20,0
"Trained dolphins recruited to locate, save elusive porpoise from extinction ",0,3,1,64,1,10,0,65,0
"Before We Let Wolverine Go Forever, Here Are 12 Quotes That'll Always Be Etched In Our Memories",0,3,16,59,2,16,2,75,0
Microsoft Songsmith Is Easy (if Painful to Hear),0,1,6,33,2,7,0,39,0
"Mindful of Violence, the N.F.L. Rules Out the Wedge Formation",0,1,9,39,4,9,0,48,0
6.5 magnitude earthquake hits off California coast,0,1,1,40,1,6,2,41,0
Gates Looks to Tougher Approach on North Korea,0,1,6,33,0,7,0,39,0
Advertisers Change Game Plans for Super Bowl,0,1,6,32,0,6,0,38,0
US president Barack Obama backs mosque near Ground Zero site,0,1,6,45,0,9,0,51,0
Here's What It Was Like To Be At Rihanna's Biggest Fashion Show Yet,0,2,13,40,2,12,0,53,0
"India's Agni-III test termed a ""partial success"".",0,1,5,33,5,6,0,38,0
Less 'buzz' in bee's brains; Wikinews interviews Dr Sally Williamson about pesticide effect on bees,0,1,5,76,4,14,0,81,0
Rebecca Ferguson Wants To Perform 'Strange Fruit' At Trump Inauguration,0,3,10,50,2,9,0,60,0
U.S. forces settle into Afghan Taliban heartland,0,1,4,36,2,6,0,40,0
Smartphone screens could soon repair themselves thanks to breakthrough self-healing material,0,2,1,80,1,10,0,81,0
March sadness: Faces of defeat,0,2,2,23,1,4,0,25,0
Gulf Oil States Seeking a Lead in Clean Energy,0,1,7,31,0,8,0,38,0
"Trump Budget Takes Hatchet To EPA And Foreign Aid, Adds Billions To Military",0,3,15,48,1,12,0,63,0
Prosecutors drop assault case against former US VP Gore,0,1,6,41,0,8,0,47,0
Man dies as car hit by train at level crossing,0,3,1,36,0,9,0,37,0
"Gunman shoots during board meeting in Florida, then kills self",0,1,2,50,1,9,0,52,0
"Katy Perry Releases ""Chained to the Rhythm,"" f/ Bob Marley's Grandson, Skip Marley",0,3,10,54,6,12,0,64,0
Southern Minnesota plane crash kills eight,0,1,2,35,0,5,0,37,0
Memory of Pat Tillman Lives On in Phoenix,0,1,6,28,0,7,0,34,0
"Colombia president: 112 people confirmed dead after river overflows, toppling homes ",0,2,1,67,2,11,3,68,0
'Bachelor' star Chris Soules arrested for leaving the scene of a fatal accident ,0,3,3,62,2,13,0,65,0
Both Sides Await Court Decision on Same-Sex Marriage in California,0,1,9,47,1,9,0,56,0
11th suspect arrested in Laos overthrow plot; indictments handed down,0,1,1,56,1,9,2,57,0
U.K. Manufacturing Unexpectedly Drops Most in Eight Months,0,3,8,41,2,7,0,49,0
Tanzania police killed in highway ambush,0,2,1,34,0,5,0,35,0
"In Reversal, Boston St. Patrick’s Day Parade Welcomes Gay Veterans Group ",0,2,11,48,3,11,0,59,0
Don Dale: Mother's search for answers over son's treatment in youth detention,0,2,3,60,3,11,0,63,0
’Angry Police Wives’ March Against Failure To Protect Officers On Eve Of French Elections,0,2,14,60,2,13,0,74,0
Here's The Law That Poses The Greatest Threat To Donald Trump,0,3,11,39,1,10,0,50,0
Pilot's flight pattern delivers New Year's message from above,0,2,3,48,2,8,0,51,0
Texas Ranchers and Farmers Struggle in Drought,0,1,5,35,0,6,0,40,0
Beyoncé ’gives birth to twins’,0,2,1,23,2,4,0,24,0
"Mizoram CM Lal Thanhawla Says That Not Just Commoners, Even Politicians Across India Are Racist",0,3,16,64,1,14,0,80,0
Australian sport may be on the cusp of change,0,1,1,36,0,8,0,37,0
Pakistan 'launches first cruise missile from submarine',0,2,1,46,2,6,0,47,0
Yahoo Discloses New Breach of 1 Billion User Accounts,0,3,7,37,0,8,1,44,0
Golfers Test Limits of Good Sense in Golf Carts,0,1,7,32,0,8,0,39,0
Motorcyclist takes global adventure after ex-boyfriend deemed it 'too dangerous' for her,0,2,1,73,3,11,0,74,0
"Berlin Truck Attack Suspect Anis Amri’s Death Sparks Anger, Fear in Italy",0,3,11,49,2,11,0,60,0
Islamic State Group Claims Berlin Christmas Market Attack,0,3,8,42,0,7,0,50,0
Bill De Blasio Is Waiting On Hillary Clinton To Speak Out On Trade,0,3,13,41,0,12,0,54,0
India’s Modi eyes victory in biggest state election test,0,2,2,45,1,8,0,47,0
Activists remember Burundi's Gatumba massacre,0,1,3,37,1,4,0,40,0
The Guardian view on internet privacy: technology can’t fix it,0,3,2,49,2,9,0,51,0
Hawks GM Wes Wilcox Makes Racially Insensitive Joke at Fan Event,0,3,11,43,0,10,0,54,0
Court to Issue Decision on Trump Immigration Order Today,0,3,7,41,0,8,0,48,0
Teacher makes GoFundMe to 'buy' senator's vote on Betsy DeVos,0,3,7,42,3,9,0,49,0
"Aaron Rodgers reportedly hasn’t spoken to his family in 2 years, and some think it’s throwing off his game",0,2,2,82,3,18,1,84,0
The Latest Precocious Teenager Loses,0,1,5,27,0,4,0,32,0
France elections: Fillon setback as wife video resurfaces,0,2,2,47,1,7,0,49,0
6.3 magnitude quake strikes Papua New Guinea,0,1,3,32,1,6,2,35,0
"In India, low-caste Dalits put dignity before livelihood, by leaving cows where they die",0,2,3,69,3,13,0,72,0
Singapore sentences Saudi diplomat to caning 'for molesting hotel intern',0,3,2,60,2,9,0,62,0
Iceland formally recognises Palestinian state with pre-1967 borders,0,1,2,53,1,7,4,55,0
"Blood-thinners Xarelto, Eliquis and Pradaxa marketed to doctors as drug companies splash cash",0,3,4,75,2,12,0,79,0
Justices Skeptical on North Carolina Law Barring Sex Offenders From Social Media ,0,3,11,58,0,12,0,69,0
Nintendo’s Switch Console Has Strong First Month in the U.S. ,0,2,9,39,3,10,0,48,0
World Bank Sees Slump in Russia Worsening,0,1,6,29,0,6,0,35,0
"NBA 3-Point Contest 2017: Complete Participant List, Comments and Reaction",0,2,10,47,3,9,5,57,0
"White House said Donald Trump was in meetings, but he was pictured golfing (again)",0,3,4,62,3,13,0,66,0
"How coral of Great Barrier Reef could be saved by big, bright clouds",0,3,4,51,1,12,0,55,0
Golden Globes 2017: Tracee Ellis Ross' Historic Win 'Means a Lot' ,0,3,9,38,4,11,4,47,0
Trump executive order: US judge temporarily halts deportations,0,2,3,51,1,7,0,54,0
UK weather: Commuter delays as fresh band of fog blankets Britain on Monday,0,3,5,57,1,12,0,62,0
"Jimmy Fallon unleashes the hounds, lets puppies predict the Super Bowl",0,3,4,55,1,10,0,59,0
Turkmenistan President Niyazov dies of heart condition,0,1,3,45,0,6,0,48,0
"Christopher Steele, Ex-British Intelligence Officer, Said to Have Prepared Dossier on Trump ",0,2,11,66,3,12,0,77,0
EpiPen alternative to hit market at more than seven times the price,0,3,2,54,0,11,0,56,0
Knicks Acquire Hughes and Wilcox in Deadline Deals,0,1,6,37,0,7,0,43,0
China Intent on Requiring Internet Censor Software,0,1,6,38,0,6,0,44,0
Scientists divided over whether 'Furku.Al' rock inscription is genuinely the work of Vikings,0,3,4,73,3,12,0,77,0
"Sources: Healthy Luol Deng, Timofey Mozgov agree to sit out rest of Lakers' season",0,2,7,59,3,13,0,66,0
Russia says deadly Syrian airstrike targeted chemical weapons factory,0,3,2,59,0,8,0,61,0
"US Army website hacked, Syrian Electronic Army takes credit ",0,2,6,44,1,9,0,50,0
India may rise as regional power,0,1,1,26,0,5,0,27,0
India's flag lands on Moon,0,1,2,19,1,4,0,21,0
Melania Trump Defamation Suit Against Political Blogger Can Move Forward,0,3,10,53,0,9,0,63,0
"IPhone hits US market, strong initial sales",0,1,4,32,1,6,0,36,0
25 Hilarious Tweets About Sending Nudes,0,3,5,27,0,5,2,32,0
Quebec police report fatalities in mosque shooting,0,3,1,43,0,6,0,44,0
BlackBerry Is Back With KEYone: Android Phone With Innovative Keyboard,0,3,13,47,1,9,0,60,0
Trump facing GOP pressure to counter Russia's Arctic fleet ,0,3,6,43,1,9,0,49,0
US and Russia to sign new arms control treaty,0,1,3,34,0,8,0,37,0
Your best pictures from the week,0,3,1,26,0,5,0,27,0
Charlotte police shooting: What happens next,0,2,2,36,1,5,0,38,0
States Wire Up Roads as Cars Get Smarter,0,2,7,26,0,7,0,33,0
Nelson Mandela taken off US terrorist list,0,1,4,32,0,6,0,36,0
In pictures: The Art of Building 2016,0,3,4,22,1,6,4,26,0
Colorado College Tigers win 41st annual Great Lakes Invitational tournament,0,1,6,58,0,9,2,64,0
"Fire at mosque in Tampa, Florida, ruled arson",0,3,3,33,2,7,0,36,0
"Nigerian girl kidnapped by Boko Haram, now a mother, found with baby",0,3,3,52,2,11,0,55,0
EXCLUSIVE: India's Legion Hackers Admit They Have Nothing To Do With Anonymous.,0,2,20,45,3,11,0,65,0
Bitcoin is spiking,0,2,1,15,0,2,0,16,0
"Yogi Berra, at 83: A One-of-a-Kind Common Man",0,1,7,24,5,7,2,31,0
Elbow knitting method by woman provides creative outlet after two vehicle accidents,0,3,1,71,0,11,0,72,0
The Best Songs of 2016 ,0,3,3,11,0,5,4,14,0
Trump’s pick for national security adviser had role in firm co-led by man who tried to sell material to the KGB,0,3,4,85,2,20,0,89,0
A Convicted Murderer’s Escape Alarms Investigators From His Past ,0,2,9,46,1,9,0,55,0
Faye Dunaway says she felt 'very guilty' about Oscars envelope fiasco,0,2,3,54,2,10,0,57,0
"Obamacare is in a 'death spiral,' says Aetna CEO",0,3,5,32,3,8,0,37,0
On a SlutWalk of No Shame With Amber Rose,0,2,8,25,0,8,0,33,0
A banker-turned-Googler explains the 2 biggest differences between working in tech and finance,0,3,2,77,2,12,1,79,0
Sen. Franken Accuses Sen. Sessions of Misrepresenting His Record on Civil Rights ,0,3,10,57,2,12,0,67,0
Bethlehem icons created by artists,0,2,1,29,0,4,0,30,0
Child's heartbreaking letter to dead father found tied to ballon,0,2,1,53,1,9,0,54,0
"Sushi lovers, beware: Tapeworm now found in U.S. salmon",0,3,4,39,4,8,0,43,0
"Wikipedia and Britannica about as accurate in science entries, reports Nature",0,1,3,63,1,10,0,66,0
Russian pilot crashes in Lithuania,0,1,2,28,0,4,0,30,0
2009–10 UEFA Champions League: Round of 16 field set,0,1,7,27,2,8,8,34,0
Hurricane Vince on track for Europe,0,1,3,27,0,5,0,30,0
Global youth conference on genocide begins in Kigali,0,1,2,43,0,7,0,45,0
Gilberto Nunez case: Judge has harsh words for dentist at sentencing,0,3,3,54,1,10,0,57,0
Did You Know That Snapchat Is Secretly Eating All Of Your Data,1,1,12,39,0,11,0,51,0
What Are Taxpayers Willing To Do To Avoid Paying Taxes?,1,3,10,35,1,9,0,45,0
"Which ""Scream Queens"" Character Are You",1,1,6,26,2,5,0,32,0
Sailor Senshi Imagined As Disney Princesses,1,1,6,32,0,5,0,38,0
How Well Do You Remember These Game Boy Games,1,1,9,28,0,8,0,37,0
Tony Nominees' Craziest Moments on Stage,1,2,5,29,1,5,0,34,0
"Ryan Reynolds Got Dunked On ""Ellen"" To Raise Money For Make-A-Wish Foundation",1,1,14,48,4,11,0,62,0
A Bride Held Her Wedding Reception At An Alzheimer's Home So Her Mom Could Attend,1,1,15,51,1,14,0,66,0
27 Professors Who Got The Last Laugh,1,1,6,22,0,6,2,28,0
Migrants Sexually Attack Girls at City Hall Youth Party,1,3,8,39,0,8,0,47,0
Do You Know The Numbers Missing From These Movies,1,1,9,32,0,8,0,41,0
8 Soups and Toddies that Will Save Your Sick Day,1,1,7,31,0,9,1,38,0
What President Trump has ordered in his first days in office,1,3,3,47,0,10,0,50,0
A Chair Lift Broke Down In Banff And Skiers Had To Rappel Down Ropes,1,1,14,41,0,13,0,55,0
How Taylor Swift Reversed Female Opinion To Become The Most Famous Pop Star In The World,1,1,16,57,0,15,0,73,0
This Etsy Store Sells The Most Stylish Loungewear For Geeks,1,1,10,40,0,9,0,50,0
This Cashier's Random Act Of Kindness Is Going Viral,1,1,9,34,1,8,0,43,0
Saudi king visits Indonesia with 'cars and entourage',1,3,2,42,2,7,0,44,0
"Phil Simms May Have Farted Away His Career at CBS, Literally",1,3,12,37,1,10,0,49,0
"Andrew Garfield Has Transformed From One ""Harry Potter"" Character Into Another",1,1,11,55,2,10,0,66,0
"Don't cry, all your favorite Vines will live on here",1,3,2,39,2,9,0,41,0
Study Reveals How Long Sex Lasts for the Average Couple,1,3,8,38,0,9,0,46,0
Don't Believe the Hype: Bling $70 Water vs. NYC Tap Water,1,3,10,31,4,10,2,41,0
Dad takes daughter and best friend to father-daughter dance for touching reason - Yahoo,1,2,2,70,2,13,0,72,0
Which Recent Kanye West Tweet Are You Based On Your Birth Month,1,1,12,40,0,11,0,52,0
Lawyer claims link between ex-NY police chief and unsolved Long Island murders ,1,3,5,61,1,12,0,66,0
5 Men Talk About Their Struggles With Body Image,1,1,8,31,0,8,1,39,0
This Apple Move Might Strike Fear Into Advertisers,1,3,8,35,0,7,0,43,0
23 Words That Are Spelled Differently In Canada,1,1,7,31,0,7,2,38,0
Self-Styled Godman 'Builder Baba' Who Owned A Bar In Noida Arrested In Multi-Crore Fraud Case,1,3,17,58,4,14,0,75,0
14 Reasons Why Rainbow Colors Look Gorgeous On Black Hair,1,1,9,37,0,9,2,46,0
What London’s Libor Traders Did Next,1,3,6,24,1,5,0,30,0
Retirement Checkup,1,3,2,15,0,1,0,17,0
"Mark Zuckerberg Does Pull-Ups With His Daughter Max, Insists She Is The 'Most Demanding Trainer'!",1,2,16,62,5,14,0,78,0
Are You More Katniss Or Furiosa,1,1,6,20,0,5,0,26,0
13 Magical Facts About Sex In The Wizarding World,1,1,8,31,0,8,2,39,0
This Puzzle Is For Everyone Who Doesn't Remember Last Night,1,1,10,39,1,9,0,49,0
Steph Curry's New Baby Daughter Had A Blast At Her First Basketball Game,1,1,13,46,1,12,0,59,0
Which Artist Is Winning 2016 So Far? Vote!,1,2,7,22,2,7,4,29,0
Pocket Kittens Are Real And Here Is What You Should Know About Them,1,1,13,42,0,12,0,55,0
"Jennifer Lawrence Wore A Jacket That Says ""Perv""",1,1,8,31,2,7,0,39,0
The man who has President Trump's ear,1,2,3,27,1,6,0,30,0
Can We Guess Your Age With Gay Porn,1,1,8,20,0,7,0,28,0
"24 ""Yo Momma"" Jokes That Are So Bad They're Actually Good",1,1,10,32,3,10,2,42,0
Here Are All The Parts Of A Cat You Need To Know,1,1,12,25,0,11,0,37,0
Taylor Swift Performing At Stagecoach Is Actually You On The Weekend,1,1,11,47,0,10,0,58,0
People Are Loving This Dog Who Came Out Of Surgery And Can't Stop Smiling,1,3,14,45,1,13,0,59,0
What’s Wrong With This Photo of Melania Trump and Queen Rania?,1,3,9,41,2,10,0,50,0
Busy Philipps' Elf On A Shelf Creations Are Absolute Genius,1,1,10,39,1,9,0,49,0
The week's happy news,1,3,1,16,1,3,0,17,0
Can We Guess How Sensitive You Are Based On This One Question,1,1,12,38,0,11,0,50,0
This Visual Test Will Determine If You’re An Optimist Or A Pessimist,1,3,12,44,1,11,0,56,0
Are You A Kardashian Or A Jenner,1,1,7,19,0,6,0,26,0
Damn! What Percent Daniel Are You,1,1,6,21,1,5,0,27,0
These Dads Working Out With Their Babies Prove That Fitness Is Forever,1,1,12,47,0,11,0,59,0
30 Tips For Buying And Selling Clothes On eBay Like A Champion,1,1,11,38,0,11,2,49,0
The Artist Behind Iconic Disney Films Drawing In Virtual Reality Is Incredible,1,1,12,55,0,11,0,67,0
This Video Of Teenage Kendall And Kylie Jenner Lip-Synching To Taylor Swift Is Amazing,1,1,15,57,1,13,0,72,0
Tell Us About Your Self(ie): Sabrina Carpenter,1,1,7,30,3,6,0,37,0
14 Adorable Animals Giving You Kind Of OK Advice,1,1,9,29,0,8,2,38,0
MSNBC’s Reid: Voice of America Broadcast Network Could Become ‘Essentially Breitbart’,1,2,14,57,4,10,0,71,0
California City Changes Name From San Bernardino To Bernie Sanderino In My Dreams,1,1,13,56,0,12,0,69,0
The Strange Case Of The Woman Whose Skin Was Turned Into A Book,1,1,13,38,0,12,0,51,0
Robots might be saving the world from a demographic disaster,1,3,1,50,0,9,0,51,0
27 Times Amazon Packaging Needed To Chill The Fuck Out,1,1,9,34,0,9,2,43,0
Do Americans think Donald Trump will be a good president?,1,3,4,43,1,9,0,47,0
"Rafael And Michael From ""Jane The Virgin"" Have The Cutest Bromance In Real Life",1,1,14,50,2,13,0,64,0
21 Insane Gadgets To Make Your iPhone Even Cooler,1,1,8,31,0,8,2,39,0
MashReads Podcast: 'The Shining' perfectly understands your winter cabin fever,1,3,5,61,3,9,0,66,0
"The Cast Of ""The L Word"" Have Aged Incredibly Well",1,1,10,29,2,9,0,39,0
12 Incredible Photos Of An Icelandic Glacier That Will Make You Want To Go There Right Now,1,1,16,56,0,16,2,72,0
Judah Friedlander's Opinion On 15 Random Things,1,1,6,32,1,6,2,38,0
"Natalie Dormer Auditioned For A Completely Different Role On ""Game Of Thrones""",1,1,12,53,2,11,0,65,0
WATCH: Fatah Song On Palestinian Authority TV Calls To ‘Slice Open’ Israel’s Chest,1,3,18,48,4,12,0,66,0
Which EDM Artist Are You Based On Your Favorite Pizza,1,1,12,32,0,9,0,44,0
"Statistics Professor Wins $100K Lottery, Shares Lottery Tip - Yahoo",1,3,9,43,3,9,3,52,0
PewDiePie taught YouTube a valuable lesson,1,3,5,32,0,5,0,37,0
The Secret To Treating Autoimmune Disease May Lie In The Gut,1,3,11,39,0,10,0,50,0
"21 Truths Dev And Rachel Taught You About Love On ""Master Of None""",1,1,12,38,2,12,2,50,0
A Chicken Nugget King,1,1,4,14,0,3,0,18,0
The 13 biggest snubs of the 2017 Golden Globe nominations,1,3,3,39,0,9,6,42,0
18 Sweet Pumpkin Treats You Won't Believe Are Healthy,1,1,8,34,1,8,2,42,0
37 Things Donald Trump Is Probably Doing Today,1,1,7,30,0,7,2,37,0
Katy Perry: ‘I Did More’ Than Just Kiss a Girl During Christian Upbringing,1,3,12,47,3,12,0,59,0
24 Cakes That Want To Be Your Everything,1,1,7,24,0,7,2,31,0
52 Things That Mildly Thrill All Twentysomething Grandmas,1,2,7,41,0,7,2,48,0
Louisville player confuses CBS reporter for Jacksonville State spy,1,3,6,52,0,8,0,58,0
28 Chocolate And Peanut Butter Treats That Are Even Better Than Reese's,1,1,11,46,1,11,2,57,0
Fox instantly regrets attempting to pounce on vole hiding in snow,1,3,1,54,0,10,0,55,0
23 Gifts Every Unicorn Lover Needs In Their Life,1,1,8,30,0,8,2,38,0
Watch Britney Spears Paint Leaves,1,1,5,24,0,4,0,29,0
"How ""Fixer Upper"" Fans Helped This Couple Adopt Their First Baby [Video]",1,3,12,45,4,11,0,57,0
"How Well Do You Remember ""The Parent Trap""",1,1,8,25,2,7,0,33,0
"What's The Funniest Moment From ""Elf""",1,1,6,23,3,5,0,29,0
"A Man Named ""Phuc Dat Bich"" Posted His Passport Photo To Facebook After Being Banned Multiple Times",1,1,17,64,2,16,0,81,0
21 Parents Who Made Us Laugh In 2015,1,1,6,17,0,7,6,23,0
Why This Architect Is Spending 10 Years Building A Swimming Pool,1,3,10,42,0,10,2,52,0
10 Insanely Delicious Smoothies To Fuel Your Trip To The Gym,1,1,10,38,0,10,2,48,0
15 Ways To Take Leftover Queso De Bola To The Next Level,1,1,11,32,0,11,2,43,0
Watch 80 Years Of Women's Eyewear In 120 Seconds,1,1,7,27,1,8,5,34,0
This Instagram Account Hilariously Captures Real Life Situations On Post-Its,1,1,11,55,1,9,0,66,0
Are You More Jimmy Fallon Or Stephen Colbert,1,1,8,29,0,7,0,37,0
WashPost: ‘Never Trump’ Republicans Complain About Never Getting a Job at the New White House,1,2,13,63,3,14,0,76,0
Democrats Bet on Buyer’s Remorse In Trump Speech Response,1,2,8,40,1,8,0,48,0
What It's Like To Have A Micropenis,1,1,7,21,1,6,0,28,0
15 best children's books of all time,1,3,0,27,1,6,2,27,0
Everything Donald Trump Looked Like In 2015,1,1,6,27,0,6,4,33,0
The Worst Time Of Year For The Most Patient And Polite Man On The Internet Has Begun,1,1,17,51,0,16,0,68,0
21 Things Tidy People Have To Deal With On A Daily Basis,1,1,11,32,0,11,2,43,0
Marco Antonio Solis And Jesus Christ Look The Same And It's Freaking Me Out,1,1,14,47,1,13,0,61,0
21 Super Calming Spaces That Will Make You Want To Meditate Right Now,1,1,12,43,0,12,2,55,0
"23 Pictures That Will Make You Say ""Huh.""",1,1,7,22,3,7,2,29,0
"Maher: Trump Violates ‘Pay Your Taxes’ Rule, I Worry ‘We Do Need the UN to Step In’",1,3,16,45,6,16,0,61,0
23 Things Anybody Who Has Ever Dated A Boy Will Understand,1,1,10,36,0,10,2,46,0
"The Cast Of ""Parks And Rec"" In Their First Episode Vs. Their Last Episode",1,1,14,43,3,13,0,57,0
A Photographer Took Pics Of Cats From Underneath To Show Us A Side Of Them Rarely  Seen,1,1,17,53,0,17,0,70,0
21 Mexican Food Moments That Are Oddly Satisfying,1,1,7,33,0,7,2,40,0
Instagram Star Reveals The Truth Behind Her Photos,1,1,8,35,0,7,0,43,0
"OK, calling it: This little boy stars in 2016's most heartwarming Christmas video",1,2,4,58,3,12,4,62,0
"Pat Buchanan: Bitter Obama in ‘Despair,’ Leaving With ‘Let’s Wreck the Place’ Attitude",1,3,11,56,7,12,0,67,0
The Top 21 Hillary Clinton Faces At The Benghazi Committee,1,1,9,38,0,9,2,47,0
24 Eating Experiences That Are Surprisingly Disturbing,1,1,6,40,0,6,2,46,0
Chelsea Handler Will (Probably) Never Get Married,1,1,7,34,2,6,0,41,0
When You're Single AF,1,1,5,12,1,3,0,17,0
John Legend: Trump Has ‘Already Done Enough to Be Impeached’,1,3,9,39,3,9,0,48,0
Thanksgiving On The AMAs Red Carpet,1,1,8,22,0,5,0,30,0
15 Things Your Dentist Actually Wants You To Know,1,1,8,31,0,8,2,39,0
11 Works Of Art Inspired By Madonna,1,1,6,21,0,6,2,27,0
Do You Know The Original Names Of Famous Brands,1,1,9,30,0,8,0,39,0
"Reminder That ""Gilmore Girls"" Is The Most Autumn Show Of All Time",1,1,12,40,2,11,0,52,0
31 British Men Who Just Wanted You To Love Them In 2015,1,1,10,28,0,11,6,38,0
This Color Test Will Determine The Type Of Sex You Like,1,1,11,34,0,10,0,45,0
"It Looks Like Philae, The Little Robot That Landed On A Comet, Is Dead",1,1,14,41,2,13,0,55,0
19 Eggless Breakfasts That Are Actually Healthy And Delicious,1,1,8,43,0,8,2,51,0
There's a 20% chance you have a particular form of synesthesia,1,2,1,47,2,10,2,48,0
Diplomatic assassinations have a long and tragic history,1,2,1,48,0,7,0,49,0
How Much Do You Actually Know About Cooking,1,1,8,28,0,7,0,36,0
The Daily Show's Trevor Noah compares Donald Trump's America to apartheid in his home country of South Africa,1,3,10,80,2,17,0,90,0
The female soldiers serving in Israel's army,1,3,2,35,1,6,0,37,0
Which Fairy Are You Based On Your Zodiac,1,1,8,25,0,7,0,33,0
DELINGPOLE: Environmentalists Aren’t Just Wrong. They’re Loathsome And Evil Too.,1,3,19,47,5,9,0,66,0
Inside a Moneymaking Machine Like No Other,1,3,6,30,0,6,0,36,0
Galleries This country has more islands than any other on Earth – and these are the best,1,3,3,68,1,16,0,71,0
29 Of The Most WTF Moments From The 2016 BAFTAs,1,1,14,18,0,9,6,32,0
These Are the Happiest and Healthiest Cities in America,1,3,6,41,0,8,0,47,0
An Artist Has Reimagined Popular TV Shows With An All-POC Cast,1,1,15,36,1,10,0,51,0
What Cake Matches Your Personality,1,1,5,25,0,4,0,30,0
If Recent Albums Had More Accurate Titles,1,1,7,28,0,6,0,35,0
PPE: the Oxford degree with a lot to answer for,1,2,4,33,1,9,0,37,0
23 Scones That Are Here To Shake Up Tea Time,1,1,9,24,0,9,2,33,0
5 Things That Could Decide Super Bowl LI ,1,3,8,24,0,8,1,32,0
"Every ""High School Musical"" Song, Ranked From Worst To Best",1,1,10,37,3,9,0,47,0
17 People Who Probably Didn't Get Their Money's Worth,1,1,8,33,2,8,2,41,0
"Someone tried to mail a box of deadly horrors to Australia, and geez it's creepy",1,2,2,62,2,14,0,64,0
Baked Chicken Tenders Recipe - NYT Cooking,1,3,8,27,1,6,0,35,0
Can You Tell If This Is A Wig,1,1,8,14,0,7,0,22,0
This Makeup Artist's Celebrity Transformations Are Spectacular,1,1,7,48,1,6,0,55,0
19 Ways To Throw Your Kid The Ultimate Birthday At Disneyland,1,1,10,39,0,10,2,49,0
The One Perk Of Being A Vegetarian That No One Ever Talks About,1,1,13,38,0,12,0,51,0
What Would You Never Do In Front Of Your Significant Other,1,1,11,37,0,10,0,48,0
7 Quick Tips For Anyone Trying To Eat Healthier,1,1,8,30,0,8,1,38,0
Francois Hollande Will Not Seek Re-Election as French President,1,3,9,45,1,8,0,54,0
Love Actually Brings Together Every Fandom Ever And It's Actually Lovely,1,1,11,50,1,10,0,61,0
"This Is What The Cast Of ""The Fresh Prince Of Bel Air"" Would Look Like In 2015",1,1,16,40,2,16,4,56,0
"15 Things You Never Knew About The Cast Of ""Pride And Prejudice And Zombies""",1,1,13,46,2,13,2,59,0
"This Mom's Parody Of The Weeknd's ""I Can't Feel My Face"" Totally Nails Back-To-School Life",1,1,17,52,7,14,0,69,0
17 Times Oprah Was The Most Relatable Billionaire Ever,1,1,8,36,0,8,2,44,0
17 Beautifully Untranslatable Hindi Words You Should Add To Your Vocabulary Right Now,1,1,12,59,0,12,2,71,0
Literally Just 19 Very Large Cats,1,2,5,21,0,5,2,26,0
Wild Ways People Use The Placenta,1,1,6,22,0,5,0,28,0
We Know What You And Your S.O. Love Most About Each Other,1,2,13,31,2,11,0,44,0
"Ruby Rose And Nina Dobrev Are Slated To Join Deepika Padukone In ""XXX: The Return Of Xander Cage""",1,1,20,57,3,17,0,77,0
This 4-year-old made an unlikely friend at the grocery store,1,3,1,47,2,9,1,48,0
"The president of Iceland can't ban pineapple on pizza, even if he wanted to The list",1,3,3,64,2,15,0,67,0
How Bitchy Are You,1,1,4,11,0,3,0,15,0
Family Spends Freezing Night in Car After GPS Directions Leave Them Stranded - Yahoo,1,2,14,56,1,13,0,70,0
Do You Actually Prefer Ryan Gosling Or Ryan Reynolds,1,1,9,35,0,8,0,44,0
26 Quirks Americans Don’t Realize Are Super Weird,1,2,7,32,1,7,2,39,0
19 Of The Most Influential Canadians As Youngsters,1,1,7,34,0,7,2,41,0
What Disney Gift Should You Get The Disney Fan In Your Life,1,1,12,36,0,11,0,48,0
Boys Noize Shares Unreleased Remixes in 2016 Recap Video: Watch,1,2,8,41,1,9,4,49,0
"This Sexy Calendar Is For Anyone Who Has A ""Thing"" For Redhead Men",1,1,13,39,2,12,0,52,0
25 Insanely Delicious Things To Make With 3 Ingredients,1,1,7,37,0,8,3,44,0
This is the secret code word for when The Queen dies,1,3,3,39,0,10,0,42,0
This 19-Year-Old Girl Looks Exactly Like Kylie Jenner,1,1,9,33,2,7,2,42,0
21 Of The Most Ridiculously Cute British And Irish Baby Names,1,1,10,39,0,10,2,49,0
When The WiFi Won't Connect,1,1,6,16,1,4,0,22,0
Meet the Romanian high school basketball freshman who is 7-foot-7,1,3,2,50,2,9,2,52,0
Free Up iPhone Space With These Hidden Tricks,1,2,8,30,0,7,0,38,0
‘White People Shouldn’t Breed’ Race-Hate Attacker Who Spat At Baby Avoids Jail Sentence,1,2,14,57,4,12,0,71,0
McCain: ‘I Do Not Know’ If I Have Confidence In Trump,1,3,12,28,3,10,0,40,0
An Open Letter To A Possible Future Mass Shooter,1,1,9,31,0,8,0,40,0
2017 Horoscopes for Your Favorite Dealmakers,1,3,4,31,0,5,4,35,0
Akzo Nobel Running Out of Reasons to Snub PPG,1,3,9,28,0,8,0,37,0
This is what it looks like when the US fires the missile they use for nukes The list,1,3,4,63,0,17,0,67,0
17 Comics About Being Tired That Are Too Real,1,1,8,27,0,8,2,35,0
This Is What It Looks Like To Get Tased In Slow Motion,1,1,12,31,0,11,0,43,0
"With A Growing Female Audience, Marvel Hopes To Invite Everyone In",1,1,11,44,1,10,0,55,0
27 Things Only Kids From Russian-Speaking Households Understand,1,1,8,45,1,7,2,53,0
If Hannibal Lecter Quotes Were Motivational Posters,1,1,7,38,0,6,0,45,0
Do You Have What It Takes To Be A #Girlboss,1,1,10,23,1,9,0,33,0
Academic group censures University of Illinois over rescinded job offer ,1,3,3,59,0,10,0,62,0
Which ShondaLand World Do You Belong In,1,1,8,25,0,6,0,33,0
Here's Our First Look At Punisher And Daredevil Going Head To Head,1,1,12,42,1,11,0,54,0
21 Funny T-Shirts You Can Wear Only When You're Knocked Up,1,1,11,33,2,10,2,44,0
Mariah Carey Is Peak Mariah Carey While Posing On A Beach In A Red Full Body Wetsuit,1,1,17,51,0,16,0,68,0
"Yes, a Teenager Dabbed in Front of Paul Ryan ",1,3,6,29,1,9,0,35,0
"NFLPA Uses Muslim Ban Hash Tag, Addresses Questions as if Muslim Ban is a Real Thing",1,2,16,52,1,15,0,68,0
This Texture Test Will Reveal Your Secret Ambition,1,3,8,35,0,7,0,43,0
FNC’s Wallace Battles Stein — ‘Where Do You Get Off’ Saying the American People Are Calling for a Recount?,1,3,17,66,5,18,0,83,0
"WTF, It Looks Like This Twitter Account “Predicted” Beyoncé’s Pregnancy Announcement",1,3,13,57,4,10,0,70,0
"Which ""AHS: Hotel"" Character Matches Your Star Sign",1,1,10,31,3,7,0,41,0
"What's The Funniest ""SpongeBob SquarePants"" Quote",1,1,8,33,3,5,0,41,0
Cory Booker and Bert take the selfie of your childhood dreams,1,3,3,48,0,10,0,51,0
17 Mindblowing Ways To Eat Bagels,1,1,5,21,0,5,2,26,0
Matt Damon Hilariously Reacts To Sexual Tweets About His Ponytail,1,1,10,46,0,9,0,56,0
This Is What Ursula Would Look Like If She Lived In Different Ocean Environments,1,1,14,53,0,13,0,67,0
#Envelopegate Is a Giant Headache for Accounting Firm PwC,1,3,8,40,1,8,0,48,0
The Pros And Cons Of Being A Student In Your Thirties,1,1,11,32,0,10,0,43,0
"The Rise, Fall, And Improbable Comeback Of Morris Brown College",1,1,10,42,2,9,0,52,0
"‘Game of Thrones’ recap, season 5 episode 9: ‘The Dance of Dragons’ and a great escape",1,2,5,58,6,15,2,63,0
37 Cozy Sweaters For People Who Are Literally Always Cold,1,1,9,37,0,9,2,46,0
11 Questions You Should Never Ask Someone In A Long Term Relationship,1,1,11,45,0,11,2,56,0
"Woman Goes Into Labour While Travelling, Railway Protection Force Helped Her Deliver Baby Inside A Train",1,3,16,72,1,15,0,88,0
This App Is The Best Thing For Comic Readers,1,1,9,27,0,8,0,36,0
Hilarious Reactions to Beyonce's Pregnancy Announcement,1,3,5,44,1,5,0,49,0
This Is What Disney Princesses Look Like Without Faces,1,1,9,37,0,8,0,46,0
What Would You Say If Your Company Announced They Wanted To Replace  You With Robots Someday,1,1,16,60,0,16,0,76,0
Can We Guess Your Favorite Animal Based On Your Favorite Actor,1,1,11,41,0,10,0,52,0
This Entrepreneur Started A Travel Company That Can Help You Quit Your Job,1,2,13,49,0,12,0,62,0
"She Began Digging Graves To Feed Her Four Daughters. 13 Years And 5,000 Bodies Later She Has Made Peace With The Dead",1,2,20,68,2,21,6,88,0
People Thought This Kid Faked His Perfect Pitch So He's Proving Them Wrong,1,1,13,48,1,12,0,61,0
Quiz: How well do you know the M25?,1,3,3,21,2,7,2,24,0
Here's Why Your Pee Smells Horrible After You Eat Asparagus,1,1,10,39,1,9,0,49,0
14 Texts All Ride Or Die Friends Send,1,1,7,21,0,7,2,28,0
8 Iconic Bollywood Movies That Prove Vinod Khanna Was The Most Charming Actor Of His Time,1,2,15,58,0,15,1,73,0
These Poor Pups Were Injured By A Porcupine But The Response Will Warm Your Heart,1,1,15,52,0,14,0,67,0
Prison Phone Rates: The Ripoff Continues,1,2,6,28,1,5,0,34,0
You Will Go Nuts Trying To Find The Poop Emoji In These Cupcakes,1,1,13,39,0,12,0,52,0
Welcome To The New Celebrity #IceBucketChallenge,1,1,8,34,1,5,0,42,0
"J.K. Rowling Celebrated Finishing ""Harry Potter"" By Graffitiing A Hotel Room",1,1,12,50,4,10,0,62,0
Samantha Power Warns Against Cutting US Funding to UN,1,3,10,35,0,8,0,45,0
1st drug OK’d for movement disorder caused by certain meds,1,2,2,45,1,9,1,47,0
17 Things Everyone Regrets Doing In Freshers' Week,1,1,7,33,1,7,2,40,0
"We Really, Really Need To Talk About Harry Styles' Hair",1,1,10,34,2,9,0,44,0
22 Things Only People Who Shop At Daiso Will Understand,1,1,9,35,0,9,2,44,0
The 'Saved by the Bell' diner is coming to a city near you,1,3,3,41,2,12,0,44,0
19 Times Feminists Were The Funniest People On Tumblr,1,3,8,35,0,8,2,43,0
New 10-minute eye surgery may help some toss their reading glasses,1,3,1,52,1,10,2,53,0
Obama ditched the cargo shorts â and so should you,1,2,1,40,2,9,0,41,0
These 6 systems will get rid of Wi-Fi dead spots in your house,1,2,3,45,1,12,1,48,0
"Ahsaan Qureshi Slams Sunil Grover, Twinkle Takes A Dig At Yogi Adityanath & More From Ent",1,2,15,57,2,15,0,72,0
"‘I have been fundamentally condemned to die in prison,’ a drug dealer wrote. Obama listened.",1,2,2,71,5,14,0,73,0
Want To Retire In Your 30s And Travel The World? This Woman Did,1,3,12,36,1,12,2,48,0
Watch the Cast of 'Stranger Things' Spit Bars at the Golden Globes,1,3,8,45,2,11,0,53,0
We Know How You Feel About Astrology Based On Your Sign,1,1,11,34,0,10,0,45,0
People Can Relate Hard To This Raccoon That Got Stuck On A Trash Truck,1,3,14,43,0,13,0,57,0
Are You More Unicorn Or Dragon,1,1,6,19,0,5,0,25,0
MS Dhoni Has Narrow Escape As He Is Rescued From A Fire At His Hotel In Dwarka,1,2,18,44,0,16,0,62,0
17 Memes That Are Way Too Real For Thirtysomethings,1,1,8,33,0,8,2,41,0
5 books Richard Branson thinks you should read,1,3,2,36,0,7,1,38,0
After-care proves to be a challenge for an 8-year-old on meds,1,2,1,46,3,10,1,47,0
You'll Miss Carrie Fisher Even More After Watching Ellen DeGeneres' Touching Tribute,1,3,13,58,2,11,0,71,0
Donald Trump's Tweets Reimagined as an Early '00s Emo Song,1,3,7,38,2,9,2,45,0
We Know What Kind Of Parent You Are Based On One Question,1,1,12,34,0,11,0,46,0
Indian army cancels recruitment exams after 'leak',1,2,1,41,2,6,0,42,0
How Mary Tyler Moore & Her 'Groundbreaking' Show Inspired Joan Jett,1,3,10,44,3,10,0,54,0
Your Horoscope For The Week Of December 7,1,1,7,26,0,7,1,33,0
Daniel Radcliffe Keeps Forgetting That He Played Harry Potter,1,1,9,44,0,8,0,53,0
Was 2016 good or bad? May and Johnson differ in Christmas messages,1,3,4,46,1,11,4,50,0
7 Conservative Classics Every American Should Read,1,2,6,37,0,6,1,43,0
Drowning Wombat Saved From Lake By Fishermen Who Caught Him In A Net,1,1,13,43,0,12,0,56,0
"An SAT tutor who charges $1,500 an hour explains what everyone does wrong preparing for the test",1,3,4,70,2,16,4,74,0
21 Insane Ways To Start Your Day With Eggs,1,1,8,24,0,8,2,32,0
Comedian-in-Chief: Obama’s Funniest Moments as President,1,3,6,41,4,5,0,47,0
April Ryan asked the most important question of the Trump presidency,1,3,3,55,0,10,0,58,0
How Much Of An Anime Otaku Are You,1,1,8,19,0,7,0,27,0
22 Times Dogs Embodied What It's Like To Have Siblings,1,1,9,33,1,9,2,42,0
A family suspected a caregiver was abusing an Alzheimer’s patient. So they installed a camera.,1,3,3,74,3,14,0,77,0
Dutch election turns spotlight on Moroccans,1,3,2,36,0,5,0,38,0
Sarah Silverman: Military Can Help Overthrow Trump,1,3,7,36,1,6,0,43,0
21 Times Tumblr Knew You Better Than You Knew Yourself,1,1,9,34,0,9,2,43,0
11 Things You've Definitely Googled Before,1,1,5,29,1,5,2,34,0
18 Perfect Cakes For People Who Hate People,1,1,7,27,0,7,2,34,0
How Well Do You Actually See The Color Yellow,1,1,9,28,0,8,0,37,0
15 Songs You Won't Believe Are Turning 10 In 2016,1,1,7,24,1,9,8,31,0
27 Deceptively Bad Gifts That'll Surprise Your Friends,1,1,7,37,1,7,2,44,0
Fmr Obama Official Farkas: ‘Disturbing’ Rice Story Was Leaked and Distracted Us from Russia,1,3,12,63,3,13,0,75,0
The ‘do-nothing Congress’ graduates to the ‘do-nothing-much Congress’,1,3,3,52,7,7,0,55,0
Two Footballers Are Set To Make History By Coming Out As Gay,1,1,12,37,0,11,0,49,0
A Paper Airplane Drone That’s Nearly Indestructible,1,2,7,37,1,6,0,44,0
Woman shares inspiring before and after photos of meth addiction The list,1,3,2,60,0,11,0,62,0
How to heat up your style during the cold season (Paid content by UNIQLO),1,3,8,50,2,13,0,58,0
23 Pictures That Look Exactly Like Life Feels,1,1,7,29,0,7,2,36,0
65 Things That Make British People Feel Slightly Guilty,1,1,8,37,0,8,2,45,0
17 Seemingly Harmless Bathroom Habits That Are Actually Disgusting,1,1,8,48,0,8,2,56,0
"Someone Made A Video Comparing The Indrani Mukerjea Case With Plot Points From ""Game Of Thrones""",1,1,16,63,2,15,0,79,0
17 Of The Best Beauty Products From Around The World,1,3,9,32,0,9,2,41,0
21 Borderline Orgasmic Moments Every Woman Will Understand,1,1,7,42,0,7,2,49,0
Republicans Now Seem To Reject The Whole Concept Of Insurance,1,3,10,42,0,9,0,52,0
17 Things You Realise After You Leave Your All-Girl School,1,1,10,36,1,9,2,46,0
"Document: Russia Uses Rigged Polls,  Fake News to Sway Foreign Elections ",1,3,10,49,2,12,0,59,0
Actor Bill Paxton Dead at 61,1,2,4,17,0,5,2,21,0
"Are You More Leslie Knope Or Ron Swanson From ""Parks And Rec""",1,1,12,36,2,11,0,48,0
America’s 100 Richest Places,1,2,3,18,1,3,3,21,0
19 Secrets Wedding Caterers Won't Tell You,1,1,6,27,1,6,2,33,0
Watch a Dad's Hysterical Video on the 'Joys' of Having His Daughter Home From College  Insider,1,3,12,63,3,16,0,75,0
You’re Wrong If You Don’t Think Chihuahuas Are The Best Dogs On This Good Earth,1,3,15,48,2,14,0,63,0
26 Things You Learn When You Date Someone Who Loves Harry Potter,1,1,11,40,0,11,2,51,0
Do the Child-Free Live Longer?,1,3,5,19,2,4,0,24,0
18 Filipino Words You Can't Translate To English,1,1,7,31,1,7,2,38,0
19 Things Only People Who Love Cooking But Are Fucking Lazy Will Understand,1,2,12,49,0,12,2,61,0
"Cara Delevingne Hits Back At Robb Stark After He Called Her ""Unprofessional""",1,1,12,51,2,11,0,63,0
Reminder: This Was Life In 2006,1,1,5,16,1,5,4,21,0
19 Tweets About Death That Are Way Too Funny Not To Laugh At,1,1,12,34,0,12,2,46,0
"29 Of Rachel Green's Most Iconic Lines On ""Friends""",1,1,8,30,3,8,2,38,0
"Should You Marry Kylo Ren Or Finn From ""Force Awakens""",1,1,10,33,2,9,0,43,0
Why TV Writers Obsess Over Chicago,1,3,7,22,0,5,0,29,0
21 Funny Texts That You Won’t Be Able To Get Through Without Laughing,1,2,12,42,1,12,2,54,0
15 Places You Should Eat Korean Food In London,1,1,8,28,0,8,2,36,0
5 Simple Tips That Will Help Every Millennial With Their Tax Investments,1,3,11,49,0,11,1,60,0
17 People Doing A Simple Thing That Will Restore Your Faith In Humanity,1,1,12,45,0,12,2,57,0
Lady Gaga in Black and White: The Billboard Woman of the Yearâs 7 Best Couture Looks,1,3,11,56,3,15,1,67,0
The week's happy news,1,2,1,16,1,3,0,17,0
What Kind Of Old Person Will You Be,1,1,8,20,0,7,0,28,0
Do you know this man? Dine-and-dash dater strikes again in Los Angeles,1,3,4,52,3,11,0,56,0
News Anchor Learns About Her Husband's Death During Live Broadcast,1,2,10,46,1,9,0,56,0
"Are You More ""Daredevil"" Or ""Jessica Jones""",1,1,7,26,4,6,0,33,0
Jennifer Lawrence Has Revealed That She's Going To Be Making Her Directorial Debut,1,1,13,56,1,12,0,69,0
A Black Woman Walks Into A Gun Show,1,1,8,20,0,7,0,28,0
24 Things All Bisexual People Can Relate To,1,1,7,27,0,7,2,34,0
The Academy Awards: Best picture nominees in 30 seconds,1,3,4,40,1,8,2,44,0
"This ""Date Rape"" Bloomingdale's Ad Is Causing Mass Outrage Online",1,1,10,43,3,9,0,53,0
23 Things That People In Wheelchairs Have To Cope With,1,1,9,34,0,9,2,43,0
How internet porn is creating a generation of men desensitised to real life sex,1,3,1,65,0,13,0,66,0
27 Times Nadia Aboulhosn Was Right About Everything,1,1,7,35,0,7,2,42,0
17 Times Britain Confused The Hell Out Of Everyone On Tumblr,1,1,10,38,0,10,2,48,0
We Know Your Zodiac Sign Based On Your Favorite Dog Breeds,1,1,11,37,0,10,0,48,0
22 Pictures People Who Don't Own A Dog Will Never Understand,1,1,10,37,1,10,2,47,0
"Enjoy NOAA's vital satellite imagery, while you still can",1,3,5,42,2,8,0,47,0
"Win one of 12 brilliant designer gifts worth £7,150 - and help the Telegraph's charity appeal ",1,3,2,66,4,16,6,68,0
Are You More Arthur Or D.W,1,1,7,13,1,5,0,20,0
"21 ""Harry Potter"" Fanfictions To Read Before You Die",1,1,8,32,2,8,2,40,0
"Kim Jong-un's wife is spotted, EIGHT MONTHS after disappearing from public view",1,2,13,52,3,11,0,65,0
19 Confessions From People Who Aren't Excited To See Their High School Friends,1,1,12,51,1,12,2,63,0
If White Men Experienced Racism And Sexism,1,1,7,29,0,6,0,36,0
How an entrepreneur stopped chasing every new idea so he could focus on one big goal,1,2,1,68,0,15,0,69,0
Scientists Discover Dead Cockroaches Make Excellent Magnets Than Alive Ones!,1,3,10,56,1,9,0,66,0
"WA bushfire contained after lives, homes threatened in Gwindinup, south-east of Bunbury",1,3,4,69,3,11,0,73,0
Do You Remember Which '00s Pop Star Sang These Lyrics,1,1,9,32,1,9,2,41,0
The friendship that divides the NBA,1,3,4,26,0,5,0,30,0
Shia LaBeouf Shouts at Wall to Kick Off 4-Year-Long Trump Protest,1,3,11,41,2,10,1,52,0
Ted Cruz Calls for $14 Billion Seized from ‘El Chapo’ to Fund Border Wall,1,2,10,45,3,13,2,55,0
Revealed: How the world's eight richest men are worth the same as HALF of the rest of the planet,1,3,6,70,2,18,0,76,0
18 Tweets For Anyone Who Has A Fear Of Pooping In Public,1,1,11,32,0,11,2,43,0
21 Times Neil Patrick Harris And David Burtka Gave Us Serious Relationship And Family Goals,1,1,14,61,0,14,2,75,0
Holy Moly This Is The Most Polite And Canadian Crowd Celebration Ever,1,1,12,46,0,11,0,58,0
Corbyn: Theresa May ‘in denial’ about NHS crisis and scapegoating GPs,1,2,8,48,3,10,0,56,0
Can You Get A 5 On This AP English Exam?,1,3,10,19,1,9,1,29,0
24 Awesome Gifts That'll Smash The Patriarchy,1,1,6,30,1,6,2,36,0
Watch: 'Logan' Hugh Jackman Has A 'Special Message' For Team Cricket India Against Australia!,1,2,14,60,6,13,0,74,0
This App Wants to Solve Sneaker Release Problems,1,3,7,34,0,7,0,41,0
Neil DeGrasse Tyson Hilariously Shut Down B.o.B's Argument That The Earth Is Flat,1,1,15,51,3,12,0,66,0
What Is The Best Underrated Game App,1,1,7,23,0,6,0,30,0
"All The ""Star Wars"" Fan Art You Didn't Know You Needed",1,1,11,30,3,10,0,41,0
"41 Things You Probably Didn't Know About ""Harry Potter And The Prisoner Of Azkaban""",1,1,13,52,3,13,2,65,0
We Celebrated Thanksgiving With Celebs On The AMA's Red Carpet,1,1,12,40,1,9,0,52,0
16 Underrated Mumbai Street Foods That Will Change Your Life,1,1,9,40,0,9,2,49,0
Tell Us About Yourself(ie): Jenny Mollen,1,1,6,26,3,5,0,32,0
"A Bride Says She's Outraged After She Missed Part Of Her Honeymoon Over A ""Damaged"" Passport",1,1,16,58,3,15,0,74,0
Are You The Worst Person In The World,1,1,8,22,0,7,0,30,0
Believers Play The Ouija Board,1,1,5,21,0,4,0,26,0
17 Ways To Get Into The Holiday Spirit At Disney World,1,1,10,32,0,10,2,42,0
32 Cute Animals You Can Meet In Italy,1,1,7,21,0,7,2,28,0
Patriots owner Robert Kraft says Tom Brady willing to play 6-7 more years,1,3,5,53,1,12,2,58,0
"21 Confessions From Obsessed ""High School Musical"" Fans",1,1,7,37,2,7,2,44,0
Trump's Tweet About Chelsea Manning And Obama Is Interesting For A Few Reasons,1,2,13,52,1,12,0,65,0
22 Slightly Wrong Names For Animals,1,1,5,23,0,5,2,28,0
Campaign Asks Women to Grow Body Hair for Antiviolence Awareness,1,3,8,47,0,9,0,55,0
Here's How Everyone Reacted To Jennifer Lawrence And Amy Schumer At The Golden Globes,1,1,14,57,1,13,0,71,0
28 Times Adele Was Actually Just The Fucking Best,1,1,8,31,0,8,2,39,0
11 Struggles All Hot Sauce Lovers Know,1,1,6,24,0,6,2,30,0
32 Hilarious Tweets About Cats,1,1,4,20,0,4,2,24,0
"Former Batchmate Slams Mira For Her Feminism Remarks, Says She 'Belittled' Girls In College",1,3,14,61,3,13,0,75,0
25 Times Blue Ivy Had Her Shit Together Better Than You,1,1,10,33,0,10,2,43,0
32 Cute Things To Distract From Your Awkward Thanksgiving,1,1,8,39,0,8,2,47,0
12 Signs You Grew Up In San Francisco,1,1,7,21,0,7,2,28,0
7 Ways Authenticity Leads To Success,1,3,5,25,0,5,1,30,0
15 Of The Most Powerful Women In The Weed Industry,1,3,9,30,0,9,2,39,0
Can You Guess The Christmas Movie From Its Amazon Review,1,1,10,37,0,9,0,47,0
In pictures: The men competing for love in the deserts of Chad,1,3,3,47,1,11,0,50,0
18 Secrets About Being An Astronaut That NASA Won't Tell You,1,1,13,34,1,10,2,47,0
This New Dad And His Baby Put Our Snapchats To Shame,1,1,11,31,0,10,0,42,0
Heartbreaking photo of father dying of cancer cradling his young son,1,3,1,57,0,10,0,58,0
Here's What Real Vegetarians Actually Eat,1,1,6,29,1,5,0,35,0
"Should You Be On ""Real Housewives Of Beverly Hills"" Or ""Real Housewives Of New York""",1,1,15,51,4,14,0,66,0
College Professors Organize National ‘Teach-In’ to Challenge ‘Trumpism’,1,3,8,51,5,7,0,59,0
"Boy, 2, throws tantrum during encounter with Queen Elizabeth",1,2,3,46,2,8,1,49,0
"In New CIA WikiLeaks Trove, ¯\_(⊙︿⊙)_/¯, (◕_◕) And ᶘ ᵒᴥᵒᶅ",1,3,9,21,18,9,0,30,0
19 Things People Who Aren't Naturally Loud Will Never Understand,1,1,9,43,1,9,2,52,0
This Insane Amethyst-Inspired Wedding Cake Will Blow Your Mind,1,1,10,43,1,8,0,53,0
21 Adorable Stuffed Animals For Grown-Ass Adults,1,1,7,32,1,6,2,39,0
Can We Guess How Tall Your Boyfriend Is?,1,3,8,24,1,7,0,32,0
"How Well Do You Remember Season 1 Of ""The Simpsons""",1,1,9,30,2,9,1,39,0
29 Celestial Accessories You'll Be Over The Moon For,1,1,8,33,1,8,2,41,0
24 Times Coriander Was The Fucking Worst,1,1,6,26,0,6,2,32,0
Audience with a monster: the pain of staging the cruel life of Jimmy Savile,1,3,3,58,1,13,0,61,0
25 Mildly Irritating Things That Drive Introverts Crazy,1,1,7,39,0,7,2,46,0
Gigi Hadid on how she deals with body-shaming trolls,1,2,2,41,1,8,0,43,0
This Woman Looks So Much Like Angelina Jolie It's Scary,1,1,10,35,1,9,0,45,0
"Which Of These ""Game Of Thrones"" Characters Are The Best",1,1,10,35,2,9,0,45,0
Should You Call Drake On His Cell Phone,1,1,8,24,0,7,0,32,0
Anarchy at the checkout: You can now own a Sex Pistols credit card,1,3,4,49,1,12,0,53,0
The Hemsworth Brothers' Instagram War Is A Christmas Gift To Us All,1,1,12,43,1,11,0,55,0
"24 ""Back To The Future"" Tattoos That Will Blow Your Mind",1,1,10,32,2,10,2,42,0
The 20 cities with the lowest cost of living,1,3,1,33,0,8,2,34,0
If Real Life Were Like A Telenovela,1,1,7,22,0,6,0,29,0
Homes in these 10 markets are selling like hotcakes,1,2,1,40,0,8,2,41,0
"How Well Do ""DASH Dolls"" Malika And Khadijah Haqq Actually Know Each Other",1,1,16,44,2,12,0,60,0
The BBC trolled Trump in the best possible way The list,1,3,6,39,0,10,0,45,0
"Miley Cyrus Is Planning A Nude Concert Where Everyone's Naked And Spewed With ""Milk""",1,1,14,54,3,13,0,68,0
CNN’s Henderson: Some Might View Flynn Resignation as the Press Having Scored Points Against the WH,1,3,16,66,2,15,0,82,0
Are You An Optimist Or A Pessimist,1,1,7,21,0,6,0,28,0
"27 Funniest Moments From ""Whose Line Is It Anyway?""",1,1,8,30,3,8,2,38,0
Universal basic income: The dangerous idea of 2016,1,3,2,36,1,7,4,38,0
13 Things I Learned When I Decided To Start Eating Vegetables,1,1,10,39,0,10,2,49,0
"In Search Of The Next ""Battlestar Galactica""",1,1,7,29,2,6,0,36,0
12 Cards Your Friends With Depression Would Actually Appreciate,1,1,8,45,0,8,2,53,0
What Celebrity Body Part Are You,1,1,6,21,0,5,0,27,0
What Is It Like To Be A Man With An Eating Disorder,1,1,12,28,0,11,0,40,0
19 Secrets People Who Work In Marketing Will Never Tell You,1,1,10,37,0,10,2,47,0
When your wife refuses conventional cancer treatment,1,2,1,45,0,6,0,46,0
"After Yangtze Ship Tragedy, A Deleted Report Drives Speculation - China Real Time Report",1,3,13,60,2,13,0,73,0
11 Reasons Why You Probably Shouldn't Let Santa Break Into Your Home This Christmas,1,1,13,54,1,13,2,67,0
"One Hatchback, 68 Tons of Meat: Arrest Ends Swiss Smuggling Case",1,3,9,41,2,10,2,50,0
Obama How the Obamas leveraged fame to advance a political agenda,1,3,3,52,0,10,0,55,0
You Can't Stop Watching These Mini Cooking Videos,1,1,8,33,1,7,0,41,0
14 New Year's Resolutions We're Still Working On,1,1,7,30,2,7,2,37,0
Meet 'Cyanide Mallika' India's First Woman Serial Killer And Now Neighbour Of Sasikala In Bengaluru Jail,1,3,16,70,3,15,0,86,0
"As Leaks Multiply, Fears of a ‘Deep State’ in America ",1,3,7,34,3,10,0,41,0
"Can You Answer These Obscure ""Friends"" Trivia Questions",1,1,8,38,2,7,0,46,0
This Woman Got Her Tinder Profile Overhauled By Her Co-Workers,1,1,11,41,1,9,0,52,0
Extremely Spicy Snack Taste Test,1,1,5,23,0,4,0,28,0
Is Govt's Plan To Ask Restaurants To Limit Food Portions A Step In The Right Direction?,1,3,16,54,2,15,0,70,0
20 Painfully Honest Confessions From Women With Polycystic Ovary Syndrome,1,1,9,53,0,9,2,62,0
Use an insight from consumer psychology research to make your spouse appreciate you more,1,2,1,74,0,13,0,75,0
29 Gifts That Even The Most Heartless People Would Adore,1,2,9,36,0,9,2,45,0
This Is Why Your Pancakes Never Come Out Fluffy,1,3,9,30,0,8,0,39,0
Diana Quick: 'For the first time in my life I can have non-sexual relationships with men',1,2,4,66,4,15,0,70,0
"OK, calling it: This little boy stars in 2016's most heartwarming Christmas video",1,3,4,58,3,12,4,62,0
Bird flu detected in chicken breeding facility in Tennessee ,1,2,2,49,0,9,0,51,0
The best ways to stream live TV without cable,1,3,3,34,0,8,0,37,0
Theresa May was asked what superpower she wished she had. It didn't end well The list,1,3,4,64,2,15,0,68,0
US Plans Futuristic #MakeInIndia Combat Choppers + 5 News Stories From New Year's Eve,1,3,15,53,3,13,1,68,0
17 Genius Tips For Dealing With Impostor Syndrome,1,1,7,33,0,7,2,40,0
12 Recipes that Celebrate the Chocolate Chip Cookie,1,1,5,37,0,7,2,42,0
16 Magical Ways To Cook Your Thanksgiving Turkey,1,1,7,32,0,7,2,39,0
Former NFL Running Back Warns Of ‘Slave Labor’ After DOJ Signals Return to Private Prisons,1,3,18,56,2,14,0,74,0
We Photoshopped Away The Features We Were Most Insecure About And This Is What Happened,1,1,15,58,0,14,0,73,0
Here’s Why It’s Legal for Airlines to Kick You Off Your Flight,1,3,10,39,2,11,0,49,0
Why Ivanka Trump is joining the Trump administration,1,3,4,41,0,7,0,45,0
Five burning questions we have about 'Stranger Things' Season 2,1,3,4,47,2,9,1,51,0
13 useless things to stop wasting your money on,1,3,0,37,0,8,2,37,0
How Well Do You Actually Know The Laws Of Rugby,1,1,10,28,0,9,0,38,0
Saturday Night Live Hilariously Made Fun Of Dating Apps In Last Night's Episode,1,1,13,53,1,12,0,66,0
Can You Pick The Right Celeb Best Friend,1,1,8,25,0,7,0,33,0
"Ted Cruz revealed his disturbing, yet poetic, feelings about queso",1,3,2,53,2,9,0,55,0
Boston Bombing Survivor to Marry the Firefighter Who Rescued Her ,1,2,8,47,0,10,0,55,0
"After Her Dad Was Jailed & Mom Remarried, This 5YO Has Been Taking Care Of Her Grandmothers!",1,3,17,55,3,16,1,72,0
Kylie Jenner Is Officially Way More Popular Than Kim Kardashian,1,1,10,44,0,9,0,54,0
Are You More House Stark Or House Targaryen,1,1,8,28,0,7,0,36,0
"At a cool $250M, LA mega-mansion is priciest listing in US",1,3,6,36,3,10,3,42,0
23 Borderline Genius Ways To Make Your Home Calm AF,1,1,10,30,0,9,2,40,0
Alec Baldwin Will Count Down End of Trump’s Term from Inauguration Day,1,2,10,48,1,11,0,58,0
23 Things That Happen When You Get Drunk With Your Mum,1,1,10,32,0,10,2,42,0
Is Justin Bieber Off To Steal Your Man,1,1,8,23,0,7,0,31,0
This Laser Razor Wants To Bring Shaving Into The 21st Century,1,1,10,39,0,10,2,49,0
These teens faked a proposal because free food is everything,1,3,1,50,0,9,0,51,0
Grammys: The winners list,1,3,2,19,1,3,0,21,0
PM Modi And Queen Elizabeth II Will Get To Watch Baahubali 2 Before All Of Us!,1,3,17,44,1,15,1,61,0
We Know What Bodily Fluid Matches Your Personality,1,1,8,35,0,7,0,43,0
33 Times Lady Gaga Proved She's Just Like Us In 2015,1,1,9,26,1,10,6,35,0
"Nobody's Satisfied After ""Hamilton"" Ticket Lottery Website Completely Failed",1,1,9,56,3,8,0,65,0
18 Of The Most Offensive Things That Have Ever Happened At Swiss Chalet,1,1,12,45,0,12,2,57,0
What Your Favorite Black Celebs Looked Like In 2006 Vs. Now,1,1,10,34,1,10,4,44,0
23 Euphoric Experiences For Everyone Who Loves To Eat,1,1,8,35,0,8,2,43,0
"This Couple Performed The ""Up"" Theme For Their 60th Anniversary",1,1,9,41,2,9,2,50,0
"Which Song From ""Revival"" Are You Actually",1,1,7,27,2,6,0,34,0
19 Things You'll Understand If You're A Girl Who Fucking Hates Shaving,1,3,11,44,2,11,2,55,0
Why we never really get over that first love,1,3,1,35,0,8,0,36,0
Trump's 20 Million Twitter Followers Get Smaller Under The Microscope,1,3,9,48,1,9,2,57,0
19 Heartbreaking Confessions About Being Addicted To Instagram,1,1,7,46,0,7,2,53,0
2016's Worst Passwords Are Just As Bad As 2015's (So Please Tell Me Yours Is Not On The List),1,3,17,46,4,18,8,63,0
The Rock Just Won Christmas By Making These Girls' Dreams Come True,1,1,12,43,1,11,0,55,0
"Canton calls LaDainian Tomlinson, Kurt Warner, Terrell Davis, Jerry Jones, 3 others",1,3,10,57,4,11,1,67,0
"Which Version Of ""1989"" Is The Best",1,1,6,17,2,6,4,23,0
MUST-SEE: Car Slides Off Edge of Moving Ferry into Open Waters  Insider,1,2,16,41,2,12,0,57,0
Tom Ford on why he won't dress Melania Trump ,1,2,4,31,1,9,0,35,0
"The 7 Big Revisions Republicans Made to Their Health Care Bill, and Why They Made Them ",1,3,13,56,1,16,1,69,0
Poll: Democratic Women Most Likely to Block or Unfriend Someone over Politics,1,3,9,56,1,11,0,65,0
24 Clever Ways To Decorate A Store-Bought Pumpkin Pie,1,1,9,33,1,8,2,42,0
Gays And Lesbians Battle Each Other While Putting Together Ikea Furniture,1,1,11,52,0,10,0,63,0
"Visually Impaired Malayalam Singer Chooses Career Over Marriage, Sets A New World Record!",1,2,13,62,2,12,0,75,0
This Pizza Ring Is The Party Food You Deserve,1,1,9,28,0,8,0,37,0
"21 Things That Happened When We Visited The Set Of ""Friends""",1,1,10,36,2,10,2,46,0
"Only An ""Office"" Scholar Will Get 15/15 On This Michael Scott Quiz",1,3,11,37,3,11,4,48,0
Meryl Streep's hilarious reaction to that Oscars mix-up is the perfect meme for 2017,1,3,3,62,2,13,4,65,0
"Sunil Grover Hits Out At Kapil Sharma, Milind Soman Swims In The Dead Sea And More The Ent World",1,3,19,58,1,18,0,77,0
13 Weirdly Random Things Indians Have Uploaded To Porn Sites,1,1,9,40,0,9,2,49,0
"Which ""Friends"" Character Would You Clash With",1,1,7,31,2,6,0,38,0
Exclusive: Jenna Jameson Denies Role in Anti-Trump Porn Film: ‘Fake News’,1,2,11,47,5,10,0,58,0
A Woman Is Surprised With A Proposal During A BuzzFeed Video,1,1,12,38,0,10,0,50,0
Everyday Items With Mexican Origins,1,1,5,26,0,4,0,31,0
"McCain, Graham Join Democrats, Demand Probe into Claims of Russian Hacking",1,3,10,52,2,10,0,62,0
"23 Holiday-Themed ""Star Wars"" Jumpers That Are Out Of This World",1,1,11,38,3,10,2,49,0
"Grades, draft needs, offseason questions for every eliminated team",1,2,1,55,2,8,0,56,0
21 Pictures That Won't Make Sense To Non-Cat People,1,1,9,30,2,8,2,39,0
"We Need To Talk About That Big Death On ""Once Upon A Time""",1,1,13,31,2,12,0,44,0
"19 Reasons Lily From ""Modern Family"" Would Be The Best Friend Ever",1,1,11,40,2,11,2,51,0
Which Ed Sheeran Song Are You Based On Your Zodiac Sign,1,1,11,34,0,10,0,45,0
Can You Name The Christmas Movie From The Distorted Scene,1,1,10,38,0,9,0,48,0
15 Halloween Candy Apples That Make All Other Apples Look Bad,1,1,10,39,0,10,2,49,0
18 Things You Should Never Do When Applying Makeup,1,1,8,32,0,8,2,40,0
19 Things That Happen When You're Dating A Picky Eater,1,1,9,33,1,9,2,42,0
Justin Bieber Speaks Out On His Nude Photo Leak And Reveals Fans Name For His Penis,1,1,16,52,0,15,0,68,0
Biden to Electoral Vote Objection: ‘It Is Over’,1,3,7,30,3,7,0,37,0
Cavaliers express frustration at officials after 26-point meltdown,1,3,1,55,1,7,2,56,0
"Teachers, What Do You Actually Want For Christmas This Year",1,1,10,39,1,9,0,49,0
Steve Bannon Leaves National Security Council After Susan Rice Takedown,1,3,10,52,0,9,0,62,0
23 Tweets That Are Way Too Funny For Anyone With Boobs,1,1,10,32,0,10,2,42,0
Kate Winslet Keeps Her Oscar In Her Bathroom So People Can Practice Their Own Acceptance Speeches,1,1,16,66,0,15,0,82,0
"Ignore the Snobs, Drink the Cheap, Delicious Wine ",1,3,6,34,2,8,0,40,0
"27 Reasons Paris Geller Is The True Heroine Of ""Gilmore Girls""",1,1,10,38,2,10,2,48,0
"Can You Match The ""Series Of Unfortunate Events"" Illustration To The Book",1,1,12,48,2,11,0,60,0
"Mayor Sadiq Khan Says London ‘Safest Global City’, Slams Donald Trump Junior",1,3,12,50,3,11,0,62,0
A Day In The Life Of A Trans Cabaret Performer,1,1,10,27,0,9,0,37,0
27 Perfect Gifts For Anyone Who Loves Whales,1,1,7,28,0,7,2,35,0
Are You Actually Grosser Than Most People?,1,3,7,28,1,6,0,35,0
Signs You're Broke AF,1,1,5,12,1,3,0,17,0
Which languages should children be learning to get ahead?,1,2,1,47,1,8,0,48,0
You'll Wish You Could Take This Dog Home After You See Her Dance,1,1,13,38,1,12,0,51,0
21 Of The Most Canadian Things You'll Ever See,1,1,8,27,1,8,2,35,0
Are You More Darth Vader Or Luke Skywalker,1,1,8,27,0,7,0,35,0
"Two Aussies play horrible prank on their friend, telling him he killed a man",1,3,2,60,1,13,0,62,0
"The New ""Beauty And The Beast"" Features Disney’s First Gay Character",1,2,11,44,3,10,0,55,0
Safe Space Event Organizer Claims She Wouldn’t ‘Feel Safe’ Describing Event to Reporter,1,3,12,60,3,12,0,72,0
19 Urban Legends From Your Childhood That Are Still Scary As Hell,1,2,11,41,0,11,2,52,0
21 Inexpensive Ways To Upgrade Your Bedroom,1,1,6,29,0,6,2,35,0
Al Gore Visits Trump Tower Seeking ‘Areas of Common Ground’,1,3,9,39,2,9,0,48,0
Schumer: Trump So Far Is ‘a President of Little Impact’,1,2,8,35,3,9,0,43,0
8 Amazing People That Will Make You Appreciate Refugees,1,1,8,38,0,8,1,46,0
22 Haiku That Are Pretty Much Parenting In A Nutshell,1,2,9,33,0,9,2,42,0
These Ingenious Lego Hacks Will Finally Help Math Make Sense,1,1,10,41,0,9,0,51,0
17 Hilarious Tweets About India's Censor Board Cutting Kissing Scenes In The New Bond Film,1,1,14,59,1,14,2,73,0
2015 Was The Year Taylor Lautner Was Still Really Hot,1,1,9,31,0,9,4,40,0
Can We Guess Your Favorite Pie,1,1,6,19,0,5,0,25,0
31 Tweets About McDonald's That'll Make You Laugh Every Time,1,1,10,37,2,9,2,47,0
Gay Men Ask Lesbian Women Questions We All Want To Know,1,1,11,34,0,10,0,45,0
"This Video Shares Some Fascinating Theories About The ""Fallout"" Games",1,1,10,48,2,9,0,58,0
17 French Fry Creations That Are Better Than A Boyfriend,1,1,9,36,0,9,2,45,0
When A Man Couldn't Feed Himself At McDonald's An Employee Did The Most Awesome Thing,1,1,16,53,2,14,0,69,0
Cemitas Are Mexico's Most Delicious Dish And You Should Try It,1,1,11,40,1,10,0,51,0
Police Investigation After Woman Brutally Beaten by ‘Anti Fascists’ for Wearing National Flag Bracelet,1,2,12,75,2,13,0,87,0
"Trump Picks His Enemy, Accuses China Of Currency Manipulation. Chinese Media Says He's 'Inexperienced'",1,2,14,70,5,13,0,84,0
23 People Who Failed Spectacularly At Cooking,1,1,6,31,0,6,2,37,0
31 Brilliant Kitchen Products For The Holiday Season,1,1,7,36,0,7,2,43,0
"For The First Time Ever, A Black Woman Will Be Headlining Coachella",1,2,12,43,1,11,0,55,0
Jenna Jameson: Porn star launches anti-Muslim rant and apparent defence of the Ku Klux Klan,1,3,7,68,2,14,0,75,0
Hillary Clinton Staffers Considered Campaign Slogan ‘Because It’s Her Turn’,1,2,10,53,3,9,0,63,0
5 Yoga Moves That Tone Your Abs,1,3,6,18,0,6,1,24,0
This tweet perfectly sums up how terrifying 2017 is already The list,1,3,2,51,0,11,4,53,0
"An American Filmmaker Couldn't Get A Visa To India, So He's Directing A Film Over Skype",1,1,16,53,3,15,0,69,0
What Video Games Are These Weapons From,1,1,7,26,0,6,0,33,0
Watchdog Group’s Trump Suit Hinges on Risky Legal Argument,1,3,8,41,1,8,0,49,0
Airport expansion: Heathrow v Gatwick,1,2,3,29,1,4,0,32,0
The Best Architecture in New York of 2016 ,1,2,5,25,0,8,4,30,0
"Aarhus, Denmark: what to see, plus the best restaurants, bars and hotels",1,3,2,55,4,11,0,57,0
"15 ""American Horror Story"" Questions That Are Impossible To Answer",1,1,9,44,2,9,2,53,0
Siemens HealthineersVoice: 4 Forces That Will Impact the Future of Healthcare Digitalization,1,3,10,69,1,11,1,79,0
This Is What Happens When You Marry A Brownie And A Cookie In The Oven,1,1,15,41,0,14,0,56,0
Kentucky Teacher Gets Prison Time for Sex With Underage Student,1,3,9,45,0,9,0,54,0
There is only one man worse at Twitter than Donald Trump,1,2,4,42,0,10,0,46,0
Homes with hot tubs – in pictures,1,3,1,25,1,6,0,26,0
"Did Kanye West's ""Gold Digger"" Secretly Predict He'd End Up With Kim Kardashian",1,1,13,50,4,12,0,63,0
"The worst mistake everybody makes when cooking steak, according to Anthony Bourdain",1,3,3,68,1,11,0,71,0
Are You Bart Or Lisa,1,1,5,11,0,4,0,16,0
Hillary Clinton Staffers Considered Campaign Slogan ‘Because It’s Her Turn’,1,3,10,53,3,9,0,63,0
A Canadian Dad Did The Most Insane Elf On The Shelf Photo Shoot,1,1,13,38,0,12,0,51,0
Involtini Recipe - NYT Cooking,1,3,6,19,1,4,0,25,0
Who Said It: Jennifer Lawrence Or Katniss Everdeen,1,1,8,34,1,7,0,42,0
TBS-Owned ‘Super Deluxe’ Game ‘Punch-a-Nazi’ Makes Players Beat MILO to a Pulp,1,3,17,43,7,11,0,60,0
A problem for senators hesitating over Trump nominees: The alternative might be worse,1,2,3,69,1,12,0,72,0
12 Remarkable Pictures Of NYC's Fifth Ave In 1911 Vs. Today,1,1,11,30,2,10,6,41,0
"Scotland could join Canada, but should it? Your responses",1,3,3,44,2,8,0,47,0
We Got Our Auras Photographed And This Is What We Saw,1,1,11,32,0,10,0,43,0
NCAA Tournament 2017: Everything You Need to Know About the Sweet 16,1,2,11,39,1,11,6,50,0
George Clooney Drinking A Cup Of Coffee Will Sexually Awaken You,1,1,11,43,0,10,0,54,0
These New Empathy Cards Make It Easier To Talk About Pregnancy Loss,1,1,12,44,0,11,0,56,0
Are You More Like Salem Or Binx,1,1,7,18,0,6,0,25,0
The Strange Case Of The Russian Diplomat Who Got His Head Smashed In On Election Day,1,3,16,53,0,15,0,69,0
Shocked villagers capture monstrous snake that gorged on TWO of their goats and became too stuffed to move,1,2,4,85,0,17,0,89,0
Actor Kal Penn shares scripts revealing Indian stereotypes in Hollywood,1,2,5,57,0,9,0,62,0
These Boyfriends Shaved Their Girlfriends' Legs... Did Anyone Survive,1,1,9,48,4,8,0,57,0
"How children play, even in the harshest of environments",1,2,1,45,1,8,0,46,0
Barbie battles Star Wars and Hatchimals at the register,1,2,4,43,0,8,0,47,0
12 Moments That Prove Queer Teens Totally Won 2016,1,3,7,29,0,8,6,36,0
Russia domestic violence: One woman's narrow escape,1,2,2,41,2,6,0,43,0
What's The Funniest Pop-Punk Tumblr Post You've Ever Seen,1,1,10,36,3,8,0,46,0
9 Actors Who Underwent Amazing Transformations & Shocked Us With Their Unrecognisable Looks,1,3,11,66,1,12,1,77,0
20 Times Amandla Stenberg Was The Most Carefree Black Girl Of 2015,1,1,10,39,0,11,6,49,0
12 Crazy Delicious Recipes To Feed Your Avocado Obsession,1,1,8,39,0,8,2,47,0
Why is east Africa facing a hunger crisis and what can be done? – podcast,1,3,2,55,2,14,0,57,0
Galleries Weird and wonderful religious relics,1,2,2,39,0,5,0,41,0
"Australia on cusp of large-scale solar boom as setup costs tumble, experts say",1,2,1,63,2,12,0,64,0
"25 Pictures That Are Way, Way Too Real For All Cat Owners",1,1,11,32,1,11,2,43,0
Golden Globes predictions: who will win – and who should win – the TV categories,1,3,4,59,3,14,0,63,0
18 Pictures Everyone Who Loves Spilling The Tea Will Understand,1,1,9,43,0,9,2,52,0
14 Adorable Images Of Dogs Wearing Trousers,1,1,6,29,0,6,2,35,0
The Greatest Late Night Snacks From Around the World,1,3,8,36,0,8,0,44,0
21 Times Gay Men Got It Wrong In 2015,1,1,7,16,0,8,6,23,0
This model only ate 500 calories a day while working. Now she's shared what she looks like after giving it up The list,1,3,3,88,2,22,3,91,0
"34 Reasons ""How I Met Your Mother"" Was The Cleverest Show On TV",1,1,13,34,2,12,2,47,0
This Is What Household Ingredients Actually Do For Your Skin,1,1,10,41,0,9,0,51,0
Carry on sexting? That’s no way to help your kids…,1,2,2,36,3,9,0,38,0
Behind the Dizzying Student Loan Game Navient Allegedly Played,1,3,8,46,0,8,0,54,0
23 Sibling Photo Shoots That Will Make You Want Another Baby,1,1,10,38,0,10,2,48,0
Tax Day Justice: DOJ Investigation of Lois Lerner Called for by Ways and Means Chairman,1,3,13,59,1,14,0,72,0
The Zodiac Signs As Bagels,1,1,5,17,0,4,0,22,0
Here Is A Really Delicious Way To Enjoy Acorn Squash,1,1,10,33,0,9,0,43,0
Why Trump Has Strong Hand in Confirmation Process: QuickTake Q&A,1,3,11,42,2,9,0,53,0
19 Things Every Woman With Shaved Hair Never Wants To Hear Again,1,1,11,40,0,11,2,51,0
"Despite 30,000+ Unsolved Cases, Bengaluru Police’s Hunting For A Cow Who Attacked Constable's Mother",1,3,13,64,5,13,5,77,0
16 Men Who Dominated Makeup In 2016,1,2,5,18,0,6,6,23,0
The opera-loving sisters who 'stumbled' into heroism,1,3,1,42,3,6,0,43,0
New Year's Resolutions Are Bound To Fail. Try This Instead.,1,3,10,37,3,9,0,47,0
New Obama/Biden memes are here to help you survive inauguration week,1,3,3,54,1,10,0,57,0
17 People Who Had Hilarious Language Brain Farts,1,1,7,32,0,7,2,39,0
Nigeria's starving children who fled Boko Haram,1,3,3,37,1,6,0,40,0
"Remain Calm But Chris Pine Just Teased ""Princess Diaries 3""",1,1,9,38,2,9,1,47,0
16 Of The Most Embarrassing Stories About Sex,1,2,7,29,0,7,2,36,0
30 Sports Movies That Will Get You Pumped Up AF,1,1,10,26,0,9,2,36,0
"How Brave Are You, Actually",1,1,5,17,1,4,0,22,0
Only One Kind of Trader Is Doing Well as Egypt Pound Weakens,1,3,10,39,0,11,0,49,0
SoftBank Robotics Plans App Store for Humanoid Pepper Robot,1,2,9,42,0,8,0,51,0
A Bride Shared A Special Wedding Dance With The Man Who Saved Her Life,1,1,14,43,0,13,0,57,0
This Is What Breastfeeding Really Looks Like,1,1,7,31,0,6,0,38,0
18 Hilarious Tweets That Perfectly Sum Up Laziness,1,1,7,34,0,7,2,41,0
Women Flood Twitter With Stories Of The First Time Their Clothes Were Sexualized,1,3,13,55,0,12,0,68,0
"After Years Of Dutiful Service, The Shiba Who Ran A Tobacco Shop Retires",1,1,13,46,1,12,0,59,0
22 Highly Sexual Words You Didn't Know You Needed,1,1,8,30,1,8,2,38,0
What's The Best Story You Have About Traveling Before The Internet,1,1,11,44,1,10,0,55,0
24 Hillarious Tweets That Perfectly Sum Up Life,1,1,7,31,0,7,2,38,0
We Know Who Your Animated Kindred Spirit Is Based On Your Zodiac,1,1,12,41,0,11,0,53,0
23 Words That Mean Something Completely Different When You Get Engaged,1,1,10,48,0,10,2,58,0
Baltimore in ‘Crisis’ Due to Officer Shortage After Months of Anti-Police Policies,1,3,10,58,3,11,0,68,0
"Watch The Exclusive First Trailer For Zac Efron And Robert De Niro's ""Dirty Grandpa""",1,1,14,54,3,13,0,68,0
Saving Edgecumbe's residents on the back of a lorry,1,2,2,40,1,8,0,42,0
Watch These Trainers Get Their Asses Kicked At Aerial Yoga,1,1,10,39,0,9,0,49,0
"16 Reactions That Are All Too Real If You've Listened To Adele's ""Hello""",1,1,12,42,4,12,2,54,0
Watch A Very Vulnerable $140 Quadcopter Drone Get Hacked Out Of The Sky,1,2,12,43,1,12,3,55,0
This Dad Just Shut It Down By Videobombing His Daughters Dancing,1,1,11,43,0,10,0,54,0
11 Ways Knitting Is Actually Drugs,1,1,5,22,0,5,2,27,0
"Unicorn Nursery: Outside the U.S., India’s IIT Produces the Most Billion-Dollar Startup Founders - India Real Time",1,3,18,73,7,16,0,91,0
Hundreds of Islamic State Volunteers Have Returned to Britain,1,3,7,46,0,8,0,53,0
EXCLUSIVE – Islamic State Supporters Celebrate Berlin Truck ‘Attack’,1,3,16,41,3,8,0,57,0
21 Calendars To Get You Excited For 2016,1,1,6,21,0,7,6,27,0
"D.C. Homeless # Doubles National Avg, Living Costs Soar to Record Highs",1,2,11,45,4,11,0,56,0
Donald Trump's four hours a night and the other extreme sleeping habits of our leaders,1,3,2,69,1,14,0,71,0
Trump just promised the biggest tax cut in history. Here’s how big it would have to be.,1,2,2,66,3,16,0,68,0
22 Puns That Went WAY Too Far,1,2,8,13,0,6,2,21,0
Valentine's is a busy time for private eyes - but not for the reason you think,1,3,1,60,2,15,0,61,0
People Met Pet Rats For The First Time And Lost Their Damn Minds,1,1,13,39,0,12,0,52,0
17 Times Americans Went Too Hard On Valentine’s Day,1,3,8,32,1,8,2,40,0
Revealed: The foods you should NEVER put in the freezer - from breadcrumbs and potatoes to any hot food,1,3,7,76,2,18,0,83,0
The president of visuals,1,3,1,20,0,3,0,21,0
"A young boy, a devastating brain tumor and parents who ‘will do anything’",1,2,1,57,3,12,0,58,0
Willow Smith Is Officially A Model Now,1,1,7,25,0,6,0,32,0
How To Evaluate A Charity,1,3,5,16,0,4,0,21,0
You Have No Fucking Clue What The Origins Of These Memes Are,1,1,12,37,0,11,0,49,0
"Here's what Southern Rail passengers are saying about the strike on Twitter - 30,000 tweets analysed",1,3,4,73,3,15,5,77,0
"49 Facts You Probably Didn't Know About ""Bridget Jones's Diary""",1,1,9,39,4,9,2,48,0
Brokaw: ‘Democrats Have a Lot of Reconstruction to Do of Their Own Party’,1,2,9,49,3,12,0,58,0
I Carried Around A Sack Of Flour For A Week To See If I Would Be A Good Parent,1,1,19,41,0,18,0,60,0
18 Unforgettable Ways To Pizza-Tize Your Superbowl Party,1,1,8,38,1,7,2,46,0
13 Things That Happen When Your Best Friends Start Getting Married,1,1,10,44,0,10,2,54,0
34 Amazing Ways To Make Your Kitchen Even More Kickass,1,3,9,34,0,9,2,43,0
Could Nutella really cause cancer? Here's what you need to know,1,2,3,48,2,10,0,51,0
"This Toy Company Re-Created The ""Star Wars"" Trailer Using Their Own Toys And It's Incredible",1,1,16,58,4,14,0,74,0
Artists Made These Heartbreaking Posters As Tribute To Child Victims Of The Peshawar School Attack,1,1,15,69,0,14,0,84,0
Let's All Take A Minute To Appreciate Lin-Manuel Miranda's Surprise Wedding Performance,1,1,13,60,3,11,0,73,0
15 Vibrator Horror Stories That'll Make You Cringe,1,1,7,33,1,7,2,40,0
"‘Hot Mugshot Guy’ Is Now Super-Rich, Living in Mansion",1,3,9,33,4,8,0,42,0
Swedish Minister: Country Needs to Integrate Returning Islamic State Fighters,1,3,9,58,1,9,0,67,0
The Next Facebook? Wall Street Sizes Up Snap’s IPO,1,2,11,29,2,8,0,40,0
"The First Episode Of ""A Series Of Unfortunate Events"" Has A Surprise Ending",1,2,13,48,2,12,0,61,0
Climate Scientist Fires Back at House Science Committee During Hearing,1,3,9,52,0,9,0,61,0
Shia LaBeouf Is Asking His Fans to Call Him On The Phone And Touch His Soul,1,1,16,44,0,15,0,60,0
21 Very Honest Secrets From Virgins,1,1,5,23,0,5,2,28,0
Martha Stewart Shaded Wendy Williams For Bringing Up The Fact That She's In Her Seventies,1,1,15,59,1,14,0,74,0
21 Times Michael Ian Black's Tweets Made You Laugh Out Loud,1,1,10,36,1,10,2,46,0
"Which Planet In The ""Star Wars"" Galaxy Would You Hail From",1,1,11,35,2,10,0,46,0
"Matthew Dellavedova killed it at NBA Finals, so the Internet turned him into a meme",1,3,7,61,1,14,0,68,0
Pop with Purpose: In defence of Justin Bieber,1,2,5,32,1,7,0,37,0
Lists The secret to skipping the queues at the world's most crowded attractions,1,3,2,64,1,12,0,66,0
Jack White And Patrick Carney Allegedly Almost Got Into A Fight,1,1,11,42,0,10,0,53,0
We Asked 25 Non Scots To React To Scottish Things And It Was Deeply Hilarious,1,1,14,47,0,14,2,61,0
"23 Rihanna Memes That’ll Make You Say “Me, I Am Rihanna”",1,2,10,30,4,10,2,40,0
A Dad Recorded All The Adorable Questions His Son Asked When Watching Star Wars For The First Time,1,1,18,63,0,17,0,81,0
How to Get the Most Out of a Doctor’s Visit,1,3,6,27,1,9,0,33,0
Weird Things Siblings Believed Growing Up,1,1,6,30,0,5,0,36,0
Hillary Clinton: Sean Spicer Guilty of ‘Everyday Sexism’ (VIDEO),1,2,12,39,5,8,0,51,0
What The Navient Lawsuit Means For Your Student Loans: Part 3,1,2,10,39,1,10,1,49,0
Guess How Much This Extravagant Wedding Really Costs,1,1,8,37,0,7,0,45,0
21 Spooky Date Ideas For You And Your Boo,1,1,8,23,0,8,2,31,0
17 Insanely Beautiful Makeup Ideas For When You're Feeling Your Look,1,1,10,45,1,10,2,55,0
34 Of The Most Wholesome Tweets Of 2016,1,3,6,20,0,7,6,26,0
"This Maid Of Honor's ""Ice Ice Baby"" Wedding Toast Is Flawless",1,1,11,37,3,10,0,48,0
17 Photos That Will Make You Fall In Love With Young Matthew Perry,1,1,12,40,0,12,2,52,0
The Pessimist’s Guide to 2017,1,2,3,17,1,4,4,20,0
The Bedtimes Of The World’s Most Successful People Might Surprise You,1,2,11,47,1,10,0,58,0
McCain: Trump’s Attacks on Press Are ‘How Dictators Get Started’,1,2,10,41,4,9,0,51,0
Florida Lawmakers Introduce Bill Banning ‘Sanctuary’ Cities–with Penalties,1,3,8,56,3,7,0,64,0
What's The Funniest Reason You've Cried While On Your Period,1,1,10,39,2,9,0,49,0
"Well actually, this jaw-dropping Steph Curry highlight was an illegal move",1,2,3,59,2,10,0,62,0
This Artist Is Making Traditional Oil Paintings Of London Grime Artists,1,1,11,50,0,10,0,61,0
"Do You Belong With Chuck Bass Or Nate Archibald From ""Gossip Girl""",1,1,12,41,2,11,0,53,0
John Glenn Said Space Flight Made His Faith in God Stronger,1,3,10,39,0,10,0,49,0
Should Hollywood be afraid of the march of Netflix?,1,3,3,39,1,8,0,42,0
Americans Try Unusual Japanese Food Inventions,1,1,6,35,0,5,0,41,0
What Historical Decade Actually Matches Your Style,1,1,7,37,0,6,0,44,0
Did Anne Hathaway Wear These Hats In 2015 Or Some Other Year,1,1,11,34,0,11,4,45,0
Our eyes reveal when we're about to have an epiphany,1,2,1,41,1,9,0,42,0
Which Classic Movie Should Your Intro To Film Essay Be About,1,1,11,39,0,10,0,50,0
21 Pictures That Sum Up The End Of The Semester,1,1,9,27,0,9,2,36,0
Wounded Vets Are Being Honored With Purple Parking Spaces,1,1,9,40,0,8,0,49,0
This Tiny Hamster Enjoying His Tiny Doughnut Will Make You Enjoy Your Day A Tiny Bit More,1,1,17,56,0,16,0,73,0
"This Is What The Minor Characters From ""The Office"" Look Like Now",1,1,12,40,2,11,0,52,0
I Terminated My Much-Wanted Pregnancy,1,1,6,26,1,4,0,32,0
18 Grilled Cheese Sandwiches That Made Us Drool In 2015,1,1,8,32,0,9,6,40,0
What Type Of Candle Should You Light Right Now,1,1,9,29,0,8,0,38,0
Which Snake Are You,1,1,4,12,0,3,0,16,0
"A 16-Year-Old Girl Was Saved From Pimps, All Thanks To This Uber Driver's Alertness",1,2,15,49,4,13,2,64,0
21 Three-Ingredient Vegan Desserts That Are As Easy As They Are Delicious,1,1,12,47,1,11,2,59,0
Sexist Political Criticism Finds a New Target: Kellyanne Conway ,1,3,8,46,1,9,0,54,0
Will snow rescue Swiss Alps after dry start to winter?,1,2,3,41,1,9,0,44,0
Google’s Photos app now dramatically improves users’ videos,1,2,2,48,2,7,0,50,0
"'Jimmy Kimmel' Asks Warriors Fans About Fake Issues, Gets Hilariously Serious Responses",1,2,12,61,3,11,0,73,0
Americans Try Mincemeat Pies,1,1,4,21,0,3,0,25,0
Which Lana Del Rey Song Are You Based On Your Zodiac Sign,1,1,12,34,0,11,0,46,0
‘Boss Baby’ is the No. 1 movie in North America for a second weekend,1,3,5,46,3,13,1,51,0
"Which cars will most likely last for 200,000 miles?",1,3,1,34,2,8,6,35,0
15 Times Musicians Made It Really Hard To Concentrate On The Music,1,1,11,42,0,11,2,53,0
7 Things That Happen When You're The Child Of An Alcoholic,1,1,10,36,1,10,1,46,0
Pope Francis: ‘Muslim Terrorism Does Not Exist’,1,3,7,31,3,6,0,38,0
Mark Ruffalo Couldn't Stop Fanboying At This Year's BAFTAs,1,1,13,35,2,8,0,48,0
We Know Who Your Celebrity Boyfriend Should Be Based On One Question,1,1,12,45,0,11,0,57,0
18 Of The Best Headphones You Can Get On Amazon,1,2,9,27,0,9,2,36,0
Page Not Found - Yahoo,1,2,4,13,1,4,0,17,0
Limbaugh Calls Out Trump for Border Wall ‘Cave’ — ‘The Country Is Ready to Blame the Democrats’ for a Shutdown,1,2,14,72,5,19,0,86,0
Who took (and took) the most retaken penalty of all time?,1,3,1,43,3,10,0,44,0
Trump says Happy New Year in the most Trump way,1,3,5,33,0,9,0,38,0
"We Know Which ""Elder Scrolls"" Race You Are Based On How You Play ""Skyrim""",1,1,14,42,4,13,0,56,0
"Kate McKinnon Made Ryan Gosling Burst Out Laughing On ""Saturday Night Live""",1,1,13,49,2,11,0,62,0
Things Salvadoran-Americans Are Tired Of Hearing,1,1,7,35,1,5,0,42,0
17 Bunnies For All The Sad People Out There,1,1,8,25,0,8,2,33,0
We Know How Old You Are Based On Your Favorite Kitten,1,1,11,32,0,10,0,43,0
Man washing massive monster truck mistaken for plane crash ,1,3,1,49,0,9,0,50,0
Only A Geography Genius Will Get 50/50 On This State Capitals Quiz,1,3,11,39,1,11,4,50,0
Krauthammer on Bannon at CPAC: He Showed He Was ‘the Brains of the Operation’,1,3,12,49,3,13,0,61,0
"Amy Schumer Beautifully Crashed A ""Game Of Thrones"" Cast Photo",1,1,10,41,2,9,0,51,0
9 People Who Want Second Chances At Talking To Their Crushes,1,1,10,39,0,10,1,49,0
Would you wash your hands with leftovers from old cocktails?,1,3,1,49,1,9,0,50,0
Five Extraordinary Trips To Make This Holiday Season,1,3,8,37,0,7,0,45,0
Fried Fair Food Telephone - Feast Mode Hunger Squad,1,1,8,34,1,8,0,42,0
This Artist Perfectly Captured Awkward Straight People Sex In A Comic,1,1,11,48,0,10,0,59,0
Could You Pass Your Defence Against The Dark Arts O.W.L,1,1,12,32,2,9,0,44,0
23 Heartbreakingly Adorable Amigurumi You Can Make Yourself,1,1,7,43,0,7,2,50,0
Sia Proved Her Voice Is Completely Incredible During Carpool Karaoke,1,1,10,49,0,9,0,59,0
This is going to be harder than Donald Trump expected,1,2,3,41,0,9,0,44,0
17 Times The Animal Kingdom Summed Up Being Single,1,1,8,32,0,8,2,40,0
29 Childhood Snacks That Sadly Didn't Return In 2015,1,1,7,30,1,8,6,37,0
"10 Reasons ""Gotham"" Season 2 Is A Brand New Show",1,1,8,26,2,9,3,34,0
Here's Everything You Need To Know About This Year's Best Picture Nominees,1,1,12,49,2,11,0,61,0
We Bought This Insane Star Wars Toy So You Don't Have To,1,1,12,32,1,11,0,44,0
When Decorating Styles Clash ,1,2,4,21,0,4,0,25,0
The fashion industry really wants you to wear pajamas on the street. Don’t do it!,1,2,2,62,3,14,0,64,0
Elmo's Twitter Is Lit AF,1,1,6,13,1,4,0,19,0
"Democratic senator asks State Dept watchdog to probe Mar-a-Lago ""promotional"" material",1,2,5,67,4,10,0,72,0
"JoJo Just Released Her ""Say Love"" Video And It's A Truly Emotional Experience",1,1,14,48,3,12,0,62,0
People Get Real About The Best And Worst Parts Of Sex,1,1,11,32,0,10,0,43,0
‘Star Wars: Episode VIII’ Title Revealed,1,3,9,23,3,5,0,32,0
16 Christmas Pinterest Fails That Almost Nailed It But Didn't,1,1,9,40,1,9,2,49,0
"One Cookie, 2 Versions: Why Girl Scout S’mores Won’t All Be the Same ",1,3,11,40,4,13,1,51,0
"Money Isn’t Free, but Moving It Is Now Cheaper",1,3,8,28,2,8,0,36,0
"Don't Body-Shame Ariel Winter, Because She Will Clap Back",1,1,10,36,3,8,0,46,0
NBN website update allows you to find out when network is available in your area,1,3,3,63,0,14,0,66,0
"After Yangtze Ship Tragedy, A Deleted Report Drives Speculation - China Real Time Report",1,2,13,60,2,13,0,73,0
Will Carrigan's suicide sparks Where There's A Will campaign for mental health programs in schools,1,3,6,76,2,14,0,82,0
Here’s A Peek At The All-New “The Powerpuff Girls” Set To Air In 2016,1,2,14,34,4,13,4,48,0
Here's What Ariana Grande's New Song Really Means,1,1,8,32,2,7,0,40,0
25 Awesome Ways To Show Off Your State Pride,1,1,8,26,0,8,2,34,0
Kanye West Unknowingly Fell In Love With A Beck Song While At A Dinner With Taylor Swift,1,1,17,55,0,16,0,72,0
Poll: 55 Percent of Voters Support Trump’s Refugee Resettlement Freeze,1,3,8,49,2,9,2,57,0
A Mom Shared The Annoying Things Said About Her Daughter With Down Syndrome And Other Moms Joined In,1,2,18,65,0,17,0,83,0
This Colour Test Will Reveal Your Orgasm Face,1,1,8,30,0,7,0,38,0
Indians And Pakistanis Are Using The Hashtag #ProfileForPeace To Send Each Other Messages Of Love,1,1,17,65,1,14,0,82,0
"Parents Abandon Kids At Railway Station, A Policeman Gives Them A New Life",1,3,13,48,1,12,0,61,0
Mapping $27 Billion In Federal Funding Of America's Sanctuary Cities,1,2,9,46,2,9,2,55,0
"Britney Spears Fan Pranks Southwest Airlines, Receives the Perfect Response",1,2,9,56,1,9,0,65,0
What Career Should You Actually Have,1,1,6,25,0,5,0,31,0
"7 can't miss apps: 'Dots & Co.,' Facetune 2, Triller and more",1,3,4,36,8,11,2,40,0
Erdogan: European Headscarf Ban ‘Started a Clash Between the Cross and the Crescent’,1,2,9,60,3,12,0,69,0
14 Beautiful And Powerful Pictures From Mumbai's Pride Parade,1,1,8,42,1,8,2,50,0
These women marched against Donald Trump. Now they're running for office,1,3,4,56,2,10,0,60,0
Obama Crushes Conspiracy: No Evidence that Russia Tampered with Votes in Election,1,3,9,60,1,11,0,69,0
Texas A&M Player Kirk Merritt's Lawyer Provides Unbelievable Reason for Indecent Exposure Accusation,1,2,13,73,2,12,0,86,0
No fairytale ending: 'Magic beans' grow to reveal secret message telling you 'It's over' ,1,3,3,66,6,14,0,69,0
Lady Gaga's New Disco Cover Will Make Your Weekend,1,1,9,32,1,8,0,41,0
10 Things We're Looking Forward to at 2017 Grammys,1,3,5,30,1,8,6,35,0
Would You Smooch These Animals,1,1,5,21,0,4,0,26,0
National Star Wars Spoiler Day,1,1,5,21,0,4,0,26,0
"Mayor Sadiq Khan Says London ‘Safest Global City’, Slams Donald Trump Junior",1,2,12,50,3,11,0,62,0
Making the 'beast' beautiful: What if your anxiety could be useful?,1,3,2,51,4,10,0,53,0
21 Struggles That Are Too Real For People Who Blush Easily,1,1,10,36,0,10,2,46,0
Who Is The Worst TV Mother,1,1,7,14,0,5,0,21,0
Can You Spot Which Is The Real Simpsons Character,1,1,9,32,0,8,0,41,0
Russian man to undergo world's first full head transplant,1,2,1,47,1,8,0,48,0
Can We Guess If You'll Get Married This Year Based On Your Favorite Emoji,1,1,14,45,1,13,0,59,0
7 Times We Were All Kidding Ourselves,1,1,6,24,0,6,1,30,0
Locals praise 'hilarious' police Facebook appeal over man 'avoiding our calls',1,3,2,62,4,10,0,64,0
"7 can't-miss apps: Duobook, Forest, AlarmMon and more",1,3,4,36,5,7,1,40,0
"This Guy Made A $4,000 Suit From Scratch And It Took Him 10 Months",1,1,12,33,2,13,6,45,0
This Girl’s Fish Pulled A “Finding Nemo” Move On Her And Everyone Is Screaming,1,3,14,48,3,13,0,62,0
Someone Made A Trump-Putin Facebook Friend Anniversary Video,1,2,9,43,1,7,0,52,0
What New Song Should You Listen To On Repeat This Weekend,1,1,11,36,0,10,0,47,0
If Fortune Cookies Existed For Thirtysomethings,1,1,6,36,0,5,0,42,0
Can You Identify These Iconic '80s Movies Based On A Screenshot,1,1,10,40,1,10,2,50,0
Tom Brady Looks Like He's 100% Moved On At His Son's Hockey Game Since Broncos Loss,1,1,15,47,3,15,3,62,0
What goes on in your brain when you get dÃ©jÃ  vu,1,3,3,34,1,11,0,37,0
I Quit Sugar For 30 Days And This Is What Happened,1,3,10,28,0,10,2,38,0
Nicki Minaj Posts Joking Pregnancy Photo And Twitter Loses It,1,3,10,42,0,9,0,52,0
19 ways to make your Mac run faster right now,1,3,1,33,0,9,2,34,0
15 Images That Prove Britney Spears Is The Queen Of Target,1,1,10,36,0,10,2,46,0
18 Pictures You’ll Understand If You’re Permanently Tattooed By A Pencil,1,3,10,48,2,10,2,58,0
When You Should Quit Your Job Before Having Another,1,3,9,34,0,8,0,43,0
We Already Have a Magic Wand to Protect Fish -- Let's Use It,1,2,10,35,3,12,0,45,0
"Guillermo from 'Jimmy Kimmel Live!' Returns to NBA Finals, LeBron Ignores Him",1,3,13,49,4,11,0,62,0
How Erdoğan’s ruthless drive for more power is shaking a divided Europe,1,3,3,56,1,11,0,59,0
9 Disney Characters Whose Contouring Game Is On Point,1,1,8,36,0,8,1,44,0
Can You Pass This Sunday School Test For Children,1,1,9,32,0,8,0,41,0
24 Times Anna Kendrick Was 100% Actually You,1,1,6,25,1,7,5,31,0
Secretary of Education DeVos asks a question and Twitter goes nuts,1,2,5,51,0,10,0,56,0
23 Dance Moves That Changed Our Lives In 2015,1,1,7,24,0,8,6,31,0
54 of the most hilariously bad Amazon movie reviews,1,3,1,40,0,8,2,41,0
19 Snacks From Your Childhood You Literally Forgot About Until Right Now,1,3,11,48,0,11,2,59,0
24-year-old Latvian rookie had a fantastic reaction after becoming the first Spurs player ejected in 4 years,1,3,2,85,2,16,3,87,0
9 Things Elizabeth Taylor Taught Us About The Art Of Love,1,3,10,36,0,10,1,46,0
19 Movies That Would Be Way Different If They Were About Parenting,1,1,11,42,0,11,2,53,0
Why Blue States Are the Real ‘Tea Party’ ,1,3,7,24,2,8,0,31,0
What's Your Favorite School Subject Based On Your Zodiac Sign,1,1,10,41,1,9,0,51,0
Coachload of Korean Tourists Robbed in ‘Horror’ Attack Linked to Paris Riots,1,3,9,54,2,11,0,63,0
Arizona governor welcomes Uber fleet of self-driving cars,1,3,2,47,1,7,0,49,0
These High School Students Just Shut It Down With This Epic Lip Dub Video,1,1,14,46,0,13,0,60,0
"GOP Sen Cotton: If Dems Filibuster, ‘Republicans Will Do What We Must’ to Confirm Gorsuch",1,2,16,55,4,14,0,71,0
Are You Sweatersexual,1,1,3,16,0,2,0,19,0
10 Awesome Things You Can Make Out Of Duct Tape,1,1,9,27,0,9,2,36,0
This Is What Porn Sets Look Like When People Aren't Having Sex In Them,1,1,14,42,1,13,0,56,0
These Five Questions Will Determine What Your Milkshakes Will Bring To The Yard,1,1,13,54,0,12,0,67,0
Davos 2017: Teens' virtual reality challenge,1,2,2,31,2,5,4,33,0
"Donald Trump, Syria, Chuck Barris: Your Wednesday Briefing ",1,2,8,40,3,8,0,48,0
How Fancy Are Your Pants,1,1,5,15,0,4,0,20,0
The Man Behind Warren Buffett’s Big Insurance Bet,1,3,8,33,1,7,0,41,0
19 Reasons Why You Should Date Someone Short,1,1,7,28,0,7,2,35,0
We Know Your Pet Peeve Based On Your Favorite BuzzFeed Badge,1,1,12,38,0,10,0,50,0
How to Navigate New Airline Carry-On Rules ,1,2,7,28,1,7,0,35,0
23 Types Of Drunk Every British Drinker Has Been,1,1,8,30,0,8,2,38,0
"18 Clever Imgur Posts That All ""Back To The Future"" Fans Will Love",1,1,12,38,2,12,2,50,0
Here's What People Really Thought About That Trump Press Conference,1,3,10,47,1,9,0,57,0
Investing In Water,1,2,3,13,0,2,0,16,0
"The hipster is dead, and you might not like who comes next",1,3,1,45,1,11,0,46,0
21 Ways Being An Optimist Could Explain One Of Your Worst Habits,1,1,11,40,0,11,2,51,0
"Mexico, Syria, Trump: Your Wednesday Evening Briefing ",1,3,7,37,3,7,0,44,0
17 Adorable Reading Nooks That Are Cosy AF,1,1,8,25,0,7,2,33,0
32 Pictures That Will Take You Back To When Life Was So Damn Simple,1,2,13,39,0,13,2,52,0
15 Brilliant Takes On Macaroni And Cheese,1,1,6,27,0,6,2,33,0
How Trump Won,1,3,3,8,0,2,0,11,0
What's The Best Thing Someone Has Ever Done For You During Sex,1,1,12,38,1,11,0,50,0
Curly-Haired Women: Tell Us Your Most Incredible Hair Tips,1,1,10,38,2,8,0,48,0
21 Blenders That Failed So Hard They Just Failed,1,1,8,30,0,8,2,38,0
Donald Tusk row leaves Poland isolated in EU,1,2,5,32,0,7,0,37,0
The 27 Weirdest Celebrity Pictures Of All Time,1,1,7,30,0,7,2,37,0
First-Generation Americans Talk About The American Dream,1,1,8,41,1,6,0,49,0
Report: Trump Could Roll Back $1.7 Billion Worth of Dodd-Frank Regulations,1,3,10,48,4,10,2,58,0
What happens in the extremely unlikely scenario the Electoral College goes rogue?,1,2,3,66,1,11,0,69,0
Emma Watson Has Given A Brutally Honest Interview On Her Child Stardom,1,1,12,47,0,11,0,59,0
The United States of Pizza: The Best Pizza From Each of the 50 States,1,3,10,43,1,13,2,53,0
This Clip Of A Woman Swarmed By Baby Otters Will Make Your Day Much Better,1,1,15,45,0,14,0,60,0
10 New Year's Resolutions For Your Wallet,1,2,6,26,1,6,2,32,0
For Anyone Who's Received A Free Granola Bar In Their ASOS Order,1,1,15,37,1,11,0,52,0
U.S. cities are using this crazy device that blocks drivers' vision until they pay their fines,1,2,2,74,3,15,0,76,0
"What happened last night, Swedes ask Trump",1,3,3,32,1,6,0,35,0
Anthony Bourdain's 12 Greatest Quotes About Drinking,1,2,6,37,1,6,2,43,0
These Illustrations Will Speak To Anyone With Anxiety,1,1,8,38,0,7,0,46,0
"11 Alternative ""25"" Album Art Covers",1,1,4,21,2,5,4,25,0
The Best Dry Shampoo for Every Hair Type,1,2,7,26,0,7,0,33,0
8 Ways To Use Bi Invisibility To Your Advantage,1,1,8,30,0,8,1,38,0
15 Startling Confessions From People Who've Had Wet Dreams,1,1,8,39,1,8,2,47,0
41 Devastatingly British Things That Happened In 2015,1,1,6,34,0,7,6,40,0
This Woman’s Unsolved Death Will Freak You The Fuck Out,1,3,10,35,1,9,0,45,0
"Justin Trudeau Hosts An AMA On Quora, Posts His Own Picture To Prove It's Really Him",1,3,18,49,2,15,0,67,0
We Know If You Own A Pair Of White Vans,1,1,10,20,0,9,0,30,0
17 Life-Changing Ways To Eat PB&J,1,1,8,16,2,5,2,24,0
"15 Things You Never Knew About The Cast Of ""Pretty Little Liars""",1,1,11,38,2,11,2,49,0
16 Lessons I Learned From South Indian Movies,1,1,7,29,0,7,2,36,0
"17 Times ""Game Of Thrones"" Fans Freaked Out In 2015",1,1,8,26,2,9,6,34,0
17 Cute Halloween Makeup Tutorials That Got Way Too Creepy,1,1,9,38,0,9,2,47,0
Democrats aim to rebuild the blue political wall in Midwest,1,3,2,48,0,9,0,50,0
Here's What Beauty Ads Would Look Like If They Only Used The Advertised Product,1,1,14,51,1,13,0,65,0
Financial abortion: Should men be able to 'opt out' of parenthood?,1,3,2,50,4,10,0,52,0
Money is pouring into the world's hottest investment product at nearly a record-setting pace,1,3,1,76,2,13,0,77,0
What The World Was Like The Last Time The Mets Went To The World Series,1,1,15,42,0,14,0,57,0
12 Real AF Sex Situations That Will Make You Cringe,1,3,10,30,0,9,2,40,0
If Leslie Knope Quotes Were Motivational Posters,1,1,7,35,0,6,0,42,0
Which 2015 Movie Matches Your Zodiac Sign,1,1,6,25,0,6,4,31,0
17 People Who Prove Gap-Tooth Smiles Are Totally Contagious,1,1,9,39,1,8,2,48,0
22 Excellent Reasons To Ban The Rounds System Immediately,1,1,8,39,0,8,2,47,0
Nike Hits Historic High in Latest Teen Research Survey,1,3,8,38,0,8,0,46,0
How a MESSY ROOM affects your sleep: Hoarders take longer to nod off and are more dozy in the daytime,1,2,11,70,1,19,0,81,0
Ann Coulter: The Silence of the Lambs Congress,1,2,6,32,1,7,0,38,0
High Schooler Jumps Out of Plane For Epic Promposal,1,3,8,35,0,8,0,43,0
Cara Delevingne Has Opened Up About Her Struggle With Mental Illness,1,1,11,47,0,10,0,58,0
How Many Of The Top 100 TV Shows Of All Time Have You Seen,1,1,14,28,0,13,3,42,0
20 Times Women Rocked The Red Carpet In Dapper Suits,1,2,9,32,0,9,2,41,0
What Should You Bring To Your Office's White Elephant Gift Exchange,1,1,11,45,1,10,0,56,0
The Killing of Kim Jong Nam: Malaysia Probes Firm for North Korea Sanctions Violations ,1,3,12,60,1,14,0,72,0
A professor called Trump’s election an ‘act of terrorism.’ Then she became the victim of terror.,1,3,3,73,5,15,0,76,0
8 Ways You're Sabotaging Your Job Search,1,3,6,26,1,6,1,32,0
"22 Tweets About ""Fifty Shades Of Grey"" That'll Make You Laugh Every Time",1,1,12,43,3,12,2,55,0
Are You More Apple Spice Or Pumpkin Spice,1,1,8,26,0,7,0,34,0
Why Ariana Grande’s feminist Twitter post was a brilliant career move,1,3,4,54,1,10,0,58,0
These Jaw-Dropping Halloween Costumes Are For Kids In Wheelchairs,1,1,10,46,1,8,0,56,0
John Stamos Blessed The World With A Photo Of His Bare Ass For Paper Magazine,1,1,15,48,0,14,0,63,0
19 Struggles Of Taking Your Kid To The Bathroom In Public,1,1,10,35,0,10,2,45,0
What It Felt Like To Watch Trump's Speech As A Mexican-American,1,1,12,39,2,10,0,51,0
Here's Why Dave Chappelle Never Did Rick James Sketch for 'SNL',1,3,12,38,3,10,0,50,0
17 Tweets About Whole Foods That'll Actually Make You Laugh,1,1,9,38,1,9,2,47,0
The Disco Ball Is Having A Moment And There's Nothing You Can Do About It,1,1,15,43,1,14,0,58,0
86 Lana Del Rey Lyrics For When You Need An Instagram Caption,1,1,11,37,0,11,2,48,0
"These Photos Perfectly Capture The Extreme, Exhausting Lives Of Amateur Bodybuilders",1,1,11,62,1,10,0,73,0
Watch A Lifelike Portrait Of Emma Watson Come Alive In This Artist's Timelapse,1,1,13,52,1,12,0,65,0
A Utah law is shaking up the $4 billion contact lens industry and prices are about to drop - Business Insider,1,2,4,82,2,20,1,86,0
How a thing for Skee-Ball started a $3.2 million business,1,3,3,40,3,9,2,43,0
Community Episode 1: Ladders [Video],1,2,4,24,3,4,1,28,0
21 Things Scotland Has That The Rest Of The World Needs To Get In 2016,1,1,13,37,0,14,6,50,0
At least 8 die after drinking bath lotion in Russia,1,3,2,39,0,9,1,41,0
A Somali Hijabi Model Walked For Kanye’s Yeezy Fashion Line And It Was Badass AF,1,3,16,49,1,14,0,65,0
Navy fighter jets depriving pilots of oxygen,1,3,1,37,0,6,0,38,0
"In 2015, Toronto Truly Revealed Its Enduring Love For Raccoons",1,1,9,39,1,9,4,48,0
The 23 Most Important Things That Have Ever Happened On YikYak,1,1,11,39,0,10,2,50,0
19 Beautiful Gifts For People Obsessed With Frida Kahlo,1,1,8,37,0,8,2,45,0
Turkish designer Barbaros Sansal jailed after mob attacks him,1,3,3,50,0,8,0,53,0
If you're appalled by what's going on in Aleppo here are six ways you can help The list,1,3,3,65,2,17,0,68,0
If Urban Dictionary Definitions Were Motivational Posters,1,1,7,44,0,6,0,51,0
21 Secrets Chinese Restaurant Waiters Will Never Tell You,1,1,8,39,0,8,2,47,0
Pentagon recommends sending 400 additional US troops to Iraq ,1,3,4,45,0,9,3,49,0
Girls Pretended To Be Kim Kardashian And Wore A Waist Trainer For A Week,1,1,14,45,0,13,0,59,0
18 Totally Awesome Gifts For The Chicagoan In Your Life,1,1,9,35,0,9,2,44,0
"Check Out This Cool Ass Worm, It's A Christmas Tree",1,1,10,30,2,9,0,40,0
Chinese Social Media Rages over United Airlines Controversy,1,3,7,45,0,7,0,52,0
"We Demoed ""Yoshi's Woolly World"" And It Was Adorably Ridiculous",1,1,10,41,3,9,0,51,0
23 Annoying Things That Will Happen For The Rest Of Your Life,1,1,11,37,0,11,2,48,0
34 Tweets Guaranteed To Make Football Fans Laugh Every Time,1,1,9,39,0,9,2,48,0
An Adorable Animals Advent Calendar: December 5,1,1,6,33,1,6,1,39,0
Are You More Nick Or Joe Jonas,1,1,7,17,0,6,0,24,0
"Scott Pruitt's signature reads as 'penis' and no, we are not exaggerating",1,2,2,56,4,11,0,58,0
Why Theresa May’s decision to call a snap election took Britain by surprise,1,3,4,58,1,12,0,62,0
We Know Where You Were Born Based On Your Favorite Animals,1,1,11,37,0,10,0,48,0
Africa's top shots: 17-24 March 2017,1,3,2,18,3,5,8,20,0
"12 Burning Questions ""Fuller House"" Needs To Answer ASAP",1,1,11,33,2,8,2,44,0
13 Things You Should Never Say To A Latina When Dating,1,1,10,32,0,10,2,42,0
"Chance The Rapper's ""SNL"" Performance Will Give You Chills",1,1,11,36,3,8,0,47,0
11 Things People With Anxiety Want You To Know,1,1,8,28,0,8,2,36,0
21 Unrealistic Standards Of Beauty Set By Art History,1,1,8,35,0,8,2,43,0
16 Times Bollywood Stars Gave You Intense Vacation Goals,1,1,8,38,0,8,2,46,0
This 5-Second Video Of An Aunty At The Gym Has Broken The Damn Internet,1,1,14,42,1,13,1,56,0
15 Cheap And Super Creative Ways To Decorate Your Home With Maps,1,1,11,40,0,11,2,51,0
This person shut down a Twitter troll so hard even J.K. Rowling approved,1,2,5,53,2,12,0,58,0
"How Much Do You Really Know About ""Doctor Who""",1,1,9,27,2,8,0,36,0
"How often does it snow in the UK, and is it getting rarer?",1,3,3,41,2,12,0,44,0
"Chelsea Handler's Netflix Series Is All About Racism, Drugs, Marriage, And Robots",1,1,12,54,4,11,0,66,0
Which “Jurassic World” Dinosaur Are You?,1,3,6,26,3,5,0,32,0
"People Are Mad That Cosmo Called The Kardashians The ""First Family""",1,1,11,44,2,10,0,55,0
5 Ways Scammers Exploit Facebook To Feed You False Information,1,3,9,43,0,9,1,52,0
30 Gorgeous Tattoos Inspired By Great Books,1,1,6,29,0,6,2,35,0
Is Your Startup Secure? Here Are 3 Basic Cybersecurity Tips For Startups,1,3,11,48,1,11,1,59,0
"Katy Perry Wasn't Allowed To Read ""Harry Potter""",1,1,8,30,3,7,0,38,0
These Chicken Nuggets Are What Dreams Are Made Of,1,1,9,32,0,8,0,41,0
All The Times In 2015 That Miley Cyrus Reminded Us She Smokes Weed,1,1,12,38,0,12,4,50,0
Donald Trump's 10 weirdest ever facial expressions The list,1,2,3,45,1,8,2,48,0
Top 10 Business Trends That Will Drive Success In 2017,1,3,8,31,0,9,6,39,0
Photos Of Grown Men With Cats That Will Make Your Heart Explode,1,1,12,40,0,11,0,52,0
Lady Gaga Is Slaying The Old Hollywood Look At The Emmys,1,1,11,35,0,10,0,46,0
"Why tourists should still travel to cities attacked by terrorists, from London to Istanbul",1,3,3,73,1,13,0,76,0
22 Photos That Prove Britain Is A Fictional Country,1,1,8,33,0,8,2,41,0
Gay Hair Salon Owner Installs Anti-Bigotry Sign After Homophobic Incident,1,2,11,52,1,9,0,63,0
17 Horribly Awkward Phone Sex Confessions That'll Make You Want To Stick To Sexting,1,1,13,54,1,13,2,67,0
This Sick Dad Surprised His Daughter By Making It To Her Cross-Country Wedding,1,3,14,51,1,12,0,65,0
Dealmakers Let More Secrets Slip as Leaks Lead to Higher Offers,1,2,9,44,0,10,0,53,0
I Got Fake Bangs To Inoculate Myself Against Actually Getting Bangs,1,1,11,46,0,10,0,57,0
What's In Your Air,1,1,4,10,1,3,0,14,0
How Greylock VC Asheem Chandna Keeps Racking Up Billion-Dollar Outcomes,1,3,12,49,1,9,0,61,0
13 Cats Who Can't Halloween,1,1,4,16,1,4,2,20,0
Can You Guess Why This Winchester Brother Is Crying,1,1,9,34,0,8,0,43,0
17 Boozy Ice Cream Treats You Can Actually Make This Holiday Season,1,1,11,43,0,11,2,54,0
Maher: Trump’s Tax Plan Proves ‘Mental Illness Is Sad’,1,3,9,33,4,8,0,42,0
Shocking Video Appears to Show Security Guard Attacking Exotic Dancer During Performance,1,2,11,66,0,11,0,77,0
Outlander Just Made A Big Casting Announcement,1,1,7,33,0,6,0,40,0
'The Last Man on Earth' kills off Trump's entire administration,1,3,5,46,3,9,0,51,0
The world in 2016: how much do you know? – quiz,1,2,1,29,3,10,4,30,0
Show Us Your Regrettable Tattoo,1,1,5,22,0,4,0,27,0
30 Things You Might Not Know About Emilie De Ravin,1,1,9,30,0,9,2,39,0
"Hoops, wheels and moose-heads: playtime in the world's most inhospitable places",1,2,1,64,4,10,0,65,0
Are You Going To Get Married In 2016,1,1,7,18,0,7,4,25,0
Fabric reopens: I spent five hours on my own in the nightclub and was amazed that I wasn't harassed,1,3,3,76,2,18,0,79,0
Belle Was Literally The Fucking Worst,1,1,6,26,0,5,0,32,0
"8-Month-Old Pak Brother Donates Marrow To Save Toddler Sister's Life In Bengaluru, Becomes Youngest Donor Ever!",1,2,17,73,5,15,1,90,0
29 Ridiculously Delicious Chinese Recipes That Are Better Than Take-Out,1,1,10,49,1,9,2,59,0
A Fun Workout For People Who Hate The Gym,1,2,9,24,0,8,0,33,0
US Virgin Islands are paying people to visit them this year,1,3,4,45,0,10,0,49,0
The angry red panda that is Japan's new working woman,1,2,2,41,1,9,0,43,0
8 Things That Happen When Your BFF Starts Dating Someone,1,1,11,35,0,9,1,46,0
Acupuncture Can Effectively Treat Chronic Pain And Depression And That's A Good News For Many,1,2,15,63,1,14,0,78,0
18 Celebrity Instagrams You Need To See This Week,1,1,8,31,0,8,2,39,0
"Here's Why Halloween On ""Scream Queens"" Rules",1,1,7,29,3,6,0,36,0
29 Times We Reached Peak Blackness In 2015,1,1,6,23,0,7,6,29,0
Can We Guess Your Zodiac Sign Based On Your Fave Celebrities,1,1,11,39,0,10,0,50,0
Tumblr Users Have Discovered A Pun Which Works In So Many Languages,1,1,12,44,0,11,0,56,0
18 Boobs That Are Actually Christmas Miracles,1,1,6,31,0,6,2,37,0
Self-charging battery could put an end to your phone dying,1,3,1,47,1,9,0,48,0
"Golden Globe Awards, Fort Lauderdale: Your Monday Evening Briefing ",1,3,9,47,2,9,0,56,0
"Double-Edged Sword: Home Prices Keep Rising, Home Inventory Keeps Falling",1,2,11,50,3,9,0,61,0
Rachel Dolezal: What the rights activist's story says about being white in modern America,1,3,4,70,2,13,0,74,0
This Genius Baby Uses Pillows For A Master Class In Creative Problem Solving,1,1,13,51,0,12,0,64,0
Here's What Actually Happens When You Stop Taking Birth Control,1,1,10,43,1,9,0,53,0
43 Times We Were Obsessed With Tracee Ellis Ross,1,1,8,30,0,8,2,38,0
Mourners gather for funeral of black victim of sword slaying ,1,3,1,50,0,10,0,51,0
We Tried To Become Best Friends In One Week And Here's What Happened,1,1,13,42,1,12,0,55,0
Top New York Restaurants of 2016 - Video - NYTimes.com,1,3,8,30,3,9,4,38,0
10 Best Music Memes of 2016,1,3,3,13,0,5,6,16,0
The 5 U.S. banks that draw the most customer complaints,1,2,3,40,2,9,1,43,0
Mancan Wine In A Can Exists Because Masculinity Is Fragile As Fuck,1,1,12,43,0,11,0,55,0
Zayn Malik Posted A Photo With Gigi Hadid,1,1,8,26,0,7,0,34,0
27 Of The Happiest Cats In The World,1,1,7,20,0,7,2,27,0
Trump inauguration: Full text of new president's speech,1,3,2,44,2,7,0,46,0
Kellogg Foundation Supports Group Headed by Cop-Killer-Loving Black Lives Matter Founder,1,3,12,64,2,10,0,76,0
The Game Posted A Lovely Photo Of His Junk On Instagram For V-Day,1,1,14,38,1,12,0,52,0
For Anyone Who Is Sexually Attracted To Young Bernie Sanders,1,1,10,41,0,9,0,51,0
My Weekend At A Gaming Convention As Told By Snapchat,1,1,10,34,0,9,0,44,0
The Straight White Man’s Guide To The 21st Century,1,3,8,31,1,8,2,39,0
13 Tech Resolutions Everyone Should Make,1,1,5,28,0,5,2,33,0
When You're Bored AF,1,1,5,11,1,3,0,16,0
These Eerie Photos Capture The Oddball Beauty Of Suburban America,1,1,10,46,0,9,0,56,0
"We, Two Regular People, Tried Meal Prepping And Here's What Happened",1,1,11,44,3,10,0,55,0
9 Helpful Things For A Bad Day,1,1,6,17,0,6,1,23,0
11 reasons why women's football is better than men's,1,3,0,40,2,8,2,40,0
"The top 10 foods to eat to beat bloating and get a flat stomach, from trendy apple cider vinegar to Korean kimchi",1,2,2,87,1,21,2,89,0
"NBA Position Power Rankings, End of Regular Season Edition: Power Forwards",1,3,12,50,2,10,0,62,0
"18 ""Sexy"" Costumes For Guys That Will Make You Lose Your Faith In Halloween",1,1,13,45,2,13,2,58,0
17 Best Moments Of 2015,1,1,3,10,0,4,6,13,0
Taraji P. Henson Absolutely Slayed The Golden Globes Red Carpet,1,1,10,43,1,9,0,53,0
"An unexpectedly beautiful view of fatherhood, from the bathroom floor",1,2,1,58,1,9,0,59,0
Can You Find The Boner Hidden In These Bones?,1,2,9,27,1,8,0,36,0
The 11 Best Red Hot Chili Peppers Songs Of All Time,1,1,10,29,0,10,2,39,0
Texas Man and His Dog Found Dead After Becoming Trapped Inside Car,1,3,11,44,0,11,0,55,0
Who Sang It: Trace Adkins Or Dustin Lynch,1,1,8,25,1,7,0,33,0
"There Is A Huge Difference Between ""Fight Club"" And ""Mr. Robot""",1,1,11,37,5,10,0,48,0
For Everyone Who Feels Personally Attacked By People Chewing,1,1,9,43,0,8,0,52,0
Four Words That Give This CEO The Courage To Take On The Beauty Industry,1,3,16,43,0,13,0,59,0
Chrissy Teigen chilling at the Golden Globes is pure gold,1,3,4,44,0,9,0,48,0
15 Very Honest Confessions From Female Star Wars Fans,1,1,8,35,0,8,2,43,0
13 Women Show Off The Shoes They Feel Sexiest In,1,1,9,28,0,9,2,37,0
12 Emojis Your Mom Wishes She Could Send To You Right Now,1,1,11,33,0,11,2,44,0
I Just Found Out About These Insane Indoor Slides And You Gotta See This,1,3,14,45,0,13,0,59,0
"Trump’s Nuclear Weapons Tweet, Translated and Explained ",1,3,6,41,2,7,0,47,0
Cher Shuts Down Twitter Troll In Most Cher Way Possible,1,1,10,36,0,9,0,46,0
They Pretend To Be Us While Pretending We Don't Exist,1,1,10,33,1,9,0,43,0
"Sit Back, Relax, And Watch All My Favorite Vines From 2015",1,1,10,32,2,10,4,42,0
16 Bad Vagina Habits You Should Ditch ASAP,1,2,10,23,0,7,2,33,0
"Here's What The Voices From ""The Little Mermaid"" Look Like In Real Life",1,1,13,43,3,12,0,56,0
"Hillary Clinton Joins Instagram, Posts Funny Pic, People Get Mad",1,3,10,43,2,9,0,53,0
This Woman Perfectly Explains Why You Shouldn't Ask People Why They Don't Have Kids,1,1,14,54,2,13,0,68,0
"8 Halloween Costumes Only ""Game Of Thrones"" Fans Will Get",1,1,9,36,2,9,1,45,0
What Successful People Do On Sunday To Be Productive All Week,1,3,11,40,0,10,0,51,0
"The Bestselling Business Books, From 'Blink' To 'The Big Short'",1,3,10,39,5,9,0,49,0
"All Blacks go to town, an ally-oop gone wrong and a between-the-legs pass",1,3,2,55,4,12,0,57,0
8 Animals That May Not Survive 2016,1,1,5,19,0,6,5,24,0
Free online resources to improve productivity - Business Insider,1,2,3,52,1,8,0,55,0
23 Easy Homemade Chocolates To Treat Yourself With,1,1,7,34,0,7,2,41,0
Draymond Green: Refs applying double standard to me,1,3,3,40,1,7,0,43,0
What It's Like To Write The Most Hyped Book Of The Year,1,1,12,31,1,11,0,43,0
"As Indian Rat Catchers Get Jobs In Florida, This Is The Story Of South India's Last Rat Catcher",1,2,18,58,2,17,0,76,0
9 Things Girls With Short Hair Won't Understand,1,1,7,31,1,7,1,38,0
Fallout 4 May Have Caused A Dramatic Dip In Pornhub's Traffic,1,1,10,39,1,10,1,49,0
"Sarah Jessica Parker Had Trouble Not Judging Her ""Sex And The City"" Character",1,1,13,50,2,12,0,63,0
"ABC News quiz: Jean-Claude Van Damme in Parliament, Ned Kelly and a tax on dancing",1,3,11,54,3,14,0,65,0
We Know Your Zodiac Sign Based On The Things You Like,1,1,11,32,0,10,0,43,0
Donald Trump ‘Winning’ War with CNN,1,2,7,21,2,5,0,28,0
27 Women Sexily Consuming Chocolate,1,1,4,25,0,4,2,29,0
Inside the logo: Wolves' new look represents franchise ready to win,1,3,2,53,2,10,0,55,0
Childfree: Meet the women who don't want to become mums,1,3,2,42,2,9,0,44,0
Are You Netflix Or Are You Chill,1,1,7,19,0,6,0,26,0
"This 4/20, Catch A Buzz With A Cannabis Cocktail",1,3,8,27,2,8,3,35,0
"We Know Your Favorite ""Inside Out"" Character Based On Your Favorite Disney Characters",1,1,13,58,2,12,0,71,0
Here's how LeBron James recovers after every NBA Finals game,1,3,8,42,1,9,0,50,0
What’s the method in Trump’s madness?,1,3,2,27,3,5,0,29,0
Here’s How To Make 21 Healthy Meals For Under $50,1,2,8,26,2,9,4,34,0
Crackdown: AG Sessions Vows ‘New Era’ at Southern Border,1,3,9,36,3,8,0,45,0
"'Rogue' national park Twitter account wasn't so rogue after all, emails show",1,3,2,59,4,11,0,61,0
15 Photos Everyone Who Grew Up Catholic Will Understand,1,1,8,37,0,8,2,45,0
Which Early '00s Pop Diva Are You Based On Your Zodiac,1,1,10,31,1,10,2,41,0
Catholic high school could make millions on Snap public offering ,1,3,2,53,0,10,0,55,0
Which One Of Zayn Malik's Tattoos Are You,1,1,8,25,1,7,0,33,0
15 Indians Who Just Couldn't Stop Winning At Life In 2015,1,1,9,31,1,10,6,40,0
Ex-NFL RB Montee Ball reveals he would get drunk 4 times a week,1,2,8,41,1,12,1,49,0
11 Reasons Bindi Irwin Is An Incredible Role Model,1,1,8,32,0,8,2,40,0
The 2017 Oscars by the Numbers [Video],1,2,4,22,2,6,4,26,0
Brie Larson's Beautiful Red Gown Has a Hidden Message,1,3,8,36,1,8,0,44,0
Frozen Mr Fox: Hunter displays animal preserved in block of ice,1,3,4,48,1,10,0,52,0
"10 Excuses To Use To Play Hooky For ""STAR WARS: THE FORCE AWAKENS""",1,1,30,19,3,12,2,49,0
This Couple Got Their Ancestry Traced And It Didn't Go As Planned,1,1,12,41,1,11,0,53,0
Here's How To Find Out Your Uber Passenger Rating (If You Really Want To Know),1,1,15,46,3,14,0,61,0
These airlines just trolled United so hard on Twitter,1,3,3,42,0,8,0,45,0
Va. woman showing friend how to play lotto game wins $1M,1,3,2,41,2,10,1,43,0
"21 ""Pocahontas"" Tattoos That Are Breathtakingly Beautiful",1,1,6,41,2,6,2,47,0
Tinker Bell Is Actually The Worst Disney Character,1,1,8,35,0,7,0,43,0
29 Celebrities In 2006 Compared With Now,1,1,5,23,0,6,6,28,0
"The Cast Of ""Brooklyn Nine-Nine"" Plays ""Never Have I Ever""",1,1,11,33,5,9,0,44,0
"Here's What You Need To Know About ""Color-Melting"" Your Hair",1,1,11,36,4,9,0,47,0
Can You Solve This Tricky Tribute Puzzle To A Classic Board Game,1,1,12,41,0,11,0,53,0
This Web Series Is Helping Trans Teens Find Their Personal Definition Of Beauty,1,1,13,54,0,12,0,67,0
19 Firsts All Close Mums And Daughters Go Through,1,1,8,31,0,8,2,39,0
Meet the robonauts: NASA's humanoid robots,1,3,5,30,2,5,0,35,0
"Money Isn’t Free, but Moving It Is Now Cheaper",1,2,8,28,2,8,0,36,0
What's The Most Annoying Misconception About Sororities,1,1,7,41,1,6,0,48,0
Here come the Fed minutes ...,1,3,2,19,3,5,0,21,0
"Dem Rep. Chaka Fattah Gets 10 Years in Prison for Fraud, Racketeering, Money Laundering",1,3,11,58,3,13,2,69,0
Why This Woman Removed Her Healthy Breasts And Ovaries,1,1,9,37,0,8,0,46,0
20 Pictures That Prove Mums Are Way Funnier Than We Give Them Credit For,1,1,13,44,0,13,2,57,0
Here's Why You Shouldn't Care About How Damn Cold It Is,1,1,11,32,2,10,0,43,0
19 Things You’ll Only Get If You’re High- AND Low-Maintenance,1,3,12,34,4,9,2,46,0
"In the Face of A.L.S., Simon Fitzmaurice Finds His Fire Inside ",1,3,11,37,4,11,0,48,0
13 Egg-cellent Easter Nail Art Ideas,1,3,5,23,1,5,2,28,0
The One Career Lesson My First Job Taught Me,1,3,9,27,0,8,0,36,0
How Intensely Long Island Are You,1,1,6,22,0,5,0,28,0
"30 Years Later, The Creepy Max Headroom Broadcast Interruption Remains Unsolved",1,3,10,56,1,10,2,66,0
25 Incredible Greek Islands You Need To See Before You Die,1,1,10,36,0,10,2,46,0
Mysteries of crown-like structures on Venus' surface revealed,1,2,2,50,2,7,0,52,0
"Coca-Cola to cut 1,200 jobs as consumers turn away from sugary drinks",1,3,2,50,2,11,4,52,0
19 Healthy Drinks Your Bartender Won't Hate You For Ordering,1,1,9,39,1,9,2,48,0
Buffalo Bills Player Asks Cops to Shoot Him During Bizarre Incident,1,3,10,47,0,10,0,57,0
How to file for a tax extension before you run out of time,1,3,1,45,0,12,0,46,0
A Brief History of Humankind’s Desperate Attempts to Stay Fit,1,3,8,43,1,9,0,51,0
Donald Trump: Post-election euphoria in Russia begins to fade Featured Stories Additional stories,1,3,7,76,2,12,0,83,0
ISIS Has Put A Million Dollar Bounty On This Woman After She Hunted Them In Syria And Iraq,1,3,21,52,0,17,0,73,0
"How Entrepreneurs Can Build A Better Power Network, One Dinner At A Time",1,3,13,46,1,12,0,59,0
"What Happened To This Guy On ""First Dates"" Will Give Hope To Socially Anxious People Everywhere",1,1,16,62,2,15,0,78,0
17 Dick Pics You’d Actually Like To Receive,1,3,7,26,1,7,2,33,0
24 Times Toast The Dog Won Us Over In 2015,1,1,8,19,0,9,6,27,0
We Know Whether Or Not You Like Cilantro,1,1,8,25,0,7,0,33,0
23 Adorable Penguin Products You Need In Your Life,1,1,8,32,0,8,2,40,0
Five Traits That Separate Job Seekers Who Get Hired From Those Who Do Not (With Real-Life Examples),1,3,18,62,3,16,0,80,0
10 Insanely Delicious Cheesecakes You Won't Believe Are Vegan,1,1,8,42,1,8,2,50,0
18 Old People Who Are Living Their Goddamn Lives,1,1,8,30,0,8,2,38,0
"Am I using this emoji right, or did I accidentally just sext someone?",1,3,3,52,2,12,0,55,0
15 Mugs The Video Gamer In Your Life Will Love,1,1,9,26,0,9,2,35,0
"24 Perfect Simon Amstell Comebacks From ""Never Mind The Buzzcocks""",1,1,9,44,2,9,2,53,0
What India’s Microloan Meltdown Taught One Entrepreneur ,1,2,7,41,1,7,0,48,0
How Evolved Are You,1,1,4,12,0,3,0,16,0
Eleven Ways to Stop Winter Weather Delays From Ruining Your Travels,1,3,10,47,0,10,0,57,0
Are You More Olivia Benson Or Olivia Benson,1,1,8,28,0,7,0,36,0
‘Frozen’s’ Original Ending Finally Revealed,1,3,5,31,3,4,0,36,0
18 Of The Greatest Photos To Have Taken Place Inside A Photo Booth,1,1,12,40,0,12,2,52,0
Which Celebrity Should Be Your Life Coach,1,1,7,28,0,6,0,35,0
5 ways criminals will try to scam you this tax season,1,3,0,42,0,10,1,42,0
A Harry Potter-Themed Bar Just Opened And You Have To Pay Your Respects,1,1,14,44,1,12,0,58,0
The Doctor Who Taste Test,1,1,5,16,0,4,0,21,0
The 17 Biggest Surprises Of This Year's Oscar Nominations,1,1,8,38,1,8,2,46,0
We compared prices at Whole Foods to those at Trader Joe's â and the results were surprising,1,3,5,70,3,16,0,75,0
Italians Review Europe's Most Popular Beers,1,1,6,31,1,5,0,37,0
Are You The Fox Or The Hound,1,1,7,15,0,6,0,22,0
Beardless Guys Got Fake Beards For A Day And Found Their Hairy Alter Egos,1,1,14,46,0,13,0,60,0
22 Brutally Honest Confessions From A Veterinarian,1,1,6,36,0,6,2,42,0
Would Your City Survive The Zombie Apocalypse,1,1,7,32,0,6,0,39,0
Two Huge Broadway Stars Covered Selena Gomez And It's Amazing,1,1,10,41,1,9,0,51,0
23 Patches For Your Tattered Clothes And/Or Life,1,1,8,30,1,7,2,38,0
7 Ways To Totally Ignore Your Man's Balls,1,1,7,25,1,7,1,32,0
46 Literary Baby Names That'll Make You Want To Have Children,1,1,10,38,1,10,2,48,0
26-year-old 'echo boomers' are running wild in America â here's what they're all about,1,2,1,64,8,13,2,65,0
Nate Silver: ‘There Really Was a Liberal Media Bubble’,1,2,8,35,3,8,0,43,0
"Gamers Angry At 'For Honor' Paywall, Ubisoft Insists Players Aren't 'Meant To Unlock Everything'",1,3,14,63,6,13,0,77,0
"Which Occupation From ""The Bachelor"" Should You Actually Be Doing With Your Life",1,1,13,53,2,12,0,66,0
The death of brick-and-mortar retail could hit these 9 companies hard in 2017,1,3,1,57,2,12,5,58,0
Here Are All The Super Bowl Commercials People Will Be Talking About,1,1,12,45,0,11,0,57,0
This Post Is Supposed To Make You Feel Better Right Now,1,1,11,34,0,10,0,45,0
What Goes Into Planning The Inaugural Ball And Why This Year Is Like No Other,1,3,15,48,0,14,0,63,0
Report: Obama Intel Officials Used ‘Russia Blackmail’ Claims to Warn Israel About Trusting Trump  ,1,2,13,67,3,15,0,80,0
17 Tumblr Posts With Plot Twists That Will Fuck You Up,1,2,10,32,0,10,2,42,0
9 People Pose Nude To Show What Body Diversity Really Looks Like,1,3,11,41,0,11,1,52,0
Bobby Flay And His Cat Are The Most Magical Duo Ever,1,1,11,31,0,10,0,42,0
18 Times Squidward Perfectly Captured The Dating Struggle,1,1,7,41,0,7,2,48,0
7 Home Purchases Worth The Splurge,1,3,5,23,0,5,1,28,0
23 Times Eating Eggnog Was Better Than Drinking It,1,1,8,32,0,8,2,40,0
Which Zodiac Is Your Perfect Match Based On Your Favourite Video Game,1,1,12,46,0,11,0,58,0
"21 Times The ""Gilmore Girls"" Cast Redefined Friendship Goals",1,1,8,40,2,8,2,48,0
"Which ""Durarara!!"" Character Are You",1,1,5,23,4,4,0,28,0
Girl On The Net: Leading UK sex blogger reveals how maintaining anonymity helped lead to a mental breakdown,1,2,7,82,1,17,0,89,0
"If You Love Your Pets, Don't Keep These 10 Plants in the House",1,3,10,36,2,12,2,46,0
This teenager discovered a new planet on his third day at work,1,3,1,50,0,11,0,51,0
NBC NewsVerifizierter Account,1,3,6,21,0,2,0,27,0
We Know Which Female Disney Character You Are Based On Your Zodiac,1,1,12,43,0,11,0,55,0
"This Facebook Post About A ""Lost Dog"" Has A Surprise Ending",1,1,11,36,2,10,0,47,0
"Sports in 2016: Winners, Losers and Cheaters ",1,3,4,28,2,7,4,32,0
"19 Times ""Freaks And Geeks"" Perfectly Portrayed High School",1,1,8,39,2,8,2,47,0
This One Question Will Tell You What People Love About You,1,1,11,37,0,10,0,48,0
Maher: It Looks Like Russia ‘Installed’ ‘Trump and His Crime Family’ ‘To Loot and Destroy America,1,3,14,62,6,15,0,76,0
"5 Steps To Help Any Woman Survive A Horror Movie, As Told By Malin Akerman",1,1,14,44,1,14,1,58,0
24 Candy Cane Themed Desserts That Are Better Than A Boyfriend,1,1,10,40,0,10,2,50,0
19 Reasons Everyone Needs To Use Their Damn Turn Signals,1,1,9,36,0,9,2,45,0
"Poll: Which Is Better, ""Harry Potter"" Or ""Game Of Thrones""",1,1,10,33,6,9,0,43,0
"Nicki Minaj Performed Maya Angelou's ""Still I Rise"" And It Will Inspire You",1,1,13,47,3,12,0,60,0
Listen – Breitbart’s Aaron Klein: UN Anti-Israel Resolution May Have Inspired Palestinian Terror Campaign,1,3,15,73,4,13,0,88,0
Pigeons Love Wearing Bagels Apparently,1,1,5,29,0,4,0,34,0
Not Captain Anymore? No Problem! MS Dhoni Comes To The Party With A Brilliant Hundred,1,3,16,53,2,14,0,69,0
"Disabled veteran, beaten for trying to save turtle's life, gets big surprise",1,3,1,61,3,11,0,62,0
26 People Who Got Shittier Christmas Gifts Than You,1,1,8,33,0,8,2,41,0
Advanced Imaging Reveals Secrets of 1491 Map Columbus May Have Used,1,3,9,44,0,10,4,53,0
There’s a 2020 presidential poll out! And it’s not totally useless!,1,3,2,47,4,10,4,49,0
Pizza Hut Hot Dog Bites Pizza Is The Pizza America Deserves,1,2,11,38,0,10,0,49,0
Trump Administration Hits Small Farmers With More Bad News,1,3,9,41,0,8,0,50,0
26 People Who Completely Failed At Cooking,1,1,6,28,0,6,2,34,0
19 Pictures That Sum Up How Absolutely Ridiculous It Is Finding A Job,1,1,12,43,0,12,2,55,0
Claus' claws: Mom says Santa insulted her son,1,3,3,33,2,7,0,36,0
'I'd do it again in a heartbeat' – your stories of being a stay-at-home dad,1,3,1,54,6,14,0,55,0
Buffalo Bills Player Asks Cops to Shoot Him During Bizarre Incident,1,2,10,47,0,10,0,57,0
Smile! This Restaurant’s Two-Way Mirror Is Filming You Taking Selfies.,1,3,11,46,4,9,0,57,0
27 Simply Lovely Wes Anderson-Inspired Wedding Ideas,1,1,7,36,1,6,2,43,0
21 Things You'll Just Get If You're Vain AF,1,1,9,22,2,8,2,31,0
Which J.K. Rowling Tweet Are You Based On Your Zodiac Sign,1,1,12,34,2,10,0,46,0
This hidden Twitter setting will free up iPhone storage space,1,2,3,49,0,9,0,52,0
An Adorable Animals Advent Calendar: December 18,1,1,6,33,1,6,2,39,0
"Why the new year starts on Jan. 1, a terrible time for renewal",1,2,2,45,2,12,1,47,0
Ellen Page Leads The Way,1,1,5,15,0,4,0,20,0
We Need To Stand Together And Defend Zac Efron's Mustache,1,1,10,37,1,9,0,47,0
23 Of The Worst Things People Have Actually Said On A First Date,1,1,12,38,0,12,2,50,0
17 Insanely Awesome Starbucks You Need To See,1,1,7,29,0,7,2,36,0
9 things you didn't know about Air Force One,1,3,3,31,1,8,1,34,0
31 Incredibly Helpful Tips And Hacks For A New Baby,1,1,9,31,0,9,2,40,0
Which Sassy Tree Are You Based On Your Zodiac,1,1,9,28,0,8,0,37,0
Which Classic Cocktail Are You,1,1,5,21,0,4,0,26,0
Day 3 Of BuzzFeed's 7-Day Clean Eating Challenge,1,1,8,29,2,7,2,37,0
Quiz of the week's news,1,2,1,17,1,4,0,18,0
15 Situations That Every Dog Owner Will Understand,1,1,7,34,0,7,2,41,0
Undercover Journo Report: Migrant Centres ‘Breeding Ground for Terrorists’,1,3,8,55,3,8,0,63,0
Ways Your Diet Proves You're Broke AF,1,1,8,22,1,6,0,30,0
Why It Matters That Pence Won't Have Dinner With A Woman Who Isn't His Wife,1,3,15,44,2,14,0,59,0
"Veterans at Wisconsin VA Hospital May Have Been Infected with Hepatitis, HIV",1,3,13,51,1,11,0,64,0
"Merkel Stands by Migrant Policy in New Year’s Speech, Says Germany Fights Terrorism with Compassion",1,2,12,71,2,14,0,83,0
19 Things To Say To Someone Who Won't Text You Back,1,1,10,28,1,10,2,38,0
There Could Soon Be A New Tournament Between The MLS And Premier League,1,1,15,44,0,12,0,59,0
The Best Cure for a Cough May Actually Be Chocolate,1,3,8,34,0,9,0,42,0
When You Go To Work Naked,1,1,6,14,0,5,0,20,0
"Fuck, Marry, Kill: The Dude Names Edition",1,1,7,25,3,6,0,32,0
Scientists: Asian Pollution Causing West Coast Smog,1,3,7,37,1,6,0,44,0
Would Obama Have Sanctioned Russia If Hacking Helped Hillary Win?  Insider,1,3,11,51,1,11,0,62,0
We Need To Talk About Kesha,1,1,6,16,0,5,0,22,0
5 Key Takeaways From President Trump’s Speech ,1,3,6,31,1,7,1,37,0
Leonard Fournette 12 pounds lighter at pro day,1,2,2,35,0,7,2,37,0
"8-Month-Old Pak Brother Donates Marrow To Save Toddler Sister's Life In Bengaluru, Becomes Youngest Donor Ever!",1,3,17,73,5,15,1,90,0
"Are You More ""Laguna Beach"" Or ""The Hills?""",1,1,8,23,5,7,0,31,0
Watch These Darling Kitten Siblings Get Confused By Their Cones,1,1,10,44,0,9,0,54,0
The 50 best young footballers in Italy,1,3,2,28,0,6,2,30,0
"Here's How To Survive Adulthood, According To Judah Friedlander",1,1,9,44,2,8,0,53,0
Guys Try Pinterest Leaf Hacks,1,1,5,20,0,4,0,25,0
The 50 Best Notorious B.I.G. Songs,1,3,7,17,3,5,2,24,0
Unlucky Owner's LaFerrari Supercar Worth Rs 6.5 Crores Is About To Be Crushed Into A Cube,1,3,16,54,2,15,2,70,0
"PC Is UN’s Newest Goodwill Ambassador, TV Actress Nia Sharma Beats Katrina-Alia And More From Ent",1,3,20,59,3,15,0,79,0
Here's How These Rappers Got Their Names,1,1,7,26,1,6,0,33,0
"I Played The Drake And Future Inspired ""Jumpman"" Game And Wasn't That Good At It",1,1,15,48,3,14,0,63,0
"Jimmy Kimmel Montage Proves Donald Trump Is A Mover, Not A Shaker",1,3,12,41,1,11,0,53,0
A CEO and former Googler explains how to talk about the gap on your rÃ©sumÃ©,1,3,7,53,2,14,0,60,0
"Is This Celeb Danish, Norwegian, Or Swedish",1,1,7,28,2,6,0,35,0
What Assumption Has Someone Made About You Because You're A Feminist,1,1,11,46,1,10,0,57,0
How to Not Lose Your AirPods ,1,3,6,17,0,6,0,23,0
"AFL-CIO Praises President Trump’s Move to Withdraw from TPP, Renegotiate NAFTA, Target Big Pharma",1,2,23,57,4,13,0,80,0
Which TV Brother Should Be Your Brother In Real Life,1,1,11,32,0,9,0,43,0
"19 Times ""How I Met Your Mother"" Hilariously Mocked Canada",1,1,9,36,2,9,2,45,0
Initial jobless claims fall to their lowest level since March 1973,1,3,2,50,0,10,4,52,0
"Rory Williams Has Pretty Much Graduated From Companion To Doctor On ""Legends Of Tomorrow""",1,1,14,60,2,13,0,74,0
Why Building Community Is Way Better For Your Career Than Networking,1,3,11,47,0,10,0,58,0
Which Decade Of J.Lo Are You,1,1,7,15,1,5,0,22,0
34 Questions You Secretly Wish You Could Ask Your Ex,1,1,9,32,0,9,2,41,0
The 19-year-old Dunkin' Donuts worker behind Ashley Judd's viral #NastyWoman poem,1,2,7,57,5,10,2,64,0
Juicero And United: Two Real-Time Case Studies In Crisis PR For Entrepreneurs,1,3,14,50,2,11,0,64,0
14 Reasons You Wish You Were The Duchess Of Cambridge,1,1,9,33,0,9,2,42,0
"24 Times Jess From ""New Girl"" Was 100% Actually You",1,1,8,26,3,9,5,34,0
"The End Of Last Night's ""Walking Dead"" Is More Proof Glenn Is Definitely Alive",1,1,14,48,3,13,0,62,0
Lena Dunham: Feminists Must Enlighten White Women Who Voted for Trump,1,3,10,48,1,10,0,58,0
24 Hilarious Tweets Every Grammar Nerd Will Appreciate,1,1,7,38,0,7,2,45,0
My Therapist Wrote My Breakup Text,1,1,6,23,0,5,0,29,0
Afghanistan: The only gynaecologist for hundreds of miles,1,3,2,47,1,7,0,49,0
21 Things Only MAC Lovers Can Truly Appreciate,1,1,9,28,0,7,2,37,0
Jack Black Tried Halloween Pinterest Hacks And Became A Master Pinner,1,1,11,48,0,10,0,59,0
This Spinach And Artichoke App Will Change Your Life,1,1,9,35,0,8,0,44,0
17 Incredible Lesbian Pinays You Need To Know,1,1,7,29,0,7,2,36,0
Injuries Can Put Teen Athletes on Path to Addiction,1,3,7,36,0,8,0,43,0
13 Things Ruby Rose Looked Like At The MTV EMAs,1,1,13,23,0,9,2,36,0
5 Things For New Investors To Know Before Investing In Marijuana Stocks,1,2,11,48,0,11,1,59,0
Nick Saban’s Grand Recruitment Tool: A Piano,1,2,7,29,2,6,0,36,0
"What's Your Favorite ""Parks And Recreation"" Moment Ever",1,1,8,37,3,7,0,45,0
Syrian Airfield Strike: What Is a Tomahawk Land Attack Missile?,1,2,9,43,2,9,0,52,0
Limbaugh: ‘Preposterous’ to Believe Russians Had Any Influence on Trump’s Election,1,3,9,59,4,10,0,68,0
A Travel Hacker's Guide to Elite Status in 2017 and Beyond,1,3,7,36,1,10,4,43,0
Old School Trading Pits to Remain After High-Tech Exchange Deal,1,3,10,43,1,9,0,53,0
8 Christmas Miracles That Actually Happened In Canada This Year,1,1,9,44,0,9,1,53,0
Summer movie preview: What to watch if you just want to see the best of the best,1,3,2,61,1,16,0,63,0
"Retired builder, 65, knocks up a bizarre UPSIDE DOWN house despite his wife dismissing the idea as 'crazy' ",1,3,11,72,4,18,2,83,0
This One-Question Quiz Will Tell You How Gullible You Are,1,1,11,36,1,9,0,47,0
Why can’t TV tap into these plays for today’s marginalised?,1,2,3,44,3,9,0,47,0
18 Little Things You'll Have To Explain To Your Kids One Day,1,1,11,35,1,11,2,46,0
Waka Flocka Just Questioned Gucci Mane’s Street Cred,1,3,8,36,1,7,0,44,0
Why This Tech CEO Is Promising To Pay Customer Refunds From His Own Paycheck,1,2,16,47,0,13,0,63,0
Which Queen Are You Based On Your Zodiac Sign,1,1,9,28,0,8,0,37,0
Goldberg defeats Kevin Owens to win WWE Universal Championship,1,2,8,46,0,8,0,54,0
19 Times Joey Tribbiani Perfectly Summed Up Your Relationship With Food,1,1,10,49,0,10,2,59,0
Wasserman Schultz: Hillary Using ‘Her Overwhelming Popularity’ to ‘Advance the Dialogue’,1,3,9,64,5,10,0,73,0
"Let's See How Well You Remember The First Episode Of ""Misfits""",1,1,11,38,3,10,0,49,0
68 New Year's Resolutions That Will Help You Own Your Twenties In 2016,1,1,11,40,1,12,6,51,0
What Bad Teenage Fashion Choice Do You Regret The Most,1,1,10,35,0,9,0,45,0
17 People Who Just Want This Election To Be Over,1,1,9,28,0,9,2,37,0
The iPhone X: Coming in 2017?,1,3,4,14,2,5,4,18,0
"16 Of The Worst Possible Responses To ""I Love You""",1,1,9,28,2,9,2,37,0
"Unhappy With Officials' Presentation On Development Works, PM Modi Walks Out Of The Meeting Midway",1,3,16,66,2,14,0,82,0
"‘Wonder Woman,’ ‘Spider-Man’ and How Trailers Push the Familiar ",1,3,8,41,6,9,0,49,0
What Is Your Favorite Activity When Visiting Family,1,1,8,36,0,7,0,44,0
This Is How You Veggie Burger,1,1,6,18,0,5,0,24,0
24 Things You Know If You're Always Hosting Dinner Parties,1,1,9,37,1,9,2,46,0
Schumer Calls on Sessions to Resign — We Need A Special Prosecutor,1,3,9,45,1,11,0,54,0
"A Priest, Rabbi, And Imam Discuss Gay Rights & More",1,1,9,30,3,9,0,39,0
"Which Of The Two ""Supernatural"" Brothers Is The Hottest",1,1,9,36,2,8,0,45,0
This Is The Best Place To Get Dope Men's Clothes For Cheap,1,1,12,34,1,11,0,46,0
"Lady Gaga And Matt Bomer's ""AHS: Hotel"" Bloody Orgy Was Choreographed",1,1,13,42,4,10,0,55,0
How Many Cuban Dishes Have You Tried,1,1,7,23,0,6,0,30,0
Lesbian Women Ask Gay Men Questions We All Want To Know,1,1,11,34,0,10,0,45,0
The 10 best tennis moments in culture,1,3,1,28,0,6,2,29,0
How Well Do You Really Know Chocolate Chip Cookies,1,1,9,33,0,8,0,42,0
17 Instagram Photos Every Short Girl Can Relate To,1,1,8,32,0,8,2,40,0
ABC Open: Your best pictures from around Australia this week,1,3,6,44,1,9,0,50,0
Nick Cannon Kind Of Predicted Mariah Carey Would Leave Him For A Billionaire,1,1,13,51,0,12,0,64,0
Women Are Tie-Dyeing Their Hair And It's Pretty Crazy,1,1,10,33,2,8,0,43,0
This Man's Hairy Back Will Make Your Jaw Drop,1,1,9,27,1,8,0,36,0
People Who Get the Best Sleep Have These 4 Things in Common,1,3,9,38,0,11,1,47,0
Pigskin A Blanket: NFL Week 12 Picks,1,1,8,19,1,6,2,27,0
Green Veggies Like Celery And Broccoli Can Help Improve Breast Cancer Treatment,1,3,12,56,0,11,0,68,0
Which 2009 Pop Hit Are You,1,1,5,12,0,5,4,17,0
Detailed security footage shows the alleged journey of Tom Brady's stolen Super Bowl jersey,1,2,5,72,1,13,0,77,0
"Obama Oversees Year of Mass Regulation, Record 97,000 Pages of Red Tape",1,3,9,44,2,11,5,53,0
"6 Awkward Holiday Conversations You're Dreading, And How To Deal With Them",1,1,11,49,2,11,1,60,0
"Four Killed, 16 Injured in Jerusalem Truck-Ramming Terror Attack",1,3,8,44,2,8,2,52,0
Here's How Orphan Black Fans Are Dealing With Tatiana Maslany's Emmy Loss,1,1,12,48,2,11,0,60,0
"Psst, Free Idea: Let's Stop Sexualising Underage Bollywood Kids",1,1,9,43,3,8,0,52,0
Brightly-lit orange UFO filmed hovering over French coastal town baffles residents,1,3,5,66,1,10,0,71,0
"Which Of The ""Harry Potter"" Deathly Hallows Are You",1,1,9,32,2,8,0,41,0
This Video Might Ruin Christmas For You,1,1,7,26,0,6,0,33,0
How Well Do You Actually Know Modern Text Speak,1,1,9,30,0,8,0,39,0
Dem Rep Cohen: ‘Hopefully Mother Earth Can Survive the Next Four Years’,1,3,11,46,3,11,0,57,0
Ryan: Bloodbath If GOP Fails to Pass Health Care Legislation,1,3,11,39,1,9,0,50,0
"How Well Do You Remember The ""Unfabulous"" Theme Song",1,1,9,33,2,8,0,42,0
Pop with Purpose: In defence of Justin Bieber,1,3,5,32,1,7,0,37,0
"The ""Harry Potter"" Covers Reimagined With Daniel Radcliffe",1,1,8,41,2,7,0,49,0
"18 Jokes That’ll Make You Be Like, “Ha!”",1,2,7,19,5,7,2,26,0
These Are The 44 Models Walking In The Victoria's Secret Fashion Show,1,1,11,44,1,11,2,55,0
Proof That Braids Look Best With Rainbow Hair,1,1,8,30,0,7,0,38,0
23 Academy Awards GIFs Perfect For Everyday Situations,1,1,9,36,0,7,2,45,0
Cara Delevingne Has Been Accused Of Ripping Off An Indie Brand's T-Shirt,1,1,13,46,2,11,0,59,0
19 Awesome New Books You Need To Read This Fall,1,1,9,27,0,9,2,36,0
Here's What Your Girlfriend's Period Wants You To Know,1,1,9,35,2,8,0,44,0
Which Dystopian Future Do You Actually Belong In,1,1,8,33,0,7,0,41,0
Former The Jump contestant Louise Hazel tells athletes to quit competition before they get hurt,1,3,5,76,0,14,0,81,0
There's a very good reason to tweet emoji at Google right now,1,3,2,47,1,11,0,49,0
Should You Be Worried About Political Risk? (Hint: Insurers Are),1,3,10,41,4,9,0,51,0
Delicious Pull Apart Bread Recipes,1,1,5,25,0,4,0,30,0
9 up-and-coming healthy fast food chains that should scare McDonald's,1,2,2,54,3,9,1,56,0
"If Crystal Pepsi's back, we want these '90s things, too",1,3,3,37,4,9,2,40,0
This Word Search Test Will Determine When You'll Get Married,1,1,10,40,1,9,0,50,0
Which New Pentatonix Original Song Are You,1,1,7,29,0,6,0,36,0
22 Of Kourtney Kardashian's Deepest Thoughts,1,1,5,31,1,5,2,36,0
Embattled ex-California mayor arrested at airport on numerous charges ,1,3,2,58,1,9,0,60,0
Leaving Home At 14 Was The Best Thing I Ever Did,1,1,10,26,0,10,2,36,0
"The scents in your body wash, chicken stock and canned drink all come from one company",1,3,1,69,1,15,0,70,0
Basically Everyone Needs To Try Working Out With DJ Khaled,1,1,11,38,0,9,0,49,0
19 Funniest Tweets Of Famous Phrases Translated Into Yoda Speak,1,1,9,43,0,9,2,52,0
It Only Took 7 Seconds For This Kylie Jenner Appearance To Get Really Awkward,1,2,13,50,0,13,1,63,0
People Try To Define Yiddish Words,1,1,6,23,0,5,0,29,0
Watch Lady Gaga's Heartbreaking New Music Video About Campus Rape,1,1,10,45,1,9,0,55,0
"If You Were Stranded On Mars, Which Vegetable Would You Eat",1,1,11,37,1,10,0,48,0
21 Things You'll Only Know If You And Your Best Friend Are Actually Grandmas,1,1,13,47,1,13,2,60,0
Can You Tell If This Is A Real Or Fake Crime Headline,1,1,12,30,0,11,0,42,0
Can You Match The Nigella Sexual Innuendo With Her Own Recipe,1,1,11,40,0,10,0,51,0
"Ever Wonder What Goes Into Making ""Steven Universe""",1,1,8,34,2,7,0,42,0
Waka Flocka Flame Is Vegan Now And It's Delightful,1,1,9,32,1,8,0,41,0
Jennifer Lawrence's New Movie Is Basically Just A Bunch Of GIFs Of Her In Search Of A Movie,1,1,20,53,1,17,0,73,0
"Biden: I Watched Trump Rally, Realized ‘We May Lose This Election’",1,2,11,41,4,10,0,52,0
"Have you decorated your Christmas tree yet? If so, we want to see it",1,2,3,50,2,13,0,53,0
23 People Who Had Absolutely No Idea What They Were Doing In 2015,1,1,11,36,0,12,6,47,0
15 Reasons Guacamole Is Better Than Boys,1,1,6,26,0,6,2,32,0
Can We Tell If You're An Axe Murderer By This One Question,1,1,12,34,1,11,0,46,0
United Airlines will hate the results of this new poll,1,3,2,43,0,9,0,45,0
This is what happens when Donald Trump attacks a private citizen on Twitter,1,3,4,59,0,12,0,63,0
32 Parents Who Totally Nailed It On Halloween,1,1,7,29,0,7,2,36,0
Snapchats Only A Morning Person and A Non-Morning Person Would Exchange,1,1,11,49,1,10,0,60,0
"Another Round, Episode 24: Ida Bae Wells",1,1,6,24,2,6,2,30,0
"Liquor sales haven't dropped where weed is legal, and people still go out, new analysis says",1,2,1,73,3,15,0,74,0
A Dad Of Four Girls Had A Total Meltdown When He Learned He Was Having A Son,1,1,17,43,0,16,0,60,0
Are You Actually Masturbating Like Everybody Else Or Not?,1,3,9,39,1,8,0,48,0
'Fresh Prince' blues cover would make Uncle Phil proud,1,3,4,40,2,8,0,44,0
Is Emirates Airline Running Out of Sky?,1,3,6,26,1,6,0,32,0
Drinking Underage Vs Drinking Legally,1,1,5,28,0,4,0,33,0
McDonald's gives consumers a break today from frozen meat,1,2,2,46,1,8,0,48,0
Signs An Awkward Guy Likes You,1,1,6,19,0,5,0,25,0
Carjacker Murders Motorist Because He Couldn’t Steal Car with Stick Shift,1,3,10,52,1,10,0,62,0
"Monks had their flesh RIPPED off before burial: 1,000-year-old monastery in Sudan reveals the grisly ritual",1,3,8,76,4,15,4,84,0
22 Times The Internet Proved We're All In This Together,1,1,9,34,1,9,2,43,0
These scientists want to create ‘red teams’ to challenge climate research. Congress is listening,1,3,2,78,3,13,0,80,0
This Word Association Test Can Determine Your Personality With Magazines,1,1,10,53,0,9,0,63,0
21 Beautiful Wedding Desserts That Are Better Than Traditional Cake,1,1,9,47,0,9,2,56,0
18 Things To Do With A Date Besides Netflix And Chill,1,1,10,31,0,10,2,41,0
Can We Guess If You're In Love,1,1,7,16,1,6,0,23,0
Jason Johnson: GOP’s Behavior on SCOTUS ‘Anti-American’,1,3,14,30,5,6,0,44,0
"Theresa May, Turkey, Arkansas: Your Tuesday Briefing ",1,3,7,36,3,7,0,43,0
Airbus Reveals New Modular Cabin Concept That Could Change How We Fly,1,3,12,46,0,11,0,58,0
10 Risky Brand Comebacks on Social Media That Worked,1,3,7,35,0,8,2,42,0
It's a hard life: readers' pictures of sleeping pets,1,3,1,40,3,8,0,41,0
Bentley Flying Spur or Rolls-Royce Ghost: Which Fantasy Car Is for You?,1,3,11,46,3,11,0,57,0
How To Drink A Jammie Dodger,1,1,6,17,0,5,0,23,0
"22 Pictures That Will Make You Say “Damn Nature, You Scary”",1,3,10,34,3,10,2,44,0
7 Signs You Grew Up With Only Brothers,1,1,7,23,0,7,1,30,0
This Five Question Test Will Determine Where In The World You Should Live,1,1,13,48,0,12,0,61,0
ADPVoice: 3 Ways To Equalize The Treatment Of Women In The Workplace,1,3,14,41,1,11,1,55,0
Who took (and took) the most retaken penalty of all time?,1,2,1,43,3,10,0,44,0
The Salary Chronicles: A $200K Job Offer Showed Me My Potential Was Limitless,1,2,13,47,2,12,3,60,0
Why Those Bigger Paychecks Don’t Feel as Good as You Thought They Would ,1,3,11,47,1,13,0,58,0
"There Was A Cool Throwback To The Original ""Mission Impossible"" In ""Rogue Nation""",1,1,13,52,4,12,0,65,0
Is this the work of aliens? Drone captures aerial footage of mysterious crop circles in Russian wheat field,1,3,3,86,1,17,0,89,0
This Children's Book Aims To Give Black Queer Boys A Voice,1,1,11,36,1,10,0,47,0
21 Legit Cool Things Star Wars Fans Will Actually Want In Their Homes,1,1,12,43,0,12,2,55,0
34 Questions Stephenie Meyer Needs To Answer Immediately,1,1,7,40,0,7,2,47,0
Kylie Jenner's Favorite Instagram Poet Wrote A Special Poem Just For Her,1,1,12,48,1,11,0,60,0
What Taylor Swift Lyric Should Be Your Life Motto,1,1,9,32,0,8,0,41,0
Democrats Hope Trump's Cabinet Picks Will Stand in Their Own Way,1,3,10,43,1,10,0,53,0
"As Lyme Disease Spreads, Young Mom’s Death Raises Questions",1,3,9,40,2,8,0,49,0
Poll: Only 13 Percent of Democrats Enthusiastic About Their Party’s Future,1,3,9,51,2,10,2,60,0
"13 Women Show Off Their Most ""Unflattering"" Outfits",1,1,7,33,2,7,2,40,0
Obama in Harvard Law Review: Prayer Won’t Do It; We Need Gun Control,1,2,12,41,3,12,0,53,0
21 Buttons Facebook Really Needs Though,1,1,5,27,0,5,2,32,0
Watch All of the Super Bowl LI Commercials in One Spot,1,3,9,35,0,10,0,44,0
Are You Good Enough For My Son,1,1,7,17,0,6,0,24,0
"Which Corrupted Gem From ""Steven Universe"" Are You",1,1,8,33,2,7,0,41,0
‘Hamilton’ Producer Lin-Manuel Miranda ’Sobbing’ After Obama Frees Domestic Terrorist Oscar Lopez Rivera,1,3,14,73,5,12,0,87,0
Plan Your Funeral And We'll Tell You How You Die,1,2,10,28,1,9,0,38,0
We Know Your Future Celebrity Husband Based On Your Birth Month,1,1,11,42,0,10,0,53,0
The 17 Most Important British Memes Of 2015,1,1,6,24,0,7,6,30,0
"19 Pictures That Will Make Any Stoner Say “Wow, Yup”",1,3,9,29,3,9,2,38,0
21 Things Only Picky Eaters Will Understand,1,1,6,29,0,6,2,35,0
You Can Buy A Candle With A Baby Raptor Inside,1,1,10,27,0,9,0,37,0
26 Pictures That Are Too Real For Anyone Who's In College,1,1,10,34,1,10,2,44,0
Megan Fox Breaks Her Instagram Fast To Share An Adorable Picture Of Her Son,1,1,14,48,0,13,0,62,0
21 Tweets About Contacts Lenses That Will Make You Laugh Out Loud,1,1,11,41,0,11,2,52,0
We Tried To Get Away With Wearing Fancy Sweatpants Four Different Ways,1,1,12,47,0,11,0,59,0
How To Be A Genderqueer Feminist,1,1,6,21,0,5,0,27,0
Here Are 11 Awesome Kickstarter Projects You Need To Invest In Right Now,1,3,12,46,0,12,2,58,0
How Much Do You Actually Know About Makeup,1,1,8,27,0,7,0,35,0
"13 ""Gilmore Girls"" Storylines The Fans Demand To See In The Revival",1,1,11,41,2,11,2,52,0
"Rezekne, Latvia, Frets About Trump NATO Stance, War With Russia",1,3,13,38,3,9,0,51,0
Rainbow Bagels Are Here And We Can't Keep Our Shit Together,1,1,11,37,1,10,0,48,0
Is Your Dad Weird? We Have The Perfect Father's Day Gift,1,3,11,33,2,10,0,44,0
Terminally Ill Patient Who Had 18 Months To Live Gets Cured Of His Cancer With A 'Wonder Drug',1,3,17,56,2,17,2,73,0
18 Struggles That Are Way Too Real For People Who Cry Easily,1,1,11,36,0,11,2,47,0
This Photo Series Shares The Experiences Of LGBT People Of Faith,1,1,14,40,0,10,0,54,0
Can You Walk Through A Dark Room Without Stepping On A LEGO Brick,1,1,16,37,0,12,0,53,0
"Winter Olympics: Big air, mixed curling among new 2018 events",1,3,3,43,2,9,4,46,0
21 Cats Who Will Sway The Non-Believers,1,1,7,23,1,6,2,30,0
Check Out These 5 Simple Tricks To Mess With Your Friends,1,1,10,36,0,10,1,46,0
"This Is What Happens When Straight People Try ""Conversion Therapy""",1,1,10,45,2,9,0,55,0
Syria conflict: Why British surgeon cannot forget this girl,1,2,3,47,1,8,0,50,0
What Percentage Jedi Are You,1,1,5,19,0,4,0,24,0
"Do You Know The Castles From ""Game Of Thrones""",1,1,9,27,2,8,0,36,0
"How ""Queen Of Sappy Love Songs"" Delilah Conquered Radio",1,1,9,36,2,8,0,45,0
19 Things People Who Wear Makeup Are Tired Of Hearing,1,1,9,33,0,9,2,42,0
"Reminder That Daniel Radcliffe's ""Harry Potter"" Audition Is Literally The Cutest Thing You'll Ever See",1,1,15,69,4,14,0,84,0
19 Ways You Know You're Friends With A Teacher,1,1,8,27,1,8,2,35,0
A Complete List of Brokers and Their Approach to ‘The Fiduciary Rule’,1,3,9,47,2,11,0,56,0
24 Tweets About Sex Guaranteed To Make You Laugh,1,1,8,30,0,8,2,38,0
Obama’s Advice For Precious Snowflakes: ‘Don’t Go Around Just Looking for Insults’,1,3,11,55,5,11,0,66,0
There's An Amazing New Beauty Box Catering To Women Of Color,1,1,11,38,1,10,0,49,0
21 Perfumes That DEFINITELY Aren't The Real Thing,1,1,16,23,1,7,2,39,0
"Turkey’s general election deals blow to Erdogan, creates political uncertainty",1,2,2,65,2,9,0,67,0
They were hoping to get to the US -- and then Trump banned them,1,3,4,44,2,13,0,48,0
How Do You Take Care Of Yourself While Training For A Race,1,1,12,35,0,11,0,47,0
How Spooky Are You Actually,1,1,5,18,0,4,0,23,0
15 Words That Mean Something Entirely Different To Women,1,1,8,38,0,8,2,46,0
The Lost Footage of Marilyn Monroe ,1,3,5,24,0,6,0,29,0
Kids Who Are Too Excited For The First Day Of School,1,1,11,31,0,10,0,42,0
Morgan StanleyVoice: Should Investors Party Like It's 1999?,1,2,8,37,3,7,4,45,0
Which TV Town Would Be The Perfect Fit For You,1,1,11,26,0,9,0,37,0
"Brace Yourself, America, All Dressed Chips Are Coming",1,1,8,36,2,7,0,44,0
How to Protect Your Privacy on Your Smartphone,1,3,6,33,0,7,0,39,0
Can You Guess The Beatles Song From Its Opening Lyric,1,1,10,34,0,9,0,44,0
Can You Find Your Dream Puppy,1,1,6,18,0,5,0,24,0
A Man Set Fire To A Gas Pump Trying To Kill A Spider With A Lighter,1,1,16,36,0,15,0,52,0
How To Shut Down Catcallers,1,1,5,18,0,4,0,23,0
"People Try ""Superfoods"" For The First Time",1,1,7,27,2,6,0,34,0
"The Cast Of ""Hamilton"" Next To Their Real-Life Historical Characters",1,1,11,45,3,9,0,56,0
We Asked 12 Scientists How Their Faith Affects Their Work,1,1,9,37,0,9,2,46,0
Robert Davi at CPAC: Trump the ‘Force of Nature’ America Needed to Break Out of Globalist Era,1,3,15,59,3,16,0,74,0
Germany to Tap Migrant Phones to Tackle Asylum Fraud,1,3,7,37,0,8,0,44,0
"Kerry Ingram, AKA Shireen From 'Game Of Thrones,' Is Alive And Well On Twitter",1,3,16,45,4,13,0,61,0
15 Tee Shirts For People Who Put Hot Sauce On Their Hot Sauce,1,1,12,35,0,12,2,47,0
"7 Essays To Read: Being A Superhero, Sex Shops, And Black Genius",1,1,11,38,3,11,1,49,0
Google’s Photos app now dramatically improves users’ videos,1,3,2,48,2,7,0,50,0
Here's What Keeps Mumbai's Seashore So Much Polluted All The Time,1,2,11,42,2,10,0,53,0
Man who lost his penis to flesh-eating superbug sues Essex hospital,1,3,2,54,1,10,0,56,0
Facebook Users Are Going Nuts Over This Fake Jennifer Aniston Story,1,1,11,46,0,10,0,57,0
Sephora's Top 10 Best-Selling Lipsticks Are A Mix Of Obvious And Unexpected,1,3,12,48,2,11,2,60,0
Uplifting Aerial Photos Of Beaches In Italy That Will Remind You Of Summer,1,1,13,49,0,12,0,62,0
Was 2016 good or bad? May and Johnson differ in Christmas messages,1,2,4,46,1,11,4,50,0
We Know Where You Live Based On Your Favorite Foods,1,1,10,32,0,9,0,42,0
Only Solve This Puzzle If You Get A Little Too Into Pop Culture,1,1,13,38,0,12,0,51,0
17 Times The Internet Nailed What It's Like Being A Scorpio,1,1,10,36,1,10,2,46,0
"Can You Match The Season 5 ""Gilmore Girls"" Quote To Who Said It",1,1,12,36,2,12,1,48,0
"The Biggest Changes Obamacare Made, and Those That May Disappear ",1,3,9,45,1,10,0,54,0
Demi Moore Joins ‘Empire’ in Recurring Role,1,2,6,29,2,6,0,35,0
"17 Foods Guaranteed To Excite Any ""Star Wars"" Fan",1,1,8,29,2,8,2,37,0
'The Big Bang Theory' will continue to haunt your television for years to come,1,3,4,59,2,13,0,63,0
"This Is The Hardest ""Divergent"" Quiz You'll Ever Take",1,1,9,33,3,8,0,42,0
"Most 'anti-aging' remedies are bogus, but here's what you should know about aging from 20s to your 60s",1,2,1,75,5,17,4,76,0
Johns Hopkins Fools Navy with Perfectly Executed Hidden Ball Trick,1,3,9,48,0,9,0,57,0
8 Fandom Ship Wars That End Here And Now,1,1,8,23,0,8,1,31,0
President Obama’s 3 Tips On How To Get Politically Active,1,3,9,37,1,9,1,46,0
21 Of The Best Things That Ever Happened In An Apple Store,1,1,11,34,0,11,2,45,0
What the Fed's rate hike means for you,1,3,2,28,1,7,0,30,0
"'Yes We Did,' Obama Says in Farewell Address, but Warns of Threats to Democracy ",1,3,10,52,4,14,0,62,0
10 Artists You Won’t Believe Have Never Won A Grammy For Album Of The Year,1,2,14,43,1,14,2,57,0
Idea And Vodafone Merge To Form The Largest Operator In India + 5 Other Major Stories From The Day,1,3,17,61,1,18,1,78,0
"How Well Do You Know The Lyrics To ""Cake By The Ocean"" By DNCE",1,1,17,30,2,13,0,47,0
Which Celebrities Have The Same Zodiac Sign As You,1,1,9,33,0,8,0,42,0
Samsung Galaxy S8 price leak suggests it will be much cheaper than Apple iPhone 8,1,2,5,60,0,14,2,65,0
We Can Tell If You're A Cat Or Dog Person Based Off Your Taste In Avengers,1,1,16,42,1,15,0,58,0
Man Dies When Car Plunges from New Orleans Parking Garage,1,3,9,39,0,9,0,48,0
12 Ways You Can Instagram Like Lauren Conrad,1,1,7,28,0,7,2,35,0
"Job hunting? 180+ openings in New York, London, Hamburg and more",1,3,5,42,4,10,3,47,0
"How Well Do You Remember The Lyrics To Panic! At The Disco's ""I Write Sins Not Tragedies""",1,1,17,52,4,16,0,69,0
This Kremlin leader bragged about tipping a U.S. presidential election,1,3,4,55,2,9,0,59,0
Chicken McNuggets only come in four shapes - here's why The list,1,3,4,47,2,11,0,51,0
When Great Isn't Good Enough: 6 Essentials To Stand Out In The MBA Applicant Pool,1,3,16,48,2,14,1,64,0
Sean Hannity Is Still Upset Ted Koppel Said He Was ‘Bad for America’ ,1,3,12,42,2,13,0,54,0
31 Insanely Adorable Products That Will Make Your Life Easier,1,1,9,41,0,9,2,50,0
Can We Guess Your Zodiac Sign Based On Your Personal Characteristics,1,1,11,47,0,10,0,58,0
Which Stock Photo Represents You And Your Work BFF,1,1,11,31,0,8,0,42,0
"Which 2016 Critics' Choice ""Best Picture"" Nominee Should You See",1,1,9,39,3,9,4,48,0
25 Reasons 2015 Was The Year Of The Geek,1,1,7,19,0,8,6,26,0
Australian Police Arrests Man On Charges Of Helping ISIS Develop Missile Technology,1,2,15,57,0,11,0,72,0
Oscars 2017: American bans Syrian behind nominated film The White Helmets from attending Oscars,1,3,7,70,1,13,4,77,0
17 Pictures Short Girls Will Never Understand,1,1,6,31,0,6,2,37,0
This teenager discovered a new planet on his third day at work,1,2,1,50,0,11,0,51,0
How food inspires names of India's Parsis,1,3,3,31,1,6,0,34,0
Is YOUR boss dysfunctional or dark? Bad managers come in two forms – and both can make your life a misery,1,3,6,77,2,20,0,83,0
11 Ways To Definitely Look Like You Got Your Sh!t Together,1,1,10,35,1,10,2,45,0
Anne Hathaway Comes To Jennifer Lawrence's Defense About That Phone Scolding Incident,1,1,12,61,1,11,0,73,0
Gina Rodriguez Is The Cutest And Brought Her Dad To The Golden Globes,1,1,13,44,0,12,0,57,0
Stop What You're Doing And Listen To Michelle Obama's Girl Power Playlist,1,1,12,48,2,11,0,60,0
21 Truths About Group Friendships,1,1,4,23,0,4,2,27,0
Where Should You Actually Live Based On Your Taste In Pizza,1,1,11,38,0,10,0,49,0
"David Cameron on Brexit, Donald Trump and why he does not regret calling a referendum",1,3,5,65,1,14,0,70,0
This Telenovela Hunk Will Get You All Hot And Bothered,1,1,10,35,0,9,0,45,0
Not To Freak Anyone Out But I Think Olivier Martinez Is Hoarding All The Baguettes,1,1,15,53,0,14,0,68,0
Here's how the White House staff pranked President Obama for the holidays,1,2,5,56,1,11,0,61,0
Merriam-Webster Drags Donald Trump for 'Unpresidented' Typo in Tweet About China,1,3,10,57,3,10,0,67,0
The Best And Worst College Towns In The U.S.,1,2,10,24,2,8,0,34,0
Here's What Happened When People Tried Chicken And Waffles For The First Time,1,1,13,51,1,12,0,64,0
"Demi Lovato Adorably Confused ""Genes"" For ""Jeans"" On BBC Radio",1,1,12,37,4,9,0,49,0
10 Amazing Cooking Hacks That Can Make Your Life Way Healthier,1,2,10,40,0,10,2,50,0
16 Confessions Your Hairdresser Will Never Tell You,1,1,7,35,0,7,2,42,0
19 Reasons The Nintendo 64 Is The Greatest Console Of All Time,1,1,10,37,0,11,4,47,0
"This Bride's ""Certificate Of Purity"" Is Causing A Huge Debate Online",1,1,11,44,3,10,0,55,0
17 Photos That Perfectly Sum Up Snapchat Vs. Instagram,1,1,8,35,1,8,2,43,0
25 Adorable Presidential Pet Photos That Will Melt Your Heart,1,1,9,41,0,9,2,50,0
Dick Costolo tweet after resignation - Business Insider,1,2,4,43,1,7,0,47,0
How Festive Are You Actually,1,1,5,19,0,4,0,24,0
This One-Eyed Cat Conquered His Fear Of The Ocean And Learned To Surf,1,1,14,42,1,12,0,56,0
"Forget Modi's 50 Day Deadline, It Will Take 4 More Months To Get Enough Currency To The Banks",1,2,16,55,2,17,3,71,0
"21 Little Details You Probably Missed In ""The Fifth Element""",1,1,9,38,2,9,2,47,0
You Have To See These Two Babies Dancing To Beyoncé’s “7/11”,1,2,10,33,4,10,3,43,0
"I Watched ""Home Alone"" For The First Time And It Was Actually Horrifying",1,1,13,45,2,12,0,58,0
These People Shared What Their PTSD Really Looks Like,1,1,12,33,0,8,0,45,0
19 Mashups That Prove Human Ingenuity Knows No Bounds,1,1,8,35,0,8,2,43,0
What's The Laziest Thing You've Ever Done,1,1,7,26,2,6,0,33,0
Here's How People Celebrate The New Year Around The World,1,1,10,37,1,9,0,47,0
"This Junior High Version Of ""Attack On Titan"" Is So Cute, You'll Want To Eat It",1,1,16,44,4,15,0,60,0
"How Well Do You Remember Ludacris's Rap From ""Glamorous"" By Fergie",1,1,11,42,3,10,0,53,0
27 Of The Most Awesome Trans Moments In 2015,1,1,7,23,0,8,6,30,0
"What Hogwarts Houses Are The Characters Of ""The Hunger Games"" In",1,1,11,41,2,10,0,52,0
24 Tips Real People Use To Get The Fuck To Sleep,1,1,10,26,0,10,2,36,0
31 Thoughts Everyone Has After A Bad Haircut,1,1,7,28,0,7,2,35,0
25 Beautiful Vintage Pictures Of New Orleans' Vibrant Culture,1,1,8,42,1,8,2,50,0
What Job Would You Have In A Disney Movie,1,1,9,24,0,8,0,33,0
Pizza dipped in milk is the most disrespectful pizza crime yet,1,3,1,51,0,10,0,52,0
"No ""Doctor Who"" Until 2017 As Steven Moffat Steps Down",1,1,9,30,2,9,4,39,0
You Actually Can Teach Employees How To Have A Great Attitude,1,2,11,40,0,10,0,51,0
This Couple Revealed Their Baby's Gender In The Most Epic Way Possible,1,1,12,46,1,11,0,58,0
Rating the job security for every NFL head coach,1,3,4,36,0,8,0,40,0
U.S. Intelligence Got the Wrong Cyber Bear,1,2,7,27,2,6,0,34,0
The top 10 best selling comic books of all time [Video],1,2,2,39,2,10,2,41,0
15 Reunion Destinations Your College BFFs Can All Agree On,1,1,11,36,0,9,2,47,0
10 Men From Morehouse Who Will Give You Future Son And Bae Goals,1,1,12,38,0,12,2,50,0
"WhatsApp makes U-turn on 'Status' feature, rolling back its biggest recent update",1,2,4,62,4,11,0,66,0
19 Cleaning Tips For The Neglected Corners In Your Home,1,2,9,35,0,9,2,44,0
Which Word Did I Search To Find This Image On Thinkstock,1,1,11,35,0,10,0,46,0
We Tried Flavoured Lube And This Is What Happened,1,1,9,32,0,8,0,41,0
27 New Songs You Need To Hear,1,3,6,15,0,6,2,21,0
Things You're Absolutely Sure Of Until You Have Kids,1,1,9,34,1,8,0,43,0
A New Parchment Declaration of Independence Surfaces. Head-Scratching Ensues. ,1,3,9,57,3,9,0,66,0
This Site Shows You What David Bowie Was Doing At Your Age,1,1,12,35,0,11,0,47,0
I Asked A Bunch Of People To Define A Good Body And This Is What Happened,1,1,16,42,0,15,0,58,0
This ‘Walking Dead’ shirt was banned from stores for racism,1,2,3,45,2,9,0,48,0
Confessions of a disappointing dad - the five things I regret the most,1,2,2,55,1,12,0,57,0
Anne Hathaway Totally Lost Her Composure At A Premiere When She Saw Mariah Carey,1,1,14,53,0,13,0,67,0
21 amazing photos that show what life is like in the coldest inhabited town on earth,1,3,0,67,0,15,2,67,0
Can We Guess What Kind Of 20-Something You Are,1,1,9,26,1,8,2,35,0
A young prince is reimagining Saudi Arabia. Can he make his vision come true?,1,3,4,58,2,13,0,62,0
Urban Decay Released A Gwen Stefani Palette And People Are Losing Their Minds,1,1,13,52,0,12,0,65,0
Couple reveals pregnancy with twins in amazing photo with 452 IVF needles - Yahoo,1,3,5,59,1,13,3,64,0
The One Thing You Never Noticed About Disney Characters,1,1,9,38,0,8,0,47,0
'Halt and Catch Fire' Episode 2: Mutiny in a man's world,1,3,5,36,4,10,1,41,0
Here's how China sees Iran - Business Insider,1,3,5,31,2,7,0,36,0
The Hilarious Reason Daniel Radcliffe Was Cast As Harry Potter,1,2,10,43,0,9,0,53,0
You Could Be Wearing Ivanka Trump Right Now and Not Even Know It,1,2,12,40,0,12,0,52,0
22 Mesmerizing Pictures Of Dusk Around The World,1,1,7,32,0,7,2,39,0
Do You Know Your BF's Face By Touch,1,1,9,18,1,7,0,27,0
"This Self-Proclaimed Singer's Cover of 'Closer' Was So Bad, It Actually Landed Him In Jail!",1,3,15,56,6,14,0,71,0
This guy went on a holiday with a group of total strangers for the greatest reason The list,1,3,2,72,0,17,0,74,0
Makeup On Instagram Vs. Makeup In Real Life,1,1,8,27,1,7,0,35,0
Do You Actually Prefer Dudes Or Dogs,1,1,7,23,0,6,0,30,0
I had two children 15 years apart,1,2,1,24,0,6,2,25,0
21 Reasons Why No One Should Have New York Values,1,1,9,29,0,9,2,38,0
North Korea's history of covert operations and secret killings,1,3,2,51,1,8,0,53,0
"Which Dead ""Grey's Anatomy"" Character Are You",1,1,7,29,3,6,0,36,0
College Football Best Signs from ESPN's 'College GameDay' from Week 15 in Baltimore,1,2,13,53,3,12,2,66,0
Schumer Voted for Wall in 2006 but Threatens Gov’t Shutdown over Funding Trump’s Wall,1,3,9,57,2,13,4,66,0
Serious Question: Did Reese Witherspoon Give Birth To Herself,1,1,9,43,1,8,0,52,0
Can You Identify The '80s Movie Based On The Screencap,1,1,9,33,1,9,2,42,0
Here’s What Therapists Want You To Know About Being Politically Active,1,3,11,48,1,10,0,59,0
The internet is losing its mind over these eerie photos of Nicola Sturgeon and Margaret Thatcher The list,1,3,6,82,0,17,0,88,0
The 19 Greatest Animal Hugs From 2015,1,1,5,20,0,6,6,25,0
Taylor Swift Chopped Her Hair Off For The Grammys,1,1,9,32,0,8,0,41,0
The 21 Best Mindy Kaling Tweets Of 2015,1,1,6,20,0,7,6,26,0
"19 Life Lessons From ""500 Days Of Summer""",1,1,6,21,2,7,5,27,0
Carrie Fisher’s Urn Is a Giant Prozac Pill,1,3,7,27,1,7,0,34,0
This Woman Recreated Some Of Dan Bilzerian's Instagram Photos With Half Naked Men,1,1,13,55,1,12,0,68,0
18 Thoughts Everyone Has Before A Hookup,1,1,6,26,0,6,2,32,0
Could your imagination be making you FAT? Vivid thoughts 'trigger food cravings and encourage you to eat more',1,3,5,85,3,17,0,90,0
"Scotland could join Canada, but should it? Your responses",1,2,3,44,2,8,0,47,0
Sundance review: 'Ingrid Goes West' is the Instagram horrorshow you fear most,1,2,5,58,3,11,0,63,0
This Dog Practicing His Prancing In Front Of A TV Is So Cute,1,1,14,34,0,12,0,48,0
What Does Your Outfit Say About You,1,1,7,22,0,6,0,29,0
Things Brazilians Do That Everyone Should Be Doing,1,1,8,35,0,7,0,43,0
Remembering The Celebrities And Cultural Icons We Lost In 2016,1,3,9,40,0,9,4,49,0
WashPo: Trump Voters ‘Motivated by Racism’ in November Elections,1,3,8,45,3,8,0,53,0
Man jailed over Perth Prison Kinder Egg cocaine plot,1,3,5,39,0,8,0,44,0
Pucker up! Eight reasons why KISSING is so good for your health - from burning calories to slowing aging,1,2,9,75,2,18,0,84,0
Taylor Swift Just Won A Damn Emmy Award,1,1,8,24,0,7,0,32,0
Ivanka Watch: Who’s Selling the First Daughter’s Fashion?,1,3,7,39,4,7,0,46,0
Which ShondaLand Show Should You Actually Be On,1,1,9,31,0,7,0,40,0
9 Christmas Movies If They Were About Cuffing Season,1,1,8,35,0,8,1,43,0
10 books that famous CEOs loved reading,1,3,3,28,0,6,2,31,0
"24 Awesome Things You Really Wanted And Never Got, But Can Still Totally Buy Today",1,1,14,51,1,14,2,65,0
Chelsea Handler blames Trump's presidency on the Kardashians,1,3,4,48,1,7,0,52,0
Can You Tell Which Famous Person The Body Double Is Hanging Out With,1,1,13,43,0,12,0,56,0
The shocking stories that led Louisiana to ban charging rape victims hefty medical fees,1,3,2,72,0,13,0,74,0
Why Scottish politician Nicola Sturgeon has been called ‘the most dangerous woman in Britain’,1,3,5,73,2,13,0,78,0
"Here Are America’s Fattest Cities, Ranked [Video]",1,3,7,32,4,6,0,39,0
Allies Fear Trump Is Eroding America’s Moral Authority ,1,2,8,38,1,8,0,46,0
Rachel Bilson And Kristen Bell Are Your New Mom-Friend Goals,1,1,11,39,1,9,0,50,0
Who passed Warren Beatty the wrong envelope? What really happened when La La Land won over Moonlight,1,3,8,75,1,16,0,83,0
Maher to the Clintons: ‘I Never Want To See Either One of You Ever Again’,1,3,12,44,3,14,0,56,0
The 10 best places for Americans to live in Canada,1,3,3,36,0,9,2,39,0
The weird names the CIA gives its hacking tools,1,3,4,35,0,8,0,39,0
All the things 'Parks and Recreation' got right and wrong about 2017,1,2,3,48,2,11,4,51,0
33 Beautiful Things For Your Home That Cost Less Than $40,1,1,9,33,1,10,4,42,0
Barack Obama legacy: What does he most regret?,1,3,3,34,2,7,0,37,0
"Despite Decline in American Marriages, Couples Still Pay Most of Nation’s Taxes",1,2,10,56,2,11,0,66,0
A Friendly Reminder That The Biggest A-Hole On Television Is Canadian,1,1,12,46,1,10,0,58,0
19 Picture Tweets That Are Way Too Funny If You’re Slightly Obsessed With Makeup,1,3,13,51,1,13,2,64,0
These Disney Princesses With Allergies Will Make You Cry,1,1,9,39,0,8,0,48,0
Which Musical Theatre Character Are You,1,1,6,28,0,5,0,34,0
Why mothers should expect less of themselves and more of their partner,1,3,1,58,0,11,0,59,0
Pigskin A Blanket: NFL Week 7 Picks,1,1,8,19,1,6,1,27,0
Free college tuition could become a reality — at least in these states,1,3,1,56,1,12,0,57,0
Are You More James Bond Or Austin Powers,1,1,8,25,0,7,0,33,0
People Are Turning The Peanut Butter Kid Into Memes,1,1,9,34,0,8,0,43,0
Football Vs. Wife: Which Do You Know Better,1,1,8,26,2,7,0,34,0
Can You Guess The Avril Lavigne Video From One Screenshot,1,1,10,38,0,9,0,48,0
27 Tips And Hacks To Get The Most Out Of Your Tiny Home,1,1,12,29,0,12,2,41,0
16 Reasons People Who Shower At Night Are Doing It Right,1,1,10,34,0,10,2,44,0
You Can’t Go To The Grocery Store Until You Pass This Nutrition Facts Quiz,1,3,14,46,1,13,0,60,0
Millennials: Traditional Retirement Might Not Be In The Cards,1,3,9,43,1,8,0,52,0
26 Seriously Awesome Gifts Only True London Underground Fans Will Love,1,1,10,48,0,10,2,58,0
Can You Match The Selena Gomez Music Video To Its YouTube Comment,1,1,13,41,0,11,0,54,0
These Photos Of Kids Freaking Out With Santa Will Make You Laugh,1,1,12,41,0,11,0,53,0
13 Ways Your Body Can Go Wrong In Space,1,1,8,21,0,8,2,29,0
22 Genius Running Hacks For When It's Cold AF Outside,1,1,10,31,1,9,2,41,0
26 Photos That Prove There Is NOTHING Hotter Than Rugby,1,1,15,29,0,9,2,44,0
People Love This Guy’s Way To Solve Dinner Fights With His Girlfriend,1,2,12,45,1,11,0,57,0
Which Mexican Candy Are You Most Like,1,1,7,24,0,6,0,31,0
This Asian Star Risks Blinding Traders,1,3,6,27,0,5,0,33,0
This small Alabama town is rebounding – but Trump could change that,1,3,3,52,1,11,0,55,0
Are You More Gordon Ramsay Or Nigella Lawson,1,1,8,29,0,7,0,37,0
What Advice Do You Wish Someone Had Told You Before You Got Married,1,1,13,42,0,12,0,55,0
"After Being Called ""Indian Piece Of Shit,"" A Student Wrote This Moving Facebook Post About Racism",1,1,16,63,3,15,0,79,0
31 iPhone Games You Should Be Playing Already,1,1,7,29,0,7,2,36,0
I Turned My LinkedIn Profile Into A Dating Profile,1,1,10,32,0,8,0,42,0
27 Forgotten Trends All Early-'00s Girls Were Slightly Obsessed With,1,1,9,44,2,9,4,53,0
69 Thoughts Everyone Has Dating After A Long Term Relationship,1,1,9,42,0,9,2,51,0
"How Well Do You Remember The Kids From ""Hey Arnold!""",1,1,10,30,3,9,0,40,0
The Secret To Delicious Cauliflower Pizza Is Lots And Lots Of Cheese,1,1,12,45,0,11,0,57,0
21 Ways To Cover Your Home With Pictures Of Your Own Cat,1,1,11,32,0,11,2,43,0
Gina Rodriguez Tackles Hollywood's Problems With Latino Diversity Head-On,1,1,10,53,2,8,0,63,0
21 Cheap And Easy Decorating Tricks For Renters,1,1,7,31,0,7,2,38,0
19 Tumblr Posts That Prove Pets Are Too Pure For This World,1,1,11,35,0,11,2,46,0
21 Things That Happen When You Decide To Grow Out Your Short Hair,1,1,12,39,0,12,2,51,0
Tragedy: Former NFL Star Todd Heap Accidentally Kills 3-Year-Old Daughter While Moving Truck,1,2,16,60,3,12,1,76,0
How Does Your Interfaith Family Celebrate The Holidays,1,1,8,39,0,7,0,47,0
You'll Wish You Scored An Invite To This State Fair-Themed Wedding,1,3,12,42,2,10,0,54,0
25 Movies With Unsimulated Sex,1,1,4,20,0,4,2,24,0
How Much Hope Is There For Alzheimer's Drugs?,1,3,8,28,2,7,0,36,0
Meet the robonauts: NASA's humanoid robots,1,2,5,30,2,5,0,35,0
What Are The Best Baby Products On Amazon,1,1,8,26,0,7,0,34,0
Nine of the weirdest Easter traditions around the world: From bunny hunting to real crucifixions,1,2,3,78,1,14,0,81,0
21 Of The Craziest Things People Have Done To Impress Their Crushes,1,1,11,43,0,11,2,54,0
Did the Warriors Diss Russell Westbrook on Twitter Before Matchup With Kevin Durant?,1,3,11,60,1,12,0,71,0
22 Things All Messy Couples Know,1,1,5,20,0,5,2,25,0
19 Reasons Taraji P. Henson Should Be Your #1 Imaginary Celebrity BFF,1,1,12,41,2,11,3,53,0
IBMVoice: Here Are The Top Five Trends To Watch For In The Internet Of Things During 2017,1,2,19,49,1,16,4,68,0
24 Times Nathan Fillion Was The Funniest Thing On Twitter,1,1,9,37,0,9,2,46,0
Here's Kendall Jenner Looking Flawless In The New Balmain X H&M Commercial,1,1,13,48,2,11,0,61,0
Meet The Three Bachelors Played A Key Role In BJP's Uttar Pradesh Triumph,1,2,15,45,1,12,0,60,0
Has This Artist Won A Grammy,1,1,6,17,0,5,0,23,0
Dad takes daughter and best friend to father-daughter dance for touching reason - Yahoo,1,3,2,70,2,13,0,72,0
This Restaurant’s Comfort Food Will Make You Want To Be A Kid Again,1,2,13,41,1,12,0,54,0
This Dog Loves Leaves More Than You Love Anything,1,1,9,32,0,8,0,41,0
I Went To The Grammys Last Night And This Is What I Learned,1,1,13,34,0,12,0,47,0
"Smurfs-Obsessed Woman Has 7,000 Smurf Items: World’s Largest Collection [Video]",1,3,10,50,6,9,4,60,0
Rachel Maddow's Trump Tax Report Proves A Comedy Gold Mine For Late Night TV Hosts,1,2,16,51,1,14,0,67,0
New technology 'will detect potholes',1,2,1,30,2,4,0,31,0
How King Bach Dominated Vine,1,1,5,19,0,4,0,24,0
A Little Boy Was Driven Around By His Furry Best Friend,1,1,11,34,0,10,0,45,0
Syria conflict: Why British surgeon cannot forget this girl,1,3,3,47,1,8,0,50,0
17 Brilliant Things That'll Keep You From Ever Having To Share,1,1,10,39,1,10,2,49,0
"Can We Guess Your S.O.'s Star Sign Based On Your Fave ""Legend Of Zelda"" Character",1,1,16,46,5,14,0,62,0
16 Delightful Pictures Of Stormtroopers Enjoying Their Day Off,1,1,8,44,0,8,2,52,0
23 Pictures That Are Way Too Real For Flight Attendants,1,1,9,35,0,9,2,44,0
Lady Gaga's David Bowie Tattoo Is Huge And Beautiful,1,1,9,34,1,8,0,43,0
Here Are Some Cricket Records Which May Never Ever Be Broken In This Lifetime,1,3,14,50,0,13,0,64,0
This Woman Uses Makeup To Make A Chilling Statement About Gender Stereotypes,1,1,12,53,0,11,0,65,0
The Best Sleepover Strategy for Parents,1,3,5,29,0,5,0,34,0
The Most Fab And Drab Celebrity Looks Of The Week,1,1,10,30,0,9,0,40,0
16 Dudes Who Are Still Going To Be Single In 2016,1,1,9,24,0,10,6,33,0
The story of five young women killed for having fun,1,2,1,41,0,9,0,42,0
What Kind Of Animal Were You In A Past Life,1,1,10,24,0,9,0,34,0
Populist Leaders Praise Trump’s Refugee Ban as Model for Europe,1,3,8,45,1,9,0,53,0
Railway Ticket Collector Bites Nose Of His Boss Who Asked Him To Work Properly,1,3,14,51,0,13,0,65,0
9 Things You'll Definitely Lose In 2016,1,1,5,22,1,6,5,27,0
What's So Special About Apple? Other Handset Makers Ask Government,1,3,10,45,2,9,0,55,0
"49 Lyrics From Adele's ""25"" For When You Need A Deep Instagram Caption",1,1,11,40,3,12,4,51,0
"Soldier's Wife Seeks CBI Probe, Anil Vij's Comment On Gandhi And Other Must Read Stories",1,3,17,54,3,14,0,71,0
VMwareVoice: Five Things To Come For Security,1,3,9,29,1,6,0,38,0
The nuclear bunkers designed for luxury living,1,3,1,39,0,6,0,40,0
ESPN’s Stephen A Smith Calls for Respect for Trump from Black Community Following Steve Harvey Backlash,1,3,16,71,1,15,0,87,0
Operation London Bridge: the secret plan for the days after the Queen’s death,1,3,4,59,2,12,0,63,0
52 Of The Most Powerful Photos Of 2015,1,1,6,19,0,7,6,25,0
Donald Trump wants everything about America to be strong. He just announced one big exception.,1,3,4,74,2,14,0,78,0
Beyond the Chokehold: The Path to Eric Garner’s Death ,1,3,7,36,2,9,0,43,0
'Am I at risk of being hacked?' What you need to know about the 'Vault 7' documents,1,3,4,57,5,16,1,61,0
The World's Most Sustainable Companies 2017,1,2,5,28,1,5,4,33,0
I Wore Food On My Face Instead Of Makeup To See If Anyone Would Notice,1,1,15,41,0,14,0,56,0
"The polar vortex is here, but it's competing with global warming",1,3,1,51,2,10,0,52,0
19 Things Only Fall Out Boy Fans Understand,1,1,7,27,0,7,2,34,0
5 differences between a pocket sprung and memory foam mattress,1,2,0,52,0,9,1,52,0
11 Reasons Being An Adult Is The Best Thing Ever,1,1,9,28,0,9,2,37,0
I Made Some Greeting Cards For My Upstairs Neighbor,1,1,9,34,0,8,0,43,0
21 Things Everyone Who Is Scared Of Spiders Will Understand,1,1,9,39,0,9,2,48,0
Here Are 8 Facts About Sheree That Kenya Might Want To Remember,1,1,11,40,0,11,1,51,0
"3,600 guests at Ghana's record-breaking dinner table",1,3,1,38,3,6,4,39,0
"The ""Mean Girls"" Premiere Was Peak '00s And Here's Proof",1,1,9,32,4,9,2,41,0
Katy Perry Hilariously Trolls Orlando Bloom's Instagram With Jennifer Aniston Joke,1,3,11,60,1,10,0,71,0
Are Carmelo Anthony's Days With the Knicks Coming to an End?,1,3,8,40,2,10,0,48,0
I Stopped Using Makeup And Washing My Hair And I’ve Never Felt Better,1,3,13,43,1,12,0,56,0
Do You Remember Which Disney Star Sang These Lyrics,1,1,9,34,0,8,0,43,0
20 Reasons Zendaya Is A Flawless Queen,1,1,6,24,0,6,2,30,0
Source: Fox ‘Sick’ of Megyn Kelly; ‘Fox News Needs to Cut Her Loose’,1,2,11,39,6,12,0,50,0
26 Of The Funniest Things People Have Said In Their Sleep,1,1,10,35,0,10,2,45,0
19 Photos That Will Terrify All Makeup Addicts,1,1,7,30,0,7,2,37,0
Are You In Formation,1,1,4,13,0,3,0,17,0
The right way to say 15 brand names you're mispronouncing all the time,1,3,1,54,1,12,2,55,0
Men Answer: Sex Or Exclusivity First,1,1,6,24,1,5,0,30,0
We Know How You Procrastinate Based On Your Zodiac Sign,1,1,10,36,0,9,0,46,0
Destinations Inside North Korea: fascinating images of the world's most secretive state,1,3,4,70,2,11,0,74,0
"High-ranking Fed official resigns, reveals role in leaked confidential information",1,3,2,69,2,9,0,71,0
Tell Us About Yourself(ie): Demetri Martin,1,1,6,28,3,5,0,34,0
Get The Best Of BuzzFeed's Reporting With Our Sunday Stories Newsletter,1,1,12,48,1,10,0,60,0
"A Couple Had A Too-Real Conversation About Jealousy, Sexuality, And Honesty",1,1,12,50,3,10,0,62,0
"19 Times ASOS Went Way, Way Too Far",1,1,10,15,1,7,2,25,0
Jogger Gives Literal Answer to Name Spelling Question,1,2,7,39,0,7,0,46,0
23 Hilarious Tumblr Posts That Students Will Totally Get,1,1,8,38,0,8,2,46,0
5 Dads and Their Awesomely Bad Dance Moves [Video],1,2,7,32,2,8,1,39,0
Six important questions Theresa May dodged in 17 minutes on the Marr Show,1,3,5,54,0,12,2,59,0
22 Coloring Books That Will Calm You The Heck Down,1,1,9,30,0,9,2,39,0
"Most common issues which ruin a relationship, according to a couples counsellor",1,3,1,66,1,11,0,67,0
27 Art History Photos That Are Too Funny For Their Own Good,1,1,11,35,0,11,2,46,0
This Dancing Shiba Will Make Your Day Every Day,1,1,9,30,0,8,0,39,0
17 Times Tumblr Made Us Laugh About Thanksgiving,1,1,7,32,0,7,2,39,0
We Know What Movie Makes You Cry,1,1,7,19,0,6,0,26,0
10 Reasons Peter Gabriel's 'Solsbury Hill' Is One of the Greatest Songs of All Time,1,2,11,53,3,14,2,64,0
21 Struggles Of Being An Overthinker,1,1,5,24,0,5,2,29,0
"When Powerhouse Eateries Have to Move and Reinvent, Magic Follows",1,3,8,47,1,9,0,55,0
19 Things All Super Polite People Just Get,1,1,7,26,0,7,2,33,0
21 Heartbreaking Confessions About Working Retail On The Holidays,1,1,8,47,0,8,2,55,0
Kate Hudson And Goldie Hawn Are Mom And Daughter Goals,1,1,10,35,0,9,0,45,0
Here are Investopedia's top 10 investor terms of 2016,1,3,2,36,1,8,6,38,0
23 Insanely Haunted Places That'll Scare The Shit Out Of You,1,1,10,37,1,10,2,47,0
Did Kim Kardashian hint at a divorce before her long-awaited return to Instagram?,1,3,4,63,2,12,0,67,0
Watch How Weather People Made Fools Of Themselves In 2015,1,1,9,35,0,9,4,44,0
15 Brutally Honest Tube Badges Every Londoner Needs Right Now,1,1,9,41,0,9,2,50,0
Proof Steven Tyler Was The Coolest Grandma In 2015,1,1,8,30,0,8,4,38,0
People Give Blood For The First Time,1,1,7,23,0,6,0,30,0
22 Tweets That Are Way Too Funny For Anyone Who Hates Wearing Jeans,1,1,12,41,0,12,2,53,0
Celebrities Beg Congress to ‘Obstruct’ Donald Trump (Video),1,3,7,41,4,7,0,48,0
When You Take A Joke Too Far,1,1,7,15,0,6,0,22,0
11 Times One Direction Was Literally Dragged Down,1,1,7,33,0,7,2,40,0
This Is The Difference Between Freshman Year And Senior Year Of College,1,1,12,48,0,11,0,60,0
26 People Who Had A Way Worse 2015 Than You,1,1,8,20,0,9,6,28,0
Report: Hillary Clinton is ‘Thinking’ about Running for NYC Mayor,1,2,9,44,3,9,0,53,0
A shocking new study just disproved the 130-year-old theory about where dinosaurs came from,1,2,1,72,2,13,3,73,0
"When these two NBA coaches speak out against Trump, you should listen",1,3,5,52,1,11,0,57,0
The Hardest NHL Logo Quiz You'll Ever Take,1,1,10,24,1,7,0,34,0
9 Reasons Why PolitiFact Is Unqualified to Label ‘Fake News’,1,3,9,39,2,9,1,48,0
34 Insanely Delicious Ways To Cook Potatoes This Thanksgiving,1,1,8,43,0,8,2,51,0
45 Signs You're An Old Millennial,1,1,5,20,1,5,2,25,0
"The ""Secret Sister"" Gift Exchange On Facebook Is Very Illegal And Also A Hoax",1,1,14,48,2,13,0,62,0
"NYT’s Friedman: Flynn Resignation Shows Russia Hacking Was On Scale With 9/11, Pearl Harbor",1,3,15,56,4,13,3,71,0
'Hidden Figures' Is Already Inspiring More Girls To Go Into STEM,1,3,14,38,2,10,0,52,0
WATCH: Protesters Burn American Flags Outside Trump International Hotel,1,3,13,49,1,8,0,62,0
Day 5 Of BuzzFeed's 7-Day Clean Eating Challenge,1,1,8,29,2,7,2,37,0
"Donald Trump As The Slug From ""Monsters, Inc."" Will Ease Your Tired Heart",1,1,13,44,4,12,0,57,0
Success In The Real World: 7 Daily Behaviors Conscientious People Avoid,1,3,10,49,1,10,1,59,0
Jennifer Aniston And Justin Theroux Make Red Carpet Debut As Husband And Wife,1,1,13,52,0,12,0,65,0
21 Things All Sweary Girls Are Tired Of Hearing,1,1,8,29,0,8,2,37,0
We Know What You And Your S.O. Love Most About Each Other,1,3,13,31,2,11,0,44,0
Exclusive: Sean Spicer Gives CNN Public Dressing-down in Press Gaggle,1,2,11,47,2,9,0,58,0
"We Had The Cast Of ""How To Be Single"" Debunk Dating Rules",1,1,12,32,2,11,0,44,0
The 17 Biggest Hoverboard Fails Of All Time,1,1,7,27,0,7,2,34,0
Stocks are in a 'rare state' — here's what happens when they get as expensive as they are right now,1,3,1,75,4,19,0,76,0
Yankees' Mason Williams Hits Monster HR for 1st Career Major League Hit,1,3,11,47,1,11,1,58,0
McDonald's switch to fresh beef is bad news for one of their biggest competitors,1,3,2,64,1,13,0,66,0
Is golf exercise?,1,3,1,13,1,2,0,14,0
The Most Expensive Death on Game of Thrones Will Probably Surprise You,1,2,10,49,0,11,0,59,0
Everyone Needs To Read This Facebook Post About America's Muslims And Sikhs,1,1,12,51,1,11,0,63,0
17 Gorgeous Gallery Walls You'll Want To Recreate In Your Own Home,1,1,11,41,1,11,2,52,0
Two Huge Whales Just Wanted To Hang With This Dude While He Paddleboarded And It's Surprisingly The Cutest,1,1,18,70,1,17,0,88,0
Here's A List Of Wigs Adele Has Snatched This Week,1,1,10,30,1,9,0,40,0
A New Mom Woke Up From Her Coma After She Heard Her Baby Cry,1,1,14,33,0,13,0,47,0
Did Blac Chyna Just Get Future's Name Tattooed On Her Hand,1,1,11,36,1,10,0,47,0
‘Watch Dogs 2’ Review: A Competent but Cringeworthy Open-World Adventure,1,3,9,49,4,9,1,58,0
Trump presidency: Opponents boosted by 'rage donation',1,2,2,43,3,6,0,45,0
This Is What Happens When You Are Proposed To,1,1,9,28,0,8,0,37,0
"Los Angeles Times Editorial Loses It over Trump: ‘Narcissist,’ ‘Demagogue’",1,2,9,50,6,9,0,59,0
Only Solve This Puzzle If You Want To Get Hazed By Famous Figures,1,1,13,40,0,12,0,53,0
This Crossword Is For Everyone Who Loves Dirty Cartoons,1,1,9,38,0,8,0,47,0
The next face of poverty could be yours,1,3,1,31,0,7,0,32,0
'Mother' Ganges becomes a legal person,1,3,2,29,2,5,0,31,0
"Sarabhai vs Sarabhai's First Teaser, Sonu Nigam Responds To The Criticism And More From Ent",1,3,14,61,2,14,0,75,0
The '2 Kinds Of People' Tumblr Will Nail Your Personality Down In A Second,1,2,13,45,2,13,1,58,0
Daniel Radcliffe's Tribute To Alan Rickman Is Completely Heartbreaking,1,1,9,52,1,8,0,61,0
Social media: Think again before you post those pics of your kids,1,3,2,51,1,11,0,53,0
The woman whose mum inspired her to track ethical food,1,3,1,44,0,9,0,45,0
"In dramatic testimony, witness describes Pa. trooper's dying moments after ambush",1,2,2,66,3,10,0,68,0
We Asked Americans To React To Canadian Election Things,1,1,9,38,0,8,0,47,0
"Young Thug's Video For ""Wyclef Jean"" Isn't What You'd Expect",1,3,10,36,5,9,0,46,0
Drunk pilot faces prison sentence after pleading guilty,1,3,1,47,0,7,0,48,0
We Know What TV Show You've Binge-Watched Based On Your Relationship Status,1,1,14,48,2,11,0,62,0
17 Rey-Inspired Products You Can Actually Buy,1,1,7,29,1,6,2,36,0
18 Of The Most WTF Photoshop Fails Of 2015,1,1,9,19,0,8,6,28,0
Let's Be Real People Were Definitely Banging At Hogwarts,1,1,9,38,1,8,0,47,0
Scott Walker Has Been Telling This Teacher's Story For Years And She Wants Him To Stop,1,3,16,54,1,15,0,70,0
32 Illustrations For Anyone Who Thinks Women Make Badass Knights,1,1,9,44,0,9,2,53,0
21 Photos That Are Way Too Real For Makeup Addicts,1,1,9,30,0,9,2,39,0
Dr. Zizmor Has Retired So No One In NYC Will Ever Have Clear Skin Again,1,1,17,39,1,14,0,56,0
Mystery of the giant metal die solved in Idaho,1,3,2,36,0,8,0,38,0
This Food Test Will Determine If You're Actually From Michigan,1,1,10,42,1,9,0,52,0
Why Hillary Clinton Lost,1,3,4,17,0,3,0,21,0
"What's Your Favorite Moment From ""Hocus Pocus""",1,1,7,30,3,6,0,37,0
JPMorgan ChaseVoice: 4 Tips To Help Your Business Flourish On Social Media,1,3,14,47,1,11,1,61,0
Which Comedy Series Should You Binge Watch Next,1,1,8,32,0,7,0,40,0
"If You Have A Spare $400, Go Ahead And Spend New Years Eve At Olive Garden",1,1,15,39,2,15,3,54,0
17 Awkward Moments When You're A Jew On Christmas,1,1,8,30,1,8,2,38,0
Google’s Next Project: Fixing Congested Cities - Digits,1,3,7,38,3,7,0,45,0
It's Hard To Forget The Best Photos From Obama's First 100 Days,1,3,11,36,2,11,3,47,0
"In One Facebook Post, Three Misleading Statements by President Trump About His Immigration Order ",1,2,13,69,1,14,0,82,0
Meet The Brownies That Put All Other Brownies To Shame,1,1,10,35,0,9,0,45,0
Here's why marriage and doctors are the most popular jokes,1,3,1,47,1,9,0,48,0
News Why you should never take your shoes off on a flight - and other cabin crew revelations,1,3,2,72,1,17,0,74,0
Miley Cyrus married? Billy Ray's post has people talking,1,3,4,42,2,8,0,46,0
37 Cleaning Basics You Should Probably Know By Now,1,3,8,32,0,8,2,40,0
The mother who made the ultimate sacrifice,1,3,1,35,0,6,0,36,0
"Rihanna And Drake Are So Cute In The ""Work"" Video It Hurts",1,1,12,33,2,11,0,45,0
Twitter Ranks the Most-Tweeted-About Holiday Songs and Movies,1,3,8,44,2,7,0,52,0
"Maher: Trump Violates ‘Pay Your Taxes’ Rule, I Worry ‘We Do Need the UN to Step In’",1,2,16,45,6,16,0,61,0
These Five Questions Will Determine Why You're Still Single,1,1,9,41,1,8,0,50,0
"When a President Says, ‘I’ll Kill You’ - Video - NYTimes.com",1,2,10,33,7,10,0,43,0
"Risen From the Grave, Keystone XL Pipeline Again Divides Nebraska ",1,3,10,45,1,10,0,55,0
Can Barrow stem flow of young Gambians heading for Europe?,1,3,4,44,1,9,0,48,0
"Farhan-Ranveer's Funny Race, SRK's Promise To Acid Attack Survivors And More From Ent World",1,3,17,57,4,13,0,74,0
"27 ""Real Life"" Magazine Headlines That Went Way, Way Too Far",1,1,10,35,3,10,2,45,0
14 Fashion Essentials You Should Own by Age 30,1,2,6,28,0,8,4,34,0
What Ghost Movies Are Required Watching For Horror Fans,1,1,9,38,0,8,0,47,0
"Journalist Booked Under Official Secrets Act, Abetment To Suicide After Soldier's Death Over Sting Video",1,3,15,73,2,14,0,88,0
14 Women Who Pushed Their Boob Potential To The Limit,1,1,9,33,0,9,2,42,0
16 Kids That Are Straight From A Horror Movie,1,3,8,27,0,8,2,35,0
Can We Guess Your Personal Life Philosophy,1,1,7,29,0,6,0,36,0
When You Think You Might Snap,1,1,6,18,0,5,0,24,0
This couple earn a six-figure salary by travelling the world,1,3,1,49,1,9,0,50,0
"The ""Mario Bros."" Theme Song Has Actual Lyrics And They're A Goddamn Inspiration",1,1,13,51,4,12,0,64,0
Nobody Likes Hand Jobs,1,1,4,15,0,3,0,19,0
"'NBC's New Year's Eve' Host Carson Daly Shares New Year's Resolution, How to Stay Warm in Times Square",1,2,18,61,6,17,0,79,0
36 Signs That Actually Deserve Your Attention,1,1,6,31,0,6,2,37,0
Richard Sherman Waited 11 Months to Rip Cam Newton for Something He Did Last Season,1,2,12,55,0,14,2,67,0
A Court Keeps People Out of Rikers While Remaining Tough ,1,3,9,38,0,10,0,47,0
17 Reactions Everyone Will Recognize During Engagement Season,1,1,7,45,0,7,2,52,0
"Blake Lively, Viola Davis, Ashley Graham, and More Gorgeous, Smart Celebs Hit the Time 100 Gala",1,3,13,60,4,15,3,73,0
Need A New Year's Resolution? 10 Ideas For A Stronger Career In 2017,1,2,11,37,2,12,6,48,0
Obama: ‘We Cannot Deny the Legacy of Racism’ in Justice System,1,3,8,41,3,10,0,49,0
These Teens Used Actual Scarlet Letters As A Clever Way To Protest Their  School's Sexist Dress Code,1,1,17,65,1,17,0,82,0
Don't Risk It! When to Pay Attention to the Expiration Dates of Pantry Items,1,3,10,51,2,13,0,61,0
8 Times Hillary Clinton Pushed Fake News,1,3,6,27,0,6,1,33,0
This Stunning Video Perfectly Captures All The Highs And Lows Of Breaking The Dahi Handi,1,1,15,59,0,14,0,74,0
Aleppo Christians celebrate holiday in hope peace has returned,1,3,2,52,0,8,0,54,0
23 Incredibly Disrespectful Things People Did To Food In 2015,1,1,8,38,0,9,6,46,0
Robert Davi at CPAC: Trump the ‘Force of Nature’ America Needed to Break Out of Globalist Era,1,2,15,59,3,16,0,74,0
"We Know How You'll Spend Christmas Based On This ""Friends"" Question",1,1,11,43,3,10,0,54,0
Twinkle Khanna Had The Best Reaction After Seeing A Vendor Sell Pirated Copies Of Her Books,1,2,16,60,0,15,0,76,0
6 takeaways from Trump's address to Congress,1,2,2,34,1,6,1,36,0
Allison Williams Looks Super Different With Bangs,1,1,7,36,0,6,0,43,0
Pilot walked away after plane crashes nose first on Maine highway ,1,2,2,53,0,11,0,55,0
Here's The First Look At Benedict Cumberbatch As Doctor Strange,1,1,10,43,1,9,0,53,0
Who Do You Think Should Win At The 2015 Emmy Awards,1,1,10,27,0,10,4,37,0
"28 Reasons Ross Geller Is Actually The Best Character On ""Friends""",1,1,10,42,2,10,2,52,0
TWO MINUTE MONEY: Tackle your credit card debt,1,3,15,23,1,7,0,38,0
25 Things You Won't Believe People Tried To Sneak On Planes,1,1,10,36,1,10,2,46,0
Your political views help determine which science books you buy,1,3,1,53,0,9,0,54,0
Black Students at University of Michigan Demand Segregated Space,1,3,7,49,0,8,0,56,0
Australian Wearing Cross Beaten By Muslim Gang Shouting ‘F*** Jesus!’,1,3,10,44,6,9,0,54,0
The 23 Deepest Zayn Malik Tweets Of 2015,1,1,6,21,0,7,6,27,0
This Puppy Wanted To Say Hello So Bad That He Got His Head Stuck In A Wall,1,1,17,41,0,16,0,58,0
Schumer Calls on Sessions to Resign — We Need A Special Prosecutor,1,2,9,45,1,11,0,54,0
Behind the scenes at a Trump photo shoot,1,3,2,31,0,7,0,33,0
Obama Administration Scraps Entry-Exit Tracking System for Migrants from Muslim Countries,1,3,10,68,1,10,0,78,0
States With Highest and Lowest Taxes,1,3,5,26,0,5,0,31,0
FULL TEXT: ‘A Merry MILO Christmas’ at Minnesota State University,1,3,18,35,3,9,0,53,0
An Adorable Animals Advent Calendar: December 6,1,1,6,33,1,6,1,39,0
What you should know before collecting Social Security,1,3,3,44,0,7,0,47,0
29 Super Cool Gifts From Target You Still Have Time To Get,1,1,11,34,0,11,2,45,0
"Health Care, Immigration Ban, North Korea: Your Tuesday Briefing ",1,2,9,44,3,9,0,53,0
24 Subtly Spooky Halloween Decorations You Can Leave Up All Year,1,1,10,42,0,10,2,52,0
"Here's What Chai Really Is, To Settle The Score About This Tea Once And For All",1,2,16,46,2,15,0,62,0
ICE Rounds Up 44 Criminal Aliens in Texas Capital,1,2,9,30,0,8,2,39,0
22 Things Every People Person Will Understand,1,1,6,31,0,6,2,37,0
Barack Obama's evolution in 10 years of hip-hop lyrics,1,3,2,40,2,8,2,42,0
Hailee Steinfeld Reveals 6 Ways She's Learned To Love Herself,1,1,9,41,1,9,1,50,0
Does Trump know he’s president?,1,3,2,23,2,4,0,25,0
15 Essential Products For Anyone Who Wants To Eat Healthier,1,1,9,39,0,9,2,48,0
How we could close tech’s gender gap in a decade,1,3,1,37,1,9,0,38,0
People Are Going Nuts Over This Ridiculously Hot Veterinarian,1,1,9,44,0,8,0,53,0
"These ""Jeopardy!"" Contestants Couldn't Tell The Biggest Martial Arts Actors Apart",1,1,11,56,4,10,0,67,0
"31 Thoughts I Had While Watching ""Empire""",1,1,6,25,2,6,2,31,0
How This 30-Something Entrepreneur Is Giving The 100 Year-Old Automotive Industry A Tune-up,1,3,13,58,3,12,5,71,0
If The Beatles Were Scientifically Accurate,1,1,6,32,0,5,0,38,0
19 Reasons That Keep Calm And Carry On Must Be Stopped Forever,1,1,11,38,0,11,2,49,0
Why Ariana Grande’s feminist Twitter post was a brilliant career move,1,2,4,54,1,10,0,58,0
19 Clever Gifts For Anyone Who's Constantly On Their Phone,1,1,9,37,1,9,2,46,0
"Grab Your Earphones And Listen To This Gorgeous Instrumental Cover Of Adele's ""Hello""",1,1,13,57,3,12,0,70,0
This Woman Tried To Live Like Kylie Jenner For A Week And It Was Exhausting,1,1,15,46,0,14,0,61,0
People Are Dressing Their Pets As Beanie Babies And It's Almost Too Much,1,1,13,46,1,12,0,59,0
14 Horror Movies That Would Actually Terrify Women,1,1,7,34,0,7,2,41,0
How Many Of These Award-Winning TV Shows Have You Seen,1,1,12,32,1,9,0,44,0
Which Famous Trio Of Friends Would You Belong To,1,1,9,31,0,8,0,40,0
Are You Scylla Or Charybdis,1,1,5,18,0,4,0,23,0
The Treasury Secretary is ‘not worried at all’ about robots taking jobs. Here’s why he could be wrong.,1,3,4,76,5,17,0,80,0
How Intuitive Are You Really,1,1,5,19,0,4,0,24,0
27 Of The Worst Things About Going To Stock Photo University,1,1,10,38,0,10,2,48,0
Ashton Kutcher blew a kiss at John McCain and lol what is happening?,1,3,5,50,1,12,0,55,0
Powerful images show what it’s like to read when you have dyslexia,1,3,1,53,1,11,0,54,0
Shocking Video Appears to Show Security Guard Attacking Exotic Dancer During Performance,1,3,11,66,0,11,0,77,0
21 Fucking Things British Women Who Love Swearing Know To Be True,1,1,11,41,0,11,2,52,0
10-Year-Old Girl Used as Human Bomb in Nigeria Attack,1,3,8,33,2,8,2,41,0
Snapchat just released a 35-minute video about itself,1,3,1,42,1,7,2,43,0
"This Cathedral’s Stairs Have Been Covered In 1,000 Cardboard Cutouts Of Nicki Minaj’s Ass",1,3,13,56,3,13,4,69,0
What Intelligence Agencies Concluded About the Russian Attack on the U.S. Election ,1,3,10,59,2,12,0,69,0
One Direction Cancelled A Gig 30 Minutes Before It Was Due To Start,1,1,12,41,0,12,2,53,0
The Hardest Thanksgiving Poll You Will Ever Take,1,1,8,33,0,7,0,41,0
24 Words That Were Overused AF In 2015,1,1,7,18,0,7,6,25,0
Report: Twitter Overbills Advertisers as Video Bug Increases Ad Metrics by 35%,1,3,9,54,2,11,2,63,0
18 Couples Who Made You Believe In Love Again,1,1,8,27,0,8,2,35,0
Why everyone's laughing at this $400 juicer,1,3,1,31,2,6,3,32,0
"Swedish Mail Delivery Suspended in No Go Zone After ‘Incident’, Safety Concerns",1,3,11,54,3,11,0,65,0
Ten Signs You're Interviewing With A Bad Employer,1,3,8,33,1,7,0,41,0
Leonardo DiCaprio's Face When Lady Gaga Walked By Him To Accept Her Award Is Everything,1,1,16,56,1,14,0,72,0
"Samuel L. Jackson Put His Own Flare On Iconic Film Quotes During ""The Late Show""",1,1,15,48,3,14,0,63,0
Will the Real Democracy Lovers Please Stand Up? ,1,2,7,32,1,8,0,39,0
These Grandmas Played Recent College Grads In Flip Cup And It's Everything,1,1,12,50,1,11,0,62,0
The 8 Best Things I Saw At The First-Ever Broadway Fan Convention,1,1,12,40,1,11,1,52,0
"'Orphan Black' Season 3, episode 9 recap: Family ties",1,3,4,35,4,8,2,39,0
Inside London's oldest cigar merchants',1,3,2,31,2,4,0,33,0
Astronauts are learning to become space explorers in one of the least likely places on Earth,1,3,2,75,0,15,0,77,0
"13 Times ""RuPaul's Drag Race"" Captured How You Feel While Unemployed",1,1,11,42,3,10,2,53,0
What’s the method in Trump’s madness?,1,2,2,27,3,5,0,29,0
It’s prime derecho season in Washington: Everything you need to know,1,2,3,53,2,10,0,56,0
Could your imagination be making you FAT? Vivid thoughts 'trigger food cravings and encourage you to eat more',1,2,5,85,3,17,0,90,0
We Know Who You Want For Christmas Based On Your Zodiac Sign,1,1,12,37,0,11,0,49,0
23 Insanely Relatable Stages Of Partying As An Introvert,1,1,8,38,0,8,2,46,0
59 Terrifyingly Real Nightmares All New Yorkers Share,1,1,7,37,0,7,2,44,0
19 Practically Impossible Questions For Every Kardashian Fan,1,3,7,44,0,7,2,51,0
"Do You Know The Names Of These ""Scandal"" Characters",1,1,9,32,2,8,0,41,0
These Questions About The '90s Will Determine Your Actual Age,1,1,9,40,1,9,2,49,0
19 Reasons Why No One Should Ever Play Video Games On A PC,1,1,13,31,0,12,2,44,0
"Leslie Jones Made Lorne Michaels Move Seats During Her ""SNL"" Audition",1,1,13,44,2,10,0,57,0
Which Christmas Cookie Matches Your Personality,1,1,6,36,0,5,0,42,0
26 Breathtaking U.S. Sights You Need To See Before You Die,1,1,11,33,2,10,2,44,0
Disney Princesses With Hair Matching Their Outfits Is Kind Of Magical,1,1,11,48,0,10,0,59,0
29 Beauty Products You Should Try In 2017,1,3,6,22,0,7,6,28,0
Baby Monkey Weeps Copiously By His Mother Who Died After Being Run Over By A Speeding Vehicle,1,3,17,60,0,16,0,77,0
15 Best Songs About Siblings,1,3,4,18,0,4,2,22,0
"Is 'baby brain' real? Yes, but not in the way you may think",1,2,2,41,4,12,0,43,0
12 Unexpectedly Bizarre Moments From British Court Cases,1,1,7,40,0,7,2,47,0
Gigi Hadid's 16-Year-Old Brother Just Got A Modeling Contract,1,1,10,38,3,8,2,48,0
"The Smiths, Kardashians, And Mary J. Blige Just Formed An Epic Squad",1,1,12,42,3,11,0,54,0
Are You More Sherlock Holmes Or Doctor Who,1,1,8,27,0,7,0,35,0
21 Beautiful Models Who Bravely Bared Their Boobs On The Runways,1,1,10,42,0,10,2,52,0
Which Disney Castle Should You Live In,1,1,7,25,0,6,0,32,0
This Dad Just Built The Most Incredible Tree Fort In His Daughter's Bedroom,1,1,13,49,1,12,0,62,0
"5 habits worth cultivating in 2017, according to a dietitian",1,3,0,45,1,9,5,45,0
19 Things You'll Only Find In A College Dorm,1,1,8,25,1,8,2,33,0
Guys Try Tinder,1,1,3,10,0,2,0,13,0
31 Things You Need To Cook In October,1,1,7,21,0,7,2,28,0
This Is The Only Way You Should Be Eating Pumpkin Pie,1,1,11,32,0,10,0,43,0
What alcohol does to your body and brain,1,3,1,32,0,7,0,33,0
"The First ""Shadowhunters"" Footage Is Seriously Cool",1,1,7,36,2,6,0,43,0
"Ranveer's Bizarre Outfit, Malaysian Students Sing SRK's Song 'Janam Janam' & More From Ent!",1,3,15,56,7,13,0,71,0
26 Movies We're Excited To See At The 2015 BFI London Film Festival,1,1,13,35,1,12,6,48,0
St. Vincent Waitressed At Her Sister's Dallas Restaurant This Weekend,1,1,10,48,2,9,0,58,0
This Video Will Make You Think Twice About Wearing A Headdress To Coachella,1,1,13,50,0,12,0,63,0
"This One Thing You Never Noticed In ""Arthur"" Will Rock Your World",1,1,12,40,2,11,0,52,0
GOLDMAN: Here are our biggest fears for 2017,1,2,8,24,1,7,4,32,0
"Super Bowl 2017: Schedule, Time, Channel and Date for Patriots vs. Falcons ",1,3,8,47,4,12,4,55,0
Airline carry-on size suggestions could mean you need new luggage,1,2,1,54,1,9,0,55,0
"22 Times Geralt Of Rivia From ""The Witcher 3"" Looked Sexy AF",1,1,11,33,2,11,3,44,0
17 Pairs Of Actually Cute Sweatpants That'll Keep You Comfy This Winter,1,1,11,46,1,11,2,57,0
This ‘Big-Hearted Banker’ Emerged From the Collapse a Billionaire,1,3,8,46,3,8,0,54,0
19 Decadent Treats Worth Breaking Your Diet For,1,1,7,31,0,7,2,38,0
10 Cheating Confessions,1,1,2,17,0,2,2,19,0
The Penny Is A Giant Waste Of Money And It Must Be Stopped,1,1,13,33,0,12,0,46,0
You Won't Believe How Much Of This Mini Crossword You Can Finish,1,1,12,40,1,11,0,52,0
27 Kids Who Just Don't Give A Fuck Any More,1,1,9,22,1,9,2,31,0
27 Indians Aside From Priyanka Chopra Who Have Appeared In Hollywood Projects,1,1,11,53,0,11,2,64,0
The Secret to Sibling Success ,1,2,4,21,0,5,0,25,0
17 Celebs Who Prove Long Hair Isn't The Only Way,1,1,9,27,1,9,2,36,0
"60 years later, a plane crash and a jail prove ‘a blessing’ for one survivor ",1,3,0,57,3,15,2,57,0
Craftsman’s famous lifetime warranty in question after $900 million sale,1,3,1,57,2,9,3,58,0
Justin Theroux Just Posted A Pic For Jennifer Aniston’s Birthday And OUR HEARTS ARE MELTING,1,3,30,46,1,14,0,76,0
How Sugar Helped Hook America on Cigarettes,1,3,6,31,0,6,0,37,0
"It Doesn't Take Much Smoking to Kill You, Study Finds",1,3,9,33,2,9,0,42,0
Must-Hear Music Podcast: Best Albums of 2016 Edition,1,3,7,32,2,7,4,39,0
17 Snacks That Do A Convincing Impression Of Fries,1,1,8,32,0,8,2,40,0
U.S. Should Clinch Second Round Pass With Win Against Familiar Foe Sweden,1,3,13,47,2,11,0,60,0
12 Insanely Silly Secret Santa Gifts That Won't Break The Bank,1,1,10,39,1,10,2,49,0
The Most Practical Cars And Crossovers For 2017,1,3,7,29,0,7,4,36,0
We Know Who You Plan On Spending Valentine's Day With,1,1,10,33,1,9,0,43,0
20 apps to get you out and about,1,3,0,23,0,7,2,23,0
What's The Comfiest Halloween Costume You've Ever Worn,1,1,8,37,2,7,0,45,0
We Know How Much Of A Virgin You Are,1,1,9,19,0,8,0,28,0
8 Ways To Live Longer,1,1,4,12,0,4,1,16,0
These Professional Fitness Instructors Tried Boxing For The First Time,1,1,10,51,0,9,0,61,0
The data firm that helped Trump win is now being probed about Brexit,1,3,3,53,0,12,0,56,0
29 Camping Recipes That'll Make You Look Like A Genius,1,1,9,33,1,9,2,42,0
This One Question Will Determine Your Favorite Type Of Climax,1,1,10,42,0,9,0,52,0
All The Looks On The Critics' Choice Awards Red Carpet,1,1,10,34,1,9,0,44,0
25 Parents Share The Parenting Hacks They Can't Live Without,1,1,9,39,1,9,2,48,0
How to Survive the Longest Flight in the World,1,2,5,33,0,8,0,38,0
Why Green Lantern can still recover and become the multi-movie franchise we deserve,1,3,3,67,1,12,0,70,0
NYT Executive Editor: Washington Post Slogan Sounds Like ‘Next Batman Movie’,1,3,13,50,3,10,0,63,0
What Weird Food Habits Did You Have Growing Up,1,1,9,29,0,8,0,38,0
17 Easy Slow Cooker Soups That Will Warm You Right Up,1,1,10,31,0,10,2,41,0
Why your phone's battery life gets shorter over time,1,2,1,42,1,8,0,43,0
'You don't belong here' - solicitor caught on film launching racist attack on woman and her young son,1,3,1,79,4,17,0,80,0
Who will be Twitter's next CEO? Volunteers include rapper Snoop Dogg,1,3,8,48,2,10,0,56,0
25 Things From 2015 You Probably Already Forgot About,1,1,7,32,0,8,6,39,0
Genius woman hacks fridge to dispense wine instead of water,1,3,1,49,0,9,0,50,0
42 Yahoo Questions That Will Make You Nervous For The Future Of Our Planet,1,1,13,46,0,13,2,59,0
15 Years Ago Rob Lowe Looked Exactly The Same At The Emmys,1,1,11,34,0,11,2,45,0
The Anti-Inauguration ,1,3,3,16,1,2,0,19,0
Women Answer: Sex Or Exclusivity First,1,1,6,26,1,5,0,32,0
This Teen's Text Prank On His Parents Is A Work Of Genius,1,1,12,33,1,11,0,45,0
6 Types Of Lesbians You've Broken Up With,1,1,7,25,1,7,1,32,0
You Should Never Ask For a Slice Of Lemon In Your Drink,1,3,11,33,0,11,0,44,0
My IUD And Me: A Lesbian Love Story,1,1,10,17,1,7,0,27,0
17 Hilarious Tumblr Posts For Everyone Who Is So Done With School,1,2,11,41,0,11,2,52,0
The week in politics,1,3,1,16,0,3,0,17,0
15 Easy Things You Can Do That Will Help When You Feel Like Shit,1,1,13,36,0,13,2,49,0
This Recipe For Fruit Sushi Will Blow Your Mind,1,1,9,30,0,8,0,39,0
A Ballet Troupe Performed An Impromptu Routine During Their Flight Delay And Slayed Us All,1,1,15,61,0,14,0,76,0
"Here's The Beautiful Detail In ""Notting Hill"" You Probably Missed",1,1,10,43,3,9,0,53,0
12 Things That Make Guys Jealous,1,1,5,20,0,5,2,25,0
FinTech 50 2016: The Future Of Your Money,1,2,7,20,1,7,6,27,0
These Are Trap Questions. Do Not Answer Them,1,1,8,28,1,7,0,36,0
Deadpool Is No Antidote For Superhero Fatigue,1,1,7,32,0,6,0,39,0
13 Pedro Infante Songs To Listen To When You're Drunk AF,1,1,11,32,1,10,2,43,0
Cat owner learns the hard way to read those Amazon descriptions carefully,1,2,2,60,0,11,0,62,0
June Intelligent Oven Might Be A Better Cook Than You,1,3,10,34,0,9,0,44,0
How 'True Detective' Season 3 Can Avoid Being a Total Dumpster Fire,1,3,10,43,2,11,1,53,0
17 Music Facts That Will Make '00s Kids Feel Old AF,1,1,10,26,1,10,4,36,0
Kristen Bell Defends Celebrity Activism: I’m Not ‘Any Less Allowed to Share What I Believe’,1,2,14,59,4,14,0,73,0
Exclusive—Rep. Massie on Trump’s First 100 Days: ‘Neil Gorsuch Was Worth the Entire Election’,1,3,12,59,6,13,3,71,0
17 Popular Song Lyrics Everyone Misheard In 2015,1,1,6,29,0,7,6,35,0
"Mumbai Is Sending Powerful Messages Of Love, Support, And Solidarity For Paris",1,1,12,53,2,11,0,65,0
These Loyal Elephants Refused To Abandon Their Dead Friend After He Broke A Leg And Got Shot!,1,2,17,59,1,16,0,76,0
7 Signs She Thinks Your Name Is Bruce,1,1,7,22,0,7,1,29,0
13 Struggles Only Pets Who Live In Canada Will Understand,1,1,9,37,0,9,2,46,0
What the hell just happened in the BBC News studio?! The list,1,3,6,42,2,11,0,48,0
23 Times Fashion Week Finally Kept It Real And Put Natural Hair On The Runway,1,1,14,47,0,14,2,61,0
Jerry Brown: ‘We’re Not Going to Bring Stupid Lawsuits’ Against Trump Wall,1,2,11,48,4,11,0,59,0
"Ashley Salter, The Bachelor's Onion Queen, Is Engaged",1,1,8,35,3,7,0,43,0
18 Deliciously Filling Salads Guaranteed To Make You Hungry,1,1,8,41,0,8,2,49,0
Six Chinese Billionaires Spring Up With Delivery Fortunes Worth $47 Billion,1,3,10,52,1,10,2,62,0
This Canadian Woman Opened Up A Can Of Thanksgiving NOPE,1,1,13,34,0,9,0,47,0
"Oh hell yeah, look how big this turtle is",1,3,1,31,1,8,0,32,0
Steph Curry Predicted His Own Fate In A '90s Burger King Commercial,1,1,11,42,1,11,2,53,0
"This Librarian Decorated The Cupboard Under Her Stairs To Look Like ""Harry Potter""",1,1,13,55,2,12,0,68,0
"Review: ‘Amélie’ Is Easy to Listen To, but Never Really Sings ",1,2,9,38,4,11,0,47,0
This photo of Edward Snowden with a bucket of chicken has caused a lot of controversy The list,1,3,4,73,0,17,0,77,0
Mobile technology takes fight against HIV in Lesotho to the people,1,3,5,51,0,10,0,56,0
Here's How You Can Help Your Friend Recovering From An Eating Disorder,1,1,12,46,1,11,0,58,0
Britney Spears Hilariously Pranked Bodyguards With The Help Of Neil Patrick Harris,1,1,12,59,0,11,0,71,0
The 20 Best Episodes of 2016,1,3,3,14,0,5,6,17,0
14 Things That’ll Happen In 2017 According To “The Simpsons”,1,3,8,34,3,9,6,42,0
6 Google products and services you never even knew existed,1,2,1,47,0,9,1,48,0
Everyone's Obsessed With This Completely Wild Video Of A Kid Playing His Kazoo,1,1,13,52,1,12,0,65,0
How the Dow Adds Up to 20000,1,2,4,13,0,6,5,17,0
13 Secrets About The Muppets You Probably Don’t Know,1,2,8,33,1,8,2,41,0
This Crossword Is For Everyone Into Kinky Sex And Rihanna Songs,1,1,11,42,0,10,0,53,0
20 companies that let you work from home,1,2,0,31,0,7,2,31,0
How much normalizing does an abnormal president deserve?,1,3,1,47,1,7,0,48,0
26 Then And Now Pictures Which Can't Not Make You Smile,1,1,10,32,1,10,2,42,0
'Painful' sunscreen burn cases ignite call for review of product testing in Australia,1,3,2,69,2,12,0,71,0
Muffler Man Returns! And We Cannot Wait To See Who Will He Take Down This Season!,1,3,16,48,2,15,0,64,0
This Vibrator Maker Was Secretly Tracking Its Customers’ Sexual Activity,1,3,10,52,1,9,0,62,0
Just Answer These Five Questions And We'll Tell You Your Celebrity Husband,1,1,12,50,1,11,0,62,0
These Two Sun Bears Are Roly Poly Cuties,1,1,8,25,0,7,0,33,0
Deconstructing President Trump's jobless numbers,1,3,3,40,1,4,0,43,0
Adult Legoland fans are really angry they're not allowed in the kids playground,1,3,2,64,1,12,0,66,0
Here’s How To Make 21 Healthy Meals For Under $50,1,3,8,26,2,9,4,34,0
Can We Guess Your Zodiac Sign From The Animal You Choose,1,1,11,35,0,10,0,46,0
One Direction Played Their Final Show And Things Got Emotional,1,1,10,43,0,9,0,53,0
18 Booty Call Confessions That Are All Too Real,1,1,8,29,0,8,2,37,0
Just A Reminder That A Taylor Swift Holiday Album Exists,1,1,10,37,0,9,0,47,0
What's Your Favorite Story From Your Time In A Black Fraternity Or Sorority,1,1,13,49,1,12,0,62,0
'Racist' primary school headmistress who called staff 'f*****g Muslims' banned from teaching for life,1,3,2,77,9,13,0,79,0
How Trump can get his groove back,1,3,2,25,0,6,0,27,0
"It's Easier To Start A Company In India Than Shutting It Down, Thanks To The Maze Of Laws",1,3,18,52,2,17,0,70,0
What Scandal Would Olivia Pope Have To Fix For You,1,1,10,31,0,9,0,41,0
We Know Your Birth Month Based On One Question,1,1,9,29,0,8,0,38,0
Long Distance Best Friends,1,1,4,19,0,3,0,23,0
Amber Rose Opened Up About Slut-Shaming During Her SlutWalk Event,1,1,12,43,1,9,0,55,0
"Katrina Kaif Turns Into A Barber, Dear Zindagi's Deleted Scene & More From The World Of Ent!",1,3,16,56,4,16,0,72,0
31 Beautiful Dog Tattoos Every Dog Lover Will Appreciate,1,1,8,38,0,8,2,46,0
"Rumoured Nokia D1C Android Phone To Be Priced At Rs 9999, More Specs Revealed",1,3,14,44,1,13,5,58,0
Do You Think Pugs Are Cute,1,1,6,15,0,5,0,21,0
27 Halloween Costumes For Men That Will Probably Make You Tingle Down There,1,1,12,49,0,12,2,61,0
"The ""PLL"" Cast Reveals What Their Characters Are Like Five Years In The Future",1,1,16,47,2,13,0,63,0
Paying for President Trump's Travel and Security Costs ,1,2,6,40,1,8,0,46,0
Can We Guess Your Personality Based On Your Resting Bitchface,1,1,10,42,0,9,0,52,0
I Finally Bought An Amazon Echo And This Is What Happened,1,1,11,36,0,10,0,47,0
There’s a Scientific Way to Leave Work Frustrations at the Office,1,3,7,47,1,10,0,54,0
11 Most Insane Things That Happened In Pennsylvania In 2015,1,1,8,36,0,9,6,44,0
"If You Have A Bad Relationship With New Year's Eve, You're Not Alone",1,3,13,40,3,12,0,53,0
PaycomVoice: 3 Things Employers Should Know About Wage Garnishments,1,3,9,48,1,8,1,57,0
How Many Premier League Football Grounds Have You Been To,1,1,10,38,0,9,0,48,0
"Which Fright From ""This Is Halloween"" Are You",1,1,8,28,2,7,0,36,0
This Baby's Reaction To Hearing About How She Was Created Is Amazing,1,1,12,44,1,11,0,56,0
43 Life-Changing Books You Need To Read,1,1,7,23,1,6,2,30,0
10 Life-Changing Things To Try In October,1,1,7,25,1,6,2,32,0
You Won't Believe Who Trump Dressed As for 'Superhero' Costume Party  Insider,1,2,11,51,3,12,0,62,0
22 Of The Most Hilarious Closed-Captioning Moments,1,1,7,34,1,6,2,41,0
Questions Australians Have For The UK,1,1,7,25,0,5,0,32,0
Rick Ross on Kanye West 'Wigging Out': 'He Played Ya'll',1,2,9,32,6,9,0,41,0
Why Fox stock is immune to Bill O'Reilly scandal,1,2,5,34,1,8,0,39,0
A Man Allegedly Threw Semen At This Woman While She Was On Her Way To Work,1,1,16,43,0,15,0,59,0
Michelle Bernard on Trump Presidency: ‘You Can’t Help But Think’ Slavery Is Coming Back,1,3,13,57,4,13,0,70,0
"How Well Do You Remember The First Episode Of ""House, M.D.""",1,1,12,32,5,10,0,44,0
21 Pictures That Are Way Too Real For People Who Are Always Cold,1,1,12,38,0,12,2,50,0
17 Confessions From Backpackers That Will Make You Laugh Out Loud,1,1,10,43,0,10,2,53,0
This Plus-Size Clothing Collaboration Is A Minimalist's Dream,1,1,9,43,2,7,0,52,0
What Happened When Venezuela Outlawed Its Own Currency ,1,2,8,39,0,8,0,47,0
Udya Chopra Royally Trolled On Twitter For Comparing Fairness Creams To Hair Colour,1,3,13,58,0,12,0,71,0
"Butler team plane loses cabin pressure; coach says 'it was scary, we had guys crying'",1,3,1,66,4,14,0,67,0
"Over 250,000 patients forced to change surgery as record number of GP practices close",1,3,3,62,1,13,6,65,0
28 Foolproof Ways To Eat Pizza Every Damn Day,1,1,8,27,0,8,2,35,0
14 Important Sigils For Twentysomethings,1,1,4,30,0,4,2,34,0
"21 Times ""Harry Potter"" Accurately Described The End Of Semester",1,1,9,42,2,9,2,51,0
Everything You Need To Know About Homemade Popcorn Crunchie Bars,1,1,10,45,0,9,0,55,0
What's The Best Way To Flirt On Social Media,1,1,9,26,1,8,0,35,0
$500k Of Student Loan Debt In 37 Seconds,1,1,6,21,1,7,5,27,0
"Goodbye, geek glasses: why aviators are this season’s biggest eyewear trend",1,2,1,61,3,10,0,62,0
17 Emotionally Raw Confessions From People With Low Self-Esteem,1,1,9,43,1,8,2,52,0
Guyana tribe goes hi-tech to protect its land,1,2,1,36,1,7,0,37,0
The Facebook Privacy Notice Going Around Is A Total Farce,1,1,10,38,0,9,0,48,0
16 Parchment-Wrapped Dinners For People Who Hate Dishes,1,3,8,37,1,7,2,45,0
Moroccans Are Responding To Police Harassment With Hilarious Memes,1,1,9,49,0,8,0,58,0
27 Last-Minute Stocking Stuffers For Every Fandom,1,1,7,33,1,6,2,40,0
17 Times Grant Gustin's Instagram Melted Your Goddamn Heart,1,1,8,40,1,8,2,48,0
19 signs you're successfully adulting,1,2,0,30,1,4,2,30,0
24 Adorable Products Every Cat Lover Needs In Their Home,1,1,9,36,0,9,2,45,0
28 Tweets About Weddings That Will Make You Laugh Out Loud,1,1,10,36,0,10,2,46,0
Men Wore Makeup For A Week And Looked Glam AF,1,1,11,25,0,9,0,36,0
10 Mouthwatering Pizza Facts,1,1,3,20,0,3,2,23,0
This Is Why Your Team Won't Win the Super Bowl Next Year,1,2,11,33,1,11,0,44,0
People Are Emptying Out Giant Stuffed Bears And Climbing Inside,1,1,10,44,0,9,0,54,0
These Two Adorable Guinea Pigs Sharing A Blade Of Grass Might Just Cause Your Heart To Explode,1,1,17,61,0,16,0,78,0
Can You Figure Out This Cards Against Humanity Crossword,1,1,9,39,0,8,0,48,0
"Michael Flynn, Kim Jong-un: Your Tuesday Evening Briefing ",1,3,8,39,3,8,0,47,0
27 Totally Hilarious Family Photos,1,1,4,24,0,4,2,28,0
25 Of The Most Epic Celebrity Glo Ups,1,2,7,21,0,7,2,28,0
Manmohan Singh's Office Knew Changing Requirements To Fit AgustaWestland's Bid Says SP Tyagi,1,2,15,63,2,12,0,78,0
Salma Hayek's Advice For Women Is Basically All You'll Ever Need,1,1,11,41,2,10,0,52,0
"Los Angeles Times Editorial Loses It over Trump: ‘Narcissist,’ ‘Demagogue’",1,3,9,50,6,9,0,59,0
Brit Awards 2017: When are they? How can I watch? Who is presenting and performing?,1,3,6,55,4,14,4,61,0
A Stingray Photobombed A Couple's Proposal And It's Adorable,1,1,9,41,2,8,0,50,0
This is probably the most over the top gingerbread house ever,1,3,1,50,0,10,0,51,0
17 Cats Who Could Use A Day Off,1,1,7,15,0,7,2,22,0
Indiana Town’s Entire Police Force Resigns,1,2,6,30,1,5,0,36,0
The 11 skills every 24-year-old should learn,1,3,1,31,2,6,4,32,0
16 Pictures That Will Instantly Destroy Any Friendship,1,1,7,38,0,7,2,45,0
"Monster Dad Rapes Minor Daughter For Months, She Finally Delivers A Baby Girl",1,3,13,51,1,12,0,64,0
Things That Make 20-Somethings Feel Old,1,1,6,25,1,5,2,31,0
We Know Your Favorite Music Genre Based On Your Zodiac Sign,1,1,11,38,0,10,0,49,0
31 Delightfully Weird Gifts For All The Medical Nerds In Your Life,1,1,11,42,0,11,2,53,0
7 Delicious Dinners That Are Great For Weeknights,1,1,7,34,0,7,1,41,0
9 Deliciously Fabulous Ways To Enjoy Chimichurri,1,1,6,35,0,6,1,41,0
19 Gorgeous And Fluffy Chow Chows To Follow On Instagram,1,1,9,36,0,9,2,45,0
37 Facts You Probably Never Knew About The Macy's Thanksgiving Day Parade,1,1,11,48,1,11,2,59,0
"'Star Wars,' 'Justice League' And The Biggest Blockbusters Of 2017",1,3,9,39,5,9,4,48,0
17 Signs You May Actually Be Addicted To Hajmola,1,1,8,30,0,8,2,38,0
Zendaya's Reaction To A Magazine Photoshopping Her Body Is Perfect,1,1,10,46,1,9,0,56,0
"What Would Your ""Harry Potter"" Wand Core Be Based On Your Zodiac Sign",1,1,13,42,2,12,0,55,0
Taraji P. Henson Had The Best Reaction To Viola Davis' Historic Emmy Win,1,1,13,45,2,12,0,58,0
This designer clothing line is stylish ... and bulletproof,1,3,1,46,3,8,0,47,0
11 Happy Little Things To Make You Smile This Week,1,3,9,30,0,9,2,39,0
This woman gave up her porn career and became a pastor The list,1,3,2,49,0,12,0,51,0
Protecting the President: Secret Weapons and a Hefty Price Tag,1,3,7,45,1,9,0,52,0
Jake Gyllenhaal Once Wrote A Letter To KFC To Bring Back Chicken Littles,1,1,15,45,0,12,0,60,0
No Deal on Health Care as Congress Goes into Recess,1,3,7,35,0,9,0,42,0
Green Gummy Bears Have Been Lying To You Your Whole Life,1,1,11,35,0,10,0,46,0
Which Member Of BTS Are You,1,1,8,14,0,5,0,22,0
Snapchat’s crackdown on content sets itself apart from Facebook and Twitter,1,2,3,61,1,10,0,64,0
"34 ""I Laughed So Hard I Cried"" Stories",1,1,7,20,2,7,2,27,0
Red Sox prospect has baseball's strangest pre-pitch routine,1,3,2,48,2,7,0,50,0
Here's What Happens When You Accidentally Buy Your Girlfriend 144 Pairs of Fuzzy Socks,1,3,12,57,1,13,3,69,0
This Video Perfectly Illustrates Why You Shouldn't Always Be On Your Phone,1,1,12,50,1,11,0,62,0
White House sends satirical news story by accident in daily newsletter and do you guys even read,1,2,2,78,0,16,0,80,0
19 Dutch Words And Their WTF Translations,1,1,8,25,0,6,2,33,0
25 Things Teetotallers In Their Twenties Will Just Get,1,1,8,36,0,8,2,44,0
Woman Helps Man Abandoned By His Mother Reclaim Life After Being Homeless For 3 Years,1,3,14,56,0,14,1,70,0
Can You Guess The Movie From The Family,1,1,8,24,0,7,0,32,0
20 Wonderful Local Stores From The Northwest You Can Shop Online,1,1,10,42,0,10,2,52,0
This Girl Trying To Get Harry Styles' Attention Will Break Your Heart,1,1,12,45,1,11,0,57,0
15 Times The Justin Trudeau Thirst Went Too Far,1,1,8,29,0,8,2,37,0
This Video Shows The Apollo Missions Like You've Never Seen Them Before,1,1,12,47,1,11,0,59,0
Can You Remember Who Was The Headliner And Who Was The Opening Act,1,1,13,41,0,12,0,54,0
The 12 Sassiest Anderson Cooper Comebacks Of 2015,1,1,6,30,0,7,6,36,0
21 Adorable Red Panda Products You Need In Your Life,1,1,9,32,0,9,2,41,0
23 Confessions From Short Guys That Prove Body-Shaming Is Real,1,1,10,40,1,9,2,50,0
Which Profane Message Do You Need To Hear Based On Your Star Sign,1,1,13,40,0,12,0,53,0
100 Women: The English girls' school reborn in a Nairobi slum,1,2,4,42,2,10,3,46,0
This Is Kim Kardashian's Amazing Placenta,1,1,6,29,1,5,0,35,0
"FAKE NEWS: CNN Claims GOP Trying to Remove ‘$200,000 Tax’ on Firearm Suppressors",1,3,20,37,5,12,6,57,0
19 Prehistoric Pendant Necklaces Every Dinosaur Lover Will Want,1,1,8,45,0,8,2,53,0
Saudis Temper Call for Cuts and Russia Digs In,1,2,7,31,0,8,0,38,0
Hundreds Of Indians Are Posting Selfies With Cows To Protest Their Slaughter,1,1,12,53,0,11,0,65,0
"How Well Do You Remember The ""Filthy Animal"" Scene From ""Home Alone""",1,1,12,41,4,11,0,53,0
Create Your Perfect Mate To Find Out Exactly When You'll Get Married,1,3,12,44,1,11,0,56,0
"Which ""High School Musical"" Song Are You Based On Your Zodiac Sign",1,1,12,41,2,11,0,53,0
23 Infamous Mugshots From History,1,3,4,23,0,4,2,27,0
17 People Who Slayed The Eyeshadow Game,1,1,6,25,0,6,2,31,0
Do You Have What It Takes To *Get* This Crossword Puzzle,1,1,11,33,2,10,0,44,0
17 Insanely Brilliant Ways To Hide Alcohol In Your Outfit,1,1,9,37,0,9,2,46,0
21 Kitchen Gadgets That Actually Help You Eat Healthier,1,1,8,37,0,8,2,45,0
22 Of The Greatest Things To Ever Happen On Snapchat,1,1,9,32,0,9,2,41,0
"One Direction's New Music Video For ""Perfect"" Is Actually Perfection",1,1,10,46,3,9,0,56,0
21 Ways To Forget About Your Ex For Good,1,1,8,22,0,8,2,30,0
10 Tips To Help You Get To Sleep,1,1,7,16,0,7,2,23,0
Forever 21 Is Being Accused Of Stealing An Artist's Design For A Crop Top,1,1,13,44,1,13,2,57,0
15 Vintage Photos Of Christmas Displays Around The UK,1,1,9,34,0,8,2,43,0
These Stills From Old Disney Cartoons Are Insanely Gorgeous,1,1,9,42,0,8,0,51,0
"We Bet You Can't Name EVERY Dwarf From ""Snow White And The Seven Dwarves""",1,1,18,39,3,13,0,57,0
Is Your Fear Of Talking On The Phone Normal,1,1,9,26,0,8,0,35,0
15 Things Single People Are Tired Of Hearing On Thanksgiving,1,1,9,40,0,9,2,49,0
23 Disney Facts That Will Make You Feel Hella Old,1,1,9,29,0,9,2,38,0
Tips for surviving switch to Daylight Saving Time ,1,2,4,38,0,8,0,42,0
23 Two-Sentence Horror Stories That Will Scare The Hell Out Of You,1,1,12,40,1,11,2,52,0
Eating More of This Will Make You Live Longer,1,3,8,29,0,8,0,37,0
There Were A Lot Of Dapper AF Celebs At The GQ Men Of The Year Awards,1,1,18,36,0,15,0,54,0
19 Things You Know When You're The Messy One In Your Relationship,1,1,11,40,1,11,2,51,0
"15 Absolutely Stunning Wedding Venues That Cost Less Than $3,000",1,1,8,39,2,9,6,47,0
"Sherlock series four: Teaser trailer drops clues about Tom Hiddleston, Moriarty and Margaret Thatcher",1,3,7,79,2,13,0,86,0
We Know Which 2016 Presidential Candidate You Find Sexiest Based On Your Birth Month,1,1,13,54,0,13,4,67,0
21 Photos That Are Too Real For Indecisive People,1,1,8,31,0,8,2,39,0
How Megyn Kelly Discovered Her 'Zone Of Genius',1,3,8,30,2,7,0,38,0
Japan PM Shinzo Abe's diplomatic hole in one with Trump,1,3,6,39,1,9,0,45,0
What Adorable Nickname Should You Give Your Dog,1,1,8,32,0,7,0,40,0
7 Life-Changing Things To Try In March,1,2,7,23,1,6,1,30,0
A dentist reveals the most effective way to whiten your teeth,1,3,1,50,0,10,0,51,0
21 Signs That Prove Booksellers Are The Absolute Best,1,1,8,35,0,8,2,43,0
Liked ‘Serial’? Here’s Why the True-Crime Podcast ‘S-Town’ Is Better ,1,3,11,40,8,10,0,51,0
This Might Be The Most Sexist Real Estate Ad Ever,1,1,10,30,0,9,0,40,0
The Effects of Stress on Your Body,1,2,5,23,0,6,0,28,0
22 Heroes Who Will Give You Eternal Light,1,1,7,25,0,7,2,32,0
27 Stores With Helpful Reviews That'll Make Online Shopping So Much Easier,1,2,11,49,1,11,2,60,0
Video: How to spot an American,1,2,3,21,1,5,0,24,0
"Zayn Malik's ""Zitties"" Are Driving People Insane",1,1,7,32,3,6,0,39,0
How Big Of A Christmas Film Fan Are You Actually,1,1,10,29,0,9,0,39,0
21 Wedding Photos You'll Want To Pin Immediately,1,1,7,31,1,7,2,38,0
"Valerie Jarrett: Trump Victory Was ‘Soul-Crushing,’ ‘Punch to the Stomach’",1,2,9,49,7,9,0,58,0
How Stereotypically Single Are You,1,1,5,25,0,4,0,30,0
16 New Year's Resolutions Only Book Nerds Can Relate To,1,1,9,34,1,9,2,43,0
"The $4,500 injection to stop heroin overdoses",1,3,1,32,2,6,4,33,0
Alabama Governor Appoints Luther Strange to Replace AG Jeff Sessions in Senate,1,3,11,56,0,11,0,67,0
Hate Hoax: Pro-Trump Students Cleared of Harassment Claims,1,3,8,41,2,7,0,49,0
"Trump’s Wisconsin Crowd Cheers Kanye West, Boos Paul Ryan",1,3,9,38,2,8,0,47,0
The Ultimate Character Vs Character Showdown,1,1,6,33,0,5,0,39,0
"Duterte Threatens to Burn Down UN Building, Calls 3 Out of 5 Americans ‘Idiots’",1,3,11,50,3,13,2,61,0
Watch Big Sean Spit A Freestyle For Funkmaster Flex,1,3,9,34,0,8,0,43,0
Obamacare: Five Things You May Not Know About the Health Care Law,1,3,11,42,1,11,0,53,0
McDonald's gives consumers a break today from frozen meat,1,3,2,46,1,8,0,48,0
A Christmas Song For The Haters,1,1,6,20,0,5,0,26,0
Does this ham look blurry to you guys?,1,3,1,29,1,7,0,30,0
What Are You Like...Sexually,1,1,5,17,3,3,0,22,0
New Hampshire family plans bucket list for 9-year-old with terminal brain tumor ,1,2,2,63,2,12,1,65,0
"If White Goodman's Quotes From ""Dodgeball"" Were Motivational Posters",1,1,9,48,3,8,0,57,0
14 Gluten-Free Thanksgiving Dishes That'll Change Your Life,1,1,8,40,2,7,2,48,0
"Ok It's Official! Science Backs The Saying 'Once A Cheater, Always A Cheater'",1,2,13,47,5,12,0,60,0
Govt Bans BBC For 5 Years From All National Parks For Making 'Malicious' Film On Kaziranga,1,3,17,55,2,15,1,72,0
24 Times Twitter Went Way Too Fucking Far,1,1,7,25,0,7,2,32,0
Watch Tina Fey as Felicity Jones' Only Hope in 'SNL' Opening Monologue,1,2,12,44,3,11,0,56,0
30 Celebrities Turning 30 This Year,1,1,4,22,0,5,4,26,0
Job-Stealing Robots? Meet Your Maker,1,3,6,24,2,4,0,30,0
Do You Actually Remember These Disney Channel Show Theme Songs,1,1,10,43,0,9,0,53,0
The Easiest Pixar Quiz You'll Ever Take,1,1,7,25,1,6,0,32,0
ACLU Backs Zuckerberg Censorship of New Media on Facebook,1,3,10,39,0,8,0,49,0
"The New ""Beauty And The Beast"" Features Disney’s First Gay Character",1,3,11,44,3,10,0,55,0
How Much Of An Asshole Are You?,1,3,7,17,1,6,0,24,0
This Picture Test Will Reveal Your Ideal Partner,1,1,8,33,0,7,0,41,0
Can We Guess Your Festive Drink,1,1,6,20,0,5,0,26,0
Teen Who Threw Her Newborn out a Window Sentenced to Probation,1,3,8,44,0,10,0,52,0
Did J.K. Simmons Really Headbutt Lupita Nyong'o At The Oscars,1,1,11,38,3,9,0,49,0
19 Fucking Infuriating Things About Women's Clothing,1,2,6,37,1,6,2,43,0
Hereâs why malls across the US are dying,1,3,3,30,2,7,0,33,0
Women Tried Boudoir Photography For The First Time And Loved Every Second Of It,1,1,14,52,0,13,0,66,0
Former Google Vice President Starts a Company Promising Clean and Safe Nuclear Energy,1,3,11,62,0,12,0,73,0
Can You Pass This Challenging Timed Food Quiz?,1,3,8,30,1,7,0,38,0
Which Off-Brand Halloween Costume Should You Wear,1,1,8,34,1,6,0,42,0
19 Things Only Cat Owners Know To Be True,1,1,8,23,0,8,2,31,0
ADPVoice: How To Find The Best Tool For Measuring Your Employees' Productivity,1,3,15,50,2,11,0,65,0
Thousands Of People Are Sharing This Facebook Post About Two Doctors Saving A Man's Life,1,1,15,58,1,14,0,73,0
Ever Wondered What's The Exact Time You Need To Sleep To Wake Up Refreshed In The Morning? Here's The Answer,1,3,20,66,3,19,0,86,0
19 Times J.K. Rowling Was Sassy AF On Twitter In 2016,1,3,11,24,2,10,6,35,0
How a thing for Skee-Ball started a $3.2 million business,1,2,3,40,3,9,2,43,0
This Plus-Size Mom Received Hate Mail for Wearing Leggings: Experience Gave Me ‘Immense Strength’,1,3,14,66,4,13,0,80,0
Russia and the U.S. Election: What We Know and Don’t Know ,1,3,9,34,4,11,0,43,0
This Homeless Guy Went Viral After Getting A Makeover And Then His Whole Life Changed,1,2,15,56,0,14,0,71,0
15 Snapchats That Are Too Real For Anyone In A Relationship,1,1,10,37,0,10,2,47,0
9 Images Of Donald Trump Photoshopped Into ~Millennial Situations~,1,1,8,47,2,8,1,55,0
9 Shows We Stopped Watching This Year,1,1,6,24,0,6,1,30,0
People Have Giant Cats Living In Their Houses And Oh My Goodness,1,3,12,41,0,11,0,53,0
7 Seriously Legit Ways You Can Earn $$$ Working From Home,1,1,9,34,3,10,1,43,0
Are You More Jack Or Finn Harries,1,1,7,20,0,6,0,27,0
24 Spectacular One-Tier Wedding Cakes,1,1,5,25,1,4,2,30,0
21 Times You Were Completely Betrayed By Crisps,1,1,7,31,0,7,2,38,0
17 Things You Might Get If You're A PoC Fan Of Marvel,1,1,12,27,1,11,2,39,0
Which Halloween Town Should You Actually Live In,1,1,8,33,0,7,0,41,0
A Veteran Had The Most Heartwarming Response To A Little Girl's Question,1,1,12,48,1,11,0,60,0
"A Guy Sent Debra Messing A Dick Pic So She Shared It With Her 257,000 Twitter Followers",1,1,16,48,1,16,6,64,0
21 times Adele slayed beyond all expectations in 2016,1,2,1,38,0,8,6,39,0
This Is The Only Spinach And Artichoke Dip You Need In Your Life,1,1,13,39,0,12,0,52,0
What are we to make of an injury forcing Tiger Woods to cancel a press conference?,1,3,3,63,1,15,0,66,0
A Goofy Ending! Presenters Mistakenly Announce La La Land As Best Picture Instead Of Moonlight,1,3,15,64,1,14,0,79,0
McCain makes secret trip to Syria to meet with US troops,1,3,5,41,0,10,0,46,0
17 Totally Genius Ways To Flavor Popcorn,1,1,6,26,0,6,2,32,0
"Rock, Schumer and Chappelle hit the stage",1,3,3,31,1,6,0,34,0
Which One Direction Member Is Your Son,1,1,7,25,0,6,0,32,0
The Best Wine Bar In Every State For When You Want To Get Classy Drunk,1,1,15,41,0,14,0,56,0
"25 Funny, Random, And Bizarre Things People Have Actually Asked Google",1,1,10,46,2,10,2,56,0
19 Absolutely Stunning Make-Up Looks To Try This Autumn,1,1,9,35,1,8,2,44,0
"Sorry America, But ""Harry Potter And The Sorcerer's Stone"" Is Wrong",1,1,11,42,4,10,0,53,0
"Lauren, Tom Hanks Found Your Fordham University Student ID",1,1,10,39,1,8,0,49,0
"How Many Of The Books Mentioned On ""Gilmore Girls"" Have You Read",1,1,12,39,2,11,0,51,0
17 More Things To Do When You're Bored Out Of Your Mind,1,1,11,30,1,11,2,41,0
How to plan a family reunion trip ,1,3,1,26,0,7,0,27,0
Cat Lovers Get Surprised By A Box Of Tiny Kittens And Lose Their Minds,1,1,14,43,0,13,0,57,0
"Dear ""Walking Dead"" Fans: You-Know-Who Definitely Isn't Dead",1,1,10,37,6,7,0,47,0
11 Bad Sex Confessions,1,1,3,14,0,3,2,17,0
We Know What Type Of Person You Are Based On When You Poop,1,1,13,33,0,12,0,46,0
21 Tumblr Posts About Masturbation That Will Get You Every Time,1,1,10,41,0,10,2,51,0
16 Photos That Capture What It's Like Renting In Toronto,1,1,9,35,1,9,2,44,0
Which Condiment Suits Your Personality,1,1,5,29,0,4,0,34,0
27 Little Dogs Who Want You To Have A Good Week,1,1,10,25,0,10,2,35,0
Here's The Real Reason Pirates Wore Eyepatches,1,1,7,32,1,6,0,39,0
Do You Remember The Theme To The Andy Milonakis Show,1,1,10,33,0,9,0,43,0
20 Super Sexy Maternity Options For The Knocked Up,1,1,8,32,0,8,2,40,0
Do You Trust Your Friends,1,1,5,16,0,4,0,21,0
This 19-Year-Old Creates Jaw-Droppingly Realistic 3D Art That Will Make You Do A Double Take,1,1,17,55,3,14,3,72,0
OBAMA: Here's what I miss most about the White House,1,2,9,32,2,9,0,41,0
23 Cheap Upgrades That Will Actually Increase The Value of Your Home,1,1,10,45,0,11,2,55,0
17 Types Of Holiday Hangovers Illustrated By Crappy Snowmen,1,1,8,41,0,8,2,49,0
"8 Times ""Bake Off"" Restored Your Faith In Humanity",1,1,8,31,2,8,1,39,0
What's The Weirdest United States Law You've Ever Heard Of,1,1,10,37,2,9,0,47,0
Google Just Found the One Question It Can’t Yet Answer,1,2,9,35,1,9,0,44,0
26 Phone Notes That Are Funny For No Damn Reason,1,1,9,28,0,9,2,37,0
Which Halloween Candy Matches Your Zodiac Sign,1,1,7,33,0,6,0,40,0
Trump’s first seven days in the White House: a video review,1,3,3,44,2,10,0,47,0
Are You More Tyler Joseph Or Josh Dun From Twenty One Pilots,1,1,12,37,0,11,0,49,0
12 Pieces Of Advice From Aziz Ansari About Love And Dating,1,2,10,36,0,10,2,46,0
Fraudsters need just three details to steal your identity – and most of it can be found on Facebook ,1,3,2,78,1,19,0,80,0
"27 Of The Most Iconic ""American Horror Story"" Quotes Of All Time",1,1,11,38,2,11,2,49,0
Ever Wondered Why Some People Snore And Some Don't? Here's Your Answer To What Causes Snoring,1,3,16,59,3,15,0,75,0
Honest Advice On Why You Should Love Your Body,1,1,9,29,0,8,0,38,0
Meet The Women Who Run The Raddest Non-Girl Scout Troop Around,1,1,12,39,1,10,0,51,0
12 Late Night Sex Line Ads Made SFW [Still NSFW],1,1,14,21,2,9,2,35,0
"20 Reasons Stiles Stilinski From ""Teen Wolf"" Is The Man Of Your Dreams",1,1,12,42,2,12,2,54,0
States Aim to Lure College Dropouts Back to School ,1,2,7,35,0,9,0,42,0
"How Much Do You Actually Love ""Hamilton""",1,1,7,25,2,6,0,32,0
"Good News, It's Guys In Sweatpants Season",1,1,7,26,2,6,0,33,0
Jeff Sessions Slams Deal to Monitor Baltimore Police,1,3,7,38,0,7,0,45,0
There's A New Taylor Swift Meme Sweeping Tumblr,1,1,8,31,1,7,0,39,0
12 Charts That Only Those Who Have Survived A Canadian Winter Will Understand,1,1,12,51,0,12,2,63,0
Adele Went Makeup-Free On The Cover Of Rolling Stone And Looks Incredible,1,1,13,48,1,11,0,61,0
I Was Ghosted 3 Times In The Last Year. Here Are 6 Things I Learned.,1,2,13,37,2,14,2,50,0
Which Evil Mythical Creature Matches Your Zodiac Sign,1,1,8,38,0,7,0,46,0
Annotated: What does Nicola Sturgeon's Scottish independence letter say and really mean? ,1,2,5,69,3,12,0,74,0
When MS Dhoni Forgot For A Split Second That He Was Not The Captain And Demanded A Review!,1,3,19,53,1,17,0,72,0
How Much Do You Actually Know About Baking,1,1,8,27,0,7,0,35,0
"We, Non-Celebs, Acted Like Celebs On Instagram And This Is What Happened",1,1,13,45,3,11,0,58,0
Take Back Your Brain From Social Media,1,2,7,25,0,6,0,32,0
The Internet Has Turned This Old Photo Of Hema Malini Into Some Really Giggle-Worthy Memes!,1,3,16,59,2,14,0,75,0
23 Times Hannah Simone Was Absolutely Flawless On Instagram,1,1,8,41,0,8,2,49,0
Obama Vs. Trump: Ex-President Returns to Radical Community Organizing to Save His Tattered Legacy,1,3,13,68,3,13,0,81,0
"As Many as 48 Million Twitter Accounts Aren’t People, Says Study",1,3,9,41,2,10,2,50,0
We Know What You Actually Want For Christmas Based On Your Zodiac Sign,1,1,13,45,0,12,0,58,0
135 Police Officers Killed in the Line of Duty in 2016,1,3,5,32,0,10,7,37,0
"Trump Digs In on Wiretap, No Matter Who Says Differently ",1,2,9,37,1,10,0,46,0
Majority of Hungarians Back Orban’s ‘Anti-Soros’ University Law,1,3,8,44,4,7,0,52,0
35 Foods That Pretty Much Sum Up Your Childhood,1,1,8,29,0,8,2,37,0
When You Suck At Flirting,1,1,5,16,0,4,0,21,0
"This Scary, But Very Real, Video Shows That Anyone Can Get Diagnosed With Cancer",1,1,14,51,2,13,0,65,0
There's A Beauty Pageant For Camels In Saudi Arabia And The Winner Will Win 31 Million Dollars!,1,3,16,59,2,16,2,75,0
Dutch IVF centre probes suspected sperm mix-up,1,3,4,35,1,6,0,39,0
This Is What Our Security State Looks Like In Manhattan,1,1,10,36,0,9,0,46,0
Bacon Lovers Meet Tiny Piglets For The First Time,1,1,9,32,0,8,0,41,0
STOCKS SLIP TO END THE YEAR: Here's what you need to know,1,2,23,21,2,11,0,44,0
26 Of The Most Powerful Photos Of This Week,1,1,8,25,0,8,2,33,0
"This ""Would You Rather"" Game For ""Home Alone"" Is Almost Too Hard",1,1,12,37,4,11,0,49,0
'Real People' In Car Commercials Are Either Actors Or Not Terribly Bright,1,3,12,48,2,11,0,60,0
"Can You Make It Through This Post Without Saying ""NOPE""",1,1,13,31,2,9,0,44,0
Brexit and Scotland: ‘Indyref2’ Appears Likely as UK Divorce From EU Looms,1,3,12,47,3,11,1,59,0
Picture | The Best Images of the Year: 57 Captivating Photos of 2016 ,1,3,7,41,2,13,6,48,0
7 Easy Fall Dinners That Are Actually Satisfying,1,1,7,33,0,7,1,40,0
Mitch Albom Wishes You Weren't Reading This On Your Phone,1,1,10,37,1,9,0,47,0
Common Interviews Serena Williams to Discuss Her Legendary Career on ESPN's 'The Undefeated In-Depth',1,3,16,68,4,13,0,84,0
It Takes Mettle—and Wire—to Build the World’s Tallest Christmas Tree,1,3,9,47,3,9,0,56,0
How to see every photo your friends have ever liked on Facebook ,1,3,2,50,0,12,0,52,0
Zayn Malik Has A New Instagram And It'll Destroy Your Soul,1,1,11,36,1,10,0,47,0
How three best documentary Oscar nominees capture our history of racial division,1,3,2,67,0,11,0,69,0
11 Far Out Gifts Your Stoner Friend Is Sure To Appreciate,1,1,10,35,0,10,2,45,0
There Is A New Round Of Celebs Reading Mean Tweets And It's As Great As You'd Expect,1,1,17,49,2,16,0,66,0
Here's A Minimalist Look At Some Of The Best Bollywood Movies From 2015,1,1,12,42,1,12,4,54,0
"The 28 Most WTF, LOL, And OMG Viral Videos Of 2015",1,1,15,17,2,10,6,32,0
26 Things Introverts Are Sick And Tired Of Hearing,1,1,8,32,0,8,2,40,0
Which Disney Channel Original Movie Are You,1,1,7,30,0,6,0,37,0
"Transgender Officer Helps Build Trust, Ease Fear in D.C.",1,3,9,36,3,8,0,45,0
Wedding guests 'spend £640 each' to attend nuptials,1,3,1,37,3,7,3,38,0
If DJ Khaled's Snapchat Captions Were Motivational Posters,1,1,9,41,1,7,0,50,0
"This Guy Covered ""Sorry"" In 20 Different Ways And I've Never Wanted To Hear An Apology More",1,1,16,54,3,16,2,70,0
This Indian Dancer Had Sex Reassignment Surgery To Live With Her Boyfriend From Pakistan,1,1,14,61,0,13,0,75,0
16 Of The Best YA Books Of 2015,1,1,7,11,0,7,6,18,0
The Best and Worst U.S. Cities for Retirement,1,3,7,29,2,7,0,36,0
Can We Guess What You'll Buy Your Secret Santa,1,1,9,28,1,8,0,37,0
"How Well Do You Actually Remember ""A Different World""",1,1,9,34,2,8,0,43,0
21 Recipes For People Who Are Obsessed With Pancakes,1,1,8,34,0,8,2,42,0
16 Very Rude Texts Your Chronic Pain Would Send You,1,1,9,31,0,9,2,40,0
Indians: You Don't Need To Get Married Just Because People Want You To,1,1,13,43,2,12,0,56,0
Ice hockey team forced to apologise for violent mascot after joke fight backfires,1,3,1,68,0,12,0,69,0
Private Equity's Indian Trilemma,1,2,4,24,1,3,0,28,0
Grace VanderWaal's 10 Best Covers,1,3,5,21,1,4,2,26,0
Chrissy Teigen Is Pregnant,1,1,4,19,0,3,0,23,0
27 Hilarious Food Puns Every Book Nerd Will Appreciate,1,1,8,36,0,8,2,44,0
33 Facts You Probably Need To Know About Tinder,1,1,8,29,0,8,2,37,0
Here's A Genius New Tool That Actually Helps You Get Perfect Eyeliner,1,1,12,45,1,11,0,57,0
Exclusive: The most powerful Briton in America on what it's really like in Donald Trump's White House,1,3,8,74,3,16,0,82,0
Do You See These Drawings The Same Way As Most People,1,1,11,32,0,10,0,43,0
"'Yes We Did,' Obama Says in Farewell Address, but Warns of Threats to Democracy ",1,2,10,52,4,14,0,62,0
The Secrets Behind Russell Westbrook's Extreme Physique,1,3,7,41,1,6,0,48,0
13 Ways Ghosts Have All The Same Problems As You,1,1,9,28,0,9,2,37,0
John Cena And His Giant Hands Play With A Tiny Tortoise,1,1,11,34,0,10,0,45,0
Television's First Asian-American Action Hero Is A Letdown,1,1,9,40,2,7,0,49,0
Share your photos of cats for a chance to win Jane Bown's book,1,2,3,46,1,12,0,49,0
32 Tweets About Alcohol That'll Actually Make You Laugh,1,1,8,36,1,8,2,44,0
Brzezinski: Trump Won EV ‘Fair and Square’ – But He’s Not ‘Completely Elected By the People’,1,3,14,56,7,15,0,70,0
Day Without Illegals Becomes a Political Dud,1,2,6,32,0,6,0,38,0
The History Of Chocolate Will Make You Want To Go Out And Get A Bar Right Now,1,1,17,44,0,16,0,61,0
Five myths about the cross,1,3,1,21,0,4,0,22,0
"Americans Eat 554 Million Jack in the Box Tacos a Year, and No One Knows Why",1,3,11,46,1,15,3,57,0
The Ultimate Guide To Getting Published In A Literary Magazine,1,1,10,43,0,9,0,53,0
23 Of The Most Heart-Shattering Breakup Songs From 2015,1,1,8,32,1,8,6,40,0
21 DIY Ornaments That'll Take Your Tree To The Next Level,1,1,12,32,1,10,2,44,0
27 Ways To Transform Your Favorite College Snacks Into Real Food,1,1,10,42,0,10,2,52,0
This is how much a coffee date with Ivanka Trump will cost you,1,2,3,47,0,12,0,50,0
Mosul: The biggest battle anywhere on the planet,1,3,2,38,1,7,0,40,0
Couples Reveal Their Biggest Pet Peeves,1,1,6,28,0,5,0,34,0
"Which Character From ""Uta No Prince-Sama"" Are You",1,1,9,30,3,7,0,39,0
Ruby Rose Is Not Happy At All About These Revealing Photos Being Published,1,1,13,49,0,12,0,62,0
26 People We Have All Been At One Point In Our Lives,1,1,11,28,0,11,2,39,0
Why April 15 Has Lost Its Claim as ‘Tax Day’ ,1,2,8,23,2,10,2,31,0
Chris Pratt Literally Looks Completely Different With His New Beard,1,1,10,48,0,9,0,58,0
27 Breathtaking Alternatives To A Traditional Wedding Bouquet,1,1,7,45,0,7,2,52,0
"A rank outsider has seized the White House. But will he defend the Constitution, or trample it?",1,3,5,71,3,16,0,76,0
17 Boozy Hot Chocolate Recipes To Make This Winter,1,1,8,32,0,8,2,40,0
Your guide to drinking responsibly during the silly season Featured Stories Additional stories,1,2,4,78,0,12,0,82,0
29 Pieces Of Birmingham's Best Street Art,1,1,6,26,1,6,2,32,0
Can You Unscramble This Celebrity's Name,1,1,6,28,1,5,0,34,0
People Try Bizarre Candy Canes,1,1,5,21,0,4,0,26,0
Mermaid Instructor? Canine Masseuse? The Oddest Hotel Jobs on Earth,1,3,9,47,2,9,0,56,0
Minimalism no more! How I discovered the joy of recluttering,1,3,3,47,1,9,0,50,0
Homeless? Starving? Cheer up! These Great Depression billboards told poor Americans how lucky they were,1,3,7,79,3,14,0,86,0
A Parasite Attacked This Dad's Brain And Destroyed His Family,1,3,10,41,1,9,0,51,0
"‘Just stop, Daddy’: A lawmaker beat his wife as his children pleaded with him, officials say",1,3,3,69,5,15,0,72,0
Sonakshi Sinha Snapchatted Herself Doodling And Accidentally Drew Kim Kardashian,1,1,10,61,0,9,0,71,0
Presenting: The 2016 version of ‘Guess Who?’,1,3,4,26,4,6,4,30,0
Santa Claus Sightings From Around The World Photos ,1,3,8,35,0,8,0,43,0
Kashmir violence: Online videos 'show abuse',1,2,2,34,3,5,0,36,0
17 Books With LGBT Characters That Will Actually Change Your Life,1,1,13,40,0,10,2,53,0
"6 Music Video ""Would You Rather"" Questions That Are Impossible To Answer",1,1,11,47,2,11,1,58,0
"D.C. Area ICE Roundup Nets 82, Including MS-13 Members",1,3,12,26,4,8,4,38,0
Trump: It Is In ‘Vital National Security Interest of the US’ to Prevent the Use of Chemical Weapons,1,3,14,65,3,17,0,79,0
11 Stress Texts You Only Send During Finals Week,1,1,8,30,0,8,2,38,0
Is Elf On The Shelf Watching You,1,1,7,19,0,6,0,26,0
13 Signs You Might Own A Badass Winter Cat,1,1,8,24,0,8,2,32,0
5 years in the past century that changed the course of human history,1,3,0,55,0,12,1,55,0
"Philae comet lander wakes up, says European Space Agency",1,3,4,43,1,8,0,47,0
16 Things Only People With Raynaud's Will Understand,1,1,7,35,1,7,2,42,0
"Here's What The ""Aladdin"" Cast Looks Like Now",1,1,8,27,3,7,0,35,0
Halsey Opened Up About What It's Like Living With Endometriosis,1,1,10,43,1,9,0,53,0
Ryan Reynolds Flew Halfway Across The World To See Blake Lively For A Day,1,1,14,46,0,13,0,60,0
Russia Wants Immigrants the World Doesn’t,1,3,5,30,1,5,0,35,0
Steven Mnuchin’s Defining Moment: Seizing Opportunity From the Financial Crisis,1,3,9,59,2,9,0,68,0
Fans are losing it over this Jon Snow theory from new 'Game of Thrones' photo,1,3,5,56,2,14,0,61,0
Why Republican candidates should want to be shut out of debates,1,2,2,51,0,10,0,53,0
31 Photos That’ll Make Every Nurse Laugh Out Loud,1,2,8,30,1,8,2,38,0
Two Kerala Youths Arrested In Goa For Distributing Anti-ISIS Pamphlets!,1,3,14,46,2,9,0,60,0
"By The Time You Show Up To My Office, Your Marriage May Be Over",1,3,14,35,1,13,0,49,0
Cold War photo sparks amazing coincidence on Reddit| Latest News Videos ,1,3,6,54,1,11,0,60,0
"Everyone's Freaking Out Over This Girl's Amazing ""Sexy Gandalf"" Costume",1,1,10,48,4,9,0,58,0
19 Insanely Delicious And Healthy Ways To Enjoy Gingerbread For Breakfast,1,1,10,51,0,10,2,61,0
13 Songs You Probably Liked Before Your Feminist Awakening,1,1,8,40,0,8,2,48,0
Three TSA Agents Arrested for Drug Smuggling Ring at San Francisco International Airport,1,2,13,63,0,12,0,76,0
"Rachel Maddow Airs Headline Linking Venezuelan Protests to Trump, Retracts Online",1,2,10,60,1,10,0,70,0
Women With These 20 Job Titles Are The Happiest At Work,1,2,10,33,0,10,2,43,0
"18 Wikipedia Pages That’ll Make You Say ""Fuck, That’s Interesting""",1,3,9,41,5,9,2,50,0
The 10 Least Stressful Jobs In 2017,1,3,5,18,0,6,6,23,0
"What's The Funniest ""Bob's Burgers"" Moment",1,1,6,27,4,5,0,33,0
Watch: 'Logan' Hugh Jackman Has A 'Special Message' For Team Cricket India Against Australia!,1,3,14,60,6,13,0,74,0
How Many Of These Ice Cream Flavors Have You Actually Tried,1,1,11,38,0,10,0,49,0
The Definitive Ranking Of Lady Gaga's Music Videos,1,1,8,34,1,7,0,42,0
We Know Your Favorite TV Show Based On Your Zodiac Sign,1,1,12,33,0,10,0,45,0
Here's What Healthy People Actually Eat All The Time,1,1,9,34,1,8,0,43,0
19 Reasons You Should Be Making Dessert In Your Slow Cooker,1,1,10,37,0,10,2,47,0
Curious Curse of May: Emerging-Market Currency Bulls Beware,1,3,8,42,2,7,0,50,0
Selena Gomez and The Weeknd spotted kissing,1,2,4,33,0,6,0,37,0
34 Non-American Musicians You Need To Add To Your Playlist,1,1,10,36,1,9,2,46,0
Airline carry-on size suggestions could mean you need new luggage,1,3,1,54,1,9,0,55,0
17 Confessions From Breast Cancer Survivors That Are Incredibly Emotional,1,1,9,53,0,9,2,62,0
29 Women Share The Life-Changing Beauty Tips They Got From Mom,1,1,11,38,1,10,2,49,0
This Insane $6 Bathing Suit From Amazon Actually Looks Good On Everyone,1,1,11,47,1,11,1,58,0
13 Ways To Prove You're Way More Interesting Than The Stupid Super Bowl,1,1,12,44,1,12,2,56,0
"I Saw ""The Force Awakens"" Without Seeing Any Other ""Star Wars"" Movie And This Is What Happened",1,1,17,57,4,16,0,74,0
17 Kids Who Aren't Messing Around This Christmas,1,1,7,31,1,7,2,38,0
Bernie Sanders launches his own podcast,1,3,2,32,0,5,0,34,0
Last Minute Halloween Costume Ideas For Your Pet,1,1,8,33,0,7,0,41,0
Android malware: 38 new phones and tablets found to be pre-installed with virus before being sold,1,2,1,77,2,15,2,78,0
"Only A True ""Friends"" Fan Can Answer These Questions About The First Season",1,3,13,48,2,12,0,61,0
How Do You Get Pumped To Work Out When You're Feeling Lazy AF,1,1,14,34,1,12,0,48,0
17 Mind-Blowing Vagina Confessions Everyone Should See,1,1,7,38,1,6,2,45,0
Dale Cavese: the football chant that took over the internet and the world,1,2,2,58,1,12,0,60,0
Adorable Baby Gorilla Is Born After Rare C-Section,1,1,9,33,1,7,0,42,0
What It Means To Be A Filipino-American,1,1,8,24,1,6,0,32,0
Watch: First Trailer for Al Gore’s ‘An Inconvenient Sequel: Truth to Power’,1,3,10,49,5,11,0,59,0
Can We Guess What Kind Of Sandwich You Are Based On Your Zodiac Sign,1,1,14,41,0,13,0,55,0
This 30-Year-Old Man Had To Change His Email Address Because His Name Is Taylor Swift,1,1,16,51,2,14,2,67,0
17 Simply Stunning Sheer Wedding Dresses,1,1,5,28,0,5,2,33,0
"26 Hilarious Tweets About Work That Are Way, Way Too Real",1,1,10,34,1,10,2,44,0
This Quiz Will Tell You How You Communicate,1,1,8,28,0,7,0,36,0
Demi Lovato’s Breast-Contouring Makeup Trick,1,3,6,32,2,4,0,38,0
Which Blue Jays Player Should You Date Based On Your Zodiac Sign,1,1,12,41,0,11,0,53,0
How to sell your home: Property stylists reveal cosmetic secrets behind locking a sale,1,3,2,70,1,13,0,72,0
"Can You Remember The Lyrics To ""One Week"" By Barenaked Ladies",1,1,11,38,2,10,0,49,0
WATCH: People Ignore Woman With Her Head Stuck in NYC Subway Doors  Insider,1,3,18,43,1,13,0,61,0
Spanish UK resident feared insurance rule would force her to leave,1,2,3,53,0,10,0,56,0
20 Hilarious Tweets That Will Make You Think Twice About Having Kids,1,1,11,44,0,11,2,55,0
What makes Norway the world's happiest country?,1,3,2,37,2,6,0,39,0
I Survived A Suicide Attempt,1,1,5,19,0,4,0,24,0
13 Breads for Your Thanksgiving Table,1,1,4,26,0,5,2,30,0
"33 Twitter Jokes That Are Just Very, Very Funny",1,3,8,28,1,8,2,36,0
What Does Star Wars Mean To You,1,1,7,18,0,6,0,25,0
The Most OMG Movie Scenes Of 2015,1,1,8,15,0,6,4,23,0
Amul's New Cartoon Perfectly Mocks Jayalalithaa's Relief Sticker Debacle,1,1,9,53,2,8,0,62,0
These Five Questions Will Determine When You're Getting Married,1,1,9,45,1,8,0,54,0
Indians: Let's Take A Second To Acknowledge That Priyanka Chopra Is F*cking Killin' It,1,1,14,55,4,13,0,69,0
80 Things Britney Spears Has Done Since Her 2007 Breakdown,1,3,8,35,0,9,6,43,0
Which Disney Character Sparked Your Sexual Awakening,1,1,7,39,0,6,0,46,0
"This Is What It's Like To Eat Durian, The Stinky And Scary King Of Fruits",1,1,15,42,2,14,0,57,0
Holy Shit This Guy Looks Exactly Like A Young Leonardo DiCaprio,1,1,12,41,0,10,0,53,0
A Dog Was Saved After Her Owner Posted She Wanted Her Shot On Facebook,1,1,14,43,0,13,0,57,0
"FYI, Tom From MySpace Is Living The Dream",1,1,11,22,1,7,0,33,0
"Cyclone Vardah Strikes Chennai, Kills 2 + 5 Other Major Stories From Today",1,3,10,48,2,12,2,58,0
21 Deliciously Warming West African Dishes You Should Be Eating This Winter,1,1,11,51,0,11,2,62,0
17 Secretly Healthy Drunk Foods,1,1,4,21,0,4,2,25,0
Are You Actually Smarter Than A Crow,1,1,7,23,0,6,0,30,0
24-hour work shifts can wreak havoc on the heart,1,3,0,37,1,8,2,37,0
9 people who discovered just how terrible their exes really are The list,1,3,1,58,0,12,1,59,0
17 Ways To Squeeze A Little Extra Storage Out Of A Tiny Kitchen,1,1,12,37,0,12,2,49,0
Are You More Taylor Swift Or Adele,1,1,7,21,0,6,0,28,0
We Fact-Checked Seven Seasons Of Shark Tank Deals. Here Are The Results.,1,3,13,45,3,11,0,58,0
Is Your Boyfriend A Man Or A Butternut Squash Wearing Sunglasses,1,1,11,43,0,10,0,54,0
"Anti-ageing breakthrough: Reprogramming the body could extend lifespan, say scientists",1,3,2,72,3,9,0,74,0
"Trump Tweets, Vowing Obamacare Isn’t Safe Yet",1,3,7,30,2,6,0,37,0
The Kid Who Wore The Messi Plastic Bag Shirt Is Going To Meet His Hero,1,1,15,41,0,14,0,56,0
16 Ice Cream Cocktails You Need In Your Life,1,2,8,26,0,8,2,34,0
Iggy Azalea Tried To Clap Back Against T.I. On Twitter,1,1,11,32,2,9,0,43,0
18 Insanely Clever And Beautifully Decorated Cookies,1,1,6,38,0,6,2,44,0
Can You Guess The Marvel Movie Based On Just The First Or Last Line,1,1,14,40,0,13,0,54,0
Syria chemical attack: Sarin gas likely weapon used in Idlib as experts say Russian claims 'don't add up',1,2,4,80,4,17,0,84,0
"Tyler Ford Answers Your Questions About Identity, Style, And More",1,1,10,44,2,9,0,54,0
An Adorable Animals Advent Calendar: December 21,1,1,6,33,1,6,2,39,0
"The One Person You Probably Never Noticed In Britney Spears' ""Piece Of Me"" Music Video",1,1,15,54,3,14,0,69,0
This Teen Brought Her Stepdad To Tears With Surprise Christmas Gift,1,3,11,46,0,10,0,57,0
Syria conflict: The biblical river at the heart of a water war,1,3,2,48,1,11,0,50,0
This Dude Dresses His Beard Up For Every Holiday And It's Glorious,1,1,12,42,1,11,0,54,0
2 Ways To Be Happier -- Today,1,3,5,15,2,6,1,20,0
11 Greeting Cards We Desperately Need For Canadian Thanksgiving,1,1,8,45,0,8,2,53,0
This Color Test Will Determine Where You Like To Have Sex,1,1,11,36,0,10,0,47,0
7 Dinners To Make This Week,1,1,5,16,0,5,1,21,0
What Percent Messy And Tidy Are You Actually?,1,2,8,29,1,7,0,37,0
We Know What % Ryan And What % Sharpay You Are,1,2,9,25,2,10,0,34,0
Which Talk Show Should You Be A Guest On,1,1,9,23,0,8,0,32,0
Here's What You Look Like Hiding A Yawn,1,1,8,23,1,7,0,31,0
18 Hilarious Tweets About Going Vegan,1,1,5,25,0,5,2,30,0
What D.C. activities are more fun when you’re high?,1,3,3,36,4,8,0,39,0
17 Absolutely Perfect Pickup Lines For Whiskey Drinkers,1,1,7,39,0,7,2,46,0
How To Dress For The Gym Without Looking Like A Tool,1,1,11,31,0,10,0,42,0
"14 Reasons You Need To Get Excited For ""Ash Vs. Evil Dead""",1,1,11,31,3,11,2,42,0
32 Gorgeous Beauty Products People Of Color Swear By,1,3,8,34,0,8,2,42,0
We Know What Your Secret Talent Is,1,1,7,21,0,6,0,28,0
What Percent Vegan Are You,1,1,5,17,0,4,0,22,0
From Caitlyn Jenner to a Brooklyn High School ,1,3,6,32,0,8,0,38,0
George Osborne's Mansion House speech,1,2,4,28,1,4,0,32,0
What's Your Genius Camping Hack,1,1,5,21,1,4,0,26,0
"19 Times Barney Stinson Was The Real Romantic On ""How I Met Your Mother""",1,1,13,42,2,13,2,55,0
"How children play, even in the harshest of environments",1,3,1,45,1,8,0,46,0
Celebrate Tax Day 2017 with these deals and freebies ,1,3,3,37,0,9,4,40,0
Here's How I Accidentally Made An Old Avril Lavigne Death Hoax Go Viral,1,1,13,45,1,12,0,58,0
Nigeria 'gay wedding' bust leads to charges,1,3,1,34,2,6,0,35,0
"In dark times, this image has a glorious message – resistance is not futile",1,3,1,59,2,13,0,60,0
In Defense Of Going Out,1,1,5,14,0,4,0,19,0
Which Hollywood Couple Should Adopt You Based On Your First Initial,1,1,11,46,0,10,0,57,0
"What's The Unluckiest, Weirdest Or Stupidest Way You've Failed Your Driving Test",1,1,12,54,3,11,0,66,0
"What’s Making Britons Grumpy? Voting, Voting, Then Voting Again",1,3,9,42,4,8,0,51,0
21 Things That Will Give Early 2000s Tweens Severe Flashbacks,1,1,8,38,0,9,6,46,0
Mysterious metallic sound in the Mariana Trench finally identified,1,3,3,55,0,8,0,58,0
22 Adorable Dog Collars Every Dog Owner Needs,1,1,7,29,0,7,2,36,0
The Problem With Caitlyn Jenner Is Bigger Than Beauty Standards,1,1,10,44,0,9,0,54,0
Has being a stay-at-home dad affected your career? Share your stories,1,3,2,54,3,10,0,56,0
Student Claims He Was Suspended for Challenging Muslim Professor’s Teaching That Jesus Wasn’t Crucified,1,3,13,75,2,13,0,88,0
20 Vintage Photos That Capture Black College Student Life In The 1940s,1,1,10,43,0,11,6,53,0
"The Leftovers creator begs critics not to binge season 3, they do so anyway: 'It's too good not to'",1,2,3,72,5,18,1,75,0
29 Places To Shop For Your Wedding Online That You'll Wish You Knew About Sooner,1,1,14,49,1,14,2,63,0
26 Fantastic Gifts For The Gamer In Your Life,1,1,8,27,0,8,2,35,0
16 Texts That Are Just Too Miami,1,1,6,18,0,6,2,24,0
This Puzzle Is For Everyone Who's Obsessed With Animated Movies,1,1,10,43,1,9,0,53,0
New Zealand river becomes first in world to be given legal status of a person,1,3,2,61,0,14,0,63,0
17 Useful Wedding Cheat Sheets For Any Bride-To-Be,1,1,9,30,2,7,2,39,0
Amazon's Echo May Be Too Difficult And Time-Consuming For Many,1,3,11,40,2,9,0,51,0
15 Things We Have In 2015 That We Didn't Have Five Years Ago,1,1,11,30,1,12,6,41,0
Everybody Watching The GOP Debates Made The Same CNN Plane Joke,1,1,15,38,0,10,0,53,0
19 Photos That Make Absolutely No Sense,1,1,6,25,0,6,2,31,0
"BuzzFeed's ""Another Round"" Podcast Has A Newsletter And You Should Sign Up",1,1,13,47,3,11,0,60,0
"Miley Cyrus’ Next Album Is Going To Be Weird, Y’all",1,2,10,29,3,9,0,39,0
12 Bouquets For Brides Who Don't Give A Fuck,1,1,8,25,1,8,2,33,0
This Kid And Her Dad Teaching Their Dog How To Howl Is So Adorable,1,1,14,39,0,13,0,53,0
Hell f*cking yes Verizon's new unlimited data plan is a good deal,1,3,2,50,2,11,0,52,0
Sorry Everyone But Jack Dawson Was Actually The Worst,1,1,9,36,0,8,0,45,0
25 Industrial Decor Ideas That Rock,1,1,5,23,0,5,2,28,0
How to find out if someone has been stalking you on Facebook The list,1,3,3,53,0,13,0,56,0
19 Things Only True Carb Lovers Will Understand,1,1,7,31,0,7,2,38,0
BBC Trending,1,3,4,7,0,1,0,11,0
Third man arrested in connection to alleged Pamela Geller beheading plot,1,2,3,59,0,10,0,62,0
We Know Your Vice Based On These Three Questions,1,1,9,31,0,8,0,40,0
The 37 Most Important Puppy Pictures Of 2015,1,1,6,25,0,7,6,31,0
"This Boston Man Yelling At A ""Sea Monstah"" Is The Best Thing You'll See Today",1,1,15,45,3,14,0,60,0
15 Invisible Things You Definitely Missed At The 2nd GOP Debate,1,1,11,39,0,10,3,50,0
Rosie O’Donnell Urges Melania Trump: ‘Divorce’ Donald and ‘Flee’,1,3,9,41,6,8,0,50,0
Hidden treasures: Why Chinese ceramics sell for millions,1,3,3,45,1,7,0,48,0
The Academy Awards: Best picture nominees in 30 seconds,1,2,4,40,1,8,2,44,0
23 Things Only Super-Organised People Will Understand,1,1,7,37,1,6,2,44,0
13 Reasons Malia Obama Needs To Attend An HBCU,1,1,11,25,0,8,2,36,0
Assaults on Border Patrol Agents Up 143 Percent,1,3,6,31,0,7,3,37,0
31 annoying words and phrases on your rÃ©sumÃ© that make hiring managers cringe,1,3,2,61,2,12,2,63,0
17 Things You Need To Know About Cutting Calories To Lose Weight,1,1,11,40,0,11,2,51,0
Are You More Hilary Duff Or Hillary Clinton,1,1,8,28,0,7,0,36,0
"G-7 Leaders Grapple With Stronger Action Against Russia, Islamic State",1,2,10,48,2,9,1,58,0
This former Wall Streeter is now a Master Sommelier â here's her advice for great-tasting wine,1,3,5,72,4,15,0,77,0
"Australia has the capacity to ride the wave, should a financial crisis make its way to our shores",1,3,1,78,1,17,0,79,0
19 Lies You Actually Believed As A Teen,1,3,7,23,0,7,2,30,0
Here's What Halloween Costume You Should Wear Based On Your Job,1,1,11,41,1,10,0,52,0
"The Mash-Up Of Boston Guys Seeing A Fish And ""The Heart Of The Sea""",1,1,15,36,3,13,0,51,0
"Donald Trump just went on a Twitter rant that was bizarre, even for him The list",1,3,4,60,1,15,0,64,0
"75 Thoughts I Had While Watching ""Star Wars: The Force Awakens""",1,1,10,38,3,10,2,48,0
"Nixon Tried to Spoil Johnson’s Vietnam Peace Talks in ’68, Notes Show ",1,2,9,44,3,12,2,53,0
What's The Weirdest Question You've Ever Googled,1,1,7,33,2,6,0,40,0
Which Stylish TV Lady's Wardrobe Should You Raid,1,1,9,31,1,7,0,40,0
Little boy has adorably sweary reaction to trying out VR,1,3,3,44,0,9,0,47,0
The Best Oscars Dresses That You’ve Probably Never Seen [Video],1,3,10,41,3,9,0,51,0
"81 Thoughts I Had During The ""American Horror Story: Hotel"" Premiere",1,1,10,43,3,10,2,53,0
"For Everyone Who Has A Lot Of Feelings About The ""Hey Arnold"" Christmas Special",1,1,14,50,2,13,0,64,0
Donald Trump Just Accidentally Tweeted A Picture Of Jeremy Corbyn And The Internet Lost It,1,1,15,61,0,14,0,76,0
"Fed hikes rates, sees 3 more rate hikes in 2017",1,3,1,31,1,9,5,32,0
Stop Everything And Slay Your Friends With This Ultimate Cheese On Toast,1,1,12,49,0,11,0,61,0
Fast and Furious 8 trailer: The Fate of the Furious looks totally bananas,1,3,5,54,1,12,1,59,0
16 Underrated Lingerie Brands That Aren't Victoria's Secret,1,1,7,41,2,7,2,48,0
Men Admit Their Feelings Of Loneliness,1,1,6,27,0,5,0,33,0
Cheese porn alert! The 10 best things to do with cheese,1,3,2,40,1,10,2,42,0
"‘The Affair’ Season 3, Episode 4: Is Alison O.K.? ",1,3,8,24,7,9,2,32,0
21 Photos That Prove Anyone Can Rock A Pair Of Duck Boots,1,1,11,33,0,11,2,44,0
29 Perfect Gifts For Ginthusiasts,1,1,4,23,0,4,2,27,0
This 3 Minute Christmas Hallmark Movie Is Hilarious,1,1,7,36,0,7,1,43,0
What to Expect in U.K. Markets When May Pulls Brexit Trigger,1,2,10,38,2,10,0,48,0
"This Couple Shares Their House With A ""Unicorn"" And It's Beyond Adorable",1,1,12,46,3,11,0,58,0
Why George Osborne is itching to sell RBS,1,2,6,28,0,7,0,34,0
This Man Went Abroad And Brought Back A Disease U.S. Doctors Had Never Seen,1,2,15,45,2,13,0,60,0
Michael Moore reveals plans for major protest at Donald Trump inauguration,1,3,4,60,0,10,0,64,0
We Know If You're A Virgin Based On A Single Question,1,1,11,31,1,10,0,42,0
Rod Carew's transplanted heart donated from ex-Ravens TE Konrad Reuland,1,3,7,53,2,9,0,60,0
19 Thanksgiving Foods To Make If You Haven't Started Planning Yet,1,1,10,42,1,10,2,52,0
Should You Get An Oscar Or Oscar Isaac,1,1,8,23,0,7,0,31,0
Brad Pitt didn’t attend the Oscars because he was busy sculpting,1,3,3,50,1,10,0,53,0
18 Cats Who Are Proving They Are Liquids,1,1,7,24,0,7,2,31,0
Helen Mirren Just Slaughtered Your Faves With One Iconic Pose,1,1,10,42,0,9,0,52,0
These Couples Tried Sensual Yoga And Things Got Steamy,1,1,9,37,0,8,0,46,0
26 Lazy But Brilliant Ways To Get Drunk,1,1,7,23,0,7,2,30,0
Pen power: China closer to ballpoint success,1,3,2,35,1,6,0,37,0
Western Sahara: Kitesurfing in the Dakhla danger zone,1,3,4,41,1,7,0,45,0
The Donald Trump Vs. Bernie Sanders Debate You Might Not Ever Get To See,1,1,14,44,1,13,0,58,0
22 Heroes Who Don't Wear Capes,1,1,5,17,1,5,2,22,0
A map of the countries that eat the most meat The list,1,2,2,41,0,11,0,43,0
"Goodbye, America's Next Top Model",1,1,5,22,2,4,0,27,0
Ashley Judd: Trump’s Election Victory Worse than Being Raped,1,3,8,42,2,8,0,50,0
"11 Times Abby Sciuto Was The Fashion Icon Of ""NCIS""",1,1,12,26,2,9,2,38,0
10 Artists to Watch in 2017,1,2,2,14,0,5,6,16,0
How Much Of A Halloween Fan Are You Actually,1,1,9,27,0,8,0,36,0
What Does Your Choice Of Spiral Say About You,1,1,9,28,0,8,0,37,0
The 25 Most GIF-Worthy Moments Of The 2015 Blue Jays Season,1,1,12,30,1,10,6,42,0
Can You Guess Which Celeb Made This Art,1,1,8,24,0,7,0,32,0
Do You Eat These Things In One Or Two Bites?,1,3,10,24,1,9,0,34,0
欢迎来到义乌：中国的多元文化试验田,1,3,0,0,1,0,0,16,0
The Drunkest People At The Golden Globes,1,3,7,27,0,6,0,34,0
12 Easy DIYs That Will Make You Fair And Lovely,1,1,11,25,0,9,2,36,0
An anti-Muslim slur on their wall made this family think of leaving the U.S. Then neighbors came to their aid.,1,3,5,82,4,19,0,87,0
If Tampon Instructions Were Actually Helpful,1,1,6,33,0,5,0,39,0
'Dangal' Girls Fatima And Sanya's Dancing Videos Will Give You A Glimpse Of Their Crazy Side!,1,2,16,58,4,15,0,74,0
"We Asked Couples Try Each Other's Hobbies And It Was Pretty, Pretty Cute",1,1,13,45,2,12,0,58,0
Women Discuss When You Should Define The Relationship,1,1,8,38,0,7,0,46,0
Grant Gustin Does What No Else Has Done Before By Looking Hot In A Beanie,1,1,15,44,0,14,0,59,0
America’s Best States to Live In,1,2,5,21,1,5,0,26,0
"13 People They Should Cast In The New All-Female ""Ocean's Eleven""",1,1,11,38,4,10,2,49,0
How Republics End ,1,2,3,12,0,3,0,15,0
21 Times Roseanne Conner Was Basically All Of Us,1,1,8,30,0,8,2,38,0
Here Are The Politicians Planning To Skip Donald Trump’s Inauguration,1,3,10,49,1,9,0,59,0
"You Might Want To Rethink That Juice Cleanse, Because Science",1,1,10,41,1,9,0,51,0
21 Tumblr Posts That Are Way Too Real For All Uni Students,1,1,11,34,0,11,2,45,0
Drexel University Professor’s Christmas Wish: ‘All I Want for Christmas is White Genocide’,1,3,11,63,4,12,0,74,0
"Welp, There Goes Bethenny Frankel With Neon Red Hair",1,1,9,34,1,8,0,43,0
"How Well Do You Remember Missy Elliot's Rap In ""1, 2 Step""",1,1,10,31,4,11,2,41,0
70 Classic Black Films Everyone Should See At Least Once,1,1,9,36,0,9,2,45,0
22 Questions For The Monsters Who Don't Like Dogs,1,1,8,30,1,8,2,38,0
Man Makes 'Crying Jordan' Uniform for Softball Team,1,3,7,35,2,7,0,42,0
Tesla has finally begun producing batteries at its massive Gigafactory,1,2,2,59,0,9,0,61,0
23 Gifts For The Clean Freak In Your Life,1,1,8,23,0,8,2,31,0
Mad Libs: Can You Woo Your Crush With This Love Poem,1,1,11,30,1,10,0,41,0
Hillary Clinton's gut-wrenching day,1,3,2,28,2,3,0,30,0
KNOW IT ALL: Thursday’s Top 7 Stories at NBC News,1,3,16,21,2,9,1,37,0
Which Female '90s TV Character Was A Total Role Model,1,1,10,31,1,9,2,41,0
19 Times Sasha And Malia Were The Flyest Kids In White House History,1,1,12,42,0,12,2,54,0
How Many Of The Most Iconic Songs Of All Time Have You Heard,1,1,13,35,0,12,0,48,0
10 DIY Projects We Totally Failed At In 2015,1,1,9,21,0,8,6,30,0
Which Celebrity Shares Your Height,1,1,5,25,0,4,0,30,0
Recovering Addicts Talk About The Stigmas Surrounding Addiction,1,1,8,48,0,7,0,56,0
The Highest-Paid Athlete In 2016 From Every State,1,2,8,29,1,7,4,37,0
This Is What To Do If Someone's Tickling You,1,1,9,26,1,8,0,35,0
Elle Fanning Says Bryan Cranston Is As Amazing As We All Think He Is,1,1,14,41,0,13,0,55,0
Kendall Jenner And Gigi Hadid Are No Longer Kind Of Almost Related,1,1,12,43,0,11,0,55,0
Cars fall into Los Angeles sinkhole,1,3,3,27,0,5,0,30,0
"Great British Bake Off finalist Andrew Smyth on Channel 4, male bakers and the secret to creative cakes",1,3,7,77,1,17,1,84,0
Family night! See the nominees who brought a relative to the Oscars,1,3,3,52,1,11,0,55,0
18 Major Scandals in Obama’s ‘Scandal-Free’ Presidency,1,2,6,36,4,6,2,42,0
DVLA website struggles with new rules on hiring a car,1,3,4,40,0,9,0,44,0
When You Don't Want To Go To Therapy,1,1,8,20,1,7,0,28,0
23 Heartbreaking And Hilarious Things People Wish They Could Say To Their Bully,1,1,12,53,0,12,2,65,0
Fix an iPhone Cable the Stylish Way—With Electrical Tape,1,3,8,39,1,8,0,47,0
Here's how much millionaires would save under GOP Obamacare repeal bill,1,2,5,55,1,10,0,60,0
16 Charts That Perfectly Illustrate Filipino Twentysomething Life,1,1,7,49,0,7,2,56,0
Britney Spears' Top 10 Deep Cuts: Her Best Songs That Were Never Singles,1,3,12,44,2,12,2,56,0
"15 Valentine's Day Gifts For People Who Love The ""Making A Murderer"" Attorneys",1,1,12,49,3,12,2,61,0
Laura Ingraham: Left Pushing Protests in Hopes of a ‘Powder Keg Moment’,1,3,9,48,3,11,0,57,0
Signs You And Your BFF Are Practically Married,1,1,10,29,0,7,0,39,0
Which Pop Anthem Matches Your Birth Month,1,1,7,28,0,6,0,35,0
Here's A Weeknight Pasta That You Can Make In 20 Minutes,1,1,10,33,1,10,2,43,0
"Best Christmas movies on Netflix, including Die Hard and Home Alone",1,2,7,49,1,10,0,56,0
This One Question Will Tell You If You're A Real Woman,1,1,11,32,1,10,0,43,0
Meet The Inspiring Plus-Size Pole Dancer,1,1,7,27,1,5,0,34,0
What Worker Burnout Feels Like,1,3,5,21,0,4,0,26,0
21 Savage Kourtney Kardashian Burns We Still Haven’t Recovered From,1,3,9,46,1,9,2,55,0
What's The Best Fast Food Burger In America,1,1,8,27,1,7,0,35,0
Malta's Azure Window rock formation collapses into the sea,1,3,3,46,1,8,0,49,0
17 Incredible Yurt Getaways For When You Need Some Chill Vibes,1,1,10,40,0,10,2,50,0
"This College Marching Band Just Shut It Down With Their Amazing ""Hello"" Cover",1,1,13,50,2,12,0,63,0
Trump wasn’t happy with his State Department finalists. Then he heard a new name.,1,3,4,61,3,13,0,65,0
Here's What Happens When You Mix Beer And Mac And Cheese,1,1,11,34,1,10,0,45,0
"A Gallery of Miss Golden Globe: Looking Back at the Famous, the Obscure, and the Misters",1,2,10,60,3,15,0,70,0
"Trump Ordered Syria Attack, then Ate Dinner with Chinese President",1,2,8,48,1,9,0,56,0
"Aretha Franklin Performing ""A Natural Woman"" For Carole King Will Leave You Speechless",1,1,13,59,2,12,0,72,0
How Much Of A Grammar Perfectionist Are You,1,1,8,28,0,7,0,36,0
"Pooja Bhatt, Nucleya, Atul Kasbekar, Shane & Falguni Peacock Came Together To Create This Funky Music Video",1,3,16,71,4,16,0,87,0
"13 ""Hamilton"" Horoscopes From Tumblr You Didn't Know You Needed",1,1,9,40,3,9,2,49,0
This Adorable Polar Bear Cub Sleeping Is All Of Us In The Morning,1,1,13,40,0,12,0,53,0
How The Rock went from failed football player to the highest-paid actor in Hollywood,1,2,4,66,1,13,0,70,0
Here's How To Do Your Makeup So It Looks Incredible In Pictures,1,1,12,39,1,11,0,51,0
12 Charts That Speak To Anyone That Stays Up Too Late,1,1,10,31,0,10,2,41,0
"Marv From ""Home Alone"" Is Sharing Behind-The-Scenes Facts On Facebook",1,1,12,44,4,9,0,56,0
People Who Don't Swear,1,1,4,14,1,3,0,18,0
51 Clothing Organization Tips That Are Downright Life-Changing,1,1,8,44,1,7,2,52,0
17 Hilarious Tumblr Posts For Everyone Who Is So Done With School,1,3,11,41,0,11,2,52,0
"7 Responses To Being Asked ""When Are You Having Kids?""",1,1,9,32,3,9,1,41,0
Kids Explaining What Love Is Will Make You Laugh And Then Cry,1,1,12,38,0,11,0,50,0
This Adorable And Friendly Quokka Can't Get Enough Of The Man Who Took A Selfie With Him,1,2,17,54,1,16,0,71,0
Here Are The Bronzers And Blushes That Actually Look Amazing On Women Of Color,1,1,14,51,0,13,0,65,0
A Little Girl Asked Her Mom To Be Friends With Her Dad And It Will Melt Your Heart,1,1,18,47,0,17,0,65,0
CITI: These '12 Charts of Christmas' tell us a lot about what to expect in 2017,1,3,7,48,3,15,6,55,0
Trevor Noah: One thing Donald Trump is honest about is his lies,1,3,5,46,1,11,0,51,0
Canada's Project Naming: Identifying the unidentified,1,3,4,42,2,5,0,46,0
22 Completely Bizarre Parts People Had In School Nativity Plays,1,1,9,43,0,9,2,52,0
Reasons to vote for Democrats tops Amazon bestseller list,1,3,3,46,0,8,0,49,0
Mulder And Scully Might Be Kissing In The First 'X-Files' Set Photos,1,3,13,41,3,11,0,54,0
What Celebrity Should You Kiss Under The Mistletoe Based On Your Zodiac,1,1,12,48,0,11,0,60,0
19 Mother And Daughter Tattoos That Are Goals AF,1,3,9,29,0,8,2,38,0
Why I joined the trans protest against Woman's Hour's Jenni Murray,1,3,6,48,2,10,0,54,0
Trader Joe's Parking,1,1,3,14,1,2,0,17,0
A Surefire 59-Step Plan To Avoid Star Wars Spoilers,1,1,9,31,1,8,2,40,0
23 Dogs Who've Out-Dogged Themselves,1,1,5,23,2,4,2,28,0
51 Modern Black Films Everyone Should See At Least Once,1,1,9,35,0,9,2,44,0
"A Full Breakdown Of The Long Feud Involving Amber Rose, Kanye West, And The Kardashians",1,1,15,56,2,14,0,71,0
This adorable little girl is all of us trying to remember how old we are,1,3,1,57,0,14,0,58,0
Jesus May Not Have Walked Jerusalem’s Via Dolorosa: Scholars,1,2,9,41,2,8,0,50,0
White House Official: Trump Seeking to ‘Reboot’ Egypt Relationship with al-Sisi Visit,1,2,10,60,4,11,0,70,0
It's not all doom and gloom: Funeral director reveals most jaw-dropping moments from his career,1,3,2,76,3,14,0,78,0
Are Your Hook Up Habits Like Everyone Else's,1,1,8,28,1,7,0,36,0
"Did Anyone Else Notice Visible Penis In ""The Martian""",1,1,9,34,2,8,0,43,0
Why do teachers leave?,1,3,1,17,1,3,0,18,0
"How Well Do You Remember ""I Put A Spell On You"" From ""Hocus Pocus""",1,1,14,35,4,13,0,49,0
"Let President Obama have a cigarette, already",1,3,3,35,1,6,0,38,0
Scientists have apparently discovered what makes the perfect breasts The list,1,3,2,65,0,10,0,67,0
"Goku From ""Dragon Ball Z"" Destroys ""Street Fighter II"" Characters In This Awesome Video",1,1,15,55,4,13,0,70,0
"Nets to sit 6 against Bulls, who can make playoffs with victory",1,3,2,48,1,11,1,50,0
7 infamous deleted scenes that cost movie studios millions,1,2,0,49,0,8,1,49,0
The New Yorker Released The Perfect Cartoon In Tribute Of Alan Rickman,1,1,12,47,0,11,0,59,0
Let's Blaze: How stoners found a dope livestreaming home,1,3,3,43,2,8,0,46,0
"The New Trailer For ""X-Men: Apocalypse"" Is Honestly Next-Level Insane",1,1,12,43,5,9,0,55,0
Was John Krasinski Hotter Before He Got Ripped,1,1,8,31,0,7,0,39,0
13 useless things to stop wasting your money on,1,2,0,37,0,8,2,37,0
"How Well Do You Remember The Lyrics To ""Gettin' Jiggy Wit It"" By Will Smith",1,1,15,43,3,14,0,58,0
"Inauguration by the numbers: Rockettes, White House records and weed [Video]",1,3,5,57,4,10,0,62,0
Are These Foods Yum Or Yuck,1,1,6,16,0,5,0,22,0
Nico Rosberg stuns Formula One with retirement bombshell,1,3,4,45,0,7,0,49,0
'Their childhoods shouldn't be owned': readers on children and social media,1,3,1,60,4,10,0,61,0
21 Men In Suits Making Us Thirsty As Hell At The BAFTAs,1,1,15,27,0,11,2,42,0
"Rachel Green From ""Friends"" Appeared On ""SNL"" And It Was Everything",1,1,13,40,4,10,0,53,0
Pug Puns That Will Brighten Your Day,1,1,7,23,0,6,0,30,0
"29 Impossibly Stylish Cat Gifts, In Order Of Awesomeness",1,1,8,37,1,8,2,45,0
These Mini Peanut Butter Cheesecakes Are The Epitome Of Food Porn,1,1,11,44,0,10,0,55,0
All The Golden Globe Afterparty Moments You Won't See On TV,1,1,12,36,1,10,0,48,0
New Glitter Roots Hair Trend Has Women Dumping Sparkles Onto Their Heads,1,1,12,49,0,11,0,61,0
19 Easy Hot Lunch Ideas That Will Warm Up Your Freezing Office,1,1,11,38,0,11,2,49,0
The Luxury in Tom Ford’s Nocturnal Animals Will Terrify and Seduce You,1,2,10,48,1,11,0,58,0
"Tiffany ""New York"" Pollard's Reaction To David Bowie's Passing Is... One Of A Kind",1,1,14,48,7,13,0,62,0
Donald Trump Thinks Susan Rice Committed a Crime,1,3,7,34,0,7,0,41,0
Here Are The Tweets Twitter Users Found Funniest This Year,1,1,10,39,0,9,0,49,0
"Dear Men Of America, It's Too Cold To Wear Shorts",1,1,10,28,2,9,0,38,0
"20 Pups Celebrating ""National Puppy Day"" Because They Know You Need This Right Now",1,3,13,52,2,13,2,65,0
What Your Favorite Thanksgiving Food Says About You,1,1,8,36,0,7,0,44,0
This Goldendoodle Won Halloween,1,1,4,24,0,3,0,28,0
19 Things Girls Too Lazy For A Beauty Routine Know To Be True,1,1,12,35,0,12,2,47,0
14 Truths Anyone Who Fastens Their Bra In The Front Will Agree With,1,3,12,41,0,12,2,53,0
This Dad Got His Daughter A Rainbow Umbrella For The Most Heartfelt Reason,1,3,13,49,0,12,0,62,0
"This Artist Claims Taylor Swift Stole Her Artwork To Promote ""1989""",1,1,10,41,2,10,4,51,0
Justin Trudeau Personally Welcomed A Plane Full Of Refugees To Canada,1,1,11,48,0,10,0,59,0
Five Signs You Work For A Weak Manager,1,3,8,23,0,7,0,31,0
23 Times Tumblr Kept It Real About Mental Health,1,1,8,30,0,8,2,38,0
Why Now Is The Best Time Ever To Become A Freelancer,1,3,11,31,0,10,0,42,0
What's The Best Last-Minute Halloween Costume You've Ever Had,1,1,10,40,3,8,0,50,0
Only Someone Obsessed With Christmas Movies Can Pass This Quiz,1,3,10,43,0,9,0,53,0
"Stop What You're Doing And Listen To This ""Golden Girls"" Remix",1,1,11,38,3,10,0,49,0
"Alanis Morissette Updated The ""Ironic"" Lyrics With Modern Struggles And It's Hilarious",1,1,12,60,3,11,0,72,0
Fall In L.A. Vs. Fall Everywhere Else,1,1,8,20,3,6,0,28,0
What Is Your Penis Horror Story,1,1,6,20,0,5,0,26,0
What It's Like Being Jewish During Christmas,1,1,7,30,1,6,0,37,0
Women Try To Put On Lipstick With A Selfie Stick,1,1,10,29,0,9,0,39,0
Here Are All Of The Reasons Why You're Wrong If You Don't Think Little Mix Are Everything,1,1,17,54,2,16,0,71,0
"Which ""Percy Jackson"" Demigod Are You",1,1,6,24,2,5,0,30,0
18 Struggles Everyone With A Cat's Name Has To Go Through,1,1,10,34,1,10,2,44,0
"Your Weekly Gossip Roundup: Jon Hamm Splits With Jennifer Westfeldt, Chris Hardwick Gets Engaged, And More",1,1,16,72,3,15,0,88,0
Our Articles on the Attacks Trump Says the Media Didn’t Cover ,1,3,8,42,1,11,0,50,0
15 Words That Mean Something Completely Different At Tim Hortons,1,1,9,44,0,9,2,53,0
If Chanel Oberlin Quotes Were Motivational Posters,1,1,7,37,0,6,0,44,0
"Here's An Eye-Opening Reminder From J.K. Rowling That You're Probably Saying ""Voldemort"" Wrong",1,1,15,60,7,12,0,75,0
Can You Pick The Right Roommate,1,1,6,20,0,5,0,26,0
Your birth month may predict your risk for certain diseases ,1,3,1,49,0,10,0,50,0
'Dangal' Girls Fatima And Sanya's Dancing Videos Will Give You A Glimpse Of Their Crazy Side!,1,3,16,58,4,15,0,74,0
"If Your Childhood Idols Were Mary-Kate And Ashley Olsen, This One's For You",1,3,14,46,3,12,0,60,0
Russell Westbrook Dodges Questions About Kevin Durant in a Hilarious Way,1,2,9,53,0,10,0,62,0
Suicide Terrorism Across the Globe Hits Record High in 2016,1,3,7,39,0,9,4,46,0
27 Easy Meals That Won't Break The Bank,1,1,7,22,1,7,2,29,0
Can You Guess The Early '00s Song From The Lyric,1,1,9,27,1,9,2,36,0
"SLB Issues An Official Statement, Swami Om Reaches Bigg Boss Finale Venue & More From Ent",1,3,17,55,2,15,0,72,0
Texas teacher suspended over anti-Trump stunt,1,3,2,37,1,5,0,39,0
Supermodels Gigi and Bella Hadid Protest Trump’s Immigration Order in NYC,1,3,11,51,1,10,0,62,0
So The (Basically) Official Arthur Twitter Just Called Out John Legend,1,3,11,47,2,10,0,58,0
"What Is Your All-Time Favorite Jim And Dwight Prank On ""The Office""",1,1,13,40,3,11,0,53,0
"Which Hogwarts Houses Do The ""PLL"" Characters Belong In",1,1,11,34,2,8,0,45,0
Tablet Reveals the 25 Coolest Hotels in the World,1,2,5,34,0,8,2,39,0
5 Easy Halloween Costumes You Can Make From An Old Bridesmaid Dress,1,1,11,44,0,11,1,55,0
We Know Which Celebrity You Hate The Most,1,1,8,26,0,7,0,34,0
23 Super Cute Contact Paper DIYs To Transform Your Home,1,1,11,33,0,9,2,44,0
18 Moments Absolutely Everyone's Experienced In Class,1,1,6,38,1,6,2,44,0
29 Of The Most Insane Traffic Jams In The World,1,1,9,27,0,9,2,36,0
Boil Christmas veg? Don't sprout nonsense,1,3,3,31,2,5,0,34,0
12 Artists We Can't Wait to See at Coachella,1,2,6,27,1,8,2,33,0
"‘Rogue One: A Star Wars Story,’ ‘Sing’ Dominate Christmas Box Office",1,2,11,41,6,10,0,52,0
Eddie Redmayne Is Going To Be A Dad And We Couldn't Be Happier,1,1,13,36,1,12,0,49,0
British People Try American Candy For The First Time,1,1,9,35,0,8,0,44,0
17 Songs That Will Make Your Workout Merry AF,1,1,9,26,0,8,2,35,0
How Full Of Crap Is Your House,1,1,7,17,0,6,0,24,0
I Returned To My Childhood Mall And Found A Nightmare,1,1,10,34,0,9,0,44,0
Meryl Streep Uses Lifetime Achievement Award Speech to Bash Donald Trump,1,2,10,52,0,10,0,62,0
17 Dads Who Are Dad AF,1,1,6,9,0,5,2,15,0
This Sephora Minnie Mouse Collection Is Every Disney Lover's Dream Come True,1,1,12,52,1,11,0,64,0
Facebook Suspends YouTuber for Disliking ‘Transgender Mother’ Commercial,1,3,8,55,2,7,0,63,0
Inside The Design Of The World's Most Beautiful Tiny House,1,3,10,38,1,9,0,48,0
"237 Different Ways To Spell ""Caitlin""",1,1,5,22,2,5,3,27,0
What's The Worst Christmas Gift You've Ever Received,1,1,8,35,2,7,0,43,0
9 Questions That'll Help You Find Your Dream Career,1,2,8,33,1,8,1,41,0
What's The Best Grilled Cheese Shop You've Ever Eaten At,1,1,10,35,2,9,0,45,0
How the Humble Taco Inspired a $750 Mexican Meal,1,2,6,30,1,8,3,36,0
Can You Match The Iconic Hat To Its TV Show Or Film,1,1,13,27,0,11,0,40,0
10 things you need to know before the opening bell,1,3,0,39,0,9,2,39,0
We Know Which 2015 Album Best Represents Your Year Based On One Question,1,1,12,44,0,12,4,56,0
44 Of The Most Breathtaking Shots In Michael Mann Movies,1,1,9,36,0,9,2,45,0
Can You Find The Political Conspiracy Hidden In This Crossword,1,1,10,43,0,9,0,53,0
Stolen baby found alive in South Carolina 18 years on,1,3,3,39,0,9,2,42,0
19 Questions You Have As A Brit Visiting America,1,1,8,30,0,8,2,38,0
Watch Carlos Vives' New Music Video 'Al Filo de tu Amor',1,3,9,34,3,10,0,43,0
17 jobs Amy Schumer does better than you,1,2,2,29,0,7,2,31,0
17 Pictures Everyone Who's Slightly Obsessed With Tea Will Understand,1,1,9,48,1,9,2,57,0
"After Threatening To Disclose Big Names, Gujrat Man Who Declared 14K Cr Goes Cold Turkey!",1,3,15,56,2,14,2,71,0
Very Helpful Study Reveals Countries Where Men Lie the Most About Dick Size,1,3,12,51,0,12,0,63,0
21 Texts Everyone Who Is Anxious Has Definitely Sent,1,1,8,34,0,8,2,42,0
21 Pictures Which Perfectly Capture Why Mumbai Is The City Of Love,1,1,11,42,0,11,2,53,0
National Signing Day 2017: 10 Biggest Takeaways,1,2,5,29,1,6,6,34,0
What to expect from E3 2015,1,3,2,15,0,5,5,17,0
"19 Hilarious Tweets About ""The Hunger Games""",1,1,6,28,2,6,2,34,0
16 numbers that perfectly captured 2016,1,3,0,28,0,5,6,28,0
Appeals Court Judges Explain Why Donald Trump’s Immigration Order is Legal,1,2,10,53,1,10,0,63,0
18 Products On Sale For Over 30% Off You Should Totally Buy If You Love To Sparkle,1,1,15,46,1,16,4,61,0
Here's What Your Teenage Emo Heartthrobs Look Like Now,1,1,9,36,1,8,0,45,0
Which Couple From A Famous Musical Matches Your Love Life,1,1,10,38,0,9,0,48,0
How Do You Tell Someone You're Just Not Into Them? With These 8 Subtle Hints,1,3,14,45,2,14,1,59,0
A Good Samaritan Gave The Shirt Off His Back To A Cold And Shivering Stranger,1,1,15,48,0,14,0,63,0
Hook Is Actually A Very Messed Up Movie,1,1,8,24,0,7,0,32,0
Can You Kiss The Right Guy On New Year's Eve,1,1,10,24,1,9,0,34,0
Table Tennis Players Engage in Epic 10-Minute Rally,1,3,7,34,1,7,2,41,0
Will You Look At Water The Same Way After Watching This,1,1,11,34,0,10,0,45,0
7 FinTech Companies Helping Millennials Dominate Their Finances This Year,1,2,10,53,0,9,1,63,0
People Are Going Nuts Trying To Find The Hidden Panda In This Photo,1,1,13,42,0,12,0,55,0
This Clever Artist Makes Hilarious Collages With His Dogs,1,1,9,40,0,8,0,49,0
Here's JPMorgan's pitch to top young talent,1,3,4,31,2,6,0,35,0
Can You Really Work Off a Bad Diet?,1,3,7,20,1,7,0,27,0
"Which ""American Horror Story: Coven"" Witch Should Be Your BFF",1,1,12,37,3,9,0,49,0
18 Times Siri Couldn't Handle Canada,1,1,5,23,1,5,2,28,0
24 Photos That Are Way Too Real For Book Lovers,1,1,9,27,0,9,2,36,0
Big Show: The giant with the six-pack,1,3,3,26,2,6,0,29,0
Woman Snapping Selfies On California's Highest Bridge Falls 60 Feet,1,3,9,46,1,9,2,55,0
"Watch the Full Pre-Credits 'Deadpool 2' Teaser, Courtesy Ryan Reynolds",1,3,9,47,4,9,1,56,0
29 Of The Best Awards Show Moments Of 2015,1,1,7,21,0,8,6,28,0
People Try More Bizarre Food Combinations That Oddly Work,1,1,9,40,0,8,0,49,0
"100 Times The ""Harry Potter"" Movies Were Visually Perfect",1,1,8,36,2,8,3,44,0
15 Reasons Arjun Kapoor Is The Perfect Man,1,1,7,26,0,7,2,33,0
Which T.S. Eliot Poem Are You,1,1,7,15,2,5,0,22,0
16 Things No One Tells You About Taking Antidepressants,1,1,8,37,0,8,2,45,0
How to achieve the 'Oscars look',1,2,2,23,2,5,0,25,0
"Officer Pulls Over Speeding Student, Teaches Him to Tie a Tie ",1,3,9,41,1,11,0,50,0
"Build Your Ideal Breakfast And We'll Tell You If You're More Type A, B, Or C",1,2,16,41,4,15,0,57,0
Ikea wants to put your whole house online. But for goodness' sake why?,1,2,2,53,3,12,0,55,0
Ice Cream Is How Satan Intends To Destroy The World,1,1,10,32,0,9,0,42,0
"Marketers, Creative Ad Execs Adjust to Video Ads With No Sound - CMO Today",1,2,14,45,2,13,0,59,0
The Pros And Cons Of Living In Florida,1,1,8,23,0,7,0,31,0
The One Career Lesson My First Job Taught Me,1,2,9,27,0,8,0,36,0
Show Us Your Colorful Tattoos,1,1,5,20,0,4,0,25,0
Ava DuVernay Would Like To Remind You Diversity Is Not That Hard,1,1,13,40,0,11,0,53,0
The 'digital wellness lady' is on a mission to make you unplug,1,3,1,48,2,11,0,49,0
"This Puppy Version Of The ""Fresh Prince"" Theme Is The Only One That Matters",1,1,14,46,2,13,0,60,0
Some women are striking from smiling today. Here’s why.,1,2,2,42,3,8,0,44,0
"How Well Do You Remember The Halloween Party Episode Of ""Friends""",1,1,11,42,2,10,0,53,0
Are You Compatible With Your Celebrity Crush,1,1,7,31,0,6,0,38,0
When A Little Girl & A Bulldog Become Best Friends,1,1,9,31,1,9,0,40,0
21 Reasons John Boyega Is Human Perfection,1,1,6,28,0,6,2,34,0
How To Find The Safest Used Vehicle You Can Afford For Your Teen,1,3,13,39,0,12,0,52,0
An Expert Take on Performing Under Pressure,1,3,6,31,0,6,0,37,0
When You Miss Your Friend,1,1,5,16,0,4,0,21,0
Which Gangster Movie Bride Are You,1,1,6,23,0,5,0,29,0
AP College Basketball Poll 2017: Complete Week 17 Rankings Released,1,3,9,42,1,9,6,51,0
The Latest: Capitol architect says pig painting breaks rules,1,3,3,48,1,8,0,51,0
Rashida Jones Doesn't Understand Why Half Of Movies Aren't About Women,1,1,11,47,2,10,0,58,0
Pilot Removed From Flight After Bizarre Rant About Divorce and Politics,1,3,10,51,0,10,0,61,0
7 Recipes From Abuelita's Kitchen,1,1,4,23,1,4,1,27,0
"Which ""Scooby-Doo"" Character Are You",1,1,6,23,3,4,0,29,0
The One Way You Should Be Using Nutella,1,1,8,24,0,7,0,32,0
We Know Your Favorite Pop Star Based On Your Favorite Disney Movie,1,1,12,43,0,11,0,55,0
The 16 grossest words in the English language The list,1,2,3,40,0,9,2,43,0
"Kelly Clarkson's ""Game Of Thrones"" Christmas Card Just Snatched The Holiday Throne",1,1,12,56,3,11,0,68,0
"Inside China's Memefacturing Factories, Where The Hottest New Gadgets Are Made",1,1,11,55,2,10,0,66,0
Behind United Airlines’ Fateful Decision to Call Police,1,3,7,40,1,7,0,47,0
EU Chief: Borders Must Stay Open Despite Deadly Terror Attacks,1,2,11,41,1,9,0,52,0
Icy US road pile-up caught on camera,1,3,3,26,1,6,0,29,0
"26 Important Dating Takeaways From ""Master Of None""",1,1,7,33,2,7,2,40,0
WaPo: Trump May ‘Outlast’ White House Press Corps with ‘Unsustainable’ Pace,1,2,11,49,5,10,0,60,0
17 Faces That Perfectly Sum Up Every Black Girl's Transition From Relaxed To Natural Hair,1,1,14,58,1,14,2,72,0
You've Probably Been Applying Sunscreen Wrong Your Entire Life,1,1,9,44,1,8,0,53,0
This Rainbow-Inspired Hummus Is Almost Too Gorgeous To Eat,1,1,10,39,1,8,0,49,0
100 Women 2016: Fighting for a good death,1,3,2,24,1,7,7,26,0
9 artists who reportedly turned down performing at Trump's inauguration,1,2,1,59,1,9,1,60,0
60 Foods That Taste Better When You're High,1,3,7,26,1,7,2,33,0
This Blog Full Of Hairy Ball Landscapes Will Make You Want To Gouge Your Eyes Out (NSFW),1,1,20,50,2,16,0,70,0
Watch People Stop Everything To Save A Baby Elephant In A Well And Cry Happy Tears,1,1,16,51,0,15,0,67,0
"Well actually, this jaw-dropping Steph Curry highlight was an illegal move",1,3,3,59,2,10,0,62,0
Should You Be Allowed To Have A Dog,1,1,8,20,0,7,0,28,0
You Can Now Show You're Really Interested On Tinder By Swiping Up,1,1,12,41,1,11,0,53,0
My boss made me think I was going mad and suffering from maternity paranoia ,1,3,2,60,0,14,0,62,0
"Not Just Air Pollution, Delhi Is Also World No.1 In Noise Pollution + 5 Other Major Reads From Today",1,2,17,60,3,18,2,77,0
15 Things That'll Give Every Tender-Headed Black Girl Instant Flashbacks,1,3,10,49,2,9,2,59,0
This Is The Hardest '90s Alt Rock Music Video Quiz You'll Ever Take,1,1,12,39,2,12,2,51,0
14 Dinner Ideas Reformed Shitty Cooks Swear By,1,3,7,30,0,7,2,37,0
People Read Other People's Heartbreaking Coming Out Letters,1,1,8,43,1,7,0,51,0
Should You Top Or Bottom More In 2016,1,1,7,19,0,7,4,26,0
"This Is What The Cast Of ""St Trinian's"" Look Like Now",1,1,11,29,3,10,0,40,0
If Joey Tribbiani Quotes Were Motivational Posters,1,1,7,37,0,6,0,44,0
Which Adele Song Should You Sob To Tonight,1,1,8,27,0,7,0,35,0
What Brand Of Fast Food Nachos Is Best,1,1,8,23,0,7,0,31,0
FaceApp: Experts have privacy concerns about popular face transformation app,1,2,3,63,1,9,0,66,0
What Piece Of Human Garbage Are You,1,1,7,22,0,6,0,29,0
Five Questions to Ask About Jamón Ibérico,1,3,6,29,0,6,0,35,0
I Survived a Sarin Gas Attack ,1,3,5,19,0,6,0,24,0
"Honestly, Rory Gilmore Sucks",1,2,4,20,1,3,0,24,0
Viola Davis On Finally Playing A ‘Sexualized' Woman,1,3,8,34,2,7,0,42,0
Onward! Hillary Clinton Looks Forward to 2017,1,3,5,29,1,6,4,34,0
Lola the Cat Survives Migrant Crossing to Italy,1,2,6,34,0,7,0,40,0
Rail journeys 10 romantic sleeper trains that still survive,1,3,1,48,0,8,2,49,0
Sharon Osbourne Tweeted Something Really Weird At Shaquille O'Neal,1,1,10,47,1,8,0,57,0
"This 4/20, Catch A Buzz With A Cannabis Cocktail",1,2,8,27,2,8,3,35,0
"Day In The Life: What It's Like To Be A Female Pilot At 40,000 Feet",1,3,14,31,3,14,5,45,0
This Is How Children Reacted To Photos Of Caitlyn Jenner,1,3,10,37,0,9,0,47,0
Here's What Top Professional Models Look Like Without Makeup,1,1,9,42,1,8,0,51,0
Singapore’s Year of Misbehaving Moneymen Puts MAS on High Alert,1,3,10,43,1,9,0,53,0
15 People Who Have Been Personally Victimized By Winter Salt Stains,1,1,10,45,0,10,2,55,0
No way out of the renting gap,1,2,1,22,0,6,0,23,0
Legendary astronaut John Glenn's inspiring life in photos,1,3,3,46,1,7,0,49,0
27 Times Adele Proved She's Actually The Realest Celebrity Of All,1,1,10,42,1,10,2,52,0
The Romanian Photographer Who Documents Beauty Around The World Is Currently Killing It In India,1,1,15,67,0,14,0,82,0
Try Passing This Tricky Grammar Test Eighth Graders Took In 1912,1,3,10,40,0,10,4,50,0
Teen surprised by giant graffiti penis lurking in senior photo,1,3,1,52,0,9,0,53,0
Are You More Like Papyrus Or Sans,1,1,7,20,0,6,0,27,0
34 Memes You'll Only Understand If Cats Rule Everything Around You,1,2,10,43,1,10,2,53,0
Arsene Wenger has made a decision over his Arsenal future: 'You will soon know',1,2,4,59,3,13,0,63,0
What Makes The Investors Bite: The Industries That Get The Most Deals On 'Shark Tank',1,3,15,53,3,14,0,68,0
31 Decadent Apple Desserts That Will Make You Swoon,1,1,8,33,0,8,2,41,0
21 Things All Friends With A Group Chat Will Understand,1,1,9,35,0,9,2,44,0
Can Silicon Valley Cure Diabetes With Low Carbs And High Tech?,1,3,11,40,1,10,0,51,0
"Mother gets cropped out of family photo, has furious response The list",1,3,2,56,1,11,0,58,0
"If ""High School Musical"" Song Titles Were Honest",1,1,8,31,2,7,0,39,0
Everything You Need to Know About How a Supreme Court Nominee Gets Confirmed ,1,2,11,53,0,13,0,64,0
This Shape Test Will Determine Your Best Quality,1,1,8,33,0,7,0,41,0
When A Celebrity Photographer Turns His Lens To Homeless People,1,1,10,44,0,9,0,54,0
24 Euphoric Experiences For Anyone Who Is Slightly Obsessed With Cooking,1,1,10,50,0,10,2,60,0
A full guide to every team in the 2017 NCAA tournament,1,3,5,35,0,10,4,40,0
Trump’s Approval Ratings Jump to 50 Percent,1,2,5,29,1,6,2,34,0
This Caption On Lindsay Lohan's Instagram Is Amazing And Completely Mind Boggling,1,1,12,57,1,11,0,69,0
How Chill Would You Be In Freaky Situations,1,1,8,28,0,7,0,36,0
This Guy Proposed To His High School Sweetheart On Her Last Day Of Chemo,1,3,14,45,0,13,0,59,0
"Hillary Clinton's Hard Choice: Her First Instagram Post - First Draft. Political News, Now. ",1,2,13,59,6,14,0,72,0
"In dramatic testimony, witness describes Pa. trooper's dying moments after ambush",1,3,2,66,3,10,0,68,0
‘I enjoyed the whole absurdity of it': Paleontologists review ‘Jurassic World.’,1,3,4,59,6,10,0,63,0
Natalie Portman Looks Exactly Like Jackie Kennedy In Her New Biopic,1,1,11,46,0,10,0,57,0
"89 Of Most Enchanting ""1989"" Covers",1,1,4,18,2,5,6,22,0
The 19 Best Nonfiction Books Of 2015,1,1,5,19,0,6,6,24,0
Ten Simple Habits That Will Get You Promoted,1,3,8,29,0,7,0,37,0
13 Of The Most Disturbing Pictures You'll Ever See,1,1,8,31,1,8,2,39,0
We Know Your Zodiac Sign Based On Which Image Of Ben Wyatt You Choose,1,1,14,42,0,13,0,56,0
6 low-sweat exercises to beat the summer heat,1,3,0,36,1,7,1,36,0
17 Photos That Prove The Only Person You Need Is Yourself,1,1,10,35,0,10,2,45,0
This Mumbai Musician's New Song Will Be Your New Favourite Jam,1,1,11,40,1,10,0,51,0
20 Things You'll Understand If You've Ever Had Anal Sex,1,1,9,33,2,9,2,42,0
"Washington Post: Paul Ryan Allies ‘Alarmed, Angered’ by 25-Year-Old Julia Hahn",1,3,11,49,6,10,2,60,0
Amy Schumer And Amy Poehler Were Perfect Together At The Emmys,1,1,11,41,0,10,0,52,0
Girlfriend somehow delighted by her boyfriend's gift of an empty box,1,3,1,56,1,10,0,57,0
Can You Guess Whether Or Not These Celebrities Have Had Their Own Cooking Shows,1,1,14,52,0,13,0,66,0
"Can We Guess When You Start Crying During ""It's A Wonderful Life?""",1,1,12,39,4,11,0,51,0
27 Wall Street movies to watch over Christmas,1,3,3,33,0,7,2,36,0
17 Celebrities Who Opened Up About Mental Health In 2016,1,3,8,33,0,9,6,41,0
"22 Actual Relationship Lessons ""Love Actually"" Taught Us",1,1,7,38,2,7,2,45,0
Want to Avoid Munching on Unhealthy Foods? Serve Yourself,1,3,7,41,1,8,0,48,0
Uber is tracking your location even when rides are finished,1,3,1,49,0,9,0,50,0
Steve Bannon: I Warned Ailes About Megyn Kelly — ‘She’s the Devil’,1,3,10,40,5,11,0,50,0
National Signing Day 2017: 10 Biggest Takeaways,1,3,5,29,1,6,6,34,0
16 Things You Didn't Know Happened In Dementia,1,1,7,29,1,7,2,36,0
36 Photos Of Italy In The Fifties That Will Make You Want To Time Travel,1,1,14,42,0,14,2,56,0
"Guillermo Del Toro To Take On ""Scary Stories To Tell In The Dark""",1,1,13,38,2,12,0,51,0
Kellyanne Conway’s Inauguration Outfit Gave People A Lot Of Feelings,1,3,10,48,1,9,0,58,0
18 YO Chennai Boy Bags NASA 'Moon' Prize For Proposing An Elevator From Earth To The Moon!,1,3,20,49,3,16,2,69,0
"WATCH: Whoopi, Behar Attack 'New Guy' Trump and 'Puppet' Spicer  Insider",1,3,14,41,6,11,0,55,0
Winter Warriors: Best 2017 Cars And Crossovers For Snow,1,3,8,34,1,8,4,42,0
Cheese porn alert! The 10 best things to do with cheese,1,2,2,40,1,10,2,42,0
How to have a good office Christmas party (without regretting everything the next day),1,3,2,69,2,13,0,71,0
Building the future: Singapore's stunning architectural projects,1,3,2,54,2,6,0,56,0
Roommates Wanted. Trump Supporters Need Not Apply. ,1,3,7,35,2,7,0,42,0
We Know What You Should Name Your Dog Based On Your Sign,1,1,12,33,0,11,0,45,0
Why Theaster Gates took an ax to his own painting at the NGA,1,2,6,42,0,12,0,48,0
14 Of The Hottest Topics From 2015,1,1,5,17,0,6,6,22,0
11 Riskiest Dog Breeds for Homeowners and Renters,1,3,5,35,0,7,2,40,0
19 Times Fry And Laurie Were 100% Right About Life,1,1,8,27,1,9,5,35,0
Here's What These 12 Celebrities Look Like With Drake's Beard,1,1,9,39,2,9,2,48,0
"Literally Just A Bunch Of Really Funny ""Lord Of The Rings"" Tumblr Posts",1,1,13,44,2,12,0,57,0
This A Cappella Group Sang 30 Of The Best Songs Of The Year In Five Minutes,1,1,15,43,0,15,2,58,0
The NFL is way overthinking this GIF thing,1,3,7,28,0,7,0,35,0
Church Sign Lists Patriots' Super Bowl Win Among Best Comebacks Ever,1,2,11,46,1,10,0,57,0
Doc Brown Recorded A Special Message For Back To The Future Day,1,1,12,40,0,11,0,52,0
21 Of The Most Awesome Things To Ever Happen In A Target,1,1,11,32,0,11,2,43,0
Can We Guess Your Personality,1,1,5,20,0,4,0,25,0
The 25 Funniest Sports Tweets From 2015,1,1,5,22,0,6,6,27,0
The Vape God Of Instagram,1,1,5,16,0,4,0,21,0
5 Smart Ways To Spend Your Tax Refund,1,3,7,22,0,7,1,29,0
17 Problems Only People Who've Had Diarrhea Will Understand,1,1,8,40,1,8,2,48,0
Possible new dino family tree 130 years later ,1,3,1,34,0,8,3,35,0
Mark Levin to Congress: Investigate Obama’s ‘Silent Coup’ vs. Trump,1,3,8,45,5,9,0,53,0
‘Paedophile hunters’ scrap Facebook Live stings after police warning,1,3,3,55,2,8,0,58,0
What Combination Of Hogwarts Houses Are You,1,1,7,30,0,6,0,37,0
We Know Who You Should Date Based On Your Favorite Dog Breed,1,1,12,37,0,11,0,49,0
Oprah Talking About Her Love For Bread Will Leave You Weirdly Inspired,1,1,12,47,0,11,0,59,0
10 things no one tells you before you take up rowing ,1,2,0,40,0,11,2,40,0
19 Problems All Polysexual People Know To Be True,1,1,8,31,0,8,2,39,0
29 Ways To Make Your Home Look Elegant AF,1,3,9,22,0,8,2,31,0
"Why NASA's Latest Discovery Matters, PM Modi Most Followed Leader And Other Must Reads",1,3,18,53,2,13,0,71,0
What we can learn from North Korean military parades,1,2,3,41,0,8,0,44,0
13 Horror Comics That Will @#$%&! You Up,1,1,6,19,6,7,2,25,0
Do You Remember What Color Eyes These Celebs Have,1,1,9,32,0,8,0,41,0
26 Times Old People Were The Best People On The Internet In 2015,1,1,11,35,0,12,6,46,0
5 Neon Eye Makeup Looks You Need To Try,1,1,8,22,0,8,1,30,0
When Great Isn't Good Enough: 6 Essentials To Stand Out In The MBA Applicant Pool,1,2,16,48,2,14,1,64,0
"Craig David Sang An Updated Version Of ""Fill Me In"" And People Are Really Into It",1,1,16,48,2,15,0,64,0
15 Phrases That Are Basically Sex To Socially Anxious People,1,1,9,40,0,9,2,49,0
"Literally Just 17 Really, Really Good Ideas",1,3,6,28,1,6,2,34,0
"First Read: Trump's Early Good-Cop, Bad-Cop Routine",1,3,9,31,5,6,0,40,0
Bucks Mascot Roasts Raptors with Series of Jokes Before Game 4,1,3,8,43,0,10,1,51,0
16 Things Londoners Want Tourists To Know,1,1,6,27,0,6,2,33,0
5 Reasons Why The Lawsuit Against Taylor Swift Makes No Sense,1,1,10,40,0,10,1,50,0
Here's What Happens When You Try to Block Mark Zuckerberg on Facebook,1,2,10,47,1,11,0,57,0
"Starting January 20, Trump could text you anytime he wants",1,3,3,43,1,9,2,46,0
Are You Soup Or Are You Salad,1,1,7,16,0,6,0,23,0
16 Holiday Recipes That Real Healthy People Actually Eat,1,1,8,38,0,8,2,46,0
Here's why cats sleep so much,1,2,1,22,1,5,0,23,0
23 Of The Most Powerful Photos Of This Week,1,1,8,25,0,8,2,33,0
This Guy Was Fined For Burping Too Loudly At An Amusement Park,1,1,12,39,0,11,0,51,0
19 Things You Missed At The 2017 SAG Awards,1,2,9,20,0,8,6,29,0
17 Tweets About Trying To Eat Healthy That Are Pretty Funny,1,1,10,37,0,10,2,47,0
Helen Mirren: ‘2016 Has Been a Big Pile of Sh*t’,1,3,7,24,4,9,4,31,0
I got bumped from a flight. Then I sued,1,2,3,27,1,8,0,30,0
We Need To Talk About How Fucking Delicious Empanadas Are,1,1,10,38,0,9,0,48,0
17 Insanely Delicious Desserts For Anyone Obsessed With Maple,1,1,8,43,0,8,2,51,0
This Is The Grossest Thing On The Internet This Week,1,1,10,33,0,9,0,43,0
21 Times Tumblr Users Helped You Feel Less Alone,1,1,8,30,0,8,2,38,0
Odd Lots: This Is How You Know When the Stock Market Is in a Bubble,1,2,12,40,1,14,0,52,0
"This time it’s Saudi Arabia: even when Boris Johnson gets it right, he’s wrong",1,3,5,56,4,13,0,61,0
A Mom And A Chef Cook Off To See Who Can Make The Better Dish For 2 Kid Judges,1,1,18,41,0,18,1,59,0
"Michael Jackson Is Worth More Than Ever, and the IRS Wants Its Cut",1,3,13,40,1,12,0,53,0
What's The Least Amount Of Exercise You Need To Remain Healthy? We Have The Answer!,1,2,15,51,3,14,0,66,0
20 Most Epic Celebrity Trump Meltdowns of 2016,1,2,5,28,0,7,6,33,0
15-Year-Old In Southwest Delhi Commits Suicide After Mother Fails To Give Her Rs 500 For Party,1,3,16,56,2,15,5,72,0
This Is The Only Coloring Book You'll Need After A Breakup,1,1,11,36,1,10,0,47,0
Can You Figure Out The Theme Of This Crossword,1,1,9,29,0,8,0,38,0
Leonardo DiCaprio Blushed Real Hard When He Watched Himself Make That Face At Lady Gaga,1,1,16,57,0,14,0,73,0
23 Incredibly Thoughtful Gifts Everyone Will Want,1,1,6,35,0,6,2,41,0
32 Pictures That Perfectly Sum Up Your Elementary School Experience,1,1,9,47,0,9,2,56,0
Palin: I’m ‘Extremely Thankful’ Trump Has Been Elected,1,3,8,35,4,7,0,43,0
Are These People Holding Rabbits,1,1,5,23,0,4,0,28,0
Ex-NFL RB Montee Ball reveals he would get drunk 4 times a week,1,3,8,41,1,12,1,49,0
29 Snuggly Things To Keep You Comfy In The Great Outdoors,1,1,10,35,0,10,2,45,0
17 Times Ryan Gosling Made You Almost Forget How To Breathe,1,1,10,37,0,10,2,47,0
Arsenal Praised For Being Only Premier League Club To Raise Money For Refugees,1,1,13,53,0,12,0,66,0
DELINGPOLE: Bread Causes Global Warming Shock,1,3,15,24,1,5,0,39,0
How Cynical Are You Compared To Everyone Else?,1,3,8,30,1,7,0,38,0
Caught tech-handed: The criminals snared by their own stupidity,1,2,2,51,2,8,0,53,0
"Cooking Got Barbara Lynch Out of South Boston, and Brought Her Back ",1,3,10,45,1,12,0,55,0
Mitt Romney’s E2 Summit 2015,1,3,4,14,1,4,5,18,0
Ranking the NBA's Top 50 Free Agents This Summer,1,2,9,28,1,8,2,37,0
"Rise And Shine, And Take This Quiz So We Know Whether Or Not You’re A Morning Person",1,3,17,49,2,16,0,66,0
This 6-Point Guide Will Help You Ace Your Selfie Game Even In Low Light At Night,1,3,16,47,1,15,1,63,0
"31 Behind-The-Scenes Photos Of ""Grease: Live"" You Might Have Missed",1,1,11,40,5,9,2,51,0
This Guinea Pig Has A Way Better Instagram Than You,1,1,10,32,0,9,0,42,0
"How Well Do You Know The Lyrics To ""Love Story"" By Taylor Swift",1,1,13,36,2,12,0,49,0
This Tattoo Artist Will Make Literally Every Person Want To Get Inked,1,1,12,46,0,11,0,58,0
This Guy's Cheese Vine Perfectly Sums Up How Silly The Daily Mail Is,1,1,13,42,1,12,0,55,0
26 Delicious Things You Can Make With A Tube Of Biscuit Dough,1,1,11,37,0,11,2,48,0
How You React To These Messages Will Show What Kind Of Online Dater You Are,1,1,15,46,0,14,0,61,0
'Will & Grace' Stars Ecstatically Reunite for Limited Revival Series: Pics!,1,3,9,51,5,10,0,60,0
These states give you the best return for your tax dollars,1,3,1,47,0,10,0,48,0
How Many Of These Animals Do You Want On Your Squad,1,1,11,30,0,10,0,41,0
"Job hunting? 180+ openings in New York, London, Hamburg and more",1,2,5,42,4,10,3,47,0
So What Is Kendrick Lamar Actually Dropping On April 7?,1,2,9,35,1,9,1,44,0
17 Pictures Hot People Will Never Understand,1,1,6,30,0,6,2,36,0
28 Songs From The Early '00s That You Forgot Existed,1,1,8,30,1,9,4,38,0
The Most Famous Celebrity Pet Accounts on Instagram [Video],1,2,8,41,2,8,0,49,0
A Lifetime of New York Sports Misery in Just One Year,1,3,9,34,0,10,0,43,0
White woman 'posed as black civil right leader' in years-long deception,1,2,1,57,3,10,0,58,0
4 things Hollywood gets wrong about archaeologists âÂ and 2 things it gets right,1,3,2,63,2,13,2,65,0
Why pop’s future is black and British,1,3,2,28,1,6,0,30,0
Blake Lively And Ryan Reynolds' Newborn Daughter's Name Is Totally Adorable,1,3,11,52,2,10,0,63,0
This Dog Groomer's Insanely Cute Instagram Account Will Take You To Your Happy Place,1,1,14,56,1,13,0,70,0
"Mashable on Periscope: ""‪Twitter party at #SXSW‬""",1,2,7,30,6,6,0,37,0
10 Italian Dishes Your Nonna Would Be Proud Of,1,1,8,28,0,8,2,36,0
Can You Identify The Premier League Footballer From Just Their Eyes,1,1,11,46,0,10,0,57,0
There's a 20% chance you have a particular form of synesthesia,1,3,1,47,2,10,2,48,0
WikiLeaks Claims CIA Lost Control of ‘Hacking Arsenal’,1,3,10,35,2,7,0,45,0
Sleazy rider! Semi-naked couple are caught having sex on the back of a moving motorcycle  ,1,3,2,70,2,16,0,72,0
Money Doesn't Grow On Trees: Financial Basics For Your Kids,1,3,10,38,2,9,0,48,0
12 Creative Ways To Use Selfie Sticks,1,1,6,23,0,6,2,29,0
19 Weird And Wonderful Gifts For The Wine Lover In Your Life,1,1,11,36,0,11,2,47,0
"The First Trailer For ""My Big Fat Greek Wedding 2"" Is Finally Here And It's Perfect",1,1,15,49,3,15,1,64,0
5 Astronauts Told Us Their Most Terrifying Moments In Space,1,1,9,40,0,9,1,49,0
13 Hanukkah Fails That Are Undeniably Hilarious,1,1,6,33,0,6,2,39,0
12 Things Your Eyes Are Trying to Tell You About Your Health,1,3,10,37,0,11,2,47,0
12 Reasons That Will Make You Want To Follow BuzzFeed On Steller,1,1,12,39,0,11,2,51,0
"Stop Everything Because A ""Friday Nights Lights"" Musical Is Happening",1,1,10,48,2,9,0,58,0
What Game Show Should You Go On,1,1,7,18,0,6,0,25,0
17 Valentine's Day Cards Full Of Hot Love And Emotion,1,1,9,32,1,9,2,41,0
'You didn't even go in hard': The day a dad ruined junior football,1,3,2,48,4,12,0,50,0
An Adorable Animals Advent Calendar: December 15,1,1,6,33,1,6,2,39,0
"Crash Brothers? Steph and KD, finding their way",1,3,5,33,2,7,0,38,0
"Can You Match The ""Avengers: Age Of Ultron"" Quote To The Right Character",1,1,13,44,3,12,0,57,0
Aggravating Air Travel Mishaps,1,1,4,23,0,3,0,27,0
Watch This Trans Teenager's Emotional Reaction To Getting Her First Dose Of Hormones,1,1,13,58,1,12,0,71,0
We Need To Discuss How Kendall Jenner Is The Most Flawless Human At New York Fashion Week,1,1,17,56,0,16,0,73,0
"Dad Joke Han Solo Might Be The Best ""Star Wars"" Twitter Account Yet",1,1,13,40,2,12,0,53,0
"13 Levels That Prove That ""Super Mario Maker"" Is Pure Evil",1,1,10,34,2,10,2,44,0
This Band Shot A Stunning Music Video Entirely On Smartphones,1,1,10,42,0,9,0,52,0
Which Gotham Girl Are You,1,1,5,16,0,4,0,21,0
"A 65-Year-Old Man's Typewriter Was Destroyed By An Angry Cop, And The Internet Got Him A New One",1,1,19,54,4,17,2,73,0
The Movie That Taught A Generation Of Misfits To Let Their Freak Flags Fly,1,1,14,47,0,13,0,61,0
Build A Wedding And We’ll Tell You If You’re Single,1,2,10,30,2,9,0,40,0
This Feisty Little Dancer Channeling Aretha Franklin Will Give You Life,1,2,11,50,0,10,0,61,0
"People are sharing their ""ugly duckling"" photos The list",1,3,2,44,2,8,0,46,0
How to Take Great Vacation Photos ,1,3,5,23,0,6,0,28,0
Millions Of People Are Obsessed With This Video Of A Mom Getting Her 4 Kids Ready,1,1,15,50,0,15,1,65,0
Lady Gaga Supports Paris Attack Victims By Stepping Out In The French Flag Colours,1,1,14,55,0,13,0,69,0
The Best Jokes On The Internet As Queen Elizabeth II Became Britain's Longest-Reigning Monarch,1,1,16,63,2,13,0,79,0
ACLU Sues Indiana Town over Cross on Top of Christmas Tree,1,3,11,37,0,10,0,48,0
Apple iPhone 8 rumors and news,1,3,2,22,0,5,1,24,0
"Great News, John Mayer Finally Found A Manly Heart Emoji That Men Can Use",1,3,14,45,1,13,0,59,0
We Know Whether You’re A Lefty Or A Righty Based On This Pattern Quiz,1,3,14,41,1,13,0,55,0
This Mom Went Viral After Her Son Recorded Her Listening To Nicki Minaj For The First Time,1,1,17,57,0,16,0,74,0
23 Pictures That Prove We’re Living In The Damn Future,1,3,9,33,1,9,2,42,0
This Grandma Just Hit The Sickest Beer Pong Shot Of 2016,1,1,10,32,0,10,4,42,0
Watch NBC TODAY Show Excerpt Free Online - Single Mom Builds Home by Watching YouTube Videos | Yahoo View,1,3,23,62,2,18,0,85,0
Why Elf On A DILF Needs To Be A Thing,1,1,13,15,0,9,0,28,0
Training Your Brain So That You Don’t Need Reading Glasses ,1,2,10,38,1,10,0,48,0
When You Can't Remember Names,1,1,5,19,1,4,0,24,0
21 Signs You Were Raised On Indiana Jones,1,1,7,25,0,7,2,32,0
Will Catalonia try to secede from Spain this year?,1,2,3,38,1,8,0,41,0
Donald Trump's closest advisor Steve Bannon thinks there will be war with China in the next few years,1,2,5,78,1,17,0,83,0
"18 Tanning Salon Horror Stories That Will Make You Say ""Gross""",1,3,10,38,2,10,2,48,0
5 Women Tried On A Bunch Of Suits And Here's What Happened,1,1,11,34,1,11,1,45,0
"The most ambitious, irritating, hopeful and overrated books of 2016 — and the best one, too",1,3,1,67,4,15,4,68,0
21 Pictures That Prove That Canada Is Not A Real Country,1,1,10,34,0,10,2,44,0
23 Things You'll Understand If You're In A Committed Relationship With Your Hair Straighteners,1,1,13,64,2,13,2,77,0
"Yes, really: '1984' is now sold out on Amazon",1,3,2,27,4,8,4,29,0
Here's How Russia Recruited Elite Hackers For Its Cyberwar Against US,1,3,12,46,1,10,0,58,0
"27 Times The ""Hamilton"" Fandom Had Jokes",1,1,6,24,2,6,2,30,0
"Sansa Stark Will Finally Catch A Break On The Next Season Of ""Game Of Thrones""",1,1,15,47,2,14,0,62,0
How Many Cats Can You Catch,1,1,6,16,0,5,0,22,0
This Toddler Headbanging And Air Drumming To His Favourite Band Is The Cutest Thing You'll See Today,1,1,17,66,1,16,0,83,0
"13 Magical ""Harry Potter""-Inspired Gifts Your S.O. Will Positively Love",1,1,11,44,5,9,2,55,0
We Got Drunk And Made Ourselves Super Bowl Trophies,1,1,9,34,0,8,0,43,0
Sports Writer Gives Up Hall of Fame Vote to Avoid Voting for Conservative Curt Schilling,1,3,12,62,0,14,0,74,0
"A Strategic Eating Guide to Expo Milan, the Foodie World’s Fair",1,2,9,42,2,10,0,51,0
Four Products to Keep You Flying This Holiday Season,1,3,8,36,0,8,0,44,0
Chemists have bad news about your cough syrup,1,2,1,37,0,7,0,38,0
"Would you take a new £1,300 DNA test that could save your life?",1,3,4,40,3,12,4,44,0
32 Gift Ideas For The Canadian In Your Life,1,1,8,25,0,8,2,33,0
Final 2016-17 Power Rankings settle all the debates,1,2,3,34,1,7,6,37,0
Will the Real Democracy Lovers Please Stand Up? ,1,3,7,32,1,8,0,39,0
This One Question Will Determine How Dirty Your Mind Is,1,1,10,36,0,9,0,46,0
Lady Gaga in Black and White: The Billboard Woman of the Yearâs 7 Best Couture Looks,1,2,11,56,3,15,1,67,0
Mayim Bialik has something to say about people calling grown women 'girls',1,3,2,59,2,11,0,61,0
Strangers Kiss Blindfolded And Guess What The Other Looks Like,1,1,10,43,0,9,0,53,0
How to Be Successful in the Sneaker Reselling Business,1,3,6,40,0,8,0,46,0
"I'm Muslim, But I'm Not",1,1,5,11,3,4,0,16,0
James Franco ‘Spiraled Into a Depression’ After Trump Victory,1,3,8,43,2,8,0,51,0
If Disney Princesses Lived In Canada,1,1,6,25,0,5,0,31,0
100 Hilarious Tweets That Prove 2016 Was The Year Of The Teenagers,1,3,10,38,0,11,7,48,0
‘Dilbert’ Creator Scott Adams to Stop Donating to Alma Mater UC Berkeley,1,3,11,48,2,11,0,59,0
There's A Hilarious Reason Everyone's Sharing This Poster For Tom Hardy's New Film,1,1,13,54,3,12,0,67,0
Drake Finally Dropped His New Album And People Are Shook,1,3,10,37,0,9,0,47,0
"Here's Why Justin Bieber's ""Sorry"" Video Is So Fucking Amazing",1,1,10,39,4,9,0,49,0
"If Sunday Is For Church, This Group Wants Saturdays For Activism",1,3,11,42,1,10,0,53,0
Erykah Badu Effortlessly Threw Shade At Iggy Azalea Last Night,1,1,10,43,0,9,0,53,0
Can You Guess The BuzzFeed Employee's Screen Name By Looking At A Photo Of Them,1,1,16,48,1,14,0,64,0
Sen. Liz Warren Refuses to Disavow Madonna’s Wish to ‘Blow Up the White House’,1,3,11,50,4,13,0,61,0
Help Us Settle The Debate That's Quietly Tearing India Apart: Bum Spray From The Front Or Back,1,1,17,59,2,16,0,76,0
Red wine ingredient may improve health of obese men,1,3,1,42,0,8,0,43,0
What Is Sleeping Beauty Syndrome? [Video],1,3,6,27,3,5,0,33,0
Can you find the sheep hiding amongst these Santas?,1,3,2,40,1,8,0,42,0
Printable Super Bowl LI prop bet scorecard,1,2,5,31,0,6,0,36,0
Proof Kim Kardashian West Is Stealing Cher’s Style,1,2,8,34,1,7,0,42,0
Los Angeles tops list of dog attacks on mail carriers,1,3,2,42,0,9,0,44,0
Daniel Craig Has Been Brutally Honest Regarding His Feelings About James Bond,1,1,12,54,0,11,0,66,0
20 Signs That Definitely Have A Hilarious Story Behind Them,1,1,9,39,0,9,2,48,0
"Which Hogwarts Houses Do The ""Gilmore Girls"" Characters Belong In",1,1,10,44,2,9,0,54,0
"The Most Savage Memes Inspired by Kendrick Lamar's ""The Heart Part 4""",1,3,10,44,3,11,1,54,0
College Student Who Accused Football Players with Rape Now Charged with Lying,1,2,10,56,0,11,0,66,0
Report: Hillary Clinton is ‘Thinking’ about Running for NYC Mayor,1,3,9,44,3,9,0,53,0
"Meet Pumpkin, The Orphaned Raccoon That Now Thinks She's A Dog",1,1,11,39,2,10,0,50,0
21 Nerdy Things You Need For Your Home Right Now,1,1,9,28,0,9,2,37,0
Developers tell Facebook: This is how you fight fake news,1,2,3,44,1,9,0,47,0
This Video Of A Dying Dog Being Nursed Back To Health Is Heartwarmingly Beautiful,1,1,14,54,0,13,0,68,0
Super Bowl commercials 2017: Grading the best and worst of the big game,1,2,3,51,1,12,4,54,0
"Economy healed under Obama, but unhappy voters chose Trump",1,3,3,46,1,8,0,49,0
Why a Lagos slum is producing Nigeria's top football talent,1,2,3,46,1,9,0,49,0
"The Best Jim And Pam Moments, Ranked In Order Of Cuteness",1,1,11,35,1,10,0,46,0
How To Make The Thanksgiving Stuffing Of Your Dreams,1,1,9,35,0,8,0,44,0
8 Things To Help You Talk To Your Family About Your Eating Disorder,1,1,12,42,0,12,1,54,0
Can You Pass This Basic Math Test Without Using A Calculator?,1,3,11,39,1,10,0,50,0
Naked Kansas City man arrested in minivan rap battle killings ,1,3,3,49,0,10,0,52,0
"How Well Do You Know The ""Pretty Little Liars"" Theme Song",1,1,11,34,2,10,0,45,0
People Are Screaming After A Guy Hilariously Called Out His Mom For Lying On Facebook,1,3,15,56,0,14,0,71,0
7 February games you should get excited about,1,3,1,36,0,7,1,37,0
Can You Fill In The Blanks Of These Master P Lyrics,1,1,11,30,0,10,0,41,0
24 Porta-Potty Horror Stories That Will Shake You To Your Core,1,3,11,38,1,10,2,49,0
This Is What Your Phone Notifications Would Look Like With 8 Million Followers,1,1,12,53,0,12,1,65,0
Kylie Jenner Wears Shiny Ass-Less Pants In New Interview Magazine Photo Shoot,1,1,13,52,1,11,0,65,0
"22 Reasons You Need To Start Watching ""Outlander"" Immediately",1,1,8,41,2,8,2,49,0
Airfare to these destinations could drop in time for spring break,1,3,1,54,0,10,0,55,0
Somehow A Shit Ton Of People Have No Idea Who Chris Pratt Is,1,1,13,35,0,12,0,48,0
One Tokyo restaurant's success and failure is decided by pandas having sex,1,2,2,60,1,11,0,62,0
We Know Your Relationship Status Based On Your Favorite Couples,1,1,10,44,0,9,0,54,0
"Teen Sets Fire to Man Sleeping on NYC Subway, Brags About It to Friends",1,3,13,44,1,13,0,57,0
Try This Cool Figure-8 Bun When Your Hair Is Dripping Wet,1,1,11,34,1,10,1,45,0
We Know Your Favorite Female Celeb Based On Your Favorite Male Celeb,1,1,12,45,0,11,0,57,0
Can You Guess Why One Direction's Niall Horan Is Laughing,1,1,10,37,1,9,0,47,0
Dem Rep Cleaver: ‘I’ve Been Getting All Kinds of Hate Phone Calls’ for Deciding To Attend Inauguration,1,2,15,67,4,16,0,82,0
"This Is What Happens When A Dude Is Low-Key Into ""The Bachelor""",1,1,13,36,3,11,0,49,0
"Hands On With Apple Music: Slick, but Nothing Special",1,3,8,35,2,8,0,43,0
Toy Horse's Wildly Detailed Dick Freaks Out Internet,1,3,8,36,1,7,0,44,0
11 Types Of Hangover Everyone Has Had At Least Once,1,1,9,31,0,9,2,40,0
Eggnog Pie Is The Greatest Thing To Ever Happen To Your Holiday,1,1,12,40,0,11,0,52,0
These Dudes Pierced Their Ears For The First And Probably Last Time,1,1,12,44,0,11,0,56,0
17 Times Lin-Manuel Miranda Proved He's A Complete Genius,1,1,9,36,2,8,2,45,0
Celebrities Turned Out in Droves in Support of Nationwide Women's Marches,1,2,8,54,1,10,0,62,0
Jade From Little Mix Tried To Prank-Call Taylor Swift,1,1,10,34,1,8,0,44,0
An Artist Reimagined Disney Princesses As Britney Spears,1,1,8,41,0,7,0,49,0
World's 'most colourful 5k run',1,2,1,22,3,4,1,23,0
"Chargers expected to exercise option for L.A. move, sources say",1,3,3,48,3,9,0,51,0
19 Life-Altering Ways To Put Booze And Cake Together,1,1,9,32,1,8,2,41,0
How Did You Make Friends As An Adult,1,1,8,21,0,7,0,29,0
Philadelphia Dance Center Invited Dads To Ballet Class And The Results Will Warm Your Heart,1,3,15,62,0,14,0,77,0
Goldberg defeats Kevin Owens to win WWE Universal Championship,1,3,8,46,0,8,0,54,0
How Prince Charles plans to sterilise the nation’s squirrels – with Nutella,1,3,4,58,2,11,0,62,0
"Microsoft’s Scaring Windows 7 Users, Claims It’s Highly Insecure, But Don’t Worry",1,2,11,53,5,11,1,64,0
Times Critics’ Top Books of 2016 ,1,3,4,18,1,6,4,22,0
Pharrell Asked A Bunch Of Kids Why They Love Reading And It Was Adorable,1,1,14,45,0,13,0,59,0
"Bizarre! Female Cricketer Scores 160, Teammates 0 In The Most Lopsided Batting Scorecard You' ll Ever See",1,3,14,68,3,16,4,82,0
I Cooked With An Easy-Bake Oven For A Week And Here's What Happened,1,1,14,39,2,12,0,53,0
Ex-Olympian among US gymnasts claiming sex abuse by team doctor ,1,3,4,49,1,10,0,53,0
Which Celebrity Should Be Under Your Tree On Christmas Morning,1,1,10,43,0,9,0,53,0
Here's why Snapchat's stock is plunging,1,3,2,30,2,5,0,32,0
27 5-Ingredient Dinners That Are Actually Healthy,1,1,6,33,1,6,3,39,0
This Is What It's Like When You Pay $2.99 A Month For Kylie Jenner's Official App,1,1,15,44,4,15,3,59,0
"Keystone Pipeline, Border Wall, Supreme Court: Your Wednesday Briefing ",1,3,9,50,3,9,0,59,0
13 Christmas Traditions From Around The World That’ll Make You Say “Huh?”,1,3,11,45,4,11,2,56,0
24 Ridiculous Sex Rumours That Went Around People's Schools,1,1,8,40,1,8,2,48,0
We Tried The Spicest Curry Dishes In L.A. And Instantly Regretted It,1,1,13,42,2,11,0,55,0
The 11 Best Celebrity Interactions On Instagram In 2015,1,1,7,34,0,8,6,41,0
A Flatter Belly With Just One Move,1,2,7,21,0,6,0,28,0
15 Life-Changingly Useful Kitchen Products You Should Know About,1,2,9,44,1,8,2,53,0
A man has invented the most ridiculous way for women to deal with their periods The list,1,2,2,70,0,16,0,72,0
A 22-Year-Old Whose Husband And Baby Were Killed By A Drunk Driver Has Posted A Gut-Wrenching Facebook Plea,1,1,20,65,3,17,2,85,0
All The Best Deals On The Internet This Weekend,1,3,9,30,0,8,0,39,0
"Report: Hillary, 6 Aides Had Access to Classified State Dept Info After Leaving Office",1,3,12,58,2,13,1,70,0
Russia domestic violence: One woman's narrow escape,1,3,2,41,2,6,0,43,0
A new mom flew to Miami to get a ‘Brazilian butt lift.’ She didn’t survive the surgery.,1,3,4,62,5,16,0,66,0
Non-Canadians Try To Identify Canadian Celebrities,1,1,7,37,1,5,0,44,0
The Struggles Of Being A Sleepwalker,1,1,6,25,0,5,0,31,0
Kerry Washington Was Accused Of Cultural Appropriation And Reacted In The Best Way,1,1,13,57,0,12,0,70,0
This Glass Bottom Sky Pool Looks Scary AF,1,3,9,25,0,7,0,34,0
11 Of The Most Nonsensical Lyrics From 2015,1,1,6,24,0,7,6,30,0
America Just Sent Back A Syrian Woman Trying To Visit Her Sick Mother,1,3,13,44,0,12,0,57,0
How “Colossal” Tore Nice-Guy Syndrome To Shreds,1,3,8,30,3,6,0,38,0
"How Well Do You Remember The Intro To ""Danny Phantom""",1,1,10,32,2,9,0,42,0
17 Cake Designs That Are Just Absolutely Stunning,1,3,7,33,0,7,2,40,0
New Yorker Cover Imagines The Childishness Of A Donald Trump Presidency,1,2,11,50,0,10,0,61,0
Actress Lisa Edelstein Uses Alan Thicke’s Death to Attack Donald Trump,1,3,10,49,1,10,0,59,0
15 Lazy And Delicious Pumpkin Spice Latte-Flavored Desserts You'll Want To Make Right Now,1,1,14,58,2,13,2,72,0
Did You Prefer The Broadway Show Or The Movie,1,1,9,28,0,8,0,37,0
A Santa Held A Photo Of A Dead Child To Honor A Grieving Father's Christmas Wish,1,1,16,48,1,15,0,64,0
10 Horror Movie Questions That’ll Stump Even The Biggest Fanatics,1,2,9,44,1,9,2,53,0
Do You Know The Colours Missing From These Flags,1,1,9,31,0,8,0,40,0
17 Easy Magic Tricks That Will Blow Your Kids' Minds,1,1,9,31,1,9,2,40,0
22 ways to be healthier with minimal effort,1,2,0,34,0,7,2,34,0
38 Cozy Cocktails Guaranteed To Warm You Up This Fall,1,1,9,33,0,9,2,42,0
Charlize Theron And Keanu Reeves Kinda Sorta Shit-Talked Each Other At The Gym,1,3,14,51,1,12,0,65,0
People Try Bull Testicles For The First Time,1,1,8,29,0,7,0,37,0
Don't Believe All the Bad Sh*t People Say About Diet Coke,1,2,10,35,2,10,0,45,0
How Romantic Was Your Proposal,1,1,5,21,0,4,0,26,0
"This picture shows how insecure men can be, and it’s worse than we thought The list",1,3,2,64,2,15,0,66,0
"These People Prove Why 'Baby, It's Cold Outside' Should Be Banned Forever",1,1,12,46,4,11,0,58,0
10 ways to beat holiday stress with fitness and nutrition,1,3,0,46,0,9,2,46,0
Dem Rep Gutiérrez: Not Used to ‘the Number of White Women’ Complaining to Him About Trump,1,3,12,59,3,15,0,71,0
"Which Hogwarts Houses Do These ""Parks And Rec"" Characters Belong In",1,1,11,44,2,10,0,55,0
Equity 101: 3 Things Every Founder Needs To Know Before Giving Away A Piece Of Their Startup,1,2,15,56,1,16,4,71,0
17 Hot Breakfasts For When You Need To Warm Up,1,1,9,26,0,9,2,35,0
Reese Witherspoon Just Called Out Hollywood Ageism And Sexism And It Was Beautiful,1,1,13,57,0,12,0,70,0
What's The Most Romantic Movie Scene Involving A Meal,1,1,9,35,1,8,0,44,0
Dylan O'Brien's Tweets As Motivational Posters,1,1,7,32,2,5,0,39,0
18 Things That Happen When Your Best Friend Comes Into Town,1,1,10,37,0,10,2,47,0
How Addicted To Wikipedia Are You,1,1,6,22,0,5,0,28,0
Donald Trump immigration ban: Detained Iraqi refugee says 'America is the land of freedom',1,2,5,69,3,13,0,74,0
"Hey Lazy People, Here's A New Super Easy, Delicious Prawn Dish You Can Try",1,1,14,44,3,13,0,58,0
How to Peel an Apple in 3 Seconds,1,1,4,21,0,7,1,25,0
If Quentin Tarantino Made Christmas Cards,1,1,6,30,0,5,0,36,0
Quizzes Quiz: Which national animals do you know?,1,3,3,37,2,7,0,40,0
Black Lives Matter to Attempt Disruption of Super Bowl Attendees’ Arrival,1,2,9,53,1,10,0,62,0
Ariana Grande Reunited With Broadway Composer Jason Robert Brown And It Feels So Good,1,1,14,58,0,13,0,72,0
The one thing you should never do to your hair first thing in the morning The list,1,2,2,64,0,16,0,66,0
25 Photos That Meat Eaters Will Never Understand,1,1,7,32,0,7,2,39,0
These Bizarre Topshop ‘Mom’ Jeans Have Shoppers Confused,1,3,8,39,2,7,0,47,0
16 Killer Halloween Looks You Can Pull Off All Year-Round,1,1,10,35,1,9,2,45,0
Touching moment conjoined twins see each other after separation surgery,1,3,1,61,0,9,0,62,0
Which Fictional Bromance Is The Best,1,1,6,25,0,5,0,31,0
"26 Times ""The Osbournes"" Were The Funniest Family On TV",1,1,10,32,2,9,2,42,0
21 Pictures People Who've Never Had A Period Won't Understand,1,1,9,39,2,9,2,48,0
9 Celebrity #TBT Photos You May Have Missed This Week,1,1,11,31,1,9,1,42,0
"Which ""Hamilton"" Character Are You Based On Your Zodiac Sign",1,1,10,39,2,9,0,49,0
Quit Your Job And Live Abroad: 8 Places So Cheap You Might Not Need To Work,1,3,15,43,1,15,1,58,0
"Conan O'Brien Shared A Touching Remembrance Of David Bowie On ""Conan""",1,1,12,44,3,10,0,56,0
"Here's how far $2,500 will get you in 10 of the most popular vacation destinations",1,3,1,58,3,14,6,59,0
"Here's How Josh Radnor Feels About The ""HIMYM"" Finale",1,1,13,29,3,8,0,42,0
"How Well Do You Actually Know The ""X-Files"" Mythology",1,1,10,32,3,8,0,42,0
23 Extremely Thirsty Tweets About Chris Pratt That Get More Graphic The More You Scroll,1,3,14,57,0,14,2,71,0
Shawn Mendes' 10 Best Deep Cuts,1,3,5,18,1,5,2,23,0
11 Pieces Of Wisdom To Read Whenever You're Feeling Down,1,1,9,35,1,9,2,44,0
Here's Why Some People Are Furious About Facebook's Indian Flag Profile Photos,1,1,12,53,2,11,0,65,0
Watch This Trans Guy Celebrate His Very First Chin Hair,1,1,10,36,0,9,0,46,0
It took 100 years and 1 inspirational video for new NYC subway line to launch,1,3,4,55,0,14,4,59,0
Wrapping The Perfect Present,1,1,4,21,0,3,0,25,0
Rampaging deer caught by shopper in US,1,3,3,29,0,6,0,32,0
The 24 Best Science Fiction Books Of 2015,1,1,6,22,0,7,6,28,0
Delta Paid A Family $11K To Give Up Their Seats,1,3,10,25,1,9,2,35,0
The 19 Best Movies Of 2015,1,1,4,11,0,5,6,15,0
Do-Nothing Congress: Democrats ‘Pivot’ from Gun Control to Blocking Pro-Gun Bills,1,2,11,55,5,10,0,66,0
23 Photos Guaranteed To Upset You,1,1,5,21,0,5,2,26,0
"If You Want to Find the Best Steals, You Need to Know These 7 Secrets to Craigslist Success",1,2,13,59,1,17,1,72,0
A Siri for Your Finances? Digit Says Trust Me,1,3,8,28,1,8,0,36,0
10 Good Reasons To Change Jobs Every 3 To 5 Years,1,3,8,27,0,10,4,35,0
Daniel Craig And Rachel Weisz Just Set Whole New Relationship Goals,1,1,11,46,0,10,0,57,0
19 Struggles All Naturally Disorganised People Will Understand,1,1,7,46,0,7,2,53,0
We Know What Picture Of Billy Ray Cyrus You Want To Get Framed For Your Mantel Based Off This One Question,1,1,21,65,0,20,0,86,0
"So Excited About Snap! But, Ummm, What’s an IPO Again?",1,2,11,29,5,9,0,40,0
19 Edible Shots You Have To Make This Holiday Season,1,1,9,32,0,9,2,41,0
18 Of The Least Productive Members Of Society,1,1,7,29,0,7,2,36,0
Shoe Thrown At Punjab CM Prakash Singh Badal During Election Rally + 5 Other Stories From Today,1,3,16,61,1,16,1,77,0
17 Things No One Tells You About Breast Cancer,1,1,8,28,0,8,2,36,0
Can You Get Through These Pictures Of Zac Efron Wearing Tiny Shorts Without Gasping For Air,1,1,16,60,0,15,0,76,0
Why Getting Fired Is Worse Than Divorce,1,3,7,26,0,6,0,33,0
"Sacrificing sleep to get top grades doesn’t work, study finds",1,2,1,49,2,9,0,50,0
Every Piece Of Evidence That Proves Anna Faris And Chris Pratt Have The Cutest Family In Existence,1,1,17,65,0,16,0,82,0
"18 Things ""Back To The Future"" Forgot To Predict",1,1,8,28,2,8,2,36,0
"Now for the good news: Regular sex benefits your mental health, too",1,3,2,52,2,11,0,54,0
Halperin: ‘Russian Troops’ Kept Hillary From Going to Wisconsin,1,3,8,44,3,8,0,52,0
22 Tweets About Being In Therapy That Will Make You Laugh Out Loud,1,1,12,40,0,12,2,52,0
Meet Riley: The 2017 Gerber Baby!,1,3,5,17,2,5,4,22,0
"Amid the uproar over Nate Parker, why is no one talking about Casey Affleck?",1,3,5,56,2,13,0,61,0
Latina Surprises BFFs Who Lost Their Parents With Sweetest Gifts,1,2,12,43,0,9,0,55,0
16 Puppies In Casts Who Are So Cute It Hurts,1,1,9,24,0,9,2,33,0
These 6 Dips Will Change Your Life,1,1,6,21,0,6,1,27,0
Jessica Chastain Just Wrote A Fire Essay About Gender Equality In Hollywood,1,1,12,52,0,11,0,64,0
"FYI, This Is Why DJ Mustard Is Called DJ Mustard",1,1,14,24,1,9,0,38,0
18 Fixes To Small Problems That Are Annoying AF,1,1,9,28,0,8,2,37,0
"22 ""Legend Of Zelda"" Tattoos That Will Blow You Away",1,1,9,30,2,9,2,39,0
The Police Only Started This Woman's Stabbing Investigation Because Farhan Akhtar Intervened,1,1,12,68,1,11,0,80,0
The families of hostages are told to keep quiet. They shouldn’t.,1,3,2,49,3,10,0,51,0
The Struggle Is Real When You're Buying Concert Tickets Online,1,1,10,42,1,9,0,52,0
"Left-Wing ‘Anti-Hate’ SPLC Cheated Tax Laws, Says Legal Complaint",1,3,14,38,5,8,0,52,0
My 5-year-old is scared to go to bed by himself. How can we all get some sleep?,1,3,2,56,4,16,1,58,0
Emma Watson Is Starting A Feminist Book Club And Wants You To Name It,1,1,14,42,0,13,0,56,0
Campuses Wary of Offering ‘Sanctuary’ to Undocumented Students ,1,3,6,47,2,8,0,53,0
Destinations 19 photographs that prove Alaska in the most beautiful place in America,1,3,3,67,0,12,2,70,0
In pictures: Secrets of French diplomacy,1,3,3,31,1,5,0,34,0
17 Books That Perfectly Capture The Immigrant Experience,1,1,7,40,0,7,2,47,0
"Let's Take A Moment To Appreciate ""Save The Last Dance""",1,1,10,33,3,9,0,43,0
21 Hilarious Tweets That Are Way Too Real If You Hate Doing Stuff,1,1,12,39,0,12,2,51,0
TWO MINUTE MONEY: Saving $100 A Month,1,2,17,9,2,6,3,26,0
People Are Loving This Twitter Account That Matches You To Your Dog Self,1,1,13,47,0,12,0,60,0
"39 Of The Best Moments In The History Of ""America's Next Top Model""",1,1,12,38,3,12,2,50,0
National Photographic Portrait Prize finalists share the stories behind the pictures,1,3,4,70,0,10,0,74,0
21 Reasons Soup Is The Best Food Ever Invented,1,1,8,28,0,8,2,36,0
22 Celebrity Dog Dads And Cat Ladies Who Will Warm Your Heart,1,1,11,37,0,11,2,48,0
"37 Thoughts I Had Listening To ""Serial's"" Surprise Second Season Premiere",1,1,10,48,3,10,2,58,0
Here's What Meg Cabot Learned About Situational Depression,1,1,8,42,1,7,0,50,0
Fix Is In: House Committee on ‘Russian Hacking’ Includes Only DNC-Hired Tech Experts,1,3,15,53,4,12,0,68,0
Joe Biden's favorite Obama-Biden meme revealed,1,2,4,35,2,5,0,39,0
14 Of The Most Crazy Creepy Places In Canada,1,1,8,26,0,8,2,34,0
19 Reasons Eating With Lipstick On Is The Absolute Worst,1,1,9,36,0,9,2,45,0
7 electric scooters that will change the way you commute,1,2,0,46,0,9,1,46,0
5 easy tricks to make your iPhone storage last longer,1,3,1,42,0,9,1,43,0
50 Of The Creepiest Places In The U.S,1,1,8,19,1,7,2,27,0
16 Things To Do With The Tears You Cried While Listening To Adele's 25,1,1,12,40,1,13,4,52,0
Are You More Kylie Jenner's Lips Or Kim Kardashian's Butt,1,1,10,36,2,9,0,46,0
Can We Guess What Kind Of Snapchatter You Are Based On A Single Question,1,1,14,45,0,13,0,59,0
18 Pictures You Understand If You're Weird As Hell,1,1,8,31,1,8,2,39,0
"The Women Of ""The Office"" Re-Created A Throwback Photo And The Emotions Are Real",1,1,15,49,3,13,0,64,0
13 Roommate Secrets That Will Make You Want To Live Alone,1,1,10,35,0,10,2,45,0
Graphic: The A-Z of Tony Blair's global business deals,1,3,6,37,3,8,0,43,0
We Know Your Favorite One Direction Song,1,1,7,27,0,6,0,34,0
14 Small Lies All Best Friends Tell Each Other,1,1,8,28,0,8,2,36,0
30 Under 30 2017: Sports,1,2,2,9,1,4,8,11,0
"13 Body Scrubs Without Microbeads, Because They Are NOT Good For The Planet",1,2,14,46,1,12,2,60,0
Oprah Rethinking Presidential Run After Donald Trump’s Win,1,3,8,42,1,7,0,50,0
Why Japanese people are wrapping themselves up in cloth,1,2,2,45,0,8,0,47,0
16 Ferrets With Better Hair Game Than Donald Trump,1,1,8,32,0,8,2,40,0
"People are sharing their ""ugly duckling"" photos The list",1,2,2,44,2,8,0,46,0
World landmarks recreated with Lego,1,2,2,29,0,4,0,31,0
Syrian ceasefire deal: What we know,1,3,2,27,1,5,0,29,0
24 Pictures That Will Make You Not Want To Live On This Planet Anymore,1,1,13,42,0,13,2,55,0
This Game Of MASH Will Make Your Middle School Dreams Come True,1,1,15,37,0,11,0,52,0
7 Healthy Eating Tricks That Are Actually So Easy,1,1,8,32,0,8,1,40,0
Can This Little Gadget Help Your Posture,1,1,7,27,0,6,0,34,0
This Video Of A Woman On A Motorbike Saving A Kitten From Traffic Is Terrifying,1,1,15,50,0,14,0,65,0
How Anyone Can Invest Like Warren Buffett,1,3,7,28,0,6,0,35,0
16 Cookie Sandwiches That Will Change The Way You Eat Dessert,1,1,10,39,0,10,2,49,0
We Know Which Emoji You Use The Most Based On Your Zodiac Sign,1,1,13,37,0,12,0,50,0
How Do You Know a Populist When You See One?: QuickTake Q&A,1,3,13,32,3,11,0,45,0
13 Spellbooks For The Witch In Your Life,1,1,7,24,0,7,2,31,0
30 Gooey And Delicious Dips That Will Make Freak Nasty Proud,1,1,10,38,0,10,2,48,0
29 Real-Life Childhood Fears That Will Make You Laugh,1,1,9,33,1,8,2,42,0
24 Things Guaranteed To Push You Way Beyond Your Breaking Point,1,1,10,41,0,10,2,51,0
14 Photos Proving That Too Many Rickshaw Drivers Have Had Their Hearts Broken,1,1,12,51,0,12,2,63,0
28 Impossibly Cute Ways To Cover Your Body In Outer Space,1,1,10,35,0,10,2,45,0
23 Beaches You Won't Believe Actually Exist In India,1,1,8,33,1,8,2,41,0
Sen. Menendez Ally Dr. Salomon Melgen Found Guilty on All 67 Counts of Medicare Fraud,1,3,12,55,2,14,2,67,0
Day 7 Of BuzzFeed's 7-Day Clean Eating Challenge,1,1,8,29,2,7,2,37,0
"How Well Do You Actually Know ""Star Wars""",1,1,8,24,2,7,0,32,0
"‘Houston, we have a problem’: The amazing history of the iconic Apollo 13 misquote",1,2,3,60,4,13,2,63,0
Trump's House Freedom Caucus tweet draws response from conservative members,1,2,4,61,1,9,0,65,0
What Men's Grooming Products Are Actually Worth The Money,1,1,9,39,1,8,0,48,0
A new Cash for Clunkers could be on the way,1,3,3,31,0,9,0,34,0
This Woman Survived One Of The Deadliest Snake Attacks,1,2,9,37,0,8,0,46,0
What's really in that weed? - CNN Video,1,2,5,24,3,7,0,29,0
Trump’s Phone Call With Taiwan President Sparks China Complaint,1,2,9,45,1,8,0,54,0
Who Said It: Lorde Or Audre Lorde,1,1,7,19,1,6,0,26,0
"A List Of The Most Romantic Jim & Pam Episodes Of ""The Office"" To Binge-Watch On Valentine's Day",1,1,18,56,5,17,0,74,0
19 Struggles That Are Way Too Real For Anyone Who's Ever Had Hair Extensions,1,1,13,47,1,13,2,60,0
What You Say To Someone Who's Grieving Vs. What They Hear,1,1,11,34,2,10,0,45,0
21 Lush Products That Actually Do What They Say,1,1,8,29,0,8,2,37,0
Kids Play With Tamagotchi,1,1,4,18,0,3,0,22,0
What Are Your Best Tips For Managing Your ADHD At Work,1,1,14,30,0,10,0,44,0
24 things to consider before taking Adderall,1,3,1,35,0,6,2,36,0
Platinum mining firm tells massacre families: we can't afford to house you,1,3,1,60,2,11,0,61,0
26 Things You'll Only Understand If You're The Oldest Child,1,1,9,37,2,9,2,46,0
Need a Breakthrough? Offer Prize Money! ,1,3,5,27,2,6,0,32,0
27 School Supplies That Will Give You Intense Elementary School Flashbacks,1,1,10,52,0,10,2,62,0
89 Thoughts Everyone Has While Wedding Dress Shopping,1,1,7,37,0,7,2,44,0
Can You Match These Katy Perry Songs To Their Albums,1,1,10,33,0,9,0,43,0
This Super Hot Doctor And His Cat Are Pure Purrfection,1,1,10,35,0,9,0,45,0
The 10 best holdalls – in pictures,1,3,1,24,1,6,2,25,0
A Guy Made A Joke About His Car's Tape Player Being For His iPhone And Now The Internet Is Mocking Him,1,1,21,60,1,20,0,81,0
Meet The San Francisco Cat Who Helped Save A Suicidal Man's Life,1,1,12,40,1,11,0,52,0
"31 Times ""Scream Queens"" Perfectly Described A Night Out With Friends",1,1,10,45,2,10,2,55,0
How Craig Sager Saved Dennis Rodman's Life,1,2,7,28,1,6,0,35,0
It Took Exactly 15 Minutes For This Female Politician To Be Asked Why She’s Childless,1,2,14,54,1,14,2,68,0
A Former Model Told Us How She Stays Healthy,1,1,9,27,0,8,0,36,0
The 24 Funniest Tweets About Cats In 2015,1,1,6,22,0,7,6,28,0
21 Reasons Americans Will Be Forever Indebted To The British,1,1,9,40,0,9,2,49,0
17 Products Every Bath & Body Works Addict Owned In The '90s,1,1,9,34,2,11,4,43,0
"Which ""Kim Possible"" Character Are You",1,1,6,25,2,5,0,31,0
Chuck Berry: Life in Photos,1,3,4,18,1,4,0,22,0
17 Celebrity Instagrams You Need To See This Week,1,1,8,31,0,8,2,39,0
Is This A Real Florida News Headline Or Something I Made Up,1,1,12,36,0,11,0,48,0
This One Music Question Will Determine When You'll Get Married,1,1,10,42,1,9,0,52,0
"Kanye West Finally Tweeted Something Lovely And It's About North, Obviously",1,1,11,52,2,10,0,63,0
"Genetic Engineering Will Be A Big Part Of The ""X-Files"" Reboot",1,1,12,37,3,10,0,49,0
Here's Another Really Good 2015 End-Of-The-Year Mashup,1,1,9,31,4,6,4,40,0
Can You Solve These Anagrams Of Classic Book Titles?,1,3,9,34,1,8,0,43,0
NAACP Vows to Oppose Trump’s Voter Fraud Investigation,1,3,11,35,1,7,0,46,0
28 Savage Kardashian Burns We Still Haven't Recovered From,1,2,8,39,1,8,2,47,0
"Dear Marvel, You Need To Recast ""Doctor Strange"" Because This Guy Is Way Better",1,3,14,49,3,13,0,63,0
"Someone Switched Gordon Ramsay's Lines From ""MasterChef Junior"" With ""Hell's Kitchen""",1,1,12,57,6,10,0,69,0
Watch A Gay Indian Man's Stunning Transformation Into Drag,1,1,9,40,1,8,0,49,0
A$AP Rocky Has The Coolest Instagram You've Ever Seen,1,1,11,32,2,8,0,43,0
23 Photos That Are Way Too True When You Have A Hangover,1,1,11,32,0,11,2,43,0
Trump's order on abortion policy: What does it mean?,1,3,2,39,3,8,0,41,0
"10 Reasons We're Psyched About The Renewal Of ""Scream Queens""",1,1,9,38,3,9,2,47,0
4 Ways To Easily Remove Stubborn Price Stickers From Gifts,1,1,9,39,0,9,1,48,0
Are You More Dev Shah Or Tom Haverford,1,1,8,23,0,7,0,31,0
Ava DuVernay's Barbie Is The Most Important One Ever,1,1,10,33,1,8,0,43,0
Paul Walker's Daughter Has Found The Perfect Way To Remember Her Late Father,1,1,13,50,1,12,0,63,0
"Celebrities Trash Neil Gorsuch: Suggest He Uses Gay Sex App, ‘Anti-LGBTQ,’ ‘Terrifying’",1,3,17,51,8,11,0,68,0
Americans Watch Russian Cartoons For The First Time,1,1,8,36,0,7,0,44,0
13 Annoying Little Problems Trans Women Didn't Expect After Transition,1,1,9,49,1,9,2,58,0
Amy Poehler And Tina Fey Make Epic Return As Hillary Clinton And Sarah Palin,1,1,14,49,0,13,0,63,0
Tinder Just Added An STI Testing Locator To Their Website,1,1,12,36,0,9,0,48,0
Destinations Why you should go to Colombia now - before it's too late,1,3,3,52,2,12,0,55,0
Anne Hathaway's Birthday Instagram Caption Is So Random And Amazing,1,1,10,47,1,9,0,57,0
"Caitlyn Jenner Warns Trump: You ‘Mess’ with LGBT Community, ‘I’m Coming After You’",1,3,15,48,7,12,0,63,0
Shia LaBeouf Moves Anti-Trump Art Exhibit to Albuquerque,1,3,9,39,1,7,0,48,0
Are You More Ellen DeGeneres Or Jimmy Fallon,1,1,9,28,0,7,0,37,0
Sexist Political Criticism Finds a New Target: Kellyanne Conway ,1,2,8,46,1,9,0,54,0
10 Things Spanish Majors Are Tired Of Hearing,1,1,7,29,0,7,2,36,0
29 Songs You Totally Forgot You Used To Love In 2003,1,1,9,27,0,10,6,36,0
MSNBC to Release Information From Donald Trump's Tax Returns,1,3,12,39,1,8,0,51,0
17 Cosplayers Get Real About The Importance Of Fictional Characters,1,1,9,47,0,9,2,56,0
19 Guys Who Were Hot Then...Who Are Even Hotter Now,1,1,10,27,3,9,2,37,0
"Hate Hoax: Man Faked ‘KKK’ Crimes, Abduction",1,3,9,25,4,6,0,34,0
Chickens Come Home to Roost: Massive Layoffs Predicted for ESPN Broadcasters,1,3,12,53,1,10,0,65,0
Can You Guess The Video Game From Its Terrible Summary,1,1,10,35,0,9,0,45,0
A Bunch Of Women Wore Pants To The Emmys And It Was Perfect,1,1,13,34,0,12,0,47,0
24 Tweets That Will Speak To Your Petty Soul,1,3,8,26,0,8,2,34,0
Hey Stores: It's Way Too Early For Christmas,1,1,8,27,2,7,0,35,0
Antarctica's sky just lit up with electric-blue clouds â here's why,1,3,1,53,5,10,0,54,0
Martin Luther King Jr.'s daughter takes down Pepsi in one heartbreaking tweet,1,3,5,59,2,11,0,64,0
An Alabama Prison’s Unrelenting Descent Into Violence ,1,3,7,39,1,7,0,46,0
21 Cats Who Really Regret Their Decisions,1,1,6,27,0,6,2,33,0
17 Jokes That Only The Smartest People Will Get,1,2,8,29,0,8,2,37,0
"SC Hears Nirbhaya's Rapists Death Penalty Appeal, ISRO Launches 104 Rockets And Other Must Reads",1,2,18,59,2,14,3,77,0
We Know What Country You Live In Based On The Things You Hate,1,1,13,36,0,12,0,49,0
The true story of the five year old who gave birth The list,1,3,2,45,0,12,0,47,0
"The 23 Most Iconic Professor Snape Moments In ""Harry Potter""",1,1,9,38,2,9,2,47,0
This Has To Be The Craziest Illusion Ever,1,1,8,26,0,7,0,34,0
17 Reasons People Who Exercise At Night Are Doing It Right,1,1,10,36,0,10,2,46,0
We Did Things Men Stereotypically Do And Here's How It Went,1,1,11,37,1,10,0,48,0
The Most Astonishing Photos That Won Awards In 2015,1,1,8,31,0,8,4,39,0
The 10 trickiest Goldman Sachs interview questions,1,3,3,39,0,6,2,42,0
This Deformed Mountain Lion Is Fascinating But Also Might Make You Gag A Little,1,1,14,52,0,13,0,66,0
12 Ways To Get Help When You Feel Completely Alone,1,1,9,30,0,9,2,39,0
The Most Monday Things To Happen In 2015,1,1,7,22,0,7,4,29,0
10 Inspirational Quotes From Artists We Lost In 2016,1,3,7,31,0,8,6,38,0
Man Surrenders to Face Charges in J.P. Morgan Cyberattack,1,3,8,39,2,8,0,47,0
This Picture Association Test Will Determine Your True Inner Age,1,1,10,45,0,9,0,55,0
"Obama Oversees Year of Mass Regulation, Record 97,000 Pages of Red Tape",1,2,9,44,2,11,5,53,0
My-King Johnson to be first active openly gay scholarship player in major-college football,1,3,3,73,2,12,0,76,0
29 Healthier Versions Of The Best Fall Desserts,1,1,7,31,0,7,2,38,0
Who Got The Most Instagram Likes – Kylie Or Kendall?,1,3,9,32,2,9,0,41,0
Do Attractive People Earn A Fatter Paycheck?,1,2,7,30,1,6,0,37,0
Kids Confess Their Feelings About Their Crush,1,1,7,32,0,6,0,39,0
"19 Things That Will Warm Even The Coldest, Deadest Heart",1,1,9,35,1,9,2,44,0
Easy Ways To Boost Your Income Now To Pay For Summer Fun Ahead,1,2,13,37,0,12,0,50,0
Ridiculously Easy Recipes for When You've Lost an Hour’s Sleep  - Recipes from NYT Cooking,1,2,13,59,3,15,0,72,0
Ellen DeGeneres And North West Brushing My Little Pony's Hair Is Just Adorable,1,1,14,51,1,12,0,65,0
Not sure what's really important in college hoops? Here's your guide,1,3,2,53,3,10,0,55,0
The 21 Most Important Selfies Of 2015,1,1,5,20,0,6,6,25,0
Why 2017 Is a Pivotal Year for K-Pop,1,3,6,18,1,7,4,24,0
These 4 Animals Sum Up What It Feels Like The Monday After Break,1,1,12,39,0,12,1,51,0
The best holiday gifts for a serious traveler,1,3,1,37,0,7,0,38,0
The world's most powerful passports revealed: Germany takes the top spot (but the UK and US trail far behind),1,3,6,81,4,18,0,87,0
52 Places to Go in 2017 ,1,3,2,10,0,6,6,12,0
The vet who 'euthanised' herself in Taiwan,1,3,2,32,2,6,0,34,0
Demi Lovato Destroyed Her First Grammys Performance And We Are All Dead Now,1,1,13,50,0,12,0,63,0
Taylor Swift Opened The Grammys And Fans Lost Their Damn Minds,1,1,11,41,0,10,0,52,0
15 Top Paying IT Certifications In 2017,1,3,6,21,0,6,6,27,0
"Hey India, Don't Talk About My Mom Like That",1,1,9,25,2,8,0,34,0
36 Backstage Celebrity Instagrams From The Emmys,1,1,6,34,0,6,2,40,0
20 Shirtless Guys With Man Buns That Will Make You Feel Things,1,1,11,38,0,11,2,49,0
17 People Who Are Absolutely Killing It At Dreamforce 2015,1,1,8,35,0,9,6,43,0
Truck blown over by powerful gust of wind in US,1,2,3,35,0,9,0,38,0
Bucks ticket plan: $149 until team wins 10 home games after Jan. 13,1,3,2,43,3,12,7,45,0
"17 Nurses Reveal The Worst Things People Got Stuck Up Their Penises, Vaginas, And Butts",1,2,14,55,2,14,2,69,0
18 Badass Portraits From Glamour's Women Of The Year Awards,1,1,9,38,1,9,2,47,0
Which Of These Foods Is The Grossest,1,1,7,23,0,6,0,30,0
The Moment It Becomes More Than A Hookup,1,1,8,25,0,7,0,33,0
32 Times Lady Gaga Had The Best Damn Year In 2015,1,1,9,24,0,10,6,33,0
We Know Which Bailee Madison Movie You'd Star In Based On Three Questions,1,1,13,47,1,12,0,60,0
"30 Under 30 Asia 2017: Industry, Manufacturing & Energy",1,3,5,31,3,8,8,36,0
British Airways Sister Airline Joins Battle in Budget Trans-Atlantic Travel,1,3,10,55,1,9,0,65,0
Pitching Tim Tebow: What It's Like to Actually Pitch to Tebow,1,2,9,40,2,10,0,49,0
Aleppo Christians celebrate holiday in hope peace has returned,1,2,2,52,0,8,0,54,0
12 Things Kendall Jenner’s Hat Looked Like At The Marc Jacobs Fashion Show,1,3,12,47,1,12,2,59,0
These Amazing African Baby Names Will Make You Want To Conceive,1,1,11,42,0,10,0,53,0
13 Crazy-Delicious Pizza Toppings You Need In Your Life,1,1,9,35,1,8,2,44,0
100 Women: How South Korea stopped its parents aborting girls,1,2,4,44,1,9,3,48,0
Do You Have The Most Horrifying Cable Company Customer Service Story,1,1,11,47,0,10,0,58,0
Muslims Outnumber Christians in More than 30 Church Schools,1,2,6,43,0,8,2,49,0
"The Justin Bieber Sports Curse Is Definitely Real, and It Just Claimed Its Latest Victim",1,2,14,59,1,14,0,73,0
Who Said It: Shia LaBeouf Or Kanye West,1,1,9,22,1,7,0,31,0
Vin Diesel and The Rock Reportedly Settle Their ‘Candy Ass’ Feud,1,3,10,42,2,10,0,52,0
43 Things That Mildly Thrill All Students,1,1,6,27,0,6,2,33,0
Please Stop Recording Concerts On Your Phone,1,1,7,31,0,6,0,38,0
Oreo Marshmallow Treats Are The Stuff Dreams Are Made Of,1,1,10,37,0,9,0,47,0
Nobel-Winning Sexism in the Lab - Room for Debate - NYTimes.com,1,2,9,40,4,10,0,49,0
This Non-Traditional Wedding Will Hit You Right In The Feels,1,3,11,39,1,9,0,50,0
This Supercouple Got Married While Running The Chicago Marathon,1,1,9,46,0,8,0,55,0
52 Things That Mildly Thrill All Twentysomething Grandmas,1,3,7,41,0,7,2,48,0
14 Fashion Essentials You Should Own by Age 30,1,3,6,28,0,8,4,34,0
17 Times In 2015 Cara Delevingne And Annie Clark Made You Believe In Love Again,1,1,13,46,0,14,6,59,0
Kelly Promises to Build Trump’s Wall in 2 Years or Less,1,2,7,36,1,10,1,43,0
A Girl Snapchatted Herself As Disney Princesses And It Is Awesome,1,1,11,44,0,10,0,55,0
Can You Guess These Old Timey Slang Words,1,1,8,26,0,7,0,34,0
27 Times Tumblr Was Beautifully Wholesome,1,2,5,29,0,5,2,34,0
31 Love Songs You Listened To In The Late '90s,1,1,8,24,1,9,4,32,0
21 Dogs Who Know Exactly What You Did,1,1,7,21,0,7,2,28,0
This Is What It's Actually Like To Live As An Anxious Person,1,1,12,36,1,11,0,48,0
"OMG, ""Game Of Thrones"" And ""Pocahontas"" Are Literally The Same",1,1,12,36,5,9,0,48,0
I Tried San Francisco's New $15 Coffee,1,1,6,22,2,6,2,28,0
Donald Trump on Peter Thiel: ‘He’s Ahead of the Curve’,1,3,7,34,4,9,0,41,0
This Recipe For Mud Hen Bars Is All You Need To See Today,1,1,13,32,0,12,0,45,0
19 Words You Don't Actually Understand Unless You're From Long Island,1,1,10,45,2,10,2,55,0
19 Things That Were Cool As An Emo Teen But Definitely Aren't Cool Now,1,1,13,41,1,13,2,54,0
This Font Test Will Reveal Something Deeply True About You,1,1,10,39,0,9,0,49,0
EXCLUSIVE – ‘Trump Singles’ Dating Site Lets Trump Supporters Find Love Online,1,3,19,45,3,11,0,64,0
Fans Are Sharing Touching And Beautiful Artwork In Tribute To David Bowie,1,1,12,50,0,11,0,62,0
"In 100 Days, Donald Trump Hasn’t Done Much Except Show Off His Signature",1,3,12,43,2,12,3,55,0
Professor Disciplined for ‘Sexual Misconduct’ after Singing Beach Boys Song to Students,1,3,9,65,2,11,0,74,0
GOLDMAN SACHS: 17 stocks that have a long way to fall,1,3,12,28,1,10,2,40,0
"This Wounded Veteran's Service Dog Was His Best Man, And It'll Make You Bawl",1,1,14,46,3,13,0,60,0
Delightfully Spooky Wedding Venues In Every U.S. State,1,1,9,36,2,7,0,45,0
When You Think You Hit It Off,1,1,7,16,0,6,0,23,0
"Which ""Waiting To Exhale"" Character Are You",1,1,7,28,2,6,0,35,0
"Which ""Breaking Bad"" Character Are You Based On Your Favourite Colour",1,1,11,46,2,10,0,57,0
It's Game Over For The Xbox One,1,3,7,17,1,6,0,24,0
Amy Schumer Exits ‘Barbie’ Movie,1,2,5,21,2,4,0,26,0
This Is What Happens When You Get Drunk,1,1,8,24,0,7,0,32,0
Katy Perry Receives Humanitarian Award from Hillary Clinton at UNICEF Snowflake Ball,1,2,15,58,0,11,0,73,0
Bill Gates reveals his 5 favorite books of 2016,1,3,2,32,0,8,5,34,0
Look At These Beautiful And Haunting Photos Of African Wildlife,1,1,10,44,0,9,0,54,0
What Does Your Taste In French Fries Say About You,1,1,10,31,0,9,0,41,0
Why Warp Speed Will Never Happen,1,2,6,21,0,5,0,27,0
Girl Had A Perfect Response When Asked Why She Wanted A Black Doll,1,2,13,41,0,12,0,54,0
STOCKS HIT ALL-TIME HIGHS: Here's what you need to know,1,3,22,21,3,9,0,43,0
"Do You Know These Classic ""Star Wars"" Characters",1,1,8,31,2,7,0,39,0
"Can You Guess ""The Simpsons"" Character From Just Their Colors",1,1,10,40,2,9,0,50,0
"Police decide man touching woman's thigh on a bus wasn't harassment, for a ridiculous reason",1,3,1,74,3,14,0,75,0
17 Things People Don't Understand About OCD,1,1,8,26,1,6,2,34,0
Report: Court Documents Show FBI Used Best Buy ‘Geek Squad’ to Gather Evidence,1,2,14,49,3,12,0,63,0
10 Ridiculously Easy And Delicious Soups That Are Perfect For Fall,1,1,10,44,0,10,2,54,0
The 19 Most Important Things That Happened At The 2016 Golden Globe Awards,1,1,11,45,0,12,6,56,0
24 Of Kanye West's Most Iconic Tweets From 2015,1,1,7,25,1,8,6,32,0
"Director Joseph Kahn Defends Taylor Swift's ""Wildest Dreams"" Video",1,1,9,46,3,8,0,55,0
WTF The Fuck Is Going On With Harry Styles' Trousers Right Now,1,1,14,36,1,11,0,50,0
Which Harry Styles Are You,1,1,5,17,0,4,0,22,0
Are You Mature For Your Age,1,1,6,16,0,5,0,22,0
French election: Accusations of Paris attack 'exploitation',1,3,3,47,3,6,0,50,0
34 Musical Baby Names That'll Make You Want To Procreate,1,1,9,35,1,9,2,44,0
Do Bangs Make These Celebrities More Bangable,1,1,7,32,0,6,0,39,0
What Kind Of Animal Is On Niall's Shirt In The New One Direction Music Video,1,1,15,46,1,14,0,61,0
Watch Madonna Drop F-Bomb on Live TV at Women's March on Washington,1,3,11,43,2,11,0,54,0
The 37 Punniest Tweets Of 2015,1,1,4,15,0,5,6,19,0
Snapchat's IPO reveals how much it cost to make a man disappear,1,2,4,47,1,11,0,51,0
Tell Us The Craziest Thing You've Done To Impress Your Crush,1,1,11,38,1,10,0,49,0
"Trump’s Wisconsin Crowd Cheers Kanye West, Boos Paul Ryan",1,2,9,38,2,8,0,47,0
This High-Tech Hijab Will Literally Make Muslim Women Cooler,1,2,10,41,1,8,0,51,0
"Parents Are Furious at This Bestselling Author for Buying $23,600 Worth of ‘Hatchimals’",1,3,9,57,4,12,5,66,0
"5 Things to Know About FFC-Acrush, China's Hottest 'Boy Band' Made Up of All Girls",1,3,15,47,5,14,1,62,0
Are Your Shopping Habits Normal,1,1,5,22,0,4,0,27,0
19 Things That Won't Make Sense To Non-Twins,1,1,8,25,2,7,2,33,0
16 Fairy Tale Cottages You Can Actually Stay In,1,1,8,29,0,8,2,37,0
25 Feared Dead After Schoolbus Hits Truck In UP + 5 More Stories From Today,1,3,13,44,1,14,3,57,0
Twitter Is Seriously LOL-ing About the FBI's Holiday Message,1,3,12,38,2,8,0,50,0
This Powerful Video Of 6 Women Sharing Their Real Life Stories Will Make You Sit Up And Take Notice,1,2,18,62,0,18,1,80,0
"As Womadelaide turns 25, what counts as 'world music'?",1,2,2,38,4,8,2,40,0
18 Indian Desserts Guaranteed To Satisfy Your Sweet Tooth,1,1,8,39,0,8,2,47,0
Is UNICEF helping all the child victims of peacekeeper sex abuse? ,1,3,7,47,1,11,0,54,0
Why I love… Michelle Obama,1,3,4,17,1,4,0,21,0
Two-Thirds Of People Actually Have Herpes Simplex Virus Type 1,1,1,10,41,1,9,1,51,0
A Woman Stood In Public Blindfolded In A Bikini To Promote Self-Love,1,1,13,43,1,11,0,56,0
We Know Where Your First Child Will Be Conceived,1,1,9,31,0,8,0,40,0
People Are 100% Not OK With How This Teen’s Roommate Opens His Bread,1,2,13,38,2,12,3,51,0
We Know What Your Love Life Will Look Like In 2016,1,1,10,26,0,10,4,36,0
Could A Planet Like Coruscant Exist?,1,3,6,24,1,5,0,30,0
The Frigid Winter Blues Summed Up By GIFs Of Really Hot Guys,1,1,14,35,0,11,0,49,0
17 Pictures That Sum Up The Life Of A Really Skinny Girl,1,1,11,32,0,11,2,43,0
What Was The First Song You Danced To At Your Wedding,1,1,11,32,0,10,0,43,0
The Posters Of 2016 Oscar Nominated Movies With The White Actors Removed,1,1,11,46,0,11,4,57,0
Donald Trump tweeted about St Patrick's day and colossally missed the irony The list,1,2,5,65,1,13,0,70,0
17 Reasons Why Halloween Kind Of Sucks,1,1,6,24,0,6,2,30,0
These Minimalist Illustrations Are Actually Mind-Blowing Optical Illusions,1,1,9,57,1,7,0,66,0
24 Reasons Why Netflix Is The Most Important Thing In Your Life,1,1,11,39,0,11,2,50,0
What a Gate Agent Can (and Can’t) Do For You,1,3,8,24,3,9,0,32,0
We Know If You're From Upstate New York Based On One Question,1,1,12,37,1,11,0,49,0
"There are two movie businesses, and both are losing to TV",1,3,3,43,1,10,0,46,0
18 Things That People With Depression And Anxiety Can Relate To,1,1,10,41,0,10,2,51,0
Tiger Woods On His Round of Golf With Donald Trump,1,3,9,32,0,9,0,41,0
A Bright Idea for Hedge Fund Managers: Do Nothing,1,3,8,32,1,8,0,40,0
Watch This Woman Surprise Her Girlfriend With The News She Will Be Her Kidney Donor,1,1,15,54,0,14,0,69,0
10 Jeans Hacks To Keep Your Look On Point,1,1,8,23,0,8,2,31,0
'Santa' robs US bank after handing out candy canes,1,3,3,37,2,8,0,40,0
You Need To Watch This A Capella Mashup Of Lady Gaga's Biggest Hits,1,1,13,41,1,12,0,54,0
25 Faces Every Older Sibling Has Definitely Made Before,1,1,8,37,0,8,2,45,0
"Apple said to be secretly working on diabetes ""holy grail""",1,2,1,46,2,9,0,47,0
Our TV Pet Peeves: 10 Things That Really Make Us Nuts,1,2,11,29,1,10,2,40,0
"Kellogg Foundation Gave Big to Soros Organization, Tides Foundation",1,2,8,50,1,8,0,58,0
25 Incredibly Honest Reasons People Are Waiting To Have Sex,1,1,9,39,0,9,2,48,0
Can YOU spot what's wrong with this photo? Image of six women on a sofa leaves the internet in a state of confusion,1,3,5,86,2,22,0,91,0
23 Pret Problems We All Know To Be True,1,1,8,21,0,8,2,29,0
Which ShondaLand Hunk Should You Date Based On Your Zodiac,1,1,11,38,0,9,0,49,0
This Woman Had The Perfect Response To People Body-Shaming An 8-Year-Old Girl,1,1,14,48,3,11,1,62,0
What Underrated Makeup Brands Should Everyone Know About,1,1,8,41,0,7,0,49,0
Eleven Ways to Stop Winter Weather Delays From Ruining Your Travels,1,2,10,47,0,10,0,57,0
ESPN's NFL MVP poll: Ryan unseats Brady for No. 1 spot,1,3,13,27,3,10,1,40,0
What Animal Should Be Your New Favorite,1,1,7,26,0,6,0,33,0
What we learned at Sean Spicer's first briefing,1,2,3,36,1,7,0,39,0
31 Terrifying Horror Films To Stream This October,1,1,7,33,0,7,2,40,0
20 Startling Boob Confessions Everyone Should See,1,1,6,35,0,6,2,41,0
Caribbean People Tried Each Other's Desserts And Had A Blast,1,1,10,40,1,9,0,50,0
"How Well Do You Remember The ""CatDog"" Theme Song",1,1,10,28,2,8,0,38,0
This Puzzle Is For Everyone Who Knows Their Booze,1,1,9,32,0,8,0,41,0
"Why Dutch From ""Killjoys"" Is The Most Kick-Ass Woman On TV",1,1,13,32,3,10,0,45,0
Meghan Trainor Perfectly Summed Up All Of Us With New Year's Resolutions,1,1,12,48,1,11,0,60,0
"14 Canadian Sex Positions, As Drawn By Canadians",1,1,7,31,1,7,2,38,0
This Glorious Mashup Of 2015's Biggest Movies Will Blow You Away,1,1,10,39,1,10,4,49,0
We Asked 17 Travel Pros For Their Best Advice On Traveling Solo And Here's What They Said,1,1,16,54,1,16,2,70,0
Poll: CNN Brand Continues to Plummet,1,3,7,23,1,5,0,30,0
21 Times George Costanza Was Actually A Twentysomething,1,1,7,39,0,7,2,46,0
These Students Honored Veterans By Carrying Their Coffins,1,1,8,42,0,7,0,50,0
Jake Gyllenhaal Will Break Your Heart In His New Movie,1,1,10,35,0,9,0,45,0
"Which ""The Force Awakens"" Character Matches Your Zodiac Sign",1,1,9,41,2,8,0,50,0
This Facebook Post About The Lack Of Chennai Rains Coverage Is Going Viral,1,1,13,49,0,12,0,62,0
Your Food Cravings Will Reveal Which Pop Diva You Are,1,3,10,34,0,9,0,44,0
These Mature Middle Schoolers Talk About What It's Like To Date In Middle School,1,1,14,52,1,13,0,66,0
Transgender: ‘Toni the Tampon’ Teaches Children Men Can Menstruate,1,3,8,47,3,8,0,55,0
Why monogamous male couples should stay mindful of HIV,1,3,4,42,0,8,0,46,0
A full guide to every team in the 2017 NCAA tournament,1,2,5,35,0,10,4,40,0
Celebrities Read Mean Tweets About Themselves: Music Edition (Part Three),1,1,10,51,3,9,0,61,0
"Weird Ways Guys Say ""I Love You""",1,1,7,17,2,6,0,24,0
The Unlikely Friendship That Changed the Way We Look at Human Behavior,1,3,10,49,0,11,0,59,0
Can You Tell How Old These Fucking Pennies Are,1,1,9,29,0,8,0,38,0
"Thalassophobia Is A Real, Terrifying Thing And You Definitely Have It",1,3,11,47,1,10,0,58,0
"We're Now the Friendly Skies, Emirates Tells a Red-Faced United",1,3,9,42,3,9,0,51,0
Can You Guess The Book From These Terrible Drawings,1,1,9,34,0,8,0,43,0
26 Poses Every Single Person Will Immediately Recognize,1,2,7,39,0,7,2,46,0
The Cheapest Way to Build Trump’s Wall,1,3,6,25,1,6,0,31,0
What Does Your Taste In Dessert Say About You,1,1,9,28,0,8,0,37,0
29 Mind-Blowing Things You Probably Didn’t Know About McDonald’s,1,3,10,41,3,8,2,51,0
Help us solve the mystery of Kendall Jenner's shorts,1,2,3,40,1,8,0,43,0
12 Disney Inspired Candles You'll Wish Were Real,1,1,7,31,1,7,2,38,0
15 People Who Took The Nae Nae To A Whole Other Level,1,1,11,29,0,11,2,40,0
18 McDonald's Hacks That Are Definitely Worth Trying,1,1,8,34,1,7,2,42,0
We Can Guess Your Grade Level With 10 Simple Questions,1,1,9,34,0,9,2,43,0
John Legend trolled Donald Trump like a champion,1,3,4,37,0,7,0,41,0
Jennifer Lawrence And Amy Schumer Together At The Golden Globes Was Perfect,1,1,12,52,0,11,0,64,0
The real problem behind fake news,1,2,1,27,0,5,0,28,0
Here's How To Bake With Booze And Nail It,1,1,9,23,1,8,0,32,0
"Whole Foods Wanted to Be More Than a Supermarket, and Therein Lies the Problem ",1,2,10,54,1,14,0,64,0
19 Things You'll Only Understand If You Have Multiple BFFs,1,1,11,35,1,9,2,46,0
"Generation X, Y and Baby Boomers: Why every generation feels entitled",1,2,6,51,2,10,0,57,0
23 Holiday Cocktails Guaranteed To Get You Merry And Bright,1,1,9,39,0,9,2,48,0
What Lazy Costume Should You Wear For Halloween,1,1,8,32,0,7,0,40,0
Doomed Jet Carrying Brazilian Team Reportedly Ran Out of Fuel ,1,2,9,43,0,10,0,52,0
This Body Cam Footage Shows A Vehicle Plow Into A Cop Car Head On,1,1,14,38,0,13,0,52,0
Great News: Adele And Britney Spears Are Practically BFFs Now,1,1,12,39,1,9,0,51,0
This Man Handed Out 100 Love Notes To Strangers To Honor His Late Wife,1,1,13,41,0,13,3,54,0
Bird flu detected in chicken breeding facility in Tennessee ,1,3,2,49,0,9,0,51,0
"Here are the perfect male and female bodies, according to men and women The list",1,3,2,63,1,14,0,65,0
"OMFG, The Backstreet Boys And Spice Girls Might Be Touring Together",1,1,14,42,1,10,0,56,0
Nightly News Why Confusing Food Labels Could Soon Be a Thing of the Past,1,3,11,48,0,13,0,59,0
Should You Get A Puppy Or Have A Baby,1,1,9,20,0,8,0,29,0
We Surprised Kids With Their Dream Christmas Presents,1,1,8,38,0,7,0,46,0
This Trick Finally Fixes Those God Awful Hanger Straps,1,1,9,37,0,8,0,46,0
19 Insanely Kawaii Cat-Themed Products You Had No Idea You Needed,1,1,11,41,1,10,2,52,0
29 Gifts For Anyone With Major Wanderlust,1,1,6,27,0,6,2,33,0
The Biggest Session Drummer Of All Time Is Ready For The Spotlight,1,1,12,43,0,11,0,55,0
31 Brilliant Ways To Dress Up A Pound Of Chicken,1,1,9,28,0,9,2,37,0
49 Italian Villages That Should Be On Your Bucket List,1,1,9,34,0,9,2,43,0
Twitter Is Destroying Brian Williams With #BrianWilliamsPopeStories,1,1,10,50,1,6,0,60,0
15 Smart Dollar Store Ideas To Declutter Your Kitchen,1,1,8,35,0,8,2,43,0
Ten Things Your Co-Workers Don't Need To Know About You,1,3,11,33,2,9,0,44,0
How a design for city living went wrong,1,3,1,31,0,7,0,32,0
16 Gorgeous Poems That Can Help You Cope With Your Depression,1,1,10,39,0,10,2,49,0
When You Don't Know if She's A Lesbian Or Hipster,1,1,9,29,2,9,0,38,0
27 Perfectly Magical Gifts For The Hermione Granger In Your Life,1,1,10,42,0,10,2,52,0
Literally Just A Bunch Of Shirtless Dudes Wearing Santa Hats,1,1,10,41,0,9,0,51,0
17 Photos You Should See If You're Curious About What Cuba's Actually Like,1,1,12,46,2,12,2,58,0
If McDonald's Made Happy Meal Toys For Thirtysomethings,1,1,9,38,1,7,0,47,0
You Can Personalize Your Own Adult Coloring Book With Your Name On It,1,1,13,44,0,12,0,57,0
Tulsi Gabbard: ‘We Need to Learn from Iraq and Libya’ Before Intervening in Syria,1,3,10,55,3,13,0,65,0
When You Can't Hide Your Emotions,1,1,6,21,1,5,0,27,0
"If This ""Great Detective Pikachu"" Game Doesn't Come To America I Will Scream",1,1,13,48,3,12,0,61,0
Did You Know Barbie And Ken Have Last Names,1,1,9,26,0,8,0,35,0
One Chart Showing What Goldman Expects Trump to Accomplish This Year,1,2,10,48,0,10,0,58,0
Kathy Griffin And Kristin Chenoweth Talk About Their Worst Heckler Stories,1,1,11,53,0,10,0,64,0
What did Rolls-Royce directors know about bribery scandal? 'No comment',1,3,4,54,4,9,0,58,0
A Lot Of People On Twitter Are Mistakenly Grieving A DJ Named David Zowie,1,1,15,45,0,13,0,60,0
17 Embarrassing Church Horror Stories That'll Make You Cringe,1,1,8,42,1,8,2,50,0
23 Perfect Gifts If Movies Are Their Religion,1,1,7,29,0,7,2,36,0
People Try Chatroulette For The First Time,1,1,7,29,0,6,0,36,0
"Raven And Chelsea Reunited And Slayed The Hell Out Of The ""That's So Raven"" Theme Song",1,1,16,52,3,15,0,68,0
"Tom Hanks, David Nott and Dustin Hoffman: 10 men whose Desert Island Discs you must listen to",1,2,9,64,2,16,2,73,0
Morgan StanleyVoice: Are Auto Insurers On The Road To Nowhere?,1,3,11,40,2,9,0,51,0
17 Incredibly Important Life Lessons We Can Learn From Winona Ryder,1,1,10,45,0,10,2,55,0
19 Friendship Bracelets You And Your BFF Seriously Need,1,1,10,35,0,8,2,45,0
Answer Just 3 Questions And We'll Guess How Bad Your New Year's Hangover Is,1,1,13,46,2,13,1,59,0
Trump Offers to Send ‘the Feds’ into Chicago to Fix Violent Crime — but They’re Already There,1,3,11,62,4,16,0,73,0
European Union Tells Hungary and Poland To Accept Mass Migration Or Leave,1,3,11,51,0,11,0,62,0
The Official Emo Band Name Generator,1,1,6,25,0,5,0,31,0
How Well Do You Remember Past Bonnaroo Lineups,1,1,8,31,0,7,0,39,0
1 Terrible Photoshop Of Regis Philbin In Princess Leia's Bikini,1,1,9,43,1,9,1,52,0
Did Meek Mill Take Back Nicki Minaj's Huge AF Ring After They Broke Up?,1,2,15,41,2,13,0,56,0
The science behind why you should stop stalking your ex on Facebook this Christmas,1,3,3,66,0,13,0,69,0
Oscars 2017: American bans Syrian behind nominated film The White Helmets from attending Oscars,1,2,7,70,1,13,4,77,0
These Photos Of Toilets From Around The World Highlight The Human Right For Sanitation,1,1,14,59,0,13,0,73,0
Why Disney Is Risking $300 Million on 'Beauty and the Beast',1,3,7,37,3,10,3,44,0
7 Reasons Shower Sex Is A Logistical Nightmare,1,1,7,31,0,7,1,38,0
Map: Is Islamic State in a neighborhood near you?,1,3,4,35,2,8,0,39,0
This Is What Adele's Collaborators Have To Say About Her Third Album,1,1,12,44,1,11,0,56,0
21 Gorgeous Drinking Accessories To Get You Elegantly Wasted,1,1,8,42,0,8,2,50,0
How two Irish students stole a masterpiece worth millions in an act of political protest,1,3,2,72,0,14,0,74,0
"ISIS still holds thousands of slaves, giving brisk business to human smugglers",1,3,4,62,1,11,0,66,0
"Cook’s favourite books, kit and gadgets of 2016",1,3,1,33,2,7,4,34,0
These Floating Bonsai Trees Look Like Actual Magic,1,1,8,35,0,7,0,43,0
For Everyone Obsessed With Nev Schulman's Chest Hair,1,1,8,36,1,7,0,44,0
35 Movies That Are Turning 10 Years Old In 2016,1,1,7,23,0,9,8,30,0
NAACP Leader Rachel Dolezal Allegedly Faked Being A Black Woman For Years,1,3,16,46,0,11,0,62,0
"The First Trailer For Ellen Page's ""Gaycation"" Is Finally Here",1,1,10,40,3,9,0,50,0
The Best Anti-Romantic Rom-Com You're Not Watching,1,1,9,32,3,6,0,41,0
"Great British Bake Off finalist Andrew Smyth on Channel 4, male bakers and the secret to creative cakes",1,2,7,77,1,17,1,84,0
What happens when narcissists become parents,1,2,1,38,0,5,0,39,0
What Is Your Absolute Favorite Pixar Movie,1,1,7,29,0,6,0,36,0
24 Of Greatest Grad School Memes On The Internet,1,1,8,30,0,8,2,38,0
Saints Running Back Mark Ingram Takes Down 600 Pound Boar,1,2,9,36,0,9,3,45,0
15 Mind-Blowing Chicken Nuggets That Will Make You Quit Fast Food,1,1,11,41,1,10,2,52,0
Flash mob brings love and money to mom battling cancer,1,2,1,44,0,9,0,45,0
Can You Keep Up With The Ruth Bader Ginsburg Workout,1,1,10,33,0,9,0,43,0
This Hero Bride Responded To A Car Crash In Her Wedding Dress,1,1,12,38,0,11,0,50,0
People Are Flipping Out Over Adele's Flip Phone In Her New Video,1,1,12,40,1,11,0,52,0
"We Need To Talk About Merlin On ""Once Upon A Time""",1,1,11,27,2,10,0,38,0
Guy Records Heartwarming Moment He Surprised His Mom For Christmas,1,3,10,47,0,9,0,57,0
Donald Trump Appoints Pro-Life Advocate as Assistant Secretary of HHS for Public Affairs,1,3,13,62,1,12,0,75,0
19 Pictures That Will Teach You Something For Once In Your Life,1,1,11,39,0,11,2,50,0
Canadian Cops Had The Best Response To An Underage Booze Party,1,1,11,41,0,10,0,52,0
This Mom Caught Her Little Girl Turning Her Baby Sister Into A Zebra With A Permanent Marker,1,1,17,59,0,16,0,76,0
John Mayer Has More to Say: The Outtakes ,1,3,7,25,1,8,0,32,0
27 Genuine Products That Are 100% Completely Legit,1,1,6,31,1,7,5,37,0
10 ways to beat holiday stress with fitness and nutrition,1,2,0,46,0,9,2,46,0
We Live In A Craven Universe Where Scott Disick Doesn't Have A Wikipedia Page,1,1,14,49,1,13,0,63,0
22 Types Of Hangovers Beautifully Illustrated By Boglins,1,1,7,40,0,7,2,47,0
45 Thanksgiving Desserts That Aren't Pumpkin Pie,1,1,6,33,1,6,2,39,0
15 Words That Have A Totally Different Meaning To Your Mom,1,1,10,36,0,10,2,46,0
Want a new job in the new year? Ask the experts – live chat,1,2,2,42,2,13,0,44,0
"Lansing, Michigan, Will No Longer Declare Itself a ‘Sanctuary City’",1,2,9,45,4,9,0,54,0
21 Photos Of Green Mangoes That'll Make You Drool,1,1,8,30,1,8,2,38,0
How to get free refills at Starbucks,1,3,2,28,0,6,0,30,0
27 People Who Prove Humanity Is An Evolutionary Dead End,1,1,9,36,0,9,2,45,0
"Can You Identify The ""Love And Hip Hop: Atlanta"" Season Based On Joseline's Hair",1,1,14,49,4,13,0,63,0
We Need To Talk About Joseph Gordon-Levitt,1,1,8,27,1,6,0,35,0
The ‘milk miracle’ that brought India to a standstill,1,3,2,41,2,8,0,43,0
17 Times Netflix And Chill Was The Greatest Meme Ever,1,1,9,33,0,9,2,42,0
"How Likely Are You To Be Struck By A Meteorite, Really",1,1,11,32,1,10,0,43,0
Kelly Clarkson's Baby Daughter Can Teach Us All How To Meditate,1,1,11,41,1,10,0,52,0
22 People Who Definitely Didn't Get The Job,1,1,7,26,1,7,2,33,0
The First Pictures From NOAA's Newest Weather Satellite Are Incredible,1,3,13,47,1,9,0,60,0
We Know Which Canadian City You Should Actually Live In,1,1,10,36,0,9,0,46,0
"Days Before Election, France Asks EU Parliament to Lift Le Pen Immunity",1,3,12,47,1,11,0,59,0
Mysterious discovery under the water in China will awaken your inner Indiana Jones,1,3,4,66,0,12,0,70,0
What Poem Has Helped You With Your Depression,1,1,8,30,0,7,0,38,0
Capital OneVoice: Top International Events Worth Traveling To In 2017,1,3,10,45,1,9,4,55,0
This new poll has all kinds of bad news for Donald Trump,1,2,3,42,0,11,0,45,0
"A three-day wedding celebration? Do learn some restraint, says Country Life",1,3,4,58,3,10,0,62,0
"Dear Academy, Please Give Leo DiCaprio A Fucking Oscar",1,1,10,35,1,8,0,45,0
"Canada Created A Burger With Melted Reese's Peanut Butter Cups, And We Tried It",1,1,14,50,2,13,0,64,0
"Meet Claire, The Globetrotting Dog Who Visits Abandoned Places Across Europe",1,1,11,54,1,10,0,65,0
Some Dudes Built A Giant Cardboard Fortress In The Middle Of Their Office,1,1,13,48,0,12,0,61,0
Why tougher times lie ahead,1,3,1,22,0,4,0,23,0
Europe’s Far-Right Enjoys Backing from Russia’s Putin,1,3,7,37,3,6,0,44,0
27 Reasons China Is The Best Place For Your Next Epic Adventure,1,1,11,39,0,11,2,50,0
News 38p pints and burgers for less than £2: which are the cheapest cities on Earth?,1,3,2,61,3,15,3,63,0
There's finally something awesome to do with Google Glass,1,2,3,45,1,8,0,48,0
"How Well Do You Know The Lyrics To ""Smooth"" By Santana Ft. Rob Thomas",1,1,14,39,3,13,0,53,0
Harry Potter Fans Have Turned Platform 9 3/4 Into A Memorial For Alan Rickman,1,1,12,48,1,13,3,60,0
21 Times Michael Clifford Was The Realest Person On Twitter,1,1,9,39,0,9,2,48,0
"103 ""Game Of Thrones"" Quotes That Make Perfect Instagram Captions",1,1,9,42,2,9,3,51,0
"17 Tweets That Will Make Every Indian Girl Go ""Ohmygod Yaaaaaa""",1,1,10,39,2,10,2,49,0
This Tiny Canadian House Has A Tiny Adorable Corgi Elevator And We Can't Handle It,1,1,15,52,1,14,0,67,0
This Girl's Legit Rant About Bollywood Songs Is Something We All Have Discussed At Some Point,1,3,16,61,1,15,0,77,0
Check out these epic Christmas lights synced to AC/DC's 'Thunderstruck',1,2,7,51,4,9,0,58,0
Whoopi: Are the Trump Administration Values ‘Really Much Different than the Taliban’s’?,1,3,9,62,5,11,0,71,0
Inside the little-known Monsanto campus where scientists are changing the way you eat,1,3,2,70,1,12,0,72,0
"Phil Simms May Have Farted Away His Career at CBS, Literally",1,2,12,37,1,10,0,49,0
8-year-old drives younger sister to McDonald's after craving a burger ,1,3,2,54,3,10,1,56,0
Which Real Housewife Are You Based On Your Birth Month,1,1,10,35,0,9,0,45,0
Which Badass Witch Are You Based On Your Birth Month,1,1,10,33,0,9,0,43,0
19 Gifts For Everyone Who Hates Everyone,1,1,6,26,0,6,2,32,0
29 Autocorrect Fails That Are Never Not Funny,1,1,7,29,0,7,2,36,0
Are You More Usher Or Justin Timberlake,1,1,7,26,0,6,0,33,0
The Salary Chronicles: A $200K Job Offer Showed Me My Potential Was Limitless,1,3,13,47,2,12,3,60,0
Steve Martin on Teaching You (and Himself) How to Be a Comedian ,1,3,8,42,2,12,0,50,0
Body positive Instagram star shares post explaining why you shouldn't feel bad about indulging,1,3,2,78,1,13,0,80,0
What's Your Sex Patronus,1,1,4,16,1,3,0,20,0
Some people are such food snobs,1,2,1,25,0,5,0,26,0
How Well Do You Match Colors,1,1,6,17,0,5,0,23,0
8 Ways To Eat Your Way Through Diwali This Week,1,1,9,28,0,9,1,37,0
"If You Don't Know How Giraffes Sleep You Are Missing Out, My Friend",1,1,13,40,2,12,0,53,0
24 Struggles People Who Don't Eat Constantly Will Never Understand,1,1,9,45,1,9,2,54,0
26 Moms Who Officially Out-Mommed Themselves In 2015,1,1,7,31,1,7,6,38,0
Chris Pratt And Jennifer Lawrence Reveal The Most Adventurous Places They've Had Sex,1,3,13,58,1,12,0,71,0
"Did John Podesta Violate Federal Financial Disclosure Laws, Or Nah?",1,2,10,46,2,9,0,56,0
25 Perfect Outfits To Wear For A Fall Wedding,1,1,8,27,0,8,2,35,0
How Much Do You Actually Remember About 2006,1,1,7,26,0,7,4,33,0
24 Secrets Male Models Will Never Tell You,1,1,7,26,0,7,2,33,0
"24 Times The ""How To Get Away With Murder"" Cast Gave Us Serious Squad Goals",1,1,14,43,2,14,2,57,0
This Food Stylist Gave Us 5 Tips To Make Normal Food Look Amazing,1,1,12,40,0,12,1,52,0
What does the Republican health plan mean for your taxes?,1,3,2,45,1,9,0,47,0
17 Life-Changing Ways To Eat Candy Canes,1,1,7,24,1,6,2,31,0
23 Tweets About Horoscopes That Will Make You Laugh Every Time,1,1,10,40,0,10,2,50,0
How artificial intelligence could stop those awkward moments when your credit card is mistakenly declined,1,3,1,90,0,14,0,91,0
Piper And Alex Are Totally Back On In The New Season Of “Orange Is The New Black”,1,3,17,46,2,16,0,63,0
Where Educated Millennials Are Moving,1,3,5,28,0,4,0,33,0
Chris Pratt 'Officially' Weighs In On That ‘Jurassic World’ Theory,1,3,10,43,4,9,0,53,0
17 Completely Insane Things That Have Happened In Hostels,1,1,8,39,0,8,2,47,0
Model Reveals Cellulite in Target's Newest Swimsuit Campaign,1,3,7,45,1,7,0,52,0
'My mum is my angle': Hilarious tattoo fails show how things go badly wrong when the inker can't spell ,1,3,2,78,4,19,0,80,0
30 Hilarious Tweets You'll Only Understand If You're In Your Thirties,1,1,10,45,2,10,2,55,0
This Food Test Will Prove If You're A Real New Yorker,1,1,11,31,1,10,0,42,0
13 Of The Most Beautiful And Moving Things Alan Rickman Ever Said,1,1,11,41,0,11,2,52,0
The Type of Parents Most Likely to Have a Child with Autism,1,3,8,40,0,11,0,48,0
18 Apple And Honey Recipes That Will Impress Your Jewish Grandma,1,1,10,42,0,10,2,52,0
Which Music Era Do You Actually Belong In,1,1,8,26,0,7,0,34,0
The John Lewis Christmas Ad Has Resulted In A Lot Of People Being A Sobbing Mess Again,1,1,17,53,0,16,0,70,0
"Ranveer's Bizarre Outfit, Malaysian Students Sing SRK's Song 'Janam Janam' & More From Ent!",1,2,15,56,7,13,0,71,0
Teens Who Say No to Social Media,1,3,6,20,0,6,0,26,0
"With Kardashian and Cyrus nude editions, is Paper the new Playboy? ",1,3,5,49,2,11,0,54,0
21 Reasons A Woman Should Never Ever Have A Pit Bull,1,1,10,30,0,10,2,40,0
"17 ""Family Feud"" Answers That'll Make You Feel Smart",1,3,8,31,3,8,2,39,0
Mouse spotted on plane costs British Airways quarter of a million pounds,1,3,3,58,0,11,0,61,0
"How auto dealers can use GPS and ""starter interrupter"" tech to disable your car",1,3,4,60,2,13,0,64,0
15 Of The Most Bengali Things That Happened In 2015,1,1,8,28,0,9,6,36,0
"Indian Girls Revealed What Kind Of Porn They Like, And Their Choices May Surprise You",1,1,15,55,1,14,0,70,0
"Everyone's Freaking Out Over The Season Premiere Of ""Arrow""",1,1,9,39,3,8,0,48,0
"What Your Star Sign Actually Says About You, According To Science",1,1,11,43,1,10,0,54,0
This 15-Second Video Of The Mumbai Marathon Will Leave You Totally Mesmerised,1,1,12,51,1,11,2,63,0
This Pole Dancing Santa Toy Might Be The Worst Christmas Decoration Ever,1,1,12,49,0,11,0,61,0
Do You Remember These Obscure '00s Boy Bands,1,1,7,27,1,7,2,34,0
"As KD returns, looking back on his OKC exit",1,3,6,28,1,8,0,34,0
BAFTA to Block Awards For Films That Aren’t Diverse Enough,1,3,13,35,1,9,0,48,0
This Moment Between A Starbucks Barista And A Deaf Customer Is Going Viral,1,1,13,49,0,12,0,62,0
How food inspires names of India's Parsis,1,2,3,31,1,6,0,34,0
"Which Minor ""Parks And Recs"" Character Are You",1,1,8,29,2,7,0,37,0
The Bottom Line: 'Homesick For Another World' By Ottessa Moshfegh,1,2,10,43,3,9,0,53,0
Warren Buffett's Dealmaking Ketchup Giant Kraft Heinz Heads Abroad In The Age Of Donald Trump,1,3,15,63,1,14,0,78,0
"How Our High School Friendships Shape Us, According To ""Paper Towns""",1,1,11,44,3,10,0,55,0
24 Tweets About College That'll Actually Make You Laugh,1,1,8,36,1,8,2,44,0
YouTube fix brings 12 million videos back to Restricted Mode,1,3,4,45,0,9,2,49,0
Can We Guess Which Kardashian/Jenner Sister Is Your Favorite Based On Three Questions,1,1,14,58,1,12,0,72,0
15 Secrets Puppet Builders At The Jim Henson Company Will Never Tell,1,1,11,44,0,11,2,55,0
Couples Find Out If Their Stories Of How They Met Add Up,1,1,12,33,0,11,0,45,0
"Persistent 6-year-old boy sees man lying in parking lot, saves his life",1,3,1,55,3,11,1,56,0
A crucial election for Hong Kong: What's at stake?,1,3,4,35,3,8,0,39,0
The Greatest Grilled Cheese Sandwich—and the History Behind It,1,3,8,45,1,8,0,53,0
"‘Ferguson Effect is Real,’ Police Survey Finds",1,3,6,31,3,6,0,37,0
"So According To ""Fantastic Beasts"" Muggles Aren't Called Muggles In The U.S",1,1,13,47,4,11,0,60,0
Being the youngest in your family officially makes you funnier The list,1,3,2,58,0,11,0,60,0
The surprising origins of your f*cking favorite swear words,1,2,1,49,1,8,0,50,0
Trump’s Blistering Speech at CPAC Follows Bannon’s Blueprint ,1,3,10,41,2,8,0,51,0
Teacher: Why I don’t want to assign Shakespeare anymore (even though he’s in the Common Core),1,3,6,67,5,15,0,73,0
This One-Legged Guy's Halloween Costumes Will Crack You Up,1,1,10,38,2,8,0,48,0
"How Well Do You Remember The Lyrics To Sum 41's ""Still Waiting""",1,1,11,36,3,11,2,47,0
Getting A Phone Call In 2016,1,1,5,14,0,5,4,19,0
Can You Tell The Difference Between Yoga Poses And Sex Positions,1,1,11,43,0,10,0,54,0
"‘Oh, you’re a teacher, you paint all day?’ Not even close, one teacher says",1,3,2,53,7,13,0,55,0
35 Things From 2007 You Would Never Do Today,1,3,7,23,0,8,6,30,0
How Can We Miss a President Who Won’t Go Away?,1,2,9,26,2,9,0,35,0
How Well Do You Remember Ted Mosby's Girlfriends? Part 2,1,1,9,35,2,9,1,44,0
"London, Gorsuch, Syria: Your Wednesday Evening Briefing ",1,2,7,39,3,7,0,46,0
Everything You Need To Know About TV And Movies In 2017,1,3,11,30,0,10,4,41,0
17 Productivity Hacks You Probably Shouldn't Try,1,1,6,33,1,6,2,39,0
The 100 best nonfiction books: the story so far,1,3,1,34,1,8,3,35,0
Second Oscar nominee banned from coming to the US to attend awards ceremony,1,3,4,59,0,12,0,63,0
The Definitive Ranking Of Ellie Goulding's Music Videos,1,1,8,39,1,7,0,47,0
Netanyahu: ‘All Signs’ Indicate Jerusalem Truck Terrorist was ‘Backer of Islamic State’,1,2,10,61,5,11,0,71,0
What to watch for in the first round of the French presidential election,1,3,2,58,0,12,0,60,0
Harry Potter Fans Are Paying It Forward And Leaving Heartfelt Notes For Future Readers,1,1,14,59,0,13,0,73,0
31 Of The Most Ridiculous Things People Bought Drunk Grocery Shopping,1,1,10,47,0,10,2,57,0
The 7 Lesbians You Meet On Tinder,1,1,6,20,0,6,1,26,0
"Do These Set Photos Prove That A ""Gilmore Girls"" Revival Is Really Happening",1,1,13,49,2,12,0,62,0
Obamacare on the Ropes as House Follows Senate in Voting to Repeal,1,3,7,48,0,11,0,55,0
Rob Kardashian Gave Us A Look Inside His Kitchen Cabinets And Refrigerator,1,1,12,51,0,11,0,63,0
19 Conveniently Portable Items That Will Change Your Life,1,1,8,39,0,8,2,47,0
Michael Moore: Democrats Must Declare ‘National Emergency’ Until FBI Discovers ‘Truth’ about Trump,1,3,14,67,5,12,0,81,0
This Question Will Determine If You're Ready To Settle Down,1,1,10,39,1,9,0,49,0
Cubs dominate MLB's list of most popular jerseys,1,3,4,36,1,7,0,40,0
The Downfall Of YouTube’s Biggest Star Is A Symptom Of A Bigger Illness,1,3,14,44,1,12,0,58,0
This Incredible Social Experiment Reveals The Many Ways India Is Keeping Its Women In The Dark,1,1,16,63,0,15,0,79,0
These People Got Snail Facials For The First Time...And It Was Pretty Scary,1,1,14,46,3,12,0,60,0
19 Slow Internet Connection Texts That Are Just Too Real,1,1,9,36,0,9,2,45,0
Quiet Guy Nightmares,1,1,3,15,0,2,0,18,0
"Literally Just 18 Hilarious Tweets About Last Night’s ""Bachelor""",1,2,8,43,3,8,2,51,0
Where Apple Ranks In Warren Buffett's Portfolio,1,3,7,33,1,6,0,40,0
Kylie Jenner's 'Snap Opera' is back but this time it's in Spanish,1,3,5,45,4,11,0,50,0
This 6-year-old boy saved a man who was having a massive heart attack The list,1,3,2,59,2,14,1,61,0
How The World Will Look In 2035,1,2,6,15,0,6,4,21,0
'Hearthstone: Journey to Un'Goro' expansion bringing 135 new cards in April,1,3,5,53,4,10,3,58,0
Prince Harry tries the old 'shoulder tap' prank on a schoolboy - and fails spectacularly The list,1,3,3,75,3,16,0,78,0
"The New Trailer For ""Orange Is The New Black"" Looks Seriously Intense",1,1,12,44,2,11,0,56,0
"How NPR's Podcast ""The Hidden Brain"" Is All About You",1,1,12,29,3,9,0,41,0
These 3 Kerala Companies Have More Gold Than All Of Australia!,1,3,10,40,1,10,1,50,0
33 New Beauty Products You Need To Try ASAP,1,2,11,22,0,8,2,33,0
We Re-Created Your Photos Of Kids Crying On Santa's Lap,1,1,11,33,2,9,0,44,0
"David Brent Quotes On Pictures Of Brendan Rodgers, Because Why Not",1,1,11,44,1,10,0,55,0
"29 Christmas Presents For The ""Twin Peaks"" Fan In Your Life",1,1,10,35,2,10,2,45,0
32 Reasons Milan Is The Absolute Worst,1,1,6,24,0,6,2,30,0
Can You Match Each Letter To Its Word In The Phonetic Alphabet,1,1,12,39,0,11,0,51,0
Here Are 16 Truly Useful Tools For Beginner Cooks,1,1,8,31,0,8,2,39,0
Charli XCX Looked Like A Space Dominatrix At The MTV EMAs,1,1,17,30,0,10,0,47,0
"You Need To Listen To Erykah Badu's ""Hotline Bling"" Remix ASAP",1,1,14,35,3,10,0,49,0
13 Perfect Gifts Your Naughty Friends Will Appreciate,1,1,7,37,0,7,2,44,0
"'90s Kids Learn What The Lyrics To ""Macarena"" Are Really About",1,1,10,37,3,10,2,47,0
I Tried 5 Different Subscription Boxes For My Period So That You Don't Have To,1,3,14,48,1,14,1,62,0
Macaulay Culkin Just Revealed What Kevin McCallister Is Actually Like Today,1,1,12,53,0,10,0,65,0
24 Things You'll Find In Every Hipster Restaurant,1,1,7,32,1,7,2,39,0
Companies Set Up Advisory Boards to Improve Digital Savvy ,1,2,8,41,0,9,0,49,0
"Which Of Lady Gaga's ""American Horror Story: Hotel"" Outfits Should You Rock",1,1,12,48,4,11,0,60,0
This Story About Alan Rickman And Rupert Grint Bonding Is Lovely,1,1,11,43,0,10,0,54,0
23 Animals Who Want Everyone To Kindly Step The Fuck Back,1,1,10,35,0,10,2,45,0
Are We Part Of That World,1,1,6,14,0,5,0,20,0
"How Well Do You Know The Lyrics To ""Stacy's Mom""",1,1,10,26,3,9,0,36,0
Answer One Question And We'll Tell You Which Adele Song You Need To Hear,1,1,14,44,1,13,0,58,0
11 Robots Who Will Certainly Rise Up To Destroy All Humans,1,1,10,36,0,10,2,46,0
Here's What Happened When People Tried Bharatnatyam For The First Time,1,1,11,48,1,10,0,59,0
11 Reasons Leslie Knope Is The Queen Of Compliments,1,1,8,33,0,8,2,41,0
When You're A Girl Who Sheds Hair Everywhere,1,1,8,28,1,7,0,36,0
The Great British Bake Off: Emotional farewell montage sees a tearful Mary Berry,1,3,8,59,1,12,0,67,0
Which Nativity Scene Member Are You,1,1,6,24,0,5,0,30,0
Is Your Lower Back Giving You A Hard Time? Yoga Could Be The Solution,1,3,14,41,1,13,0,55,0
Here’s Chelsea Clinton Responding to an Awkward Joke About Her Mom,1,3,9,46,1,10,0,55,0
19 Confessions From People Who Feel Guilty About Masturbating,1,1,8,43,0,8,2,51,0
32 Unbelievable Confessions About Masturbation,1,1,4,36,0,4,2,40,0
A Mountain Lion Just Climbed A Utility Pole In California And Stayed There,1,1,13,49,0,12,0,62,0
8 Things All Millennials Need to Know About Debbie Reynolds [Video],1,3,9,45,2,10,1,54,0
Kanye West And Wiz Khalifa Are Officially Drama Free,1,1,9,35,0,8,0,44,0
Gulp! Water increasingly unaffordable for many Americans,1,3,3,46,1,6,0,49,0
17 Things Vegetarians In The South Have To Deal With,1,1,9,32,0,9,2,41,0
Children As Young As 13 Are Now Attending Smartphone Rehab Centres To Cure Their Addiction,1,3,14,60,0,14,2,74,0
"Forget The Three Khans, Irrfan Khan Witnessed His Own Stardom When He Got Mobbed In Gangtok!",1,3,16,59,2,15,0,75,0
13 Valentine's Day Cards For Gay Men,1,1,6,21,1,6,2,27,0
"24 Reasons Why There Will Never Be A Movie Greater Than ""10 Things I Hate About You""",1,1,15,47,2,16,4,62,0
25 Times Drake Completely Won 2015,1,1,4,19,0,5,6,23,0
N.B.A. Finals: Golden State Warriors Get Mad and Pull Even With Cleveland Cavaliers ,1,2,14,53,4,13,0,67,0
People Try Iconic Asian Snacks,1,1,5,21,0,4,0,26,0
How could things get worse for Trump?,1,3,2,28,1,6,0,30,0
This New Starbucks Drink Is Basically Butterbeer,1,1,7,35,0,6,0,42,0
Fed tantrum sets off biggest exodus from emerging markets since 2008,1,3,1,53,0,10,4,54,0
Explore The Planet With The New And Improved Google Earth,1,3,10,38,0,9,0,48,0
Inquiry Opens Into How a Network of Marines Shared Illicit Images of Female Peers ,1,3,11,57,0,14,0,68,0
"How Well Do You Know These Random, 16th Century Flemish Proverbs",1,1,10,41,1,10,2,51,0
19 Couples In 2016 Who Perfectly Nailed This Whole Relationship Thing,1,2,9,44,0,10,6,53,0
CeeLo Green to Joy Villa: 10 of the strangest Grammy Awards outfits,1,3,7,46,1,11,2,53,0
17 Life-Changing Ways To Eat A Twix,1,1,7,19,1,6,2,26,0
The Biggest Wild Card In Retirement And How To Deal With It,1,3,12,36,0,11,0,48,0
Retirement Rules,1,2,2,13,0,1,0,15,0
"Comey, the Russia Probe and the FISA Court’s Role: QuickTake Q&A",1,2,13,37,4,10,0,50,0
"""Jurassic World"" uses bad science - Business Insider",1,3,4,38,3,7,0,42,0
23 Healthier Versions Of Your Favorite Holiday Treats,1,1,7,37,0,7,2,44,0
How Average Are You Actually,1,1,5,19,0,4,0,24,0
Man washing massive monster truck mistaken for plane crash ,1,2,1,49,0,9,0,50,0
Breast Cancer Trends: Why Do Women in These 5 States Opt for Unneeded Mastectomies?,1,3,11,56,2,13,1,67,0
Watch Gorillaz Debut New 'Humanz' Album in Its Entirety at Secret London Show,1,3,11,52,2,12,0,63,0
Christian Bakers Who ‘Lost Everything’ for Refusing Gay Wedding Cake Appeal Verdict,1,3,11,59,2,11,0,70,0
On A Date: Guys Vs. Girls,1,1,6,12,2,5,0,18,0
Some Colleges Have More Students From the Top 1 Percent Than the Bottom 60. Find Yours. ,1,2,12,55,2,16,3,67,0
Apple Music's rivals aren't impressed,1,3,2,29,2,4,0,31,0
17 Hilarious Tumblr Posts That Will Make You Question Everything You Know About Language,1,1,13,60,0,13,2,73,0
Jennifer Lawrence's Favorite Moment Of 2015 Was Getting Drunk With Amy Schumer,1,1,11,51,1,11,4,62,0
Emma Watson Responds To Jennifer Lawrence's Pay Equality Essay In A Lovely Way,1,1,13,52,1,12,0,65,0
Which YouTube Beauty Guru Are You Based On One Question,1,1,11,35,0,9,0,46,0
"13 Times ""Sesame Street"" Parodies Completely Nailed It",1,1,7,36,2,7,2,43,0
21 Beautiful Reasons Women Joined 'A Day Without A Woman',1,3,9,35,2,9,2,44,0
Newly found planet could be just right for life,1,2,1,38,0,8,0,39,0
21 Dating Struggles As Told By These Weird Clothing Labels,1,1,9,38,0,9,2,47,0
"Which ""Degrassi"" Character Are You Based On Your Zodiac Sign",1,1,10,39,2,9,0,49,0
Here’s Your Exclusive First Preview Of Mariah Carey’s New Website,1,3,10,44,2,9,0,54,0
Americans Listened To Coke Studio For The First Time And Were Pretty Damn Impressed,1,1,14,56,0,13,0,70,0
Fillon's enemies hope family affair will end presidential bid,1,3,1,51,1,8,0,52,0
You Won't Believe Why This Woman Is Suing Chipotle for Over $2 Billion,1,3,11,44,2,12,1,55,0
This Woman Paralyzed From The Waist Down Became An Aerial Performer,1,1,11,46,0,10,0,57,0
17 Things Couples In Open Relationships Need You To Know,1,2,9,36,0,9,2,45,0
16 iPhone Hacks That Will Save Your Battery,1,1,7,27,0,7,2,34,0
Where Will Kendrick Lamar’s Next Studio Album Take Us?,1,3,9,35,2,8,0,44,0
FX’s ‘American Crime Story’ to Explore Lewinsky Sex Scandal as ‘Right-Wing’ Plot to ‘Tear Down’ Bill Clinton,1,3,16,68,8,16,0,84,0
ABC News quiz: Trump's taxes and Weatherill's slanging match with Frydenberg,1,3,7,56,3,10,0,63,0
Chris Pratt As Santa Claus Is Exactly What You Need Today,1,3,11,36,0,10,0,47,0
Could We Be Friends,1,1,4,12,0,3,0,16,0
This Woman Had The Best Response When Her Husband Asked What Was On Her Mind,1,1,15,47,0,14,0,62,0
Can You Guess Why Ron Swanson Is Mad,1,1,8,21,0,7,0,29,0
"Double-Edged Sword: Home Prices Keep Rising, Home Inventory Keeps Falling",1,3,11,50,3,9,0,61,0
"One Direction Played ""Never Have I Ever"" And It Got ~Scandalous~",1,1,11,39,4,10,0,50,0
"Fashion Designer Rachel Roy On Her New ""Curvy"" Collection And Inspiring Women",1,1,12,52,2,11,0,64,0
27 Hilariously Simple Ideas That Would Make The World More Fun,1,1,10,40,0,10,2,50,0
Frito-Lay Drops Doritos Super Bowl TV Advertisements - Yahoo,1,3,10,40,2,8,0,50,0
What Your Favorite '90s Cartoon Characters Would Look Like In Real Life,1,1,11,46,1,11,2,57,0
"Now Kanye West Has Called Taylor Swift ""Fake"" In Leaked Audio",1,1,11,38,2,10,0,49,0
Kanye West Also References Kim Kardashian's Sex Tape On His New Album,1,1,12,45,1,11,0,57,0
Parenting For Idiots: celebs' boring baby stories may remind you of your own,1,2,3,59,2,12,0,62,0
Health Insurers List Demands if Affordable Care Act Is Killed ,1,2,9,43,0,10,0,52,0
What We Know About the Alleged Chicago Hate Crime Streamed Live on Facebook ,1,3,11,52,0,13,0,63,0
The Obamas' Best Pop Culture Moments ,1,3,6,24,1,6,0,30,0
Here's How To Fry Seafood At Home,1,1,7,19,1,6,0,26,0
These DIY Magnetic Jar Holders Will Save You So Much Cabinet Space,1,1,14,41,0,11,0,55,0
Florida woman's toilet clogged by an iguana because Florida,1,3,2,48,1,8,0,50,0
Did You Peak In 2015,1,1,4,8,0,4,4,12,0
"The Top Beaches In The World, According To National Geographic",1,2,10,42,1,9,0,52,0
Jon Jones Offers Ronda Rousey Career Advice Following Her Loss,1,3,10,43,0,9,0,53,0
"Are You More Lola Or Zoey From ""Zoey 101""",1,1,8,20,2,8,3,28,0
"Nathan Sykes Plays A Game Of ""Never Have I Ever"" And It's Adorable",1,1,13,38,3,12,0,51,0
"This Surat Tea Seller Just Redefined 'Black Tea' For Us, I-T Seizes Rs 400 Crores And Jewellery From Him",1,2,19,60,4,18,3,79,0
People Tell Childhood Stories About Santa Claus,1,1,7,34,0,6,0,41,0
"How A 9-Year-Old Rape Survivor, Living With Her Mother On The Streets, Nailed Her Rapist In Court",1,2,18,58,4,16,1,76,0
Who gets fooled most by phone fraud?,1,3,1,28,1,6,0,29,0
"Winter Storm Makes for Messy Travel in Plains, Northeast",1,3,7,40,1,8,0,47,0
You Probably Qualify To Be An Astronaut And Don't Even Know It,1,1,12,38,1,11,0,50,0
Forgot about Dray? Green does it all in Warriors' Game 1 triumph,1,2,5,45,2,11,1,50,0
"23 ""Parks And Rec"" Questions That Are Impossible To Answer",1,1,9,36,2,9,2,45,0
The Macy's Thanksgiving Day Parade Quiz,1,1,6,27,1,5,0,33,0
What Is Your French Name,1,1,5,15,0,4,0,20,0
36 Of The Absolute Best Curvy Costume Ideas,1,1,7,27,0,7,2,34,0
Trump Suggests GOP Needs Until 2018 To Craft 'Wonderful' Obamacare Replacement,1,3,12,50,2,10,4,62,0
How I Learned To Accept My Self-Harm Scars,1,1,9,25,1,7,0,34,0
43 Impossibly Cute Products You’ll Actually Use,1,3,6,32,1,6,2,38,0
Once Upon A Time Just Made Two Extremely Exciting Announcements,1,1,10,44,0,9,0,54,0
We Need To Talk About How Sad Puffins Look,1,1,9,25,0,8,0,34,0
‘The New Celebrity Apprentice’ is missing something — and it isn’t just Trump,1,2,5,56,4,12,0,61,0
Emma Stone's Response To The Tired 'What Are You Wearing' Question Is Perfection,1,3,13,52,3,12,0,65,0
23 Moms Who Were Clearly Meant To Be Moms,1,1,8,23,0,8,2,31,0
18 Images That Only Women Will Truly Understand,1,2,7,31,0,7,2,38,0
Can You Guess Which Non-Princess Disney Gal Said It,1,1,10,32,1,8,0,42,0
"21 Times ""The Tonight Show Starring Jimmy Fallon"" Totally Owned 2015",1,1,9,41,2,10,6,50,0
This Sweet Dog Became A Mom To A Litter Of Orphaned Opossums,1,1,12,37,0,11,0,49,0
Do you know this man? Dine-and-dash dater strikes again in Los Angeles,1,2,4,52,3,11,0,56,0
This iPhone Trick Allows You To Access Your Information During A Medical Emergency,1,1,13,57,0,12,0,70,0
24 Completely Bewitching Tim Burton Inspired Wedding Ideas,1,1,7,42,0,7,2,49,0
Report: Megyn Kelly to Make NBC Debut in June,1,2,9,27,1,8,0,36,0
These are the 7 smartest countries in the world when it comes to science,1,3,1,57,0,13,1,58,0
Trump's America Supreme Court: What is the 'nuclear option' and why are Republicans planning to use it?,1,3,6,76,5,16,0,82,0
Why the Nike Air Max 1 Is More Important Than the Air Jordan 1,1,3,10,37,0,13,2,47,0
17 People Who Are Happy For Obama But Are Also Internally Sobbing,1,2,11,41,0,11,2,52,0
Parents of successful kids have these 12 things in common,1,3,1,45,0,9,2,46,0
We Know Which GIF Will Make You Laugh Based On Your Age,1,1,14,30,0,11,0,44,0
17 People Who Totally Ruined The Moment,1,3,6,25,0,6,2,31,0
Why Are People So Bothered by a Colorful Photo of 5 Black Women?,1,2,9,41,1,12,1,50,0
Your Ex Vs. Your New Crush,1,1,6,14,1,5,0,20,0
FaceApp: Experts have privacy concerns about popular face transformation app,1,3,3,63,1,9,0,66,0
"15 Gary Busey Dance Moves We Can't Wait To See On ""Dancing With The Stars""",1,1,14,41,3,14,2,55,0
"What Would Your ""Star Wars"" Porn Name Be",1,1,8,23,2,7,0,31,0
22 People Who Were Just Smooth AF,1,1,7,18,0,6,2,25,0
19 Better Names For Everyday Things,1,1,5,23,0,5,2,28,0
"If ""Dragon Ball Z"" Characters Had Realistic Proportions",1,1,8,38,2,7,0,46,0
Watch Kacey Musgraves’ “Biscuits” Video And Life Will Be Gravy,1,3,10,40,3,9,0,50,0
15 Ways To Not Be A Terrible Person,1,1,7,19,0,7,2,26,0
16 Things That Are Turning 16 In 2016,1,1,5,17,0,7,8,22,0
25 Genius Spaghetti Recipes You Should Know,1,1,6,29,0,6,2,35,0
Why I’m Breaking Up With the Apple Watch ,1,2,7,25,1,8,0,32,0
"In Memoriam: Shia LaBeouf's Beautiful, Gorgeous Rattail",1,1,8,38,3,6,0,46,0
Celebrity Deaths in 2016: Some of the Many Famous Figures We Lost This Year,1,3,10,47,1,13,4,57,0
China to create new economic zone outside Beijing,1,3,2,40,0,7,0,42,0
Everything You Need To Know About The Longest Movie Ever Made,1,1,11,40,0,10,0,51,0
L.A. Film Festival 2015 Showcases Diversity,1,3,6,26,2,5,4,32,0
"All you Valentine's Day haters are wrong. There, I've said it.",1,2,5,42,5,10,0,47,0
We Need To Acknowledge That Niall Is The Most Underrated Member Of One Direction,1,1,14,53,0,13,0,67,0
Quick Question: What Are Some Beauty Secrets Your Indian Mum Told You,1,1,12,45,1,11,0,57,0
"Cyclone Vardah Strikes Chennai, Kills 2 + 5 Other Major Stories From Today",1,2,10,48,2,12,2,58,0
21 Beauty Mistakes Every '00s Girl Has Made It Through,1,3,8,32,1,9,4,40,0
"The Making-Of ""Wet Hot American Summer"" Is Ninety Minutes Of Pure Joy",1,1,13,42,3,11,0,55,0
Only A Trivia Genius Can Pass This Timed True Or False Quiz,1,3,12,36,0,11,0,48,0
This Is What An Emo Teen's Life Was Like In 2006,1,1,10,23,1,10,4,33,0
Judge Napolitano: ‘Three Intel Sources’ Say Obama Looked to Brit Agency to Spy on Trump,1,3,12,58,3,14,0,70,0
What's The Weirdest Sex Toy You've Ever Seen,1,1,8,27,2,7,0,35,0
15 Ways To Work Out Harder And Actually See Results,1,1,9,31,0,9,2,40,0
Texas A&M Player Kirk Merritt's Lawyer Provides Unbelievable Reason for Indecent Exposure Accusation,1,3,13,73,2,12,0,86,0
What’s a little oil between neighbors? Venezuela-Guyana tensions flare.,1,3,3,56,4,8,0,59,0
For People Who Need More Uzo Aduba In Their Lives,1,1,10,30,0,9,0,40,0
16 Very Honest Confessions About Sexual Frustation,1,1,6,36,0,6,2,42,0
Here Are Some GIFs I Drew About Having Period Rage,1,1,12,29,0,9,0,41,0
15 surprising facts about Tesla cars you probably didn't know,1,2,1,48,1,9,2,49,0
Two Appetizers That You Must Serve At Your Thanksgiving Dinner This Year,1,1,12,49,0,11,0,61,0
Here's the electric car Mercedes is building to take on Tesla,1,3,3,47,1,10,0,50,0
Are These Harry Potter Spells Or Just Gibberish,1,1,8,32,0,7,0,40,0
The Koch brothers and the Republican Party go to war — with each other,1,2,4,52,1,13,0,56,0
Destinations 19 photographs that prove Japan is the most beautiful place on Earth right now,1,2,3,72,0,14,2,75,0
13 Kanye West Quotes As Kids Classroom Posters,1,1,7,30,0,7,2,37,0
Six women. Three nursing homes. And the man accused of rape and abuse,1,3,3,52,2,12,0,55,0
The Weeknd & NAV Are Up To Their Necks in Models in 'Some Way' Video: Watch,1,3,15,41,4,15,0,56,0
30 Things You Need To Know About David Koechner,1,1,8,29,0,8,2,37,0
Did Obama really wiretap Trump Towers?,1,3,4,28,1,5,0,32,0
23 Spicy Ways To Bring More Hot Sauce Into Your Life In 2016,1,1,11,31,0,12,6,42,0
"Which ""Friends"" Costume Should You Wear For Halloween",1,1,8,36,2,7,0,44,0
16 Cute And Practical Valentine's Gifts,1,1,5,26,1,5,2,31,0
How to flirt in a relationship,1,3,1,24,0,5,0,25,0
Star Wars: What do fans make of the trailer for The Last Jedi?,1,2,6,42,2,12,0,48,0
Here Are The Celebrities Who Joined Twitter In 2015,1,1,8,31,0,8,4,39,0
Here Are Some Very Important Writing Tips From Neil Gaiman,1,1,10,39,0,9,0,49,0
9 Of The Hottest Guys On Earth Ruined By Soul Patches,1,1,10,32,0,10,1,42,0
32 Autumn Leaf Photos That Are Almost Pornographic,1,1,7,34,0,7,2,41,0
This Author Wrote A Beautiful Handwritten Note To Herself As Inspiration,1,1,11,51,0,10,0,62,0
Cole Sprouse Has Revealed His Halloween Costume For This Year And It's Actually Perfect,1,1,14,59,1,13,0,73,0
Desperation Sets in for House Hunters in Toronto’s Red-Hot Market,1,2,8,46,2,9,0,54,0
"Next Week's Episode Of ""Keeping Up With The Kardashians"" Addresses Lamar Odom's Overdose",1,1,13,59,4,12,0,72,0
21 Vines That Are Funny Even Though They Shouldn't Be,1,1,9,32,1,9,2,41,0
I Asked My Mom For Marriage Advice And Here's What Happened,1,1,11,37,1,10,0,48,0
Bumped from a flight? Know your rights before you fly ,1,3,2,41,1,10,0,43,0
Kate Winslet Officially Wrote No Retouching Into Her L'Oreal Contract,1,1,11,48,1,9,0,59,0
Jimmy Kimmel Introduced The Most Famous Julia Roberts To A Bunch Of Civilians Also Named Julia Roberts,1,1,17,69,0,16,0,86,0
"Markelle Fultz hopes to be No. 1 pick, expects rivalry with Lonzo Ball in NBA",1,2,8,52,2,14,1,60,0
Financial Spring Cleaning: Which Employee Benefit Forms To Keep And Which To Toss,1,3,13,55,1,12,0,68,0
18 Things Everyone Who's In A Relationship With Sephora Knows To Be True,1,1,12,45,1,12,2,57,0
"13 Creepy Behind-The-Scenes Photos Of ""Edward Scissorhands""",1,1,8,39,4,6,2,47,0
The horrifying way some drug addicts are now getting their fix,1,3,1,51,0,10,0,52,0
Need To See How Climate Change Hurts Our Mother Earth? Let Google Timelapse Show You,1,3,15,54,1,14,0,69,0
This high-tech E.L.F. is guiding confused shoppers with the help of IBM's Watson,1,3,8,55,5,12,0,63,0
A Flatter Belly With Just One Move,1,3,7,21,0,6,0,28,0
Handle with care: readers' photos on the theme of tender,1,2,1,44,2,9,0,45,0
How a career in fast food could make you richer than becoming a lawyer,1,3,1,56,0,13,0,57,0
‘Global Warming is Good’ Says President Trump’s Science Guru,1,3,8,41,3,8,0,49,0
If Bad Reviews Were On Movie Posters,1,1,7,23,0,6,0,30,0
What Do You Wish You Knew Before You Went To College,1,1,11,31,0,10,0,42,0
"Police Swarm Willsboro, N.Y., in Search of Escaped Killers ",1,2,8,38,4,9,0,46,0
Revealed: The true scale of Tony Blair's global business empire,1,3,4,48,2,9,0,52,0
17 Hilarious Honest Definitions Of Sci-Fi And Fantasy Terms,1,1,9,39,1,8,2,48,0
13 Kids Who Have Wayyy More Swag Than You,1,1,8,23,0,8,2,31,0
‘Clock Boy’ Dad Vows to Appeal Tossed Case,1,3,7,26,2,7,0,33,0
13 Of The Most Sexist Ads Made In India,1,1,8,21,0,8,2,29,0
9 at-home remedies that actually work,1,2,0,30,1,5,1,30,0
How to clean your sweaty balls and prevent a smelly scrotum,1,3,1,48,0,10,0,49,0
Celebrity Weddings of 2016,1,2,2,17,0,3,4,19,0
Revenge of the Lunch Lady Credits,1,3,4,24,0,5,0,28,0
Which TV Sister Should Be Your Sister,1,1,8,23,0,6,0,31,0
Women Are Wearing Plastic Bag Onesies In Taiwan,1,1,8,32,0,7,0,40,0
Dominatrix reveals what it's like to run a sex dungeon hotel,1,3,1,48,1,10,0,49,0
17 Moments That Are Too Real For Anybody Who's Not Totally Out Of The Closet,1,1,14,45,1,14,2,59,0
'Yolocaust': How should you behave at a Holocaust memorial?,1,2,3,44,4,8,0,47,0
"44 Strange, Ridiculous, And Bizarre Things Overheard On The London Underground",1,1,10,54,2,10,2,64,0
"Lucy Barnard's bid to walk 30,000km from Argentina to Alaska includes collecting poo for Harvard",1,3,5,70,2,14,5,75,0
"USF Basketball Team Accidentally Leaves Troy Holston, Geno Thorpe at Airport",1,3,12,53,1,10,0,65,0
24 Times Denny's Completely Owned Twitter In 2015,1,1,6,29,1,7,6,35,0
We Found the Best Chocolate Truffle in the World,1,3,6,34,0,8,0,40,0
"Forget gap years and get a job in JD Sports, advises City lawyer",1,2,5,46,1,12,0,51,0
17 White Women Who Could Play Rachel Dolezal In The Inevitable Movie,1,2,11,44,0,11,2,55,0
This Pakistani Comic Book Brings The Country's Issue Of Child Marriage To Light,1,1,13,53,1,12,0,66,0
"Retirement Questions, Answered: What Those Who Are Keeping Pace Should Know",1,3,11,52,2,10,0,63,0
10 Brilliant Pieces Of Life Advice From Ryan Reynolds To His Fans,1,1,11,41,0,11,2,52,0
18 Times “Community” Snuck In Hilarious Little Jokes That You Might’ve Missed,1,2,11,50,3,11,2,61,0
21  Amazing Products Everyone Who Hates Everyone Needs To Own,1,1,9,40,0,10,2,49,0
"Zac Efron Wore A ""Bae Watch"" Shirt To ""Baywatch"" Rehearsal",1,1,10,35,4,9,0,45,0
Meet A Woman That Is Still Managing Stock Portfolios At 100-Years-Old,1,1,12,42,2,10,3,54,0
Tear Gas Attack On Hamburg Metro Affects 50,1,2,7,27,0,7,2,34,0
This Guy Celebrated A Bachelor Party Alone After The Rest Of The Wedding Party Got Stranded,1,1,16,60,0,15,0,76,0
15 Moms Whose Weird Ideas Might Just Be Genius,1,3,8,28,0,8,2,36,0
Using ‘Now’ to Get Students to Think About the Future,1,3,7,35,2,9,0,42,0
19 Things That Are Romantic In Films But Terrible In Real Life,1,1,11,38,0,11,2,49,0
People who’ve had multiple marriages confess how they REALLY feel about their divorces,1,2,7,66,1,12,0,73,0
9 Science Stories You Can't Miss: The Bad Pharma Edition,1,1,9,35,2,9,1,44,0
19 Pictures That Prove A Bin Bag Is The Greatest Halloween Costume Of All Time,1,1,14,48,0,14,2,62,0
What's Your Favorite Food Based On Your Zodiac Sign,1,1,9,33,1,8,0,42,0
23 Office Workers Who Have Perfected The Art Of Sarcasm,1,3,9,35,0,9,2,44,0
Meet The Donald Trump Of Indonesia: Another Billionaire Who Wants To Be President,1,3,13,55,1,12,0,68,0
We Know Which YA Hottie Should Be Your Boyfriend Based On Your Zodiac Sign,1,1,15,46,0,13,0,61,0
The Show That's Breaking New Ground For Queer Representation,1,1,9,42,1,8,0,51,0
"What Are Your Favorite ""Grey's Anatomy"" Relationships",1,1,7,37,3,6,0,44,0
"How professor/dad Robert Kelly realised he'd gone viral. Very, very viral",1,3,4,55,4,10,0,59,0
Can we be as happy as Scandinavians?,1,3,2,27,1,6,0,29,0
37 Science Facts We Didn't Know At The Start Of This Year,1,1,11,32,1,11,2,43,0
We tried all six new Frappuccino flavors so you don’t have to,1,3,2,47,1,11,0,49,0
"For Everyone Whose Sexual Awakening Was Caused By David Bowie In ""Labyrinth""",1,1,12,51,2,11,0,63,0
The Most Canadian Groom Ever Left His Wedding To Plow Out His Guests In A Snow Storm,1,1,17,51,0,16,0,68,0
16 Super Chill Dogs Who Love The Sun,1,1,7,20,0,7,2,27,0
Here's A Look At Disney-Pixar's New Short Film Featuring An Indian-American Family,1,1,14,53,4,11,0,67,0
Why George Osborne is itching to sell RBS,1,3,6,28,0,7,0,34,0
"28 ""New Girl"" Quotes Guaranteed To Make You Laugh Every Time",1,1,10,36,2,10,2,46,0
£18 sticks... and other signs your neighbourhood has hit Peak Gentrification,1,2,2,58,4,10,2,60,0
"14 ""Game Of Thrones"" Moments Improved By ""Star Wars"" Quotes",1,1,9,35,4,9,2,44,0
Staycationer year in review: The best and worst D.C. tourist spots I’ve visited so far,1,3,5,63,4,14,0,68,0
Who Said It: Kendall Or A Ken Doll,1,1,8,18,1,7,0,26,0
These simple badges are helping social media users talk about mental illness,1,3,1,64,0,11,0,65,0
There's a secret message buried inside Nintendo's new $60 console,1,3,2,49,3,9,2,51,0
13-Year-Old Kids Are Making Thousands Reselling Supreme Hats And Tees,1,1,11,45,2,9,2,56,0
We Know Your Zodiac Sign Based On Your Favorite Pop Star,1,1,11,35,0,10,0,46,0
"Can You Match The Quote To The ""Full House"" Character",1,1,10,32,2,9,0,42,0
You'll Sob When You Try These Yoga Poses At Home,1,1,10,28,1,9,0,38,0
What Do You Do When You Can't Fall Asleep,1,1,9,23,1,8,0,32,0
19 Tweets About Movies That Will Make You Laugh Every Time,1,1,10,36,0,10,2,46,0
What's The Funniest Tinder Bio You've Ever Seen,1,1,8,30,2,7,0,38,0
"Vanessa Hudgens' Heart-Wrenching Performance In ""Grease: Live"" Wowed Everyone",1,1,10,54,5,8,0,64,0
15 Times Indian Newspapers Messed Up In 2015,1,1,6,25,0,7,6,31,0
Humans: Everything we know about Channel 4's new series so far from the cast to that creepy Persona Synthetics ad,1,3,5,86,2,19,1,91,0
"Cheap, widely available drug could stop thousands of mothers bleeding to death",1,3,1,65,1,11,0,66,0
This One Tweet Captures Chennai's Unbreakable Spirit,1,1,7,38,1,6,0,45,0
19 Things Michiganders Know Are True,1,1,5,24,0,5,2,29,0
App Smart | Instant Photo Collages - Video - NYTimes.com,1,2,9,34,4,9,0,43,0
If I Could Speak To My Mental Disorder,1,1,8,23,0,7,0,31,0
21 Times Red Forman Was The Realest Fucker On The Planet,1,1,10,34,0,10,2,44,0
Which Extinct Animal Are You,1,1,5,19,0,4,0,24,0
High School Softball Catcher Gets Away with Leveling Pair of Baserunners,1,2,9,53,0,10,0,62,0
DJ Khaled Got Lost At Sea On His Jet Ski And Shit Got Very Real,1,1,16,33,0,14,0,49,0
19 Pieces Of Shitty Taxidermy That Sum Up Your 2015,1,1,8,28,0,9,6,36,0
We Know Which Disney Princess Your Mom Wishes You Were,1,1,10,35,0,9,0,45,0
Guyana tribe goes hi-tech to protect its land,1,3,1,36,1,7,0,37,0
35 Celebrity Photos You Didn't See On TV At The MTV EMAs,1,1,16,26,1,11,2,42,0
16 Times Club Penguin Perfectly Summed Up Being A College Student,1,1,10,43,0,10,2,53,0
@Work Advice: When a supervisor’s body odor makes meetings impossible,1,3,3,54,3,9,0,57,0
7 Crucial Photo Strategies Everyone With A Big Head Should Know,1,1,10,42,0,10,1,52,0
Kendall Jenner And Gigi Hadid Transformed This Homeless Kid Into A Hot Model,1,1,13,51,0,12,0,64,0
What Fucked Up Thing Will Happen To You This Christmas,1,1,10,35,0,9,0,45,0
How Bajirao Mastani's Flaws Make It A Perfect Tribute To Great Indian Storytelling,1,1,13,56,1,12,0,69,0
Which Marilyn Monroe Are You Based On Your Favorite Ice Cream Flavor,1,1,12,45,0,11,0,57,0
David Pogue tested 47 pill-reminder apps to find the best,1,2,2,43,1,9,2,45,0
21 Things You’ll Only Get If You’re Slightly Obsessed With True Crime,1,2,11,43,2,11,2,54,0
We Need To Talk About The Biggest Problem With Buying Things In 2015,1,1,12,40,0,12,4,52,0
The 20 best tech jobs in America right now,1,2,2,30,0,8,2,32,0
No Jail Time for Walk of Fame Trump Star Smasher,1,2,8,31,0,9,0,39,0
Can We Guess Where You're From Based On The Soda You Drink,1,1,12,34,1,11,0,46,0
10 top tips from our London correspondent,1,3,1,32,0,6,2,33,0
We Asked Non-Italians To React To Pictures Of Italian Things And This Is What Happened,1,1,16,55,1,14,0,71,0
A Japanese CEO resigned after an employee’s ‘death from overwork.’ Why it won’t be enough.,1,3,6,64,6,14,0,70,0
"There's A Place Where You Can Ride Falkor From ""The NeverEnding Story""",1,1,13,43,3,11,0,56,0
These Canadian Kids Welcoming Refugees Will Make You Feel All The Feels,1,1,12,48,0,11,0,60,0
"21 Pictures That Prove This ""Star Wars"" Stuff Is Getting Out Of Control",1,1,12,43,2,12,2,55,0
Eli Lake: Susan Rice Requested Unmasking of People Connected to Trump Transition,1,3,10,58,1,11,0,68,0
Donald Trump on Peter Thiel: ‘He’s Ahead of the Curve’,1,2,7,34,4,9,0,41,0
Church Sign Lists Patriots' Super Bowl Win Among Best Comebacks Ever,1,3,11,46,1,10,0,57,0
Monte Paschi Rescue Plan Ends With State Bailout: QuickTake Q&A,1,3,12,40,2,9,0,52,0
These Gadgets Will Make You Believe In The Future Of Food,1,1,11,36,0,10,0,47,0
12 Charts That Are Way Too Real For People Who Hate People,1,1,11,34,0,11,2,45,0
21 Big Dogs Trying Their Best To Be Brave,1,1,8,23,0,8,2,31,0
What Will Your 2016 Good Luck Symbol Be,1,1,7,21,0,7,4,28,0
We Have The Answers To 12 Of Your Most Pressing Star Wars Questions,1,1,12,41,0,12,2,53,0
9 Sex Positions To Spice Up Your Long-Term Relationship,1,1,9,36,1,8,1,45,0
"Angelica Pickles' Best 18 Lines On ""Rugrats""",1,1,6,27,3,6,2,33,0
Helen Mirren’s Instagram Is The Most Delightful Thing You’ll See Today,1,2,11,47,2,10,0,58,0
I'm Asexual But I'm Not,1,1,5,12,2,4,0,17,0
Dad Nails The Problem With Complaining About Parents Who Fly With Kids,1,3,12,47,0,11,0,59,0
"Ranveer-Deepika's New Year Plans, Salman Beats SRK And More From The World Of Entertainment",1,3,17,58,3,13,0,75,0
The 9 Celebrities Discover Their Inner Princess Puzzle,1,1,7,39,0,7,1,46,0
Lady Gaga Just Casually Slayed The JFK Airport Terminal,1,1,11,36,0,8,0,47,0
A Guide to Knowing When You Need a Professional to File Your Taxes ,1,3,10,44,0,13,0,54,0
This Uber executive sure sounds defensive about not taking the fall for Uber's harassment crisis,1,3,3,78,1,14,0,81,0
Do You Know The Disney Movie By The Food,1,1,9,23,0,8,0,32,0
'We are making science' says man as his doctor reveals plans for head transplant,1,2,1,64,2,13,0,65,0
18 Unbelievably Delicious Things You Can Do To Store-Bought Cookies,1,1,10,45,1,9,2,55,0
10 Recipes To Make As You Cry To Adele's New Album,1,1,10,27,1,10,2,37,0
Business Photos of the Month,1,3,3,21,0,4,0,24,0
39 Things They Didn't Show You On TV At The 2015 EMAs,1,1,13,22,1,11,6,35,0
31 Things All Kids Of High School Teachers Know To Be True,1,1,11,34,0,11,2,45,0
Income Tax Raid In A Bank Of Maharashtra Branch Finds Rs 10 Crore In Stashed Cash In New Notes,1,2,18,56,0,18,2,74,0
Medical drones could be the next wave of emergency response ,1,3,1,49,0,10,0,50,0
How Brown-Eyed Parents Can Have A Blue-Eyed Kid,1,1,10,28,2,7,0,38,0
Texas teacher suspended over anti-Trump stunt,1,2,2,37,1,5,0,39,0
What the French elections mean for Brexit,1,3,3,32,0,6,0,35,0
Can We Guess Your Favorite Disney Villain,1,1,7,28,0,6,0,35,0
"Donald Trump references ""Nazi Germany"" in tweet about intelligence agencies",1,2,4,60,2,9,0,64,0
Initial jobless claims unexpectedly fall,1,3,1,35,0,4,0,36,0
Someone Created A Meme Coloring Book And It’s Everything We Never Knew We Needed,1,3,14,52,1,13,0,66,0
A ‘Firefly’ Reboot Could Happen If This One Person Is On Board,1,2,12,37,2,11,0,49,0
The Hardest European Capital Cities Test You'll Ever Take,1,1,9,39,1,8,0,48,0
"Barkley: Muslims, Immigrants, LGBT People ‘Getting to Feel What Black People Feel Like Now’",1,2,16,57,5,13,0,73,0
What Are the Top-Selling Holiday Songs?,1,3,6,26,2,5,0,32,0
Steve Ballmer Serves Up a Fascinating Data Trove ,1,3,7,34,0,8,0,41,0
If The Kardashians Wrote Greeting Cards,1,1,6,28,0,5,0,34,0
28 David Cameron Pig Puns That Will Make You Squeal With Laughter,1,1,11,41,0,11,2,52,0
Former Giants player saves man from roof of burning home,1,3,2,45,0,9,0,47,0
Pope Francis Urges Immigrants to Respect ‘Local Laws and Customs’,1,3,8,46,2,9,0,54,0
"Russian Diplomat Assassin’s Sister Says Police School, Not Gulen, Radicalized Him",1,2,11,57,3,10,0,68,0
Google wants to fix tech’s diversity problem with an outpost for historically black colleges,1,2,1,77,1,13,0,78,0
Style Secrets of Southern Men,1,3,4,21,0,4,0,25,0
22 Jokes You Probably Shouldn’t Laugh At But Definitely Will,1,2,9,39,1,9,2,48,0
This is the first US delivery from Amazonâs drone publicly caught on video,1,2,4,58,2,12,0,62,0
19 Homemade Food Gifts That You Can Actually Make,1,1,8,31,0,8,2,39,0
Here Are The Biggest Moments On Twitter From 2015,1,1,8,29,0,8,4,37,0
A conspiracy theory-spreading website now has a seat in the White House briefing room,1,3,3,68,1,13,0,71,0
Which Famous Teenager Are You,1,1,5,20,0,4,0,25,0
19 Insane Platform Shoes You Need Immediately,1,1,6,31,0,6,2,37,0
Sebastian Gorka likes to be called ‘Dr. Gorka.’ He gets his way only in conservative media.,1,2,5,66,5,15,0,71,0
"How Would You Die On ""Scream: The TV Series""",1,1,10,23,3,8,0,33,0
Can We Guess Your Personality Based On Your Favorite Dog,1,1,10,37,0,9,0,47,0
Play This Drinking Game If You're Spending The Holidays With In-Laws,1,1,12,44,2,10,0,56,0
Can Star Wars: The Last Jedi rehabilitate Yoda?,1,2,7,31,2,7,0,38,0
22 Halloween Treats That Are Much More Festive Than Candy,1,1,9,37,0,9,2,46,0
16 Truths For People Who Fucking Love Naps,1,1,7,26,0,7,2,33,0
"Here's Where ""Joy"" Went Very, Very Wrong",1,1,7,23,4,6,0,30,0
Queen Bey's pregnancy is a lifeline for humanity,1,3,2,38,1,7,0,40,0
Which Popular '90s Phrase Should You Bring Back In 2016,1,1,8,31,1,9,6,39,0
11 Deeply Confused Cats In Socks,1,1,5,20,0,5,2,25,0
Brutally honest ad for a 2002 Oldsmobile brings the internet infinite joy,1,3,2,56,0,11,4,58,0
"5 things for Thursday, March 16: Travel ban, Yahoo hack, Trump budget, Syria",1,3,6,50,5,12,3,56,0
Which '00s Disney Channel Mean Girl Are You,1,1,7,26,1,7,2,33,0
How Has Your Favourite NHL Team's Logo Changed Over Time,1,1,12,34,1,9,0,46,0
25 Foolproof Ways To Impress The Ladies At The Club,1,1,9,31,0,9,2,40,0
Four Confirmation Fights That Shaped the Supreme Court ,1,3,7,40,0,8,0,47,0
Try Not To Get Angry At These 2015 Nail Polish Names,1,1,10,28,0,10,4,38,0
Ballroom Dancing: Fitness Doubles as Date Night,1,2,6,34,1,6,0,40,0
What's Your All-Time Favorite Book About The American South,1,1,10,39,2,8,0,49,0
An American who channels President Trump in the ring becomes Mexico’s biggest wrestling villain,1,3,5,76,1,13,0,81,0
Report: Nicolas Cage Offered Role of Ronald Reagan in Biopic,1,3,8,42,1,9,0,50,0
If Disney Movies Were Blaxploitation Films,1,1,6,31,0,5,0,37,0
The iPhone X: Coming in 2017?,1,2,4,14,2,5,4,18,0
"How The Killer From MTV's ""Scream"" Stacks Up Against The Movies",1,1,13,37,3,10,0,50,0
5 things Australians need to know from Apple's 2015 WWDC keynote,1,2,6,42,1,10,5,48,0
That New Year’s Resolution? Let Us Help You Stick With It ,1,3,11,34,2,11,0,45,0
A Brief History of Humankind’s Desperate Attempts to Stay Fit,1,2,8,43,1,9,0,51,0
President Obama Hits Twitter to Celebrate Legacy,1,2,6,36,0,6,0,42,0
Is Your Style Minimalist Or Eclectic?,1,2,6,25,1,5,0,31,0
TV Producer Ken Ehrlich on His Most Memorable Grammy Moments,1,3,10,41,0,9,0,51,0
22 Tumblr Posts To Remind You That Harry Potter Fans Are Hilarious,1,1,11,42,0,11,2,53,0
Marrying the man who saved my life,1,2,1,27,0,6,0,28,0
This Little Trick Will Save Your Tights From Total Destruction,1,1,10,43,0,9,0,53,0
"Chaps, is your blood type letting you down in bed? Men with A, B or AB four times more likely to suffer impotence",1,3,6,82,3,22,0,88,0
Eddie Redmayne Occasionally Pays Rent For Drama Students,1,1,8,41,0,7,0,49,0
"How I Made $20,000 More In 2016 Than I Did In 2015",1,3,9,15,2,11,13,24,0
Here's Mark Zuckerberg totally 'not' campaigning in Indiana,1,3,4,45,3,7,0,49,0
13 Things You Wish You Knew Before You Got Your Period,1,1,10,32,0,10,2,42,0
Future Provides Lively Performance of 'Incredible' on 'Ellen': Watch,1,3,7,48,5,8,0,55,0
Someone Needs To Invent This App That Plays Nickelback Songs To Stop You From Stalking Your Ex Online,1,1,18,66,0,17,0,84,0
"22 Tweets About ""Lord Of The Rings"" That'll Make You Laugh Every Time",1,1,12,40,3,12,2,52,0
27 Incredibly Wonderful Products For People Who Love Fall,1,1,8,39,0,8,2,47,0
21 People Who Embraced Being Weird In 2015,1,1,6,23,0,7,6,29,0
16 Moments Everyone Has When Bringing Your Significant Other Home To Meet Your Family,1,1,13,57,0,13,2,70,0
We Need To Talk About The Absolute Perfection That Is Tim Riggins,1,1,12,42,0,11,0,54,0
Even Donald Trump Can’t Save Twitter ,1,3,6,24,1,6,0,30,0
15 AIM Struggles All '00s Teens Will Remember,1,1,8,25,1,7,4,33,0
"These Wookiee Cookies Are The Perfect Snack For All You ""Star Wars"" Fans",1,1,13,45,2,12,0,58,0
NCAA Tournament 2017: Everything You Need to Know About the Elite Eight,1,3,12,43,1,11,4,55,0
23 Struggles People Who Don't Wear Contact Lenses Will Never Get,1,1,10,41,1,10,2,51,0
Taking Antidepressants For The First Time,1,1,6,30,0,5,0,36,0
"28 Of The Best ""Saturday Night Live"" Characters Of All Time",1,1,10,35,2,10,2,45,0
17 McDonald's International Menu Items The U.S. Needs Right Now,1,1,11,38,3,9,2,49,0
Can Living In Space Make Us Younger? An Astronaut Has Experienced Age Reversing!,1,3,13,53,2,12,0,66,0
"15 Reasons Link From ""Zelda"" Is The Perfect Man",1,1,8,27,2,8,2,35,0
How are Australia's Syrian refugees coping?,1,3,3,33,2,5,0,36,0
40 Country Songs That Defined Your Life In The Early 2000s,1,1,9,33,0,10,6,42,0
17 Photos That Are Literally You In The Morning,1,1,8,29,0,8,2,37,0
Academic group censures University of Illinois over rescinded job offer ,1,2,3,59,0,10,0,62,0
"Ladies, What Questions Do You Still Ask Your Mom",1,1,9,30,1,8,0,39,0
"After Media Witch Hunt, CNN’s Kayleigh McEnany Apologizes for Mixing Up Americans Beheaded by Terrorists",1,3,16,72,2,14,0,88,0
Which Hogwarts Houses Do These Random Disney Characters Belong In,1,1,10,46,0,9,0,56,0
Ombre-Beige Is The Season's New Nail Trend And It's Grossly Disappointing,1,1,12,48,3,10,0,60,0
Here's Why Adopting A Pet Is The Best Idea Ever,1,1,10,27,1,9,0,37,0
Three Questions To Ask Before Quitting Your Job,1,3,8,32,0,7,0,40,0
23-Year-Old Student Dies of Suffocation During Skrillex Concert in Delhi,1,1,9,50,2,9,2,59,0
12 Struggles Everyone Who Has A  Common Last Name Can Relate To,1,1,11,38,0,12,2,49,0
"Will Ferrell Is The New, Badass Santa",1,1,7,23,1,6,0,30,0
Pillows Contain Dead Bugs and Their Poop,1,3,6,28,0,6,0,34,0
11 Ridiculous Selfie Confessions,1,1,3,24,0,3,2,27,0
This Video Of Ron Swanson Drinking Whisky For 45 Minutes Is The Only Yule Log You Need,1,1,16,52,0,16,2,68,0
"Which Character From ""You, Me, And The Apocalypse"" Are You",1,1,10,35,4,9,0,45,0
NBC’s Jansing: You Have to ‘Acknowledge’ Obama Admin Was Scandal Free –There Were Just ‘Policy Differences’,1,3,17,68,7,15,0,85,0
Where In The South Should You Vacay Based On Your Zodiac Sign,1,1,12,38,0,11,0,50,0
We Took People Who Were Terrified Of Snakes And Had Them Face Their Biggest Fear,1,1,15,51,0,14,0,66,0
Everyone Should Listen To Lady Gaga's Speech On Why She Wanted To Quit Music,1,1,14,48,1,13,0,62,0
"Mexican newspaper slams American Spring Breakers for ""shocking"" Build that Wall chant",1,3,6,66,2,11,0,72,0
"Which Character From ""Dance Academy"" Are You",1,1,7,29,2,6,0,36,0
Can you spot the snake hiding in this photo?,1,2,1,34,1,8,0,35,0
What Kind Of Pop-Tart Matches Your Personality,1,1,8,31,1,6,0,39,0
How Trump’s Calls to World Leaders Are Upsetting Decades of Diplomacy ,1,2,9,49,1,11,0,58,0
Here's Alton Brown's Trick For Cooking Pasta Perfectly,1,3,8,37,2,7,0,45,0
People Stuck Their Arms In A Hole And Blindly Let A Tattoo Artist Ink Them,1,1,15,45,0,14,0,60,0
Are Short Men More Likely to Go Bald? [Video],1,3,8,26,3,8,0,34,0
19 Passive Aggressive Notes That Deserve A Damn Medal,1,1,8,35,0,8,2,43,0
Seahawks running back Marshawn Lynch stars in 'Call of Duty: Black Ops III',1,3,10,50,3,12,0,60,0
17 Limited-Edition Beauty Products You Need To Buy ASAP,1,3,12,32,1,8,2,44,0
"How Well Do You Remember The Lyrics To ""No Scrubs""",1,1,10,29,2,9,0,39,0
21 Insanely Colorful Meals That Are Healthy AF,1,1,8,29,0,7,2,37,0
I wrote this Rachel Dolezal headline. Here are 14 others you’ll probably read today.,1,3,4,62,3,13,2,66,0
This Is What Life Looks Like When You Owe Your Entire Life In Student Loan Debt,1,1,16,48,0,15,0,64,0
You Have To See This Guy's Sweet Reaction To Finding Out He's Going To Be A Dad,1,1,17,44,2,16,0,61,0
Apple Pay is about to get much better - Business Insider,1,3,4,41,1,10,0,45,0
Can We Tell What The Best Part Of Your 2016 Will Be,1,1,11,25,0,11,4,36,0
Which Taylor Swift Song Is Actually About Your Life,1,1,9,34,0,8,0,43,0
18 Confessions About Proposals That Will Make You Glad You're Single,1,1,10,45,1,10,2,55,0
What Carb Are You,1,1,4,10,0,3,0,14,0
"Which Hogwarts Houses Do These ""American Horror Story"" Characters Belong In",1,1,11,52,2,10,0,63,0
This Orangutan Rolling On The Ground Laughing Will Make Your Fucking Day,1,1,12,49,0,11,0,61,0
The Trouble With Disney’s Remake Machine,1,2,6,28,1,5,0,34,0
21 Animals Who Are Just As Embarrassing As Your Mom,1,1,9,31,0,9,2,40,0
"These Youth Football Players Quit Their Game To Do The ""Whip/Nae Nae""",1,1,13,42,3,11,0,55,0
"What Comes After ""Fear The Walking Dead""",1,1,7,25,2,6,0,32,0
24 Annoying Things Only Hairy Girls Will Understand,1,1,7,35,0,7,2,42,0
Never Forget Hilary Duff Once Sucked A Dude's Thumb In A Music Video,1,1,13,42,1,12,0,55,0
NYC Man Who Allegedly Pushed an Army Veteran into Oncoming Traffic Charged with Murder,1,2,13,60,0,13,0,73,0
Why Google's Valentine's Day game is a lot darker than you think,1,2,4,47,2,11,0,51,0
Taylor Swift's Birthday Message To Ed Sheeran Is Probably The Cutest Thing Ever,1,1,13,53,1,12,0,66,0
Priyanka Chopra's Accent Is Helping Me Solve My Biggest Identity Crisis,1,1,11,49,1,10,0,60,0
11 celebrities who've made cameo appearances in Neighbours,1,3,1,47,1,7,2,48,0
Paraplegic man and fiancée's creative pregnancy announcement goes viral,1,3,1,61,1,8,0,62,0
This Is What It Looks Like To Graduate 79 Years Late,1,1,10,30,0,10,2,40,0
Watch Kendall And Kylie Jenner Pretend To Do Karaoke In A Friend's Music Video,1,1,14,50,1,13,0,64,0
Guy Friends Get Naked And Bare All,1,1,7,21,0,6,0,28,0
"Attention, Texas Transplants: H-E-B Is Now Selling Its Products Online",1,1,12,45,4,9,0,57,0
21 times Adele slayed beyond all expectations in 2016,1,3,1,38,0,8,6,39,0
This 'Save The Boy Child' Campaign Is Every Grain Of Truth That Our Society Needs To Learn,1,3,17,55,2,16,0,72,0
Deshaun Watson allegedly asked to leave Tuscaloosa bar,1,3,3,44,0,7,0,47,0
We Know What Popular Song You Hate Based On One Question,1,1,11,35,0,10,0,46,0
People Came Together To Help A Widowed Old Man Find A Fishing Buddy And It’s So Touching,1,3,17,54,1,16,0,71,0
Photos: The Scooter From The Who’s ‘Quadrophenia’,1,3,7,32,4,6,0,39,0
People Are Proving No Dick Is Too Big By Dropping Condoms On Their Heads,1,1,14,45,0,13,0,59,0
"Which Moment From ""The Simpsons"" Always Makes You Ugly Cry",1,1,10,37,2,9,0,47,0
Can You Guess The Numbers Missing From These Book Titles,1,1,10,37,0,9,0,47,0
Little Mix Just Shut Down Body-Shamers In The Most Perfect Way Possible,1,1,13,46,1,11,0,59,0
19 Pictures Non-Bitchy People Will Never Understand,1,1,7,35,1,6,2,42,0
Report: Megyn Kelly to Kick Off NBC Show with Kardashian Family Interview,1,3,12,49,1,11,0,61,0
"The Entire Original Cast Just Signed On For The ""Trainspotting"" Sequel",1,1,11,47,2,10,0,58,0
All The Looks At The 2016 Golden Globes,1,1,7,21,0,7,4,28,0
"After Her Wedding Was Canceled, A Bride's Family Turned Her Reception Into A Feast For The Homeless",1,1,17,64,2,16,0,81,0
"Drop Everything And Google ""A Long Time Ago In A Galaxy Far Far Away""",1,1,14,40,2,13,0,54,0
23 Things You’ll Only Get If You’re 50% Hella Organised 50% Hot Mess,1,2,10,36,4,12,6,46,0
"This ""Star Wars"" Fan Theory About Kylo Ren Is Perfect",1,1,10,32,2,9,0,42,0
24 Perfectly Romantic Wedding Songs For Twentysomethings,1,1,6,42,0,6,2,48,0
Chipotle Actually Isn't That Good,1,1,5,23,1,4,0,28,0
21 Pumpkin Recipes To Get You In The Fall Spirit,1,1,9,28,0,9,2,37,0
"This teenager used to walk miles to work to take care of his mother, then everything changed The list",1,3,2,80,1,18,0,82,0
Get Organized To Get Moving -- Here's How,1,3,7,24,3,7,0,31,0
Johnny Manziel offers Donald Trump advice before deleting Twitter account,1,3,5,59,0,9,0,64,0
It's a hard life: readers' pictures of sleeping pets,1,2,1,40,3,8,0,41,0
7 Healthy Eating Tricks That Are Actually Realistic,1,1,7,36,0,7,1,43,0
"OMG, This Genius Inflatable Mattress Will Save You So Much Money Forever",1,1,14,46,1,11,0,60,0
"Woman slashed Trump sign in Florida because it 'ruined her chill,' cops say ",1,3,3,57,3,13,0,60,0
That Emotional Advice Kid kept Jimmy Fallon in stitches during their interview,1,3,6,61,0,11,0,67,0
What Matching Tattoo Should You Get With Your BFF,1,1,11,30,0,8,0,41,0
"Despite the negative stigma, payday loans are not much different from credit cards",1,3,1,68,1,12,0,69,0
What's Your Horoscope For The Week Of Oct. 19,1,1,8,25,2,8,2,33,0
17 Easy Weeknight Pastas That Don't Have Any Dairy,1,1,8,31,1,8,2,39,0
16 Of The Most Embarrassing Stories About Sex,1,3,7,29,0,7,2,36,0
"Kim Kardashian called the flu 'an amazing diet' and, well, you can guess what happened",1,3,2,66,4,14,0,68,0
How Trump ended Democrats' 144-year winning streak in one county,1,3,3,47,2,9,3,50,0
Forgot about Dray? Green does it all in Warriors' Game 1 triumph,1,3,5,45,2,11,1,50,0
"Bizarre Court Case Puts a Violinist, and Leipzig String Quartet, in an Unflattering Light ",1,3,10,64,2,14,0,74,0
Secrets of Disney World performers revealed in longtime Goofy's AMA,1,2,7,50,1,9,0,57,0
"The 10 Most Iconic Sessions Of ""Carpool Karaoke"" With James Corden",1,1,10,42,2,10,2,52,0
27 things you didn't know your iPhone could do,1,3,1,34,1,8,2,35,0
"23 Times Dr. Lance Sweets Was The Best Character On ""Bones""",1,1,10,34,3,10,2,44,0
Viewpoint: Is inequality about to get unimaginably worse?,1,3,2,46,2,7,0,48,0
25 Signs BodyPump Is Rapidly Taking Over Your Life,1,1,9,31,0,8,2,40,0
Can You Name The John Green Book By Just The Cover Art,1,1,12,31,0,11,0,43,0
"Students Denounced as ‘Racist’ For Wearing Red, White and Blue Clothing at Basketball Game",1,3,11,63,3,13,0,74,0
"American Pharoah Lands on Sports Illustrated Cover, and It's Incredible",1,2,8,52,2,9,0,60,0
How Creepy Was Terrence Howard's Kiss At The Emmys,1,1,9,32,1,8,0,41,0
"18 Reasons Rose Tyler Was Undeniably The Best Companion On ""Doctor Who""",1,1,11,45,2,11,2,56,0
"A New Series Of ""Serial"" Has Unexpectedly Arrived",1,1,8,32,2,7,0,40,0
I became my mother-in-law's carer - but I just couldn't handle the stress of the job,1,3,2,62,5,15,0,64,0
Fake News: AP Touts Anti-Trump Poll with Warped Demographics Conducted by Soros-Backed Org,1,3,14,61,3,12,0,75,0
"‘Orange Is the New Black’: Slow days at Litchfield, as Season 3 marks time",1,3,7,49,4,13,1,56,0
Maher: ‘Trump’s Stormtroopers’ Are Pulling 16-Year-Olds Out of Classrooms To Deport Them,1,3,12,57,6,11,2,69,0
"Here's What The Cast Of ""Hey Dude"" Looks Like Now",1,1,10,27,3,9,0,37,0
12 Hilarious Holiday Stock Photos That Make No Sense At All,1,1,10,37,0,10,2,47,0
The 54 Absolute Worst Things About Fall,1,1,6,25,0,6,2,31,0
Can You Get Through This Post Without Relating To It,1,1,10,33,0,9,0,43,0
Walmart is reportedly about to buy the hottest men's clothing brand,1,2,1,55,1,10,0,56,0
Trump's Links To Convicted Felon Who Stabbed A Man With A Margarita Glass Just Got Weirder,1,3,16,58,1,15,0,74,0
7 Inanimate Objects That Are Actively Plotting Against Us,1,1,8,40,0,8,1,48,0
Global Colleges Ranked by Subject,1,3,4,25,0,4,0,29,0
"Superman And Lois Lane Get It On In The ""Batman V. Superman"" Trailer",1,1,13,40,3,12,0,53,0
'Vanpacker' tourists irk councils on Australia's coast,1,3,2,43,3,6,0,45,0
The biggest surprises and snubs of the 2017 Oscar nominations,1,3,2,46,0,9,4,48,0
The Dude Who Followed His Girlfriend Around The World Just Photographed Their Wedding Perfectly,1,2,14,68,0,13,0,82,0
This Marathon Couple Found The Mystery Woman Who Photographed Their Engagement,1,1,11,57,0,10,0,68,0
Boy discovers new planet | GrindTV.com,1,3,4,27,2,5,0,31,0
"How ""Friday Night Lights"" Was Your High School Experience",1,1,9,38,2,8,0,47,0
George Clooney Reveals Which Baby Names Amal Has Already Shot Down,1,3,11,45,0,10,0,56,0
This Teen Brought Her Stepdad To Tears With Surprise Christmas Gift,1,2,11,46,0,10,0,57,0
10 Cities Where Workers Will Earn The Least In 2017,1,3,8,28,0,9,6,36,0
This Is How You Make Healthy Cauliflower Fried Rice,1,1,9,34,0,8,0,43,0
US Man Charged With Hate Crime For Thrashing Indian Origin Man 'Mistaking Him For A Muslim',1,3,17,57,2,15,0,74,0
Agatha Christie festival to host cookery demonstration with poisonous twist,1,3,2,64,0,9,0,66,0
Ten Incredible Pictures That Showcase Astronomy's Future,1,3,7,42,1,6,0,49,0
10 things to watch on national signing day,1,2,0,33,0,7,2,33,0
8 Of The World's Most Stylish Hotels - From Mexico To Paris,1,3,10,35,2,11,1,45,0
"4 Soft Skills You Need To Work On, And Why",1,3,9,22,1,9,1,31,0
Take The BuzzFeed Five-Day Inbox Cleanse And Stop Hating Your Email,1,1,13,43,1,10,0,56,0
The very messy psychology of the awkward personal text,1,3,1,45,0,8,0,46,0
These Are the Happiest and Healthiest Cities in America,1,2,6,41,0,8,0,47,0
"Which Hogwarts Houses Do The Characters Of ""Brooklyn Nine-Nine"" Belong In",1,1,12,48,3,10,0,60,0
Nicki Minaj's Latest Selfie Comes With An Amazing Inspirational Message,1,1,10,51,1,9,0,61,0
"15 Things That Happen When People Think You Don't ""Look Latina""",1,1,10,38,3,10,2,48,0
21 Wicked Ways To Trick People Into Eating The Best Candy Ever,1,1,11,38,0,11,2,49,0
Triple H endorses Joel Embiid for All-Star Game,1,3,7,32,1,7,0,39,0
ADHD Is Loyle Carner’s Superpower,1,3,8,20,1,4,0,28,0
25 Times Rainn Wilson Was Seriously Hysterical On Twitter,1,1,8,39,0,8,2,47,0
10 Reasons The Starbucks Red Cup Is The Most Magical Thing Ever,1,1,11,39,0,11,2,50,0
16 Tweets That Sum Up The Lengths You Would Go To Avoid Other People,1,1,13,40,0,13,2,53,0
Watch One Woman Transform Into 7 Disney Characters In 90 Seconds,1,1,9,42,0,10,3,51,0
34 Memes You'll Only Understand If Cats Rule Everything Around You,1,3,10,43,1,10,2,53,0
Commuters Left Shocked As Someone Played Porn On LED Screen At Delhi's Rajiv Chowk Metro Station,1,3,18,62,1,15,0,80,0
Who Will You Vote For In The 2024 Presidential Election,1,1,9,33,0,9,4,42,0
Waters: We Have to ‘Do the Investigation’ to Find Evidence to Impeach Trump,1,3,9,51,3,12,0,60,0
Louis C.K. Accused of Plagiarizing SNL ‘Birthday Clown’ Skit (Video),1,3,12,41,6,9,0,53,0
Aziz Ansari's Instagram Post About His Dad Will Make You Cry,1,1,11,38,1,10,0,49,0
England Wants Football Fans To Sing French National Anthem This Week,1,1,11,47,0,10,0,58,0
We Know Which Disney Song You Are,1,1,7,20,0,6,0,27,0
Cambodia breast milk: The debate over mothers selling milk,1,3,2,47,1,8,0,49,0
23 Insanely Clever Responses To Ex Texts,1,1,6,26,0,6,2,32,0
This restaurant will pay you to eat soup if temperatures fall below zero,1,3,1,59,0,12,0,60,0
Modern Relationship Struggles,1,1,3,24,0,2,0,27,0
22 Hilarious Tweets About Being Exhausted All The Time,1,1,8,36,0,8,2,44,0
Eaglet Hatches on Camera: What Are Its Chances of Survival?,1,2,8,40,2,9,0,48,0
"Are You Warm-Hearted Or A Cold, Hard Bitch?",1,2,9,24,3,7,0,33,0
#ChickenTweet As Motivational Posters,1,1,5,28,1,3,0,33,0
Here's How Bollywood Dressed Up For Halloween,1,1,7,31,1,6,0,38,0
Fake News: Family Didn’t ‘Flee Town’ over Breitbart Story That Doesn’t Mention Them,1,3,12,54,5,12,0,66,0
19 Insanely Delicious Nutella Treats To Blow Your New Year's Diet On,1,1,11,43,1,11,2,54,0
George And Amal Clooney Adopted The Cutest Dog Ever,1,1,9,34,0,8,0,43,0
Build Your Ideal Boyfriend And We'll Guess Your Favorite Starbucks Drink,1,3,11,50,1,10,0,61,0
Who Said It: Taylor Swift Or Dr. Phil,1,1,8,20,2,7,0,28,0
Curt Schilling: I’d Be Voted in MLB HOF if I Said ‘Lynch Trump’,1,2,15,32,4,12,0,47,0
We Know What Kind Of Instagram Photo You Last Posted,1,1,10,33,0,9,0,43,0
Can You Identify The British Regional Accent,1,1,7,31,0,6,0,38,0
17 Gifts You Just Know Scully's Given Mulder On His Birthday,1,1,10,37,1,10,2,47,0
How Many Of These 15 Weird Boob Habits Do You Actually Do,1,1,11,33,0,11,2,44,0
5 Lightning headphones to stuff in the stockings of iPhone 7 owners,1,3,2,52,0,11,2,54,0
This Dog Accidentally Ran A Half-Marathon And Placed Seventh,1,1,10,41,1,8,0,51,0
"Susan Buffett reveals the surprising way she found out that her dad, Warren Buffett, was rich",1,3,4,72,2,15,0,76,0
Why are we so passionate about the smiling poop emoji?,1,2,1,43,1,9,0,44,0
17 Desserts Guaranteed To Turn You Into A Chocoholic,1,1,8,34,0,8,2,42,0
Gitmo Board Approves Release of Al-Qaeda Bomb Maker,1,3,8,35,1,7,0,43,0
56 Thoughts I Had While I Was Being Ghosted,1,1,8,25,0,8,2,33,0
I Bet You Can't Figure Out Which Gwen Stefani Is Younger,1,1,11,34,1,10,0,45,0
9 Celebrities As Zombies And Some Undead Fiction,1,1,7,33,0,7,1,40,0
What Everyone Thinks When They Text And Drive,1,1,8,30,0,7,0,38,0
Musk’s Surprise Rapport With Trump Means 40% Rally for Tesla,1,3,8,39,2,9,2,47,0
Jose Bautista Offered Prizes For Dressing Up Like Him And People Went All Out,1,1,14,50,0,13,0,64,0
26 Pictures Guaranteed To Make You Laugh Every Time,1,3,8,33,0,8,2,41,0
Stone Cold Steve Austin Tries Fancy Cocktails For The First Time,1,1,11,43,0,10,0,54,0
15 Of The Hardest Relationship Questions That’ll Really Make You Think,1,2,10,47,1,10,2,57,0
Who pays what? ATO names large companies that paid zero tax in 2014-15,1,3,4,46,2,12,6,50,0
New space pics show off the greatest kitten toe beans in all the universe,1,2,1,59,0,13,0,60,0
19 Things You Never Knew About Tattooing Celebrities,1,3,7,36,0,7,2,43,0
PLEASE STOP SUBTWEETING,1,1,21,0,0,2,0,21,0
Which J.Lo Song Are You,1,1,6,12,1,4,0,18,0
Drake Got A New Tattoo In Honor Of Toronto,1,1,9,25,0,8,0,34,0
Why December is the best time to get fit - and the perfect party season exercise plan,1,3,2,66,1,16,0,68,0
21 Pressing Concerns Australians Have About American Food,1,1,7,41,0,7,2,48,0
"Tahir Shah Leaves Pakistan, Kareena-Saif Officially Introduce Baby Taimur & More From Ent",1,2,13,61,3,12,0,74,0
19 Thanksgiving Dips That Will Feed A Crowd,1,1,7,27,0,7,2,34,0
Are You More Target Or Walmart,1,1,6,19,0,5,0,25,0
19 Actually Stylish Men To Follow On Instagram,1,1,7,30,0,7,2,37,0
VIDEO: French Police Flee Armed Mob as Week-Long Paris Riots Spread to City Centre,1,3,17,50,2,13,0,67,0
27 Adorable Giraffe Products You Need In Your Life,1,1,8,32,0,8,2,40,0
We Know Your Favorite '90s Movie Based On The First Letter Of Your Name,1,1,13,42,1,13,2,55,0
How Well Do You Know The Countries of Africa,1,1,8,28,0,8,0,36,0
"Dieselgate: 13 VW Managers Indicted Around The World, Big Guys Unbothered",1,3,11,48,2,10,2,59,0
41 incredible museums to visit before you die,1,3,0,36,0,7,2,36,0
How an Entrepreneur Made Time to Be Healthy,1,3,6,30,0,7,0,36,0
"What A Gender-Swapped ""Harry Potter"" Would Really Look Like",1,1,10,38,3,8,0,48,0
Can You Identify These Movies Based On The Main Character's BFF,1,1,13,39,1,10,0,52,0
19 Things That Happen When Your BFF Is Basically Your Sister,1,1,12,36,0,10,2,48,0
Even a Democratic congressman has to answer for Trump,1,3,3,42,0,8,0,45,0
Can You Pick The Right Slice Of Pizza,1,1,8,22,0,7,0,30,0
Why The Internet Thinks Anime And Bad Photoshop Can Beat ISIS,1,1,14,37,0,10,0,51,0
12 gifts the modern gentleman actually wants this year,1,3,0,44,0,8,2,44,0
What you’d need to earn in every state to rent a decent apartment,1,2,1,51,1,12,0,52,0
The truth about the uninsured rate in America,1,3,2,36,0,7,0,38,0
23 Mums Who Took Snapchat A Little Too Far,1,1,8,24,0,8,2,32,0
"26 Tumblr Posts About ""Star Wars"" Guaranteed To Make You Laugh",1,1,10,38,2,10,2,48,0
99 Thoughts Everyone Has When They Swim One Mile,1,1,8,30,0,8,2,38,0
This Cursing Coloring Book Is Fucking Brilliant,1,1,7,34,0,6,0,41,0
WATCH: Girls from Viral 'Missing Legs' Photo Explain the Mystery  Insider,1,3,13,46,3,11,0,59,0
Which Dunder Mifflin Employee Are You Based On Your Zodiac Sign,1,1,11,42,0,10,0,53,0
La Raza in WaPo: Trump Immigration Orders Like ‘Slave Trade’,1,3,10,38,3,9,0,48,0
Sanders: Obama’s Wall Street Speech ‘Unfortunate’,1,3,6,34,4,5,0,40,0
Will Kim Kardashian’s Robbers Reveal the Location of Her Ring?,1,3,8,43,2,9,0,51,0
19 Pictures That Prove Drunk You Is An Actual Genius,1,1,9,32,0,9,2,41,0
Kristaps Porzingis Gets Revenge on Dwight Howard with 1-Handed Poster Dunk,1,3,9,53,1,10,1,62,0
100 Women 2016: Russian doping whistleblower gives rare interview,1,3,2,47,1,8,7,49,0
"The ideal hair to beard (length) ratio, according to top London stylists",1,3,2,56,3,11,0,58,0
"How Well Do You Actually Remember The ""Home Alone"" Booby Traps",1,1,11,39,2,10,0,50,0
Avian flu taking a bite out of McMuffin availability? ,1,2,3,41,1,9,0,44,0
What Cole Swindell and 'The Bachelor' Have In Common,1,3,8,34,2,8,0,42,0
"Are These Reviews From ""Street Fighter V"" Or Another Fighting Game",1,1,11,43,2,10,0,54,0
Sania Mirza Was Just Congratulated By One Of The Greatest Tennis Players Of All Time,1,1,15,55,0,14,0,70,0
If Young Adult Book Titles Were Honest,1,1,7,25,0,6,0,32,0
Here's What Happens When Tomboys Wear Dresses For A Week,1,1,10,36,1,9,0,46,0
14 Deliciously Insane Ways To Celebrate National Cheeseburger Day,1,1,8,47,0,8,2,55,0
Why Rapper Young M.A Is Not Signing A Record Deal--For Now,1,3,13,32,3,10,0,45,0
How Much Extra Beer and Pizza You Consume During March Madness,1,2,10,42,0,10,0,52,0
Turley: Trump Making Same Arguments as Obama in Defense of Immigration Executive Order,1,3,10,63,1,12,0,73,0
What Should Your Last-Minute Halloween Costume Be Based On Three Questions,1,1,12,51,1,10,0,63,0
Were There Any Real Winners at the Grammys? ,1,3,6,29,1,8,0,35,0
15 Household Items You Need To Replace Right Now,1,1,8,30,0,8,2,38,0
"What is Drake’s More Life: a mixtape, an album or a playlist?",1,3,4,42,4,11,0,46,0
Were You A Disney Or Nickelodeon Kid,1,1,7,23,0,6,0,30,0
Street Artist Depicts Caitlyn Jenner as ‘It’ Clown in Posters Outside Fox Studio,1,3,11,55,2,12,0,66,0
Hep Alien Performed The “Gilmore Girls” Theme Song And It Was Perfect,1,3,12,44,2,11,0,56,0
'Spy from suburbia': Pensioner's secret life revealed after bomb scare,1,2,2,55,4,9,0,57,0
What I’m really thinking: the professor’s wife,1,3,2,35,3,6,0,37,0
16 Pets Who Are Already Over Christmas,1,3,6,24,0,6,2,30,0
What It Was Like Being A New York Mets Fan In 2015,1,1,11,24,0,11,4,35,0
Inside the Minds of the Ultrawealthy ,1,2,3,28,0,6,0,31,0
"Risky behavior declines with age, and gray matter may explain why",1,3,1,53,1,10,0,54,0
24 Orange Cats Just Being Their Adorable Selves,1,1,7,31,0,7,2,38,0
Priest Reportedly Suspended For Riding A Hoverboard During Mass,1,1,9,46,0,8,0,55,0
21 Supporting TV Characters Who Might Even Be Better Than The Main Characters,1,1,13,50,0,12,2,63,0
Community Episode 1: Ladders [Video],1,3,4,24,3,4,1,28,0
21 Reasons Spanish Is The World’s Weirdest Language,1,3,7,34,1,7,2,41,0
These Pretzel Bites Are Dippable AF,1,1,7,23,0,5,0,30,0
19 Incredibly Satisfying Pictures For People Who Really Love Eyeliner,1,1,9,49,0,9,2,58,0
This Word Association Test Will Tell You If You're More Realistic Or Idealistic,1,1,13,53,1,12,0,66,0
How To Avoid Credit Card Debt This Holiday Season,1,3,9,32,0,8,0,41,0
Gwendoline Christie Showed Up To The Emmys Looking Like A Literal Goddess,1,1,12,50,0,11,0,62,0
Is Australia on the brink of becoming a completely cashless society?,1,3,2,55,1,10,0,57,0
Golden Globes 2017: TV Snubs and Surprises ,1,3,6,25,1,7,4,31,0
10 Underrated Cities Where Millennials Can Actually Buy Homes,1,3,8,43,0,8,2,51,0
27 Things That Christmas-Obsessed Parents Need Right Now,1,1,8,38,1,7,2,46,0
"Krauthammer: Timing of Russia Sanctions ‘Ridiculous,’ Obama Actions ‘Adolescent’",1,3,8,58,6,8,0,66,0
These states will take the most money out of your paycheck,1,3,1,47,0,10,0,48,0
Report: Iran Violating Nuclear Deal with Secret Development Near ‘Off-Limits’ Parchin Site,1,3,12,63,4,11,0,75,0
Syria: Here's what you need to know about Trump's strike on air base,1,2,3,50,3,12,0,53,0
Climate 25 - The Weather Channel,1,2,4,20,1,5,2,24,0
How Russia's YouTube generation is getting its news,1,3,4,39,1,7,0,43,0
Soros-Funded Groups Back Anti-Trump Women’s March,1,3,8,33,3,5,0,41,0
17 Videos That Made You Sob At Your Desk In 2015,1,1,9,23,0,10,6,32,0
25 Delicious Thanksgiving Desserts That Go Easy On The Sugar,1,1,9,40,0,9,2,49,0
9 Halloween Costumes That Don't Actually Require A Costume,1,1,8,40,1,8,1,48,0
KFC's Colonel Sanders As A Unicorn Will Either Ruin You Or Give You Life,1,1,16,42,1,13,0,58,0
This Woman Unknowingly Photographed Her Own Engagement,1,1,7,41,0,6,0,48,0
This Quiz Will Brighten The Crap Out Of Your Day,1,1,10,29,0,9,0,39,0
This New Treatment Could Make Your Cells Look Young Again,1,3,10,38,0,9,0,48,0
Baby remains found in 'underground chambers' beneath former home for unmarried mothers in Ireland,1,2,2,80,2,13,0,82,0
17 Words That Have A Different Meaning When You Really Love Halloween,1,1,11,45,0,11,2,56,0
"Sonu Nigam Tweets About Morning Azaan On Loudspeakers, Faces Backlash For Calling It ‘Forced Religiousness’",1,3,15,75,3,14,0,90,0
21 Times You Used To Call Me On My Cell Phone,1,1,10,23,0,10,2,33,0
13 Simple Little Things To Try If You're Having Trouble Sleeping,1,1,10,41,1,10,2,51,0
Was this murderous attack on a Russian diplomat revenge for Turkey's dirty deal with Putin? ,1,2,4,71,2,15,0,75,0
"What Hogwarts Houses Are The Characters Of ""Gilmore Girls"" In",1,1,10,40,2,9,0,50,0
HuffPost Headline Quiz: Dec. 30 to Jan. 5,1,3,6,22,3,7,3,28,0
MSNBC’s Ruhle: Conway ‘Did Break the Glass Ceiling’,1,2,11,29,4,7,0,40,0
Show Us Your Health And Fitness-Inspired Tattoos,1,1,8,33,1,6,0,41,0
17 Real-Life Confessions From Taxi Drivers That Will Give You So Many Feels,1,1,13,47,1,12,2,60,0
"Do You Remember The Hogwarts House Of These Minor ""Harry Potter"" Characters",1,1,12,50,2,11,0,62,0
People Talk About Their First Therapy Session,1,1,7,32,0,6,0,39,0
23 Products Everyone Who Hates Everyone Needs To Own,1,2,8,34,0,8,2,42,0
DBS BankVoice: How To Live Luxe For Less,1,3,11,21,1,7,0,32,0
24 unprofessional habits that could cost you a job,1,3,0,40,0,8,2,40,0
Children As Young As 13 Are Now Attending Smartphone Rehab Centres To Cure Their Addiction,1,2,14,60,0,14,2,74,0
Anna Soubry: 'I'll never forgive Boris Johnson' – video,1,3,5,37,5,8,0,42,0
Can You Pick The Best Secret Santa,1,1,7,21,0,6,0,28,0
'You don't belong here' - solicitor caught on film launching racist attack on woman and her young son,1,2,1,79,4,17,0,80,0
"Yes, Your Birth-Control Pills Really Might Be Making You Feel Awful, Study Says",1,2,14,50,3,12,0,64,0
‘We all came alive in that moment’: Watch a victorious boy celebrate the end of his chemotherapy,1,3,2,75,3,16,0,77,0
Which Drake Album Matches Your Personality,1,1,6,31,0,5,0,37,0
What's Your Fall Romance Forecast,1,1,5,23,1,4,0,28,0
21 Three-Ingredient Snacks To Make For Thanksgiving That Are Easy AF,1,1,12,43,1,10,2,55,0
22 Totally Real And Totally Hilarious Ways Things Got Their Name,1,3,10,42,0,10,2,52,0
7 Reminders of How Ridiculous the XFL Was,1,3,7,26,0,7,1,33,0
13 Awkward Moments When You Have Depression And Anxiety,1,1,8,37,0,8,2,45,0
4 Solutions to Common Tax Issues,1,3,4,22,0,5,1,26,0
What your views on Russia and Islam say about your politics,1,2,3,46,0,10,0,49,0
This Color Blot Test Will Determine What Your Subconscious Is Obsessed With,1,1,12,52,0,11,0,64,0
What Are Some Misconceptions About OCD,1,1,8,25,0,5,0,33,0
This Aggressive Ad For Trump's '90s Game Show Seems Just Like His Campaign,1,3,12,46,2,12,2,58,0
21 Ridiculously Cool Gifts College Students Never Knew They Needed,1,1,9,46,0,9,2,55,0
25 Times Ed Miliband Blessed Us In 2015,1,1,6,20,0,7,6,26,0
10 Swoonworthy Recipes That Seem Fancy But Are Actually Easy To Make,1,1,11,44,0,11,2,55,0
21 Confessions Of A Southerner Going To School In The North,1,1,10,37,0,10,2,47,0
"How Well Do You Actually Know ""The Addams Family""",1,1,9,30,2,8,0,39,0
Samantha Bee Created A Rape Threatline For Trolls And It's Genius,1,1,11,43,1,10,0,54,0
These Women Hurt Their Vaginas While Biking,1,1,7,30,0,6,0,37,0
OurMine just combined hacking and debunking to dispel a fake Britney Spears death tweet,1,3,4,70,0,13,0,74,0
Toddler's misunderstanding inspires the perfect New Year's family tradition,1,3,3,62,2,8,0,65,0
Build A Bowl Of Mac ‘N’ Cheese And We’ll Guess How You Like To Have Sex,1,2,16,37,3,15,0,53,0
"Kim Kardashian And Tracee Ellis Ross Playing ""Never Have I Ever"" Is Unexpectedly Hilarious",1,1,14,61,2,13,0,75,0
Selena Gomez Reveals She Underwent Chemotherapy When People Thought She Was In Rehab,1,1,13,59,0,12,0,72,0
Build A Bowl Of Mac ‘N’ Cheese And We’ll Guess How You Like To Have Sex,1,3,16,37,3,15,0,53,0
Masters chairman explains the tournament's infamous cell-phone policy and vows to never change it,1,3,1,81,2,13,0,82,0
18 Real-Life Optical Illusions That Will Leave You Shook,1,3,9,36,1,8,2,45,0
A treasure hunter found 3 tons of sunken gold — and can’t leave jail until he says where it is The list,1,3,2,77,2,21,1,79,0
What Your Family On Facebook Needs To Hear,1,1,8,27,0,7,0,35,0
21 Things You Could Stand To Appreciate A Little More,1,1,9,33,0,9,2,42,0
Chilaquiles Are The Greatest Food Ever And You Should Try It,1,1,11,39,0,10,0,50,0
"If You Takes Photos And Shoot Videos Instead Of Helping Accident Victims, May Be You Need To Be Punished",1,2,19,66,1,18,0,85,0
What is it like to live next to a prison?,1,2,1,30,1,9,0,31,0
You Can Watch Shia LaBeouf Watch All His Movies,1,1,10,29,0,8,0,39,0
What Does Your Choice Of Whiskey Say About You,1,1,9,29,0,8,0,38,0
15 things successful people do over holiday breaks,1,3,0,41,0,7,2,41,0
21 Songs Every ’90s Girl Still Knows By Heart,1,3,7,25,1,8,4,32,0
They’ll be home for Christmas: Five homeless children get a holiday surprise,1,3,3,60,2,11,0,63,0
Ranking All 124 Episodes Of 'It's Always Sunny In Philadelphia',1,3,9,39,3,9,3,48,0
Makeup blogger's dad nails anti-LGBTQ bigot with perfect response,1,3,6,49,2,8,0,55,0
Kelly Ripa Dyes Her Hair Pink Just Like Half Of Hollywood,1,2,11,36,0,10,0,47,0
Which Member Of The Pope's Squad Are You,1,1,8,24,1,7,0,32,0
"Liquor Shops Along Highways Shut, Indian Student Assaulted In Poland And Other Must Read Stories",1,3,15,66,1,14,0,81,0
16 Things People From Hawai'i Wish Mainlanders Would Stop,1,1,8,38,1,8,2,46,0
Are You Actually Masturbating Like Everybody Else Or Not?,1,2,9,39,1,8,0,48,0
"German Woman Fed Up Of Degrading Sex Games, Kills And Beheads Partner With Electric Saw",1,3,15,57,1,14,0,72,0
We All Need The D Says This Hilariously Awkward Yukon Government Ad,1,1,12,44,0,11,0,56,0
As it happened: Reaction to Trump strikes,1,3,3,31,1,6,0,34,0
The Definitive Ranking Of The Best '90s Comedies,1,2,7,31,1,7,2,38,0
How Posh Is Your Fridge,1,1,5,14,0,4,0,19,0
What Happened When a French Billionaire Built a Free Coding School in California,1,3,10,58,0,12,0,68,0
No way out: You can't delete a Mastodon account,1,3,3,34,2,8,0,37,0
"Ed Sheeran To Play A Cameo In GoT, Salman To Make A Film With Akshay And More From Ent World",1,3,21,51,1,19,0,72,0
If Disney Princesses Had Realistic Hair,1,1,6,28,0,5,0,34,0
Selena Gomez and The Weeknd spotted kissing,1,3,4,33,0,6,0,37,0
3 American Foreign Policy Options That 2016 Presidential Candidates Need to Choose Among,1,2,10,61,0,12,5,71,0
Why are so many celebrities dying in 2016? ,1,2,1,29,1,8,4,30,0
"76 Thoughts I Had Starting ""Freaks And Geeks"" For The First Time",1,1,11,38,2,11,2,49,0
Is Facebook failing to remove obscene content from its pages,1,3,2,49,0,9,0,51,0
Can You Identify These UK Airports From The Air,1,1,10,29,0,8,0,39,0
This Moment Between A 92-Year-Old And Her Baby Great-Granddaughter Is Totally Adorable,1,1,14,56,3,11,2,70,0
Pictures show starving Bulgarian orphan's incredible transformation after being adopted by US woman,1,3,4,82,1,12,0,86,0
The Little Prince Trailer Will Make You Feel All Your Feelings,1,1,11,41,0,10,0,52,0
Which Dinosaur Matches Your Zodiac Sign,1,1,6,28,0,5,0,34,0
Can You Identify These Foods By An Extreme Close Up,1,1,10,32,0,9,0,42,0
Watch This Newly Unearthed 2013 Kanye West Interview,1,3,7,34,0,7,4,41,0
What Color Should You Dye Your Hair Based On Your Taste In Movies,1,1,13,40,0,12,0,53,0
We Know What Your Love Life Is Like Based On A Single Question,1,1,13,37,0,12,0,50,0
"Donald Trump references ""Nazi Germany"" in tweet about intelligence agencies",1,3,4,60,2,9,0,64,0
Golden Globes 2017: Emma Stone tolerates Ryan Seacrest question about her dress,1,3,6,57,1,11,4,63,0
Are You Ready for Math Whiz Camp? ,1,3,6,20,1,7,0,26,0
Maryland president: Would expect shutdown of UNC over academic allegations,1,2,5,59,1,9,0,64,0
Fans go to extreme lengths to find title game tickets,1,3,1,43,0,9,0,44,0
Your best photographs on the theme of empowerment,1,3,1,41,0,7,0,42,0
Fact-checking what Donald Trump’s lawyer said about the president-elect’s finances,1,3,3,66,4,9,0,69,0
Washington Post Flips Out over Conservatives with WH Access: ‘What’s a Legitimate News Outlet?’,1,3,12,65,5,13,0,77,0
West Virginia: How the Bluest State Became the Reddest,1,3,7,38,1,8,0,45,0
Easter egg calculator: How guilty should you feel about your binge?,1,3,2,53,2,10,0,55,0
How Good At Spelling Are You Actually,1,1,7,24,0,6,0,31,0
A Kansas lawmaker just compared Planned Parenthood to a Nazi death camp,1,2,5,55,0,11,0,60,0
Here's A Helpful Tool To ‘Resist The Trump Agenda’,1,3,9,30,3,8,0,39,0
29 Cats That Are A Friggin’ Holiday Miracle,1,2,7,26,1,7,2,33,0
If Disney Princesses Were Pinay,1,1,5,22,0,4,0,27,0
The 23 Greatest Things That Have Ever Happened On Facebook,1,1,9,38,0,9,2,47,0
These are the 10 trendiest hairstyles for guys right now,1,3,1,44,0,9,2,45,0
"Here's What Happens When You Watch Too Many ""Sherlock"" Episodes, And Annoy Your Mom",1,1,14,52,4,13,0,66,0
The Most Adorable App Ever Is Here And All You Do In It Is Collect Cats,1,1,16,40,0,15,0,56,0
"31 Times ""Frasier"" Was The Wittiest Show On TV",1,1,9,25,2,8,2,34,0
16 Ways To Totally Own Bisexual Visibility Week,1,1,7,31,0,7,2,38,0
17 People Who Accidentally Ruined Thanksgiving,1,1,5,34,0,5,2,39,0
15 Creepy Eyeball Treats Guaranteed To Scare Your Guests,1,1,8,38,0,8,2,46,0
Plan Your Funeral And We'll Tell You How You Die,1,3,10,28,1,9,0,38,0
Is this the work of aliens? Drone captures aerial footage of mysterious crop circles in Russian wheat field,1,2,3,86,1,17,0,89,0
"J.K. Rowling Used ""Harry Potter"" To Explain Why She Opposes A Cultural Boycott Of Israel",1,1,16,54,4,14,0,70,0
Ask the experts: 9 books that will help you stand up for equality in 2017,1,3,1,52,1,14,5,53,0
Triple j's Hottest 100: Everything you need to know,1,3,3,35,2,8,3,38,0
SAPVoice: How Bots Can Help You Find The Right Gift This Year,1,3,15,34,1,11,0,49,0
Images Of How HIV Affects Lives Around the World,1,1,10,30,0,8,0,40,0
"I'm An Immigrant, But I'm Not",1,1,6,15,3,5,0,21,0
How Astronauts Will Ring in the New Year,1,3,6,27,0,7,0,33,0
You Should Never Ask For a Slice Of Lemon In Your Drink,1,2,11,33,0,11,0,44,0
21 Insanely Creative Halloween Costumes For You And Your Friends,1,1,9,44,0,9,2,53,0
"36 Alternate ""Hocus Pocus"" Titles That Are Truly Accurate",1,1,8,37,2,8,2,45,0
"This Crazy, Expensive Stock Market Is for Speculators, Not Investors ",1,3,9,48,2,10,0,57,0
"For Everyone Who Thinks Alan Rickman's Role In ""Galaxy Quest"" Was His Best One",1,1,14,48,3,13,0,62,0
The Love Witch and witchcraft's appeal in the era of Trump,1,2,4,43,1,10,0,47,0
16 Things That Were Rebellious At School But Definitely Aren't Now,1,1,10,43,1,10,2,53,0
23 Things That Could Only Happen In San Francisco,1,1,8,31,0,8,2,39,0
5 things to do by New Year's Eve to lower your tax bill,1,2,3,38,1,12,1,41,0
"61 Things You Probably Didn't Know About ""Harry Potter And The Philosopher's Stone""",1,1,12,53,4,12,2,65,0
The Year in Pictures 2016 ,1,3,3,14,0,5,4,17,0
Climate change is going to be very bad for the global economy,1,3,1,49,0,11,0,50,0
What's The Best College Drunk Food Spot In America,1,1,9,32,1,8,0,41,0
17 Tumblr Posts About Yoda Guaranteed To Make You Laugh,1,1,9,35,0,9,2,44,0
"Ricky Gervais Is Officially Back As David Brent From ""The Office""",1,1,11,42,2,10,0,53,0
St. Vincent Says She Designed A Guitar With Room For Boobs,1,1,11,36,1,10,0,47,0
What Lego Piece Are You,1,1,5,14,0,4,0,19,0
Why every new employee at a billion-dollar glasses brand gets Kerouac and pretzels as a welcome gift ,1,2,2,81,1,17,0,83,0
Your guide to drinking responsibly during the silly season Featured Stories Additional stories,1,3,4,78,0,12,0,82,0
A New Film Captures What Life Is Like For Two Black Men In Tottenham,1,1,14,41,0,13,0,55,0
19 Feminist Costume Ideas For Badass Little Girls,1,1,7,33,0,7,2,40,0
21 Signs That Need To Be Taken Down Immediately,1,1,8,29,0,8,2,37,0
"Carrie Bradshaw's 23 Most Iconic Lines On ""Sex And The City""",1,1,10,35,3,10,2,45,0
"How Well Can You Remember ""Grease""",1,1,6,21,2,5,0,27,0
Someone is fighting the House's livestreaming ban one donation at a time,1,3,2,58,1,11,0,60,0
These Daughters Pranked Their Parents With Tattoos,1,1,7,37,0,6,0,44,0
IBMVoice: 6 Things To Know About Mobile Wallets Before You Use Them This Holiday Season,1,2,17,54,1,14,1,71,0
This Is What Taylor Swift Songs Would Be Titled If They Were Honest,1,1,13,42,0,12,0,55,0
What Is The Worst Pick Up Line You've Ever Heard,1,1,10,28,1,9,0,38,0
26 Photos That Will Make You Want To Spend 2017 Travelling,1,2,9,33,0,10,6,42,0
"Dang, Two More Celeb Couples Have Filed For Divorce",1,1,9,33,1,8,0,42,0
Donald Trump’s Cabinet Picks Disagree With President-Elect on Some Key Issues,1,2,11,54,2,10,0,65,0
"Which ""SNL"" Character Matches Your Zodiac",1,1,8,26,2,5,0,34,0
19 Cleaning Tips For The Neglected Corners In Your Home,1,3,9,35,0,9,2,44,0
President Donald Trump’s first Monday in office,1,3,4,36,1,6,0,40,0
Who Said It: Kanye West Or Jenna Maroney,1,1,8,24,1,7,0,32,0
This Is The One Reason We Should All Get Rid Of Our Smartphones,1,1,13,38,0,12,0,51,0
CNN: Obama Fired a ‘Parting Shot’ Towards Israel and Netanyahu,1,3,10,40,3,9,0,50,0
Trump's America Mother Of All Bombs: What is it and why is the US now using it to fight Islamic State?,1,3,11,68,3,20,0,79,0
"Arm Glow Is Your New Life Goal, Thanks To Lupita Nyong'o",1,1,11,33,2,10,0,44,0
55 New Year's Resolutions That Are Actually Doable,1,1,7,33,1,7,2,40,0
How Low IRS Audit Rate Could Actually Hurt You,1,3,11,27,0,8,0,38,0
Everything You Need To Know About Netflix's Original Series In 2016,1,1,10,42,1,10,4,52,0
"11 Times Constance Wu From ""Fresh Off The Boat"" Had The Best Response To Life",1,1,14,45,2,14,2,59,0
"Kapil Admits To Arguing With Sunil, Jacqueline To Be Justin Bieber's Tour Guide & More From Ent",1,3,16,60,3,16,0,76,0
Kellyanne Conway Burns Hillary Clinton over Tweet Celebrating 9th Circuit Ruling,1,3,9,60,0,10,1,69,0
5 Essential Investing Moves For Millennials,1,3,5,32,0,5,1,37,0
Are You More Like Dannii Or Kylie Minogue,1,1,8,26,0,7,0,34,0
"""Basic Economy"" airline fares save you money, but come at a cost",1,3,2,48,3,11,0,50,0
Finance Department spends thousands on 'excruciating' recruitment video,1,3,2,60,2,7,0,62,0
Analysis: Why Voting Rights Advocates Are Worried About a Trump Voter Fraud Probe,1,3,12,56,1,12,0,68,0
19 Reasons Costco Is All You Could Ever Want And Need,1,1,10,31,0,10,2,41,0
Half of German Women Feel Unsafe in Their Own Neighbourhoods,1,3,8,43,0,9,0,51,0
Toronto Opened A Nutella Cafe And People Are Going Hazelnuts,1,1,10,41,0,9,0,51,0
"Sonu Nigam Tweets About Morning Azaan On Loudspeakers, Faces Backlash For Calling It ‘Forced Religiousness’",1,2,15,75,3,14,0,90,0
Can This Test Determine Your Personality,1,1,6,29,0,5,0,35,0
The Year We Imagined The End Of The Closet,1,1,9,25,0,8,0,34,0
"The new 'Justice League' trailer is here, omg, omg, breathe, please everyone just breathe, akjsdhfgkas;",1,3,3,78,8,14,0,81,0
Which Spam Email Are You,1,1,5,15,0,4,0,20,0
23 Things Every Music Nerd Will Find Funny,1,1,7,26,0,7,2,33,0
"Physiotherapy, chiropractic and osteopathy: What's the difference? Featured Stories Additional stories",1,3,5,83,4,10,0,88,0
We Know What Song You Need To Hear Right Now,1,1,10,25,0,9,0,35,0
9 Timeless Leadership Lessons from Cyrus the Great,1,3,5,37,0,7,1,42,0
"Yo Gotti Links With Kanye West, Quavo, Big Sean And 2 Chainz On New Song ""Castro""",1,3,15,46,4,15,1,61,0
The world's longest airline routes,1,2,1,28,1,4,0,29,0
"Would You Make It To The Final Rose Ceremony On ""The Bachelor""",1,1,12,37,2,11,0,49,0
Here's how people reacted to seeing 'Pirates of the Caribbean: Dead Men Tell No Tales',1,3,8,60,4,14,0,68,0
"Which Character From ""The Blacklist"" Are You",1,1,7,29,2,6,0,36,0
"This ""50 Shades"" Twitter Account Is The One Every Nerd Has Been Waiting For",1,1,13,45,2,13,2,58,0
Snow stylish: an ice-cool fashion shoot – in pictures,1,3,1,41,3,8,0,42,0
"24 Things That Would Happen If ""Inside Out"" Was Set In The Philippines",1,1,12,42,2,12,2,54,0
"16 Magical Pumpkins All ""Harry Potter"" Fans Need To See",1,1,9,33,2,9,2,42,0
Big business warns Trump against mass deportation,1,3,2,41,0,6,0,43,0
A 17-Year-Old Artist Created This Incredible Map Of Literature,1,1,10,40,2,8,2,50,0
"When Taylor Swift Wants To Meet You, You Meet Her",1,1,10,29,1,9,0,39,0
2017 NCAA Tournament Bracket: Latest Projection of the Field of 68,1,2,9,40,1,10,6,49,0
This Mom Hilariously Calls Out The Dysfunction Of School Drop-Off Lines,1,1,12,48,1,10,0,60,0
A genuinely believable CGI actor? It won’t be long,1,3,5,35,2,8,0,40,0
World's Biggest Pension Fund Gets More Serious on Abe's Overhaul,1,3,9,44,2,9,0,53,0
NBC’s Chuck Todd to John Kelly: Is Deporting Illegals the Best Use of Money?,1,3,13,47,3,13,0,60,0
20 Sex Toys You And Your Partner Will Actually Use,1,1,9,30,0,9,2,39,0
"Channing Tatum Lip Syncing ""Let It Go"" Is Everything You'd Expect It To Be",1,1,14,44,3,13,0,58,0
We Know Your Favorite Dog Breed Based On These Random Questions,1,1,11,42,0,10,0,53,0
These Artists Have Been Leaving Cool Little Jokes Across London For Years,1,1,12,50,0,11,0,62,0
Adele Wrote A Lovely Letter About Why She's Been Away So Long,1,1,12,37,1,11,0,49,0
Let's Talk About Chanel #3,1,1,4,15,2,4,1,19,0
The World’s Fastest Woman   ,1,3,4,17,1,6,0,21,0
"Cuba: Thugs Beat Pregnant Pro-Democracy Dissident ‘in the Belly,’ Put Father in the Hospital",1,3,11,63,5,13,0,74,0
Progressives Prepping for Anti-Trump Woman’s March by Making ‘Pussyhats’,1,3,8,52,4,8,0,60,0
"Disney Princesses As ""The Crow""",1,1,5,20,2,4,0,25,0
13 Things That Happen When You Hang Out With A Frenemy,1,1,10,32,0,10,2,42,0
What You Need to Know About Trump’s Statement on Israeli Settlements ,1,3,9,48,1,11,0,57,0
Ex-Trump University student wants the president's apology,1,3,3,46,2,6,0,49,0
Free Wine Fountains and Other Bold Ways Wine Will Change in 2017,1,2,9,40,0,11,4,49,0
This newscaster's terrified reaction is all of us getting caught daydreaming at work,1,2,1,70,1,12,0,71,0
17 Things You'll Understand If You're Slightly Obsessed With Your Bed,1,1,10,45,2,10,2,55,0
Meatballs With Any Meat Recipe - NYT Cooking,1,2,9,27,1,7,0,36,0
18 Pugs Who Forgot Very Important Things,1,1,6,26,0,6,2,32,0
Here's How To Hookup With Anyone,1,1,6,20,1,5,0,26,0
The Much-Maligned Minivan Is The Perfect Vehicle To Usher In The Era Of Self-Driving Cars,1,3,17,56,2,14,0,73,0
There's a story behind the video of a man punching a kangaroo the head The list,1,2,2,61,1,15,0,63,0
18 Perfect Tweets For When Your Relatives Are Annoying During Thanksgiving,1,1,10,52,0,10,2,62,0
"A man confessed to punching a baby boy to death, police say. Why he may not face charges.",1,3,2,67,3,17,0,69,0
24 Pictures That Show 2016 Is Off To A Terrible Start,1,1,9,28,0,10,6,37,0
How Income Disparity Impacts Romantic Relationships,1,1,6,40,0,5,0,46,0
"A 17-Year-Old Created This Insanely Detailed ""Map Of Stereotypes""",1,1,10,41,4,8,2,51,0
Why Working Out Doesn't Have To Suck,1,1,7,22,1,6,0,29,0
Here's The Best Cement Ad You Will Ever See In Your Whole Life,1,1,13,36,1,12,0,49,0
Is Australia on the brink of becoming a completely cashless society?,1,2,2,55,1,10,0,57,0
German Town Receives Bomb Threat After Cancelling Turkish Rally,1,3,9,46,0,8,0,55,0
11 Reasons Why Kanye West Shouldn't Be So Sad About His Height,1,1,11,37,1,11,2,48,0
50 Of Our Favorite BuzzFeed Community Posts Of 2015,1,1,8,29,0,8,6,37,0
Which Nail Polish Brands Actually Stay On Your Nails,1,1,9,35,0,8,0,44,0
RNC Chair: GOP Base Will ‘Walk Away’ in Midterms If Border Wall Is Not Built,1,3,18,41,3,14,0,59,0
Are You More Taylor Swift Or Kanye West,1,1,8,24,0,7,0,32,0
"Erykah Badu's ""Phone Down $$$$"" Is Everything You Ever Needed",1,1,9,36,7,9,0,45,0
Trump Continues to Defend His Call With Taiwan's Leader ,1,2,8,38,1,9,0,46,0
Here's The Leonardo DiCaprio Movie We Should Really Be Talking About,1,1,12,45,1,10,0,57,0
I'm an iPhone Person And This Is Why I Actually Love The New Android Phone,1,1,14,45,1,14,0,59,0
21 Horrifying Images Of Animorphs,1,1,4,23,0,4,2,27,0
"Marijuana Eases Pain, But Jury's Out On Other Health Benefits, Scientists Say",1,3,12,51,3,11,0,63,0
26 Tweets That Are WAY Too Real For Any Indian,1,1,11,24,0,9,2,35,0
19 Things You Could Buy If Money Were No Object,1,1,9,27,0,9,2,36,0
21 Pictures That Girls Will Just Never Understand,1,1,7,33,0,7,2,40,0
Were You More Harry Styles Or Justin Bieber In 2015,1,1,9,29,0,9,4,38,0
"Top 12 Divas, Ranked By How They Laugh",1,1,7,21,1,7,2,28,0
Rare Superbug Gene Discovered on U.S. Pig Farm,1,3,8,29,2,7,0,37,0
"The 22 Best ""Rain Drop, Drop Top"" Tweets",1,2,7,21,3,7,2,28,0
If Disney Movies Were Directed By Tim Burton,1,1,8,29,0,7,0,37,0
This  Beautifully Inclusive Ad Will Make You Ugly Cry,1,1,9,35,0,9,0,44,0
"What The Hell Was Happening On ""Life With Derek""",1,1,9,29,2,8,0,38,0
Old man dances at Dutch electronic dance festival,1,3,2,40,0,7,0,42,0
18 Truths About Being In The Closet That Hit Too Close To Home,1,1,12,36,0,12,2,48,0
16 Bad Vagina Habits You Should Ditch ASAP,1,3,10,23,0,7,2,33,0
When You Don't Feel Comfortable Going Home For The Holidays,1,1,10,39,1,9,0,49,0
Man reunited with vintage car he last drove in the 1950s after current owner tracks him down,1,2,1,71,0,16,4,72,0
21 Fierce AF Haircuts That Will Look Good On Anyone,1,1,10,30,0,9,2,40,0
19 Times Buffalo Bills Fans Lost Their Minds In 2015,1,1,8,29,0,9,6,37,0
"27 Times ""Hannah Montana"" Accurately Described Being A College Student",1,1,9,48,2,9,2,57,0
The 27 Best TV Quotes Of 2015,1,1,6,11,0,6,6,17,0
Here's What To Do If Your Phone's Storage Is Full,1,1,10,28,2,9,0,38,0
The Most Expensive Death on Game of Thrones Will Probably Surprise You,1,3,10,49,0,11,0,59,0
Why we have George Michael to thank for James Corden's 'Carpool Karaoke',1,3,7,51,3,11,0,58,0
15 Indian Beauty Secrets The Whole World Should Know,1,1,8,34,0,8,2,42,0
The Only Acceptable Way To Serve Sweet Potatoes,1,1,8,32,0,7,0,40,0
ATTENTION: Aziz Ansari Is Chilling In India,1,1,15,21,1,6,0,36,0
16 Parents Of LGBT Kids Who Just Don't Get It,1,1,12,21,1,9,2,33,0
Meet One Of The Filthiest Female Characters You'll See Onscreen This Year,1,1,12,49,1,11,0,61,0
Everyone Calm Down Because Canada Has Solved The Dog Pants Question,1,1,11,46,0,10,0,57,0
The Aspirational R.S.V.P.: Saying Yes When You Mean No ,1,3,12,29,5,9,0,41,0
Thoughts During A Pedicure,1,1,4,19,0,3,0,23,0
The Average Woman Will Change Dress Sizes 31 Times in Her Lifetime,1,2,10,43,0,11,2,53,0
Limbaugh: I Hope Trump Has ICE Agents Waiting for Illegal Aliens in Attendance at Congressional Address,1,3,15,72,1,15,0,87,0
My 100 Days of Covering President Donald Trump,1,2,6,30,0,7,3,36,0
Police: Facebook Live Murder Suspect Steve Stephens Killed Himself During Pursuit,1,3,11,59,1,10,0,70,0
Which Breakfast Food Matches Your Zodiac Sign,1,1,7,32,0,6,0,39,0
18 Pictures That Are Way Too Real If You Have A Brother,1,1,11,31,0,11,2,42,0
The Most Powerful Images Of World War I,1,1,8,24,0,7,0,32,0
10 things 2017 has made us do,1,3,0,17,0,6,6,17,0
18 Pictures That Prove Cats Are Evolving,1,1,6,26,0,6,2,32,0
‘One of the most scary things I’ve ever seen’: Hero who saved skier on lift considers fate,1,2,3,67,4,16,0,70,0
Chinese Authorities Put Facial Recognition on Toilet Paper Dispensers to Deter Theft,1,3,10,63,0,11,0,73,0
Girls Try Tinder For The First Time,1,1,7,22,0,6,0,29,0
How Hans Are You,1,1,4,9,0,3,0,13,0
What President Trump's coming Obamacare decision could mean for Americans ,1,3,5,58,1,10,0,63,0
Taboo star Tom Hardy provides update on Mad Max: Fury Road sequel: 'It's a matter of when',1,3,8,61,5,16,0,69,0
These Easy Pizza Pinwheels Are Delicious AF,1,1,8,29,0,6,0,37,0
10 wellness retreats to clear your head for 2017,1,3,0,34,0,8,6,34,0
White House Objects to Drudge Criticism: GOP Needs Time to Replace ‘Mammoth’ Obamacare,1,2,13,58,3,12,0,71,0
People Ride An IO HAWK For The First Time,1,1,13,20,0,8,0,33,0
13 Wise Life Lessons From Mindy Kaling's New Book,1,1,8,30,1,8,2,38,0
Uzo Aduba Attended The SAG Awards With The Same Guy She Went To Prom With,1,1,17,42,0,14,0,59,0
People Review The New Barbie Bodies,1,1,6,24,0,5,0,30,0
Outside Source Reality Check: North American Free Trade deal,1,3,8,43,1,8,0,51,0
"Why these mysterious, blood-sucking fish fell from the Alaskan sky",1,2,2,53,2,9,0,55,0
Here Are 44 Photos Of President And First Lady Obama That'll Make You Miss Bae,1,1,14,47,1,14,2,61,0
The hottest Aussie city just had its coldest day and people really freaked out,1,3,2,63,0,13,0,65,0
"For more than a year, this woman lived in a $1.2 million home with her sister’s corpse",1,3,1,63,4,16,2,64,0
Just How Accidental Was This Instagram That Ariana Grande Uploaded,1,1,10,47,0,9,0,57,0
This Country Singer Makes Music On His Game Boy In His Spare Time,1,1,13,40,0,12,0,53,0
21 British Christmas Traditions America Needs To Adopt,1,1,7,38,0,7,2,45,0
Rahul Gandhi Tweeted About His Vacation & Twitter Took It Upon Itself To Troll Him Mercilessly!,1,3,15,63,2,15,0,78,0
51 Of America's Most Instagrammed Places In 2015,1,1,6,28,1,7,6,34,0
Let’s All Take A Moment And Laugh At These Funny “Parks & Rec” Photos,1,2,13,39,4,13,0,52,0
What Would Zooey Deschanel Name You,1,1,6,24,0,5,0,30,0
Here's How To Actually Reuse Your Wedding Dress In A Beautiful Way,1,1,12,42,1,11,0,54,0
This Cop Ended Up Delivering A Baby During A Routine Traffic Stop,1,1,12,42,0,11,0,54,0
How To Eat Nothing But Pizza For Every Single Meal,1,1,10,31,0,9,0,41,0
Scary-Good Google Pixel XL: Keeps My iPhone 7 Plus At Bay,1,3,12,32,2,10,1,44,0
"16 Things Every ""Star Wars"" Fan Needs For A Successful Christmas",1,1,10,40,2,10,2,50,0
Can You Guess Why The Gilmore Girls Are Crying,1,1,9,29,0,8,0,38,0
What Lady Gaga Song Should Be Your Anthem,1,1,8,26,0,7,0,34,0
13 Halloween Decorations That Got Way Too Real,1,1,7,30,0,7,2,37,0
FBI Interviews Top U.S. Gymnasts in Intensifying Sexual-Abuse Investigation,1,3,12,52,3,8,0,64,0
31 Reasons Fennel Should Be The New Food Mascot Of Fall,1,1,10,33,0,10,2,43,0
Man threatens to set himself on fire outside BBC's London office,1,3,5,48,1,10,0,53,0
Celebrities Around The World Have Paid Tribute To David Bowie,1,1,10,42,0,9,0,52,0
19 Signs You're Slightly Obsessed With Cabin Socks,1,1,7,33,1,7,2,40,0
What Is The Best City In Texas?,1,3,7,17,1,6,0,24,0
GOP Candidate Loses Party's Support After Telling Woman 'You Should F**k Me',1,3,14,46,5,11,0,60,0
"A Youth Paid Rs 34,000 For An iPhone, Fraudster Duped Him By Sending Parcel Full Of Papers",1,3,16,51,2,16,5,67,0
NFL1000 Presents Bleacher Report's 2017 NFL Draft Preview,1,3,11,30,1,7,8,41,0
Are You Pikachu Or Meowth,1,1,5,16,0,4,0,21,0
What Is Equal Pay Day? Here’s Everything You Need to Know,1,3,10,35,2,10,0,45,0
You've Been Cooking The Wrong Thing In Your Crockpot This Whole Time,1,1,12,44,1,11,0,56,0
The world in 2016: how much do you know? – quiz,1,3,1,29,3,10,4,30,0
Want To Boycott Trump-Friendly Companies? These Apps Aim To Assist You,1,3,12,46,2,10,0,58,0
"Do You Belong At Hogwarts Or The ""AHS"" Coven",1,1,11,23,2,8,0,34,0
Singular Single-Malt Whiskeys Born in the USA,1,3,8,30,1,6,0,38,0
We Know Which Animal GIF Will Make You Laugh Based On Your Zodiac,1,1,15,38,0,12,0,53,0
Hilarious Dad Taught Twin Daughters How To Scare People In Hotel Hallways,1,2,12,50,0,11,0,62,0
"This $1 Trick Will Help You Get Amazing, Even Eyebrows",1,1,9,33,2,9,1,42,0
"Bill Nye and Tyler, The Creator just dropped the hottest theme song ever",1,3,5,54,1,12,0,59,0
This Green Dot Test Knows How Easily You Get Jealous,1,1,10,33,0,9,0,43,0
Can You Pass This Seriously Difficult John Green Books Quiz,1,1,10,40,0,9,0,50,0
"Candy Carson Singing The ""National Anthem"" Is The Only Thing You Need Today",1,1,13,48,2,12,0,61,0
21 Mind-Blowing Ways To Eat S'mores,1,1,6,20,2,5,2,26,0
Fit for 40: how an osteopathy course turned me into a crack addict,1,3,1,50,1,12,2,51,0
How You Act Around Your Friends Vs. Your Best Friend,1,1,10,32,1,9,0,42,0
21 Pictures That Will Only Make Sense To People With Siblings,1,1,10,39,0,10,2,49,0
Which NFL Team Should You Support This Season Based On Your Football Team,1,1,15,46,0,12,0,61,0
Here's A Make-Ahead Meal Plan That Anyone Can Cook,1,1,10,30,2,8,0,40,0
22 Secrets Zookeepers Will Never Tell You,1,1,6,27,0,6,2,33,0
"Whoa, Jimmy Kimmel Looks Super Hot With A Beard",1,1,9,29,1,8,0,38,0
Inside the Navy SEAL Raid in Yemen Targeting al Qaeda,1,3,10,34,0,9,0,44,0
"12 Ways ""Today's Special"" Was The Most WTF Kids' Show Ever",1,1,12,30,4,10,2,42,0
Fact Check: Did Treasury Nominee's Bank Foreclose on a 90-Year-Old Widow?  Insider,1,2,11,52,5,12,2,63,0
13 Divine Ways To Cook With Pomegranates This Holiday Season,1,1,9,40,0,9,2,49,0
American Kids Tried Candy From Around The World And Questioned Life,1,1,11,46,0,10,0,57,0
Is This Food Natural Or Genetically Modified,1,1,7,31,0,6,0,38,0
Who Should Win the Grammy for Best Tropical Latin Album? Vote!,1,3,9,41,2,10,0,50,0
Create A Sampler Platter And We'll Guess Your Age And Height,1,3,11,38,1,10,0,49,0
"17 Incredible ""Degrassi"" Fashion Moments",1,1,4,28,2,4,2,32,0
You Have To See These Two Babies Dancing To Beyoncé’s “7/11”,1,3,10,33,4,10,3,43,0
The dental nurse who became an alligator catcher,1,3,1,40,0,7,0,41,0
What Would Amortentia Smell Like To You,1,1,7,26,0,6,0,33,0
Accidental Tom Hardy lookalike was 'gutted' after not meeting himself,1,3,3,55,2,9,0,58,0
So A Racist Came To Your Halloween Party,1,1,8,25,0,7,0,33,0
London attack: Photo of woman wearing hijab bypassing victim may not show full story,1,3,2,68,1,13,0,70,0
North Korea: Friendship with Syria ‘Will Be Strengthened and Developed’,1,3,8,51,3,9,0,59,0
George Will on Fox News Shake-Up: ‘I Have a Feeling Mr. O’Reilly Is Replaceable’,1,3,14,47,6,13,0,61,0
ESPN Super Bowl LI expert picks,1,2,8,18,0,5,0,26,0
Rep. Kelly on Obamacare Fix: ‘We’re Going to Find Out What’s in It Before We Pass It’,1,3,14,49,6,16,0,63,0
What Type Of Show Should You Binge-Watch In 2016,1,1,9,26,1,8,4,35,0
Which Taylor Swift Track Should Be Your Personal Theme Song,1,1,10,40,0,9,0,50,0
"13 signs you have a work spouse, even if doesn't feel like it",1,2,0,45,2,12,2,45,0
The 17 Worst Things You Could Say To Someone From Chicago,1,1,10,35,0,10,2,45,0
"Trump: ‘We Are Fighting’ ‘Fake News’ – ‘They Shouldn’t Be Allowed To Use’ Anonymous Sources, CNN ‘Clinton News Network’",1,3,20,69,12,18,0,89,0
"This Weather Reporter Snuck In Multiple ""Star Wars"" Puns While Reporting The Weather",1,1,13,57,2,12,0,70,0
"Can You Get 100% On This ""Parks And Rec"" Character Quote Quiz?",1,3,11,33,4,11,3,44,0
We Know The Worst Mistake You've Ever Made Based On Your Taste In Balls,1,1,14,43,1,13,0,57,0
Do You Think You Can Find The Rock Under A Rock?,1,3,11,26,1,10,0,37,0
Signs That Your Mom Might Just Be Cool,1,1,8,23,0,7,0,31,0
Cure for chocoholics: Scientists say you need to 'imagine a forest' if you want to curb your cravings,1,3,2,79,3,17,0,81,0
Michael Moore wants you to do these 10 things to take down Donald Trump The list,1,3,5,58,0,15,2,63,0
"Miley Cyrus Sent Britney Spears ""Britney"" Balloons For Her Birthday",1,1,10,46,2,9,0,56,0
"Chief of Dentsu, Japanese Ad Agency, to Resign Over Employee’s Suicide ",1,2,9,48,3,11,0,57,0
The Noise All Brits Make In Awkward Situations,1,1,8,31,0,7,0,39,0
The CIA’s Secret History Is Now Online,1,3,9,22,1,6,0,31,0
Alligator seems to go for a little ride on a manatee,1,3,1,41,0,10,0,42,0
15 Turkey Facts That Will Make You Sound Smart This Thanksgiving,1,1,10,42,0,10,2,52,0
Some things never change: 1996 career advice that's still solid,1,3,1,47,2,9,4,48,0
"Here Are The ""Star Wars"" Films' Most Blatant Special Effects Changes",1,1,11,44,3,10,0,55,0
17 biggest business stories of 2016,1,3,0,24,0,5,6,24,0
What Is Your Dessert IQ,1,1,6,13,0,4,0,19,0
Rand Paul: ‘There’s a Lot of ObamaCare Lite’ in House Obamacare Replacement Bill,1,2,11,53,4,12,0,64,0
"Czech President’s Spokesman: ‘Trump Protects His Country, Exactly What EU Elites Do Not Do’",1,2,15,58,5,13,0,73,0
What the WikiLeaks document dump tells us about the CIA's Frankfurt base ,1,3,7,53,1,12,0,60,0
5 Traits Hiring Managers Look For | Ashford University,1,3,7,37,1,8,1,44,0
Hillary Spokesman: Clinton Campaign Didn’t Appreciate ‘Profound’ Impact of the ‘Breitbart Effect’,1,3,10,70,6,11,0,80,0
What's The Most Delicious Thing You Can Eat In Atlanta For Less Than $10,1,1,13,42,2,13,2,55,0
15 Chill Ass Bedrooms That Will Make You Want To Sleep Through Your Alarm,1,1,13,45,0,13,2,58,0
"Why we buy milk, bread and toilet paper when it snows",1,2,1,41,1,10,0,42,0
What's SO Great About YOUR Life,1,1,10,15,1,5,0,25,0
Why Medicaid Is So Hard for Republicans,1,3,6,27,0,6,0,33,0
20 Times Olivia Wilde Was The Realest Person On Twitter,1,1,9,35,0,9,2,44,0
What Leadership Quality Suits Your Personality,1,1,6,35,0,5,0,41,0
"11 Questions Every ""Doctor Who"" Fan Has, Answered By Steven Moffat",1,1,10,41,3,10,2,51,0
What Obscure Thing Should You Make Sexy For Halloween,1,1,9,36,0,8,0,45,0
"Film Fraternity Mourns Jayalalithaa's Death, Manish Malhotra's Star-Studded 50th Bday Bash And More From Ent",1,3,15,73,4,14,2,88,0
Ellen DeGeneres Dressed Up As A Kardashian For Halloween,1,1,10,38,0,8,0,48,0
16 Chocolate Chip Cookies That Prove God Exists,1,1,7,31,0,7,2,38,0
Bar Exchange Shows How EU’s Brexit Negotiator Gets Deals Done,1,3,11,40,1,9,0,51,0
Train row almost pulls Kosovo and Serbia off the rails,1,2,3,42,0,9,0,45,0
All the countries where polygamy is legal The list,1,3,2,40,0,8,0,42,0
15 Awesome Gifts For Anyone Who Loves Boobs,1,1,7,27,0,7,2,34,0
"As Chicago Murder Rate Spikes, Many Fear Violence Has Become Normalized ",1,3,11,49,1,11,0,60,0
10 super-successful people share the toughest sacrifices they made to achieve their goals,1,2,0,74,1,12,2,74,0
One little drop of your blood may someday predict how long you’ll live,1,3,1,56,1,12,0,57,0
Twinkle Khanna Wonders How She'll Feel Patriotic When She's Paying To Watch Ranveer In His Undies!,1,3,16,64,3,15,0,80,0
"Despite his rhetoric, here’s a clear sign that Trump is eager to show 100-day wins",1,3,2,60,3,14,3,62,0
Ugly is the next big trainer trend for 2017,1,3,1,30,0,8,4,31,0
City of London grapples with new EU shake-up,1,2,4,32,1,7,0,36,0
Initial jobless claims fell by more than expected,1,2,1,41,0,7,0,42,0
17 Struggles All Smartypants Will Understand,1,1,5,32,0,5,2,37,0
"Damn Straight Sigourney Weaver Will Be In The New ""Ghostbusters""",1,1,10,43,2,9,0,53,0
19 Dorm Room Tips That'll Get You Instantly Organized,1,1,8,34,1,8,2,42,0
29 Husbands Who Crushed This Whole Marriage Thing In 2015,1,1,8,34,0,9,6,42,0
21 Truths All Women Will Understand,1,1,5,23,0,5,2,28,0
Are You More Of A Verbal Or Nonverbal Communicator,1,1,9,33,0,8,0,42,0
"15 Mind-Blowing Things You Probably Didn't Know About Spencer And Heidi From ""The Hills""",1,1,14,55,4,13,2,69,0
18 Photos That Are Way Too Real For Makeup Artists,1,1,9,30,0,9,2,39,0
We Asked An Expert Why We Keep Hearing About Escaped Peacocks,1,1,11,40,0,10,0,51,0
We Know Whether You'll Have Sex In 2016,1,1,7,20,1,7,4,27,0
Teen who crashed into BMW finds out why honesty is the best policy,1,3,4,50,0,12,0,54,0
17 People Who Are Determined To Be Even Gayer In 2017,1,3,9,28,0,10,6,37,0
39 Weird Things You'll Find In Every British Family Home,1,1,9,35,1,9,2,44,0
Can We Guess Your Age And Gender From These 10 Questions,1,1,10,34,0,10,2,44,0
How To Draw A Turkey That's So Good Everyone Will Freak Out,1,1,12,35,1,11,0,47,0
"The New Trailer For ""The Huntsman"" Is Glorious",1,1,8,29,2,7,0,37,0
"Julianne Moore Cries In Times Square, Makes Tourists Very Uncomfortable",1,1,10,51,1,9,0,61,0
When You're A Girl Who Spends Too Much Money,1,1,9,26,1,8,0,35,0
The 12 best video games of 2016,1,3,1,18,0,6,6,19,0
21 Recipes That Will Completely Transform Boring Leftovers,1,1,7,42,0,7,2,49,0
How I Learned To Celebrate Eid Al Adha In America,1,1,10,30,0,9,0,40,0
The Power of Simple Life Changes to Prevent Heart Disease ,1,2,8,40,0,10,0,48,0
16 Things You See When You Go To Tim Hortons At 6 A.M,1,1,12,25,1,12,3,37,0
30 Times The Classroom Was More Extra Than Educational,1,3,8,36,0,8,2,44,0
"This con man lied his way into Princeton. Decades later, he was found squatting in mountain shack.",1,3,3,76,3,16,0,79,0
Which Of These Popstars Actually Wrote Their Own Songs,1,1,9,37,0,8,0,46,0
Who Do The Mysterious Hands In Justin Bieber's Photo Belong To,1,1,11,40,1,10,0,51,0
You Will Go Nuts Looking For Chewie In These Drawings,1,1,10,34,0,9,0,44,0
Share your photos of cats for a chance to win Jane Bown's book,1,3,3,46,1,12,0,49,0
How Well Do You Know These Viral Vines,1,1,8,23,0,7,0,31,0
Airport Security Checkpoint Optical Illusion - Business Insider,1,3,7,48,1,7,0,55,0
Here's How Bananas Are Coming To The Rescue Of The Tribal Economy In India,1,2,14,46,1,13,0,60,0
Read the Cover Story: What Happened to Richard Simmons?,1,3,7,38,2,8,0,45,0
This Patriots Player May Skip White House Visit if Team Wins Super Bowl  Insider,1,3,13,53,0,14,0,66,0
Does Putin Still Favor Sidekick Medvedev?,1,3,6,29,1,5,0,35,0
"13 Rare Photos Of The Cast Of ""A Cinderella Story"" That Will Give You All The Feels",1,1,16,47,2,16,2,63,0
"Trump & Co Try Getting Masood Azhar Banned At UN, China Vetos + 5 Other Important Reads From Today",1,3,17,59,3,18,1,76,0
33 Science Facts We Didn’t Know At The Start Of 2016,1,3,9,26,1,10,6,35,0
6 Questions You Seriously Need To Ask Yourself,1,1,7,31,0,7,1,38,0
What Do You Actually Deserve For Christmas,1,1,7,29,0,6,0,36,0
19 Apocalyptic Photos Of Storms And Supercells From Kansas And Beyond,1,1,10,47,0,10,2,57,0
26 Painful Truths About Running During The Winter,1,1,7,33,0,7,2,40,0
Illinois Legislature Decides Against Making Obama’s Birthday a State Holiday,1,3,9,57,1,9,0,66,0
"Champagne, Prosecco, and ... British Fizz? Why the new name for our bubbly is causing a stir",1,3,5,65,6,16,0,70,0
What 2015 Meme Are You Based On Your Zodiac Sign,1,1,9,26,0,9,4,35,0
How A Fake Viral News Story Wrecked Three People’s Lives,1,3,10,36,1,9,0,46,0
Sign Up For BuzzFeed's Crossword Newsletter Reminders,1,1,8,38,1,6,0,46,0
Which iPhone or Android Yoga App Is Best for Me?,1,3,8,30,1,9,0,38,0
"Do You Recognise The ""Goosebumps"" Book From Its Original Cover",1,1,10,41,2,9,0,51,0
He was almost killed in Afghanistan. Now he’s been painted by the president who sent him there.,1,2,3,73,3,16,0,76,0
Are You Team Michael Or Team Rafael,1,1,7,22,0,6,0,29,0
17 Of The Most Beautifully Illustrated Picture Books In 2015,1,1,8,37,0,9,6,45,0
Dear White People: Here's Some Well-Intentioned Halloween Advice From India,1,1,11,52,3,9,0,63,0
This Child Used Her Sleeping Mother's Fingerprint to Buy $250 Worth of Pokemon Gear,1,2,11,54,2,13,3,65,0
Texas Couple Reveals Pregnancy with Photo Featuring 452 In-Vitro Fertilization Needles,1,3,10,62,1,10,3,72,0
How To Bake Perfect Cookies While Maintaining Your Sanity,1,1,9,40,0,8,0,49,0
Where Should You Go On Holiday Based On Your Zodiac Sign,1,1,11,35,0,10,0,46,0
8 Signs You Were Raised In The South,1,1,7,21,0,7,1,28,0
My daughter’s death made me do something terrible on Facebook,1,3,2,49,1,9,0,51,0
Obama’s Final Interview as President to Air on History Channel,1,2,7,45,1,9,0,52,0
How to protect yourself from lightning strikes,1,2,1,39,0,6,0,40,0
11 Things Every Canadian Does,1,1,4,19,0,4,2,23,0
13 Insanely Easy 10-Minute Pizza Snacks,1,1,5,24,1,5,4,29,0
The 29 Most WTF Moments From The 2015 MTV EMAs,1,1,14,17,0,9,6,31,0
McCain makes secret trip to Syria to meet with US troops,1,2,5,41,0,10,0,46,0
This is what REALLY happens when you don't brush your teeth (and it'll put you off skipping it ever again) ,1,3,7,76,4,20,0,83,0
17 Celebrities Only Black People Know,1,1,5,25,0,5,2,30,0
19 Unexpected Music Mashups You Didn't Know You Needed,1,1,8,35,1,8,2,43,0
16 Pictures That Are Way Too Real For Sales Associates,1,1,9,34,0,9,2,43,0
This Indian Designer Had The Best Response To Being Shamed For Her Wedding Dress,1,1,14,53,0,13,0,67,0
Grandmas Play Cards Against Humanity,1,1,5,27,0,4,0,32,0
"Which Hogwarts House Would Each ""Glee"" Character Be In",1,1,9,35,2,8,0,44,0
Zimbabweans To Pay 35 Quadrillion Local Dollars For $1 As Currency Dies,1,2,10,46,1,11,3,56,0
"Bangkok city guide: what to do plus the best hotels, restaurants and bars",1,3,1,58,2,12,0,59,0
Rebel Wilson And Dakota Johnson Answer Your Dating Questions,1,1,9,43,0,8,0,52,0
Take This Color Test To See If You're A Big Old Dumb-Dumb,1,1,13,31,2,11,0,44,0
"Dear ""Walking Dead"": You Just Killed The Wrong Person",1,1,9,33,3,8,0,42,0
Seven bits of advice for aspiring comedians,1,3,1,36,0,6,0,37,0
Going out in Kabul: Little joys in the shadow of fear,1,3,3,39,1,10,0,42,0
Samantha Bee's Show Tells You What Trump Knew And When He Knew It,1,3,13,39,1,12,0,52,0
Seasonally stressed? How to outsource your Christmas to the professionals,1,3,3,60,1,9,0,63,0
Bollywood Celebrities Looked Damn Good At The 2016 Umang Mumbai Police Show,1,1,11,49,0,11,4,60,0
"These are the fastest ways to make friends, according to one scientist The list",1,3,2,63,1,13,0,65,0
Ivanka Trump Booed at Women’s Event in Berlin: President Is ‘Champion’ of Families ,1,3,10,56,4,13,0,66,0
FS1’s Cowherd Slams ‘Sellout’ Kaepernick: Where’s Your Courage Now That You’re a Free Agent?,1,3,14,57,7,13,1,71,0
News Why Bali is the greatest destination on Earth (so says TripAdvisor),1,3,6,53,2,11,0,59,0
"Mother, daughter die in grisly Czech sauna accident",1,2,2,41,1,7,0,43,0
The 61 Best Teacher Memes On The Internet,1,1,7,25,0,7,2,32,0
Should Farmers Fear Trump?,1,3,4,18,1,3,0,22,0
What's The Love Of Your Life Up To Right Now,1,1,10,24,1,9,0,34,0
"High-ranking Fed official resigns, reveals role in leaked confidential information",1,2,2,69,2,9,0,71,0
Would You Eat This Adorable Chocolate Baby Groot?,1,3,8,33,1,7,0,41,0
Why your SUV needs winter tires,1,3,4,22,0,5,0,26,0
"10 Expensive Habits You Can, And Should, Break Today",1,3,8,32,2,8,2,40,0
"The Ultimate ""Scream Queens"" Drinking Game",1,1,6,29,2,5,0,35,0
Drake Responded To Adele And Said He'd Do Anything She Wants,1,1,11,38,1,10,0,49,0
"The Hardest ""National Lampoon's Christmas Vacation"" Quiz You'll Ever Take",1,1,10,50,4,9,0,60,0
This beautiful genius got a Game Boy Color to run 'Wolfenstein 3D',1,3,6,46,2,11,1,52,0
'I lost all my fingers': Asylum seekers make dangerous border crossing,1,2,2,55,3,10,0,57,0
"‘If they call you a pig in the police it’s not personal. As head, it was very personal’",1,3,2,63,5,17,0,65,0
Celebrity Weddings of 2016,1,3,2,17,0,3,4,19,0
How Well Do You Remember Basic Science,1,1,7,25,0,6,0,32,0
Gigi Hadid Silencing Her Body Shamers Will Give You Life,1,1,10,37,0,9,0,47,0
Tons of juice flood Russian town after factory accident,1,3,2,45,0,8,0,47,0
John Boyega Was Actually The Cutest Part Of The BAFTAs,1,1,14,31,0,9,0,45,0
European Establishment Tries New Election Tactic: Full Embrace of the EU,1,3,10,51,1,10,0,61,0
"Woman Detained at DFW Airport for Allegedly Smuggling Raw Animal Brains, Other Animal Parts in Luggage",1,3,15,71,1,15,0,86,0
Do You Actually Prefer Chris Pratt Or Chris Hemsworth,1,1,9,36,0,8,0,45,0
This Bride Literally Put A Spell On Her New Husband During Their First Dance,1,1,14,49,0,13,0,63,0
How Much Of A Grinch Are You,1,1,7,15,0,6,0,22,0
Americans Might Have to Get a Visa for Europe,1,2,6,31,0,8,0,37,0
How to tap into the best bargains in wine today,1,2,1,37,0,9,0,38,0
New York’s de Blasio Retreats on Claim That Donald Trump Caused Anti-Semitic Threats,1,3,12,58,2,12,0,70,0
Bubba Watson Sinks Wild Putt with Back Turned to Hole at US Open Practice,1,2,12,48,0,13,0,60,0
The 14 Most Influential Canadian Animals Of 2015,1,1,6,29,0,7,6,35,0
Why Manchester By the Sea should win the best picture Oscar,1,2,5,44,0,10,0,49,0
Picks for every trophy given at Home Depot College Football Awards,1,2,6,50,0,10,0,56,0
How Annabeth Chase Are You,1,1,5,17,0,4,0,22,0
21 Secrets Anyone Dating An Actor Knows,1,1,6,25,0,6,2,31,0
What cocaine does to your body and brain,1,3,1,32,0,7,0,33,0
"Kashmiri Scholar Threatened, Forced To Leave BITS Pilani + Other Top Stories",1,3,14,49,2,11,0,63,0
When You Have No Chill,1,1,5,13,0,4,0,18,0
17 Geography Puns That Are So Bad They're Kind Of Wonderful,1,1,10,36,1,10,2,46,0
Surprising celebrity friendships,1,3,1,29,0,2,0,30,0
Which Member Of Jennifer Lawrence's Growing Squad Are You,1,1,9,39,1,8,0,48,0
Facebook's Fake News Solution Has Three Big Problems,1,3,8,36,1,7,0,44,0
"Parents, What's The Worst Thing That Went Wrong On Halloween",1,1,10,39,2,9,0,49,0
17 Confessions About Dating In Your Thirties That Are Way Too Real,1,1,11,42,0,11,2,53,0
America's Favorite Vinyl Records By State,1,3,6,29,1,5,0,35,0
We Know Your Celeb Boyfriend Based On The First Letter Of Your Name,1,1,13,42,0,12,0,55,0
"23 Tweets That Will Make You Say “Wow, Did I Write That?”",1,3,11,29,4,11,2,40,0
"Trump was caught practicing his speech, so the internet made jokes",1,2,1,54,1,10,0,55,0
"This Airbnb Is A ""Netflix And Chill"" Utopia",1,1,8,26,2,7,0,34,0
This Guy Invented Extra Long Selfie Arms And It's The Weirdest Thing Ever,1,1,13,47,1,12,0,60,0
The Moment Your Relationship Becomes Official,1,1,6,34,0,5,0,40,0
"34 Facts You Probably Didn't Know About ""Harry Potter And The Order Of The Phoenix""",1,1,14,50,3,14,2,64,0
"22 Pictures That Will Make You Say ""I Need An Adult""",1,1,10,28,2,10,2,38,0
5 Times Rihanna Did Coachella Style Better Than All Others,1,3,9,39,0,9,1,48,0
An exercise scientist demonstrates the proper bench press,1,3,1,49,0,7,0,50,0
16 Siblings Who Had The Last Laugh,1,1,6,20,0,6,2,26,0
"Do You Remember The Lyrics To ""Thriller""",1,1,7,25,2,6,0,32,0
"As the Commodities Rally Slows, Currency Investors Get Creative",1,3,8,46,1,8,0,54,0
These Are the Best- and Worst-Performing Airlines in the World,1,3,7,44,2,9,0,51,0
Here comes CPI...,1,3,4,8,3,2,0,12,0
28 Times Tumblr Told The Truth About Hypochondria,1,1,7,33,0,7,2,40,0
Here's Why Kermit and Miss Piggy Actually Broke Up,1,1,8,33,1,8,0,41,0
"How Well Do You Remember ""Jersey Shore""",1,1,7,24,2,6,0,31,0
J.Lo Just Slayed The AMAs Stage With An Insane Dance Medley,1,1,14,34,1,10,0,48,0
23 Hilarious Tweets About Coffee That Will Get You Every Time,1,1,10,39,0,10,2,49,0
A List Of Things That Need To Chill Immediately,1,1,9,30,0,8,0,39,0
21 Confessions From People Who Can't Put Their E-Books Down,1,1,10,36,2,9,2,46,0
Dozens of couples went to a top fertility clinic. It may have used the wrong sperm.,1,3,2,64,2,15,0,66,0
The old-fashioned way - but can Belgrade's artisans survive?,1,3,2,46,4,8,0,48,0
Sessions Border Plan Has Entire Political Spectrum Abuzz,1,3,8,41,0,7,0,49,0
23 Simple Ways To Be The Literal Worst Today,1,1,8,26,0,8,2,34,0
12 Christmas Presents For Someone That You'll Never Ever EVER Bone,1,1,13,40,1,10,2,53,0
6-year-old boy celebrates end of chemo treatments with adorable dance,1,3,0,57,2,9,1,57,0
15 fantastic non-toy gifts for the holidays,1,3,0,34,1,6,2,34,0
These Kids Schooled Stacey Dash On The Importance Of Black History Month,1,1,12,49,0,11,0,61,0
9 Actors Who Underwent Amazing Transformations & Shocked Us With Their Unrecognisable Looks,1,2,11,66,1,12,1,77,0
"Students Denounced as ‘Racist’ For Wearing Red, White and Blue Clothing at Basketball Game",1,2,11,63,3,13,0,74,0
14 Easy Ways to Save Money This Spring,1,2,6,23,0,7,2,29,0
Two Female PTV Anchors Get Banned For Voicing Their Opinions About Workplace Harrasment,1,3,15,60,0,12,0,75,0
"Trailer Of Raees Is Out, Dilip Kumar Thanks Fans For Wishing Him A Speedy Recovery And More From Ent",1,2,19,62,1,18,0,81,0
15 Stunning North Carolina Towns You Absolutely Need To Visit,1,1,9,41,0,9,2,50,0
Only A Genius Can Get 13/13 In This Visual Riddle Quiz,1,3,10,29,1,10,4,39,0
16 Redhead Truths As Told By Tweets,1,1,6,21,0,6,2,27,0
Who Gets To Take Part In The Menstruation Conversation,1,1,9,37,0,8,0,46,0
This Artist Re-Imagined Super Mario As Famous Cultural Icons,1,1,10,41,1,8,0,51,0
Mitsubishi Heavy IndustriesVoice: 3 Japanese Business Practices For An Age Of Disruption,1,2,12,63,1,11,1,75,0
Can You Beat This Infuriating A To Z Geography Quiz?,1,2,10,32,1,9,0,42,0
21 Celebrity Kids Who Are Killing Us With Cuteness On Instagram,1,1,10,41,0,10,2,51,0
"14 Incredible ""Game Of Thrones"" Tattoos That Are To Die For",1,1,10,35,2,10,2,45,0
This Girl Transformed Her Back Brace Into Steampunk Armor And It's So Sick,1,1,13,48,1,12,0,61,0
11 Animals Just Trying To Get Home For Thanksgiving Via Turtle Taxi,1,1,11,43,0,11,2,54,0
Why Every Millennial Should Consider Funding A Roth IRA,1,2,11,36,0,8,0,47,0
"‘Fun Home’ takes home five Tonys, including for best musical",1,3,3,45,3,9,0,48,0
12 Amazing Photos That Will Make You Feel So Very Insignificant,1,1,10,41,0,10,2,51,0
19 Accessories For Anyone Who Loves Sleep More Than People,1,1,9,38,0,9,2,47,0
"A Year On, Few Answers From Probe Into Prince's Death",1,3,10,32,2,9,0,42,0
Fmr Obama Official Farkas: ‘Disturbing’ Rice Story Was Leaked and Distracted Us from Russia,1,2,12,63,3,13,0,75,0
How One Black College Survived The Leap From Division II To Division I And Back Again,1,1,17,53,0,15,0,70,0
"A Crazy Genius Spent 13 Years Archiving Every Episode Of MTV's ""120 Minutes""",1,1,13,43,3,12,5,56,0
Police: Chicago Torture Victim’s Parents Received Taunting Messages,1,2,8,50,2,7,0,58,0
"An Undertaker Talks About Life, Happiness And A 1000 Funerals",1,3,9,38,1,9,4,47,0
Hillary Clinton: Sean Spicer Guilty of ‘Everyday Sexism’ (VIDEO),1,3,12,39,5,8,0,51,0
'I believe my husband was poisoned',1,3,1,27,2,5,0,28,0
A growing number of analysts are dismissing the iPhone 8 curved display rumours,1,2,2,64,0,12,1,66,0
19 Pairs Of Sisters Whose Style You'll Want To Steal,1,1,9,31,1,9,2,40,0
Iraq 'witch hunt' lawyer Phil Shiner could avoid paying debts,1,2,3,47,2,9,0,50,0
Ashton Kutcher blew a kiss at John McCain and lol what is happening?,1,2,5,50,1,12,0,55,0
This Woman Smashing Her Face Into Bread Is Oddly Compelling,1,1,10,40,0,9,0,50,0
'The world is two dimensional': What it's like to not be able to smell,1,3,2,51,4,13,0,53,0
What is Dodd-Frank? And is Trump about to cause another financial crisis?,1,2,5,54,3,11,0,59,0
Celebrate World Gin Day with these easy cocktails,1,2,4,38,0,7,0,42,0
How Popular Are Your Emo Opinions?,1,3,6,22,1,5,0,28,0
Why I am confident enough to pre-order a Nintendo Switch,1,2,4,42,1,9,0,46,0
Stunning 1900 images record Norwegian villagers amid epic landscapes,1,3,2,54,0,8,4,56,0
What's The Funniest Tumblr Post About Being A Twin,1,1,9,32,1,8,0,41,0
These People Got Their Ears Extracted For The First Time And It Was Grossly Hilarious,1,1,15,56,0,14,0,71,0
If You Love “Harry Potter” You Won’t Be Able To Get Through This Post Without Crying,1,3,16,50,3,15,0,66,0
Russia bath lotion kills 48 drinkers in Irkutsk,1,2,2,36,0,7,2,38,0
Natasha Lyonne And Fred Armisen Make Their Debut As A Couple At The Emmy Awards,1,1,15,50,0,14,0,65,0
Inside Le Pen’s Growing Army of Discontent,1,3,6,29,1,6,0,35,0
18 Insane Acne Transformations That Prove The Power Of Makeup,1,1,9,41,0,9,2,50,0
Ted Cruz: Dems Suffer From ‘Trump Derangement Syndrome’,1,2,8,37,3,7,0,45,0
29 Truly Horrible Vegetable Recipes That Should Not Exist,1,1,8,39,0,8,2,47,0
"Kanye West Sang ""Gold Digger"" For His ""American Idol"" Audition",1,1,10,39,4,9,0,49,0
The Democratic Candidates Looked Oddly Familiar,1,1,6,36,0,5,0,42,0
Golf Commentator Caught on Mic Saying Player’s Fiancée Wears ‘the Shortest Skirt In the Country’,1,3,12,67,3,14,0,79,0
A Bride Honored Her Father At Her Wedding With A Dance With Four Of His Fellow Police Officers,1,1,18,59,0,17,0,77,0
Venice’s Jeweler to the Stars Is Also Its Best-Kept Secret,1,3,9,38,2,9,0,47,0
What Percent Single Are You,1,1,5,18,0,4,0,23,0
Americans have been lying to themselves about the economy for way too long,1,2,1,61,0,12,0,62,0
22 Things That Will Inevitably Happen When You Live With Your Best Friend,1,1,12,47,0,12,2,59,0
The secret camera hook in public toilets that perverts are using to spy on people,1,3,1,66,0,14,0,67,0
King of the tape-measure home run? Aaron Judge's blasts go a long way,1,3,3,51,3,12,0,54,0
The world's fastest land animal is even more threatened than we thought,1,3,1,58,1,11,0,59,0
How The Kardashians Manipulated The Media To Become The Most Famous Family In The World,1,1,15,58,0,14,0,73,0
19 Extremely Satisfying Moments For Book Lovers,1,1,6,33,0,6,2,39,0
America's Richest Celebrities 2016: George Lucas Leads Steven Spielberg And Oprah,1,3,10,55,2,10,4,65,0
What Should You Netflix And Do Based On Your Emoji Preference,1,1,11,40,0,10,0,51,0
Zac Efron Dominated The Stage As Snoopy In A High School Play,1,1,12,38,0,11,0,50,0
PewDiePie claims YouTube contacted him over deleting his account,1,2,5,51,0,8,0,56,0
"Gul Panag Expresses Her View On Sonu Nigam, Abhi-Aish's 10th Anniversary And More From Ent",1,3,15,56,3,14,2,71,0
Glenn Beck Mocks Sarah Palin: ‘Has She Had a Brain Aneurysm?’,1,3,10,37,4,10,0,47,0
Divers find leg attached to cinder block in search for missing woman,1,2,1,56,0,11,0,57,0
19 Things All '00s Girls Who Grew Up On Rom Coms Will Relate To,1,1,12,33,1,13,4,45,0
Quantum Physics Tells Us Our Fate Is Not Written In The Stars,1,2,12,38,0,11,0,50,0
"J.K. Rowling And Daniel Radcliffe Lead ""Harry Potter"" Stars Paying Tribute To Alan Rickman",1,1,15,58,4,13,0,73,0
Frank Ocean Had The Most Memorable Grammys Moment And He Wasn’t Even There,1,3,13,48,1,12,0,61,0
"This Couple's ""Half & Half"" Photos Help Them Share Their Lives In Spite Of Distance",1,1,14,51,4,14,0,65,0
Here's How Millennials Are Preparing For Success In 2017,1,2,8,35,1,8,4,43,0
"Justin Timberlake Goes To The Island From ""Lost""",1,1,8,31,2,7,0,39,0
The Fight for Net Neutrality,1,2,4,20,0,4,0,24,0
Can We Guess Your Favorite Disney Movie Based On Your Zodiac,1,1,11,39,0,10,0,50,0
Tell Us About Yourself(ie): David Anders,1,1,6,26,3,5,0,32,0
13 Reasons 2015 Is Basically A Repeat Of 1995,1,1,6,21,0,8,10,27,0
Do You Guys Hate Me,1,1,5,10,0,4,0,15,0
15 Times Priyanka Chopra Goddamn Owned 2015,1,1,5,26,0,6,6,31,0
Here's How To Actually Start Exercising Again,1,1,7,31,1,6,0,38,0
"Kenan Thompson And Kel Mitchell Reunited On ""The Tonight Show"" And Our '90s Dreams Came True",1,1,15,57,3,15,2,72,0
17 Reasons Emily Gilmore Is A Masterpiece,1,1,6,27,0,6,2,33,0
"What's The Funniest ""It's Always Sunny In Philadelphia"" Moment",1,1,9,41,4,8,0,50,0
Which Netflix Original Series Should You Star In,1,1,8,33,0,7,0,41,0
"Trump Immigration Order Marks Worst Day ‘Since Japanese Internment’, Says Seattle Mayor",1,3,12,61,3,11,0,73,0
Source: Fox ‘Sick’ of Megyn Kelly; ‘Fox News Needs to Cut Her Loose’,1,3,11,39,6,12,0,50,0
"Donald Trump, Syria, Chuck Barris: Your Wednesday Briefing ",1,3,8,40,3,8,0,48,0
12 Charts Only Sephora Lovers Will Understand,1,1,6,31,0,6,2,37,0
What's Your Actual Age Based On Your Favorite Childhood Gaming System,1,1,11,47,1,10,0,58,0
California Professor Calls Trump’s Win ‘Act of Terrorism’,1,3,7,40,3,7,0,47,0
How Does Your Morning Routine Compare To Everyone Else’s?,1,2,9,38,2,8,0,47,0
In pictures: Sony World Photography Awards,1,3,5,31,1,5,0,36,0
What Should All Newbies Should Know Before Hitting The Gym,1,1,10,39,0,9,0,49,0
America's hottest investment product is about to go global,1,3,1,48,1,8,0,49,0
What Cupcake Flavor Are You,1,1,5,18,0,4,0,23,0
There's A Lot Missing From Johnny Depp And Tom Hardy's Gangster Movies,1,1,12,45,2,11,0,57,0
Drake Had A Very Drake-Like Reaction To Seeing Sasha Obama's OVO Dad Hat,1,3,16,42,2,12,0,58,0
Why certain noises really drive people nuts,1,2,1,36,0,6,0,37,0
This Crossword Is For Audiophiles Everywhere,1,1,6,33,0,5,0,39,0
"Interview: Maxine Waters thinks millennials can change politics for everyone (yes, everyone)",1,2,3,74,4,11,0,77,0
This Is What It's Like To Play Pictionary With Comics Professionals,1,1,11,45,1,10,0,56,0
GOP Lawmaker: U.S. Won’t Spray Opium in Afghanistan Because Crops ‘Might Be Too Close to a Mosque’,1,2,17,59,6,16,0,76,0
"Sam Hunt's ""Break Up In A Small Town"" Video Is So Hot It's Problematic",1,1,14,39,4,13,0,53,0
DIY Sugar Wax,1,1,5,6,0,2,0,11,0
3 Types Of Awful Co-Workers And How To Deal With Each,1,3,11,30,1,10,1,41,0
Pinball Craftsman Hits Bumpers Building a Sought-After Machine,1,3,8,46,1,7,0,54,0
Rahul Gandhi Tweeted About His Vacation & Twitter Took It Upon Itself To Troll Him Mercilessly!,1,2,15,63,2,15,0,78,0
"Facebook Targets 30,000 Fake French Accounts Before Election",1,2,7,40,1,7,5,47,0
19 Of The Most Dad Things Dads Do At Christmas,1,1,9,26,0,9,2,35,0
Boy Has The BEST Reaction To Being Adopted After 832 Days In Foster Care,1,2,16,40,0,13,3,56,0
These Dads Dancing Ballet with Their Daughters Will Steal Your Heart  Insider,1,3,11,54,0,12,0,65,0
9 Comebacks Feminists Would Be Proud Of,1,1,6,26,0,6,1,32,0
"Justin Bieber Awkwardly Scolds Fans To ""Clap On Beat""",1,1,9,34,2,8,0,43,0
The Rent Is Too Damn High: In Search Of The Truth About Airbnb’s Impact On Housing,1,3,16,49,2,15,0,65,0
Choose Your Own Death,1,1,4,14,0,3,0,18,0
Frightening Celebrity Statues,1,3,3,24,0,2,0,27,0
"Which ""Harry Potter"" Moment Do You Wish Could Happen In Real Life",1,1,12,40,2,11,0,52,0
"'Star Wars,' 'Justice League' And The Biggest Blockbusters Of 2017",1,2,9,39,5,9,4,48,0
See 100 Years Of Japanese Beauty In Just Over One Minute,1,1,10,33,0,10,3,43,0
17 Reasons Why You Should Do The Right Thing And Date A Scorpio,1,1,12,37,0,12,2,49,0
What Are The Best Video Games Of All Time,1,1,9,24,0,8,0,33,0
Who is Milo Yiannopoulos?,1,2,3,18,1,3,0,21,0
The Apprentice 2016: Alana Spencer triumphs in the strongest final in years - review,1,3,4,61,2,13,4,65,0
Apple's Big Developers Conference Is Today. Here's What to Expect. [Video],1,2,10,48,6,10,0,58,0
What's The Best Family Halloween Costume You've Ever Had,1,1,9,37,2,8,0,46,0
You can take the biggest step toward building wealth in 10 minutes at your computer,1,2,1,66,0,14,2,67,0
Mariah Carey has NYE performance fiasco ,1,3,5,29,0,6,0,34,0
"Okay, fine fine, Google's April Fool's Day pranks are pretty great this year, here are all of them",1,3,5,71,5,17,0,76,0
This Adorable Polar Bear Cub Just Discovered Snow,1,1,8,34,0,7,0,42,0
Lesbian Princess,1,1,2,13,0,1,0,15,0
Here's Why Glenn Close Wants To End The Stigma Around Mental Illness,1,1,12,44,1,11,0,56,0
This Couple's Creepy Selfie Is Seriously Freaking People Out,1,3,9,42,1,8,0,51,0
11 Jobs That Pay More Than $100K At The Best Places To Work In 2017,1,3,13,30,1,14,9,43,0
"Dividend stocks aren't as great as they used to be (KO, MO)",1,2,5,39,4,11,0,44,0
White woman 'posed as black civil right leader' in years-long deception,1,3,1,57,3,10,0,58,0
Here are our top 8 climate change stories of 2017,1,3,1,34,0,9,5,35,0
"This Vine Of New York On ""Celebrity Big Brother"" Is Fucking Perfect",1,1,12,42,2,11,0,54,0
"Kesha's So Hyped To Guest Star On ""Jane The Virgin""",1,1,10,29,3,9,0,39,0
"Here's What The ""Mona Lisa"" Looks Like With Celebrities' Brows",1,1,10,39,4,9,0,49,0
Ian McKellen Got Choked Up Reading This Beautiful Coming Out Letter,1,1,12,45,0,10,0,57,0
"After Teaching Himself To Do His Daughter's Hair, A Single Dad Started A Class To Teach Others",1,1,17,59,2,16,0,76,0
Inside The New Feminist Show You Need To Watch Right Now,1,1,11,35,0,10,0,46,0
"If Crystal Pepsi's back, we want these '90s things, too",1,2,3,37,4,9,2,40,0
Fast Food Cheat-Sheet: Here’s What to Order at 10 Chains,1,3,8,34,3,9,2,42,0
Night Owls Become Early Risers,1,1,5,21,0,4,0,26,0
34 Times Celebrity Men Gave Us Intense DILF Goals,1,1,11,28,0,8,2,39,0
23 Incredibly Awkward Situations You'll Understand If Your Dick Is Massive,1,1,10,51,1,10,2,61,0
Ed Sheeran Had A Hell Of A Night At The MTV EMAs,1,1,16,21,0,11,0,37,0
Moms Imagine What It Would Look Like If Moms Spoke To Everyone How They Talk To Kids,1,1,17,51,0,16,0,68,0
13 Times Lady Gaga Needed To Move The Fuck Outta The Way,1,1,11,32,0,11,2,43,0
"Despite Big Loss Vs Australia, Virat Kohli And Ravichandran Ashwin Are Unmoved In The ICC Test Rankings",1,3,19,67,1,16,0,86,0
"Gorsuch: Scalia A ‘Lion of the Law’ – Judges Should Look to What Law Demands, Not What They Prefer",1,3,15,60,5,18,0,75,0
8 Amazing Beauty Products You’ll Wish You’d Known About Sooner,1,3,9,41,2,9,1,50,0
Fifty Shades Of Green: How Fanfiction Went From Dirty Little Secret To Money Machine,1,3,14,56,1,13,0,70,0
12 Reasons Masculinity Is Terrible For Men,1,1,6,28,0,6,2,34,0
This Is What Really Happens In The Girls' Bathroom,1,1,9,32,1,8,0,41,0
Apple reveals new Music app to rival Spotify,1,2,3,34,0,7,0,37,0
Do you want the good news or the bad news?,1,3,1,31,1,9,0,32,0
"NASA, Mosul, Kim Jong-nam: Your Thursday Briefing ",1,3,10,29,4,7,0,39,0
Which IKEA Product Are You,1,1,8,14,0,4,0,22,0
20 Absurdly Chic Dogs That Have Mastered The Art Of Winter Dressing,1,1,11,43,0,11,2,54,0
30 Under 30 Europe: These Are The Stars Shaping The World Of Finance In 2017,1,3,12,41,1,14,8,53,0
9 Questions To Determine If You’re More Type A Or Type B,1,3,11,32,1,11,1,43,0
War for the Planet of the Apes trailer sees Caesar go into battle with humans,1,3,4,59,0,14,0,63,0
"Animators Reimagined ""Spirited Away"" As An 8-Bit Video Game And It's Incredible",1,1,12,51,4,11,1,63,0
19 Things Only University Of New South Wales Students Will Understand,1,1,10,47,0,10,2,57,0
"What’s Making Britons Grumpy? Voting, Voting, Then Voting Again",1,2,9,42,4,8,0,51,0
17 Mildly Infuriating People Who Must Be Stopped,1,1,7,32,0,7,2,39,0
‘Drunk Don Lemon’: CNN Cuts Mic During New Year’s Eve Show,1,2,13,31,4,10,0,44,0
Where can you beat the Brexit effect on holiday?,1,3,2,37,1,8,0,39,0
18 Things You Should Do Differently While Dating In 2016,1,1,8,33,0,9,6,41,0
20 Small Things To Do When Gender Dysphoria Gets You Down,1,1,10,35,0,10,2,45,0
14 Things All Book Nerds Will Relate To On Valentine's Day,1,1,10,35,1,10,2,45,0
How to Retire at 40,1,3,2,11,0,4,2,13,0
Correction: Snow-Buildings Collapse story,1,3,4,32,2,3,0,36,0
Brexit: Supreme Court judges to deliver verdict on Theresa May's plans for EU withdrawal,1,3,7,66,2,13,0,73,0
"Bank of Canada holds, says 'economic slack remains'",1,3,2,39,3,7,0,41,0
This Is How It Feels When You Tell Someone You Got Tested And They Overreact,1,1,15,47,0,14,0,62,0
What Is Your Best Advice For Dating Someone With Depression,1,1,10,40,0,9,0,50,0
How Big Pharma plans to fend off Trump,1,3,4,27,0,7,0,31,0
19 Pictures That Will Give You Intense Flashbacks To Being Sick As A Kid,1,3,13,44,0,13,2,57,0
Trump’s False Autism Claims Could Have Serious Consequences For People With The Condition,1,3,13,63,1,12,0,76,0
9 shows to get excited about in 2017,1,3,0,24,0,7,5,24,0
"If You’re Behind on Retirement Savings, Here’s How to Catch Up",1,2,9,40,3,10,0,49,0
E Ink unveils world's largest ePaper display at CES,1,3,6,36,1,8,0,42,0
"How Well Do You Remember The Lyrics To ""Start Of Something New""",1,1,12,38,2,11,0,50,0
The One Tip That Will Help Guys Dress Better For The Rest Of Their Lives,1,1,15,43,0,14,0,58,0
Who Would You Rather Be In Your Race,1,1,8,21,0,7,0,29,0
This Is What Happens When You Ask Your 12-Year-Old Brother For Dating Advice,1,1,14,46,2,12,2,60,0
"White House social media director misused official position by going after GOP lawmaker, ethics experts say",1,3,5,86,1,15,0,91,0
"16 Reasons There Should Be A ""Cat Owner Appreciation"" Day",1,1,9,35,2,9,2,44,0
How Trump’s Calls to World Leaders Are Upsetting Decades of Diplomacy ,1,3,9,49,1,11,0,58,0
Catholic Bishop: Churches Should Not Shield Illegal Immigrants,1,3,8,46,1,7,0,54,0
11 Things All Twentysomethings Should Know About Their Jobs,1,1,8,41,0,8,2,49,0
European Championship Qualifying - ESPN FC,1,2,9,27,1,5,0,36,0
This Introverted Teen Just Released The Most Relatable Album Of The Year,1,1,12,49,0,11,0,61,0
Latest Uber controversy sheds light on how companies use your emails,1,3,2,56,0,10,0,58,0
Vote: Four burning questions heading into Final Four,1,2,4,40,1,7,0,44,0
"17 Times ""Chavo Del Ocho"" Perfectly Summed Up Your Life",1,1,9,33,2,9,2,42,0
The Try Guys Try Therapy,1,1,5,15,0,4,0,20,0
This Is Why Mainland Europe Is Better At Christmas Than Everyone Else,1,1,12,46,0,11,0,58,0
Which Year Of The 2010 Decade (So Far) Are You,1,1,9,22,2,9,4,31,0
This Facebook Post Proves Just How Ridiculous Women’s Clothing Sizes Are,1,3,11,50,1,10,0,61,0
Does Ranch Really Go With Everything,1,1,6,25,0,5,0,31,0
The Best Rap Verses of 2016,1,3,4,14,0,5,4,18,0
24 Pictures That Will Make You Lose Faith In The Education System,1,1,11,41,0,11,2,52,0
15 Untold Emergency Room Horror Stories That'll Make Your Skin Crawl,1,2,10,45,1,10,2,55,0
Kelly Rowland's Latest Instagram Pics Are The Epitome Of Black Girl Magic,1,1,12,49,1,11,0,61,0
How Long Would You Survive In 'The Belko Experiment'?,1,3,9,33,3,8,0,42,0
‘Great Wall’ Star Matt Damon: ‘I’m Not a Believer in Walls’,1,3,9,34,6,10,0,43,0
19 Valentine's Day Sweets Guaranteed To Get You Kissed,1,1,8,35,1,8,2,43,0
Don’t call Donald Trump a liar – even if he is one,1,2,3,34,2,11,0,37,0
What We're Reading ,1,2,3,12,1,3,0,15,0
27 Cat Pictures Because Life Is Literally Just Terrible,1,1,8,37,0,8,2,45,0
"Kellogg’s Besieged by Food Product Recalls over Listeria, Glass, Metal",1,3,8,50,3,9,0,58,0
"Which ""Aristocats"" Kitten Are You",1,1,5,22,2,4,0,27,0
What's The Weirdest Thing Your Dog Does,1,1,7,25,1,6,0,32,0
18 Confessions About Married Sex That Will Break Your Heart,1,1,9,39,0,9,2,48,0
Goldman Sachs Is About To Swallow Donald Trump,1,2,8,31,0,7,0,39,0
Here come retail sales...,1,3,1,18,3,3,0,19,0
Justin Bieber's Biggest Moments of 2016,1,3,4,25,1,5,4,29,0
24 Of History's Most Epic Last Words,1,1,6,21,1,6,2,27,0
10 Hairstyles For Curly Hair You Need To Try ASAP,1,1,12,26,0,9,2,38,0
How to avoid a Mariah Carey meltdown,1,3,3,27,0,6,0,30,0
Are You More Furiosa Or Rey,1,1,6,16,0,5,0,22,0
6 Tips To Be More Spontaneous While Clicking Candid Photographs,1,3,9,44,0,9,1,53,0
19 Reasons Chickens Are Actually The Cutest,1,1,6,29,0,6,2,35,0
The 10 most valuable brands in the world,1,3,1,30,0,7,2,31,0
"Ellen DeGeneres Hilariously Scared Selena Gomez With ""Taylor Swift""",1,1,10,47,2,8,0,57,0
Morgan StanleyVoice: Should Investors Party Like It's 1999?,1,3,8,37,3,7,4,45,0
13 Recipes For People Who Think They Hate Slow Cookers,1,1,9,34,0,9,2,43,0
Cop In Madhya Pradesh Gets Thrashed Brutally For Issuing A Fine To A BJP Leader's Relatives,1,3,18,57,1,15,0,75,0
Italian woman 'returns mixed-race surrogate baby',1,3,1,40,3,5,0,41,0
What's The Funniest YouTube Comment You've Ever Seen,1,1,9,34,2,7,0,43,0
These Photos Of A Dog Dressed As 12 Different Disney Characters Will Totally Make You Smile,1,1,15,59,0,15,2,74,0
The Mona Lisa Just Turned Down Cara Delevingne For A Date,1,1,11,36,0,10,0,47,0
This Is What $4 Of Street Food Looks Like Around The World,1,1,11,34,1,11,1,45,0
Dreaming of a frugal Christmas? Meet the people who’ve stopped shopping,1,3,3,56,2,10,0,59,0
The dentist who became one of the richest people in Washington,1,3,2,50,0,10,0,52,0
BuzzFeed Crossword: Two Peas In A Pod,1,1,8,22,1,6,0,30,0
This Vine Of A Kid And Snake Sharing A Lollipop Is Mesmerizing,1,1,12,39,0,11,0,51,0
Women Get Real About The Worst Parts About Having Your Period,1,1,11,40,0,10,0,51,0
The 10 least stressful jobs in America,1,3,2,28,0,6,2,30,0
'Santa' robs US bank after handing out candy canes,1,2,3,37,2,8,0,40,0
This Mom Took A Laugh-Out-Loud Photo Of Her Baby And A Magazine,1,1,14,36,2,11,0,50,0
The new BBC Dad is a Latvian mayor whose cat interrupted his live stream,1,3,6,53,0,13,0,59,0
MRC: 3 Networks Covered Sessions 7x More Than Eric Holder Being Held in Contempt of Congress,1,2,14,60,1,15,2,74,0
Tina Fey Gave The Perfect Answer To A Question About Women In Comedy,1,1,13,43,0,12,0,56,0
These Flight Attendants Say Their New Uniforms Are Making Them Sick,1,3,11,46,0,10,0,57,0
"Here's What The Cast Of ""Hannah Montana"" Looks Like 10 Years Later",1,1,11,39,3,11,2,50,0
Which Adele Lyric Describes Your Love Life,1,1,7,29,0,6,0,36,0
Can You Get Through This Post Without Moaning With Pleasure,1,1,10,40,0,9,0,50,0
18 Tragic Photos That Will Make All Makeup Addicts Weep,1,1,9,35,0,9,2,44,0
Student Loan Repayment: The Hottest Employee Benefit Of 2017,1,3,8,39,1,8,4,47,0
So The (Basically) Official Arthur Twitter Just Called Out John Legend,1,2,11,47,2,10,0,58,0
12 Christmas Movies Streaming on Netflix That Don't Suck,1,3,7,38,1,8,2,45,0
27 Underrated Parenting Products That Actually Work,1,1,6,37,0,6,2,43,0
6-Year-Old Basketball Player Glides Past Defender with Impressive Eurostep,1,3,9,54,2,8,1,63,0
"1,500 people, 2 elevators and 500 tons of luggage -- here's how the Saudi king travels",1,3,1,57,5,15,8,58,0
McCain: Obama’s Lack of Leadership Causing ‘Unraveling of the World Order’,1,3,9,51,4,10,0,60,0
Dog-Related Bills Flood Albany as Major Legislation Stalls ,1,2,8,42,1,8,0,50,0
5 hotels with fascinating past lives,1,3,0,30,0,5,1,30,0
15 Things Nobody Thinks To Tell You About Leaving University,1,1,9,40,0,9,2,49,0
"Never Trump Movement Leader, Former Jeb Bush Staffer Helen Aguirre Ferre Infiltrates White House",1,2,14,68,1,13,0,82,0
9 Of The Most Cringeworthy Things To Happen To Disney Princesses In 2015,1,1,11,44,0,12,5,55,0
Your birth month may predict your risk for certain diseases ,1,2,1,49,0,10,0,50,0
The Most Beautiful Love Story You'll See Onscreen This Year,1,1,10,39,1,9,0,49,0
Quadruplet Dad Gets Incredible Gift From Steve Harvey After Wife’s Death,1,2,11,50,1,10,0,61,0
Kylie Jenner's Bodyguards Apparently Pushed Jessica Alba So She Sent Flowers,1,1,11,54,1,10,0,65,0
Faked News: Your Guide to 22 Post-Election Hate Hoaxes,1,3,8,34,2,8,2,42,0
Surprise: Good Economic News Isn’t Always Great News for Investors,1,3,9,46,2,9,0,55,0
33 Of The Most Annoying Rom-Com Moments Of All Time,1,3,10,29,1,9,2,39,0
This Kid's Demonstration Of Perfect Pitch Will Blow You Away,1,1,10,40,1,9,0,50,0
What Kind Of Chanel-O-Ween Gift Do You Actually Deserve,1,1,11,34,2,8,0,45,0
21 Reasons Why 2015 Was The Worst Year Canada Has Ever Seen,1,1,10,32,0,11,6,42,0
18 Differences Between Snow Days In Canada And America,1,1,8,36,0,8,2,44,0
What's Your Dream Home Style?,1,3,5,18,2,4,0,23,0
The Love Witch and witchcraft's appeal in the era of Trump,1,3,4,43,1,10,0,47,0
Krauthammer: Syria Strike Sends Message that ‘There Is a Sheriff in Town’ – ‘America Is Back’,1,3,12,60,6,15,0,72,0
We Gave Kevin Hart And Ice Cube The BFF Test And It Was Hilarious AF,1,1,18,36,0,14,0,54,0
18 Memes Only Super Sensitive People Will Relate To,1,3,8,33,0,8,2,41,0
You're On The Wrong Side Of History If You Say Taylor Swift Can't Sing,1,1,14,41,2,13,0,55,0
The most spoken language in the world is the one plants use to talk to each other The list,1,2,2,70,0,18,0,72,0
Andrea Mitchell: Sean Spicer First Press Briefing Was ‘Substantive’ and ‘Responsive’,1,3,10,59,5,10,0,69,0
Adele Pranked Some Employees At Jamba Juice And It's Everything,1,1,10,43,1,9,0,53,0
"Madonna's Carpool Karaoke is here and, well, you just need to see it for yourself",1,3,3,61,3,14,0,64,0
Kristin Cavallari Posted A TBT With Stephen And It Will Make You Nostalgic AF,1,1,17,47,0,13,0,64,0
These Adoption Agencies Need Volunteers To Snuggle And Take Care Of Babies,1,1,12,51,0,11,0,63,0
Why #DuragHistoryWeek Is More Than A Joke,1,1,9,25,1,6,0,34,0
"Wall Street Made Charles Murphy Successful and Rich, but Happiness Eluded Him",1,3,10,55,1,11,0,65,0
19 Reasons Why Low Power Mode Is The Best Thing Ever,1,1,10,30,0,10,2,40,0
This Is What Happens When A Guy Takes A Shower At Work,1,1,12,31,0,11,0,43,0
This Hilarious New Twitter Account Makes Ads That Are Actually Honest,1,1,11,48,0,10,0,59,0
Are You A Proper Grown Up Yet,1,1,7,16,0,6,0,23,0
"The ABCs According To ""The Hunger Games""",1,1,9,23,2,6,0,32,0
Which '90s Fashion Trend Should You Bring Back Based On Your Zodiac,1,1,11,42,1,11,2,53,0
Steve Martin on Teaching You (and Himself) How to Be a Comedian ,1,2,8,42,2,12,0,50,0
"No Toilet, No Bride Say People From 110 Villages Across Haryana, Punjab and Himachal Pradesh",1,3,13,60,2,14,3,73,0
Are You Actually Taylor Swift?,1,3,5,20,1,4,0,25,0
Can We All Take A Moment To Appreciate Angela Bassett At The BAFTAs,1,1,17,38,0,12,0,55,0
Best honeymoon destinations  - Business Insider,1,2,3,37,1,6,0,40,0
UC Berkeley to Offer Class on Fake Language from ‘Game of Thrones’,1,2,9,44,2,11,0,53,0
"Insecure, OJ and The Night Of: how TV tackled race in 2016",1,3,8,33,2,11,4,41,0
You've Been Using Your Rice Cooker Wrong The Entire Time,1,1,10,36,1,9,0,46,0
Let's See Just How Obsessed With Makeup You Truly Are,1,1,10,33,1,9,0,43,0
"This ""Jessica Jones"" Scene Is A Reminder Of What Hero Stories Are Really About",1,1,14,49,2,13,0,63,0
The 10 best high-necked blouses – in pictures,1,3,1,33,2,7,2,34,0
Should We Netflix And Chill,1,1,5,18,0,4,0,23,0
"Overwhelmed by emotion, Jason Day did the only thing he could",1,2,3,47,1,10,0,50,0
The New Trump-Obama Phone Chat On 'Conan' Is All Kinds Of Hilarious,1,3,13,40,3,11,0,53,0
Tell Us About Yourself(ie): Dexter Darden,1,1,6,27,3,5,0,33,0
BMX star turns abandoned Silverdome into his own decaying playground,1,3,4,55,0,9,0,59,0
The 34 Most Important Instagrams From Britney Spears In 2015,1,1,8,37,0,9,6,45,0
‘Don’t play identity politics!’ The primal scream of the straight white male,1,2,2,59,4,11,0,61,0
"Steven Moffat Took Our ""Which Doctor Who Companion Are You"" Quiz",1,1,11,41,2,10,0,52,0
The lure of New Zealand for jaded Americans,1,3,4,32,0,7,0,36,0
My worst holiday: Guardian writers on breaks that nearly broke them,1,3,2,54,1,10,0,56,0
How To Pitch Stories To BuzzFeed LGBT,1,1,11,20,0,6,0,31,0
7 Adorable Pups We Met On Snapchat,1,1,6,21,0,6,1,27,0
Jimmy Kimmel Breaks Down Why Ivanka Trump Just Got A Plum White House Job,1,2,14,46,0,13,0,60,0
Kids Talk About When Their Parents Got Divorced,1,1,8,32,0,7,0,40,0
Breakthrough Ebola vaccine proves ‘highly protective’,1,2,2,44,2,5,0,46,0
This Porn Site Is Rerouting Its Utah Users To Online Sex-Ed Resources,1,2,13,44,1,11,0,57,0
15 Scented Candles You Could Actually Use,1,1,6,27,0,6,2,33,0
Earth's Oceans Are Warming A Lot Faster Than We Thought,1,2,10,35,1,9,0,45,0
14 Free Pieces Of Advice,1,1,4,14,0,4,2,18,0
England v Slovenia: Hodgson says Euro 2016 win all that matters,1,2,4,44,1,10,4,48,0
Climate of Violence: Stephen Colbert Depicts Stephen Miller’s Head on a Spike,1,3,9,55,2,11,0,64,0
We Know Which Oscar You Should Win Based On Your Favorite Lady Gaga Shoe,1,1,14,45,0,13,0,59,0
Stash Some Cash -- You're One Surprise Away From Going Broke,1,3,10,37,3,10,0,47,0
‘Frozen Ever After:’ An Exclusive Look at Disney’s Upcoming Attraction - Speakeasy,1,3,10,56,5,11,0,66,0
Just 18 Really Funny Tumblr Makeup Posts,1,1,6,26,0,6,2,32,0
Indian Redditors Responded PERFECTLY To A College's Alleged List Of Bizarre Rules For Females,1,1,22,57,1,13,0,79,0
Everyone On The Internet Is Freaking Out Over Amber Rose's Response To Kanye,1,1,13,50,1,12,0,63,0
"This New Cafe Is Every ""Friends"" Fan's Dream Come True",1,1,10,32,3,9,0,42,0
"29 Things That Would Be Different If ""Love Actually"" Were Set Today",1,1,11,41,2,11,2,52,0
19 Words That Mean Something Completely Different When You're Obsessed With Makeup,1,1,11,57,1,11,2,68,0
20 Gifts Only People Who Live On The Internet Will Appreciate,1,3,10,39,0,10,2,49,0
"Sam Smith's Cover Of Drake's ""Hotline Bling"" Is Everything",1,1,9,37,4,8,0,46,0
Passion points: 3 stories about technology that inspires and empowers,1,2,1,57,1,9,1,58,0
"21 Reasons ""Unbreakable Kimmy Schmidt"" Is The Best Comedy Of 2015",1,1,9,38,2,10,6,47,0
17 Ways To Make Your Shower The Best Place On Earth,1,1,10,29,0,10,2,39,0
Gay in Putin's Moscow: why the city is pinker than you think,1,2,3,44,2,11,0,47,0
'I lost all my fingers': Asylum seekers make dangerous border crossing,1,3,2,55,3,10,0,57,0
Donald Trump Floats Boeing Proposal to Counter Lockheed Martin’s F-35,1,2,9,47,2,9,2,56,0
19 Pictures That Prove Kids Are Better Than Us All,1,1,9,30,0,9,2,39,0
Which Famous Couple Are Actually Your Parents?,1,3,7,32,1,6,0,39,0
Pretend To Write A Book And We’ll Guess How Old You Are,1,3,12,31,1,11,0,43,0
Are You More Han Solo Or Indiana Jones,1,1,8,23,0,7,0,31,0
Stop What You're Doing And Watch Justin Bieber Serenade Selena Gomez,1,1,11,46,1,10,0,57,0
This Depressing Christmas Ad Is Enraging Everyone,1,1,7,36,0,6,0,43,0
"What ""Harry Potter"" Character Are You Based On Your Birth Month",1,1,11,40,2,10,0,51,0
Friendly Reminder That Your Smoke Detector Is Totally Radioactive,1,1,9,48,0,8,0,57,0
Everyone Should Be Able To Get 7/10 On This Science True Or False Test,1,3,13,40,1,13,3,53,0
How This 27-Year-Old Made $1 Million Last Year,1,3,8,25,3,7,3,33,0
Pool party organizer: He didn't have to use aggression - CNN Video,1,3,6,46,3,11,0,52,0
What Halsey Music Video Are You,1,1,6,20,0,5,0,26,0
32 Ridiculously Clever Group Halloween Costumes,1,1,5,35,0,5,2,40,0
How I Earned My Porn Star Name,1,1,7,17,0,6,0,24,0
Can We Guess Your Relationship Status Based On Your Favorite Board Game,1,1,12,48,0,11,0,60,0
"Guess What, British People Are Taking The Piss Out Of Donald Trump Now",1,1,13,44,1,12,0,57,0
9 Differences Between Hanging Out With Your New Friend Vs. Your Best Friend,1,1,12,49,1,12,1,61,0
"17 Weird, Gross, Hilarious Things Everyone On Their School Football Team Did Together",1,1,12,57,2,12,2,69,0
Disney Villains In Real Life,1,1,5,19,0,4,0,24,0
"Hipsters, heritage and Handel – how cities can escape London’s shadow",1,3,3,53,3,10,0,56,0
Corruption tour shines light on murky world of graft in Mexico,1,2,2,50,0,10,0,52,0
Who Are All The Celebrities Wearing At 2016's Golden Globes,1,1,9,36,1,9,4,45,0
"Which ""Teen Wolf"" Pack Do You Belong In",1,1,8,22,2,7,0,30,0
Take A Look Back At The Biggest Black Friday Toys Of The Past 20 Years,1,1,14,40,0,14,2,54,0
"Which ""Gotham"" Character Would Be Your Best Friend",1,1,8,33,2,7,0,41,0
14 Celebrity Names You ALWAYS Have To Google,1,1,12,23,0,7,2,35,0
Which Makeup Item Are You,1,1,5,16,0,4,0,21,0
Gay marriage opponents are suddenly all about states’ rights. Wonder why.,1,3,2,58,3,10,0,60,0
Saving the Easter bunnies of the Brecks,1,3,3,30,0,6,0,33,0
"15 Stages Of Surviving An Australian Summer As Told By ""The Simpsons""",1,1,11,43,2,11,2,54,0
22 Things You'll Know If You're A Massive Prude,1,1,8,27,2,8,2,35,0
"Which ""How To Get Away With Murder"" Character Should Be Your Partner In Crime",1,1,14,48,2,13,0,62,0
21 Men On Tinder Who Need To Log Off And Think About What They Have Done,1,1,15,40,0,15,2,55,0
ABC News quiz: Trump's taxes and Weatherill's slanging match with Frydenberg,1,2,7,56,3,10,0,63,0
Free to a good gnome? Woman baffled after more than 100 garden ornaments turn up in her front garden overnight,1,3,2,85,1,19,3,87,0
"WSJ: Trump clings to wiretap claim ‘like a drunk to an empty gin bottle,’ damaging his credibility",1,3,4,74,4,16,0,78,0
"Karachi's Diwalis Are Getting Quieter By The Year, And Here's Why",1,1,11,41,3,10,0,52,0
24 Forgotten Trends All Mid-'00s Teen Girls Were Slightly Obsessed With,1,1,10,45,2,10,4,55,0
19 Fixes For Every Clothing Emergency,1,1,5,25,0,5,2,30,0
The Most Delicious And Foolproof Way To Cook Salmon,1,1,9,34,0,8,0,43,0
Signs You're Dating The Wrong Person,1,1,6,24,1,5,0,30,0
We Know Your Favorite Food Based On Your Favorite Chrissy Teigen,1,1,11,43,0,10,0,54,0
15 Gorgeous People With Disabilities Who Are Winning The Style Game,1,1,10,45,0,10,2,55,0
29 Hilarious Literary Internet Puns,1,1,4,25,0,4,2,29,0
These hidden gems serve West African dishes you’d be hard-pressed to find anywhere else,1,3,3,69,2,13,0,72,0
Bargain Street Style From London Shoppers,1,3,6,30,0,5,0,36,0
"This Is The Best ""Scream Queens"" Drinking Game Ever",1,1,9,32,2,8,0,41,0
"The First ""Grease: Live"" Teaser Is Here And It's Absolutely Electrifying",1,1,11,47,4,10,0,58,0
This Woman Couldn't Help But Faint When Her Boyfriend Surprised Her With A Proposal,1,1,14,55,1,13,0,69,0
How to Protect Your Tax Refund From Scammers - Yahoo,1,3,8,34,1,9,0,42,0
The Electric Porsche Needs to Roar,1,3,5,24,0,5,0,29,0
Mayweather Promotions CEO Says Race is the Reason People Want to See Floyd Mayweather Fight Conor McGregor,1,3,17,73,0,16,0,90,0
What's The Best Song To Have Sex To,1,1,8,19,1,7,0,27,0
18 Posts That Prove Coconut Oil Is The Answer To All Your Problems,1,1,12,40,0,12,2,52,0
9 Disney Movies That Would Be Much Better If They Were Set In Scotland,1,1,13,43,0,13,1,56,0
How Obsessed Are You With Your Favourite Band,1,1,8,30,0,7,0,38,0
"In The Middle Of Assembly Session, Tripura MLA Grabs Speaker’s Mace And Tries To Sprint Away!",1,3,18,57,3,15,0,75,0
GameStop to shutter 100+ stores,1,3,2,21,1,4,3,23,0
"UK teacher becomes one of youngest people to die from dementia, aged 40",1,3,2,54,1,12,2,56,0
"Fitness takes hard work to gain, but how fast does it fade? Featured Stories Additional stories",1,3,4,74,2,15,0,78,0
What Does Your Bellybutton Say About Your Personality,1,1,8,38,0,7,0,46,0
Girl Scout takes on the mantle of truth in advertising,1,3,2,43,0,9,0,45,0
This Restaurant Has Been Selling Sandwiches Named After Alleged Rapists And Violent Men,1,1,13,62,0,12,0,75,0
Are You Smart Enough To Solve This Murder?,1,3,8,26,1,7,0,34,0
The latest reported reason teams aren't signing Colin Kaepernick: His vegan diet,1,2,4,63,2,11,0,67,0
How to get the stained glass look in your own home,1,3,1,39,0,10,0,40,0
Why The Warriors Are So Tough To Beat | FiveThirtyEight,1,3,11,34,1,9,0,45,0
Revealed: The perfect way to cook rice so that it's perfectly fluffy and NEVER sticks to the bottom of the pan ,1,2,7,81,2,21,0,88,0
Biden to Electoral Vote Objection: ‘It Is Over’,1,2,7,30,3,7,0,37,0
"How Well Do You Actually Know The Lyrics To ""Bidi Bidi Bom Bom""",1,1,13,36,2,12,0,49,0
Google Docs tool can show every edit a person has ever made,1,3,2,46,0,11,0,48,0
39 Accessories That Look Exactly Like Your Favorite Food,1,1,8,38,0,8,2,46,0
Trashy TV can reveal the ugly truths about domestic violence,1,3,3,48,0,9,0,51,0
Report: Malia Obama Attends Dakota Access Pipeline Protest at Sundance,1,3,9,51,1,9,0,60,0
18 Times “Community” Snuck In Hilarious Little Jokes That You Might’ve Missed,1,3,11,50,3,11,2,61,0
"23 Times Andy Dwyer From ""Parks & Rec"" Was Wrong About Everything",1,1,10,39,3,11,2,49,0
This Color Test Will Determine How You Like To Masturbate,1,1,10,38,0,9,0,48,0
16 Kids That Are Straight From A Horror Movie,1,2,8,27,0,8,2,35,0
Let Robots Teach Our Kids? Here’s Why That Isn’t Such a Bad Idea,1,2,12,37,3,12,0,49,0
"Teenager Chops 8-Year-Old Schoolmate Into Pieces, Throws His Heart Inside School For Revenge",1,2,14,62,3,12,1,76,0
21 Secrets American Eagle Employees Will Never Tell You,1,1,8,37,0,8,2,45,0
Australians Try Japanese Candy,1,1,4,23,0,3,0,27,0
Which Disney Princess Are You Based On Your Birth Month,1,1,10,36,0,9,0,46,0
The CEO of Dippin' Dots just responded to 5 years of angry tweets from Trump's press secretary,1,3,7,68,2,16,1,75,0
Conway: WikiLeaks Didn’t Convince Americans They ‘Didn’t Like’ and ‘Didn’t Trust’ Hillary,1,3,12,58,8,11,0,70,0
"21 Confessions From The Biggest ""Grey's Anatomy"" Fans On The Internet",1,1,10,44,3,10,2,54,0
This Man Surprised His Wife With The White Christmas Of Her Dreams,1,1,12,43,0,11,0,55,0
Branson offers some dads one year leave on full pay,1,3,1,41,0,9,0,42,0
This Photographer Takes Discarded Shopping Lists And Turns Them Into Freaky Recipes,1,1,12,60,0,11,0,72,0
Malin Akerman Plays The World's Hardest Game Of  Would You Rather,1,1,11,42,1,11,0,53,0
Campaign-Trail Marine Le Pen Blocked From Entering Migrant Camp,1,3,10,44,1,8,0,54,0
Krauthammer: Obama ‘Torched’ the Democrats’ Entire Minor League System,1,3,8,50,4,8,0,58,0
When You're In Love With Your Best Friend,1,1,8,25,1,7,0,33,0
Name That Disney Bird,1,1,4,14,0,3,0,18,0
This Mini Pop-Tart Recipe Will Awaken Your Childhood Soul,1,1,10,38,1,8,0,48,0
Thierry Henry Says What We're All Thinking About Sport's LGBT Issues,1,1,14,42,2,10,0,56,0
Women Had Their BFFs Cut Their Hair And It Didn't Turn Out So Great,1,1,16,37,1,13,0,53,0
‘The Desk Wants to Know’ ,1,3,4,14,2,5,0,18,0
"29 Times The ""13 Reasons Why"" Cast Were IRL Friendship Goals",1,3,11,33,2,10,4,44,0
NCAA Bracketology 2017: Real-Time Seed and Region Projections for All 68 Teams,1,3,12,47,2,11,6,59,0
Shocking Confessions Of Teen Mothers,1,1,5,27,0,4,0,32,0
19 Tweets About The Friend Zone That Are Way Too Real,1,1,10,31,0,10,2,41,0
Which Actor Should Be Your Leading Man,1,1,7,25,0,6,0,32,0
If Londoners Actually Told The Truth,1,1,6,25,0,5,0,31,0
When You Realize Every Guy Is Taken,1,1,7,22,0,6,0,29,0
Don't Panic: 7 Things To Do After Getting Fired,1,2,8,28,2,8,1,36,0
15 Products That’ll Make You Actually Look Forward To Second Semester,1,3,10,46,1,10,2,56,0
22 Signs You're Middle-Aged Before Your Time,1,1,7,27,2,6,2,34,0
Parents Will Totally Get Chrissy Teigen's Funny Story About Boogers,1,3,10,47,1,9,0,57,0
Dem Rep Gabbard: I’m ‘Doing My Homework’ on the Impeachment Process,1,3,9,44,4,10,0,53,0
20 Things You Need To Know About Those Famous Bed Bath & Beyond Coupons*,1,1,12,43,2,13,2,55,0
"14 Pictures ""HSM"" Zac Efron Took That He Wouldn't Today",1,1,11,30,3,9,2,41,0
19 Painful Confessions About Being An Artist,1,1,6,30,0,6,2,36,0
22 Honest Confessions From A Burger King Server,1,1,7,31,0,7,2,38,0
The First End-Of-The-Year Mashup Of 2015 Has Arrived,1,1,10,28,3,7,4,38,0
What Pet Name Should You Bestow Upon Your Significant Other,1,1,10,40,0,9,0,50,0
Man's commentary of a NY train giving zero f*cks about people is comedy gold,1,2,3,58,2,13,0,61,0
Saudi Prince Cops 80 Plane Tickets for His Fleet of Well-Traveled Falcons,1,2,10,49,1,11,2,59,0
How Full Of Christmas Cheer Are You,1,1,7,22,0,6,0,29,0
"Chris Brown, Soulja Boy to Settle Twitter Beef with $1M Boxing Match",1,3,10,44,2,11,1,54,0
"Crosby, Stills, Nash and Young Could Reunite Over Shared Hatred of Trump",1,3,10,49,2,11,0,59,0
17 Beauty And Skincare Products You Should Steal From Bae,1,1,9,37,0,9,2,46,0
33 Things Shia LaBeouf Said To Students In A Lift In The Oxford Union,1,1,14,40,0,13,2,54,0
19 Songs That Are Actually Fuckboy Anthems,1,1,6,28,0,6,2,34,0
"Far more on the line than an Aussie Open trophy for Federer, Nadal",1,3,5,48,1,12,0,53,0
Downton Abbey Star Michelle Dockery's Partner Has Died At The Age Of 34,1,1,12,44,1,12,2,56,0
Appeals Court Judges Explain Why Donald Trump’s Immigration Order is Legal,1,3,10,53,1,10,0,63,0
12 Struggles That Are Too Real For Queer Vampires,1,1,8,31,0,8,2,39,0
"Pelosi: Barring Illegal Immigrants From Citizenship Is ‘Just Not Respectful, And Not Worthy of Our Country’",1,3,15,73,4,15,0,88,0
This Book Of Illustrated Quotes From Authors Will Inspire You,1,1,10,42,0,9,0,52,0
Michael Savage: Syria Is a No-Win Situation for America,1,3,8,37,2,8,0,45,0
26 Struggles All English / Scottish Couples Face,1,1,6,32,1,7,2,38,0
Dutch Court: Populist Lawmaker Wilders Guilty of ‘Incitement to Discrimination’,1,3,8,59,3,9,0,67,0
9 Best Wines Under $9,1,1,3,11,1,4,2,14,0
Viola Davis On Finally Playing A ‘Sexualized' Woman,1,2,8,34,2,7,0,42,0
"Do You Know Which TV Show This ""A"" Is From",1,1,11,20,2,9,0,31,0
Tell Us What Tiny But Wonderful Things You Are So Thankful For This Year,1,1,14,45,0,13,0,59,0
Kellyanne Conway’s Inauguration Outfit Gave People A Lot Of Feelings,1,2,10,48,1,9,0,58,0
Shock Video: Gunman Ambushes Police Officers Inside Arizona Walmart,1,3,9,49,1,8,0,58,0
What's The Worst Thing A Bug Has Ever Done To You,1,1,11,27,1,10,0,38,0
CargillVoice: How Millennials Are Driving Change In The Protein Industry,1,3,11,51,1,9,0,62,0
Donald Tusk row leaves Poland isolated in EU,1,3,5,32,0,7,0,37,0
Pete Wentz Wants Fall Out Boy To Collab With Taylor Swift,1,1,11,36,0,10,0,47,0
Why American Airstrikes Go Wrong ,1,3,5,23,0,5,0,28,0
Here's How Migos Will Make Sure Your Valentine's Day Won't Flop,1,3,11,39,3,10,0,50,0
22 Things Every Guy Does When He Starts Losing His Hair,1,1,10,33,0,10,2,43,0
"Sarah Palin Said The Most Amazingly Bizarre Thing At The ""Stop The Iran Deal"" Rally",1,1,15,52,2,14,0,67,0
Read This Inspiring Post By Robin Williams' Daughter On Depression,1,1,10,46,1,9,0,56,0
Here’s what your body would say if it could talk,1,3,1,37,1,9,0,38,0
17 Truths Only Book Lovers Will Understand,1,1,6,28,0,6,2,34,0
"If You Are Super Rich, You Probably Live in the U.S.: Chart",1,2,11,33,4,11,0,44,0
"Average British woman spends £70,000 on her appearance in a lifetime, research finds",1,2,2,62,3,12,5,64,0
The 9 People You Play In Beer Pong,1,1,7,19,0,7,1,26,0
"MILO Cameraman Assaulted, Equipment Broken",1,3,8,29,1,4,0,37,0
Why Facebook tracks internet outages around the world,1,3,2,44,0,7,0,46,0
The worms that invade your brain,1,3,1,26,0,5,0,27,0
Literally Just A Bunch Of Funny OITNB Quotes,1,1,12,25,0,7,0,37,0
Here's What You Should Eat For Dinner This Week,1,1,9,29,1,8,0,38,0
26 Kids Who Won Halloween With Their Gender-Bent Costumes,1,1,9,37,1,8,2,46,0
Which Version Of Alanis Morissette Are You,1,1,7,29,0,6,0,36,0
106 Memorable TV Deaths In 2015,1,1,5,14,0,5,7,19,0
"What Is Your ""Pretty Little Liars"" Season 1 IQ",1,1,9,26,2,8,1,35,0
"The Walking Dead to continue for 20 years, says producer",1,2,3,41,1,9,2,44,0
This New Beauty Trend Uses Pieces Of Plexiglass To Color Hair,1,1,11,40,0,10,0,51,0
How Many TV Shows Did You Watch In 2015,1,1,9,18,0,8,4,27,0
War of Words after David Crosby Calls Ted Nugent and Donald Trump a ‘Pair of A**holes’,1,3,11,56,4,15,0,67,0
Which Celebrity Is Actually Your Soulmate,1,1,6,30,0,5,0,36,0
This new podcast from the 'Serial' team is going to be your next obsession,1,3,2,57,2,13,0,59,0
Ex-State Staffer Who Advocated Spying On Trump Boasted Of ‘Getting Winks From Inside’ Obama Admin,1,3,16,64,3,14,0,80,0
What's Next for LA Clippers Following Chris Paul's Latest Injury?,1,3,10,43,3,9,0,53,0
Lin-Manuel Miranda on hosting the Oscars: 'It's not a thing I would ever want to do',1,3,6,58,5,15,0,64,0
First-born children really are the cleverest - and it’s all thanks to their parents,1,2,1,66,3,13,0,67,0
11 Of The Cutest Couples At The 2017 Golden Globes,1,3,8,27,0,9,6,35,0
19 Super Cute Dollar Store DIYs That Will Complete Your Bedroom,1,1,12,39,0,10,2,51,0
Life Without A Cat Vs Life With A Cat,1,1,9,20,0,8,0,29,0
"13 ""One Tree Hill"" Questions That Are Impossible To Answer",1,1,9,36,2,9,2,45,0
How Insufferable Is Your Family Being Right Now,1,1,8,32,0,7,0,40,0
22 Things All Latina Moms Understand,1,1,5,24,0,5,2,29,0
Isle of Man TT: Jamie Hamilton's injuries 'not life-threatening',1,2,6,45,5,8,0,51,0
The World's Most Expensive Cars For 2017,1,3,6,23,1,6,4,29,0
What It's Like To Date When You Can't Have Sex,1,1,10,25,2,9,0,35,0
Reminder That Jennifer Lopez Is Not A Real Human,1,1,9,31,0,8,0,40,0
"Which ""HIMYM"" Couples Halloween Costume Should You And Your S.O. Wear",1,1,16,39,4,10,0,55,0
"Here's The Coolest Easter Egg In ""The Force Awakens""",1,1,9,32,3,8,0,41,0
Christmas quiz: Do you know the story behind what's on your Christmas table?,1,3,3,58,3,12,0,61,0
18 Things Everyone With A Beard Will Understand,1,1,7,31,0,7,2,38,0
These Tacos Are The Epitome Of Cheese On Cheese,1,1,9,30,0,8,0,39,0
"How ""Harry Potter"" Would Be Different In Canada",1,1,8,30,2,7,0,38,0
53 Of The Best Opening Sentences In Literature,1,2,7,30,0,7,2,37,0
22 Helpful Tips For Completing BuzzFeed's 2016 Clean Eating Challenge,1,1,9,44,1,9,6,53,0
25 Best Jobs That Pay More Than $100K,1,2,7,17,1,7,5,24,0
Democrats Target Nunes After He Reveals Trump Transition Team Was Surveilled,1,3,11,55,0,10,0,66,0
This Woman Is Posting Heartbreaking Stories About Mental Health On Instagram To Fight Stigma,1,1,14,65,0,13,0,79,0
Brothers jailed for trafficking people from Poland to work at Sports Direct,1,2,4,60,0,11,0,64,0
Court settles debate that’s divided grammar nerds for decades,1,3,1,51,1,8,0,52,0
The 12 Absolute Greatest 30 Rock Cameos,1,1,5,24,0,6,4,29,0
A Comedian Talked About Being Abused And Raped In A Previous Relationship,1,1,12,50,0,11,0,62,0
Judge Jeanine to Liberals: ‘Donald J Trump Is the President for the Next Four Years — Deal With It’,1,3,14,63,4,18,0,77,0
16 Texts 2016 Is Actually Dying To Send You,1,1,7,22,0,8,6,29,0
Ruby Rose Tried To Dance Like Drake And It Was Perfect,1,1,11,33,0,10,0,44,0
19 Times It's OK To Hit The Panic Button,1,1,9,20,1,8,2,29,0
Stop Whatever You're Doing Right Now And Drool Over These Korean-Style Nachos,1,1,13,51,2,11,0,64,0
Which Belle And Sebastian Album Should You Listen To Right Now,1,1,11,41,0,10,0,52,0
The Carter incident: Why did WA Police leave a traumatised Aboriginal family stranded?,1,2,7,65,2,12,0,72,0
19 Times Kris Jenner Savagely Roasted The Hell Out Of Her Family,1,2,11,40,0,11,2,51,0
Today's Dose Of WTF: Four Topless Women Did Bollywood Dancing At Times Square Wearing Only Body Paint,1,1,19,64,2,16,0,83,0
This Gorgeous Man Travels The World Eating Pizza,1,1,8,33,0,7,0,41,0
"This ""Jurassic World"" Deleted Scene Is Literally The Shit",1,1,9,38,2,8,0,47,0
Where Should You Go On Vacation? Let Your Personality Type Decide,1,3,11,43,1,10,0,54,0
This Is For Everyone Who Fits Into Both Slytherin And Hufflepuff Houses,1,1,12,48,0,11,0,60,0
Alien bugs hitching a ride to Earth on spacecraft could ATTACK humans and must never be allowed to escape,1,3,8,79,0,18,0,87,0
"16 Products You Probably Own If You Were Slightly Obsessed With ""High School Musical""",1,1,13,55,2,13,2,68,0
Rick Ross on Kanye West 'Wigging Out': 'He Played Ya'll',1,3,9,32,6,9,0,41,0
23 Types Of Hummus Guaranteed To Blow Your Mind,1,1,8,29,0,8,2,37,0
‘Dirty Dancing’: See Photos From the ABC Remake,1,2,9,28,3,7,0,37,0
Survey: Most Americans lack savings to cover emergencies,1,2,3,45,1,7,0,48,0
This grandmother accidentally knitted something very NSFW The list,1,3,6,52,0,8,0,58,0
Crucial choice in 'Self/Less' movie clip: Would you want Ryan Reynolds' body?,1,2,6,54,6,11,0,60,0
Neil DeGrasse Tyson Talks About The Beauty Of Life And Death,1,1,12,38,0,10,0,50,0
13 Things to Know About the Charts This Week: Little Big Town Brings Taylor Swift Back to No. 1,1,3,14,58,2,18,3,72,0
23 Christmas Morning Treats Your Family Will Love,1,1,7,33,0,7,2,40,0
"The Playlist: Mary J. Blige Sings of Self-Empowerment, Kendrick Lamar Raps About Power ",1,2,13,57,4,13,0,70,0
This Is What It Feels Like To Have ADHD,1,1,12,19,0,8,0,31,0
De Blasio: NYC Will Be at Risk of Terror If Sessions Cuts Law Enforcement Funding to Sanctuary Cities,1,3,17,66,1,17,0,83,0
11 Quotes From Harry Potter To Help You Cope With Loss,1,1,10,32,0,10,2,42,0
A Flight Attendant’s Jet Lag Survival Guide,1,3,7,29,1,6,0,36,0
Turning to Twitter instead of the police,1,3,2,32,0,6,0,34,0
"Australia should consider shorter working week, Greens leader Richard Di Natale says",1,3,5,67,1,11,0,72,0
The 21 Most Adorable Puppies Of 2015,1,1,5,19,0,6,6,24,0
17 Times Jordin Sparks Totally Slayed The Instagram Game,1,1,8,38,0,8,2,46,0
Donald Trump’s Visitors Log Shows Who’s Shaping His Transition,1,3,9,43,2,8,0,52,0
Here's Why Tensions Are Flaring Over Gibraltar: QuickTake Q&A,1,3,11,39,3,8,0,50,0
'Facebook killer' Steve Stephens found dead in vehicle,1,2,3,42,2,7,0,45,0
How To Turn Classic Thanksgiving Foods Into Boozy Cocktails,1,1,9,42,0,8,0,51,0
19 Delicious Ways To Eat More Candy Corn This Fall,1,1,9,30,0,9,2,39,0
"Taylor Swift's Acoustic Version Of ""Blank Space"" Will Leave You Breathless",1,1,11,50,3,10,0,61,0
Ed Sheeran's 'Shape of You' & 4 Other Songs That Added Writers After Release,1,3,11,47,4,13,1,58,0
The Best Way To Explain Your Job To Family Who Don't Get It,1,3,13,33,1,12,0,46,0
Gabourey Sidibe Refuses To Back Down,1,1,6,25,0,5,0,31,0
This Silicon Valley couple saves animals from slaughter â take a look inside their farm,1,3,3,70,2,14,0,73,0
"You Guys, This Theory Explains Santa Perfectly Using “Harry Potter”",1,3,10,45,3,9,0,55,0
"Is This A Europa League Team Or ""Game Of Thrones"" Location",1,1,11,35,2,10,0,46,0
These Are The Recipes You Need To Try In 2017,1,3,9,23,0,9,4,32,0
19 Style Influencers Who Aren't Kylie Jenner,1,1,6,29,1,6,2,35,0
This Ad Just Might Feature The Cutest Use Of Spanglish Ever,1,1,11,38,0,10,0,49,0
"Hurrah, Dollars Are Now Flowing (Almost) Normally Again",1,3,8,37,3,7,0,45,0
Can You Tell The Difference Between These MAC Lipsticks,1,1,11,36,0,8,0,47,0
Most important breast cancer drug in two decades will not get NHS funding,1,3,4,57,0,12,0,61,0
The Official Sonic The Hedgehog Twitter Lost Its Mind In 2015 And It Was Amazing,1,1,14,48,0,14,4,62,0
Only Solve This Puzzle If You Hate Authority,1,1,8,29,0,7,0,37,0
Why did alleged Ft. Lauderdale airport shooter get gun back from police?,1,3,3,56,2,11,0,59,0
"Here's How Miley Cyrus, Kylie Jenner, Chrissy Teigen, and Other Celebrities Rang in Christmas",1,3,12,64,4,13,0,76,0
"This Antiques Roadshow guest just discovered her family heirloom is worth £150,000",1,2,3,60,2,11,6,63,0
20 Of The Most Embarrassing Things That Have Happened To People At The Gym,1,1,13,46,0,13,2,59,0
17 Signs You're An Adult But Also Still A Kid,1,2,9,24,1,9,2,33,0
Can You Beat This Infuriating A To Z Geography Quiz?,1,3,10,32,1,9,0,42,0
16 DIYs You Can Make With Old Toys Because Growing Up Is Overrated,1,1,14,38,0,12,2,52,0
13 Ways Your Makeup Habits Can Make You Sick,1,1,8,26,0,8,2,34,0
The New Wonder Woman Movie Officially Looks Amazing,1,1,8,36,0,7,0,44,0
What “I’m so busy!” really tells your friends,1,2,2,32,4,7,0,34,0
"Do You Remember The Lyrics To ""Welcome To The Tipton"" From ""The Suite Life Of Zack And Cody""",1,1,18,53,4,17,0,71,0
Can You Tell Which Pop Star Is Older,1,1,8,21,0,7,0,29,0
"Stephen Colbert Went Full ""Hunger Games"" Last Night",1,1,8,34,2,7,0,42,0
Corruption tour shines light on murky world of graft in Mexico,1,3,2,50,0,10,0,52,0
These Designers Reinvented Disney Princesses' Shoes And They Are Amazing,1,1,10,52,1,9,0,62,0
Spike Lee calls out teams for not signing free agent Colin Kaepernick,1,3,4,54,0,11,0,58,0
24-hour work shifts can wreak havoc on the heart,1,2,0,37,1,8,2,37,0
Adventurous Father’s Day Gifts,1,3,4,22,1,3,0,26,0
A Dad Turned All The Ridiculous Things He Ends Up Saying To His Kids Into A Book,1,1,17,47,0,16,0,64,0
Christmas Day? Groundhog Day? I can’t tell the difference,1,3,5,41,3,8,0,46,0
Samsung May Be Just Fine After Chief's Arrest,1,2,8,29,1,7,0,37,0
This Couple With Down Syndrome Threw The Most Magical Wedding,1,3,10,42,0,9,0,52,0
3 Homemade Nut Butter Cup Recipes,1,1,5,22,0,5,1,27,0
23 Words You'll Only Understand If You're From Indiana,1,1,8,34,2,8,2,42,0
We visited Ralph Lauren's soon-to-close flagship Polo store and saw why the brand is struggling,1,2,4,74,3,14,0,78,0
One California Democrat Admits He’s Tired of Trashing Trump,1,3,8,42,1,8,0,50,0
What Is Your Weirdest Fear,1,1,5,17,0,4,0,22,0
ADPVoice: 4 Ways Organizations Around The World Are Helping Working Mothers,1,3,13,50,1,10,1,63,0
"There's A New Doctor On ""Grey's Anatomy"" And He's Hot AF",1,1,12,29,5,10,0,41,0
10 Rare Pepe Gifts That'll Prove You're Not A Normie,1,1,9,30,2,9,2,39,0
The World's Shortest Man Has Died At 76,1,1,7,22,1,7,2,29,0
Fatherly advice: Kris Bryant's dad has suggestions for LaVar Ball,1,3,6,48,2,9,0,54,0
18 Cats Who Are Ready For Christmas,1,1,6,21,0,6,2,27,0
7 Ways To Style Your Braids If You Suck At Hair,1,1,10,26,0,10,1,36,0
"Joss Whedon, Tim Burton, And Anne Rice Are Appearing In A Vampire Documentary",1,1,13,50,2,12,0,63,0
How Pope Francis is about to reshape the climate discussion,1,3,3,47,0,9,0,50,0
"People Keep Making The Same Joke About ""House Hunters"" And It's Funny AF",1,3,14,43,3,12,0,57,0
14 Chilling Pictures of Incredible Underwater Sculptures,1,2,5,43,0,6,2,48,0
21 Call Center Horror Stories That'll Give You Nightmares,1,1,8,38,1,8,2,46,0
12 Corporate Mascots From Your Childhood Who Weren't As Cool As They Thought,1,1,12,49,1,12,2,61,0
WATCH: Girls from Viral 'Missing Legs' Photo Explain the Mystery  Insider,1,2,13,46,3,11,0,59,0
"Which ""South Park"" Character Are You Actually",1,1,7,30,2,6,0,37,0
The Best of 2016 and Sometimes Well Before It,1,3,6,27,0,8,4,33,0
The 46 Best Stoner Memes On The Internet,1,1,7,24,0,7,2,31,0
How To Pose Like Jenny McCarthy And Donnie Wahlberg On A Red Carpet,1,1,14,41,0,12,0,55,0
Bullied teen creates magnificent prom dress and it is perfect payback,1,2,1,58,0,10,0,59,0
This Guy Lost The Rings Right Before He Proposed...And It Was Still Insanely Adorable,1,1,15,54,3,13,0,69,0
Can You Identify The TV Show Based On These Screencaps Of Drinks,1,1,13,40,0,11,0,53,0
Can You Pass This Cat-Themed Art History Quiz,1,1,9,28,1,7,0,37,0
This Young Trans Filmmaker At Sundance Wants To Revolutionize Trans Storytelling,1,1,11,59,0,10,0,70,0
Easy Ways To Boost Your Income Now To Pay For Summer Fun Ahead,1,3,13,37,0,12,0,50,0
How the Berlin attack suspect slipped through authorities' net,1,3,2,51,1,8,0,53,0
A Quick Shout-Out To Lupita Nyong'o's Umbrella Man,1,1,9,31,3,7,0,40,0
21 New Year's Resolutions For TV To Consider In 2016,1,1,9,27,1,9,6,36,0
22 Secrets Hotel Breakfast Waiters Are Supposed To Keep,1,1,8,37,0,8,2,45,0
16 Questions We Have About Kylie Jenner,1,1,6,25,0,6,2,31,0
"A supermodel-backed music festival where tickets cost up to $12,000 turned into a nightmare â here's what happened",1,3,1,87,6,17,5,88,0
They were hoping to get to the US -- and then Trump banned them,1,2,4,44,2,13,0,48,0
"The Entire ""Street Fighter V"" Cast Ranked By Design",1,1,9,32,2,8,0,41,0
"Do You Remember The Lyrics To ""Time After Time"" By Cyndi Lauper",1,1,12,38,2,11,0,50,0
Watch This Woman Talk About Her Struggle As A Two-Time Survivor Of Child Sexual Abuse,1,1,16,54,1,14,0,70,0
TV Producer Ken Ehrlich on His Most Memorable Grammy Moments,1,2,10,41,0,9,0,51,0
27 Perfect Prints Your Walls Wish That You'd Buy,1,1,8,29,1,8,2,37,0
Watch Big Sean Spit A Freestyle For Funkmaster Flex,1,2,9,34,0,8,0,43,0
18 Times @Nenshi Proved He Was Canada's First Internet Dad,1,1,9,36,2,9,2,45,0
MILO to Bill Maher: It’s Now Breitbart Publishing the Exciting Gay Editorials,1,3,13,51,2,11,0,64,0
"How Well Do You Know ""The Devil Wears Prada""",1,1,9,25,2,8,0,34,0
Everybody Is Crying Over This Heartwarming Christmas Advert,1,3,8,44,0,7,0,52,0
"5 of the worst atrocities carried out by British Empire, after 'historical amnesia' claims",1,3,2,71,3,13,1,73,0
‘Great Wall’ Star Matt Damon: ‘I’m Not a Believer in Walls’,1,2,9,34,6,10,0,43,0
"21 Ladies Who Killed It At The ""Essence"" Street Style Block Party",1,1,11,39,2,11,2,50,0
26 Times Kim Kardashian Was Shut Down By Her Own Family,1,1,10,33,0,10,2,43,0
"28 Shots Of ""Breaking Bad"" Characters That Are Beautifully Composed",1,1,9,45,2,9,2,54,0
Can We Guess Your Zodiac From The Garbage Person You'd Date,1,1,11,37,1,10,0,48,0
24 Things You'll Only Understand If You're Slightly Obsessed With Traveling,1,1,10,51,2,10,2,61,0
The polar vortex is coming. Here’s what that means — and how cold it could get.,1,3,2,58,4,15,0,60,0
Everything you wanted to know about 'Rogue One' but were afraid to ask,1,3,3,53,2,12,0,56,0
"How Well Do You Know The Job Descriptions On ""The Bachelor/Bachelorette""",1,1,12,47,3,10,0,59,0
Here Are Some Handy Color Charts For Your Burger King-Induced Green Poop,1,1,13,47,1,11,0,60,0
I Used To Be Ashamed Of My Fear. Then I Started Training As An Acrobat,1,1,15,40,1,14,0,55,0
Don’t call Donald Trump a liar – even if he is one,1,3,3,34,2,11,0,37,0
14 Ridiculously Awesome Toaster Snacks To Get You Through The Cold,1,1,10,44,0,10,2,54,0
This Word Association Test Will Reveal Your True Self,1,1,9,36,0,8,0,45,0
Ancient Chinese tomb-sweeping festival goes hi-tech,1,2,2,42,2,5,0,44,0
"Fathers and Sons review – a poignant, poetic memoir",1,3,2,39,2,8,0,41,0
"WWE Wrestler Glenn Jacobs, Aka Kane, Will Run as Republican for County Mayor in Tennessee",1,2,14,59,2,14,0,73,0
"Nissan recalls more than 56,000 cars, cites power steering ",1,3,1,42,2,9,5,43,0
23 Super Stylish Products Every Elephant-Lover Needs To Own,1,1,9,39,1,8,2,48,0
"People Judged Me On My Weight Post-Pregnancy, Says Shilpa Shetty On Fat-Shaming Of New Mothers",1,3,17,60,3,14,0,77,0
Damian Lewis webchat – post your questions now,1,3,2,36,1,7,0,38,0
Beijing: The city where you can't escape smog,1,2,2,34,2,7,0,36,0
Everyday Struggles Of A Germophobe,1,1,5,25,0,4,0,30,0
We Know Your Age Based On Your Opinions About Disney Villains,1,1,11,40,0,10,0,51,0
Here's What Would Happen If Flight Attendants Were Honest,1,1,9,39,1,8,0,48,0
Here's Everyone Who Attended The BAFTAs,1,1,10,23,1,5,0,33,0
18 Celebrities Who Were Really Hot When They Were Younger,1,1,9,37,0,9,2,46,0
"15 ""Gossip Girl"" Book Plotlines That Never Made It To The Show",1,1,11,36,2,11,2,47,0
2017 MLB Rookies Who Are Being Hyped Up Too Early,1,3,11,25,0,9,4,36,0
17 Insanely Delicious Ways To Cook Butternut Squash This Fall,1,1,9,41,0,9,2,50,0
"Go Ahead, Write a Check for Your Coffee, I’ve Got All Day",1,3,10,33,3,11,0,43,0
"Aziz Ansari's ""Master Of None"" Nails Race Perfectly",1,1,8,33,3,7,0,41,0
Is This A Jessica Or Ashlee Simpson Lyric,1,1,8,26,0,7,0,34,0
17 Clever Products That Will Make Chores Suck Less,1,1,8,32,0,8,2,40,0
This Is What $1 USD Gets You In Food All Around The World,1,1,14,29,1,12,1,43,0
The 10 best things to do this week,1,3,1,24,0,7,2,25,0
"We want children, but my husband struggles to climax through intercourse",1,2,1,60,1,10,0,61,0
Prince George steals the show as Royal Family leaves Christmas Day service,1,2,6,57,0,11,0,63,0
10 Insanely Delicious Veggie Noodle Recipes That Are Better Than Pasta,1,1,10,48,0,10,2,58,0
17 Glorious Bacon-Wrapped Foods That Will Sexually Awaken You,1,1,9,41,1,8,2,50,0
"Russia should reinstate the monarchy and appoint PUTIN as royal emperor, says influential Moscow churchman ",1,2,7,84,1,15,0,91,0
20 Hidden Messages In Cartoons That Probably Made You The Messed Up Person You Are Today,1,3,15,56,0,15,2,71,0
People Are Rushing To Get Critical Prescriptions Out Of Fear Over Obamacare Repeal,1,2,13,57,0,12,0,70,0
How Badly Are You Taking The One Direction Hiatus,1,1,9,32,0,8,0,41,0
"How Well Do You Remember ""Juno""",1,1,6,18,2,5,0,24,0
Try To Guess The Christmas Movie From A Single Letter,1,3,10,34,0,9,0,44,0
"New Details in ""Flip or Flop"" Stars' Divorce",1,3,6,28,3,7,0,34,0
17 Reasons Why Natural Hair Is Not A Good Look,1,1,9,26,0,9,2,35,0
23 Albums You Definitely Owned As A Christian Teenager In The '90s,1,1,10,40,1,11,4,50,0
Things You Wouldn't Have If Black People Didn't Invent It,1,1,10,36,2,9,0,46,0
Mom Blasted for Encouraging Toddler to Pole Dance in Disturbing Video,1,3,8,51,0,10,0,59,0
"2,000 years later, scientists finally know what's in these charred Roman scrolls",1,3,1,61,3,11,4,62,0
9 Wonderfully Weird Ornaments For People Who Don't Do Tradition,1,2,9,43,1,9,1,52,0
22 Mindblowing Books For Anyone Who’s Slightly Obsessed With True Crime,1,2,10,48,1,10,2,58,0
Backflip Catch Attempt off Rooftop Ends Horribly,1,3,6,36,0,6,0,42,0
Cyclone Debbie: Meet the storm chaser who gets a thrill from severe weather,1,2,3,59,1,12,0,62,0
21 Things Only Costco Food Lovers Will Understand,1,1,7,33,0,7,2,40,0
"This ""Gilmore Girls"" Fan Designs Beautiful Posters Inspired By The Show",1,1,11,48,2,10,0,59,0
"Do You Remember ""Crazy Funky Junky Hat"" From ""Wizards Of Waverly Place""",1,1,12,44,4,11,0,56,0
These Canadians Won Lots Of Money And Then Took An Adorable Photo,1,1,12,42,0,11,0,54,0
14 Things PM Modi Said In His 'Mann Ki Baat'+5 Must Read Stories,1,3,13,33,3,12,3,46,0
Meet The Three Bachelors Played A Key Role In BJP's Uttar Pradesh Triumph,1,3,15,45,1,12,0,60,0
11 Shibas Who Would Please Like You To Go On,1,1,9,24,0,9,2,33,0
"Which TV Show Should You Binge-Watch, Based On Your Favorite Curse Word",1,1,14,44,2,11,0,58,0
11 Awkward Moments You Have To Face During The Holidays,1,1,9,35,0,9,2,44,0
21 Desserts That Prove Bourbon Makes Everything Better,1,1,7,38,0,7,2,45,0
19 People Who Look Just Like Macklemore,1,1,6,25,0,6,2,31,0
10 things to watch on national signing day,1,3,0,33,0,7,2,33,0
5 Key Takeaways From President Trump’s Speech ,1,2,6,31,1,7,1,37,0
"In Europe, Four Main Concerns About Trump",1,3,7,27,1,6,0,34,0
21 Truths For People Who Like Animals More Than Other Humans,1,1,10,38,0,10,2,48,0
What New Song Should You Play On Repeat This Weekend,1,1,10,33,0,9,0,43,0
Trump Isn't America's Only Billionaire Politician -- Meet The Others,1,3,9,46,4,9,0,55,0
The Best Podcasts for Self-Improvement,1,3,5,28,1,4,0,33,0
24 Pictures That Prove Kids Invented Being Assholes,1,1,7,35,0,7,2,42,0
"Bill Nye and Tyler, The Creator just dropped the hottest theme song ever",1,2,5,54,1,12,0,59,0
19 Times You Realized You Were Dating Target,1,1,7,28,0,7,2,35,0
"The Isolated Vocal Track Of Freddie Mercury And David Bowie Singing ""Under Pressure"" Is Amazing",1,1,15,64,2,14,0,79,0
8 ingenious innovations helping autistic children communicate,1,3,0,54,0,6,1,54,0
America’s 100 Richest Places,1,3,3,18,1,3,3,21,0
Everything You Need To Know About The Man Behind Lord Varys,1,1,11,38,0,10,0,49,0
"5 Reasons ""The Last Witch Hunter"" Is The Most Vin Diesel Movie Ever",1,1,12,40,2,12,1,52,0
The super-secret division in charge of the Russia investigation,1,2,2,52,1,8,0,54,0
Backflip Catch Attempt off Rooftop Ends Horribly,1,2,6,36,0,6,0,42,0
21 Theories About Jack On “This Is Us”,1,2,7,20,2,7,2,27,0
Courageous bus driver apprehends thief after witnessing crime,1,3,1,53,0,7,0,54,0
"Here's What The Stars Of ""Casper"" Look Like Today",1,1,9,29,3,8,0,38,0
This Test Will Determine How Word-Sensitive You Are,1,1,9,34,1,7,0,43,0
25 Gifts For People Obsessed With The Ocean,1,1,7,27,0,7,2,34,0
Does Your Family Have Embarrassing Terms For Bathroom Stuff,1,1,9,42,0,8,0,51,0
Why more people die on January 1 than any other time of the year ,1,2,2,48,0,14,1,50,0
If Men In Bond Films Were Named Like The Women,1,1,10,27,0,9,0,37,0
Trump Isn't America's Only Billionaire Politician -- Meet The Others,1,2,9,46,4,9,0,55,0
Fred Savage Can't Go Home Again,1,1,6,19,1,5,0,25,0
Body language expert reveals nine ways to spot a liar (and how YOU can get away with telling fibs),1,3,4,74,2,18,0,78,0
Flying? ‘Bad Romance’? What to Expect From Lady Gaga’s Super Bowl Halftime Show ,1,3,12,50,5,13,0,62,0
Are You Actually Taylor Swift?,1,2,5,20,1,4,0,25,0
17 Thanksgiving Turkey Mistakes Everyone Makes,1,1,5,34,0,5,2,39,0
We Invaded Three Queer Lady Couple's Apartments To See What It's Like After The U-Haul,1,1,16,53,3,14,0,69,0
The Recent U.S. Terror Plots You Won't Hear Donald Trump Talking About,1,3,13,43,3,11,0,56,0
17 Delicious Foods You Should Be Eating For Better Skin,1,1,9,35,0,9,2,44,0
Viola Davis And Jimmy Kimmel Want You To Understand The Dangers Of Texting While Walking,1,1,15,59,0,14,0,74,0
We Know Your Favorite Christmas Movie Based On What You're Hungry For,1,1,12,45,1,11,0,57,0
Amy Schumer Exits ‘Barbie’ Movie,1,3,5,21,2,4,0,26,0
Puppies Tested The New BB-8 Toy And It's Everything You Need,1,1,12,35,2,10,1,47,0
Warren Buffett Explains How He Conquered Stage Fright,1,2,8,38,0,7,0,46,0
A reason for hope for (almost) every team,1,2,1,31,2,7,0,32,0
"Which ""Real Housewives"" Cast Should You Actually Join",1,1,8,36,2,7,0,44,0
Here are the must-see movies that are going to win Oscars in 2017,1,3,2,46,1,12,4,48,0
How To Get Your Green Card In America,1,1,8,22,0,7,0,30,0
"Here Is ""Hey Arnold"" As An Actual ""Football Head""",1,1,9,28,4,8,0,37,0
"17 Reasons Nadiya From ""Bake Off"" Was The Best British Person 2015",1,1,10,37,2,11,6,47,0
"Which ""Neon Genesis Evangelion"" Character Are You",1,1,7,34,2,6,0,41,0
"Yes, old people totally understand emoji (except maybe that eggplant one)",1,3,1,59,3,10,0,60,0
"If You Get More Than Five Wrong On This Quiz, You’ve Probably Never Seen A Penis",1,3,16,47,2,15,0,63,0
Are YOU popular on Tinder? Dating app reveals the most right-swiped names of 2016,1,3,6,56,2,13,4,62,0
21 Things You've Never Noticed At Disneyland,1,1,6,29,1,6,2,35,0
Here's How The World's Richest Cricket Board Dug Its Own Grave And Sank Very Deep,1,3,15,50,2,14,0,65,0
Watch A Very Vulnerable $140 Quadcopter Drone Get Hacked Out Of The Sky,1,3,12,43,1,12,3,55,0
How To Profit From Trump Inflation,1,2,6,23,0,5,0,29,0
Which TLC Show Matches Your Zodiac Sign,1,1,9,24,0,6,0,33,0
Pi Day: A number of things to know,1,3,3,23,1,7,0,26,0
18 Of The Best Headphones You Can Get On Amazon,1,3,9,27,0,9,2,36,0
"In Case You're Wondering, This Is What David Beckham Looks Like Dressed Up As Freddie Mercury",1,1,16,60,2,15,0,76,0
Here's Proof All Beauty Brand Models Actually Look Exactly The Same,1,1,11,45,1,10,0,56,0
Rupert Murdoch's most controversial tweets,1,2,2,35,1,4,0,37,0
Police Investigation After Woman Brutally Beaten by ‘Anti Fascists’ for Wearing National Flag Bracelet,1,3,12,75,2,13,0,87,0
"Oh My God, There's Going To Be A ""Friday Night Lights"" Reunion In Texas",1,1,14,40,4,13,0,54,0
Which Of Kylie Jenner's Instagram Poses Is The Most YOU,1,1,12,33,1,9,0,45,0
"Who Said It: Ron Swanson From ""Parks And Rec"" Or Stanley From ""The Office""",1,1,14,42,5,13,0,56,0
21 Times The Internet Was Super Accurate About Aunts And Uncles,1,1,10,41,0,10,2,51,0
"12 Christmas Gifts To Americans, Love Canada",1,1,6,29,1,6,2,35,0
"All The Times Jackie And Kelso Kissed On ""That 70's Show""",1,1,10,32,3,10,2,42,0
16 Badass Cat Forts,1,1,3,11,0,3,2,14,0
"This Dad Had A Brilliant Response For When A ""Small-Minded"" Commented Didn't Approve Of His Son's Costume",1,1,18,66,5,16,0,84,0
THE FUTURE OF RETAIL 2016 [SLIDE DECK],1,2,26,0,2,6,4,26,0
"Mark Zuckerberg Does Pull-Ups With His Daughter Max, Insists She Is The 'Most Demanding Trainer'!",1,3,16,62,5,14,0,78,0
One Direction Just Released A Heartbreaking New Track From Their Upcoming Album,1,1,12,56,0,11,0,68,0
How Stereotypically Mum Is Your Mum,1,1,6,24,0,5,0,30,0
"Forget coffee, this adorable baby has the greatest morning routine ever",1,2,1,59,1,10,0,60,0
Which Jessie J. Song Are You,1,1,6,16,1,5,0,22,0
13 Basic Cooking Techniques Everyone Should Know,1,1,6,34,0,6,2,40,0
"How Well Do You Know ""Pretty Little Liars""",1,1,8,25,2,7,0,33,0
Topshop’s Graphic Tee Has a Major Typo,1,2,6,25,1,6,0,31,0
"Blake Lively, Taylor Swift, And A Kangaroo Took A Selfie Together",1,1,11,42,2,10,0,53,0
Walmart is reportedly about to buy the hottest men's clothing brand,1,3,1,55,1,10,0,56,0
A High School Math Problem Asked Students To Choose Who Sexually Assaulted Maya Angelou,1,3,14,60,0,13,0,74,0
"How People Who Have Struggled With Eating Disorders See ""Fat""",1,1,10,40,2,9,0,50,0
NBC Turns 90: A Look Back at 42 of Its Most Iconic Shows,1,3,11,28,1,12,4,39,0
40 Reaction GIFs Guaranteed To Help You Deal With Fuckboys,1,1,11,36,0,9,2,47,0
"Please get along, people tell presidents",1,3,1,33,1,5,0,34,0
Kanye West Postpones Presidential Run to 2024 After Trump Meeting,1,3,8,44,0,9,4,52,0
26 Pictures People Who Don't Work Out Will Never Understand,1,1,9,38,1,9,2,47,0
What Would A Disney Movie Of Your Life Be Like,1,1,10,27,0,9,0,37,0
19 Extremely Relatable Moments From A Chinese Dating Show,1,3,8,39,0,8,2,47,0
"Craig David Turned Justin Bieber's ""Love Yourself"" Into A Soulful Garage Tune And It's Amazing",1,1,15,61,4,14,0,76,0
"17 Times Schmidt From ""New Girl"" Was The Best Character On TV",1,1,12,34,2,11,2,46,0
"Here Is Tom Hiddleston Singing In ""I Saw The Light,"" You're Welcome",1,1,12,40,4,11,0,52,0
Which Disney Villain Song Should Be Your Anthem,1,1,8,32,0,7,0,40,0
What's The Most Mortifying Thing That Happened To You While Studying Abroad,1,1,12,51,1,11,0,63,0
Don't Read These Wikipedia Pages If You Want To Sleep Tonight,1,1,11,39,1,10,0,50,0
21 Dogs Named Bob,1,1,3,9,0,3,2,12,0
Do You Belong With The Plastics Or The Chanels,1,1,9,29,0,8,0,38,0
This Texture Test Will Reveal A Hidden Personality Trait,1,1,9,39,0,8,0,48,0
21 Times British People Confused The Hell Out Of Everyone On Twitter,1,1,11,44,0,11,2,55,0
"After Bitcoin Dropped 10%, How Likely Is An ETF Now?",1,3,11,27,3,9,2,38,0
What's The Craziest Experience You've Ever Had With A Vibrator,1,1,10,41,2,9,0,51,0
Ann Coulter: A Maniac Is Running Our Foreign Policy! (It’s Not Trump),1,3,12,41,5,11,0,53,0
BuzzFeed Press Blog,1,1,4,13,0,2,0,17,0
17 Photos That Prove Snoop Dogg Has The Greatest Hair Of All Time,1,1,12,39,0,12,2,51,0
People Are Losing It After This Student Publicly Roasted His College With Two Words,1,3,14,56,0,13,0,70,0
All the ways you could lose your seat on an airplane,1,2,1,41,0,10,0,42,0
22 Things All Emo Girls Owned In The '00s,1,1,7,21,1,8,4,28,0
17 Amazing Christmas Jumpers You Simply Must Have,1,1,7,33,0,7,2,40,0
27 Stores With Helpful Reviews That'll Make Online Shopping So Much Easier,1,3,11,49,1,11,2,60,0
Sextacles: How Snapchat's new Spectacles are being used in the sack,1,3,4,51,2,10,0,55,0
12 Gifts For The Cat Lover You Don't Like,1,1,8,22,1,8,2,30,0
"People Are Upset About Meryl Streep's ""I'd Rather Be A Rebel Than A Slave"" T-Shirt",1,1,16,47,5,14,0,63,0
19 Starter Kits That Will Help You Be Crafty AF In 2016,1,1,11,27,0,11,6,38,0
Blind date: ‘She definitely thinks I’m a witty guy’,1,2,3,36,4,8,0,39,0
9 Vitiligo Transformations That Prove The Power Of Makeup,1,1,8,40,0,8,1,48,0
What Percent Messy And Tidy Are You Actually?,1,3,8,29,1,7,0,37,0
Teen Nearly Blinded by Hair Dye,1,3,5,21,0,5,0,26,0
"The Trailer For ""Star Trek Beyond"" Shows Us A New Villain",1,1,11,34,2,10,0,45,0
16 Faces All Latinos Will Recognize Around The Holidays,1,1,8,37,0,8,2,45,0
Women Scientists Are Tweeting “Sexy” Photos Of Themselves At Work To Shut Down Sexism,1,3,14,56,2,13,0,70,0
We Know Your Bra Size Based On Random Questions,1,1,9,30,0,8,0,39,0
"The ""Star Wars: The Force Awakens"" Poster Holds Some Tantalizing Questions",1,1,11,50,3,10,0,61,0
How does Australia match up with the U.S. women ahead of opener?,1,3,4,46,3,11,0,50,0
Here's Why Bald Eagles Are Always Photographed From The Side,1,1,10,40,1,9,0,50,0
This Proposal Cake Will Put All Other Proposals To Shame,1,1,10,37,0,9,0,47,0
Tweetbot 3 for Mac review - Business Insider,1,3,4,31,1,7,1,35,0
We Know Which Christmas Movie You Should Star In,1,1,9,31,0,8,0,40,0
Poll: Half of College Students Believe Their Student Loans Will Be Forgiven,1,3,11,52,1,11,0,63,0
If You Don't Get 100 On This Quiz You Are A Fucking Moron,1,1,12,29,1,12,3,41,0
The Liquid Candy Bar Taste Test,1,1,6,20,0,5,0,26,0
The 25 Most Spectacular Fast Food Fails Of All Time,1,1,9,31,0,9,2,40,0
The Perfect Anywhere Workout,1,1,4,21,0,3,0,25,0
"Hey, McDonald's: Fix Your Damn Ice Cream Machine",1,1,9,29,3,7,0,38,0
Julianne Moore Busts Redhead Myths With Stephen Colbert,1,1,8,40,0,7,0,48,0
16 Jackie Chan Stunts That Perfectly Capture Your Twenties,1,1,8,40,0,8,2,48,0
"Which ""Crazy Ex-Girlfriend"" Character Are You",1,1,7,30,3,5,0,37,0
"We Know Which ""Game Of Thrones"" Character You Don't Like Based On Your Zodiac",1,1,14,47,3,13,0,61,0
"Alexa, what other devices are listening to me?",1,3,1,36,2,7,0,37,0
How the Dow Adds Up to 20000,1,3,4,13,0,6,5,17,0
"A Bunch Of People Are Texting Their Exes With Just Adele's ""Hello"" Lyrics",1,1,13,45,3,12,0,58,0
Can We Guess The Contents Of Your Makeup Bag,1,1,9,27,0,8,0,36,0
This Arizona Gubernatorial Candidate Wants You To Know All About His Sex Life,1,3,13,52,0,12,0,65,0
"Do You Remember The Halloween Costumes From ""The Office?""",1,1,9,37,3,8,0,46,0
"$50,000 Reward for Facebook Killer as Manhunt Goes ‘National’",1,2,6,38,4,8,5,44,0
An Ode To Yolanda Foster's Malibu Mansion,1,1,7,27,1,6,0,34,0
Is LeBron's NBA Finals performance the best ever? Not quite. He ranks eighth.,1,3,9,52,4,12,0,61,0
21 Hilarious Tweets That Perfectly Sum Up Your Relationship With Your Co-Workers,1,1,12,54,1,11,2,66,0
"Listen To BuzzFeed's New Podcast ""The Tell Show""",1,1,9,29,3,7,0,38,0
Pet 'emotion trackers' and intelligent jeans are here. But do we want them?,1,2,2,57,4,12,0,59,0
Alexei Navalny Wants Putin’s Job. Here’s What He’d Do With It,1,3,11,36,4,10,0,47,0
Jennifer Aniston And Justin Theroux Have Everyone's Dream Valentine's Day Plans,1,1,11,56,2,10,0,67,0
"You Need To See This ""Dirty Thunderstorm"" Over Mount Etna",1,1,10,36,2,9,0,46,0
13 Animals Totally Nailing This Halloween Thing,1,1,6,33,0,6,2,39,0
Drake Dancing To Bollywood Music Is The Best Thing On The Internet Right Now,1,1,14,49,0,13,0,63,0
Hangover Cures The Internet Swears By,1,1,6,26,0,5,0,32,0
CAMRA pub of the year 2017: Britain's best boozer revealed,1,3,6,37,2,9,4,43,0
17 Blind Dogs Who Will Make Your Day A Lil' Bit Better,1,1,11,29,1,11,2,40,0
Suspected Car Bomb Explodes in Swedish Capital Stockholm,1,2,7,42,0,7,0,49,0
"How Well Do You Know ""The Last Of Us""",1,1,9,18,2,8,0,27,0
We Bet You Can't Name All 30 NHL Teams In 5 Minutes,1,1,12,24,1,11,3,36,0
Bullied teen creates magnificent prom dress and it is perfect payback,1,3,1,58,0,10,0,59,0
ADPVoice: What We Learned About Benefit Policies In 2016,1,3,11,32,1,8,4,43,0
15 Untold Emergency Room Horror Stories That'll Make Your Skin Crawl,1,3,10,45,1,10,2,55,0
13 Cuties Who Are Ready For Sweater Weather,1,1,7,27,0,7,2,34,0
10 Waterfall Braid Hairstyles To Try This Summer,1,3,7,32,0,7,2,39,0
Trump Top Adviser Steve Bannon Attends NSC Meeting One Day After Being ‘Removed’,1,3,15,51,2,12,0,66,0
War of Words after David Crosby Calls Ted Nugent and Donald Trump a ‘Pair of A**holes’,1,2,11,56,4,15,0,67,0
My Mother And I Finally Opened Up About Our Depression And Anxiety,1,1,12,43,0,11,0,55,0
Carrie Fisher’s Urn Is a Giant Prozac Pill,1,2,7,27,1,7,0,34,0
Zayn Malik Looks Exactly Like Young Joseph Stalin,1,1,8,34,0,7,0,42,0
There's A Shadow On A Church In San Francisco That Looks Like A Sideboob,1,1,14,44,1,13,0,58,0
21 Fucking Great Gifts For Your Best Friend Who Loves Swearing,1,1,10,40,0,10,2,50,0
Fact Check: Spicer’s Pre-emptive Attack on the Nonpartisan C.B.O. ,1,3,9,42,6,9,0,51,0
Here’s the babygrow that’s making dads angry,1,3,1,35,2,6,0,36,0
Emojis: What The Fuck Do They Mean,1,1,7,20,1,6,0,27,0
Here's how LaCroix sparkling water gained a cult following,1,3,3,46,1,8,0,49,0
What Your Friends Say About You,1,1,6,20,0,5,0,26,0
This Is The Easiest Way To Make Vegan Fettuccine Alfredo,1,1,10,37,0,9,0,47,0
Which Kanye West Throwdown Tweet Are You,1,1,7,27,0,6,0,34,0
21 Experiences That Are Better Than Sex For People Who Love Food,1,1,11,40,0,11,2,51,0
New technology 'will detect potholes',1,3,1,30,2,4,0,31,0
This Is Your Next Netflix Murder Mystery Obsession,1,2,8,35,0,7,0,43,0
STOCKS DO NOTHING: Here's what you need to know,1,3,16,21,2,8,0,37,0
Songwriters Accuse Radio Stations of 'Illegal Cartel',1,3,6,39,2,6,0,45,0
Do You Own A Cat Or Does Your Cat Own You,1,1,11,20,0,10,0,31,0
Which Food Should You Encase In Sweet Gelatin This Year,1,1,10,36,0,9,0,46,0
Who Is Actually The Worst Sister?,1,3,6,21,1,5,0,27,0
There’s An Airline People Dislike Even More Than United,1,3,9,37,1,8,0,46,0
12 Confessions From People Who Struggle With Anxiety,1,1,7,36,0,7,2,43,0
Are You Brave Enough To Date A Werewolf,1,1,8,24,0,7,0,32,0
"Yes, Trump Is Being Held Accountable ",1,2,6,24,1,6,0,30,0
Can We Guess Your Age Based On Your Apps,1,1,9,23,0,8,0,32,0
This Artist Made Adorable Illustrations For Some Of The Best Pickup Lines,1,1,12,50,0,11,0,62,0
Golden Globes 2017 list of winners,1,3,2,23,0,5,4,25,0
"Which Zodiac Should You Date Based On Your Favorite ""Game Of Thrones"" Character",1,1,13,52,2,12,0,65,0
Which Fall Out Boy Is Your Soulmate,1,1,7,22,0,6,0,29,0
"People Are Dyeing Their Hair ""Pumpkin Spice"" Now",1,1,8,31,2,7,0,39,0
Which Instagram Filter Should You Use On Your First Picture Of 2016,1,1,11,41,0,11,4,52,0
The angry red panda that is Japan's new working woman,1,3,2,41,1,9,0,43,0
Exclusive: Patient With Extreme Form of TB Sent to NIH,1,3,11,33,1,9,0,44,0
11 Christmas Cards Only Mexican Moms Would Send,1,1,7,31,0,7,2,38,0
This Broadway Star Called Out His Audience For Shaming A Special Needs Child,1,1,13,51,0,12,0,64,0
Nasty or nice? Study links personality to brain shape,1,3,2,42,1,8,0,44,0
7 Cocktails to Make the Game of Thrones Finale Go Down Easier,1,3,8,41,0,11,1,49,0
14 Genius Last-Minute Halloween Costume Ideas For Redheads,1,1,8,40,1,7,2,48,0
6 Easy Ways To Tell If You Are Good With Money,1,3,10,25,0,10,1,35,0
The Try Guys Ruin Your Childhood (With Weird Costumes),1,1,9,35,2,8,0,44,0
"This Is What ""Bake Off"" Looks Like Around The World",1,1,10,30,2,9,0,40,0
School Van Driver Held For Raping Minor Girls In His Car For Over 6 Months,1,2,14,45,0,14,1,59,0
Here's A Mouthwatering Step-By-Step Guide To Making The Most Insanely Delicious Fried Chicken,1,1,15,63,3,12,0,78,0
Celebrities With Meet-Cute Stories,1,3,5,25,1,3,0,30,0
The Best Way To Explain Your Job To Family Who Don't Get It,1,2,13,33,1,12,0,46,0
Is This Halle Berry's Worst (But Also Best) Red Carpet Look Ever,1,1,12,38,3,11,0,50,0
What's the gender pay gap in my industry? New government tool lets you find out,1,3,2,61,2,14,0,63,0
18 German Shepherd Puppies Who Need To Be Snuggled Immediately,1,1,9,42,0,9,2,51,0
21 Products On Sale For Under $25 You Should Totally Buy If You Love Color,1,1,13,42,1,14,4,55,0
Syria conflict: The biblical river at the heart of a water war,1,2,2,48,1,11,0,50,0
"Which ""Pac-Man"" Ghost Are You",1,1,6,16,3,4,0,22,0
The Names Of Today's Hottest Canadian Celebrities According To A Dad,1,1,11,46,1,10,0,57,0
Asexual People Answer Questions You Have,1,1,6,29,0,5,0,35,0
15 Reasons December Is The Best Month,1,1,6,23,0,6,2,29,0
Swedish Police Chief Shut Down By Interior Minister After Call to Deport Terror Suspects,1,3,13,62,0,13,0,75,0
See Moment When Conjoined Twins Reunite After Surgery,1,2,8,38,0,7,0,46,0
Stop Everything You're Doing And Watch This Grandma Try Virtual Reality For The First Time,1,1,15,60,1,14,0,75,0
This woman saved a man’s life on their first date The list,1,3,2,44,1,11,0,46,0
"For a longer life, researchers say eat this many fruits and veggies per day",1,3,1,60,1,13,0,61,0
"Pay Up, Slowpokes: More States Fine Drivers Who Dawdle in the Left Lane",1,3,11,46,2,12,0,57,0
"Philly Fed manufacturing demolishes expectations, hits its highest level since 1984",1,3,2,66,1,10,4,68,0
19 Treats You Wish You Could Eat With Lorelai Gilmore,1,1,9,33,0,9,2,42,0
Almost Half of Criminal Suspects in Munich Are ‘Non-Germans’,1,3,8,41,3,8,0,49,0
We Know Where You'll Meet Your Soulmate Based On This One Question,1,1,12,42,1,11,0,54,0
Parents Will Totally Get Chrissy Teigen's Funny Story About Boogers,1,2,10,47,1,9,0,57,0
We Tried YouTube Makeup Tutorials And This Is What Happened,1,1,11,39,0,9,0,50,0
Farage: ‘A Lot of Trump Voters Will Be Scratching Their Heads’ over Syria Airstrikes,1,2,12,56,3,13,0,68,0
Kim Kardashian shared beauty tips in her first post-robbery public appearance,1,3,2,64,1,10,0,66,0
Payback Potential As Australian Prime Minister's 'Dumb Deal' Earns Trump Tongue-Lashing,1,2,12,61,4,10,0,73,0
BBC Dad Robert E. Kelly Gives Another Interview to the BBC [Video],1,3,14,38,3,11,0,52,0
13 Burning Questions For Ketchup Lovers,1,1,5,27,0,5,2,32,0
How Much Extra Beer and Pizza You Consume During March Madness,1,3,10,42,0,10,0,52,0
How Christmassy Is Your House,1,1,5,20,0,4,0,25,0
"Grace Jones Calls Out Rihanna, Gaga, Miley, And Co In Hilariously Blunt New Memoir",1,1,14,52,3,13,0,66,0
18 Pets With No Damn Respect For Books,1,1,7,22,0,7,2,29,0
Politico Scoop: Eric Trump Killed Two Deer,1,3,7,28,1,6,0,35,0
"The Best Eco-Friendly Superyachts, Toys and Tenders to Help Save the Planet",1,3,10,52,2,11,0,62,0
Workout Wear And Athleisure Style: 7 Ways To Workout In Style This Season,1,3,12,47,1,12,1,59,0
What's the gender pay gap in my industry? New government tool lets you find out,1,2,2,61,2,14,0,63,0
"In Nationwide Crackdown, Italy Announces ‘Zero Tolerance’ for Illegal Aliens",1,3,9,55,3,9,0,64,0
Are You More Light Or Dark Side Of The Force,1,1,10,25,0,9,0,35,0
Find Out What Dessert You Should Bake This Weekend,1,1,9,33,0,8,0,42,0
Klein: The Left’s Latest Desperate Tactic – Smear Trump As ‘Mentally Ill’,1,2,11,46,5,11,0,57,0
Woman jailed for helping Sabrina Moss' killer,1,2,3,35,1,6,0,38,0
Here’s Why Your Boobs Aren’t Perfectly Symmetrical,1,3,7,35,2,6,0,42,0
Literally Just 10 Photos Of Selena Gomez Looking Flawless At Z100 Jingle Ball,1,1,12,48,0,12,5,60,0
25 Amazing Gifts For Anyone Who Spends Most Of Their Time Snacking,1,1,11,42,0,11,2,53,0
How English sounds to people who don't speak English The list,1,3,4,46,1,10,0,50,0
16 Mac And Cheese Dishes That Are Better Than A Boyfriend,1,1,10,35,0,10,2,45,0
21 Things Every Self-Respecting Guy Over 30 Should Own,1,1,8,33,1,8,4,41,0
Washington Officer Shot Identified; Remains Critical ,1,2,6,40,1,6,0,46,0
You Could Be Wearing Ivanka Trump Right Now and Not Even Know It,1,3,12,40,0,12,0,52,0
Gun-Controlled Chicago Ends 2016 with Nearly 800 Homicides for the Year,1,3,7,46,1,10,7,53,0
27 Times It Actually Paid Off To Be Clumsy,1,1,8,24,0,8,2,32,0
39 Of The Funniest Texts From Straight White Boys In 2015,1,1,9,32,0,10,6,41,0
Indian Girl Receives A Thank You Letter From Obama After She Told Him He Was The Best President,1,3,18,60,0,17,0,78,0
Common Word Brain Farts,1,1,4,16,0,3,0,20,0
An Older Couple Gives Love Advice,1,1,6,22,0,5,0,28,0
New drone footage gives us the best look at Apple's spaceship campus yet,1,3,2,57,1,12,0,59,0
"Macklemore Has Released A Track Called ""White Privilege II"" And It's Something",1,1,13,51,3,11,0,64,0
Should Liam Hemsworth Or Chris Hemsworth Be Your Valentine,1,1,9,41,0,8,0,50,0
"In A Perfect World, Who Would Win At The Grammys This Year",1,1,12,34,1,11,0,46,0
18 Adorable Dogs Who Are So Ready For Fall,1,1,8,24,0,8,2,32,0
This Food Test Will Determine If You're Really From Florida,1,1,10,39,1,9,0,49,0
Joss Whedon: ‘I Want a Rhino to F*ck Paul Ryan to Death’,1,3,9,32,4,11,0,41,0
14 Moments Of Pure Bliss You’ll Only Recognize If You Live Alone,1,3,11,39,1,11,2,50,0
"Why Delta Air Lines Paid Me $11,000 Not To Fly To Florida This Weekend",1,2,13,37,2,13,5,50,0
21 Secrets About Postal Workers You Didn't Know You Needed,1,2,9,37,1,9,2,46,0
"This Promising New Technique May Be a Safer, Less Painful Way to Remove Birthmarks and Tattoos",1,3,13,65,1,15,0,78,0
These Famous Landmarks Photoshopped To Look Like The Zombie Apocalypse Are Chilling,1,1,12,60,0,11,0,72,0
"First Photo From ""Gilmore Girls"" Reboot Proves Lorelai Hasn't Aged",1,1,10,44,3,9,0,54,0
The Worst Way To Get Caught Cheating,1,1,7,23,0,6,0,30,0
"Europe’s drug use, in 2 maps",1,3,1,19,2,5,1,20,0
The 5 U.S. banks that draw the most customer complaints,1,3,3,40,2,9,1,43,0
Unrequited Love,1,1,2,12,0,1,0,14,0
"The 17 best jobs in America that pay over $100,000",1,2,2,29,2,9,8,31,0
The $99 Flights Everyone Is Freaking Out Over Come With A Major Catch,1,1,12,42,1,12,2,54,0
"Injecting natural oils for muscle gain could be deadly, doctors warn",1,3,1,56,1,10,0,57,0
21 Things Every Guy Should Know About His Black Girlfriend's Hair,1,1,10,42,1,10,2,52,0
17 Things Black People Deal With On A Daily Basis,1,1,9,29,0,9,2,38,0
If You Talked To People Like Your Pets,1,1,8,23,0,7,0,31,0
28 Things That Will Make You Impossibly Happy No Matter Your Mood,1,1,11,41,0,11,2,52,0
"I love social media, even if it doesn't love me back",1,3,1,39,2,10,0,40,0
11 Things All Introverts Should Know,1,1,5,24,0,5,2,29,0
We Gave Musicians An Elf On The Shelf And Here's What Happened,1,1,12,38,1,11,0,50,0
Can You Solve This Crossword About Farts,1,1,7,27,0,6,0,34,0
55 Pictures That Will Inspire You To Layer Up For Fall,1,1,10,32,0,10,2,42,0
Can We Guess Your Hogwarts House Based On What You Like The Most,1,1,13,39,0,12,0,52,0
"22 Mesmerizing, Mundane Photos Of A Day In The Life Of Darth Vader",1,1,12,39,1,12,2,51,0
Show Us Your Biggest Halloween Costume Fail,1,1,7,30,0,6,0,37,0
Which '00s Movie Leading Lady Are You Based On Your Zodiac,1,1,10,35,1,10,2,45,0
"Hyderabad Cops Catch 47 Kids Watching Porn, ISIS Beheadings In Internet Cafes, Parade Them In Front Of Media",1,3,20,67,2,17,2,87,0
15 great excuses to not go out tonight,1,3,0,29,0,7,2,29,0
"This Color Test Will Determine If You're Sexy, Hot, Or Cute",1,1,11,35,3,10,0,46,0
Making Yoga an Exercise in Democracy ,1,2,4,27,0,6,0,31,0
"Which Hogwarts Houses Do These ""Hannibal"" Characters Belong In",1,1,9,43,2,8,0,52,0
25 Things You Forgot You Used To Do,1,1,7,19,0,7,2,26,0
How Khalil Rafati quit crack cocaine and heroin to become a juice millionaire,1,2,3,62,0,12,0,65,0
Here's Mark Wahlberg Doing Pull-Ups In Slow Motion For Funsies/Hardsies,1,1,12,47,3,9,0,59,0
Gwen Stefani Talked About Her Divorce And It Will Depress The Crap Out Of You,1,1,15,48,0,14,0,63,0
"Did This Guy Just Take A Picture Of The ""Jersey Devil""",1,1,11,31,2,10,0,42,0
Superstitious People Go Ghost Hunting For The First Time,1,1,9,39,0,8,0,48,0
The People V. O.J. Simpson Reminds Us There Was A Time We Didn't Know Who The Kardashians Were,1,1,19,54,4,17,0,73,0
Not just healthy for student finances! How a humble serving of beans on toast can tackle the pain of gout,1,3,2,83,1,19,0,85,0
Five burning questions we have about 'Stranger Things' Season 2,1,2,4,47,2,9,1,51,0
24 Things That Will Make You Slightly Obsessed With The Netherlands,1,1,10,45,0,10,2,55,0
15 Ginger Desserts To Make Just In Time For Christmas,1,1,9,33,0,9,2,42,0
"Teen investigative journalists oust shady principal, give us all hope for future",1,2,1,67,1,11,0,68,0
"Inventory of Prince's Estate Lists Cash, Property and Gold Bars",1,3,8,44,2,9,0,52,0
Germophobe Struggles,1,1,2,17,0,1,0,19,0
We Made Andrew Garfield Build An Ikea Chair While Talking About His New Movie,1,1,14,50,0,13,0,64,0
The 10 Best-Paying Cities For Tech Jobs,1,3,7,23,1,6,2,30,0
Some of the Tests Ahead for Brazil’s President: QuickTake Q&A,1,3,9,40,3,9,0,49,0
This Couple Totally Shocked Her Father With This Adorable Pregnancy Announcement,1,1,11,59,0,10,0,70,0
36 Seriously Hot Men With Cute Cats That Will Melt You Completely,1,1,11,41,0,11,2,52,0
25 Times Billy Eichner Was The Most Hilarious Person On Twitter,1,1,10,41,0,10,2,51,0
"Kanye West Has Revealed His Album Title Is ""The Life Of Pablo""",1,1,12,37,2,11,0,49,0
24 Tumblr Posts Only Pop-Punk Fans Will Laugh At,1,1,9,28,1,8,2,37,0
Brandon Darby: Border Patrol Agents Feel Betrayed by the Trump Administration,1,3,9,57,1,10,0,66,0
What Halloween Movie Should You Watch Right Now Based On Three Questions,1,1,12,49,0,11,0,61,0
24 Songs You Sweatily Made Out To In 2005,1,1,7,20,0,8,6,27,0
MashTalk: Did WikiLeaks just do Apple and Google a huge favor?,1,3,7,43,2,10,0,50,0
7 Facts About History That Will Blow Your Mind,1,1,8,29,0,8,1,37,0
Do you have any cosmetic surgery regrets?,1,3,1,33,1,6,0,34,0
Tell Us About Yourself(ie): Rob Delaney,1,1,6,25,3,5,0,31,0
Can You Update a Passover Menu and Still Satisfy Traditionalists?,1,3,8,47,1,9,0,55,0
Which Slytherin Hybrid Are You,1,1,5,21,0,4,0,26,0
Trump dismisses explosive report on claims Russia compromised him: 'FAKE NEWS â A TOTAL POLITICAL WITCH HUNT',1,3,34,56,5,16,0,90,0
Here Are All The Winners At The 2016 BAFTAs,1,1,12,19,0,8,4,31,0
21 People Who Took Passive-Aggressive To A New Level In 2015,1,1,10,33,1,10,6,43,0
Which Lana Del Rey Album Are You,1,1,7,19,0,6,0,26,0
How Many Of These SpongeBob Faces Do You Recognize,1,1,10,32,0,8,0,42,0
17 Cats Really Loving The Cat Nip,1,1,6,19,0,6,2,25,0
31 Books That Will Help You Better Understand Mental Illness And Disorders,1,1,11,50,0,11,2,61,0
Romania protests: 'Race against time' for corruption fighters,1,3,2,49,3,7,0,51,0
How to Tie a Scarf,1,2,3,11,0,4,0,14,0
Miss America Apologized To Vanessa Williams After 32 Years,1,1,8,40,0,8,2,48,0
The 24 Best Fiction Books Of 2015,1,1,5,16,0,6,6,21,0
18 Cats Who Don't Believe In Books,1,1,6,19,1,6,2,25,0
"‘Life’ is no picnic for a crew of astronauts, but a real treat for the audience",1,3,1,60,3,15,0,61,0
Which Zodiac Should You Date Based On Your Zodiac Sign,1,1,10,35,0,9,0,45,0
Just Three Per Cent of Newly Arrived Migrants Have Found Work,1,2,10,41,0,10,0,51,0
A Father Surprised His Daughter By Standing Up Without His Wheelchair And Walked Her Down The Aisle,1,1,17,66,0,16,0,83,0
Senate Confirms Dr. Ben Carson 58-41 to Lead Housing and Urban Development Department,1,2,10,57,2,12,4,67,0
The parents who created a drug to save their daughters,1,3,1,44,0,9,0,45,0
"Six Months, No Interviews -- Until I Started Breaking The Rules",1,3,10,40,3,10,0,50,0
Only Solve This Crossword If BuzzFeed Is Your BFF,1,1,12,29,0,8,0,41,0
15 Campaign Signs That Are Actually Winning This Canadian Election,1,1,9,46,0,9,2,55,0
Retail chains are floundering and it's not because of Amazon,1,3,2,48,1,9,0,50,0
Trump's 20 Million Twitter Followers Get Smaller Under The Microscope,1,2,9,48,1,9,2,57,0
This Woman Loves Harry Potter So Much That She Buys A Book From Every Country She Visits,1,1,17,55,0,16,0,72,0
Why pizzas come with that plastic table in the center,1,3,1,43,0,9,0,44,0
A Gay Artist Quite Literally Schooled Someone Who Sent Him Hate Mail,1,1,12,45,0,11,0,57,0
Inside the mind of the accused Facebook Killer ,1,3,3,36,0,8,0,39,0
The 100 Most Important Puppy Photos Of All Time,1,3,8,28,0,8,3,36,0
"2017 NFL schedule: Record predictions, analysis for all 32 teams",1,3,4,43,2,9,6,47,0
"14 Times You Were Fiercely Linda From ""Bob's Burgers""",1,1,8,32,3,8,2,40,0
Mad Max Furiosa Tutorial With Kandee Johnson,1,1,7,31,0,6,0,38,0
11 Ways Make-Up Was So Much Worse In The '00s,1,1,9,21,2,9,4,30,0
What Can You Buy For $1 In Your Country,1,1,8,21,1,8,1,29,0
Time To Settle It Once And For All: What's The Best Chocolate Candy You Could Get On Halloween,1,1,18,57,2,17,0,75,0
Why You Shouldn't Have A Smartphone,1,1,6,23,1,5,0,29,0
They’ve had Redskins tickets for more than 50 years. They’ve finally had enough.,1,3,3,59,4,12,2,62,0
Here's Justin Bieber Looking Gorgeous While Skateboarding And Playing Instruments,1,1,10,61,1,9,0,71,0
How Monday Was Your Monday,1,1,5,17,0,4,0,22,0
Ranveer Singh Talked About Facing The Casting Couch And It's Uncomfortably Real,1,1,12,55,1,11,0,67,0
Annotated: What does Nicola Sturgeon's Scottish independence letter say and really mean? ,1,3,5,69,3,12,0,74,0
20 Reasons You Should Give The New Joker A Chance,1,1,9,29,0,9,2,38,0
France’s Presidential Vote on Sunday: Why It Matters ,1,3,7,36,2,8,0,43,0
7 Things Women Can Do To Avoid Catcallers,1,3,7,26,0,7,1,33,0
"39 Amazing Things That Will Make You Fall In Love With Portland, Maine",1,1,12,43,1,12,2,55,0
Gorgeous Set Photos From The Upcoming Film About Legendary Trans Activist Marsha P. Johnson,1,1,14,63,1,13,0,77,0
Someone Claims To Have Posted The Fat Jew's Book Online In Its Entirety,1,1,13,45,1,12,0,58,0
"17 Unforgettable Childhood Moments From Playing ""Crosscountry Canada""",1,1,7,51,2,7,2,58,0
Brightly-lit orange UFO filmed hovering over French coastal town baffles residents,1,2,5,66,1,10,0,71,0
"Co-op recalls 165,000 chocolate Santas after batteries found inside two",1,2,2,52,2,9,6,54,0
Better Dieting Through Chemistry,1,3,4,25,0,3,0,29,0
11 People You'll Definitely Work With At Some Point In Your Life,1,1,11,39,1,11,2,50,0
Can You Guess The Smashed Up Valentine's Day Candy,1,1,9,32,1,8,0,41,0
Are You A Little Bit Bitchy,1,1,6,16,0,5,0,22,0
This One Feature On The Apple Watch Actually Helped Me Quit Smoking,1,1,12,44,0,11,0,56,0
Philadelphians reeling over city's new sugary drink tax,1,3,1,46,1,7,0,47,0
"Actor Siddharth Doesn't Want Us To Call Him A Hero, But He's Leaving Us No Choice",1,1,16,47,3,15,0,63,0
16 Siblings Who Were Absolutely Savage,1,3,5,26,0,5,2,31,0
"18 Perfect Responses For When Someone Texts You ""K""",1,1,8,31,2,8,2,39,0
Share Your HBCU Family Photos,1,1,8,17,0,4,0,25,0
Activist Funds Put Executive Pay Formulas Under Microscope,1,2,8,43,0,7,0,51,0
There Is A Cat Hidden In This Serious New York Times Photo Of Obama,1,1,14,40,0,13,0,54,0
"Trailer Of Nawazuddin's 'Haramkhor', SRK's Inspiring Speech And More From The World Of Ent!",1,3,16,56,6,13,0,72,0
Under 30 Holiday Gift Guide,1,2,4,17,0,4,2,21,0
The Ultimate Bob Dylan Trivia Quiz,1,1,6,23,0,5,0,29,0
Stephen Colbert Cooked A Meal With An Indian Mom And It Was Cute AF,1,1,15,39,0,13,0,54,0
Well-Done Steak Without Shame,1,3,5,20,1,3,0,25,0
A Guy Made A Fake Fact Go Viral To Prove Not To Believe Everything You Read,1,1,16,44,0,15,0,60,0
Women Are Doing Tropical Eye Makeup And It's Mesmerizing,1,1,9,38,1,8,0,47,0
24 Makeup Milestones For Anyone Obsessed With Beauty,1,1,7,36,0,7,2,43,0
22 Reasons Giraffes Are The Greatest,1,1,5,24,0,5,2,29,0
Chris Hemsworth's First Instagram Post Is Wild,1,1,7,32,1,6,0,39,0
Should Leonardo DiCaprio Or Bradley Cooper Be Your Valentine,1,1,10,42,0,8,0,52,0
"17 Times ""Steven Universe"" Made You Cry",1,1,6,23,2,6,2,29,0
Jerry Brown Seeks ‘Common Ground’ with Donald Trump,1,3,7,35,2,7,0,42,0
So It Looks Like Nicki Minaj And Meek Mill Are Actually Engaged,1,1,12,40,0,11,0,52,0
"Do You Remember These Details From The First Episode Of ""Gilmore Girls""",1,1,12,46,2,11,0,58,0
18 life-saving facts that everyone should know,1,3,0,37,1,6,2,37,0
Left Bashes Lady Gaga for Not Attacking Trump During Super Bowl Halftime Show,1,3,12,53,0,12,0,65,0
Danish dental student pulls out own wisdom tooth and - naturally - posts a video of the grisly procedure online,1,3,1,89,2,19,0,90,0
Ann Coulter: The Silence of the Lambs Congress,1,3,6,32,1,7,0,38,0
Here's What Happens When You Try to Block Mark Zuckerberg on Facebook,1,3,10,47,1,11,0,57,0
23 People Who Look Drop Dead Amazing Wearing Brown Lipstick,1,1,9,39,0,9,2,48,0
This Is The Most Rigged Crane Game You'll Ever See,1,1,10,30,1,9,0,40,0
The Robots Aren't Coming for Your Job. They're Already Here,1,3,9,38,3,9,0,47,0
Think again before you post those pics of your kids,1,3,1,41,0,9,0,42,0
Instafamous: The Eyebrow Queen,1,1,4,22,1,3,0,26,0
"‘Top Chef’ Host Padma Lakshmi Calls MILO A ‘Neo-Nazi,’ Calls Berkeley Riot A ‘Victory’",1,2,18,47,8,13,0,65,0
"18 Insanely Cute Gifts You Should Buy ""Your Person"" Immediately",1,1,9,41,2,9,2,50,0
Fake Newsman Brian Williams Slams Fake News,1,2,7,30,0,6,0,37,0
How The Rock went from failed football player to the highest-paid actor in Hollywood,1,3,4,66,1,13,0,70,0
Request A Post And We'll Literally Write It For You,1,1,10,31,1,9,0,41,0
Drunk People Drunk Dial Their Loved Ones,1,1,7,27,0,6,0,34,0
32 Amazing DIY Costumes That Prove Halloween Is Actually Meant For Teens,1,1,13,46,0,11,2,59,0
Kanye West's New Fashion Collection Is Quite The Sight,1,1,9,36,1,8,0,45,0
What % Fashionable Are You?,1,3,4,17,2,4,0,21,0
15 Star Wars Character Names According To A 12-Year-Old Boy,1,1,10,34,2,9,4,44,0
59 Rihanna Lyrics For When You Need An Instagram Caption,1,1,9,36,0,9,2,45,0
Esteban Santiago-Ruiz: What we know so far about the suspected Fort Lauderdale shooter,1,3,6,66,2,12,0,72,0
"Which ""AHS: Hotel"" Character Are You Based On Your Zodiac Sign",1,1,13,36,3,10,0,49,0
Is This Pretty Doll Spying on Children?,1,2,6,26,1,6,0,32,0
Whistle-Blower: ‘Global Warming’ Data Manipulated Before Paris Conference,1,3,9,53,4,7,0,62,0
23 Delicate Moonstone Necklaces You'll Never Take Off,1,1,7,36,1,7,2,43,0
"Star Wars Cast Members Do ""Star Wars"" Impersonations",1,1,8,35,2,7,0,43,0
"Amber Rose Just Went All In, Literally, With Her Tweet To Kanye",1,1,12,38,2,11,0,50,0
American Beauty As Told By Miss America Winners,1,1,8,32,0,7,0,40,0
29 Tweets About Facebook That Will Make You Laugh Every Time,1,1,10,38,0,10,2,48,0
Answering your questions about the new collective bargaining agreement,1,3,1,61,0,8,0,62,0
The Moment The Relationship Becomes Long Distance,1,1,7,36,0,6,0,43,0
This 10-Year-Old Cannot Get Her Passport - Unless Her 'Abusive' Father Signs On The Form,1,3,15,52,5,14,2,67,0
A Ranking Of The Creepiest Kids In Horror Movies,1,1,9,31,0,8,0,40,0
Ecuador fines media for not publishing a story,1,2,1,38,0,7,0,39,0
Are These People Smiling At A Baby Or A Laptop,1,1,10,27,0,9,0,37,0
A Bride Took Her Own Wedding Photos And The Album Is Absolutely Beautiful,1,1,13,48,0,12,0,61,0
'Broadchurch' is the best British crime show you're not watching,1,2,2,50,3,9,0,52,0
Are Baby Carrots as Healthful as Other Carrots? ,1,2,6,33,1,8,0,39,0
13 Charts That Perfectly Sum Up Having A Big Butt,1,1,9,29,0,9,2,38,0
People React To A Controversial Article On Consent,1,1,8,35,0,7,0,43,0
29 Unmistakable Signs You're Both A '90s And '00s Kid,1,1,7,28,3,9,6,35,0
It turns out CPR will bring a drowned lizard back to life. A couple of times.,1,3,5,55,2,15,0,60,0
"How Well Do You Remember ""The Office"" Seasons 1-3",1,1,8,28,3,8,2,36,0
How Dad Are You Actually,1,1,5,15,0,4,0,20,0
How a Pennsylvania teenager feels about the future under Donald Trump,1,2,4,55,0,10,0,59,0
23 Tweets That Sum Up San Francisco's Thoughts On The Blue Angels,1,1,11,40,1,11,2,51,0
Here's What Canadians Did While Americans Celebrated Thanksgiving,1,1,8,49,1,7,0,57,0
Can You Guess What These Actual Scout Badges Are For,1,1,10,33,0,9,0,43,0
"Would you take a new £1,300 DNA test that could save your life?",1,2,4,40,3,12,4,44,0
"15 Women Show Off Their Most ""Unflattering"" Hair, Makeup, And More",1,1,10,40,4,10,2,50,0
"Which Character From ""Haikyuu!!"" Are You",1,1,6,25,4,5,0,31,0
The 10 Commandments of the Tuxedo,1,3,3,23,0,5,2,26,0
8 Trans Tropes We Need To Retire In 2016,1,1,7,20,0,8,5,27,0
Sinkholes explained: How are they caused and what are the warning signs?,1,3,2,57,2,11,0,59,0
"These Are Going To Be The 16 Biggest Food Trends In 2016, According To Pinterest",1,1,13,46,1,14,6,59,0
How to know if you're actually depressed,1,2,1,32,1,6,0,33,0
The Best Rap Verse Of The Month,1,3,7,18,0,6,0,25,0
19 Tumblr Posts That Are Too Real For Anime Fans,1,1,9,28,0,9,2,37,0
Odd Lots: How an Old-School Chess Shop Survives in Modern New York,1,3,11,42,2,11,0,53,0
17 Tweets Every Left-Handed Person Will Totally Relate To,1,1,9,37,1,8,2,46,0
Are You Ready To Move In With Your SO,1,1,10,19,0,8,0,29,0
Nepal transgender model dazzles India,1,3,2,31,0,4,0,33,0
This Gum Commercial Is Making People Everywhere Weep,1,1,8,37,0,7,0,45,0
"How Well Do You Really Remember ""Living Single""",1,1,8,30,2,7,0,38,0
Pumpkin Flavored Breakfast Treats,1,1,4,26,0,3,0,30,0
Our happy places: The vacation spots we call home,1,2,2,38,1,8,0,40,0
Save Typing Time with the Hidden Web-Address Suffix Keys [Video],1,2,9,43,3,9,0,52,0
21 Pictures That Will Only Slightly Piss You Off,1,3,8,30,0,8,2,38,0
Why aren't men changing their name after marriage?,1,3,1,40,2,7,0,41,0
The Oscars showed yet again why it's never over till it's over,1,3,2,47,2,11,0,49,0
"Brits Try And Fail To Label The United States, Because It's A Thanksgiving Tradition",1,1,14,55,2,13,0,69,0
16 Stories That Prove 2016 Wasn’t The Absolute Worst,1,3,7,30,1,8,6,37,0
Trevor Noah explains how aliens have invaded Earth and it has to do with Trump's hair,1,2,4,65,1,15,0,69,0
BFFs Tried Sensual Yoga And Had The Time Of Their Lives,1,1,13,32,0,10,0,45,0
11 Epic Slaps That Are Incredibly Therapeutic To Watch,1,1,8,36,0,8,2,44,0
"When God Closes A Door, He Opens A Window",1,1,9,23,1,8,0,32,0
"We Played A Hilarious Game Of ""Badu Or Badon't"" With Erykah Badu",1,1,12,38,3,11,0,50,0
Picks for every trophy given at Home Depot College Football Awards,1,3,6,50,0,10,0,56,0
"So, BuzzFeed Has A Newsletter About Hot Guys Now",1,1,10,29,1,8,0,39,0
"Target Is Pulling This ""Star Wars"" Shirt For Boys That Writes Leia Out Of The Scene",1,1,16,50,2,15,0,66,0
"What Does The ""U Up?"" Text Mean",1,1,7,15,3,6,0,22,0
"Ryan Phillippe Comes For Amy Schumer In This Deleted ""Trainwreck"" Scene",1,1,11,48,2,10,0,59,0
CHINAH share video for 'Even Love' - premiere,1,2,8,27,3,7,0,35,0
Alec Baldwin Will Count Down End of Trump’s Term from Inauguration Day,1,3,10,48,1,11,0,58,0
Which Lola From 'Kalyeserye' Are You Based On These Really Hard Questions,1,1,12,48,2,11,0,60,0
17 Unusual And Beautiful Russian Baby Names,1,1,6,29,0,6,2,35,0
The right way to say 15 brand names you're mispronouncing all the time,1,2,1,54,1,12,2,55,0
Critics Say Trump Appointees Can Dodge a Huge Tax Bill. That’s Not the Case. ,1,2,12,48,3,14,0,60,0
Who Is Your Hollywood Daddy Based On The First Letter Of Your Name,1,1,13,41,0,12,0,54,0
Man surprises high school sweetheart with proposal during her last chemo session,1,3,1,68,0,11,0,69,0
Rescue Workers Pulled Out All the Stops To Make This Grandmother's Birthday Wish Come True,1,1,14,61,1,14,0,75,0
Aziz Ansari Called Out The Whiteness Of Late Night To Stephen Colbert,1,1,12,46,0,11,0,58,0
Jimmy Kimmel Breaks Down Why Ivanka Trump Just Got A Plum White House Job,1,3,14,46,0,13,0,60,0
‘Might Does Not Make Right; Being in the Right Does.’ ,1,3,8,32,4,10,0,40,0
My Roommate Built A Cat Castle Fit For Royalty,1,1,9,29,0,8,0,38,0
9 Times I Cried,1,1,3,8,0,3,1,11,0
WashPost: ‘Never Trump’ Republicans Complain About Never Getting a Job at the New White House,1,3,13,63,3,14,0,76,0
Bank branch use falls 6% as customers embrace digital advances,1,2,1,50,1,9,1,51,0
Which 2015 Slang Term Are You Based On Your Zodiac Sign,1,1,10,31,0,10,4,41,0
We Know If You Secretly Hate Adele,1,1,7,21,0,6,0,28,0
How to watch the Women's March on Washington,1,3,4,32,1,7,0,36,0
30 Under 30 Asia 2017: Pioneer Women,1,3,4,17,1,6,8,21,0
BuzzFeed Crossword: Acting Like A Director,1,1,7,29,1,5,0,36,0
The 6 Biggest Credit Mistakes Millennials Are Making,1,3,7,37,0,7,1,44,0
What your views on Russia and Islam say about your politics,1,3,3,46,0,10,0,49,0
A Definitive Ranking Of Babyface's Greatest Hits,1,1,7,34,1,6,0,41,0
We Know Your Best Quality Based On Random Questions,1,1,9,34,0,8,0,43,0
"Honestly, Goldilocks Was The Absolute Worst",1,1,6,31,1,5,0,37,0
Canadians: Can You Tell If This Photo Was Taken In The Afternoon Or At Night,1,1,15,46,1,14,0,61,0
Siena Coach Jimmy Patsos Shakes Imaginary Hands After Rider Walks Off Floor,1,3,12,52,0,11,0,64,0
21 Of The Most Trolled Baby Names Of Our Time,1,2,9,25,0,9,2,34,0
Trump Supporters Inadvertently Show How Easily Misinformation Spreads Online,1,3,9,59,0,8,0,68,0
Here's What Your Favorite '90s Toys Look Like Today,1,1,8,31,2,8,2,39,0
22 Times Tina Fey And Amy Poehler Shut Down Sexism In The Best Damn Way,1,1,14,41,0,14,2,55,0
"The Ultimate ""American Horror Story: Hotel"" Drinking Game",1,1,8,39,3,7,0,47,0
21 Tweets That Are Too Funny For Anyone Who Has A Sister,1,1,11,32,0,11,2,43,0
Can You Find All 23 Chameleons Hiding In This Forest,1,1,9,32,0,9,2,41,0
All the best (and geekiest) signs from Marches for Science around the world,1,3,3,58,2,12,0,61,0
13 Books That Will Make You Believe In Ghosts,1,1,8,27,0,8,2,35,0
China Rising & Downloads Falling: 5 Takeaways From the IFPI's Global Music Report,1,2,13,52,3,12,1,65,0
17 Things That Actually Helped Me Lose 85 Pounds,1,1,7,29,0,8,4,36,0
22 Things Single People Just Get,1,1,5,20,0,5,2,25,0
"Judah Friedlander From ""30 Rock"" Defines Popular Dating Terms",1,1,8,41,2,8,2,49,0
12 Wedding Tips For Brides With Anxiety,1,1,6,25,0,6,2,31,0
J.K. Rowling Has Revealed She's Writing Another Children's Book,1,1,10,41,4,8,0,51,0
15 Well-Kept Secrets of the Masters,1,3,4,23,1,5,2,27,0
21 Unconventional Septum Rings That You Need Immediately,1,1,7,40,0,7,2,47,0
Here Are All of Ed Sheeran's Videos: Vote for Your Favorite,1,2,9,38,2,10,0,47,0
11 Ways To Totally Nail Sex With Any Woman,1,1,8,24,0,8,2,32,0
MMA Fighter Attempts Spinning Kick and Fails in the Most Hilarious Way Possible,1,2,12,55,0,12,0,67,0
Stanford Accepts Muslim Teenager Who Wrote ‘BlackLivesMatter’ 100 Times On Application,1,3,12,59,2,10,3,71,0
Modi Keeps Doing This Bizarre Thing When He Poses For Photos With Children,1,1,13,49,0,12,0,62,0
Are These People Laughing At Salad Or Something Else,1,1,9,35,0,8,0,44,0
An NGO Working For The Protection Of Animals Is Making Travel Industries Across The Globe Elephant-Friendly,1,3,19,72,1,15,0,91,0
The apps that drain your phone's battery the most,1,3,1,39,1,8,0,40,0
23 Things You'll Understand If You're Slightly Obsessed With Michaels,1,1,9,47,2,9,2,56,0
16 Photos Of Desis That Will Give You Intense Squad Goals,1,1,10,35,0,10,2,45,0
Tell Us About Yourself(ie): Jon Glaser,1,1,6,24,3,5,0,30,0
19 Ridiculous Lies Literally Everyone Told As Kids,1,1,7,34,0,7,2,41,0
How Much Do You Spend On Mental Healthcare,1,1,8,27,0,7,0,35,0
This Three-Ingredient No-Bake Cake Is Insanely Delicious,1,1,9,39,2,6,0,48,0
"OK, Time To Vote: What Was The Song Of The Summer",1,1,12,25,2,10,0,37,0
We Know What YA Couple You And Your Significant Other Are,1,1,12,35,0,10,0,47,0
"March Jobs Report:  Yeah, Yeah. Blame the Weather. But Check Out These Charts",1,3,12,48,4,13,0,60,0
18 Documentaries That Will Leave You With A Smile On Your Face,1,3,11,38,0,11,2,49,0
Globalist Le Pen Rival Promises to ‘Emancipate’ Migrant Communities,1,2,8,49,2,8,0,57,0
Can You Guess The Movie From The Santa Claus,1,1,9,27,0,8,0,36,0
"When a President Says, ‘I’ll Kill You’ - Video - NYTimes.com",1,3,10,33,7,10,0,43,0
"30 Words For ""Fart,"" Ranked",1,1,4,14,3,4,2,18,0
Suspected Car Bomb Explodes in Swedish Capital Stockholm,1,3,7,42,0,7,0,49,0
5 shocking revelations from the Tennessee teacher criminal complaint,1,2,1,58,0,8,1,59,0
Watch Live: Trump ‘Make America Great Again’ Celebration,1,2,8,38,3,7,0,46,0
"If ""Harry Potter"" Characters Were In ""Game Of Thrones""",1,1,9,33,4,8,0,42,0
Weird Things Gay Couples Do,1,1,5,18,0,4,0,23,0
"People Are Trying To Make Britney Spears A Playable Character In ""Super Smash Bros."" Because Why Not",1,1,17,64,3,16,0,81,0
How To Ask Questions And Look Smart At Your Next Meeting,1,3,11,35,0,10,0,46,0
Can You Identify These TV Shows Based On Their IMDb Descriptions,1,1,14,40,0,10,0,54,0
Life for gays in the Israeli military just got easier,1,3,2,42,0,9,0,44,0
How to watch the Women's March on Washington,1,2,4,32,1,7,0,36,0
Miss World is the biggest beauty pageant you’ve never heard of. What’s it doing in Washington?,1,3,4,71,4,15,0,75,0
Atlantic Fake News: Fetal Heartbeats Are ‘Imaginary’,1,3,7,36,3,6,0,43,0
Brooks: Trump Admin Has ‘High Levels of Incompetence’,1,3,7,36,3,7,0,43,0
The Official Ranking Of All Of Oprah's Harvests From 2015,1,1,9,34,1,9,4,43,0
21 Little Things That Ruin Every Retail Worker’s Day,1,3,8,33,1,8,2,41,0
"Cook your Christmas turkey upside down to stop it drying out, researchers claim",1,3,2,64,1,12,0,66,0
17 Dogs Who Demand A Cuddle,1,1,5,15,0,5,2,20,0
Campaign-Trail Marine Le Pen Blocked From Entering Migrant Camp,1,2,10,44,1,8,0,54,0
Liberal ladies: You're killing it on OKCupid,1,3,5,31,2,6,0,36,0
"After this man's son killed himself, he decided the world needed a little more kindness The list",1,3,2,76,2,16,0,78,0
MS Dhoni's Wife Sakshi Gives It Back To Harsh Goenka After His Comments On The Former Skipper,1,3,18,58,1,16,0,76,0
What Is Brody Jenner Trying To Say With This NSFW Cartoon,1,3,14,33,0,10,0,47,0
How Wild Was Your Weekend,1,1,5,16,0,4,0,21,0
How To Keep Working Into Your 60s And Beyond,1,3,8,26,0,8,2,34,0
Vote: Four burning questions heading into Final Four,1,3,4,40,1,7,0,44,0
Afghanistan's First Female Fighter Pilot Is Now Getting Death Threats From The Taliban,1,2,13,60,1,12,0,73,0
The truth behind the world's most reliable IQ test The list,1,2,4,44,1,10,0,48,0
"The Girl Who Plays Sansa Stark On ""Game Of Thrones"" Has A Crush On Ryan Gosling",1,1,16,46,2,15,0,62,0
"What ridiculously successful people eat, revealed",1,3,1,42,1,5,0,43,0
15 Movie And TV Retrospectives From 2015 That Will Make You Nostalgic,1,1,11,41,0,11,6,52,0
Stunning Portraits Of SF That'll Make You Want To Call It Frisco,1,1,13,39,1,11,0,52,0
31 Albums That Will Be 20 Years Old In 2016,1,1,7,19,0,9,8,26,0
There's An Incredibly Creepy New App That Brings Your Pictures To Life,1,1,12,46,1,11,0,58,0
This is how much caffeine is in your favorite drinks,1,3,1,42,0,9,0,43,0
"Which Of The Final Three Houseguests Should Win ""Big Brother""",1,1,10,40,2,9,0,50,0
"10 Times I Lost My Sh*t Watching ""Hamilton"" The Musical",1,1,9,32,3,9,2,41,0
Jim Harbaugh shares milk with mail truck driver who hit him as kid,1,2,2,52,0,12,0,54,0
How Much Of An Instagram Cliche Are You,1,1,8,24,0,7,0,32,0
This Video Hilariously Makes Fun Of How People Stage Instagrams,1,1,10,44,0,9,0,54,0
Can You Do The Asian Squat,1,1,6,15,0,5,0,21,0
Hep Alien Performed The “Gilmore Girls” Theme Song And It Was Perfect,1,2,12,44,2,11,0,56,0
"This Trailer For Joel McHale's ""Emoji Movie"" Is Both Hilarious And Terrifying",1,1,13,50,3,11,0,63,0
Brexit is not the high point of democracy – it's the greatest fraud ever perpetrated in British politics,1,3,2,83,2,17,0,85,0
Why Some Consumers Want No Logos on Their Gifts This Season,1,3,10,39,0,10,0,49,0
This Khloé Kardashian campaign finally strips ‘empowerment’ of all meaning,1,3,3,60,2,9,0,63,0
Where will Trump’s aides draw the line on lies?,1,3,2,35,2,8,0,37,0
"After Seven Years, Someone Finally Completed ""American Ninja Warrior's"" Final Course",1,1,11,59,4,10,0,70,0
You Can Watch This Guy Write A Book In Real-Time Right Now,1,1,13,33,1,11,0,46,0
Van Morrison: 30 essential songs,1,3,2,23,1,4,2,25,0
These Americans Think Justin Trudeau Is Just Some Guy In A Canoe,1,1,12,41,0,11,0,53,0
Basic Food-Sharing Etiquette For All You Damn Heathens,1,1,9,37,1,7,0,46,0
37 Food Tweets Guaranteed To Make You Laugh Every Time,1,1,9,34,0,9,2,43,0
15 Ways Your Brain Fools You On A Daily Basis,1,1,9,25,0,9,2,34,0
23 Things You'll Only Relate To If You're Slightly Obsessed With Makeup,1,1,11,45,2,11,2,56,0
"The Best Place To Get Pie In Every State, According To Yelp",1,3,12,35,1,11,0,47,0
"More Than 40 Shot, 11 Killed Over Christmas Weekend in Gun-Controlled Chicago",1,3,10,50,2,11,4,60,0
Literally Just A Bunch Of Inspiring GIFs Of The Rock,1,1,12,31,0,9,0,43,0
It's Time For Us To Realize That Leonardo DiCaprio Doesn't Need An Oscar,1,1,14,44,2,12,0,58,0
SAPVoice: Your Customer's Experience Is Broken: Here's How To Fix It,1,3,14,40,4,10,0,54,0
13 Of Our Favourite Television Moments In 2015,1,1,6,27,0,7,6,33,0
This pretty penny could cost you a pretty penny,1,3,1,38,0,8,0,39,0
5 Trump myths about illegal immigration,1,3,1,32,0,5,1,33,0
The Year in Money,1,3,3,11,0,3,0,14,0
17 Tumblr Posts About Teachers Guaranteed To Make You Laugh,1,1,9,39,0,9,2,48,0
These Three Questions Will Tell You Which Makeup Brand To Use,1,1,11,40,0,10,0,51,0
This woman was threatened with murder because she uncovered her hair in Saudi Arabia The list,1,2,4,74,0,15,0,78,0
This video of a woman talking with her cheating ex has gone viral The list,1,3,2,58,0,14,0,60,0
Which lucky locations will have a white Christmas this year?,1,2,2,48,1,9,0,50,0
If Movies That Were Shot In Vancouver Were Actually Set In Vancouver,1,1,12,45,0,11,0,57,0
"How Emily Fields From ""Pretty Little Liars"" Are You",1,1,9,32,2,8,0,41,0
'Like a scene out of Jurassic Park': Massive alligator 'Humpback' strolls past stunned tourists in Florida park ,1,3,6,84,5,17,0,90,0
"""Spy in the Wild"": What animals do when they don't know we're watching",1,2,3,50,5,12,0,53,0
Why I Had My Father Killed: Woman Breaks Silence 30 Years After Hiring Hit Man to Shoot Abusive Dad [Video],1,3,18,65,3,19,2,83,0
People Have Giant Cats Living In Their Houses And Oh My Goodness,1,2,12,41,0,11,0,53,0
Can We Guess The Last Thing You Googled Based On Your Age,1,1,12,34,0,11,0,46,0
25 Things You Will Only Understand If You Went To College In Texas,1,1,12,40,0,12,2,52,0
Elon Musk's next move: Merging brains and computers?,1,2,3,39,3,7,0,42,0
Westgate Park: Why an Australian lake has turned pink,1,3,4,40,1,8,0,44,0
People are dumping shared bikes in horrible piles,1,2,1,41,0,7,0,42,0
"The ABCs According To ""Law And Order: SVU""",1,1,12,20,3,7,0,32,0
Play Ball! Independent Baseball Does Major League Business,1,2,8,42,1,7,0,50,0
Google and Uber alums have created a doctor's office that's like an Apple Store meets 'Westworld',1,3,5,73,4,15,0,78,0
Iran Sanctions 15 U.S. Companies for Supporting Israel,1,3,7,36,2,7,2,43,0
"The ""Mr.Robot"" Cast Gave Us The Title Sequence We Deserve At NYCC",1,1,16,35,3,11,0,51,0
Sharks never sleep: There are scarier things at the beach than shark attacks,1,3,2,61,1,12,0,63,0
27 Gorgeous Wedding Cakes That Are Almost Too Pretty To Eat,1,1,10,37,0,10,2,47,0
"There Was A Mini ""Sisterhood Of The Traveling Pants"" Reunion",1,1,10,39,2,9,0,49,0
How I Learned to Take the SAT Like a Rich Kid ,1,3,10,25,0,11,0,35,0
Left Wing Vegan Denied Swiss Passport Because She’s ‘Too Annoying’,1,2,10,44,3,9,0,54,0
Turley: Trump Making Same Arguments as Obama in Defense of Immigration Executive Order,1,2,10,63,1,12,0,73,0
Can You Name The TV Show From The Intro Alone,1,1,11,25,0,9,0,36,0
Beat The Year-End Rush On These Three Financial Moves,1,3,10,34,1,8,0,44,0
Do College Football Refs Have It In for Your Team?,1,3,9,31,1,9,0,40,0
"GoT's Natalia Tena Plays The Hardest Game Of Would You Rather For ""Game Of Thrones"" Fans",1,1,17,53,3,15,0,70,0
"39 Times ""30 Rock"" Was The Smartest Show On TV",1,1,9,22,2,9,4,31,0
Cold War fake news: Why Russia lied over Aids and JFK,1,2,8,34,1,10,0,42,0
"Nicki Minaj Blasted Farrah Abraham From ""Teen Mom"" On Twitter",1,1,10,40,2,9,0,50,0
A Group Says French Media Are Pronouncing This Guy's Name Wrong,1,1,11,41,1,10,0,52,0
Can You Pick The Right Canadian Best Friend,1,1,8,28,0,7,0,36,0
These Awesome Grandparents Just Changed The Wedding Photo Booth Game,1,1,10,49,0,9,0,59,0
Are You More Like A Vampire Or A Werewolf,1,1,9,24,0,8,0,33,0
"Mariah Carey And YG Link Up In The Video For ""I Don't""",1,2,13,27,3,11,0,40,0
18 Pictures That Prove Dogs Are Actually Beautiful Weirdos,1,3,8,40,0,8,2,48,0
Here's What 100 Years Of Men's Grooming Trends Looks Like,1,1,9,34,2,9,3,43,0
Which Classic Guitar Riff Are You,1,1,6,22,0,5,0,28,0
Freezing Genitals to Boost Sex Drive Is Apparently a Thing People Do Now,1,2,11,49,0,12,0,60,0
'Jeopardy!' champion pokes fun at Warriors' blown 3-1 Finals lead,1,3,3,46,5,9,2,49,0
Court Rules CNN Racial Discrimination Lawsuit Can Proceed,1,2,10,40,0,7,0,50,0
Find Your Next Healthy Recipe With The BuzzFeed Food Newsletter,1,1,11,43,0,9,0,54,0
If Popular American TV Shows Were Set In The Philippines,1,1,11,36,0,9,0,47,0
17 Problems You'll Understand If You're Tall-Ish,1,1,7,30,3,6,2,37,0
Apple unveils Apple Music streaming service,1,3,3,35,0,5,0,38,0
Can You Identify ALL Of These Footballers Just From Their Legs,1,1,13,39,0,10,0,52,0
Just an hour a day on social media can affect kids' happiness,1,3,1,48,1,11,0,49,0
Fabulous Men and a Fabulous Pledge,1,2,4,25,0,5,0,29,0
Is it Healthier to Remove Your Shoes at Home?,1,3,6,30,1,8,0,36,0
21 Awesome Ways To Bring The Outdoors Into Your Home,1,1,9,32,0,9,2,41,0
24 Kids Who Are In Dire Need Of An Exorcism,1,1,9,23,0,9,2,32,0
Here's 3 Ways To Make Hummus,1,1,5,16,1,5,1,21,0
People Are Mad Uncomfortable After Looking At This Japanese Artist’s Intricate Food Carving,1,3,13,65,1,12,0,78,0
Is Ronda Rousey Broken or Ready to Roar Back? Her Past May Offer Some Clues,1,3,13,47,1,14,0,60,0
6 Social Impact Business Ideas That Could Change The World From The Under 30 Summit EMEA,1,2,17,53,0,15,3,70,0
"There Is No Wrong Time To Listen To ""All I Want For Christmas Is You""",1,1,15,38,2,14,0,53,0
Italy sex case dropped because woman 'did not scream',1,3,1,42,2,8,0,43,0
JPMorgan ChaseVoice: 10 Digital Marketing Tips For Small Business Owners,1,3,12,48,1,9,2,60,0
21 Crock Pot Dump Dinners For Winter,1,1,6,22,0,6,2,28,0
20 Cats Who Are Ready AF For Thanksgiving,1,1,8,24,0,7,2,32,0
"Akshay Donates To Martyred Jawans' Kin, Baahubali 2 Trailer Is Out And More From Ent!",1,3,14,53,3,14,1,67,0
17 Things Only People With Crazy Low Blood Pressure Will Understand,1,1,10,45,0,10,2,55,0
Can You Guess The Bollywood Celebrity From Just A Childhood Picture,1,1,11,46,0,10,0,57,0
CNN’s Jeffrey Lord called Trump the MLK of health care. He then had a very long day.,1,2,10,55,3,16,0,65,0
This TV Host Accidentally Told Piers Morgan She Could Sit On His Face Live On Air,1,1,17,49,0,15,0,66,0
Serious Question: How Many Pairs Of Basketball Shorts Does Adam Sandler Own,1,1,12,51,1,11,0,63,0
Who Is Your Celeb Boyfriend Based On Your Birth Month,1,1,10,34,0,9,0,44,0
"When You Binge-Watch ""Making A Murderer"" And Think You Can Solve Crimes",1,1,13,44,3,11,0,57,0
"Dear Guys, Please Immediately Stop Using Your Cell Phones At Urinals",1,1,11,46,1,10,0,57,0
A growing number of analysts are dismissing the iPhone 8 curved display rumours,1,3,2,64,0,12,1,66,0
A Monkey In India Has Adopted A Puppy And They're Adorably Inseparable,1,1,12,46,1,11,0,58,0
21 Celebrity Wax Figures Who Perfectly Sum Up Your Relationship With Your Boss,1,1,12,52,0,12,2,64,0
This 'smart condom' will measure your performance in the bedroom The list,1,3,2,58,2,11,0,60,0
How Trash Are You On A Scale Of 1-10,1,1,8,16,1,8,3,24,0
What Is Your Sex IQ,1,1,6,9,0,4,0,15,0
What Gift Should You Get For Yourself This Year,1,1,9,30,0,8,0,39,0
Earth's Oceans Are Warming A Lot Faster Than We Thought,1,3,10,35,1,9,0,45,0
32 Things You'll Only Understand If You Went To University In The '90s,1,1,11,41,2,12,4,52,0
Can You Guess Who These Celebrities' Godparents Are,1,1,8,35,1,7,0,43,0
Can You Make The Right Choice,1,1,6,18,0,5,0,24,0
Which Movie Squad Are You And Your Friends,1,1,8,27,0,7,0,35,0
"Vladimir Putin admits 2016 was a ‘difficult year’, hopes people can become magicians and stop 2017 being so bad",1,3,2,80,3,18,8,82,0
When You're Out Of F*&%s To Give,1,1,7,15,4,6,0,22,0
The non-apology of the year award goes to Nobel scientist who thinks women just cry all the time,1,2,2,76,1,17,0,78,0
Bartenders Tell You Exactly What You're Doing That Annoys Them,1,1,10,42,1,9,0,52,0
Here's how the US military is sticking it to Beijing in the South China Sea,1,2,7,53,1,14,0,60,0
Amber Tamblyn Sums Up The Messiness Of Breastfeeding In One Photo,1,3,11,44,0,10,0,55,0
11 Things Gingers Really Want Non-Gingers To Know,1,1,8,31,1,7,2,39,0
New York Times; The Left Is Alarmed by Donald Trump’s Reach for Union Voters,1,3,12,49,2,13,0,61,0
Anthony Bourdain And Eric Ripert Share Their Best Travel Tips,1,2,10,42,0,9,0,52,0
23 Jokes That Are Hilariously British,1,1,5,25,0,5,2,30,0
"21 Pictures Only ""The Hobbit"" Fans Will Think Are Funny",1,1,9,33,2,9,2,42,0
"Cheap, widely available drug could stop thousands of mothers bleeding to death",1,2,1,65,1,11,0,66,0
Donald Trump doesn't read books â Here are other successful people who don't read very much,1,2,3,71,4,15,0,74,0
New Research Shows Zombies Would End the Human Race in 100 Days,1,3,9,40,0,11,3,49,0
Cliff Sims: House Healthcare Bill ‘Still a Work in Progress’,1,3,8,40,3,9,0,48,0
Can You Guess The Oscar Nominated Movie From This Short Clip,1,1,11,39,0,10,0,50,0
21 Scruffy Men That'll Get You All Hot And Bothered,1,1,9,30,1,9,2,39,0
Chemical Leak During Cleaning Operation Leaves At Least 7 Workers Dead In Latur Oil Mill,1,3,14,59,0,14,1,73,0
WWE superstar Charlotte Flair reveals her WrestleMania fitness and diet plans,1,3,7,60,0,10,0,67,0
Republicans add to Obamacare confusion with new 'repair' pitch,1,2,2,50,2,8,0,52,0
This swimwear model is becoming a professional kickboxer The list,1,2,2,54,0,9,0,56,0
7 Honest Pieces Of Advice For Scientists From A 90-Year-Old Nobel Laureate,1,1,12,46,2,11,3,58,0
How Much Do You REALLY Know About Cake,1,1,13,18,0,7,0,31,0
This Couple Who Met On Twitter Had A Gorgeous Twitter-Themed Wedding,1,3,12,45,1,10,0,57,0
What Song Helps Get You Motivated,1,1,6,22,0,5,0,28,0
33 Dresses With Pockets You're Gonna Want To Wear Right Now,1,1,10,36,1,10,2,46,0
12 Stunning American Hotels You'll Want To Live In Forever,1,1,9,37,1,9,2,46,0
This British Rapper Is Trying To Find Out Why His Father Killed Himself,1,1,13,46,0,12,0,59,0
This Dog Perfectly Photobombed His Owners' Engagement Photos,1,1,8,44,1,7,0,52,0
"P. Diddy's ""I Need A Girl (Part One)"" Was The Best R&B Song Of The Early 2000s",1,1,17,34,7,16,4,51,0
Dear Harry Styles' Pants At The AMAs: Why,1,1,10,22,2,7,0,32,0
The awful sores in her mouth were a symptom of something very serious,1,3,1,56,0,12,0,57,0
"This Illustrated ""Home Alone"" Storybook Will Make You So Excited For Christmas",1,1,12,53,2,11,0,65,0
"Which Taylor Swift ""1989"" Tour Outfit Would You Rock",1,1,8,30,2,8,4,38,0
OMG This Cloud Is An Emoji,1,1,8,13,0,5,0,21,0
28 Bros Who Absolutely Crushed 2015,1,1,4,20,0,5,6,24,0
New Study Reveals Chemicals in Fast Food Wrappers Could Be Harmful AF,1,3,12,46,0,11,0,58,0
Tom Wheeler to Step Down as FCC Chairman on Day of Trump’s Inauguration,1,2,11,47,1,12,0,58,0
27 Sex Questions You're Too Afraid To Ask Anyone But Google,1,1,10,36,1,10,2,46,0
I Heart Girl: Eight photos which will question what you know about being a woman,1,3,4,61,1,14,0,65,0
"Which ""Inside Amy Schumer"" Character Are You",1,1,7,29,2,6,0,36,0
19 Times Twitter Perfectly Summed Up Your Inner Grandma,1,1,8,37,0,8,2,45,0
26 Infomercial Fails Guaranteed To Make You Laugh Every Time,1,1,9,40,0,9,2,49,0
What Is A Water Bear,1,1,5,11,0,4,0,16,0
"This New ""Sports Illustrated"" Model Is The Magazine's Curviest Yet",1,1,10,44,3,9,0,54,0
17 Heartbreaking Confessions From People With An Unrequited Love,1,1,8,46,0,8,2,54,0
We Know How Drunk You'll Be On Christmas,1,1,8,24,1,7,0,32,0
19 Gifts Your Work Spouse Would Actually Love To Receive,1,1,9,36,0,9,2,45,0
Troll Tries To Test Gospel Singer Kirk Franklin And Twitter Is Loving His Clap Back,1,3,15,54,0,14,0,69,0
Is This A Hoverboard,1,1,4,13,0,3,0,17,0
29 Tweets That Every Single Hairdresser Will Relate To,1,1,8,36,0,8,2,44,0
"Italy voted ‘no’ to constitutional reform. This is why, and what will happen next.",1,3,2,62,5,13,0,64,0
WorldStarHipHop Founder Lee “Q” O’Denat's Cause of Death Revealed,1,3,12,41,4,8,0,53,0
15 Perfect Mugs For Anyone Who Loves A Good F-Bomb,1,1,10,28,1,9,2,38,0
Presenting: The 2016 version of ‘Guess Who?’,1,2,4,26,4,6,4,30,0
19 Inspiring Confessions From People Who Beat Anorexia And Bulimia,1,1,9,46,0,9,2,55,0
23 Memes That'll Get You Through An Existential Crisis,1,3,8,35,1,8,2,43,0
Why You Should Always Google Your Dates,1,1,7,26,0,6,0,33,0
What Girls Do On Instagram,1,1,5,17,0,4,0,22,0
17 Bold AF Hidden Hair Colors You Can Actually Wear To Work,1,1,12,34,0,11,2,46,0
Everyone Loves U.S. Banks,1,3,5,15,2,3,0,20,0
21 Times Tumblr Got Too Real About Kylo Ren,1,1,8,25,0,8,2,33,0
23 Things You Should Never Say To Short Women,1,1,8,27,0,8,2,35,0
17 Street Artists To Bring Some Anarchy To Your Instagram Feed,1,1,10,40,0,10,2,50,0
There will only be one loser in the aftermath of Obama's attack on Israel – the United Nations,1,2,5,70,2,17,0,75,0
'Jurassic World': Should you see it?,1,3,3,24,4,5,0,27,0
Watch This Out Gay Marine Ask Singer Steve Grand To The Marine Corps Ball,1,1,14,46,0,13,0,60,0
I Wore Crop Tops For A Week As A Plus-Size Woman And This Is What Happened,1,1,17,41,1,15,0,58,0
Why This 6th-Grade Girl Purposefully Broke Her School's Sexist Dress Code,1,3,11,49,2,10,1,60,0
17 Of The Most Hilarious Amazon Reviews Of 2015,1,1,7,26,0,8,6,33,0
48 Things That Mildly Thrill Everyone Who Works In An Office,1,1,10,38,0,10,2,48,0
19 Honest Confessions From An Ann Summers Worker,1,1,7,32,0,7,2,39,0
19 totally rational fears every New Yorker has,1,3,2,35,0,7,2,37,0
What STD Are You,1,1,6,7,0,3,0,13,0
These Were The Most In-Demand New York Library Books Of 2015,1,1,11,34,1,10,4,45,0
"How Well Do You Know The Lyrics To ""Hakuna Matata""",1,1,10,29,2,9,0,39,0
Can You Predict The Winners Of The 2016 Golden Globe Awards,1,1,10,35,0,10,4,45,0
25 of the coolest cars that have been in 'The Fast and the Furious' movies,1,3,3,53,2,14,2,56,0
Here's how the White House staff pranked President Obama for the holidays,1,3,5,56,1,11,0,61,0
7 little ways you can love your body more in 2017,1,3,0,34,0,10,5,34,0
Is This Kendall Jenner Falling On Her Literal Head?,1,2,9,33,1,8,0,42,0
10 Mouthwatering Dishes That Are As Healthy As They Are Simple,1,1,10,40,0,10,2,50,0
17 Pictures Guaranteed To Make You Sad,1,1,6,24,0,6,2,30,0
29 People Who Clearly Don't Understand How Food Works,1,1,8,34,1,8,2,42,0
OracleVoice: How A Concrete Manufacturer Is Changing The Face Of Finance,1,3,12,49,1,10,0,61,0
This 87-Year-Old Granny Gives Zero Fucks And She Is Everyone's Idol,1,1,12,40,3,10,2,52,0
Toronto's Peel District School Board in Muslim prayer row,1,3,6,42,1,8,0,48,0
Do You Actually Prefer Guys Or Pies,1,1,7,22,0,6,0,29,0
Super talented dad transforms his sons' drawings into beautiful artwork,1,2,1,60,1,9,0,61,0
"Sridevi, Nawazuddin & Akshaye Khanna Are All Set To Put You On The Edge Of Your Seat With 'Mom'",1,2,18,55,4,18,0,73,0
"Oh, how I loved you, Johnny Depp. Now I see the purple-tinted truth",1,3,6,45,4,12,0,51,0
14 Unbelievably Rude Cards From Your Dickhead Brain,1,1,7,35,0,7,2,42,0
FAKE NEWS on Day One: Spicer Scolds Press for TIME Reporter’s False Martin Luther King Bust Story,1,3,24,55,2,16,0,79,0
The Only Way To Ask For A Tampon,1,1,8,17,0,7,0,25,0
Here's The BS Reason Kanye Wasn't Invited To Perform At Trump's Inauguration,1,2,13,49,3,11,0,62,0
"For Migrants Headed North, the Things They Carried to the End ",1,3,8,42,1,11,0,50,0
Seasonal Allergy Problems,1,1,3,20,0,2,0,23,0
Two Adorable Little Girls Found Mark Ruffalo's Lost Phone In The Blizzard,1,1,12,49,1,11,0,61,0
These Dads Doing Ballet With Their Daughters Is the Only Thing You Need to Watch Today,1,2,14,57,0,15,0,71,0
"Dakota Johnson's Advice For Her 16-Year-Old Self: ""Don't Get Tattoos, You Idiot!""",1,1,13,46,9,11,2,59,0
Video Captures Delta Pilot Smacking Woman to Break Up Fight ,1,2,9,41,0,10,0,50,0
How conniving carmakers caused the diesel air pollution crisis,1,3,1,53,0,8,0,54,0
We Tried The Makeup Eraser That Claims To Remove All Your Makeup With Just Water,1,1,15,51,0,14,0,66,0
Don't Expect The Courts To Solve Trump's Conflicts Of Interest,1,3,10,41,2,9,0,51,0
We Need To Help Bob Saget Decide If He Should Get Lasik Or Not,1,1,14,35,0,13,0,49,0
MILO Resigns from Breitbart News,1,3,7,21,0,4,0,28,0
"Thalassophobia Is A Real, Terrifying Thing And You Definitely Have It",1,2,11,47,1,10,0,58,0
Which Famous YouTuber Should Be Your Valentine,1,1,8,32,0,6,0,40,0
Western Sahara: Kitesurfing in the Dakhla danger zone,1,2,4,41,1,7,0,45,0
Try to make it through this video of one snake eating another,1,3,1,49,0,11,0,50,0
"Thank you for your support, which is more important now than ever",1,3,1,52,1,11,0,53,0
20 Things That Happen When You're Out With The Squad,1,1,9,31,1,9,2,40,0
How Much Do Guys Know About Birth Control,1,1,8,26,0,7,0,34,0
GOP Sen Collins: House Healthcare Bill ‘Dead on Arrival’ in Senate,1,2,11,42,3,10,0,53,0
Footballer scores world's sneakiest penalty in truly stylish fashion,1,2,1,58,1,8,0,59,0
19 Pictures That Are Like A Dream If You Love Arcades,1,1,10,31,0,10,2,41,0
Rapper Fetty Wap Injured In A Motorcycle Accident,1,1,8,34,0,7,0,42,0
We Had An Expert Teach Us How To Do Our Makeup Like Grown-Ass Women,1,1,15,38,1,13,0,53,0
The 26 clichés of a middle-class Christmas,1,3,2,31,1,6,2,33,0
This Photographer Immersed Himself In The Lives Of Homeless People,1,1,10,47,0,9,0,57,0
The gruelling test of the Sydney to Hobart yacht race,1,3,3,41,0,9,0,44,0
Pick A Heart-Shaped Potato To Reveal Your Potato Soulmate,1,1,10,38,1,8,0,48,0
British singer's open letter about racist encounter on a train,1,3,1,51,1,9,0,52,0
21 Little Things You Did In 2006 That Were So Gratifying,1,1,9,31,0,10,6,40,0
Which Condiment Matches Your Personality,1,1,5,31,0,4,0,36,0
This graphic shows how vulnerable every type of job is to automation,1,2,1,56,0,11,0,57,0
"Not Withdrawing Rs 2,000 Notes Says Government, Nizamuddin Clerics Missing In Pakistan And Other Must Reads",1,2,15,71,2,15,4,86,0
Vote: Which NFL team had the most disappointing season?,1,3,5,40,2,8,0,45,0
Storm Stella: Thousands of US flights delayed or cancelled due to winter snowstorm,1,3,5,64,1,12,0,69,0
Gabrielle Union Looks EXACTLY The Same At Age 42 As She Did At 26,1,1,18,30,0,13,4,48,0
14 Crucial Tips For Anyone Who Washes Their Face,1,1,8,30,0,8,2,38,0
"How Well Do You Know The Intro To ""Daria""",1,1,9,22,2,8,0,31,0
MSNBC’s Nance: Trump ‘Pushing This Nation to a Constitutional Crisis’,1,3,12,44,4,9,0,56,0
There was something about Mary: She changed TV forever,1,2,5,40,1,8,0,45,0
Things Only People Who Hate Talking On The Phone Will Understand,1,1,11,43,0,10,0,54,0
18 of the hottest under-the-radar startups to watch in 2017,1,3,0,42,2,9,6,42,0
Can We Guess Your Fave Disney Villain Song Based On Your Fave Taylor Swift Song,1,1,15,50,0,14,0,65,0
21 Badass Things Bollywood Did In 2015,1,1,5,21,0,6,6,26,0
"Sports in 2016: Winners, Losers and Cheaters ",1,2,4,28,2,7,4,32,0
The new Interior secretary rode a horse to work because why not,1,2,2,50,0,11,0,52,0
32 Containers That Will Make You Want To Organize Immediately,1,1,9,41,0,9,2,50,0
People Make Their Ideal Starbucks Cup,1,1,6,26,0,5,0,32,0
25 Faces You'll Recognise If You've Ever Had A Period,1,1,9,31,2,9,2,40,0
"These Are the Most Beautiful Women in the World, According to a New Poll",1,3,9,49,1,13,0,58,0
Exclusive: Patient With Extreme Form of TB Sent to NIH,1,2,11,33,1,9,0,44,0
George Clooney And Channing Tatum Took Our BFF Test And OMG,1,1,15,34,0,10,0,49,0
This dad makes the most amazing Disney princess costumes for his daughter,1,2,2,60,0,11,0,62,0
Simple Leopard Halloween Makeup You Can Do In 10 Minutes,1,1,9,36,0,9,2,45,0
"A Black Body On Trial: The Conviction Of HIV-Positive ""Tiger Mandingo""",1,1,14,42,4,10,0,56,0
Test Your Culinary Knowledge,1,1,4,21,0,3,0,25,0
"23 Important Life Lessons ""The Hunger Games"" Have Taught Us",1,1,9,37,2,9,2,46,0
Caffeine may help protect against inflammation and heart disease finds new study,1,2,1,68,0,11,0,69,0
Just 28 Perfect Tweets From Women About The 2017 Oscars,1,2,8,32,0,9,6,40,0
A behaviourist's guide to New Year's resolutions,1,3,3,37,2,6,0,40,0
People Are Totally Obsessed With This Dad Sending His Family Weird Photos Of His Huge Cube,1,3,16,59,0,15,0,75,0
"You Probably Missed This One Detail In The Fifth ""Harry Potter"" Book",1,1,12,43,2,11,0,55,0
19 People Who Got The Worst Secret Santa Gifts In History,1,2,10,35,0,10,2,45,0
This Woman Makes Tiny Fake Food And It's Incredibly Cute,1,1,10,36,1,9,0,46,0
WATCH: Heart-Stopping Rescue As Kitten Comes Within A Whisker Of Death,1,3,16,42,2,10,0,58,0
Are Fat Cells Forever? ,1,3,4,14,1,4,0,18,0
French Mayor to be Tried for Muslim ‘Problem’ Comments,1,3,6,38,2,8,0,44,0
Which Random '80s Movie Are You,1,1,5,18,1,5,2,23,0
Bill O'Reilly Is Running Out Of Friends,1,3,8,24,1,6,0,32,0
"This Guy Watched All Of ""Breaking Bad"" For Three Days Straight And It's An Emotional Roller Coaster",1,1,17,63,3,16,0,80,0
"Watch: Obama ‘Anger Translator’ Bids Farewell: ‘Good Luck with Your Healthcare A**holes, I’m Out’",1,3,13,61,10,13,0,74,0
Can Your Body Language Trick People Into Liking You,1,1,9,34,0,8,0,43,0
What Small Things Frustrate You More Than Anything,1,1,8,35,0,7,0,43,0
"We Know Your Favorite Holiday Song Based On Your Favorite ""Frozen"" Song",1,1,12,46,2,11,0,58,0
The 25 Most Drab Celebrity Looks Of 2015,1,1,6,21,0,7,6,27,0
19 Things Everyone Who Owns A Flip Phone In 2015 Knows To Be True,1,1,12,34,0,13,6,46,0
'Not This White Woman' clothing line launched for women to show they didn't vote for Donald Trump,1,3,6,72,3,16,0,78,0
20 BuzzFeed Articles It's Probably OK That I Never Finished,1,1,11,36,1,9,2,47,0
31 Wonderful Local Stores From The Midwest You Can Shop Online,1,1,10,40,0,10,2,50,0
"The twilight tales of Vince Carter, Dirk Nowitzki and Paul Pierce",1,2,7,47,1,10,0,54,0
The Try Guys Try K-Pop Idol Makeup,1,1,8,19,1,6,0,27,0
23 Ridiculously Clever Halloween Costumes Every TV Lover Will Want,1,1,10,45,0,9,2,55,0
37 Of The Best Street Cats Of 2015 And Also A Few From 2014,1,1,11,25,0,13,10,36,0
Will Apple help get people addicted to news?,1,3,2,34,1,7,0,36,0
Which British Musician Are You Based On Your Zodiac Sign,1,1,10,37,0,9,0,47,0
37 Times Scottish Twitter Was The Funniest Place On The Internet In 2015,1,1,11,43,0,12,6,54,0
The Official Ranking Of Taylor Swift Leaving And Arriving Places In 2015,1,1,11,46,0,11,4,57,0
45 People Who Somehow Managed To Get Their Hand Stuck In A Fucking Jar,1,1,13,42,0,13,2,55,0
Reminder: This Was Life In 2001,1,1,5,16,1,5,4,21,0
"There's A Fun New Parody Of The ""Mr. Men And Little Miss"" Books",1,1,13,34,4,12,0,47,0
See All the World’s Greatest Places in One Month On a Flying Cruise,1,3,10,44,1,12,0,54,0
We Know How You'll Haunt People As A Ghost Based On Your Zodiac,1,1,13,37,1,12,0,50,0
"Try To Control Yourself, But The ""Sexiest Doctor Alive"" Is Giving Away A Date For Charity",1,1,16,55,3,15,0,71,0
We Know Your Height Based On Random Questions,1,1,8,30,0,7,0,38,0
17 Secrets Olive Garden Employees Will Never Tell,1,1,7,33,0,7,2,40,0
"Michael B. Jordan Got Laid The Fuck Out While Filming ""Creed""",1,1,11,37,3,10,0,48,0
19 Tweets About Nintendo That Will Make You Laugh,1,1,8,31,0,8,2,39,0
Which Classic Nintendo 64 Game Are You,1,1,6,24,0,6,2,30,0
Marcellus Wiley goes one-on-one with Lonzo Ball,1,3,4,35,2,6,0,39,0
‘Equal Pay Day’ Reminds Us That the Gender Wage Gap Myth Persists,1,3,11,41,2,11,0,52,0
21 Stores You'll Love If You Are Addicted To Urban Outfitters,1,1,10,38,1,10,2,48,0
What's The Absolute Laziest Thing You've Ever Paid For,1,1,9,35,2,8,0,44,0
This Fake Trailer For A Haunted Bro Movie Is Actually Terrifying,1,1,11,43,0,10,0,54,0
19 Game Day Recipes To Make This Sunday,1,1,7,23,0,7,2,30,0
17 Times Richard Ayoade Was The Hero We Needed,1,1,8,28,0,8,2,36,0
29 Dogs Looking Depressed AF In Their Halloween Costumes,1,1,9,37,0,8,2,46,0
23 People Who've Just Done Their Job Beautifully,1,1,7,31,1,7,2,38,0
This Makeup Challenge Is Putting Unknown Beauty Brands on the Map,1,3,9,46,0,10,0,55,0
The One Way To Get A Creepy Guy Away From You,1,1,11,24,0,10,0,35,0
Five Jet Crew Members Have Been Suspended For Allowing Sonu Nigam To Sing On A Flight,1,1,16,54,0,15,0,70,0
There's Now Weed For Menstrual Cramps That You Stick In Your Vagina,1,1,12,43,1,11,0,55,0
"The best CEOs, according to employees",1,2,4,27,1,5,0,31,0
"Bette Midler Fact-Check: Trump Said ‘More than 4,000 Shot in Chicago’ – but Only 762 Murders",1,3,11,53,6,15,7,64,0
Impress Fellow 90s Kids With This Fresh Prince Basketball Jersey,1,1,9,44,0,9,2,53,0
2017 MLB Rookies Who Are Being Hyped Up Too Early,1,2,11,25,0,9,4,36,0
The Boston women who knit sweaters for chickens,1,3,2,38,0,7,0,40,0
21 Dinners You Only Need 20 Minutes To Make,1,1,7,24,0,8,4,31,0
These Five Questions Will Tell You What Percentage Muggle You Are,1,1,11,44,0,10,0,55,0
I spent Christmas alone — and got exactly what I wanted,1,3,3,41,1,10,0,44,0
I Asked Guys If They Were Going To Buy Leona Lewis's Exclusive Grindr Album,1,1,14,47,1,13,0,61,0
"Everyone loves Bernie Sanders. Except, it seems, the Democratic party",1,3,5,52,3,9,0,57,0
Here's Why Tensions Are Flaring Over Gibraltar: QuickTake Q&A,1,2,11,39,3,8,0,50,0
How Well Can You Identify These '00s Teen Movies,1,1,8,29,1,8,2,37,0
She Let Another Woman In Labour Suffer Because Her Husband Had Scraped Her Audi,1,3,14,52,0,13,0,66,0
‘Learning Curve’ as Rick Perry Pursues a Job He Initially Misunderstood ,1,2,9,50,2,11,0,59,0
17 People Who Definitely Didn't Meet A Celebrity In 2015,1,1,8,32,1,9,6,40,0
"In Besieged Syria, Mothers Carry an Added Burden ",1,3,7,33,1,8,0,40,0
"25 Words You Don't Actually Understand Unless You're A ""Doctor Who"" Fan",1,1,11,43,4,11,2,54,0
The Grossest Thing On The Internet This Week Involves A Wrestler With Extremely Strong Junk,1,1,15,62,0,14,0,77,0
A Canadian Nightclub Put A Crazy Donald Trump Mural In Its Bathroom,1,1,12,44,0,11,0,56,0
Is This The Saddest Salad That Has Ever Happened?,1,3,9,31,1,8,0,40,0
This Louisiana Sheriff Will Scare The Living Shit Out Of You,1,1,11,39,0,10,0,50,0
You Should Take This Quiz If You Could Use A Laugh Today,1,1,12,33,0,11,0,45,0
Rogue groin? When filming a 'Star Wars' movie went kind of NSFW,1,2,8,41,3,11,0,49,0
How Trump administration could reshape the internet,1,3,2,43,0,6,0,45,0
Teen who lost his hands becomes unlikely basketball hero,1,3,1,47,0,8,0,48,0
"17 Words That Have A Different Meaning When You're A ""Friday Night Lights"" Fan",1,1,13,47,3,13,2,60,0
Friends' plan to trick teacher with identical haircuts is the sweetest thing,1,2,1,63,1,11,0,64,0
Surprise! Trump is listening to critics,1,2,2,31,1,5,0,33,0
#COCKROACHESANDCHER Is The Most Important Hashtag Of This Century,1,1,26,30,1,8,0,56,0
What Would One Of Your Sims Traits Be,1,1,8,22,0,7,0,30,0
Who Said It: Alice Cooper or the Dalai Lama,1,1,7,27,1,8,0,34,0
9 Ways To Save Your Sanity On The Wednesday Before Thanksgiving,1,1,10,42,0,10,1,52,0
"If Trump wants the pipes built in America, what does that mean?",1,2,3,47,2,11,0,50,0
Spanish UK resident feared insurance rule would force her to leave,1,3,3,53,0,10,0,56,0
Can You Name Every One Of Terry Pratchett's Discworld Books,1,1,10,39,1,9,0,49,0
Kendall Jenner's Ponytail Is What Ponytail Dreams Are Made Of,1,1,10,41,1,9,0,51,0
Absolut upsets South Koreans by mixing vodka with politics,1,3,3,47,0,8,0,50,0
21 Important Reminders For Anyone Who Went Through A Breakup This Year,1,1,11,46,0,11,2,57,0
The Weirdest Record Store Day Releases Ever,1,3,7,30,0,6,0,37,0
17 Questions Twins Are Sick Of Answering,1,1,6,26,0,6,2,32,0
4 Surprising Roles You Might've Forgotten Debbie Reynolds Played,1,3,8,46,1,8,1,54,0
17 Genius Candy Cane-Flavored Sweets,1,1,5,24,1,4,2,29,0
Seconds from disaster: Nail-biting photos from around the world capture the moment JUST before impact,1,3,6,79,2,14,0,85,0
14 Best Beatbox Vines Of 2015,1,1,4,14,0,5,6,18,0
What's Your Favorite Comedy Movie With A Black Cast,1,1,9,33,1,8,0,42,0
21 Of The Worst Things People Have Ever Smelled,1,1,8,29,0,8,2,37,0
17 Mind-Blowingly Delicious Noodles To Try In NYC,1,1,10,29,1,7,2,39,0
"A teen fired up Facebook Live from the highway. Moments later, everyone in her car was dead.",1,2,4,69,3,16,0,73,0
19 Teens Who Did The Most In 2016,1,3,6,14,0,7,6,20,0
Why Medications Are So Expensive (In One Map),1,3,8,28,2,7,0,36,0
Here's My Lonely Sister-In-Law's Newest Christmas Card,1,1,9,35,4,6,0,44,0
16 Realities Of Growing Up As Explained By TV Shows,1,1,10,30,0,9,2,40,0
These Eerie Photos Show Just How Hooked We Are On Our Phones,1,1,12,37,0,11,0,49,0
This Grandma Who Looks Like Scarlett Johansson Just Got Invited To Get Drunk With Her,1,3,15,56,0,14,0,71,0
How Much Of A Miserable Bastard Are You Actually,1,1,9,31,0,8,0,40,0
Congressional Black Caucus to Re-Hang Anti-Cop ‘Police as Pigs’ Painting in Capital Citing ‘Constitution’,1,3,13,73,6,13,0,86,0
Do You Remember Whose Music Video These Celebrities Starred In,1,1,10,43,0,9,0,53,0
15 Photos That Prove Reese Witherspoon Is Winning At Breakfast,1,1,9,42,0,9,2,51,0
25 Things ’90s Kids Said That ’00s Kids Would Never,1,2,7,27,2,9,6,34,0
7 Awesome Ideas For Easy Weeknight Dinners,1,1,6,29,0,6,1,35,0
"IS Operative Arrested In Gujarat, DU Student Gangraped By Friends And Other Must Reads",1,3,16,56,1,13,0,72,0
This Girl Just Won Halloween With Her Transforming Cinderella Costume,1,1,10,50,0,9,0,60,0
6 low-sweat exercises to beat the summer heat,1,2,0,36,1,7,1,36,0
Can You Pass Our Britishness Exam,1,1,6,22,0,5,0,28,0
"18 Times ""House M.D."" Got Way, Way Too Real",1,1,9,19,5,8,2,28,0
"Here's What Would Happen If The Characters Of ""Harry Potter"" Had The Internet",1,1,13,49,3,12,0,62,0
Nine of the weirdest Easter traditions around the world: From bunny hunting to real crucifixions,1,3,3,78,1,14,0,81,0
Are You Dealing With A Real Expert Or A Fake? 7 Ways To Tell,1,3,13,32,1,13,1,45,0
This Color Test Will Determine Your Favorite Type Of Dick,1,1,10,38,0,9,0,48,0
Virat Kohli Has Spoken Up Against Sexism And Gender-Based Violence,1,1,11,45,1,9,0,56,0
"21 Reasons Felicity Smoak Is The Real Hero Of ""Arrow""",1,1,9,31,2,9,2,40,0
Should You Join A Gym In 2016,1,1,6,13,0,6,4,19,0
"There's A New Character Named Linkle In An Upcoming ""Zelda"" Game",1,1,11,40,3,10,0,51,0
17 Disney Nutella Memes Guaranteed To Make You Laugh Out Loud,1,1,10,39,0,10,2,49,0
16 Important Things To Know About Getting A Puppy,1,1,8,31,0,8,2,39,0
This Selfie Of Mindy Kaling Wearing Pimple Cream Is All Of Us,1,1,12,38,0,11,0,50,0
15 Pets That Look So Much Like Food It Will Make You Uncomfortable,1,1,12,40,0,12,2,52,0
14 Men That Made 2015 A Maddeningly Hot Year,1,1,7,23,0,8,6,30,0
14 Tattoos That Didn't Make Sense Before 2015,1,1,6,25,1,7,6,31,0
Why I want my home to watch me,1,3,2,21,0,7,0,23,0
"One Direction Played ""Tattoo Roulette"" And It Got Pretty Tense",1,1,10,41,2,9,0,51,0
Police Shut Down Two Little Girls’ Lemonade Stand And It Was The Saddest Thing Ever,1,3,15,53,1,14,0,68,0
"25 Jokes That Are So Corny And Stupid, They're Actually Good",1,3,10,36,2,10,2,46,0
When You Turn Into A Different Person While Driving,1,1,9,34,0,8,0,43,0
Former Miss USA charged in boyfriend assault ,1,3,5,33,0,7,0,38,0
Career Change By Staying Put: How To Make A Lateral Move Within The Same Company,1,2,15,50,1,14,0,65,0
20 Faces You'll Have Perfected If You Love To Gossip,1,1,9,31,1,9,2,40,0
"MSNBC’s Roberts: Dems Have ‘Fever Dream,’ Getting ‘the Horse Before the Cart’ with Mike Flynn",1,3,16,56,7,14,0,72,0
Real parents reveal 16 kid expenses that are worth the money,1,3,1,47,0,10,2,48,0
10 Places To Travel In 2016,1,1,4,12,0,5,6,16,0
Zendaya Coleman Completely Changed Her Hair For This Shoot And It's Everything You Need In Life,1,1,16,63,1,15,0,79,0
Village vigilante who informs on illegally parked cars dubbed a 'prat' by furious traders,1,3,1,73,2,13,0,74,0
"Millennials, Do You Fear Snakes, Sharks Or Credit?",1,3,8,32,3,7,0,40,0
Disney Allows A Dying Fan To See The New Star Wars Early,1,1,12,33,0,11,0,45,0
Jessica Chastain Has Communed With Ghosts,1,1,6,30,0,5,0,36,0
19 Reasons Dogs Are Actually The Best Part of Any Party,1,1,9,34,0,10,2,43,0
17 Things The Republican Candidates Actually Looked Like At The Debate,1,1,10,48,0,10,2,58,0
"The Evolution Of Jennifer Lawrence's ""Hunger Games"" Style",1,1,8,39,3,7,0,47,0
Lie to Me: Fiction in the Post-Truth Era ,1,3,6,25,2,8,0,31,0
Can You Name The Iconic '90s Music Video From A Single Screencap,1,1,11,39,1,11,2,50,0
16 Foods Who Are Feeling A Little Lost Right Now,1,2,9,28,0,9,2,37,0
Here's What Real Healthy People Actually Eat For Brunch,1,1,9,37,1,8,0,46,0
"All the most shocking things about Scientology, according to Leah Remini's revealing show",1,2,4,71,2,12,0,75,0
Wasserman Schultz: Donald Trump Believes He ‘Was Elected as a Dictator’,1,2,9,49,3,10,0,58,0
11 Amazing Chicken Wings From Around The World,1,1,7,30,0,7,2,37,0
Kanye West Is Making Lots of Fashion People Super Mad,1,3,9,35,0,9,0,44,0
This Gross Video From Montreal Shows Why You Shouldn't Flush Condoms,1,1,11,46,1,10,0,57,0
15 Powerful Cocktails Guaranteed To Get You Through The Holidays,1,1,9,44,0,9,2,53,0
Grace VanderWaal's 10 Best Covers,1,2,5,21,1,4,2,26,0
This Marine’s Response To His Daughter Asking For A Pride Flag Is So Touching,1,3,14,49,1,13,0,63,0
This Music Video Starring All Dogs Is Fucking Insane,1,1,9,35,0,8,0,44,0
This Book Is For Everyone Who Loves TV As Much As Literature,1,1,13,36,0,11,0,49,0
Animated map of what Earth would look like if all the ice melted,1,2,2,50,0,12,0,52,0
9 Rescue Dogs Sleeping In Their Beds For The First Time,1,1,10,34,0,10,1,44,0
"Samuel L. Jackson Has Some Issues With The Lightsaber Battles In ""The Force Awakens""",1,1,14,54,3,13,0,68,0
Russian ambassador killed in Turkey: What do we know about assassin?,1,3,3,53,2,10,0,56,0
21 Barbie Computer Games You Totally Forgot Existed,1,1,7,35,0,7,2,42,0
Why Does Luke Skywalker Want to See the End of the Jedi?,1,3,8,36,1,11,0,44,0
16 Struggles That Are Way Too Real For People Who Constantly Have To Pee,1,1,13,44,0,13,2,57,0
Hyphen-Nation - NYTimes.com,1,3,5,17,3,2,0,22,0
17 Insanely Relatable Animal Vines,1,1,4,24,0,4,2,28,0
"For Online Dating Sites, a Bumpy Road to Love ",1,3,7,29,1,9,0,36,0
Laughter to be 3D printed and launched into space,1,3,2,38,0,8,1,40,0
"Beyonce-Adele's Powerful Grammys' Speeches, Taimur Ali Khan's New Pic & More From Ent!",1,3,13,54,7,12,0,67,0
27 Portraits From Wes Anderson Movies That Are Beautifully Striking,1,1,9,47,0,9,2,56,0
Sumo's next superstars? Why Mongolia is a wrestling powerhouse,1,2,3,49,2,8,0,52,0
The Best Cities for Getting a Great Job This Year May Surprise You,1,2,11,43,0,12,0,54,0
17 Tiny Necklaces That Are Too Cute To Function,1,1,8,29,0,8,2,37,0
If Victoria's Secret Models Had Stretch Marks,1,1,7,31,1,6,0,38,0
How democratic is Israel?,1,3,2,19,1,3,0,21,0
What's made Canada's Slims River disappear?,1,2,4,31,3,5,0,35,0
Poll: George Soros Incredibly Unpopular In Native Hungary,1,3,8,41,1,7,0,49,0
9 Wonderfully Weird Ornaments For People Who Don't Do Tradition,1,3,9,43,1,9,1,52,0
Washington State socks recalled after 'Go Dawgs' printed inside,1,3,4,49,2,8,0,53,0
Can You Guess Which Popular Music Video Has More Views,1,1,10,35,0,9,0,45,0
"This Is The ""Gilmore Girls"" Quote Your Heart Needs Right Now",1,1,11,37,2,10,0,48,0
Everyone forwarded this viral Santa story. But it might not be true.,1,3,3,52,2,11,0,55,0
18 Pictures That Prove Just How Small Canada's Population Is,1,1,9,39,1,9,2,48,0
What Color Is Your Aura Right Now,1,1,7,20,0,6,0,27,0
"This Vine Is The Only ""Hotline Bling"" Meme You Need To See",1,1,12,33,2,11,0,45,0
Is LeBron's NBA Finals performance the best ever? Not quite. He ranks eighth.,1,2,9,52,4,12,0,61,0
These Guys Went Into The Deep Woods To Find Bigfoot,1,3,10,32,0,9,0,42,0
Joseph Jakubowski manhunt: Fugitive purportedly writes letter threatening violence on Easter Sunday ,1,3,5,82,1,12,0,87,0
Climate 25 - The Weather Channel,1,3,4,20,1,5,2,24,0
15 Body Trends That Are The Next Big Thing,1,1,8,24,0,8,2,32,0
23 Things You'll Only Understand If You're Low-Key Obsessed With MAC Lipstick,1,1,14,47,3,11,2,61,0
VIDEO: Homeowner with Shotgun Lies in Wait for Intruders,1,3,10,37,1,8,0,47,0
17 Very Real Struggles For Anyone Who Grew Up With Super-Fine Hair,1,1,12,40,1,11,2,52,0
Mozart In The Jungle Should Be The Next Show You Binge-Watch,1,1,12,37,1,10,0,49,0
21 Things That Were Cool In 2006 But Definitely Aren't In 2016,1,1,9,31,1,11,10,40,0
"WhatsApp makes U-turn on 'Status' feature, rolling back its biggest recent update",1,3,4,62,4,11,0,66,0
Huge Fire Hits France’s Grande-Synthe Migrant Camp,1,3,8,34,2,6,0,42,0
34 Young Adult Novels To Diversify Your Bookshelf,1,1,7,33,0,7,2,40,0
Jesse Sexy Metcalfe Had A Yard Sale While You Were Living A Life Full Of Regrets,1,1,16,49,0,15,0,65,0
Muslim Comedian Mo Amer Travels With Eric Trump To Scotland. Comes Out With 'Good News',1,3,15,55,3,14,0,70,0
This Dog Riding A Bike With A Helmet On Is The Cutest Damn Thing You'll See All Day,1,1,18,47,1,17,0,65,0
"Which Is The Best ""Star Trek"" Movie Of All Time",1,1,10,26,2,9,0,36,0
14 Things We Learned From Caitlyn Jenner’s ‘20/20’ Interview [Video],1,2,8,39,6,9,6,47,0
Here's everything we know so far about Samsung's new Galaxy S8,1,3,4,45,2,10,1,49,0
"14 Reasons ""The Muppet Christmas Carol"" Is The Ultimate Christmas Movie",1,1,10,47,2,10,2,57,0
‘The Daily Show’ Names the ‘Greatest Trump Tweet of All Time’ ,1,3,9,38,4,11,0,47,0
17 Texts That Sum Up Being Drunk,1,1,6,18,0,6,2,24,0
Alys Fowler: how to give your seedlings the best start in life,1,2,2,48,1,11,0,50,0
These Three Questions Will Tell You Which Big City To Live In,1,1,12,38,0,11,0,50,0
Dude wakes up to a really mean skunk in his tent,1,3,1,37,0,10,0,38,0
Rebel Wilson Wants One Direction Fans To Know She Didn't Grope Harry Styles,1,1,13,49,1,12,0,62,0
We Know What Your Dream Means,1,1,6,18,0,5,0,24,0
Danielle Brown,1,3,2,11,0,1,0,13,0
Who Said It: David Brent Or Michael Scott,1,1,8,25,1,7,0,33,0
John Krasinski Had A Very Awkward Night At The Golden Globes While Sitting At Leonardo DiCaprio's Table,1,1,18,68,1,16,0,86,0
17 Pictures Of Beach Bodies That Will Get You Motivated,1,1,9,35,0,9,2,44,0
"Nintendo Announced Cloud Will Be In ""Smash Bros"" And We Lost Our Minds",1,1,13,43,2,12,0,56,0
"Martin Scorsese's Impression Of Robert De Niro In ""Goodfellas"" Is Perfect",1,1,11,49,3,10,0,60,0
This Girl’s Fish Pulled A “Finding Nemo” Move On Her And Everyone Is Screaming,1,2,14,48,3,13,0,62,0
"41,000 Indians Have Petitioned The Censor Board For More Gender-Sensitive Ratings",1,1,11,53,2,10,5,64,0
Nobody believed man got run over by a deer on April Fools'; video proves it,1,2,3,56,2,14,0,59,0
Who's the Hindu hardliner running India's most populous state?,1,3,3,48,3,8,0,51,0
14 Times Mindy Lahiri Perfectly Described Your Relationship With Food,1,1,9,49,0,9,2,58,0
Could Dark Matter Ever Form A Star?,1,3,7,21,1,6,0,28,0
19 Boyfriends Who Must Be Stopped,1,1,5,21,0,5,2,26,0
Which Rainbow Brite Color Kid Matches Your Personality,1,1,8,39,0,7,0,47,0
Defining moments in '70s television,1,2,1,27,1,4,2,28,0
CITI: These '12 Charts of Christmas' tell us a lot about what to expect in 2017,1,2,7,48,3,15,6,55,0
Kelly Ripa Got Her Walk Of Fame Star And Everything About It Was Adorable,1,1,14,46,0,13,0,60,0
‘Drunk Don Lemon’: CNN Cuts Mic During New Year’s Eve Show,1,3,13,31,4,10,0,44,0
Can Star Wars: The Last Jedi rehabilitate Yoda?,1,3,7,31,2,7,0,38,0
21 Things College Kids Actually Want For Christmas,1,1,7,34,0,7,2,41,0
Now We Know Why Sasha Obama Skipped Dad's Farewell Address  Insider,1,3,11,44,1,11,0,55,0
"Here are 15 of the most notable members of Mar-a-Lago, Trump's 'Winter White House' that costs $200,000 to join",1,2,7,70,8,18,8,77,0
Whoa: Celine Dion's Son Grew Up,1,1,6,18,2,5,0,24,0
15 Appetizers For A Rockin' New Year's Eve,1,1,7,24,2,7,2,31,0
Which Starbucks Drink Are You Based On Your Zodiac Sign,1,1,10,36,0,9,0,46,0
23 People Tell Us Why We Should All Be Rooting For The Mets,1,1,12,33,0,12,2,45,0
28 DIY Candles That Will Help You Brave The Cold,1,1,11,26,0,9,2,37,0
23 Vegan Recipes You Need To Try This Autumn,1,1,8,26,0,8,2,34,0
The Rock Literally Wore The Most Perfect Halloween Costume,1,1,9,41,0,8,0,50,0
Do You Know Your Fact From Fiction,1,1,7,21,0,6,0,28,0
Find Out How Big Of A Reality TV Fan You Were In 2015,1,1,13,24,0,12,4,37,0
"Your Soulmate Tom Hiddleston Is Really, Really Good At Impressions",1,1,10,46,1,9,0,56,0
31 Of The Most Heartwarming Books You’ll Ever Read,1,3,8,31,1,8,2,39,0
McCain: Rand Is ‘Working for Vladimir Putin’,1,3,7,28,3,6,0,35,0
These New Yorkers Dealt With A Stalled Subway Train By Starting A Drake Singalong,1,1,14,54,0,13,0,68,0
Third man arrested in connection to alleged Pamela Geller beheading plot,1,3,3,59,0,10,0,62,0
Best places to swim with sharks,1,3,1,25,0,5,0,26,0
Are You In Your Freshman Or Senior Year,1,1,8,24,0,7,0,32,0
This Video Of Anushka Sharma’s Conversation With A Journalist’s Mother Will Make You Go Awww!,1,3,15,61,3,14,0,76,0
Who Would You End Up With In A Wes Anderson Movie,1,1,11,28,0,10,0,39,0
Can You Make It Through These Photos Of Trucks Without Laughing Like A 7-Year-Old,1,1,15,50,2,13,1,65,0
"Richard Matt and David Sweat, Convicted Murderers Who Escaped Prison, Have Grisly Past",1,2,12,60,2,12,0,72,0
Airbus-Boeing Speed Race Increasingly Takes Place on the Ground,1,2,8,46,1,8,0,54,0
People are extremely confused by this BBC journalist's hands The list,1,3,5,53,1,10,0,58,0
Bill O'Reilly talked about the 'white establishment' and Twitter went into meltdown,1,2,4,65,3,11,0,69,0
"Are You Tyra Or Tiffany From ""Top Model""",1,1,8,23,2,7,0,31,0
20 Creepily Fascinating Things From Scotland Yard's Hidden Museum Of Crime,1,1,10,51,1,10,2,61,0
Which Male Actor Should You Get For Christmas Based On The First Letter Of Your Name,1,1,16,53,0,15,0,69,0
Serena Williams Gives The Best Answer To A Reporter Who Asks Why She Isn't Smiling,1,1,15,52,1,14,0,67,0
Amy Poehler's Biggest Fear Is Making J-Lo Mad,1,1,9,27,2,7,0,36,0
Can You Identify The Dog Breed By Its Picture,1,1,9,28,0,8,0,37,0
Prince William Gives Emotional And Rare Speech About Princess Diana,1,1,10,48,0,9,0,58,0
Sam’s Club Bets Drones Will Fly Off the Shelves at Christmas,1,2,9,40,1,10,0,49,0
Why anxious British parents' babies are among the greatest criers in the world,1,3,2,63,1,12,0,65,0
Brain can't remember colors - Business Insider,1,3,3,35,2,6,0,38,0
The WWE Issued An Apology For Kurt Angle Wiping His Nose On The Indian Flag 17 Years Ago,1,1,19,50,0,17,2,69,0
What makes Norway the world's happiest country?,1,2,2,37,2,6,0,39,0
Not extinct: 'Jurassic Pork' report flags projects that survived earmark ban ,1,3,3,60,3,11,0,63,0
The Oscars: Everything you need to know (and some things you don't),1,2,3,49,4,11,0,52,0
What I Learned About Friendship On Pro-Anorexia Sites,1,1,9,36,1,7,0,45,0
'The Powerpuff Girls': See the first images of the series' return,1,2,4,47,4,10,0,51,0
Dog-Related Bills Flood Albany as Major Legislation Stalls ,1,3,8,42,1,8,0,50,0
"What's The Most Underrated Place To Shop For Fun, Bright Plus-Size Clothing",1,1,13,48,3,11,0,61,0
"From Franklin Graham to Tony Campolo, some evangelical leaders are splitting over gay marriage",1,3,5,75,1,13,0,80,0
"What's The Best Video From Taylor Swift's ""1989""",1,1,7,26,4,7,4,33,0
Dates On Food Labels May Actually Start To Make Some Sense,1,2,11,37,0,10,0,48,0
Watch: SNL Pays Tribute to Obama — ‘Don’t Go!’,1,3,9,23,6,8,0,32,0
Why Medium Failed to Disrupt the Media,1,3,5,27,0,6,0,32,0
5 ways the GOP bill could change your health insurance,1,3,3,41,0,9,1,44,0
"Democrats block confirmation votes for Sessions, Price and Mnuchin",1,3,4,53,1,8,0,57,0
Where's The Best Place To Buy Punk And Grunge Clothes,1,1,10,33,1,9,0,43,0
Is feminism killing romance?,1,3,1,23,1,3,0,24,0
How Ford got right with Trump,1,3,3,21,0,5,0,24,0
"Gorsuch: Scalia A ‘Lion of the Law’ – Judges Should Look to What Law Demands, Not What They Prefer",1,2,15,60,5,18,0,75,0
22 Simple Rings That'll Give You All The Feels,1,1,8,27,1,8,2,35,0
People Try Holiday-Themed Cocktails,1,1,5,26,1,3,0,31,0
"Which Of The ""12 Days Of Christmas"" Are You",1,1,8,23,2,8,2,31,0
Mark Krikorian: Puzder Was Champion of ‘Jobs Americans Won’t Do’ Myth,1,3,10,45,4,10,0,55,0
In An Alternate Universe What Does Your Celebrity Thanksgiving Look Like,1,1,11,51,0,10,0,62,0
Which One Is The Real Yankee Candle Name,1,1,8,25,0,7,0,33,0
Can You Match The Boy To His Boy Band,1,1,9,20,0,8,0,29,0
42 Photos Of What It Looked Like Inside Kanye West's Fashion Show,1,1,11,40,1,11,2,51,0
See Ivanka Trump and Jared Kushner’s New $5.5 Million D.C. Home,1,3,10,36,5,10,2,46,0
Meat Is A Key Ingredient In A Lot More Than Food,1,3,11,27,0,10,0,38,0
23 Chilling Facts About Disney's Haunted Mansion,1,1,6,33,1,6,2,39,0
9 Safety Tips To Keep Your Pet Happy And Healthy This Fall,1,1,11,35,0,11,1,46,0
A Guy Asked Toronto Police To Arrest Him So He Could Catch The Jays Game From Jail,1,1,17,49,0,16,0,66,0
"Would You Rather: ""Star Wars: The Force Awakens"" Edition",1,1,9,35,4,8,0,44,0
"23 Reasons You Should Re-Watch ""The Social Network""",1,1,8,31,3,7,2,39,0
25 Times Halsey Was The Queen Of Instagram,1,1,7,26,0,7,2,33,0
How The World Will Look In 2035,1,3,6,15,0,6,4,21,0
The Shade Room Is Coming For The Gossip Industry's Wig,1,1,10,34,1,9,0,44,0
23 Times Kelly Rowland Was So Gorgeous It Almost Hurt,1,1,9,33,0,9,2,42,0
When Bike Sharing Goes Wrong,1,3,5,19,0,4,0,24,0
This Wife Surprised Her Husband With An Amazing Batman-Themed Family Photo Shoot,1,3,13,55,1,11,0,68,0
"How The ""Cash Me Ousside"" Teen Defies Expectations For White Girls",1,3,11,43,2,10,0,54,0
This Woman's Random Act Of Kindness For A Dad & His Daughter Is Going Viral,1,3,14,45,2,14,0,59,0
"Which Character From Disney's ""Recess"" Are You",1,1,7,30,3,6,0,37,0
This Extremely Chill Video Game Is All About Succulents,1,1,9,38,0,8,0,47,0
19 Extremely Satisfying Moments Every Woman Looks Forward To,1,1,8,42,0,8,2,50,0
Ask Your Employers To Let You Take A Power Nap For 20 Minutes Because It Can Help Boost Your Creativity,1,2,19,63,0,19,2,82,0
11 reasons why women's football is better than men's,1,2,0,40,2,8,2,40,0
"On ""Learning"" Blackness",1,1,3,16,2,2,0,19,0
"Paris, Bill O’Reilly, Venezuela: Your Thursday Evening Briefing ",1,3,9,43,4,8,0,52,0
What A Nuclear Test Can Teach Us About The Moon,1,2,10,28,0,9,0,38,0
These Extraordinary Close-Up Photos Of Animal Eyes Look Out Of This World,1,1,13,48,1,11,0,61,0
Fast and Furious 8 star Vin Diesel finally comments on Dwayne 'The Rock' Johnson feud,1,2,8,60,2,14,1,68,0
Should You Date A Member Of One Direction Or 5 Seconds Of Summer,1,1,12,39,0,12,1,51,0
24 Miss J. Alexander Reaction GIFs For Any Situation,1,1,10,31,1,8,2,41,0
14 Graphs That Are Too Real For Any Student With Social Anxiety,1,1,11,39,0,11,2,50,0
‘Liberal Answer to Breitbart News’ Loses CEO Before It Even Launches,1,3,12,44,2,10,0,56,0
Can We Guess If You Are Team Peeta Or Team Gale Based On Your Zodiac Sign,1,1,16,42,0,15,0,58,0
25 Things People Did To Feel More Confident During Sex,1,1,9,34,0,9,2,43,0
What NOT to do after a big sports performance: Thank both your wife and girlfriend,1,3,5,62,1,14,0,67,0
Are You Going To Be A Third Wheel Forever,1,1,9,24,0,8,0,33,0
"17 Compelling Reasons To Have A Crush On Brett Dier From ""Jane The Virgin""",1,1,13,44,2,13,2,57,0
The states where Americans are incorrectly declared dead every year,1,3,2,56,0,9,0,58,0
"21 Pure, Wholesome Tweets That Will Help You Through The Dark Winter",1,3,11,43,1,11,2,54,0
Which Iconic Celebrity GIF Are You Based On Your Biggest 2015 Achievement,1,1,13,45,0,11,4,58,0
All The Best Deals On The Internet Today,1,2,8,25,0,7,0,33,0
"The First Trailer For The ""Independence Day"" Sequel Is Here",1,1,10,38,2,9,0,48,0
21 Skincare Products That Might Help With Acne,1,2,7,30,0,7,2,37,0
"Everyone Freak Out Because The Spice Girls Are ""Potentially"" Planning A Reunion Tour",1,1,13,57,2,12,0,70,0
The High-Class Sushi Bar Has a New Secret Weapon,1,3,9,30,1,8,0,39,0
"If you want to end a relationship, this is how to do it The list",1,3,2,47,1,14,0,49,0
ESPN expert predictions: Will anyone catch the Cubs?,1,2,6,37,2,7,0,43,0
Senate Confirms Dr. Ben Carson 58-41 to Lead Housing and Urban Development Department,1,3,10,57,2,12,4,67,0
"Jimmy Kimmel Blended ""Scandal"" With ""Gossip Girl""",1,1,7,32,4,6,0,39,0
13 Animals Who Are Way More Gangster Than You,1,1,8,27,0,8,2,35,0
What's The Best Place To Buy Tomboyish Clothing,1,1,8,31,1,7,0,39,0
Italy’s Struggling Economy Has World’s Healthiest People,1,3,7,41,2,6,0,48,0
The 8 best new features Apple added to your iPhone in iOS 10.3,1,2,5,40,1,12,4,45,0
"Which Character From ""The Rocky Horror Picture Show"" Are You Based On Your Taste In Hot Dogs",1,1,17,57,2,16,0,74,0
This Hedgehog Is So Fat He Can't Even Roll Up Into A Ball Any More,1,1,15,36,1,14,0,51,0
Put These Songs On At Your Holiday Party If You Want Everyone To Murder You,1,1,15,46,0,14,0,61,0
People Took To Twitter To Share Their Deeply Personal #IntersexStories,1,1,11,49,1,9,0,60,0
"Kellogg’s Besieged by Food Product Recalls over Listeria, Glass, Metal",1,2,8,50,3,9,0,58,0
25 Gluten-Free Desserts That'll Make You Forget All About Flour,1,1,10,40,2,9,2,50,0
Interview with Ukip candidate gets more terrifying with every paragraph you read The list,1,2,3,73,0,13,0,76,0
What do Africans think of Trump?,1,3,3,23,1,5,0,26,0
The Hater's Guide to Loving Port Wine,1,3,6,24,1,6,0,30,0
"19 Times Forever 21 Went Way, Way Too Far",1,3,7,21,1,8,4,28,0
19 Things Lazy Girls Who Hate Getting Ready Will Know To Be True,1,1,12,38,0,12,2,50,0
"Hot Topic's New ""The Nightmare Before Christmas"" Collection Is Super Spooky",1,1,11,51,3,10,0,62,0
Why the rise of Donald Trump and Isis have more in common than you might think,1,3,4,59,0,15,0,63,0
6 Reasons Why Penning Down Your Thoughts On A Blog Is Always A Good Decision,1,3,14,47,0,14,1,61,0
10 Can't Miss Tax Deductions For Small Businesses & Self-Employed Persons,1,3,10,48,3,10,2,58,0
19 Questions You've Definitely Wanted To Ask Your Therapist,1,1,8,40,1,8,2,48,0
23 Photos People With Straight Hair Will Never Understand,1,1,8,39,0,8,2,47,0
Rapper Who Burned Donald Trump Mask Arrested in Connection with Violent Home Invasion,1,3,11,62,0,12,0,73,0
Tom Ford on why he won't dress Melania Trump ,1,3,4,31,1,9,0,35,0
24 Tweets About Being Introverted That'll Make You Laugh Out Loud,1,1,10,42,1,10,2,52,0
17 Of The Greatest Supermarket Substitution Fails Of 2015,1,1,7,36,0,8,6,43,0
Can We Guess What Your First Cell Phone Was,1,1,9,26,0,8,0,35,0
"Here's How To Do Therapy On Yourself, According To A Therapist",1,1,11,39,2,10,0,50,0
"Reading, Writing, Required Silence: How Meditation Is Changing Schools And Students",1,3,11,59,3,10,0,70,0
Tunnels to the sky: Photographer captures Italy's hidden courtyards,1,3,3,54,2,8,0,57,0
"Diwali, As Explained By My Brown Dad",1,1,7,22,1,6,0,29,0
"Fuck, Marry, Kill: The Girl Names Edition",1,1,7,25,3,6,0,32,0
19 Things You Need If You're Mildly Obsessed With Stuff,1,1,9,34,1,9,2,43,0
22 Deep Questions To Ponder In 2016,1,1,5,18,0,6,6,23,0
How the world cheered on 'Batkid'| Latest News Videos ,1,3,5,37,3,9,0,42,0
Instagram Is Launching a Redesigned Website with Bigger Photos,1,3,7,47,0,8,0,54,0
"Being An Extra On ""Black-Ish"" Totally Radicalized Me",1,1,9,33,3,7,0,42,0
13 Real AF Things Carrie Fisher Said About Living With Mental Illness,1,3,12,44,0,11,2,56,0
"Magaluf 2015: Bucking broncos, budgie smugglers and new laws",1,2,2,44,2,8,4,46,0
5 Signs Of High Emotional Intelligence,1,3,5,27,0,5,1,32,0
Secret Teacher: a counselling course revolutionised my teaching,1,3,2,53,1,7,0,55,0
22 Pictures That Prove Asos Is Conspiring To Turn Us All Into Cher,1,1,12,40,0,12,2,52,0
19 Tooth Fairy Ideas That Are Borderline Genius,1,1,7,31,0,7,2,38,0
Dad's Heartbreak: Girl He Raised as His Own Was Really Kidnapped as a Newborn - Yahoo,1,3,12,55,3,15,0,67,0
Awesome Teacher Pranks Students With Gibberish-Filled Spelling Test,1,3,9,50,1,7,0,59,0
Cuban on Trump: ‘I Don’t Think He Lasts Four Years’,1,2,9,29,4,9,0,38,0
"Plan Your Wedding, We’ll Give You A Day, Month, And Year",1,3,11,31,4,10,0,42,0
Here's How You Can Help India's 19-Year-Old Sprinter Get To The 2016 Olympics,1,1,13,42,4,12,6,55,0
A gynecologist secretly photographed patients. What’s their pain worth?,1,3,2,58,3,8,0,60,0
ESPN's NFL MVP poll: Ryan unseats Brady for No. 1 spot,1,2,13,27,3,10,1,40,0
President Trump Delivers First Address to Congress: Celebs React,1,2,8,47,1,8,0,55,0
9 Painfully True SEX-Pectations Vs Reality,1,1,8,27,1,5,1,35,0
21 People Who Slayed In African Ankara Print,1,1,7,28,0,7,2,35,0
The Carolina Panthers Mascot Is Absolutely Purrfect,1,1,7,38,0,6,0,45,0
Bloomberg on Sanctuary Cities: ‘The Law Is the Law’ – ‘You Should Obey the Law’,1,3,11,48,6,14,0,59,0
Champagne and Guy Fawkes masks: An inauguration party for Donald Trump in Russia,1,3,7,60,1,12,0,67,0
Why can’t TV tap into these plays for today’s marginalised?,1,3,3,44,3,9,0,47,0
Why Republican candidates should want to be shut out of debates,1,3,2,51,0,10,0,53,0
This Mother's Struggle To Bring Back Her Kidnapped 2 YO Daughter To Mumbai Is Coming To An End,1,3,18,57,1,17,1,75,0
19 Of The Most Cringe-Worthy Audition Horror Stories You'll Ever Hear,1,1,11,44,2,10,2,55,0
7 Home Purchases Worth The Splurge,1,2,5,23,0,5,1,28,0
Everyone's Sharing This Picture Of A Crowd To Make A Point About Modern Life,1,1,14,48,1,13,0,62,0
2016: The Year of the Canada Fan,1,2,4,17,1,6,4,21,0
A 42-Bogey Goods Train Runs Over This Indian Woman But She Survives The Incident Like A Boss!,1,2,17,56,2,16,2,73,0
55 Things That Slightly Infuriate Londoners,1,1,5,31,0,5,2,36,0
These Questions Will Tell Us When You Lost Your Virginity,1,1,10,38,0,9,0,48,0
You've Been Making The Wrong Thing In Your Rice Cooker This Entire Time,1,1,13,45,1,12,0,58,0
The Surprising Factor That Could Be A Gold Mine In Your Next Negotiation,1,3,13,47,0,12,0,60,0
19 Times Haggis Was The Fucking Worst,1,1,6,23,0,6,2,29,0
18 Major Scandals in Obama’s ‘Scandal-Free’ Presidency,1,3,6,36,4,6,2,42,0
Drunk Canadian Pilot Almost Endangered 100 Lives After He Fainted In The Cockpit!,1,3,12,53,1,12,3,65,0
21 Of The Weirdest News Stories From New Jersey In 2015,1,1,9,30,0,10,6,39,0
29 Unbelievably Cringeworthy Teenage Fashion Fails,1,1,5,38,0,5,2,43,0
New MacBook keyboard review - Business Insider,1,3,5,34,1,6,0,39,0
23 Cocktails That Will Make You Forget About Booze,1,1,8,32,0,8,2,40,0
Should You Stay Home From School,1,1,6,21,0,5,0,27,0
17 Times The Fragility Of Masculinity Went Way Too Far,1,1,9,34,0,9,2,43,0
5 Easy DIY Tips You Really Need To Try,1,3,10,19,0,8,1,29,0
The best photos from the NCAA Tournament so far,1,3,6,33,0,8,0,39,0
12 Animal Christmas Ornaments That Are Too Cute For Words,1,1,9,37,0,9,2,46,0
The weirdest insults politicians threw at each other in government this year,1,3,1,64,0,11,0,65,0
The clever pun pictures (that aren't as easy as you think) baffling the Internet... so how many can YOU solve?,1,2,5,79,7,19,0,84,0
Can We Guess Your Zodiac Sign Based On The Pattern You Choose,1,1,12,38,0,11,0,50,0
38 People Share What Helped Them Resist The Urge To Self-Harm,1,1,11,37,1,10,2,48,0
This Refugee Developed Smart Jewelry To Protect Women From Assault,1,3,10,47,0,9,0,57,0
28 Adorable Animal Things You Need In Your Life,1,1,8,29,0,8,2,37,0
26 Genius Tips For Keeping Your Shit Together In College,1,1,9,36,0,9,2,45,0
"Taylor Swift Donated 25,000 Books To NYC Schools In Need",1,1,11,30,1,9,5,41,0
"Someone Made An ""In-N-Out Pie"" And It Is A Beautiful And Revolting Mess",1,1,15,40,4,12,0,55,0
We Tried Virtual Reality For The First Time And Here's What Happened,1,1,12,44,1,11,0,56,0
It's Christmas so of course Norway has made a record-breaking pooping marzipan pig The list,1,3,4,71,2,14,0,75,0
Free Up iPhone Space With These Hidden Tricks,1,3,8,30,0,7,0,38,0
For Everyone Who Just Wants To Wear Cat Ears On Halloween,1,1,11,36,0,10,0,47,0
"Twitter Goes Crazy With This Dialogue From 'Half-Girlfriend', Turns It Into A Hilarious Meme!",1,3,15,60,5,13,0,75,0
DA Clears Fresno Officers In Fatal Shooting of Unarmed Teen,1,3,10,40,0,9,0,50,0
What's The Least Amount Of Exercise You Need To Remain Healthy? We Have The Answer!,1,3,15,51,3,14,0,66,0
"This Artist Painted Lin-Manuel Miranda's ""Hamilton"" On A Ten-Dollar Bill",1,1,12,46,5,9,0,58,0
Which Weird Animal Matches Your Zodiac Sign,1,1,7,30,0,6,0,37,0
'47 Meters Down' is the Mandy Moore shark movie we didn't know we wanted,1,2,4,50,3,13,2,54,0
What I learned from filing my own taxes for the first time,1,3,2,45,0,11,0,47,0
The 25x Rule To Early Retirement,1,2,5,20,0,5,2,25,0
These Michelle Obama memes are the internet's coping mechanism,1,3,3,50,1,8,0,53,0
"The Zodiac Signs As ""Favorite Things""",1,1,6,24,2,5,0,30,0
"17 Things You Never Noticed On ""Friends"" That Will Make You Say, ""How Did I Miss That?""",1,3,16,47,6,16,2,63,0
20 Cavity-Inducing Snacks That You'd Beg Your Mom For In Elementary School,1,1,12,47,2,11,2,59,0
16 Things All Girls Should Do In Their Twenties,1,1,8,29,0,8,2,37,0
These Are The Chillest Lizards In The History Of The Animal Kingdom,1,1,12,44,0,11,0,56,0
What Type Of Guy Is Your Ideal Man,1,1,8,19,0,7,0,27,0
Tell Us About A Time You Peed Yourself,1,1,8,23,0,7,0,31,0
Turkey Faces a New Political Reality,1,3,5,26,0,5,0,31,0
"Society Could Collapse In A Decade, Predicts Math Historian",1,2,9,41,1,8,0,50,0
Here Are The Six Guys You Have Inevitably Danced With At A Club,1,1,13,38,0,12,0,51,0
15 Surprising Actors Who Unknowingly Sparked My Sexual Awakening,1,1,8,46,0,8,2,54,0
27 Epic Adventures Worth Taking In Your Twenties,1,1,7,32,0,7,2,39,0
"Which Lyon Brother On ""Empire"" Is The Most Fine",1,1,9,28,2,8,0,37,0
Gay marriage opponents are suddenly all about states’ rights. Wonder why.,1,2,2,58,3,10,0,60,0
"Aziz Ansari's Parents Are Simply Amazing In ""Master Of None""",1,1,10,38,3,9,0,48,0
Pew Survey: Police Support Gun Rights over Gun Control by 3 to 1 Margin,1,3,9,46,1,13,2,55,0
How Would You Respond To These Texts,1,1,7,23,0,6,0,30,0
Do You Know The First Roles Of These A-List Actors,1,1,11,29,1,9,0,40,0
15 Totally Bizarre Kinds Of Booze You Can Actually Buy,1,1,9,34,0,9,2,43,0
Racist troll guilty of harassing Labour MP with antisemitic posts,1,3,4,52,0,9,0,56,0
"Poll: What Was The Scariest Character On ""Are You Afraid Of The Dark?""",1,1,13,41,4,12,0,54,0
Drunk Canadian Pilot Almost Endangered 100 Lives After He Fainted In The Cockpit!,1,2,12,53,1,12,3,65,0
A Dog Kept Watch Over Her Trapped Best Friend For A Week Until Help Arrived,1,1,15,46,0,14,0,61,0
23 Situations Everyone Who Grew Up Shy Will Understand,1,1,8,36,0,8,2,44,0
ICE Arrests 51 in Austin During Two-Day Op,1,3,9,23,1,7,2,32,0
Pamela Anderson Is Cured Of Hepatitis C,1,1,7,26,0,6,0,33,0
Seahawks GM on Richard Sherman trade talks: 'We've opened that door',1,2,6,48,4,10,0,54,0
If you have dark circles around your eyes it could be a sign of something more serious The list,1,3,2,75,0,18,0,77,0
"No Charges for Hijab Hate Hoax, Says Prosecutor",1,3,7,32,1,7,0,39,0
12 Presidential Candidates And Their Dog Twins,1,1,6,32,0,6,2,38,0
19 Times J.K. Rowling Was Sassy AF On Twitter In 2016,1,2,11,24,2,10,6,35,0
Can We Guess How Much Pizza You Ate In 2015,1,1,9,21,0,9,4,30,0
11 Songs '00s Disney Channel Kids Haven't Heard In Way Too Long,1,1,10,36,2,11,4,46,0
Improve Your Gmail With BuzzFeed's 5-Day Inbox Challenge,1,1,9,37,2,7,1,46,0
Freezing Genitals to Boost Sex Drive Is Apparently a Thing People Do Now,1,3,11,49,0,12,0,60,0
50 Cent Let His Money Do The Talking In An Instagram Response To Rick Ross,1,1,14,44,0,14,2,58,0
19 Pictures That Prove We Have Moved Far Away From God’s Light,1,3,11,37,1,11,2,48,0
26 Pictures That Show How Different America And Britain Are,1,1,9,39,0,9,2,48,0
7 coworking spaces with childcare across the U.S.,1,3,2,37,2,7,1,39,0
The 1 Simple Trick I Use To Totally Slash My Food Waste,1,3,11,32,0,11,1,43,0
33 Dwight Schrute Jokes That Still Make You Laugh Every Time,1,1,10,38,0,10,2,48,0
22 Fantastic Podcasts To Make Your Commute Less Shitty,1,1,8,36,0,8,2,44,0
'An angry Ferrero Rocher': CeeLo Green's bizarre Grammys outfit explained ,1,3,7,53,4,10,0,60,0
Don’t Leave a Job Interview Without Asking These 3 Questions,1,3,8,41,1,9,1,49,0
Sarcastic kid has the most cynical joke about what will happen when she turns 100,1,3,1,63,0,14,3,64,0
What Is Your Favorite Science Fact Of All Time,1,1,9,29,0,8,0,38,0
"15 Of The Most Impossible ""Would You Rather"" Questions You've Ever Heard",1,1,11,45,3,11,2,56,0
When Abuela Knows You're Sick,1,1,5,19,1,4,0,24,0
Everyone forwarded this viral Santa story. But it might not be true.,1,2,3,52,2,11,0,55,0
A Six-Figure Income May Not Shield You From a Shock,1,2,10,31,1,9,0,41,0
People are very worried by this video of Donald Trump The list,1,3,4,47,0,11,0,51,0
Which Broadway Musical Should You See Based On Your Birth Month,1,1,11,42,0,10,0,53,0
Premier League: 10 things to look out for this weekend,1,3,2,40,1,9,2,42,0
Which City Should You Visit Based On Your Taste In Chocolate,1,1,11,39,0,10,0,50,0
23 Historic Pictures From The Macy's Thanksgiving Day Parade,1,1,8,41,1,8,2,49,0
"Someone Created The Scariest ""Simpsons"" Opening Ever",1,1,7,37,2,6,0,44,0
Can Americans Pass The UK Driving Test,1,1,8,24,0,6,0,32,0
Schumer: I Wish Democrats Hadn’t Triggered the ‘Nuclear Option’,1,3,8,43,4,8,0,51,0
Willow The Costume Queen Has Totally Nailed Back To The Future Day,1,1,12,43,0,11,0,55,0
6 Reasons Why Sushant Singh Rajput Can't Resist Shah Rukh Khan's Invitation To Dubai,1,3,13,55,2,13,1,68,0
This Test Will Reveal Your Relationship Status At The End Of 2017,1,3,11,39,0,11,4,50,0
"After This Sikh Guy Became Part Of A Racist Meme, The Internet Helped Turn Him Into A Hero",1,1,18,54,1,17,0,72,0
Earl Thomas tweets he'll return next season for the Seahawks,1,3,3,47,1,9,0,50,0
Democrats Hope Trump's Cabinet Picks Will Stand in Their Own Way,1,2,10,43,1,10,0,53,0
You'll Want To Be Best Friends With Justin Bieber After Watching His Carpool Karaoke,1,1,14,56,1,13,0,70,0
"Rita Ora Wants To Remake ""Lady Marmalade"" And THAT IS NOT OK",1,1,19,28,2,11,0,47,0
Teacher: Why I don’t want to assign Shakespeare anymore (even though he’s in the Common Core),1,2,6,67,5,15,0,73,0
We Need To Talk About Nuts In Brownies And Cookies,1,1,10,31,0,9,0,41,0
11 People Who Look Strikingly Similar To Leonardo DiCaprio,1,1,9,39,0,8,2,48,0
The brutal dictatorship the world keeps ignoring,1,2,1,41,0,6,0,42,0
Thoughts You Have During An Exam,1,1,6,21,0,5,0,27,0
21 Second-Day Hairstyle Tutorials,1,1,4,23,1,3,2,27,0
How To Financially Prepare For A Career Change,1,3,8,31,0,7,0,39,0
Tina Fey has a message for all the college-educated white women that voted,1,3,2,59,1,12,0,61,0
Michael B. Jordan Is Too Hot To Handle In This New Movie Trailer,1,1,13,38,1,12,0,51,0
"Which ""White Chick"" Are You",1,1,5,16,2,4,0,21,0
NYC Man Who Allegedly Pushed an Army Veteran into Oncoming Traffic Charged with Murder,1,3,13,60,0,13,0,73,0
This Company Ships Potato Love Notes To Your Friends For $8,1,1,10,37,1,10,1,47,0
"What’s in Ivanka Trump’s Art Collection, and What Is It Worth?",1,3,9,39,4,10,0,48,0
21 Things Everyone Who Has Worked In A Welsh Pub Will Remember,1,1,11,38,0,11,2,49,0
This Is The Best Shah Rukh Khan Tribute Video You'll See All Day,1,1,13,38,1,12,0,51,0
"Damn, The Insides Of Indian Trains Are About To Change Completely",1,1,11,43,1,10,0,54,0
Great Moments In Roomfuls Of Men Legislating Women's Bodies,1,3,9,41,1,8,0,50,0
Here's What You Should Actually Do When You Have A Crush,1,1,11,34,1,10,0,45,0
There are major differences between Trump's immigration ban and Obama's 2011 policy,1,3,3,63,2,11,4,66,0
18 Valentine's Day Cupcakes That'll Make You Forget You're Single,1,1,9,42,3,9,2,51,0
Characteristics of Men Who Are More Likely to Go Bald [Video],1,2,9,40,2,10,0,49,0
Technology could redefine the doctor-patient relationship,1,2,1,50,1,5,0,51,0
Do You Know Your GF's Face By Touch,1,1,9,18,1,7,0,27,0
Can You Get A Perfect Score On This Ron And Hermione Quiz,1,1,12,34,0,11,0,46,0
"The Arctic is showing stunning winter warmth, and these scientists think they know why",1,3,2,70,1,13,0,72,0
How to Become a ‘Superager’ ,1,3,3,18,2,5,0,21,0
Report: Valerie Jarrett to Mount Insurgency from Obama’s DC Mansion,1,3,9,47,2,9,0,56,0
When Your BF Has A Female BFF,1,1,10,13,0,6,0,23,0
The Story Behind How This Dog Lost His Ear Is Heartbreaking And Inspiring,1,1,13,48,0,12,0,61,0
This 5SOS Performance Is The Most Beautiful Thing You'll Ever Hear,1,1,13,41,1,10,1,54,0
19 Things All Students Have Experienced,1,1,5,27,0,5,2,32,0
Boyfriends Try Their Girlfriends' Sexy Halloween Costumes,1,1,7,43,1,6,0,50,0
The happiness of gay people around the world mapped The list,1,3,2,48,0,10,0,50,0
Housing crisis: the empty nester's guide to downsizing,1,3,1,44,2,7,0,45,0
A Soap Opera Actress Tried To Hate On Viola Davis's Emmy Speech,1,1,12,39,1,11,0,51,0
"Forget coffee, this adorable baby has the greatest morning routine ever",1,3,1,59,1,10,0,60,0
Caitlyn Jenner On The Moment She Felt Most Proud To Be A Woman In 2015,1,1,14,38,0,14,4,52,0
15 Stylishly Sexy Tall Guys Who Will Make You Feel Things,1,1,10,35,0,10,2,45,0
17 Photos That Will Give You A Raging Hockey Boner,1,1,9,30,0,9,2,39,0
The 29 Best College Bars In America,1,1,6,21,0,6,2,27,0
Raw Photos Capture The First Moments Of Motherhood,1,1,8,35,0,7,0,43,0
Viola Davis Gives The Perfect Response To Nancy Grahn's Criticism,1,1,10,45,1,9,0,55,0
Where to Get Free Pancakes on National Pancake Day,1,3,7,35,0,8,0,42,0
"You Won't Sleep After Seeing The ""Today"" Show Cast As ""Peanuts"" Characters",1,1,12,46,5,11,0,58,0
"A 3-Year-Old Girl With Cancer Sang ""Let It Go"" From Her Bed With Some Help From Her Nurses",1,1,19,49,4,17,1,68,0
We Know Which K-POP Girl Group You Belong In Based On One Question,1,1,16,37,1,12,0,53,0
"ISRO's Record Breaking Satellite Launch, Jayalalithaa's Assets To Be Seized And Other Must Read Stories",1,2,18,68,3,14,0,86,0
This Is What People Are Buying On Amazon This Week,1,1,10,31,0,9,0,41,0
Seen This Image Of 'Pregnant' Trump Being Spooned By Vladimir Putin? Here’s What It Means!,1,3,15,56,5,14,0,71,0
We Know Which Marvel Superhero You Are Based On Your Zodiac Sign,1,1,12,41,0,11,0,53,0
5 Great Books To Read In November,1,1,6,20,0,6,1,26,0
These Hilarious Comics Will Change How You See Disney Princesses,1,1,10,45,0,9,0,55,0
"‘Teen Vogue’ Ignores Truth That Trayvon Martin Was Shot for Beating Zimmerman, Not Because of Race",1,3,14,66,3,15,0,80,0
23 People Who Couldn't Even Get A Fucking Acronym Right,1,1,9,34,1,9,2,43,0
Migrants take public transport to Calais,1,3,2,33,0,5,0,35,0
"Which ""Harry Potter"" Parents Are You And Your S.O. Based On Your Zodiac",1,1,14,41,4,12,0,55,0
Are You More Of An Earthling Or An Alien,1,1,9,23,0,8,0,32,0
Can You Identify The Architectural Landmark By One Small Detail,1,1,10,44,0,9,0,54,0
Ariana Grande Flawlessly Shut Down Sexist Comments In A Radio Interview,1,1,11,50,0,10,0,61,0
Why Getting Fired Is Worse Than Divorce,1,2,7,26,0,6,0,33,0
The Best Dry Shampoo for Every Hair Type,1,3,7,26,0,7,0,33,0
21 Puppies Who Are On The Naughty List This Year,1,1,9,28,0,9,2,37,0
Jeff Immelt on Dealing With Trump and Globalization,1,3,6,38,0,7,0,44,0
5 of the Biggest Celebrity Real Estate Buys of 2016 [Video],1,3,6,36,2,10,5,42,0
Tim Cook sees augmented reality rivaling iPhone's impact,1,3,3,45,1,7,0,48,0
Urban Meyer had last laugh in prank war with recruit Baron Browning,1,2,4,52,0,11,0,56,0
"Demonetisation Is Illegal, Journalists Twitter Accounts Hacked And Other Must Read Stories",1,3,12,66,1,11,0,78,0
"Kareena-Taimur's Adorable Pic Goes Viral, Kapil Sharma Introduces His GF To The World And More From Ent!",1,3,19,65,4,16,0,84,0
Cardboard And Caviar: Documenting Homelessness In London's Bourgeois Boroughs,1,1,9,58,2,8,0,67,0
We Know Who Designed Your Eye Bags Based On Your Birth Month,1,1,12,37,0,11,0,49,0
"Previously Deported Alien, Brother Busted With 200 Pounds of Meth",1,2,8,44,1,9,3,52,0
An 89-Year-Old Man Tried Stand-Up Comedy For The First Time And Smashed It,1,1,15,42,3,12,2,57,0
Property tycoon denies threatening business partner’s pregnant wife,1,3,1,58,1,7,0,59,0
We Know How Tall You Are Based On Popular Foods You've Never Eaten,1,1,13,40,1,12,0,53,0
Meet The 4-Year-Old Twins Who Are Taking The Modeling World By Storm,1,1,13,41,2,11,1,54,0
‘Game of Thrones’ reveals its Season 7 summer release date,1,2,3,43,2,9,1,46,0
25 Halloween Cakes That Will Scare The Shit Out Of You,1,1,10,32,0,10,2,42,0
Which Early 2000s Disney Show Matches Your Zodiac,1,1,7,31,0,7,4,38,0
15 Amazing Women You Should Know Better,1,1,6,25,0,6,2,31,0
14 Apps To Help You Manage Your Anxiety,1,1,7,23,0,7,2,30,0
12 Grim Realities Of Life,1,1,4,15,0,4,2,19,0
Are You More Like Zoe Or Joe Sugg,1,1,8,18,0,7,0,26,0
22 Perfect Valentines For People Who Have No Time For Feelings,1,1,10,40,0,10,2,50,0
ASCAP and Radio Group's 5-Year Pact Doesn't Address the Elephant in the Room,1,3,13,47,3,12,1,60,0
What Will Your New Year's Eve Be Like,1,1,8,21,1,7,0,29,0
U.S. Navy Vets Played Battleship And It Wasn't Pretty,1,1,10,32,3,8,0,42,0
13 Dad Jokes Guaranteed To Slay This Halloween,1,1,7,30,0,7,2,37,0
Can We Guess Your Zodiac Sign Based On Your Nail Polish Choice,1,1,12,39,0,11,0,51,0
Smartphone thefts drop as kill switch usage grows,1,2,1,41,0,7,0,42,0
Apple Vowed to Revolutionize Television. An Inside Look at Why It Hasn’t,1,3,10,49,2,11,0,59,0
Airplane Food In Economy Vs. First Class On 20 Airlines,1,1,9,34,1,9,2,43,0
Can You Name Every My Chemical Romance Song,1,1,8,28,0,7,0,36,0
40 Thoughts Everyone Has When It Starts Raining Outside,1,1,8,37,0,8,2,45,0
Waterfall Wedding Proposal Goes Horribly Wrong,1,2,6,35,0,5,0,41,0
21 Pieces Of Advice Anyone In A Relationship Could Definitely Use,1,3,10,43,0,10,2,53,0
Sisters Tell Their Worst Fight Stories,1,1,6,27,0,5,0,33,0
"SZA Shares Video for New Song ""Love Galore"" f/ Travis Scott",1,2,11,35,3,10,0,46,0
This Cat Is Named After Hugh Jackman Because It's Recovering From A Fire Faster Than Wolverine,1,3,16,62,1,15,0,78,0
22 Of The Most Powerful Photos Of This Week,1,3,8,25,0,8,2,33,0
How our culture of kink-shaming is making us much less sexually liberated than we think,1,2,1,71,1,14,0,72,0
13 Reasons Why Taylor Swift's 1989 World Tour Was The Best Part Of 2015,1,1,11,36,1,13,10,47,0
"Hey, Remember How 6 Democrats Voted To Confirm Ben Carson?",1,3,9,37,2,9,1,46,0
Lean In Isn't Working. Now What?,1,3,6,18,3,5,0,24,0
22 Pictures That Won't Make Sense To People Who Aren't An Eldest Sibling,1,1,12,44,2,12,2,56,0
Don Vito Has Died At 59,1,1,5,11,0,5,2,16,0
Some Dude Asked Natalie Dormer How She Feels About Looking Like Kermit The Frog's Girlfriend,1,1,15,62,1,14,0,77,0
We Know Your Valentine's Day Plans Based On Random Questions,1,1,10,40,1,9,0,50,0
23 Things People With Borderline Personality Disorder Want You To Know,1,1,10,48,0,10,2,58,0
Here's 12 Awkward Christmas Gift Stories,1,1,5,27,1,5,2,32,0
This Amazing New Plus-Size Clothing Line Is Not For The Faint Of Heart,1,1,14,43,1,12,0,57,0
American Santas Try Mince Pies,1,1,5,21,0,4,0,26,0
"For Online Dating Sites, a Bumpy Road to Love ",1,2,7,29,1,9,0,36,0
13 Real AF Things Carrie Fisher Said About Living With Mental Illness,1,2,12,44,0,11,2,56,0
Mom's Maternity Acroyoga Is out of This World - Yahoo,1,2,7,35,2,9,0,42,0
This Instagram Account Is Recreating 2015's Greatest Hits With Barbies,1,1,9,47,1,9,4,56,0
Here’s everything you can do right now to filter out Twitter abuse,1,3,2,52,1,11,0,54,0
21 Things For People Who Think Snails Are Cute AF,1,1,10,28,0,9,2,38,0
"Here's How To Draw A Hand, Maybe",1,1,7,17,2,6,0,24,0
17 Brilliant Slow Cooker Hacks,1,1,4,20,0,4,2,24,0
9 Totally Normal Things To Do With A Pig,1,1,8,23,0,8,1,31,0
Cavaliers' LeBron James weighs in on NBA's rest conundrum,1,2,7,40,2,8,0,47,0
38 Times Tom Hardy Melted Your Heart With His Love For Dogs,1,1,11,35,0,11,2,46,0
Christmas: The weird and wonderful ways the world is celebrating,1,2,2,52,1,9,0,54,0
The Soup Cancelled After 22-Year Run,1,1,6,22,1,5,2,28,0
"17 Outrageosly Funny ""Cards Against Humanity"" Combinations",1,1,6,42,2,6,2,48,0
Elizabeth Warren Fails to Disclose $1.3 Million Line of Credit,1,3,7,42,2,9,2,49,0
What Your Crush Thinks Of You Based On One Question,1,1,10,32,0,9,0,42,0
This Is What Happens When You're Garbage At Being An Adult,1,1,11,36,1,10,0,47,0
Here's How A Little Girl's Sketches Sent One Photographer On An Epic Journey,1,1,13,49,2,12,0,62,0
99 Things You Can Do To Improve Your Life And The Lives Of Those Around You,1,3,15,43,0,15,2,58,0
23 Tweets Every Single Person Can Identify With,1,1,7,31,0,7,2,38,0
This Woman Refused To Change Her Facebook Picture To The French Flag And It's Going Viral,1,1,16,57,1,15,0,73,0
How Successful People Spend Their Weekends,1,3,6,31,0,5,0,37,0
The Hot Spots Where Bankers Love to Vacation,1,3,7,30,0,7,0,37,0
"Can You Spot The Real ""Harry Potter"" Character From The Fake",1,1,11,37,2,10,0,48,0
Lowry: Paul Ryan Thinks Trump Will Just Sign GOP Bills — ‘That’s Not The Way It’s Going to Work’,1,2,19,53,6,18,0,72,0
"Power Rankings: Rockets, Spurs jump ahead after Warriors stumble",1,3,5,49,2,8,0,54,0
I'm About To Start A Rumor That Andi Dorfman And Chris Harrison Are Dating Based Off These Two Photos,1,1,19,63,1,18,0,82,0
Serious Question: Is This Brad Pitt Or Not,1,1,8,26,1,7,0,34,0
23 Ways You May Have Internalised Misogyny Without Even Realising,1,3,9,45,0,9,2,54,0
People Tried Salmon That Was Cooked In A Dishwasher,1,1,9,34,0,8,0,43,0
28 Unexpected Halloween Costumes You Can Make Yourself,1,1,7,38,0,7,2,45,0
Kendall Jenner Posed Topless And She Looks Like A Goddess,1,1,10,38,0,9,0,48,0
"Emma Watson Is A Badass On A Mission To Rescue Her Boyfriend In ""Colonia""",1,1,14,44,2,13,0,58,0
19 Pictures That Are Too Real When You Can't Pay Any Attention,1,1,11,37,1,11,2,48,0
I’ve lost faith in men. They seem incapable of genuine affection or loyalty,1,3,2,59,2,12,0,61,0
How Successful People Handle Toxic People,1,3,6,30,0,5,0,36,0
This Arab teacher’s catchy attempt to teach Hebrew has become an online sensation in Israel,1,3,4,72,1,14,0,76,0
Haley: No One at the UN ‘Is Talking to Me About the President’s Tweets’,1,3,11,43,4,13,0,54,0
"Alexa, Stop Making Life Miserable for Anyone With a Similar Name!",1,2,9,44,2,10,0,53,0
America Ferrera Is Thrilled To No Longer Be The Only Latina On Primetime,1,1,13,47,0,12,0,60,0
"Director Benny ""Boom"" Douglas Reveals Why an Unknown Actor Is Playing Tupac in 'All Eyez on Me'",1,3,14,61,4,16,0,75,0
Can You Pass This Basic American Sign Language Test?,1,3,9,34,1,8,0,43,0
"Are You More ""Parks And Recreation"" Or ""The Office""",1,1,9,30,4,8,0,39,0
17 Perfect Products For Embracing Your Inner Kanye,1,1,7,34,0,7,2,41,0
"His Brother Kept Mocking And Disturbing His Sleep, So He Hacked Him To Pieces In Full Public View",1,3,18,61,1,17,0,79,0
The best TV and film Easter eggs of the year,1,3,4,31,0,9,0,35,0
Try And Guess What Chips These Were Before We Smashed Them,1,1,11,37,0,10,0,48,0
Rihanna Now Has More No. 1 Singles Than Michael Jackson,1,1,9,35,1,9,1,44,0
How This Writer Learned To Cope With His Stepbrother's Schizophrenia,1,1,10,48,1,9,0,58,0
How A 21-Year-Old Took UBreakiFix From His Bedroom To 262 Stores And A Deal With Google,1,2,18,47,2,15,5,65,0
7 Insanely Delicious Ways To Eat Leftover Halloween Candy,1,1,8,40,0,8,1,48,0
43 Pets Who Need A Home For Christmas,1,1,7,21,0,7,2,28,0
10 Horror Movie Questions That’ll Stump Even The Biggest Fanatics,1,3,9,44,1,9,2,53,0
Tell Us About Yourself(ie): DJ Qualls,1,1,7,22,3,5,0,29,0
17 Times Rihanna Taught You How To Talk To Fuckboys,1,1,9,31,0,9,2,40,0
This New Gray Burger From McDonald's Has Everyone Saying WTF,1,1,13,37,1,9,0,50,0
22 Tweets That Perfectly Sum Up Growing Up Texan,1,1,8,30,0,8,2,38,0
Finally! A Crossword Filled With Star Wars Puns,1,1,8,31,1,7,0,39,0
A Man And A Woman Live Streamed The Same Moments To Show How Differently Women Are Treated Online,1,1,18,62,0,17,0,80,0
Billboard Music Awards: Photos of the 2017 Nominees,1,3,5,34,1,7,4,39,0
"If The Characters On ""Jessica Jones"" Looked Like They Did In The Comics",1,1,13,44,2,12,0,57,0
This Guy Drops His Phone In The Toilet Has Worst Day Ever,1,1,12,34,0,11,0,46,0
Don't Believe All the Bad Sh*t People Say About Diet Coke,1,3,10,35,2,10,0,45,0
"25 Times The ""OITNB"" Cast Were Ultimate Squad Goals At The Emmys",1,1,15,34,2,11,2,49,0
Cinnabon fails the galaxy with terrible tweet about Carrie Fisher's death,1,3,3,59,1,10,0,62,0
That Thing When Your Hair Looks Amazing Right Before A Haircut,1,1,11,41,0,10,0,52,0
30 Life-Changing Crock-Pot Recipes To Make This Fall,1,1,9,32,2,7,2,41,0
Bloomberg on Sanctuary Cities: ‘The Law Is the Law’ – ‘You Should Obey the Law’,1,2,11,48,6,14,0,59,0
The Worst Things About Weddings,1,1,5,22,0,4,0,27,0
Here's Some Glorious Photos Of Voldemort Dancing Enthusiastically At A Photocall,1,1,11,58,1,10,0,69,0
These Three Questions Will Tell You What Disney Movie You'd Star In,1,1,12,43,1,11,0,55,0
NASA Astronauts Don't Have Enough Spacesuits To Wear & This Is An Astronomical Problem!,1,3,16,55,3,13,0,71,0
The Designer of Melania Trump’s Inaugural Ball Gown Loved Working With Her,1,3,11,51,1,11,0,62,0
"Russ, Kawhi, Harden, or LeBron? We Know Who Deserves To Win NBA MVP",1,3,17,34,4,12,0,51,0
12 Charts Only People Who Live In L.A. Will Understand,1,1,10,31,2,9,2,41,0
Haim Saban ‘Deeply Disturbed’ by Obama’s ‘Biased’ Actions Against Israel,1,3,9,49,5,9,0,58,0
"Schwarzenegger Quits ‘Celebrity Apprentice’ After One Season, Cites Show’s ‘Baggage’",1,2,10,59,6,9,0,69,0
10 Times Trump Spread Fake News ,1,2,5,19,0,6,2,24,0
"Thanks To Cow Slaughter Ban, The Cricket Ball Might Become Obsolete!",1,3,11,45,2,10,0,56,0
Your Tuesday Briefing ,1,2,3,16,0,3,0,19,0
13 Classic ’00s Songs That Were Actually Meant For Other Artists,1,2,9,40,1,10,4,49,0
This Korean Pop Star Can't Stop Falling On Stage During Her Performance,1,1,12,47,1,11,0,59,0
Justin Bieber Walked Out Of A Painfully Awkward Spanish Interview,1,1,10,46,0,9,0,56,0
"The Playlist: Mary J. Blige Sings of Self-Empowerment, Kendrick Lamar Raps About Power ",1,3,13,57,4,13,0,70,0
Your Horoscope For October,1,1,4,19,0,3,0,23,0
"The Internet Has Decided On Its Favourite ""Force Awakens"" Couple",1,1,10,43,2,9,0,53,0
15 Christians Who Don't Care At All About A Starbucks Cup,1,1,10,34,1,10,2,44,0
Budget 2017: key points at a glance,1,2,1,23,1,6,4,24,0
We Know If You're More Waffle House Or Ihop Based On These Seven Questions,1,1,14,46,1,13,0,60,0
Jennifer Lawrence's Real-Life Best Friend Called Her On TV To Find Out If She's Been Replaced By Amy Schumer,1,1,21,66,3,18,0,87,0
6 of the Craziest Things We Saw Go Down During Inauguration Weekend,1,2,9,46,0,11,1,55,0
The Story Of A Reporter Who Killed Herself On Air Is Taking Over Sundance,1,1,14,46,0,13,0,60,0
17 Confessions Of People Who Were Dumped In The Worst Ways,1,1,10,36,0,10,2,46,0
Profiles From Your Nightmares: Evil Clown,1,1,6,29,1,5,0,35,0
22 Photos That'll Make You Miss The Hell Out Of Your School Friends,1,1,12,40,1,12,2,52,0
19 Hilarious Disney Posts That Totally Nailed It,1,1,7,32,0,7,2,39,0
"New Day, weekdays 6-9am ET 3-year-old's beaming adoption photo wins over Internet",1,3,5,57,5,11,3,62,0
Seth Rogen Says The Most Perfect Thing About Dick Pics,1,1,10,35,0,9,0,45,0
"Does Dark Matter Exist, Or Is Gravity Wrong? The Answer Lies Billions Of Years In The Past",1,2,17,55,2,16,0,72,0
"Colin Kaepernick Turns In Historically Bad Performance Against The Bears, Benched For Gabbert",1,2,13,67,1,12,0,80,0
Transgender Teens Get Emotional Speaking To Their Future Selves In This Powerful Video,1,1,13,61,0,12,0,74,0
Are Your Instagram Habits Like Everyone Else's?,1,3,7,32,2,6,0,39,0
25 Incredibly Beautiful Wedding Cakes That Won 2015,1,1,6,32,0,7,6,38,0
'90s Pop Culture References Your Kids Will Never Understand,1,1,8,40,1,8,2,48,0
27 Songs From 2007 You Definitely Had On Your iPod,1,3,8,27,0,9,6,35,0
7 Terror Attacks and Plots Foiled This Christmas Season,1,3,7,39,0,8,1,46,0
Watch 19 Male Celebrities Speak In Other Languages,1,1,7,34,0,7,2,41,0
This Lingerie Model Was Born Without Legs And Uses A Skateboard To Get Around,1,1,14,50,0,13,0,64,0
5 differences between a pocket sprung and memory foam mattress,1,3,0,52,0,9,1,52,0
A Billionaire in La La Land,1,3,5,17,0,5,0,22,0
"The ""Friends"" Creators Can't Stress Enough That A Reboot Will Never Happen",1,1,12,48,3,11,0,60,0
"A Lot Of People Are Sharing This Bizarre And Unexpected ""Come Dine With Me"" Ending",1,1,15,51,2,14,0,66,0
Here Are 7 Quick And Easy Dinners To Make This Week,1,1,10,30,0,10,1,40,0
These Men Tried To Groom Their Own Eyebrows,1,1,8,28,0,7,0,36,0
What Do You Wish You Knew Before You Started Losing Weight,1,1,11,37,0,10,0,48,0
Oscars Mistake Casts Unwanted Spotlight on PwC ,1,3,7,33,0,7,0,40,0
Here Are 6 Unique Ways To Drink Coffee,1,1,7,23,0,7,1,30,0
19 Incredibly Important Reasons You Should Watch The Rugby World Cup,1,1,10,46,0,10,2,56,0
Watch Google's CEO Dissing The Hell Outta Real Madrid Like A True Barca Fan,1,1,16,45,1,13,0,61,0
"18 Reasons You Need To Be Watching ""Billy On The Street""",1,1,10,32,2,10,2,42,0
"Woman Detained at DFW Airport for Allegedly Smuggling Raw Animal Brains, Other Animal Parts in Luggage",1,2,15,71,1,15,0,86,0
23 Products Everyone Who Hates Everyone Needs To Own,1,3,8,34,0,8,2,42,0
10 Go-Go Remakes You Absolutely Must Hear,1,1,7,25,1,6,2,32,0
31 Celebrity Babies We Said Hello To In 2015,1,1,7,23,0,8,6,30,0
This is the safest place for you to sit in a plane The list,1,3,2,44,0,13,0,46,0
Tell Us Why You Take Medication For Your Mental Health,1,1,10,35,0,9,0,45,0
"Are You Finn Or Poe From ""Star Wars: The Force Awakens""",1,1,11,31,3,10,0,42,0
Can You Guess The Lana Del Rey Music Video From The Screenshot,1,1,12,39,0,11,0,51,0
17 Things That Were Maybe Going To Kill You In 2015,1,1,9,26,0,10,6,35,0
The country where women are sent to exile for being on their period The list,1,3,2,60,0,14,0,62,0
Why April 15 Has Lost Its Claim as ‘Tax Day’ ,1,3,8,23,2,10,2,31,0
10 Leftover Makeovers You Won't Believe,1,1,5,26,1,5,2,31,0
Are You More Emotional Or Logical,1,1,6,22,0,5,0,28,0
France’s Presidential Vote on Sunday: Why It Matters ,1,2,7,36,2,8,0,43,0
Steven Spielberg's 'Jurassic Park' decision that changed movies forever,1,2,4,56,3,8,0,60,0
I Started Therapy So I Could Take Better Care Of Myself,1,1,11,34,0,10,0,45,0
Fix Is In: House Committee on ‘Russian Hacking’ Includes Only DNC-Hired Tech Experts,1,2,15,53,4,12,0,68,0
Can You Match The Iconic Costume To The Quote,1,1,9,28,0,8,0,37,0
I Forgot To Find My Husband At A Black University,1,1,10,30,0,9,0,40,0
This Girl Whose Entire Family Got Killed In An Act Of Arson Just Wants Cards For Christmas,1,1,17,57,0,16,0,74,0
Panda Wrestles Snowman [Video],1,3,4,21,2,3,0,25,0
"Ronda Rousey Beat The Crap Out Of A Guy On ""Ellen"" And It Was Awesome",1,1,15,38,2,14,0,53,0
Jennifer Lawrence Was So Nervous About Her First Sex Scene That She Got Drunk,1,1,14,50,0,13,0,64,0
U.S. Soccer should start answering tough questions about Hope Solo,1,2,5,50,2,9,0,55,0
Women Are Painting Tiny 3-D Sweaters On Their Nails And It's Amazing,1,1,12,42,2,11,1,54,0
10 Foods You Didn't Know Had Nuts In Them,1,1,8,22,1,8,2,30,0
Watch All the Performances at the 2017 Grammys,1,3,4,31,0,7,4,35,0
Dollar Regains Reflation Mojo as Hedge Fund Bets Get Flushed Out,1,2,10,44,0,10,0,54,0
19 Jokes About “Mr. Brightside” That Are Guaranteed To Make You Laugh,1,3,11,42,3,11,2,53,0
The Only Times Square Live Stream You'll Need On New Year's Eve,1,2,12,38,2,11,0,50,0
Are You Taller Than Barack Obama,1,1,6,21,0,5,0,27,0
Katy Perry's Pan Flute Performance Will Have You Crying Tears Of Laughter,1,1,12,49,1,11,0,61,0
This Is What Happens When Your Abuela Tries To Speak English,1,1,11,39,0,10,0,50,0
Emma Bunton Taking A Selfie Is The Most Baby Spice Thing To Ever Happen,1,1,14,44,0,13,0,58,0
This Is How You Know You're Not Meant To Be An Entrepreneur,1,3,12,35,1,11,0,47,0
The Naked Rowers Are Back With Their 2016 Calendar,1,1,8,30,0,8,4,38,0
Here Are 20 Very Attractive Men Who Aren't White,1,1,8,29,1,8,2,37,0
BuzzFeed Edit News,1,1,4,12,0,2,0,16,0
Destinations 10 dishes you cannot leave the Netherlands without eating,1,3,2,57,0,9,2,59,0
17 Hilarious Gifts Parents Have Given To Their Kids,1,1,8,33,0,8,2,41,0
Fed tantrum sets off biggest exodus from emerging markets since 2008,1,2,1,53,0,10,4,54,0
17 Uncommon Survival Products That Will Actually Change Your Life,1,1,9,45,0,9,2,54,0
New Yorker Cover Imagines The Childishness Of A Donald Trump Presidency,1,3,11,50,0,10,0,61,0
These badass women exercising to Maya Angelou's poetry is all the inspiration you need today,1,2,3,74,1,14,0,77,0
"Which Character From ""The Good Dinosaur"" Are You",1,1,8,31,2,7,0,39,0
True meaning of Christmas found in family's magical reunion,1,3,2,48,1,8,0,50,0
"F#@k, Marry, Kill: The ""Divergent"" Edition",1,1,6,24,7,5,0,30,0
"Illinois Second Graders Adore School Janitor, Line Up to Get Yearbooks Autographed - Yahoo",1,3,12,63,2,13,0,75,0
"This Is What The Cast Of ""Made In Chelsea"" Would Look Like As Dogs",1,1,14,37,2,13,0,51,0
5 Things to Watch in British Prime Minister Theresa May’s Speech,1,3,8,44,1,10,1,52,0
9 Things TV And Movies Actually Have To Understand About Latinos In 2016,1,1,12,43,0,12,5,55,0
17 Things Kylie Jenner Did Three Years Ago That She'd Never Do Now,1,1,12,39,1,12,2,51,0
"Buzzy, Newly Accessible Destinations, From the Canadian Arctic to Chengdu, China",1,3,9,58,3,10,0,67,0
"Grades, draft needs, offseason questions for every eliminated team",1,3,1,55,2,8,0,56,0
Single People Take Honest Holiday Photos,1,1,6,29,0,5,0,35,0
Explorers plan descent to the Titanic before it's too late,1,3,2,46,1,9,0,48,0
24 Relationship Problems That Are Too Real For People WIth Anxiety,1,1,11,43,0,10,2,54,0
The 10 trickiest Goldman Sachs interview questions,1,2,3,39,0,6,2,42,0
19 Things Everyone Who Does Military Fitness Knows To Be True,1,1,10,39,0,10,2,49,0
From mermaids and breast feeding mothers to a 'man fairy': The 69 new emoji coming to your phone this year,1,2,2,80,3,19,2,82,0
"How Well Do You Remember The Lyrics To ""School Of Rock""",1,1,11,32,2,10,0,43,0
LaVar Ball Is a Genius,1,3,5,13,0,4,0,18,0
20 Underrated Actors Who Deserve Some Emmy Love,1,1,7,31,0,7,2,38,0
10 Badass Hairstyles You Need To Try Immediately,1,1,7,32,0,7,2,39,0
Pigskin A Blanket: NFL Week 14 Picks,1,1,8,19,1,6,2,27,0
"We Know Your Favorite ""Game Of Thrones"" Character Based On Your Favorite ""Harry Potter"" Character",1,1,15,64,4,14,0,79,0
27 Cheap Plastic Things That Were Your Entire Childhood For Some Reason,1,3,11,47,0,11,2,58,0
Your Sweet Tooth Will Be Changed Forever After These Homemade Doughnuts,1,1,11,50,0,10,0,61,0
100 funny jokes by 100 comedians,1,3,0,21,0,5,6,21,0
21 Of The Most Powerful Photos Of This Week,1,3,8,25,0,8,2,33,0
49 Bizarre But Also Very Real Fears Every Woman Can Relate To,1,3,11,37,0,11,2,48,0
20 Times Women Rocked The Red Carpet In Dapper Suits,1,3,9,32,0,9,2,41,0
25 Movies From The '00s That Are So Bad They're Good,1,1,9,27,2,10,4,36,0
15 TV Characters Who Prove Slytherins Are Actually The Best,1,1,10,38,0,9,2,48,0
68 Beautiful Temporary Tattoos You'll Want To Keep Forever,1,1,8,39,1,8,2,47,0
Dem Rep Gabbard: I’m ‘Doing My Homework’ on the Impeachment Process,1,2,9,44,4,10,0,53,0
17 Times The Internet Perfectly Summed Up Being A Libra,1,1,9,35,0,9,2,44,0
The Hardest Science Quiz You'll Take Today,1,1,7,28,1,6,0,35,0
This ’00s Quiz Will Reveal Your Age And Location,1,3,8,29,1,8,2,37,0
19 Dogs Who Just Don't Want Summer To End,1,1,8,22,1,8,2,30,0
Lady Antebellum reveals 2017 ACM Award nominees,1,3,6,31,0,6,4,37,0
"Afghanistan, Syria, Vin Diesel: Your Friday Briefing ",1,2,7,36,3,7,0,43,0
How Patriotic Are You?,1,3,4,14,1,3,0,18,0
This Cancer Survivor Lost Her Leg But It Didn't Slow Her Down,1,1,12,37,1,11,0,49,0
Gwyneth Paltrow Sends Birthday Wishes to Ex-Husband Chris Martin … and Boyfriend Brad Falchuk,1,3,12,66,2,13,0,78,0
19 Things Every Person Who Stays Up Too Late Knows,1,1,9,30,0,9,2,39,0
Secrets of Disney World performers revealed in longtime Goofy's AMA,1,3,7,50,1,9,0,57,0
"Do You Really Know The Words To ""Breaking Free""",1,1,9,28,2,8,0,37,0
These Three Girls Dressed Up As “Hidden Figures” Characters Will Give You Life,1,3,13,51,2,12,0,64,0
Hillary Clinton's gut-wrenching day,1,2,2,28,2,3,0,30,0
"Catholic Group Flies Syrians to Italy, Marking Contrast to Trump Ban",1,2,9,48,1,10,0,57,0
9 Slightly Gross Reasons You Might Want To Leave Your Pubes The Fuck Alone,1,1,13,47,0,13,1,60,0
23 Things All Single Girls Are Tired Of Hearing,1,1,8,29,0,8,2,37,0
Amazon to Begin Accepting Food Stamps,1,3,5,27,0,5,0,32,0
17 Hilarious Literary Thanksgiving Puns,1,1,4,29,0,4,2,33,0
This Freestyle Crossword Will Test Your Knowledge Of Pop Culture,1,1,10,45,0,9,0,55,0
ISRO Successfully Launches RESOURCESAT-2A On The PSLV-C36 Rocket This Morning,1,3,28,35,2,9,3,63,0
It's The Moment You've Been Waiting For: 100 Years Of Hamster Beauty In 60 Seconds,1,1,13,47,3,14,5,60,0
15 Important Reminders For Anyone Who Wants To Lose Weight This Year,1,1,11,44,0,11,2,55,0
If you have any of these symptoms you may have an anxiety disorder The list,1,2,2,59,0,14,0,61,0
7 high-paying jobs for people who hate people,1,2,0,36,1,7,1,36,0
Britain First: A day with the UK's anti-Islam alt-right group,1,3,6,42,4,9,0,48,0
If Disney Princesses Were From Florida,1,1,6,27,0,5,0,33,0
Here Are All The Backstage Celebrity Pictures From The 2016 BAFTAs,1,1,14,38,0,10,4,52,0
14 Beautifully Weird Spider-Man Vines That'll Make You Question Your Existence,1,1,11,53,2,10,2,64,0
10 Reasons Peter Gabriel's 'Solsbury Hill' Is One of the Greatest Songs of All Time,1,3,11,53,3,14,2,64,0
Harvard Law School is making a major change to its admissions policy,1,3,3,54,0,11,0,57,0
French Montana Wearing Slippers On The Beach Will Make You Feel Uncomfortable,1,1,12,54,0,11,0,66,0
Iraq 'witch hunt' lawyer Phil Shiner could avoid paying debts,1,3,3,47,2,9,0,50,0
"17 Times ""Steven Universe"" Won Over Our Hearts In 2015",1,1,8,29,2,9,6,37,0
15 Gorgeous London-Inspired Tattoos You'll Absolutely Love,1,1,7,41,2,6,2,48,0
Can We Guess How Much Water You Drank In 2015,1,1,9,23,0,9,4,32,0
Brexit: Supreme Court judges to deliver verdict on Theresa May's plans for EU withdrawal,1,2,7,66,2,13,0,73,0
The 17 cheapest holiday destinations outside of Europe in 2017,1,3,2,45,0,9,6,47,0
11 Arts And Crafts Projects That Prove Mason And Penelope Disick Are Creative Geniuses,1,1,13,58,0,13,2,71,0
27 Things Everyone Hates With A Passion But Would Never Admit,1,3,10,39,0,10,2,49,0
Who Said It: Daenerys Targaryen Or Cersei Lannister,1,1,8,35,1,7,0,43,0
Democrats Target Nunes After He Reveals Trump Transition Team Was Surveilled,1,2,11,55,0,10,0,66,0
How Would The Universe Change If We Grew An Extra Dimension?,1,3,11,38,1,10,0,49,0
'Clean Sleeping' Is Expected To Be The Biggest Health Rage Of 2017,1,2,11,38,2,11,4,49,0
Berlin attack: So-called Islamic State claims responsibility,1,3,4,48,2,6,0,52,0
These 9 Women Are Wearing Exactly What They've Been Told Not To And It's Totally Awesome,1,1,15,55,2,15,1,70,0
How I regularly book round-trip international flights for less than $400,1,2,2,55,2,10,3,57,0
"Nicki Minaj Would Like The Media To Know That Yes, Actually, She Can Smile",1,1,14,45,2,13,0,59,0
24 Pictures That Prove 2015 Is The Damn Future,1,1,7,25,0,8,6,32,0
"17 Things Zac Efron Wore In ""High School Musical"" Ranked",1,1,9,34,2,9,2,43,0
How Much Did You Accomplish In 2015,1,1,6,19,0,6,4,25,0
22 Questions You'll Have Asked Yourself If You Always Stay Up Late,1,1,11,41,1,11,2,52,0
47 Lazy-Girl Beauty Hacks Everyone Should Know,1,1,7,30,1,6,2,37,0
One of the most powerful women in finance gives her career advice to young Wall Streeters,1,2,3,71,0,15,0,74,0
6 Celebrities Who Have Embraced Donald Trump as Our President [Video],1,3,9,47,2,10,1,56,0
Saying 'I don't': The case for not getting married,1,3,3,35,4,8,0,38,0
14 Times Tumblr Was A Little Too Accurate About The Hogwarts Houses,1,1,11,43,0,11,2,54,0
Here are all the companies that have cut ties with the Trump family,1,3,2,53,0,12,0,55,0
Grocery Store Fried Chicken Taste Test,1,1,6,27,0,5,0,33,0
Can You Pass This Basic Trigonometry Quiz,1,1,7,28,0,6,0,35,0
"Just because your kids are headed off to college, it doesn’t mean they’ll graduate",1,2,1,65,3,13,0,66,0
All The Best Deals On Amazon Today,1,3,7,21,0,6,0,28,0
‘The smell of death was everywhere’: Inside the world’s most dangerous mines,1,3,2,59,4,11,0,61,0
Former Gitmo Detainee Charged with Assault in Australia,1,2,6,42,0,7,0,48,0
Hong Kong Seaside Mansion Bought for Estimated $86 Million,1,3,7,40,1,8,2,47,0
"21 Times ""Hocus Pocus"" Perfectly Described Being Single BFFs",1,1,10,38,2,8,2,48,0
"NASA launches ‘flying saucer’ test flight, suffers chute snafu  ",1,2,4,47,3,10,0,51,0
18 Sales That Are Almost Too Good To Be True,1,1,9,24,0,9,2,33,0
"Mom thought newborn had cold, then she noticed signs of something more serious",1,3,1,64,1,12,0,65,0
What's One Literary Magazine Everyone Needs In Their Life,1,1,9,39,1,8,0,48,0
28 Things You Won't Believe Are Turning 20 In 2016,1,1,7,25,1,9,8,32,0
Hottest Spring New-Car Lease Deals Under $200 A Month,1,3,9,31,2,8,3,40,0
"Govt Doesn't Care About Cash Crunch, Raises Fuel Prices + 5 Other Major Reads From Today",1,3,14,55,3,15,1,69,0
Watch: Spicer Asked How It Feels ‘To Work for a Fascist?’ In Apple Store,1,3,12,43,4,13,0,55,0
Watch These Gay Men Give Lesbians Wardrobe Makeovers,1,1,8,37,0,7,0,45,0
34 Disturbing Photos From SantaCon That Will Ruin Your Christmas,1,1,10,43,0,9,2,53,0
DIY Pore-Cleansing Egg White Face Mask,1,1,9,23,1,5,0,32,0
"Psychics, witches and pagans: What do people get out of alternative spirituality?",1,3,2,65,3,11,0,67,0
People Had Their Minds Read By A Mentalist And It Was Batshit Insane,1,1,13,43,0,12,0,56,0
How Women Modernized The Disney Princess,1,3,6,29,0,5,0,35,0
Why Betterment Added A Human Touch To Its Roboadvisor Tool,1,3,10,39,0,9,0,49,0
The World’s Oldest Bank Is Stuck With Beautiful Tuscan Villas It Can’t Sell,1,3,13,48,2,12,0,61,0
Ohio Anti-fracking Organizer Gets Jail for Voter Registration Fraud,1,2,8,50,1,8,0,58,0
Can You Identify These Pop Artists By An Anagram Of Their Name,1,1,12,39,0,11,0,51,0
We Know If You're A Lipstick Or A Lip Gloss Fan,1,1,11,25,1,10,0,36,0
Russell Westbrook Gives Great Response to Reporter Who Asked About Stats Following Playoff Loss,1,3,13,69,0,13,0,82,0
Africa's week in pictures: 21-27 April 2017,1,3,2,24,3,6,8,26,0
18 Throwback Fairy Winkles Toys Only '90s Kids Will Remember,1,1,8,38,1,9,4,46,0
15 Totally Wild Confessions About Sex Tapes,1,1,6,29,0,6,2,35,0
See the Reactions to Chris Brown's Appearance on 'Black-ish',1,2,6,42,4,8,0,48,0
Word of the Day: Cory Booker explains 'freedom' to Bert,1,3,5,38,3,9,0,43,0
21 Things Everyone Who Wears Uggs In 2016 Will Relate To,1,1,9,31,0,10,6,40,0
People With Disabilities Make Fun Of Donald Trump,1,1,8,34,0,7,0,42,0
Are You More Like Ina Garten Or Giada De Laurentiis,1,1,10,32,0,9,0,42,0
7 Of The Craziest Science Studies That Won At The Ig Nobel Awards,1,1,12,40,0,12,1,52,0
So What’s in This Year’s Oscars Swag Bag?,1,3,7,24,3,7,0,31,0
"American Pharoah Lands on Sports Illustrated Cover, and It's Incredible",1,3,8,52,2,9,0,60,0
27 Animals Hilariously Embodied What It Means To Be Human,1,1,9,37,0,9,2,46,0
"These Horrifyingly Satisfying Photos Of ""Baby Foot"" Will Haunt You",1,1,10,45,2,9,0,55,0
Immigrant Accused of Child Rape Disappears after Posting Bond,1,2,7,46,0,8,0,53,0
"Apple kicked off WWDC with Bill Hader, drones and at least one goat",1,3,7,47,1,12,0,54,0
Dem Sen Menendez: Trump ‘Great Wall of Hate’ a Waste of $20 Billion,1,3,9,40,4,12,2,49,0
Brie Larson Says Her Reaction To Casey Affleck Winning An Oscar 'Speaks For Itself',1,3,14,54,2,13,0,68,0
"At UN, Nikki Haley Has Become the Conscience of the Trump Administration",1,3,10,50,1,11,0,60,0
21 Black People Give Their Best Advice For Taking Care Of Your Mental Health,1,1,13,48,0,13,2,61,0
"Are You More Like Howard Or Raj From ""The Big Bang Theory""",1,1,12,33,2,11,0,45,0
"Suzanne Collins Wrote A Touching Letter Saying Goodbye To The ""Hunger Games"" Series",1,1,13,56,2,12,0,69,0
So many questions: Hilarious photos from around the world capture people in VERY puzzling scenarios,1,2,6,78,1,14,0,84,0
We Surprised Celebs With Mistletoe And Here's What Happened,1,1,9,41,1,8,0,50,0
"No Additional Episodes Of ""Making A Murderer"" Have Been Made Yet",1,1,11,41,2,10,0,52,0
Are You More DJ Khaled Or Miranda Sings,1,1,9,23,0,7,0,32,0
It Took Exactly 15 Minutes For This Female Politician To Be Asked Why She’s Childless,1,3,14,54,1,14,2,68,0
Everything You Need to Know About the International Women's Strike on March 8,1,3,9,54,1,12,1,63,0
Bionic Leaf Makes Fertilizer From Sunlight And Air,1,3,8,35,0,7,0,43,0
Is This the Swiss Watch Industry’s Great Digital Disrupter?,1,2,8,41,2,8,0,49,0
This Is What Actually Makes You Sleepy At Thanksgiving Dinner,1,1,10,42,0,9,0,52,0
17 Vines That Prove Mashups Should Never Be Longer Than Six Seconds,1,1,11,43,0,11,2,54,0
This Is What 100 Years Of Girls' Fashion Looks Like,1,1,9,29,1,9,3,38,0
OMG The Middle Finger Emoji Has Arrived And Here's How To Get It,1,1,15,36,1,12,0,51,0
"Reality? No, Thanks. Moviegoers Sought Escape in 2016. ",1,3,6,33,4,8,4,39,0
2017 Summer Movie Preview: 40 Must-See Films (With Exclusive Photos!),1,3,9,40,5,9,6,49,0
Can You Spell The Name Of This Welsh Village,1,1,9,27,0,8,0,36,0
Women Found Freedom Going Braless For An Entire Week,1,1,9,35,0,8,0,44,0
Jacob Tremblay's Dad Is Dad AF,1,1,7,17,1,5,0,24,0
38 Gorgeous Quotes From Literature That Might Help You Cope With Your Depression,1,1,12,54,0,12,2,66,0
Daring People Try Daring Shots,1,1,5,21,0,4,0,26,0
Waterfall Wedding Proposal Goes Horribly Wrong,1,3,6,35,0,5,0,41,0
All the news from Apple's WWDC 2015 Keynote,1,2,7,24,1,7,4,31,0
23 Cheap and Easy Hacks For the Best Bath Ever,1,1,7,28,0,9,2,35,0
Lesbians Watched And Critiqued Lesbian Porn And It Was Traumatic,1,1,10,45,0,9,0,55,0
"FYI, There's A Man In Kolkata Who Supplies America With Drugs To Execute Criminals",1,1,16,51,2,13,0,67,0
The Ridiculously Simple Way to Save Money: Envelopes,1,3,7,37,1,7,0,44,0
Here’s What Happens If You Take The Morning-After Pill All The Time,1,3,13,41,2,11,0,54,0
Little Boy Accidentally Tells His Mom What Every Parent Needs To Hear (But Never Does),1,2,15,55,2,14,0,70,0
What Do You Wish You'd Known About Breast Cancer Before Being Diagnosed,1,1,12,47,1,11,0,59,0
"'Ugliness And Handicap' Are Reasons Behind Higher Dowry, Teaches Maharashtra School Textbook",1,2,12,66,3,11,0,78,0
Who Had the Best Tour of 2016? Vote!,1,3,5,18,2,7,4,23,0
Trainspotting: Then Vs Now,1,1,4,18,1,3,0,22,0
This Is How Much You Should Be Paying Your Babysitter Now,1,3,11,36,0,10,0,47,0
21 Times In 2015 Neil Patrick Harris's Family Was Cuter Than Yours,1,1,10,38,1,11,6,48,0
Brits Respond To Questions From Australians,1,1,6,32,0,5,0,38,0
22 Things That Happen When You Date A 6-Foot-Something Man,1,1,10,34,2,9,3,44,0
People Try Rainbow Doritos,1,1,4,19,0,3,0,23,0
"How Would You Die On ""Scream Queens""",1,1,7,21,2,6,0,28,0
What the F*ck Is Going On in This New Pepsi Ad Starring Kendall Jenner?,1,3,12,44,2,13,0,56,0
Former Gitmo Detainee Charged with Assault in Australia,1,3,6,42,0,7,0,48,0
17 People Who Get That Texting Is Actually The Worst Thing Ever,1,1,11,39,0,11,2,50,0
"Floyd Mayweather: Fight with Conor McGregor 'getting very, very close'",1,3,6,51,4,9,0,57,0
30 Under 30 2017: Youngest,1,3,2,11,1,4,8,13,0
The 45 Funniest Tweets From 2015,1,1,4,17,0,5,6,21,0
23 Crucial Items Every Die-Hard Tailgater Needs,1,1,7,31,1,6,2,38,0
A small Arkansas town has its first murder suspect in decades. He’s 12.,1,3,3,51,3,12,2,54,0
17 Stunning Men With Eyeliner Better Than Yours,1,1,7,31,0,7,2,38,0
"Which OTP From ""Scream Queens"" Is The Best",1,1,10,23,2,7,0,33,0
"Fred Armisen Did Southern Accents On ""The Tonight Show"" And It Was Impressive",1,1,13,50,2,12,0,63,0
This Married Couple Had An Honest Discussion About Their Relationship And Their Very Real Age Difference,1,1,16,73,0,15,0,89,0
The 21 Greatest Raccoons Of 2015,1,1,4,17,0,5,6,21,0
Here's How Quantum Computing Will Change The World,1,2,8,34,1,7,0,42,0
Sears has a bigger problem than plunging sales â but nobody's talking about it,1,3,1,63,3,13,0,64,0
Couple announces pregnancy in a perfect Bob Ross-inspired way,1,3,3,49,1,8,0,52,0
Most diverse place in America? It's not where you think,1,3,3,41,2,9,0,44,0
He was almost killed in Afghanistan. Now he’s been painted by the president who sent him there.,1,3,3,73,3,16,0,76,0
16 Stories That Prove 2016 Wasn’t The Absolute Worst,1,2,7,30,1,8,6,37,0
This car promises to be fully electric and drive itself. Will that be enough?,1,3,2,60,2,13,0,62,0
'Homeland' Season 6 trailer definitely hits a little too close to home,1,2,2,54,2,11,1,56,0
19 Adorably Cute Couples On The Emmys Red Carpet,1,1,8,30,0,8,2,38,0
There was something about Mary: She changed TV forever,1,3,5,40,1,8,0,45,0
"Your Perfect End-Of-Summer Mix Is Here, From DJ A-Trak",1,1,13,29,4,8,0,42,0
9 cooking projects that will please a crowd — or just you,1,2,0,44,1,11,1,44,0
25 Super Last-Minute Halloween Costumes That Will Blow People's Minds,1,1,10,46,2,9,2,56,0
It’s Official! Donald Trump Speaking at CPAC,1,3,9,27,2,6,0,36,0
"The New ""Being Canadian"" Movie Is Hilariously Honest",1,1,8,35,2,7,0,43,0
43 Of The Most Stunning Red-Carpet Looks Of 2015,1,1,8,25,1,8,6,33,0
Can You Guess What These Dogs Are Looking At?,1,2,9,27,1,8,0,36,0
Happy Feet: Gumboot dancing used to educate children,1,3,3,41,1,7,0,44,0
Hot Men Taking Their Shirts Off And Then Putting Them Back On,1,1,12,38,0,11,0,50,0
British Blue Chips Snub Investor Calls to Show CEO Pay Ratio,1,2,12,38,0,10,0,50,0
"Yep, Lyft gained users from #DeleteUber, and we now know how many",1,2,4,47,3,11,0,51,0
This anti-Trump site snagged a unique domain name,1,3,2,39,1,7,0,41,0
19 Insane Pizza Mashups That Are Delicious AF,1,1,8,28,0,7,2,36,0
Here's What Your Favourite Fall Out Boy Album Says About You,1,1,11,38,1,10,0,49,0
How Successful People Spend Their Weekends,1,2,6,31,0,5,0,37,0
This Pattern Quiz Will Determine Your Social Behavior,1,1,8,38,0,7,0,46,0
We Know Who You Should Date Based On Your Netflix Choices,1,1,11,36,0,10,0,47,0
11 Bowls Of Oatmeal That Will Change Your Breakfast Forever,1,1,9,39,0,9,2,48,0
Adidas offers island to any NFL prospect who breaks record for fastest 40-yard dash,1,3,4,63,1,13,2,67,0
Women With Acne Get Incredible Makeup Transformations,1,1,7,40,0,6,0,47,0
"Report: Evidence of Detroit Voter Fraud, Too Many Votes in 37% of Precincts",1,3,9,49,3,12,2,58,0
Elizabeth Banks tapping Red Queen for vein of inspiration,1,3,4,45,0,8,0,49,0
19 Weird AF Questions That Actually Kinda Make Sense,1,3,9,33,0,8,2,42,0
Can You Guess Which Makeup Product Is The Most Expensive,1,1,10,37,0,9,0,47,0
Counter-Terror Police on Site After Several Injured in French School Shooting,1,3,10,56,1,10,0,66,0
Fan Grabs Foul Ball Barehanded While Wearing a GoPro,1,2,9,35,0,8,0,44,0
"Blowing Up ""The Leftovers""",1,1,4,17,2,3,0,21,0
This Bride Baked A Life-Sized Wedding Cake Of Herself And Her Groom,1,1,13,42,1,11,0,55,0
10 People Who Lost 50+ Pounds Share Their Best Tips For Getting Started,1,1,11,43,1,12,4,54,0
Vanessa Hudgens Shared A Heartbreaking Photo Of Her Father's Grave,1,1,10,46,1,9,0,56,0
This Sikh Man's Tweet After The Paris Terror Attacks Captured What Religion Should Be About,1,1,15,61,1,14,0,76,0
We Asked A Married Couple To Try Each Other's Hobbies And This Is What Happened,1,1,15,49,1,14,0,64,0
Do You Know Your GF By Touch,1,1,8,14,0,6,0,22,0
Watch — Dying Marine to Trump and General Mattis: ‘Give ‘Em Hell’,1,3,9,40,5,11,0,49,0
Which Fictional Couple Are You And Your Partner,1,1,8,32,0,7,0,40,0
15 Gifts Your Coolest Friend Will Truly Appreciate,1,1,7,34,0,7,2,41,0
"The First Trailer For ""Captain America: Civil War"" Is Finally Here To Destroy You",1,1,14,51,3,13,0,65,0
15 Delicious Ways To Make Your Favorite Candy Even Better,1,1,9,37,0,9,2,46,0
This Couple Is Proof That Not All Anonymous Commenters Are Terrible People,1,1,12,51,0,11,0,63,0
14 Times Orin From Parks And Rec Perfectly Summed Up Your Inner Darkness,1,3,12,46,0,12,2,58,0
This Is Amber Rose's World And We're Lucky To Be Living In It,1,1,13,34,2,12,0,47,0
Here's How To Tell A Friend They're Not Going To Be A Bridesmaid,1,1,13,37,2,12,0,50,0
Russia's 'Humpty Dumpty' hackers: What were they trying to do?,1,3,4,44,5,9,0,48,0
Truck blown over by powerful gust of wind in US,1,3,3,35,0,9,0,38,0
These are the 20 best-selling books of the year,1,2,1,35,1,8,2,36,0
17 Disney Accessories You'll Want Immediately,1,1,5,32,1,5,2,37,0
"After Richmond Park, here are 10 seats Remainers may hope to take from Tory Brexiteers",1,3,6,63,1,14,2,69,0
Can You Guess The One Direction Music Video By Its YouTube Comment,1,1,13,42,0,11,0,55,0
This company wants you to bring your dog to work,1,3,1,38,0,9,0,39,0
3 Toxic Types Of Friends You Should Get Rid Of,1,1,9,27,0,9,1,36,0
Iraqi Kurdish fashionistas make a splash,1,3,2,33,0,5,0,35,0
Ten Questionable Federal Gov’t Expenditures Greater Than Trump’s Border Wall,1,3,10,55,2,9,0,65,0
17 Ridiculous Texts All Siblings Have Sent To Each Other,1,1,9,36,0,9,2,45,0
Yankees' Mason Williams Hits Monster HR for 1st Career Major League Hit,1,2,11,47,1,11,1,58,0
The Definitive Ranking Of Dudes Who Deserve Tina Belcher's Love,1,1,10,43,1,9,0,53,0
Twilight of the Rock Gods,1,3,3,18,0,4,0,21,0
32 Times Scottish Twitter Was The Funniest Place On The Internet,1,1,10,42,0,10,2,52,0
We Know Your Age And Favorite Pizza Based On A Single Question,1,1,12,39,0,11,0,51,0
Which Disney Valentine's Day Card Should You Give To Your Bae,1,1,11,39,1,10,0,50,0
9 iPhone tricks that will make your life easier in 2017,1,3,1,39,0,10,5,40,0
23 Pictures That Will Devastate Anyone Who Loves Food,1,1,8,35,0,8,2,43,0
"Who Is Actually The Best ""Jessica Jones"" Character",1,1,8,33,2,7,0,41,0
Crash victim miraculously survives after a STEEL POLE speared through his chest in horrific road accident,1,2,10,80,0,15,0,90,0
Which Rap Artist Are You Based On Your Zodiac Sign,1,1,10,31,0,9,0,41,0
We Know What Type Of Wine You Like To Drink During The Day,1,1,13,33,0,12,0,46,0
"I Rewatched ""Charlie's Angels"" With My Middle School Best Friends 15 Years Later",1,1,12,51,3,12,2,63,0
22 Things That Seemed Cool As A Kid That Actually Suck As An Adult,1,1,13,38,0,13,2,51,0
18 Gloriously Cringeworthy Things All '00s Girls Did To Their Hair,1,1,9,42,1,10,4,51,0
14 Struggles Every Person Who's The Last Of Their Friends To Get Married Has,1,1,13,47,1,13,2,60,0
"Which ""Team Fortress 2"" Character Are You",1,1,6,26,2,6,1,32,0
This Woman Is Taking A Stand Against People Who Say Mental Illness Is Fake,1,1,14,47,0,13,0,61,0
Which Disney Song Are You Based On Your Zodiac Sign,1,1,10,32,0,9,0,42,0
Lady Gaga posts photo of new Metallica 'tattoo' ahead of Grammy Awards performance,1,2,5,63,2,12,0,68,0
Have you been affected by combat stress?,1,3,1,32,1,6,0,33,0
2017 NBA Power Rankings: Post-Trade Deadline Standings for All 30 Teams,1,3,11,42,2,10,6,53,0
Viola Davis's Daughter Dressed Up As Her Mom For Halloween,1,1,10,38,1,9,0,48,0
40 Celebrity Pixie Cuts So Good You'll Want to Go for It,1,2,9,33,1,11,2,42,0
Man with rifle arrested at DC restaurant targeted by fake news conspiracy theories ,1,3,3,67,0,13,0,70,0
Don't Mess With Arnold Schwarzenegger! Troll Mocking Special Olympics Gets Destroyed On Social Media,1,3,14,71,2,13,0,85,0
Of Course Nicki Minaj's Ex Safaree Has Something to Say About Remy Ma's Diss Track,1,3,14,52,2,14,0,66,0
"This ASL Interpretation Of Adele's ""Hello"" Is Heartbreakingly Gorgeous",1,1,11,48,3,8,0,59,0
For Everyone Who Hates The Red Cups Because They're Not Filled With Dunkin Donuts,1,1,14,53,1,13,0,67,0
Shocking New Details Emerge in Aaron Hernandez's Double Murder Trial,1,2,9,49,1,9,0,58,0
Are You More Country Mouse Or City Mouse,1,1,8,25,0,7,0,33,0
#CyborgTrumpProblems Aims To Find Donald Trump's Major Malfunction,1,2,10,47,2,7,0,57,0
23 Profoundly Disturbing Photos Of Homemade Sex Machines In America,1,1,9,47,0,9,2,56,0
"Female cockroaches can reproduce for years without needing a male, scientists find",1,3,1,69,1,11,0,70,0
"How Well Do You Remember ""Coming To America""",1,1,8,27,2,7,0,35,0
This Oreo Popcorn Is The Movie Snack You Need Right Now,1,1,11,34,0,10,0,45,0
The Rock Rescued His Adorable New Puppy On Labor Day,1,1,10,33,0,9,0,43,0
Where's The Best Family-Friendly Vacation Spot,1,1,7,32,2,5,0,39,0
"Meet Alice In Wonderland's Daughter On Disney's ""Descendants: Wicked World""",1,1,10,51,5,9,0,61,0
Which Male Rapper Is Your Soulmate Based On Your Zodiac Sign,1,1,11,39,0,10,0,50,0
15 Awards For Anyone Who Definitely Has What's Going Around,1,1,9,38,1,9,2,47,0
Can You Match The Quote To The '90s Rom-Com,1,1,9,22,2,8,2,31,0
Assaults on Border Patrol Agents Continue – 3 in Day,1,3,6,35,1,9,1,41,0
That's What He Said: Steve Carell Just Trolled 'Office' Fans Bad,1,3,11,39,4,10,0,50,0
53 Important Questions The Internet Has About Spiders And Snakes,1,1,9,44,0,9,2,53,0
Zayn Malik Has Bleached His Hair Again And Grown A Big Beard,1,1,12,37,0,11,0,49,0
"17 People Who Seriously Misunderstood The Meaning Of ""Netflix And Chill""",1,1,10,48,2,10,2,58,0
27 Unique And Fun Date Ideas You’ll Wish You Thought Of First,1,2,11,36,1,11,2,47,0
There's Something Called A Racoon Dog And A Guy In Japan Has One,1,1,13,38,1,12,0,51,0
Minor leaguer Buddy Baumann gets unfortunate haircut after losing a bet,1,3,3,58,0,10,0,61,0
Japanese Women Try On Geisha Halloween Costumes,1,1,7,34,0,6,0,41,0
Ted Cruz: Dems Suffer From ‘Trump Derangement Syndrome’,1,3,8,37,3,7,0,45,0
Which TV Mom Should Be Your Mom,1,1,8,17,0,6,0,25,0
The Koch brothers and the Republican Party go to war — with each other,1,3,4,52,1,13,0,56,0
21 People Who Really Know What Life Is All About,1,1,9,28,0,9,2,37,0
'90s TV Shows Reimagined As Nickelodeon Cartoons,1,1,7,32,1,6,2,39,0
‘Maduro Diet’: 3 Out of 4 Venezuelans Lost ‘At Least 19 Pounds’ in 2016,1,2,8,37,5,13,8,45,0
Meet the Baby Born at a Pennsylvania Car Dealership,1,2,6,37,0,8,0,43,0
We Tried To Stop Using Exclamation Points And It Was So Hard,1,1,12,37,0,11,0,49,0
Drake Shared A Sweet Instagram Post Thanking Rihanna For His Only No. 1 Songs,1,1,13,49,1,13,1,62,0
Literally Just 19 Photos Of Dev Patel And Sunny Pawar Being Adorable,1,3,11,44,0,11,2,55,0
19 Signs You're Finally Becoming An Adult,1,1,6,26,1,6,2,32,0
Can You Identify The Kesha Music Video By A Screencap,1,1,10,34,0,9,0,44,0
"17 ""Family Feud"" Answers That Will Never Stop Being Funny",1,1,9,35,2,9,2,44,0
The embarrassing reason behind Amazon’s huge cloud computing outage this week,1,3,2,64,1,10,0,66,0
"Artificial intelligence has a big year ahead, well beyond tech",1,3,1,51,1,9,0,52,0
Obama Warns of ‘Tribalism’ At Pearl Harbor: ‘Resist the Urge to Demonize Those Who Are Different’,1,3,13,64,5,15,0,77,0
Watch an Artist Carve a Hotel Suite Out of Ice in One Minute,1,3,9,39,0,12,0,48,0
Developers tell Facebook: This is how you fight fake news,1,3,3,44,1,9,0,47,0
A Universe of Bubbles in Every Champagne Bottle ,1,3,6,34,0,8,0,40,0
The Dress Is Now Officially A Sexy Halloween Costume,1,1,9,35,0,8,0,44,0
22 Of The Most Disgusting Things People Have Actually Put In Their Mouths,1,1,12,47,0,12,2,59,0
The $1 Accessory Michelle Williams and Sienna Miller Rocked on the Golden Globes Red Carpet,1,2,11,64,1,14,1,75,0
Here's what happens when you stick a Galaxy S8 in a Unicorn Frappuccino and drop it from 100 feet,1,3,5,69,1,18,4,74,0
The 38 Most Awkward Cats Of 2015,1,1,5,15,0,6,6,20,0
Can We Guess Your Age And Where You're From,1,1,9,25,1,8,0,34,0
21 Spectacular Places All People Who Love Fall Colors Must Visit,1,1,10,42,0,10,2,52,0
Free Wine Fountains and Other Bold Ways Wine Will Change in 2017,1,3,9,40,0,11,4,49,0
Which Leonardo DiCaprio Character Is Your Soulmate,1,1,8,36,0,6,0,44,0
Disney Parodies The Biggest Movies Of 2015 In A Series Of Cute Film Posters,1,1,13,45,0,13,4,58,0
These Women Bikini Waxed Their Boyfriends To Give Them A Taste Of Womanhood,1,1,13,50,0,12,0,63,0
"27 Moments ""How I Met Your Mother"" Fans Will Never Forget",1,1,10,33,2,10,2,43,0
This Stuffed Bhurji Pav Is Here To Up Your Breakfast Game,1,1,11,36,0,10,0,47,0
Nick Offerman And Megan Mullally Are Really Into Puzzles And It's Totally Adorable,1,1,13,56,1,12,0,69,0
If Disney Voices Looked Like Their Characters,1,1,7,32,0,6,0,39,0
19 Scrumptious Thanksgiving Casseroles Guaranteed To Impress Your Guests,1,1,8,54,0,8,2,62,0
Nicole Scherzinger Is Your New Katniss Everdeen,1,3,7,34,0,6,0,41,0
Now is the the worst time to buy a new laptop,1,2,1,34,0,10,0,35,0
Which Wes Anderson Character Are You,1,1,6,25,0,5,0,31,0
We Know Whether Or Not You're A Nerd,1,1,8,20,1,7,0,28,0
New Photos Of Mysterious Bright Spots On Ceres Are The Sharpest Yet,1,3,12,44,0,11,0,56,0
Can You Actually See The Difference Between Black And Blue,1,1,10,39,0,9,0,49,0
Rapper Who Burned Donald Trump Mask Arrested in Connection with Violent Home Invasion,1,2,11,62,0,12,0,73,0
"Blame wages and turtle doves: '12 Days' now costs $34,363",1,3,2,34,5,9,7,36,0
24 Hilarious Tweets That Perfectly Capture Your Existential Despair,1,1,8,49,0,8,2,57,0
"Can You Remember The First Episode Of ""Full House""",1,1,9,31,2,8,0,40,0
A Teenager And A Porn Star With The Same Name Confused Twitter,1,1,12,39,0,11,0,51,0
Can We Guess Your Ex-Boyfriend's Name With Three Questions,1,1,10,38,2,8,0,48,0
"21 Gifts Every ""Back To The Future"" Fan Will Own In The Future",1,1,12,34,2,12,2,46,0
15 Super Bowl Snacks Worth Feasting On,1,1,6,24,0,6,2,30,0
What Really Happened To Your Favorite Band,1,1,7,29,0,6,0,36,0
Which Member Of Girls Aloud Are You,1,1,7,22,0,6,0,29,0
"The most ambitious, irritating, hopeful and overrated books of 2016 — and the best one, too",1,2,1,67,4,15,4,68,0
"Stop Pitting Them Against Each Other, All's Well Between 'Raees' SRK And 'Kaabil' Hrithik!",1,3,16,54,7,13,0,70,0
"A top NATO general echoes Trump, calling aspects of alliance ‘obsolete’",1,2,6,52,3,10,0,58,0
How Well Do You Actually Know The US States?,1,2,10,25,1,8,0,35,0
You Need To Try This Bagel Grilled Cheese Immediately,1,1,9,36,0,8,0,45,0
How to make sure your startup doesn't destroy your personal life,1,3,1,52,1,10,0,53,0
"This Band Just Slayed Their Cover Of Justin Bieber's ""Sorry""",1,1,10,38,3,9,0,48,0
Here's A Bunch Of Women Honestly Discussing Their Sexting Habits,1,1,10,44,1,9,0,54,0
"While We're Obsessing Over Weddings, Let's Learn To Talk About Marriages Too",1,1,12,50,3,11,0,62,0
For Everyone Whose Sexual Awakening Was Caused By Johnny Depp,1,1,10,42,0,9,0,52,0
People who’ve had multiple marriages confess how they REALLY feel about their divorces,1,3,7,66,1,12,0,73,0
"Ned Ryun: Trump Knows Media Will Hate Him Anyway, ‘So Why Not Go Big?’",1,2,14,38,5,13,0,52,0
A judge reveals an easy way to protect yourself if you loan a friend money,1,3,1,59,0,14,0,60,0
27 Of The Best Responses For When Random Guys Tell You To Smile,1,1,12,37,0,12,2,49,0
"If You Aren't Already Terrified Of Pigeons, This Video Will Get You There",1,1,13,46,2,12,0,59,0
Android malware: 38 new phones and tablets found to be pre-installed with virus before being sold,1,3,1,77,2,15,2,78,0
Indian Women Open Up About Their First Times Being Harassed In Public,1,1,12,46,0,11,0,58,0
6 ways to push your online activism into the real world in the Trump era,1,3,1,56,0,14,1,57,0
21 Amazing Cocktails For Anyone Who Loves Citrus,1,1,7,32,0,7,2,39,0
7 Easy Dinners To Make This Week,1,1,6,19,0,6,1,25,0
Kurtz: ‘Establishment Media’ Hyperventilation Over Trump Selection of Press Conference Questioners ‘Whiny’,1,3,11,79,5,11,0,90,0
34 Hilarious Nicknames Chinese People Have Given Celebrities,1,1,7,44,0,7,2,51,0
Parenting For Idiots: celebs' boring baby stories may remind you of your own,1,3,3,59,2,12,0,62,0
You Should Be Making Cheese In The Microwave,1,1,8,29,0,7,0,37,0
Cartel-linked Mexican Border Governor Booted from Political Party,1,3,7,50,1,7,0,57,0
Can You Guess Which City Enters The New Year First,1,1,10,31,0,9,0,41,0
11 Times Ruby Rose Changed The MTV EMAs Game,1,1,12,22,0,8,2,34,0
Everything You Need To Know About McDonald's New Chocolate-Covered French Fries,1,1,13,54,2,10,0,67,0
People Keep Making Huge Facebook Chats With People With The Same Name,1,1,12,46,0,11,0,58,0
17 Impossibly Easy Kitchen DIYs That Only Look Expensive,1,1,10,36,0,8,2,46,0
Which Disney Villain Are You Based On These Questions About Disney Movies,1,1,12,50,0,11,0,62,0
23 Places You Won't Believe Are In England,1,1,7,25,1,7,2,32,0
What's The Best Mary-Kate And Ashley Movie Of All Time,1,1,11,32,2,9,0,43,0
"39 Things You Probably Didn't Know About The ""Back To The Future"" Trilogy",1,1,12,44,3,12,2,56,0
This $200 AI Will End Tennis Club Screaming Matches,1,2,9,30,1,8,3,39,0
These Are The Craziest Stories Of Past Lottery Winners,1,1,9,37,0,8,0,46,0
How Well Do You Really See Different Shades Of Red,1,1,10,31,0,9,0,41,0
Amazon's New Credit Card Primed To Disrupt Retail,1,3,8,33,1,7,0,41,0
Canadian Cops Are Giving Out The Most Dad Winter Driving Advice On Facebook,1,1,13,50,0,12,0,63,0
Would You Survive A Day In The Life Of A '90s Kid,1,1,11,24,1,11,2,35,0
What Celebrities Have The Same Zodiac Sign As You,1,1,9,32,0,8,0,41,0
Someone just pointed out exactly why Theresa May should be scared of an election The list,1,3,4,70,0,15,0,74,0
Adults Guess Crayola Crayon Color Names,1,1,6,28,0,5,0,34,0
Don't Know If You Should Get The New iPhone? Take This Quiz,1,1,12,34,2,11,0,46,0
9 Gross Things To Never Do In Front Of Your Man,1,1,10,26,0,10,1,36,0
This Color Test Will Determine Your Guilty Pleasure,1,1,8,36,0,7,0,44,0
"Everything You Wanted To Know About ""The Heroes: Reborn"" Cast",1,1,10,39,3,9,0,49,0
7 mega-billionaires who made a fortune last year,1,3,0,39,1,7,1,39,0
What Women Really Think of Men ,1,2,5,20,0,6,0,25,0
"Can't sleep? Insomniacs should try camping, say scientists",1,2,2,46,3,7,0,48,0
This Is What It's Like To Grow Up Looking Different Than Your Parents,1,1,13,43,1,12,0,56,0
"Afghanistan, Syria, Vin Diesel: Your Friday Briefing ",1,3,7,36,3,7,0,43,0
Miss Piggy And Kermit Can't Have A Business Meeting Without Drama,1,1,11,43,1,10,0,54,0
Here’s Who’s Winning (And Losing) At WrestleMania 33,1,2,8,31,4,7,2,39,0
32 Behind-The-Scenes Entertainment Features From 2015 That Deserve Another Look,1,1,10,52,2,9,6,62,0
39 Products That Will Help You Embrace Your Inner Cat Lady In 2016,1,1,11,37,0,12,6,48,0
Stephen A. Smith Jokes That Women's World Cup Players Don't Want To 'Mess Their Hair Up',1,2,16,52,5,15,0,68,0
Should Australians be able to opt out of Medicare? This professor thinks so,1,2,4,58,1,12,0,62,0
"Another Round, Episode 29: What's On Your Reparations Tab",1,1,8,36,3,8,2,44,0
"17 Images That Perfectly Sum Up Life In Really, Really Cold Weather",1,1,11,42,1,11,2,53,0
Madeleine Albright: Trump’s Message Should Not be ‘America First but America as a Partner’,1,3,10,63,4,13,0,73,0
What Crazy Bullshit Will Donald Trump Say Next,1,1,8,31,0,7,0,39,0
5 YA Books You Should Be Reading This January,1,1,9,27,0,8,1,36,0
"We Tried Animal Balls, Brains, Udders, And Tongues",1,1,8,32,3,7,0,40,0
One of Disney’s most popular brands has investors really worried,1,3,2,52,1,9,0,54,0
Riley Curry Makes Modeling Debuts And Is Absolutely Adorable,1,1,9,43,0,8,0,52,0
14 Ways To Be A Healthyish Eater Right Now,1,1,8,24,0,8,2,32,0
14 Pictures Everyone Who's Been To An Indian Wedding Will Recognise,1,1,10,44,1,10,2,54,0
Can We Guess Your Favorite Holiday With Questions About Food,1,1,10,41,0,9,0,51,0
Should You And Your SO Get A Puppy,1,1,9,18,0,7,0,27,0
Can You Help Me Find A Halloween Costume For My Son,1,1,11,30,0,10,0,41,0
The 2017 Oscars after parties – in pictures,1,3,2,29,1,7,4,31,0
Everyone Just Found Out That Denzel's Son Is Really Hot,1,1,10,35,1,9,0,45,0
Just Foolin’ Around: 7 Books From Comics and Humorists ,1,2,7,36,2,9,1,43,0
17 Dogs Who Are Really Pleased With Themselves,1,1,7,30,0,7,2,37,0
11 People Who Are So Fucking Wrong It's Not Even Funny,1,1,10,31,1,10,2,41,0
Can You Really Tell The Difference Between Elena Gilbert And Katherine Pierce,1,1,12,54,0,11,0,66,0
In Defense Of Oatmeal Raisin Cookies,1,1,6,25,0,5,0,31,0
"There Was A Mini ""Arrested Development"" Reunion At The SAG Awards",1,1,13,40,2,10,0,53,0
Brent Musburger: Olbermann Should Stick to Sports,1,3,6,36,1,6,0,42,0
8 Gross Things That Happen When You Share Beauty Products,1,3,9,38,0,9,1,47,0
Why I love… Michelle Obama,1,2,4,17,1,4,0,21,0
27 Stunning Photos of the Worlds Most Beautiful Places,1,3,6,38,0,8,2,44,0
Mystery man donates wedding dress with touching note about late wife ,1,2,1,57,0,11,0,58,0
8 Things You Need To Know About Gabriel Iglesias And His Weight Loss,1,1,12,43,0,12,1,55,0
Scientists Discover New Species Of Bat That's Actually Been In Their Collection Since 1983,1,1,13,59,1,13,4,72,0
17 Trends That Appeared At Literally Every Wedding In 2015,1,1,8,35,0,9,6,43,0
Hope for troops as antibiotics show they could be 'exciting new treatment' for PTSD,1,3,5,63,2,13,0,68,0
Here's the question the author of 'The 4-Hour Workweek' asks himself to keep from wasting time,1,3,4,70,4,15,1,74,0
"23 Times Tinder Actually Made You Say ""Awww""",1,1,7,26,2,7,2,33,0
Paris Hilton's Phone Case Is The Greatest Phone Case To Ever Protect A Phone,1,1,14,48,1,13,0,62,0
Counter-Terror Police on Site After Several Injured in French School Shooting,1,2,10,56,1,10,0,66,0
An Adorable Animals Advent Calendar: December 19,1,1,6,33,1,6,2,39,0
Which Kardashian/Jenner Should Be Your BFF,1,1,9,27,1,5,0,36,0
The Most Unique Looks at the 2017 Golden Globe Awards,1,2,7,33,0,9,4,40,0
Muslims Outnumber Christians in More than 30 Church Schools,1,3,6,43,0,8,2,49,0
"Adam Woodyatt Is Upset A #HowsAdam Moment Didn't Happen During The ""Corrie"" Live Episode",1,1,15,56,4,13,0,71,0
Do You Know Disneyland Rides' History,1,1,6,25,1,5,0,31,0
The 10 most unforgettable sports stories of 2016,1,3,1,34,0,7,6,35,0
The two ages you're happiest at The list,1,2,2,30,1,7,0,32,0
Good News for Irish Taxpayer May Be Bad News for Irish Investors,1,3,10,43,0,11,0,53,0
Animal Rights Activists Outraged as Micheal Bloomberg’s Daughter Dates Trophy Hunter,1,3,10,63,1,10,0,73,0
"2015 You're Great And I'ma Let You Finish, But 2006 Had The Best Music Of All Time",1,1,15,40,3,16,8,55,0
10 Promising Jobs In 2017 And The Skills You Need To Get Them,1,3,11,32,0,12,6,43,0
6 of the Craziest Things We Saw Go Down During Inauguration Weekend,1,3,9,46,0,11,1,55,0
17 Texts You'd Get If Drake Moved In With You,1,1,9,24,1,9,2,33,0
17 Weird Pizza Crusts That Are Actually Brilliant,1,1,7,33,0,7,2,40,0
The Definitive Ranking Of Nando's Food,1,1,6,26,1,5,0,32,0
Someone Please Teach The BBC How Tennis Works; They Keep Reporting Hingis Won Doubles Matches Alone,1,1,18,65,1,15,0,83,0
18 Tumblr Posts For Those That Need Their Faith In Humanity Restored,1,2,11,44,0,11,2,55,0
Disney's live-action Mulan finds its director in Niki Caro,1,3,4,44,2,8,0,48,0
"The One Mind-Blowing Detail You Missed In ""The Little Mermaid""",1,1,11,39,3,9,0,50,0
19 Things That Happen When You're A 20-Something High School Teacher,1,1,10,42,2,10,4,52,0
This woman was rejected from a job interview with a savage emoji message The list,1,3,2,65,0,14,0,67,0
"Roland Martin: Trump ‘Hoodwinked, Bamboozled’ White Working-Class Voters",1,2,9,51,5,7,0,60,0
The most powerful passports in the world,1,2,1,33,0,6,0,34,0
These Brave People Have Changed The Meaning Of Bath Time,1,3,10,37,0,9,0,47,0
City of London grapples with new EU shake-up,1,3,4,32,1,7,0,36,0
Who Are Your Guys,1,1,4,10,0,3,0,14,0
"You might not know it, but this Kiwi city is a total street art wonderland",1,3,2,57,1,14,0,59,0
"Game of Thrones season 7 actor talks release date, ‘something special happening for the premiere’",1,3,2,77,3,14,1,79,0
18 Texts Your Mom Definitely Sent You During College,1,1,8,34,0,8,2,42,0
26 Adorable Mugs To Give Your BFF,1,1,8,17,0,6,2,25,0
21 Things That Are Goddamn Disappointing Every Fucking Time,1,1,8,41,0,8,2,49,0
"TeradataVoice: How To Help Retirement Planners, Who Try, But Can't Help Themselves",1,2,13,54,4,11,0,67,0
Here's What Happened When English Footballer Harry Kane Labelled NFL Teams On A Map,1,1,16,53,1,13,0,69,0
These opening movie title sequences are pure masterpieces,1,3,1,49,0,7,0,50,0
19 Last-Minute Elf On The Shelf Ideas,1,1,7,21,1,6,2,28,0
Few good alternatives to Palestinian state,1,3,2,35,0,5,0,37,0
"Thousands Of People Are Sharing This ""Humans Of Bombay"" Post About A Child With A Rare Genetic Disorder",1,1,18,66,2,17,0,84,0
23 Things Teachers Actually Want For Christmas,1,1,6,32,0,6,2,38,0
This Dude Takes His Hamster For A Daily Walk With A Tiny Leash,1,1,13,37,0,12,0,50,0
29 Of The Most WTF Looks From The Victoria's Secret Fashion Show,1,1,13,37,1,11,2,50,0
22 Of The Funniest Excuses People Have Used To Justify Skipping A Workout,1,1,12,47,0,12,2,59,0
Cox BusinessVoice: 5 Considerations Before Ordering WiFi For Your Business,1,2,11,52,1,9,1,63,0
How Many Of These Logos Do You Recognize,1,1,8,25,0,7,0,33,0
Donald Trump says he will follow 'two simple rules' - and now everyone's making the same joke The list,1,3,3,77,4,18,0,80,0
Are YOU popular on Tinder? Dating app reveals the most right-swiped names of 2016,1,2,6,56,2,13,4,62,0
14 Gifts That Support the Causes Closest to Your Heart,1,3,7,36,0,9,2,43,0
Is the church's culture of shame increasing abortions?,1,2,1,44,2,7,0,45,0
32 Things Justin Bieber Definitely Says To Whoever Takes His Instagram Pictures,1,1,11,55,0,11,2,66,0
Washington Post: Trump’s Appointments of Military Officers May Turn U.S. Into Dictatorship,1,3,12,63,4,11,0,75,0
More Than 100 Sex Offenders Caught in Single Border Sector This Fiscal Year,1,3,11,49,0,12,3,60,0
What Does Your iPhone Colour Say About Your Sex Preference,1,1,10,39,0,9,0,49,0
"The ""Twilight"" Author Has Rewritten The Book To Reverse The Genders",1,1,11,44,2,10,0,55,0
Survivors pulled from avalanche hotel after two days,1,3,1,44,0,7,0,45,0
Donald Trump and Justin Trudeau were asked the same question - their answers said it all. The list,1,3,5,74,2,17,0,79,0
We Know Your Age And State Based On Your Mani,1,3,10,26,0,9,0,36,0
21 Things That Happened If You Were Really Shit At P.E,1,1,11,30,1,10,2,41,0
15 Times Viola Davis Was The Role Model This Damn World Needs,1,1,11,37,0,11,2,48,0
Here's The Real Deal With Drinking Activated Charcoal,1,1,8,37,1,7,0,45,0
Here's Why Facebook Creeping Is No Longer Anonymous,1,3,8,35,1,7,0,43,0
"How Long Before The Dow Jones Industrial Average Reaches 21,000?",1,3,9,39,2,9,5,48,0
What Twentysomething Stereotype Are You Based On Your Zodiac Sign,1,1,10,46,0,9,0,56,0
Fake News: AP Touts Anti-Trump Poll with Warped Demographics Conducted by Soros-Backed Org,1,2,14,61,3,12,0,75,0
Major Elements of Trump’s New Immigration Policies ,1,3,6,37,1,7,0,43,0
Chris Sale is a great addition for the Red Sox. There’s just one problem.,1,2,5,52,3,13,0,57,0
That Picture Of  Matthew Perry And Courteney Cox Everyone Is Talking About Is 10 Years Old,1,1,15,57,0,16,2,72,0
25 Children Have Been Selected From Across India For The Revered National Bravery Awards,1,2,13,60,0,13,2,73,0
25 Times Hipster Britain Went Too Damn Far,1,1,7,26,0,7,2,33,0
We Made A Ridiculously Big Cat Fort For My Cat,1,1,10,27,0,9,0,37,0
35 Totally Brilliant Ways To Eat More Chocolate,1,1,7,31,0,7,2,38,0
Which Celebrity Should Be Your First Famous BFF,1,1,10,30,0,7,0,40,0
This Humans Of New York Parody Account For Orcs Is Everything,1,1,11,40,0,10,0,51,0
Fake VPNs Are Trying To Cash In On Your Online Privacy Fears,1,3,14,35,0,11,0,49,0
When Everything In Mami's House Is A Lie,1,1,8,24,1,7,0,32,0
Two Rats Fought Over A Slice A Pizza In New York City Because Why Not,1,1,15,40,0,14,0,55,0
29 Things Non-Germans Find Bewildering About Germany,1,1,7,36,1,6,2,43,0
We Tried To Have Sex With Ghosts And Here's What Happened,1,1,11,35,1,10,0,46,0
A Kansas lawmaker just compared Planned Parenthood to a Nazi death camp,1,3,5,55,0,11,0,60,0
The 5 Stages Of Getting Your First Grey Hair,1,1,8,27,0,8,1,35,0
British Blue Chips Snub Investor Calls to Show CEO Pay Ratio,1,3,12,38,0,10,0,50,0
Which Non-Prince Disney Guy Is Your Soulmate,1,1,8,29,1,6,0,37,0
21 Things Only Non-Harry Potter Fans Know To Be True,1,1,10,30,1,9,2,40,0
Everything You Need To Know About This Chocolate Cheese Toastie,1,1,10,44,0,9,0,54,0
Here's How Most People Have Anal Sex,1,2,7,22,1,6,0,29,0
Situation vacant: Running Rome's Colosseum,1,3,4,32,2,4,0,36,0
Economists: Working Class Whites ‘Dying Disproportionately’ from ‘Deaths of Despair’,1,3,8,62,5,9,0,70,0
25 Reasons A Trip To Costa Rica Could Actually Change Your Life,1,1,11,39,0,11,2,50,0
Gwyneth Paltrow Has Shit In Her Paaaaants,1,1,7,28,0,6,0,35,0
Here's What Happened When Twentysomethings Tried Cooking Their Family Recipes For The First Time,1,1,14,68,1,13,0,82,0
Across The Universe Of John Lennon In 39 Pictures,1,1,8,31,0,8,2,39,0
Wonder Woman dumped as a special UN ambassador after uproar,1,3,4,46,0,9,0,50,0
PICS: Le Pen Goes to Sea as She Clashes With Macron Over Fishing Policy,1,3,15,42,1,13,0,57,0
This Woman's Lonely Christmas Cards Are Hilarious,1,1,7,35,1,6,0,42,0
These Women Used Periscope For The First Time And Felt Like They Were Being Catcalled On The Internet,1,1,18,66,0,17,0,84,0
26 Truly Incredible Things To Do With Ice Cream,1,1,8,29,0,8,2,37,0
"Sonu Nigam Shaves His Head Off, Kapil Sharma & Sunil Grover To Appear On A Show & More From Ent",1,2,18,55,3,19,0,73,0
12 Lessons Learned From Bad Sex,1,1,5,19,0,5,2,24,0
"Not Just Air Pollution, Delhi Is Also World No.1 In Noise Pollution + 5 Other Major Reads From Today",1,3,17,60,3,18,2,77,0
Which Good Luck Charm Matches Your Personality,1,1,7,33,0,6,0,40,0
Glasses adjust with your eyes👓; World travels via container ship 🚢; Refugee videogamer-turned-football star🎮 🏈,1,3,3,85,8,14,0,88,0
21 Stunning Photos Of Newfoundlands And Labradors,1,1,6,35,0,6,2,41,0
11 Heartwarming And Hilarious Stories About LGBT Parents Coming Out To Their Kids,1,2,15,52,0,12,2,67,0
Which Pawnee City Hall Mural Are You,1,1,7,23,0,6,0,30,0
23 Reasons Christmas In Florida Is Actually The Best,1,1,8,34,0,8,2,42,0
Three Ways to Protect Your 401(k) If Trump Kills the Fiduciary Rule,1,3,9,42,2,11,3,51,0
13 Indians Told Us About Their Worst Experiences With Moral Policing In Colleges,1,1,12,54,0,12,2,66,0
What's Your Favorite Book With A Great LGBT Lead Character,1,1,13,35,1,9,0,48,0
The Biggest Moment Of Nancy Pelosi's Town Hall Almost Didn't Happen,1,3,11,44,2,10,0,55,0
This Instagram Makeup Artist Turns Herself Into Terrifying Creatures,1,1,9,51,0,8,0,60,0
Dale Cavese: the football chant that took over the internet and the world,1,3,2,58,1,12,0,60,0
"Here's What ""Back To The Future"" Got Right And Wrong About 2015, According To Neil deGrasse Tyson",1,1,16,57,4,16,4,73,0
19 Confessions That Capture What It Feels Like To Be Insecure In A Relationship,1,1,13,51,0,13,2,64,0
"Oscars Mix-Up: It’s ‘Moonlight,’ Not ‘La La Land’ - Video - NYTimes.com",1,3,13,36,11,11,0,49,0
37 Of The Most Insane Pictures Ever Taken At Burning Man,1,1,10,34,0,10,2,44,0
Puerto Rico Just Opened Up The Dress Code For LGBTQ Students,1,1,15,35,0,10,0,50,0
23 Horrifying Old Photos That Will Keep You Awake At Night,1,1,10,36,0,10,2,46,0
Beschreibung Bewertungen Neue Funktionen Weitere Informationen Ähnlich Mehr vom Anbieter,1,3,9,70,0,9,0,79,0
"Who, What, Why: How do dogs donate blood?",1,2,4,26,4,7,0,30,0
Stumped On Holiday Gift Ideas? Let Forbes' 30 Under 30 Alumni Help,1,2,10,39,2,11,4,49,0
This iPhone Feature Is A Shortcut To All Of Your Most-Used Settings,1,1,13,42,1,11,0,55,0
18 Simple Time-Saving Ideas To Help You Prepare For The Thanksgiving Meal,1,1,12,47,1,11,2,59,0
Match The Celebrity Baby Name From 2015 To Their Famous Parent,1,1,10,38,0,10,4,48,0
If Cosmo Wrote About Men The Same Way They Write About Women,1,1,12,37,0,11,0,49,0
Please Take A Moment Out Of Your Day To Look At This Stunning Aishwarya Rai Bachchan Photo Shoot,1,1,18,61,0,17,0,79,0
"11 Times Selena Gomez's ""Hands To Myself"" Video Made Me Question My Homosexuality",1,1,12,52,3,12,2,64,0
"Which ""True Blood"" Character Should You Date Based On Your Zodiac Sign",1,1,12,45,2,11,0,57,0
12 People Who Regret Asking The Internet For Help In 2015,1,1,9,32,0,10,6,41,0
"Disney's New ""Frozen"" Plane Is The Epitome Of Chill",1,1,9,31,3,8,0,40,0
These 6 Assault Survivor Stories Will Break Your Heart,1,1,8,37,0,8,1,45,0
24 Photos That Prove The Rock Won 2015,1,1,6,19,0,7,6,25,0
Which Hogwarts Houses Do These Pop Divas Belong In,1,1,9,33,0,8,0,42,0
NBC's 'Hairspray Live!': The Best Social Media Reactions to the Show,1,2,11,42,5,10,0,53,0
People Open Up About Why They Take Medication For Their Mental Health,1,1,12,46,0,11,0,58,0
Are e-cigarettes safer than tobacco? New study fires up debate,1,3,2,49,2,9,0,51,0
This Couple Had The Craziest Wedding Crasher: The President,1,1,9,41,1,8,0,50,0
Man threatens to set himself on fire outside BBC's London office,1,2,5,48,1,10,0,53,0
Tell Us About Yourself(ie): Jake Lacy,1,1,6,23,3,5,0,29,0
21 Amazing Holiday Books You Need To Read ASAP,1,1,11,25,0,8,2,36,0
44 Brunch Recipes You Can Make At Home To Save Cash,1,1,10,29,0,10,2,39,0
This Toddler Had The Best Reaction When She Found Out Adam Levine Is Married,1,1,14,49,0,13,0,63,0
29 Incredibly Delicious Recipes That Start With A Can,1,1,8,35,0,8,2,43,0
19 Things That Happened for the First Time in 2016 ,1,3,5,30,0,10,6,35,0
We Know If You Have A Mac Or PC Based On Random Questions,1,1,14,31,0,12,0,45,0
5 mistakes Americans are making with their money,1,3,1,39,0,7,1,40,0
"The Actress Who Played Cho Chang Hated Her Hair During The ""HP"" Kiss Scene",1,1,15,44,2,13,0,59,0
24 Times Ruby Rose And Phoebe Dahl Defined Relationship Goals In 2015,1,1,10,42,0,11,6,52,0
Justin Bieber Might Have Revealed That His Most Recent Song Is About Selena Gomez,1,1,14,54,0,13,0,68,0
19 Couples In 2016 Who Perfectly Nailed This Whole Relationship Thing,1,3,9,44,0,10,6,53,0
Actor Kal Penn shares scripts revealing Indian stereotypes in Hollywood,1,3,5,57,0,9,0,62,0
24 Ways To Add Some Geometry To Your Home Decor,1,1,9,27,0,9,2,36,0
Ruby Rose Is Single Again And We Have Some Questions She Needs To Answer,1,1,14,45,0,13,0,59,0
29 Baller Ass Winter Coats You Might Be Able To Afford,1,1,10,32,0,10,2,42,0
7 details you may have missed on Sunday's 'The Walking Dead',1,3,4,42,3,10,1,46,0
"Do You Still Remember What Happened In ""A Series Of Unfortunate Events""",1,1,12,46,2,11,0,58,0
The 20-year-old leading the March Against Revenge Porn,1,3,5,38,2,7,2,43,0
Actor T.J. Miller Arrested for Allegedly Slapping Uber Driver,1,2,9,42,2,8,0,51,0
Firefighters and cancer: Is a risky job even riskier?,1,3,2,41,2,8,0,43,0
Nancy Pelosi: I Don’t Think Democrats ‘Want A New Direction’,1,3,10,37,4,9,0,47,0
19 Surprising Confessions About Anal Sex,1,1,5,28,0,5,2,33,0
Beautifying Baghdad: Colouring in a city of walls,1,3,3,38,1,7,0,41,0
How Well Do You Actually Know Your Starbucks?,1,3,8,29,1,7,0,37,0
Kate Hudson Joins List of Celebs Crushing on Jeff Bridges,1,2,8,40,0,9,0,48,0
8 Tips For Avoiding Information Overload,1,2,5,29,0,5,1,34,0
"Obama, Through Kerry, Proposes Dividing Jerusalem",1,2,6,36,2,5,0,42,0
How It Feels To Be An Atheist In A Highly Religious Society,1,1,12,36,0,11,0,48,0
The Nighttime Routine That’ll Make You More Productive Tomorrow,1,3,9,45,1,8,0,54,0
The parody accounts that make Twitter bearable in the era of Trump,1,3,3,52,0,11,0,55,0
Is Your Soulmate A Jedi Knight Or Sith Lord,1,1,9,26,0,8,0,35,0
Want To Surf Down An Active Volcano? Here's How To Do It,1,3,12,31,2,11,0,43,0
WTF Would You Do If Your Kid Said F*ck,1,1,11,18,1,8,0,29,0
You May Have More Retirement Income Available Than You Thought,1,2,10,43,0,9,0,53,0
We Gave These Americans Euros And They Were Confused,1,1,9,35,0,8,0,44,0
China’s fishermen explain why they think the sea is theirs,1,2,1,47,1,9,0,48,0
Why ‘living within our means’ is a great con,1,3,1,33,2,8,0,34,0
"19 Times ""Fresh Off The Boat"" Made You Laugh Uncontrollably",1,3,9,37,2,9,2,46,0
How The Hubble Space Telescope Changed The Universe,1,3,8,36,0,7,0,44,0
70 Percent in Japan Approve of Shinzo Abe’s Trump Visit; Communist Party Outraged,1,2,10,55,2,12,2,65,0
Stop what you're doing and put this timelapse of the Milky Way on fullscreen,1,3,3,59,1,13,0,62,0
Utah Lawmakers Pass Measure Calling on Congress to Abolish U.S. Education Department,1,3,11,60,2,11,0,71,0
Govt To Launch An 'Anti-Troll' App For Women Soon!,1,3,10,28,4,8,0,38,0
"Oprah Interviewed The Cast Of ""Friends"" In 1995 And It Will Melt Your Heart",1,1,13,43,2,13,4,56,0
21 Things Tim Hortons Employees Secretly Wished You Knew,1,1,8,38,0,8,2,46,0
Here's Why Shonda Rhimes Is The Biggest Troll In TV Right Now,1,1,13,36,1,11,0,49,0
Michael Moore: ‘Donald Trump Is Gonna Get Us Killed’,1,3,9,32,3,8,0,41,0
This Color Test Will Determine If You're An Introvert Or Extrovert,1,1,11,44,1,10,0,55,0
A Bengaluru Hotel Took Underprivileged Kids On A Tour Of The City As A Christmas Surprise,1,1,16,58,0,15,0,74,0
This Man's Insane Makeup Art Will Straight Up Mesmerize You,1,1,10,39,1,9,0,49,0
Jan Gehl: The architect responsible for making Melbourne liveable,1,3,4,52,1,8,0,56,0
"France Just Made Every Citizen An Organ Donor, Unless They Opt Out",1,2,12,42,1,11,0,54,0
18 Documentaries That Will Leave You With A Smile On Your Face,1,2,11,38,0,11,2,49,0
17 Too Real Things For Perpetually Late People,1,1,7,30,0,7,2,37,0
Teacher opens Books & Braids salon for young girls at elementary school,1,3,3,56,1,11,0,59,0
27 Small Yet Crucial Life Lessons From The Internet,1,1,8,33,0,8,2,41,0
This Dog Could Not Be More Chill About The Election,1,1,10,32,0,9,0,42,0
"If The Cast Of ""Rugrats"" Grew Up To Be Parents",1,1,10,25,2,9,0,35,0
NFL alternate realities: Biggest draft 'what if?' for all 32 teams,1,3,4,46,4,10,2,50,0
The Biggest Media and Advertising Questions for 2017,1,3,5,36,0,7,4,41,0
This Couple Wants To Show How Traveling With A Partner Isn't Always A Fairy Tale,1,1,15,50,1,14,0,65,0
How a white kid’s taunt and a black student’s body slam made race their high school’s main subject,1,3,1,77,3,17,0,78,0
Peanut Butter And Jelly Bourbon Exists And It's A Gift To Us All,1,1,13,38,1,12,0,51,0
Activist Funds Put Executive Pay Formulas Under Microscope,1,3,8,43,0,7,0,51,0
Cereal Isn't Cool In 2016,1,1,4,12,1,4,4,16,0
"Move over hipsters, here comes the ""yuccie""",1,3,1,33,3,6,0,34,0
15 Pieces Of Sushi That Are A Sin Against Nature,1,1,9,28,0,9,2,37,0
Can We Guess What Kind Of Person You Are From These 10 Questions,1,1,12,38,0,12,2,50,0
How Much Of A Chocoholic Are You,1,1,7,19,0,6,0,26,0
"Try To Guess Even More Disney Movies Just By The ""Walt Disney Presents"" Screen",1,1,14,49,2,13,0,63,0
Northwestern MutualVoice: The Sweet Smell Of Success: 5 Tips For Starting A Post-Retirement Business,1,3,15,68,3,13,1,83,0
"Police Shoot Tear Gas to Disperse Hot 97 Summer Jam Crowds, 61 Arrested",1,2,10,44,1,12,4,54,0
19 People Who Have Too Much Going On,1,1,7,20,0,7,2,27,0
Will we be able to cryogenically freeze organs one day?,1,2,1,44,1,9,0,45,0
"18 Times The Internet Perfectly Summed Up Playing ""Mario Kart""",1,1,9,40,2,9,2,49,0
The Transgender Dating Dilemma,1,1,4,23,0,3,0,27,0
15 Iconic Items For Everyone Who Loves Kim Kardashian's Crying Face,1,1,10,44,1,10,2,54,0
"Magic and Bird get reacquainted as Lakers look in on Pacers star Paul George, sources say",1,3,6,67,1,15,0,73,0
These Parents Threw A Lit “Divorce Party” To Make Their Split Less Awkward,1,2,13,47,2,12,0,60,0
55 Carly Rae Jepsen Lyrics You Should Definitely NOT Say To Your New Crush,1,1,15,44,0,13,2,59,0
14 Powerful Quotes That Will Make You Hopeful For The Future,1,1,10,38,0,10,2,48,0
Exclusive: Jenna Jameson Denies Role in Anti-Trump Porn Film: ‘Fake News’,1,3,11,47,5,10,0,58,0
26 Times Ellen DeGeneres Scared The Crap Out Of Famous People,1,1,11,38,0,10,2,49,0
36 Songs You'll Remember If You Were In College From 2007-2011,1,1,9,31,2,10,10,40,0
Here's What You Should Actually Buy on Black Friday,1,1,8,34,1,8,0,42,0
This Tip Will Make Sure You Never Run Out Of Condoms Again,1,1,12,35,0,11,0,47,0
What Will Be Your Favorite Animal Of 2016,1,1,7,23,0,7,4,30,0
'It's more common than you think': What we need to know about abortion according to experts,1,2,2,70,4,15,0,72,0
24 Rules For Women On A First Date With A Man,1,1,10,23,0,10,2,33,0
Are You Player 1 Or Player 2,1,1,5,15,0,6,2,20,0
Who Is Your Dad Actually,1,1,5,15,0,4,0,20,0
What It's Like To Be Behind The Table At A Comic Convention,1,1,12,35,1,11,0,47,0
Ingenious Hack Turns Amazon Dash Button Into Trump-Fighting Machine,1,3,10,48,1,8,0,58,0
18 People Who Have It Harder Than Donald Trump,1,1,8,28,0,8,2,36,0
22 Things To Give Your BFF To Show Them They're The One For You,1,1,15,32,1,13,2,47,0
An eye doctor explains why your eyes twitch sometimes,1,3,1,44,0,8,0,45,0
"Illinois Second Graders Adore School Janitor, Line Up to Get Yearbooks Autographed - Yahoo",1,2,12,63,2,13,0,75,0
Sean Spicer to ABC’s Jon Karl: ‘Calm Down’ — ‘It’s Not Your Press Briefing’,1,2,14,40,8,13,0,54,0
17 Of The Actual Worst Avocados That Have Ever Happened,1,1,9,35,0,9,2,44,0
"How Well Do You Remember ""A Christmas Story""",1,1,8,27,2,7,0,35,0
Spring breakers save people from devastating house fire,1,3,1,47,0,7,0,48,0
"The $4,500 injection to stop heroin overdoses",1,2,1,32,2,6,4,33,0
Galleries Britain's 20 most 'crap' towns - and why we love them,1,3,2,44,4,11,2,46,0
13 Faces Every Tech CEO Who Goes To A Meeting With Donald Trump Will Immediately Recognize,1,3,17,56,0,15,2,73,0
16 Fucking Creepy Things That Actually Happened In 2016,1,2,7,34,0,8,6,41,0
Signs It’s Time For a Career Change | Ashford University,1,2,8,37,2,9,0,45,0
It turns out CPR will bring a drowned lizard back to life. A couple of times.,1,2,5,55,2,15,0,60,0
Not Funny: ‘Saturday Night Live’ Viewers Are Over the Trump Jokes,1,3,10,42,3,10,0,52,0
19 Things That Make Solo Travel A Little Less Intimidating,1,3,9,38,0,9,2,47,0
"Are You Busy Ramone Or Amanda Zimm From ""Ready Or Not""",1,1,11,31,2,10,0,42,0
"What's The Biggest Thing You Want To See From The ""Gilmore Girls"" Revival",1,1,13,45,3,12,0,58,0
"After Brutally Killing A Kangaroo With Metal Pipe, Two Men Have Been Jailed In Australia",1,2,15,58,1,14,0,73,0
"How Well Do You Remember ""Sabrina, The Teenage Witch""",1,1,9,33,3,8,0,42,0
Chrissy Teigen Announced The Sex Of Her Baby And People Are Flipping Out,1,1,13,47,0,12,0,60,0
"Joseph Gordon-Levitt Made A DIY Yoda Costume For The ""Star Wars"" Premiere",1,1,15,44,3,11,0,59,0
Women and film: Is it still a man's world behind the camera?,1,3,2,44,3,11,0,46,0
People Are Loving This Dog Who Came Out Of Surgery And Can't Stop Smiling,1,2,14,45,1,13,0,59,0
"I Can't Stop Laughing At This Tweet About Kajol, Come Laugh With Me",1,1,13,40,2,12,0,53,0
Here's All You Need To Know About The New Harry Potter Theme Park At Universal Studios Hollywood,1,1,17,62,1,16,0,79,0
Quids in: why it’s time to get rid of your £1 coins,1,3,1,35,3,11,1,36,0
Google Just Found (Probably) The Most Dangerous Android Malware Ever Seen,1,3,11,50,2,10,0,61,0
This Lo Mein Recipe Is So Easy You'll Be Able To Open Your Own Restaurant,1,1,15,43,1,14,0,58,0
Steve Carell's Explanation For Trolling 'Office' Fans Is Peak Michael Scott,1,3,11,51,3,10,0,62,0
Bank Tellers Draw Scrutiny Over Security,1,2,6,29,0,5,0,35,0
"Your smartphone knows a lot about you, but what about your mental health?",1,2,1,58,2,12,0,59,0
"Here's what we know about Bobby Murphy, Snapchat's mysterious billionaire cofounder",1,3,4,66,3,10,0,70,0
This Makeup Artist Transforms Her Lips Into Tiny Pieces Of Art And It's Incredible,1,1,14,54,1,13,0,68,0
57 Vintage Photos Of Couples That Will Make You Believe In Love,1,1,11,39,0,11,2,50,0
10 things we want to see in 'Fast 9' (or whatever it ends up being called),1,2,1,51,4,15,3,52,0
She had something to say about Betsy DeVos. So she sent her senator a pizza — with a message.,1,3,5,67,3,18,0,72,0
8 Creative Hobbies To Take Up In 2017,1,2,6,19,0,7,5,25,0
"Republican Party, ‘Kong: Skull Island’: Your Friday Evening Briefing ",1,3,9,46,5,9,0,55,0
"Maher: I’ll Only Accept Garland on Supreme Court, The Pick Was ‘Stolen’",1,3,11,44,5,11,0,55,0
13 TED Talks that can teach you how to live a happier life,1,3,4,40,0,12,2,44,0
From God's Finger to Azure Window: 11 natural landmarks lost to the elements (and vandalism),1,3,5,67,4,14,2,72,0
We Know Your Favorite Fandom Based On Your Zodiac Sign,1,1,10,35,0,9,0,45,0
23 Leonardo DiCaprio Faces That Are Basically You,1,1,8,32,0,7,2,40,0
"Twitter Announces Censoring Search Results, ‘Low-Quality Tweets’ to Combat ‘Abuse and Harassment’",1,3,11,69,6,11,0,80,0
18 Awesome Holiday Traditions Your Family Should Try This Year,1,1,9,42,0,9,2,51,0
What Happens When The Internet Turns You Into A Superhero,1,1,10,38,0,9,0,48,0
11 Classic Movie Lines From Alan Rickman,1,1,6,26,0,6,2,32,0
The new course getting more women into Australian politics,1,2,2,48,0,8,0,50,0
The social media problems gripping our girls,1,2,1,37,0,6,0,38,0
"Who's happy, who's not: Norway tops list, US falls",1,3,4,33,5,8,0,37,0
"Obama Orders Five Last Minute Monuments, Most In Presidential History",1,3,10,49,1,9,0,59,0
8 Things You Should Know About Alcohol Before Freshers' Week,1,1,9,40,1,9,1,49,0
We Know If You're Hungry Based On Your Reaction To These GIFs,1,1,14,35,1,11,0,49,0
There are lots of ways to get rich — but only one way to stay that way,1,3,1,52,1,16,0,53,0
A Couple Saved An Injured Squirrel And Now He's Living In Their Christmas Tree,1,1,14,50,1,13,0,64,0
Does Facebook want to read your THOUGHTS? Secretive division may be developing a mind-reading device,1,3,11,73,2,14,0,84,0
18 Of The Most Powerful Science Photos From This Month,1,1,9,34,0,9,2,43,0
Can You Rock Climb Without A Rope,1,1,7,20,0,6,0,27,0
A Man Went Snowboarding Through Times Square During The Blizzard,1,1,10,45,0,9,0,55,0
A Canadian Mailman Just Found The Woman Who Wrote A Heartbreaking Letter To Santa 22 Years Ago,1,1,16,60,0,16,2,76,0
"How a lab chemist went from ‘superwoman’ to disgraced saboteur of more than 20,000 drug cases",1,3,1,69,3,15,5,70,0
Demi Lovato's Impressions Of Fetty Wap And Christina Aguilera Are Mind-Blowing,1,1,12,54,2,10,0,66,0
16 Messages That Are Basically Sexts For Parents,1,1,7,32,0,7,2,39,0
21 Of The World's Most Powerful People As Youngsters,1,1,8,33,1,8,2,41,0
"Fat is GOOD for you! Diets laden with butter, cream and CHEESE 'can help combat surge in Type 2 diabetes' ",1,3,13,68,4,20,1,81,0
Where Can You Find The Best BBQ In Texas,1,1,11,21,0,8,0,32,0
Gift Guide: Books Most Recommended By FORBES In 2016,1,3,13,26,1,8,4,39,0
25 Art History Snapchats That Will Make You Giggle,1,1,8,32,0,8,2,40,0
How to participate in the Women's Strike if you can't skip work,1,3,3,47,2,11,0,50,0
22 Things Your Vagina Wants You To Know About Masturbation,1,3,9,38,0,9,2,47,0
These Three Minute Chocolate Chip Cookies Are Everything,1,1,8,41,0,7,0,49,0
Kate Winslet Has Criticised Actresses For Speaking Publicly Against Pay Inequality,1,1,11,61,0,10,0,72,0
This graphic shows how vulnerable every type of job is to automation,1,3,1,56,0,11,0,57,0
Did This Gossip Headline Happen In 2015 Or Not,1,1,8,26,0,8,4,34,0
17 Beavers Who Just Want To Be Your Feminist Ally,1,1,9,29,0,9,2,38,0
Pelosi: Tillerson Not Suited for ‘Revered Position’ of Secretary of State,1,3,8,52,3,10,0,60,0
"Amul Does It Again, Gives A Most 'Engaging' Twist To Virat-Anushka's Engagement Rumor!",1,3,14,54,6,12,0,68,0
17 Gorgeous Teal Pumpkins That Are Anything But Scary,1,1,8,35,0,8,2,43,0
Report: Megyn Kelly to Make NBC Debut in June,1,3,9,27,1,8,0,36,0
How You Hear Baby Names Vs. How Kids Hear Them,1,1,10,26,1,9,0,36,0
'Gilligan's Island' star Dawn Wells talks Mary Ann's sex appeal ,1,2,6,44,4,10,0,50,0
Pinterest Will Now Tell You When A Product's Price Drops,1,1,10,36,1,9,0,46,0
"Phoebe From ""Friends"" Is Literally The Fucking Worst",1,1,8,35,2,7,0,43,0
Griping about the popular vote? Get over it.,1,2,2,33,2,7,0,35,0
Hayley Williams's family in theme park safety plea,1,2,2,40,1,7,0,42,0
My Friend Is Bankrupting Herself. Should I Speak Up? ,1,3,9,33,2,9,0,42,0
Hilary Duff On Her Phone Is Every Twentysomething Ever,1,1,9,37,0,8,0,46,0
Do-Nothing Congress: Democrats ‘Pivot’ from Gun Control to Blocking Pro-Gun Bills,1,3,11,55,5,10,0,66,0
17 Insanely Cool Things You Can Do With A Hot Glue Gun,1,1,11,30,0,11,2,41,0
What the Chinese saying 'The ugly wife is a treasure at home' actually means,1,3,3,58,2,13,0,61,0
This Rescued Pit Bull's Smile Is the Cutest Thing You'll See Today  Insider,1,3,12,48,2,13,0,60,0
Why are women in Ireland marking Christmas on January 6?,1,3,4,41,1,9,1,45,0
Can You Guess If This Is A Michael Scott Or Andy Dwyer Quote,1,1,13,35,0,12,0,48,0
24 Times Lucy Hale Won Our Hearts On Instagram,1,1,8,28,0,8,2,36,0
Hear A Clip Of Good Charlotte's Comeback Song,1,1,8,29,1,7,0,37,0
Liam Hemsworth Went Vegan,1,1,4,18,0,3,0,22,0
"Which Zodiac Should You Date Based On Your Favourite ""Game Of Thrones"" House",1,1,13,49,2,12,0,62,0
Big B Snubs Australian Media After They Compare Kohli With Trump In Just One Epic Tweet!,1,3,16,56,1,15,0,72,0
Rupert Murdoch's most controversial tweets,1,3,2,35,1,4,0,37,0
John Legend Kissing Chrissy Teigen's Baby Bump Is Couple Goals,1,1,10,42,1,9,0,52,0
Hot Guys Holding BB-8 Is The Only Thing You Need To See Today,1,1,14,33,1,12,1,47,0
‘The Daily’: The 47-Day Fall of Michael Flynn ,1,3,7,25,4,8,2,32,0
We Gave Drunk Girls A Bunch Of Puppies And There Were Lots Of Tears,1,1,14,40,0,13,0,54,0
15 Times Canadian Cops Had Too Much Fun On The Job,1,1,10,28,0,10,2,38,0
Koran Verse Denying Jesus Was Son of God Sung in Scottish Cathedral,1,3,10,46,0,11,0,56,0
This Grandma Had The Perfect Response To Finding Out Her Granddaughter Was Engaged To A Woman,1,1,16,62,0,15,0,78,0
40 Incredible Things You Didn’t Know About Emma Stone,1,3,8,34,1,8,2,42,0
Uber drivers threaten rebellion against the $40bn company,1,3,1,46,1,7,2,47,0
Pelosi: ‘I Think the Press Were Accomplices in the Undermining of Our Election’,1,2,9,55,3,12,0,64,0
The biggest companies in the world are excited about one of Trump's key economic plans,1,3,2,69,1,14,0,71,0
11 Stats That Put Wayne Rooney's 50 Goals Into Perspective,1,1,8,36,1,9,4,44,0
10 Bizarre Claims People Make to Avoid Paying Taxes,1,3,7,34,0,8,2,41,0
Does your home need a thinking lightbulb?,1,3,1,33,1,6,0,34,0
This Is How BuzzFeed LA Does Halloween,1,1,9,23,0,6,0,32,0
The Woman Leading A Crusade To Tell More Asian-American Stories,1,1,11,42,1,9,0,53,0
21 Things You Just Get If You Met Your Best Friend At An All-Girls' School,1,1,15,41,2,14,2,56,0
"The Hardest ""Pretty Little Liars"" Quiz You'll Ever Take",1,1,9,35,3,8,0,44,0
Are Wall Street Banks Doing Enough to Prevent Shoddy Chinese IPOs?,1,3,12,43,1,10,0,55,0
Why Carrie Fisher's ashes were carried in Prozac-shaped urn,1,2,4,45,2,8,0,49,0
Literally Just 17 Pictures Of Christopher Meloni's Butt,1,1,7,38,1,7,2,45,0
A Reminder Of What It Really Meant To Be A Militant Feminist,1,1,12,37,0,11,0,49,0
This Is What Happened When We Showed Non-Australians Photos Of Aussie Stuff,1,2,13,50,1,11,0,63,0
10 Money Moves To Make Before Year End,1,3,7,22,0,7,2,29,0
Meghan Trainor And Charlie Puth Made Out For An Uncomfortably Long Time At The AMAs,1,1,17,52,0,14,0,69,0
"Would You Be Accepted Into The KKT Sorority From ""Scream Queens""",1,1,13,39,2,10,0,52,0
"Here's what Southern Rail passengers are saying about the strike on Twitter - 30,000 tweets analysed",1,2,4,73,3,15,5,77,0
What Every Star Wars Fan Needs To See At Disneyland,1,1,10,32,0,9,0,42,0
Literally Just 25 Things That Happened At Walmart In 2015,1,1,8,34,0,9,6,42,0
Here’s What Executives Are Saying to Shareholders About Jobs,1,3,8,43,1,8,0,51,0
Which Panic! At The Disco Album Best Fits Your Personality,1,1,10,38,1,9,0,48,0
"That's The Future: Solar Power Rate Drops To Rs 3.15/Unit, And It's Only Going To Get Cheaper!",1,3,17,51,7,16,3,68,0
Driver Keeps Commuters Jingling All the Way With Christmas-Themed Public Bus - Yahoo,1,3,12,58,2,12,0,70,0
MILO Announces New Media Venture,1,2,8,20,0,4,0,28,0
Batman Fans Rejoice! Six Separate Movies Are Rumoured To Release In 2019,1,3,11,45,1,11,4,56,0
15 Dogs Who Want This Goddamn Rain To Stop,1,1,8,24,0,8,2,32,0
Can You Make It Through These 29 Tweets Without Laughing Once,1,1,10,39,0,10,2,49,0
"These skincare products are a waste of money, according to a dermatologist",1,3,1,61,1,11,0,62,0
23 Things You'll Get If You Hate Men But Are Also Attracted To Them,1,3,13,38,1,13,2,51,0
Here's why all the sudden the banks love Snapchat — but still hate Twitter,1,3,3,56,2,13,0,59,0
Crucial choice in 'Self/Less' movie clip: Would you want Ryan Reynolds' body?,1,3,6,54,6,11,0,60,0
Who Should Replace Beyonce at Coachella? Vote!,1,3,6,32,2,6,0,38,0
These Are The Photos By Indians Shortlisted In The World's Biggest Photography Contest,1,1,13,60,1,12,0,73,0
"Conway: Clinton Camp ‘Not Past Anger, Grief And Denial Stages’",1,3,10,39,4,9,0,49,0
See Emma Stone As A Superhero In A Movie That's Not Happening,1,1,12,37,1,11,0,49,0
"As Chicago Murder Rate Spikes, Many Fear Violence Has Become Normalized ",1,2,11,49,1,11,0,60,0
Humans: Everything we know about Channel 4's new series so far from the cast to that creepy Persona Synthetics ad,1,2,5,86,2,19,1,91,0
Sean Spicer went full Melissa McCarthy today,1,2,5,33,0,6,0,38,0
"Let's All Take A Moment To Appreciate Daveed Diggs From ""Hamilton""",1,1,11,42,3,10,0,53,0
"Nancy Sinatra Slams CNN, Congratulates Trump: ‘Why Do You Lie, CNN?’",1,3,15,37,6,10,0,52,0
19 Words That Only '00s Kids Will Really Understand,1,1,7,31,1,8,4,38,0
48 Things Women Hear In A Lifetime That Men Just Don't,1,1,10,31,1,10,2,41,0
Everyone Is Convinced The Brother And Sister From This Folgers Ad Are Hooking Up,1,1,14,53,0,13,0,67,0
21 Things You’ll Understand If You Love People But Also Hate Them,1,3,11,40,1,11,2,51,0
"South Carolina's Twitter Trolls Duke After Loss, Posts Link to 'DidDukeWin.com'",1,2,12,52,5,10,0,64,0
"Fabio Buying a Gun After More than $200,000 in Gold Coins, Watches, Stolen from Home",1,3,10,50,4,14,6,60,0
"12 Ridiculous Things That Actually Happened On ""The Bachelor"" Last Night",1,3,10,48,2,10,2,58,0
26 Pictures That Will Ruin Your Weekend,1,3,6,25,0,6,2,31,0
Zadie Smith's Productivity Tips Will Make You A More Focused Person,1,1,11,45,1,10,0,56,0
"The Ultimate ""Star Wars"" Fans Got Married In Line For ""The Force Awakens""",1,1,13,44,4,12,0,57,0
Northern soul: a fashion showcase,1,2,1,27,1,4,0,28,0
The Boston women who knit sweaters for chickens,1,2,2,38,0,7,0,40,0
Odd Lots: This Is How You Know When the Stock Market Is in a Bubble,1,3,12,40,1,14,0,52,0
This Is What They Did For Fun: The Story Of A Modern-Day Lynching,1,1,14,37,2,12,0,51,0
Why losing a dog can be harder than losing a relative or friend,1,3,1,50,0,12,0,51,0
Face transplant recipient overwhelmed by result,1,3,1,41,0,5,0,42,0
"Scientists to begin sending messages to aliens, despite warnings that it could trigger Earth’s destruction",1,2,2,88,2,14,0,90,0
31 People Who Are Really Nailing This Whole Marriage Thing,1,1,9,38,0,9,2,47,0
"What Trump’s whiter, less academic Cabinet says about race and class in America",1,2,4,61,2,12,0,65,0
How Many Iconic Early '00s Movies Have You Actually Seen,1,1,9,35,1,9,2,44,0
17 Reasons Why Jos. Louis Are The Ultimate Culinary Delight,1,1,9,38,1,9,2,47,0
Why do killer whales and humans go through menopause?,1,3,1,43,1,8,0,44,0
22 Times Someone Fucked Up And Hoped No One Would Notice,1,1,10,34,0,10,2,44,0
"15 Words That'll Only Make Sense To ""America's Next Top Model"" Fans",1,1,11,39,4,11,2,50,0
I Turned My Flat Into A Goddamn Ball Pool And You Can Too,1,1,13,32,0,12,0,45,0
Can You Match The Flame Test Colour To The Element,1,1,10,31,0,9,0,41,0
34 Charming Accessories All Fairy Tale Lovers Need,1,1,7,34,0,7,2,41,0
SAPVoice: Facebook And Uber Reveal Secrets Of Digital Disruption,1,3,12,43,1,8,0,55,0
17 Reasons Why Port Authority Is Literally Hell On Earth,1,1,9,36,0,9,2,45,0
19 signs you're successfully adulting,1,3,0,30,1,4,2,30,0
Russell Westbrook defends Thunder teammates: 'Don't try to split us up',1,2,4,53,4,10,0,57,0
'Twin Peaks' Season 3: Showtime revival gets a premiere date,1,3,4,43,3,9,1,47,0
Here's How To Make Your Own Bracelet,1,1,7,22,1,6,0,29,0
See What Salads Look Like All Over The World In Under Two Minutes,1,1,13,40,0,12,0,53,0
We Need To Talk About How Sexy Jared Keeso Is,1,1,10,26,0,9,0,36,0
Scary Stories To Tell In The Dark Reimagined For Millennials,1,1,10,41,0,9,0,51,0
Report of terminally ill boy who died in Santa's arms called into question ,1,2,2,59,1,13,0,61,0
The story of five young women killed for having fun,1,3,1,41,0,9,0,42,0
Craftsman’s famous lifetime warranty in question after $900 million sale,1,2,1,57,2,9,3,58,0
Amazon’s Jeff Bezos Exploring Legal Challenge to Trump Travel Ban,1,3,9,46,1,9,0,55,0
21 Things You Need For Your Baby If You Were In Hufflepuff Or Ravenclaw,1,1,13,43,0,13,2,56,0
What's One Thing You're Sick Of Hearing As An Introvert,1,1,10,34,2,9,0,44,0
21 Tiny Fashionable Hats You Can Make For Your Cat,1,1,9,30,0,9,2,39,0
"You Won't Believe How Much The Original ""Wedding March"" Sheet Music Is On Sale For",1,1,15,50,3,14,0,65,0
"Canada Plans To Legalise Marijuana By 2018, To Accept Recreational Use Of Pot Nationwide",1,3,13,57,1,13,4,70,0
Patriots Fans Dance in the Streets - Video - NYTimes.com,1,3,8,36,3,9,0,44,0
John Stamos And Julianne Moore Acted Out A Soap Opera Entirely Using Taylor Swift Lyrics,1,1,15,59,0,14,0,74,0
The Best Christmas Songs to Dance to,1,2,5,25,0,6,0,30,0
Why don't Japanese drivers buy US cars?,1,3,4,27,2,6,0,31,0
"Literally Just 17 Really, Really Good Ideas",1,2,6,28,1,6,2,34,0
'Overwatch' teases a possible new hero and it's (probably) not Doomfist,1,2,2,54,5,10,0,56,0
21 Delicious And Affordable Things You Need To Eat In Nashville,1,1,10,41,0,10,2,51,0
"19 Tweets About Dogs That Are Funny, Pure, And Just So Goddamn True",1,2,12,39,2,12,2,51,0
NFL POWER RANKINGS: Where all 32 teams stand heading into Week 16,1,3,18,31,1,11,4,49,0
"See inside the $5.5 million Washington, DC, home where Ivanka Trump and Jared Kushner are reportedly moving",1,3,8,77,4,16,2,85,0
Will BlackBerry's New Device Help It Make a Comeback in 2017?,1,3,9,36,2,10,4,45,0
A Sea Otter Learned How To Use An Inhaler After She Got Asthma,1,1,13,37,0,12,0,50,0
This High-Tech Hijab Will Literally Make Muslim Women Cooler,1,3,10,41,1,8,0,51,0
"‘Top Chef’ Host Padma Lakshmi Calls MILO A ‘Neo-Nazi,’ Calls Berkeley Riot A ‘Victory’",1,3,18,47,8,13,0,65,0
23 Art Designs That Enraptured Us In 2015,1,1,6,22,0,7,6,28,0
How To Make The Ultimate Spaghetti With Red Sauce,1,1,9,32,0,8,0,41,0
22 Guaranteed Ways To Piss Off A Human,1,1,7,22,0,7,2,29,0
5 Things About ISRO’s World Record Launch That Will Make You A Proud Indian,1,2,16,44,1,13,1,60,0
14 Struggles Everyone Who Hates Being Touched Will Understand,1,1,8,43,0,8,2,51,0
"This Actor Had The Best ""Game Of Thrones"" Themed Birthday",1,1,10,36,2,9,0,46,0
Bloomberg Benchmark   ,1,3,2,16,0,4,0,18,0
"Obama, Through Kerry, Proposes Dividing Jerusalem",1,3,6,36,2,5,0,42,0
14 Photos That’ll Make You Laugh If Your Sense Of Humor Is Stuck In Middle School,1,3,15,48,1,15,2,63,0
Which Musical Girl Group Would You Be In,1,1,8,25,0,7,0,33,0
What Was The Most Delicious Meal You Made In 2015,1,1,9,27,0,9,4,36,0
Quantiacs -- A Quant Hedge Fund Built With Freelancers,1,3,8,36,2,8,0,44,0
French Presidential Candidate Macron Forced to Deny Gay Affair,1,3,8,46,0,8,0,54,0
21 Dogs Who Are Thankful For Their Best Friends,1,1,8,29,0,8,2,37,0
18 Heartbreaking Confessions From People With Agoraphobia,1,1,6,43,0,6,2,49,0
FTC Warns Social Media Influencers to Stop ‘Stealth Ads’,1,2,10,36,2,8,0,46,0
Mark Cuban: Trump Is ‘Political Chemotherapy’ for the System,1,2,7,42,3,8,0,49,0
16 Beautiful Quotes That Will Make You Fall In Love With Paris,1,1,11,38,0,11,2,49,0
14 Duets That Prove Two Voices Are Better Than One,1,1,9,30,0,9,2,39,0
10 Mundane Things About Fall That Are Actually The Most Terrifying,1,1,10,44,0,10,2,54,0
"Why these mysterious, blood-sucking fish fell from the Alaskan sky",1,3,2,53,2,9,0,55,0
From A Tribal Reality To Olympic Dreams: How This Girl Became A National Level Archer,1,3,15,55,1,14,0,70,0
"Which Rejected Love Interest From ""The O.C."" Should Be Your Boyfriend",1,1,12,43,4,10,0,55,0
Do You Remember These WWF Tag Teams From Your Childhood,1,1,12,34,0,9,0,46,0
"11-year-old girl's hands covered in third-degree burns after making ""slime""",1,3,0,58,6,9,2,58,0
Beauty Brands That Broke Diversity Barriers in 2016 [Video],1,2,7,38,2,8,4,45,0
"In 100 Days, Donald Trump Hasn’t Done Much Except Show Off His Signature",1,2,12,43,2,12,3,55,0
Here’s What I Learned On A Minimal Makeup Challenge,1,2,9,33,1,8,0,42,0
Why do killer whales and humans go through menopause?,1,2,1,43,1,8,0,44,0
This Is The One R&B Song You Need To Listen To This Fall,1,1,14,29,1,12,0,43,0
The Beauty Trends You’re Going to See Everywhere This Fall,1,3,9,39,1,9,0,48,0
Fasten up: readers' photos on the theme of attach,1,3,1,38,2,8,0,39,0
What To Include On Your Resume (And What You Can Ditch),1,3,11,32,2,10,0,43,0
"This Is What ""Clueless"" Would Be Like If It Were Set In 2015",1,1,12,30,2,12,4,42,0
How to Speed Up Your Slow Mac - Personal Tech News,1,3,9,30,1,10,0,39,0
Which Of Taylor Swift's Music Video Love Interests Are You,1,1,10,38,1,9,0,48,0
"Which ""Hamilton"" Character Are You",1,1,5,23,2,4,0,28,0
Super Bowl commercials 2017: Grading the best and worst of the big game,1,3,3,51,1,12,4,54,0
Inside the Minds of the Ultrawealthy ,1,3,3,28,0,6,0,31,0
Which Biblical City Should You Live In,1,1,7,25,0,6,0,32,0
Obama: Sanders ‘A Pretty Centrist Politician’ Compared to ‘Some of the Republicans’,1,3,9,58,5,11,0,67,0
Did You Know A Couple Of Hours A Day In The Sun Could Boost Your Immunity? Here's How,1,3,18,48,2,17,0,66,0
We love Harrison Ford even when he’s causing real life havoc. Here’s why,1,3,4,53,3,12,0,57,0
The new dating app that aims to include people with disabilities,1,3,1,53,0,10,0,54,0
These Kids In Tijuana Crossed The Border Every Day To Go To School In America,1,1,15,48,0,14,0,63,0
17 Winter Hacks That Canadians Swear By,1,1,6,25,0,6,2,31,0
Gigi Hadid on how she deals with body-shaming trolls,1,3,2,41,1,8,0,43,0
Here Are The Best Hair And Makeup Looks From The Emmys Red Carpet,1,1,13,40,0,12,0,53,0
18 Outfits Alia Bhatt Wore In 2015 That You'll Want To Steal,1,1,10,32,1,11,6,42,0
"An Undertaker Talks About Life, Happiness And A 1000 Funerals",1,2,9,38,1,9,4,47,0
"NYT: Mexico Owns California and Texas, Will Trade For Amnesty",1,3,11,39,2,9,0,50,0
Tyra Banks & Chrissy Teigen Got Really Candid About Fertility Issues,1,1,10,47,1,10,0,57,0
Report: Drew Carey’s Son Started Fire Outside DeploraBall,1,3,9,39,2,7,0,48,0
"5 things for Monday, April 3: China, Supreme Court, Colombia",1,2,6,39,4,9,2,45,0
When You're a Dude Who Doesn't Like Watching Sports,1,1,8,33,2,8,0,41,0
"The country where people devour pasta, wine and olive oil is the world's healthiest. Really.",1,3,2,72,4,14,0,74,0
"If You're Excited For The New ""Star Wars"" Movie You Have To See This Art",1,1,15,40,3,14,0,55,0
"Okay, fine fine, Google's April Fool's Day pranks are pretty great this year, here are all of them",1,2,5,71,5,17,0,76,0
31 Times Puppies Made The World A Better Place,1,1,8,28,0,8,2,36,0
Clemson Tigers 'Get Back' Coach Puts in Work During the Offseason,1,3,9,44,2,10,0,53,0
22 Tweets About Bands That Will Actually Make You Laugh,1,1,9,35,0,9,2,44,0
19 Pictures That Prove Drunk People Are Actually Geniuses,1,3,8,39,0,8,2,47,0
Which Fictional Queer Lady Are You Based On Your Zodiac Sign,1,1,11,39,0,10,0,50,0
This Photo Of 500 Sheep In A Snowy Field Will Mess With Your Mind,1,1,13,36,0,13,3,49,0
21 Cats Who Are Still Figuring Out This Whole Cat Thing,1,1,10,33,0,10,2,43,0
Virat Kohli's Fluent Hundred Keeps India Afloat Even As England Make Dents In Their Batting Order,1,3,16,65,1,15,0,81,0
"19 Healthier, Grown-Up Versions Of Your Favorite Childhood Foods",1,1,9,43,2,8,2,52,0
32 Things Karl Pilkington Has 100% Actually Said,1,1,6,29,1,7,5,35,0
"Watch This Guy Play Out The Entire 2017 Oscars, Impressions And All",1,2,11,40,1,11,4,51,0
"Umm, So It Turns Out That Delhi Is Literally Full Of Dicks",1,1,12,34,1,11,0,46,0
13 Great Stories That Have Nothing to Do With Politics ,1,3,8,35,0,10,2,43,0
11 Ways The Reality Of Valentine's Day Doesn't Live Up To The Instagram Expectations,1,1,13,54,2,13,2,67,0
This Free App Is The Best Thing To Happen To Email Since Gmail,1,1,13,37,0,12,0,50,0
Everyone Stop And Appreciate Zac Efron Touching Himself,1,1,8,40,0,7,0,48,0
"For Anyone Who Had A Crush On Sheik From ""Zelda""",1,1,10,27,2,9,0,37,0
17 Times People Fell Head-Over-Heels For Musical Theater,1,1,9,36,2,7,2,45,0
Can You Match These Britney Spears Songs To Their Albums,1,1,10,37,0,9,0,47,0
Which Season Is The Best Season,1,1,6,20,0,5,0,26,0
24 Wives Who Are Crushing This Whole Marriage Thing,1,1,8,33,0,8,2,41,0
"Ok It's Official! Science Backs The Saying 'Once A Cheater, Always A Cheater'",1,3,13,47,5,12,0,60,0
These Sweatpants Overalls Are Making Me Have So Many Feelings,1,1,10,42,0,9,0,52,0
George Takei Took Down An Internet Troll And It Was Perfect,1,1,11,38,0,10,0,49,0
How to be the most memorable person in the room,1,3,1,37,0,9,0,38,0
Taxes From A To Z (2017): A Is For Affordable Care Act Reporting,1,3,12,33,3,12,4,45,0
Are You More Of A Broadway Stage Musical Or Movie Musical,1,1,11,36,0,10,0,47,0
"7 Essays To Read This Week: Black Joy, God, And When You “Literally Can’t Even”",1,3,14,44,6,14,1,58,0
New York to Require Salt Warnings; San Francisco to Ban Soda Ads,1,2,10,42,1,11,0,52,0
"Untested Developer Picked Wrong Time, Wrong Place and Wrong Neighbors ",1,3,9,50,1,10,0,59,0
Surgeon Promising Head Transplant Now Asks America for Help,1,2,8,43,0,8,0,51,0
Can You Find Out What's Missing From This Tough Crossword,1,1,10,37,1,9,0,47,0
"19 Mysteries That Small-Town Midwesterners Will Never, Ever Solve",1,3,9,44,2,8,2,53,0
31 Things That'll Actually Save You From The Cold,1,1,8,30,1,8,2,38,0
"Did ""Project Runway"" Choose The Right Winner",1,1,7,29,2,6,0,36,0
Reversal or Refinement? Seeking Meaning to Obama’s New Iraq Path,1,3,8,45,2,9,0,53,0
This Color Quiz Will Tell You Which Husky Should Be Your BFF,1,1,14,35,0,11,0,49,0
18 Steampunk Tattoos That Will Transport You To An Alternate Universe,1,1,10,47,0,10,2,57,0
"Which ""Suite Life Of Zack And Cody"" Character Are You Based On Your Zodiac Sign",1,1,15,48,2,14,0,63,0
21 Minimalist Ways To Store Everything In Your Home,1,1,8,33,0,8,2,41,0
61 businesses Trump has targeted on Twitter,1,3,2,33,0,6,2,35,0
We Know Which Disney Princess You Dislike The Most Based On Your Zodiac,1,1,13,46,0,12,0,59,0
10 Companies Hunting Freelancers In 2017,1,3,4,25,0,5,6,29,0
How 'The O.C.' Ruined New Year's Eve,1,3,8,17,5,6,0,25,0
Can We Guess How Much You Owe In Student Loans,1,1,10,27,0,9,0,37,0
These Award Winning Photos Of Wild Animals Are Hilarious,1,1,9,39,0,8,0,48,0
These 4 Questions Will Determine If You Should Get A Cat,1,1,10,35,0,10,1,45,0
"Karnataka CM Confuses China's 'Sichuan' With India's Siachen, Almost Starts A War",1,3,13,52,5,11,0,65,0
"J.K. Rowling Is Splitting ""Harry Potter And The Cursed Child"" Into Two Plays",1,1,14,46,4,12,0,60,0
11 Brilliant Outfits Every Man Needs To See Before Shaadi Season,1,1,10,42,0,10,2,52,0
The Terrifying Way Not Sleeping Enough Actually Changes Your Gut,1,3,10,45,0,9,0,55,0
Queen JoJo Just Slayed All Your Faves (Except Adele) With This Powerful Tonight Show Performance,1,1,16,64,2,14,0,80,0
"How Well Do You Actually Remember ""Halloweentown""",1,1,7,34,2,6,0,41,0
Washington Post: Trump’s Appointments of Military Officers May Turn U.S. Into Dictatorship,1,2,12,63,4,11,0,75,0
This Food Test Will Determine If You're Actually From Maryland,1,1,10,42,1,9,0,52,0
"China Tightens Censorship, Bans Livestreaming for Coverage of Trump’s Inauguration",1,3,8,63,2,9,0,71,0
12 Wildly Awkward Sex Confessions,1,1,4,23,0,4,2,27,0
Why are Kinder Surprise eggs illegal in the US?,1,3,5,33,1,8,0,38,0
Tom Cotton: ‘The Powerful and Elite Reap the Benefits of a Constant Influx of Low-Skill Labor’,1,3,12,63,4,15,0,75,0
Which Rihanna Era Are You,1,1,5,16,0,4,0,21,0
Whistleblower Soldier Now Leaks Video Of Jawan In Uniform Washing His Senior's Personal Car,1,3,14,63,1,13,0,77,0
"17 Reasons Brandy Is Black History, Present, And Future",1,1,8,35,2,8,2,43,0
Everything you need to know about Corinne Olympios â the newest villain on 'The Bachelor',1,3,5,68,4,14,0,73,0
"25 Of The Most Hilarious ""SpongeBob"" Quotes",1,1,7,26,2,6,2,33,0
Mindy Kaling Has Written All Of Us A List Of Her Favorite Rom-Coms,1,1,14,39,1,12,0,53,0
This New Adele Song Is Going To Slay Your Entire Existence,1,1,11,37,0,10,0,48,0
Nerd-shamers and perverts: why University Challenge is going viral,1,3,3,53,2,8,0,56,0
The Most Amazing Celebrity Biopic Transformations [Video],1,2,7,42,2,6,0,49,0
Tell Us About Yourself(ie): Taylor Kinney,1,1,6,27,3,5,0,33,0
The Top 50 CEOs… As Ranked by Their Workers,1,2,9,23,1,8,2,32,0
4 things Hollywood gets wrong about archaeologists âÂ and 2 things it gets right,1,2,2,63,2,13,2,65,0
Reminder: Before Donald Trump Ran For President He Would Randomly Tweet About Celebrities,1,1,13,63,1,12,0,76,0
"24 Things All ""Harry Potter"" Fans Can Agree On",1,1,8,26,2,8,2,34,0
"20 ""Game Of Thrones"" Questions That Are Impossible To Answer",1,1,9,38,2,9,2,47,0
21 Delicious Ways To Celebrate Mardi Gras,1,1,6,27,0,6,2,33,0
"Which ""AHS: Murder House"" Character Are You",1,1,9,25,3,6,0,34,0
15 Hilarious Tweets About Narendra Modi Hanging Out With Francois Hollande,1,1,10,52,0,10,2,62,0
How Well Do You See Color,1,1,6,14,0,5,0,20,0
Which Shia Are You Based On Your Favorite Hole,1,1,9,29,0,8,0,38,0
21 Things Everyone Who Grew Up In A Catholic Family Will Understand,1,1,11,43,0,11,2,54,0
12 Of The Most Powerful Science Photos Of This Week,1,1,9,31,0,9,2,40,0
Do We All Unknowingly Have A Gender Bias,1,1,8,25,0,7,0,33,0
A Flight Attendant’s Jet Lag Survival Guide,1,2,7,29,1,6,0,36,0
"These guys hunt for space rocks, and sell them for enormous profit to collectors",1,2,1,65,1,13,0,66,0
Midas 2017: Meet The 100 Best Venture Capitalists In The World,1,3,9,35,1,10,7,44,0
The 10 most effective ad campaigns this year,1,3,1,34,0,7,2,35,0
This car promises to be fully electric and drive itself. Will that be enough?,1,2,2,60,2,13,0,62,0
15 Americans Who Finally Found The Perfect Reason To Move To Canada,1,1,11,43,0,11,2,54,0
Here's How To Actually Get Fit When You're A College Student,1,1,11,37,2,10,0,48,0
Blood Orange releases a stunning new music video for 3 tracks,1,3,2,48,0,10,1,50,0
A Dry Cleaner Lost This Bride's 147-Year-Old-Wedding Dress. So She Turned To Facebook For Help.,1,3,17,55,6,14,3,72,0
Are You More Michael Strahan Or Kelly Ripa,1,1,8,27,0,7,0,35,0
"Which Hogwarts House Does Each ""Grey's Anatomy"" Character Belong In",1,1,10,45,3,9,0,55,0
What Should Your Yearbook Quote Be,1,1,6,23,0,5,0,29,0
There Is No Shame In Amber Rose's Morning-After Game,1,1,10,32,2,8,0,42,0
All the fiery reactions to that crazy 'Game of Thrones' twist,1,2,3,46,2,10,0,49,0
Are you being held to ransom with an engagement ring?,1,3,1,42,1,9,0,43,0
15 Mouthwatering Recipes To Try In 2016,1,1,5,22,0,6,6,27,0
Gap InternationalVoice: What Every CEO Should Know About Organic Growth,1,3,13,48,1,9,0,61,0
"Hips hurting? It's because we evolved from walking on four legs to standing up, say scientists",1,3,2,74,3,15,0,76,0
11 Things To Do When Somebody Dumps You Shittily,1,1,8,30,0,8,2,38,0
Serena Williams Went Tubing With Colton Haynes And OMFG She's Flawless,1,1,14,45,1,10,0,59,0
Which Classic PlayStation Dude Should You Take To Bed,1,1,10,35,0,8,0,45,0
Which Of Peter Pan's Lost Boys Are You,1,1,8,22,1,7,0,30,0
The Right Way to Fall ,1,3,4,13,0,5,0,17,0
23 Free Health And Fitness Apps You Need To Download Immediately,1,1,10,42,0,10,2,52,0
15 fascinating facts about North Korea,1,3,2,29,0,5,2,31,0
We Know Your Favorite Dog Breed Based On Your Favorite Snack,1,1,11,39,0,10,0,50,0
"4 Soft Skills You Need To Work On, And Why",1,2,9,22,1,9,1,31,0
Disney Princesses Singing In Their Native Languages Is Pretty Magical,1,1,10,50,0,9,0,60,0
On the roads discovering Britain's eccentric lay-by businesses,1,3,2,51,2,7,0,53,0
The top 15 American cities for young college grads,1,3,2,38,0,8,2,40,0
17 International Starbucks Items That We Need Immediately,1,1,7,41,0,7,2,48,0
Which Hoverboard Is Right For You,1,1,6,22,0,5,0,28,0
This Sparkly Silicone Beauty Blender Is About To Change The Makeup Game,1,3,12,48,0,11,0,60,0
"With Claims of C.I.A. Hacking, How to Protect Your Devices ",1,3,10,35,4,10,0,45,0
29 Giant Versions Of Your Favorite Foods You Can Make Yourself,1,1,10,40,0,10,2,50,0
Virtual Reality Is Bringing These Lost Worlds Back to Life,1,2,9,40,0,9,0,49,0
Pigskin A Blanket: NFL Conference Championship Picks,1,1,9,36,1,6,0,45,0
Rashida Jones Defended Her Hot Mom On Twitter,1,1,8,30,0,7,0,38,0
Watch 80 Years Of Halloween Costumes In Under Three Minutes,1,1,9,39,0,9,2,48,0
Katy Perry: ‘I Did More’ Than Just Kiss a Girl During Christian Upbringing,1,2,12,47,3,12,0,59,0
"Woman shot dead; great-grandson, 13, among 3 teens charged",1,3,1,42,4,8,3,43,0
Why raising interest rates this week may have been a bad idea,1,3,1,49,0,11,0,50,0
Watch Live: Trump ‘Make America Great Again’ Celebration,1,3,8,38,3,7,0,46,0
40 Celebs You Probably Didn't Know Attended Black Colleges,1,1,8,39,1,8,2,47,0
"North Carolina-Gonzaga about firsts, big men and bad ankles",1,2,3,46,2,8,0,49,0
19 Things That Look Exactly Like Caillou,1,1,6,26,0,6,2,32,0
Why Parents and Doctors Should Think About A.D.H.D. in Preschool ,1,3,11,40,4,10,0,51,0
Henry Cavill Asked Kids If They Liked Batman More Than Superman,1,1,11,42,0,10,0,53,0
Can You Name These Movies From Just Three Screenshots,1,1,9,36,0,8,0,45,0
17 Impossibly Tiny Glasses That Will Make You Feel Crazy Fancy,1,1,10,40,0,10,2,50,0
"Here's Everything We Know About Merlin On ""Once Upon A Time""",1,1,11,36,3,10,0,47,0
We Know Your Favorite Dog Breed Based On Your Taste In Men,1,1,12,35,0,11,0,47,0
"For a longer life, researchers say eat this many fruits and veggies per day",1,2,1,60,1,13,0,61,0
23 Things All '00s Green Day Fans Desperately Wanted,1,1,7,32,1,8,4,39,0
"23 ""Archer"" Jokes So Funny They'll Put You In The Danger Zone",1,1,11,34,3,11,2,45,0
This Batman-themed pregnancy announcement is a geek couple's dream,1,2,2,54,2,8,0,56,0
U.S. Tobacco Industry Rebounds From Its Near-Death Experience,1,3,10,41,3,7,0,51,0
25 Genius Tweets Guaranteed To Make You Laugh If You're Clueless About Sport,1,1,12,49,1,12,2,61,0
"Who Wears a $3,074 Bra?",1,3,3,9,3,4,4,12,0
"20 Tweets That Perfectly Capture The ""Fallout 4"" Experience",1,1,7,39,2,8,3,46,0
"Which ""Halloweentown"" Creature Are You",1,1,5,27,2,4,0,32,0
This Makeup Youtuber Had The Best Response To A Teen Who Said She Wished She Looked Like Her,1,3,18,57,0,17,0,75,0
"An Awesome Look At The Behind-The-Scenes Concept Art Of ""Aladdin""",1,1,12,40,4,9,0,52,0
21 Times Blue Ivy's Hair Stunted On Toddlers Everywhere,1,1,8,36,1,8,2,44,0
We Asked People What Their Self-Care Routines Are,1,1,9,32,1,7,0,41,0
We Got Eyebrow Extensions And The Transformations Were Unreal,1,1,9,44,0,8,0,53,0
This Woman Risked Her Life for a 59-Inch Ass,1,3,7,26,1,8,2,33,0
Excuses You Make For Not Going To The Gym,1,1,9,24,0,8,0,33,0
Widow claims husband died of 'emotional distress' after being forced to clean toilet,1,2,1,69,2,12,0,70,0
"21 Times ""The Sims"" Gave You Unrealistic Dating Expectations",1,1,8,40,2,8,2,48,0
This Is The Best Way To Netflix And Chill,1,1,9,24,0,8,0,33,0
Here's What You Should Actually Eat When You're Hungover,1,1,9,37,2,8,0,46,0
Chance the Rapper just wants us all to relax and listen to his bath playlist,1,3,2,60,0,14,0,62,0
26 Instagram Accounts That Will Give Guys Serious Style Goals,1,1,9,41,0,9,2,50,0
The 11 Best Moments From John Oliver's Hilarious Guide To The Canadian Election,1,1,12,52,1,12,2,64,0
'I was a real-life mean girl': Reformed bullies share their BIGGEST regrets in searingly honest confessions,1,2,9,79,4,15,0,88,0
Will You Win A Grammy Or An Oscar,1,1,8,18,0,7,0,26,0
Inside the world of competitive sign spinning,1,3,1,38,0,6,0,39,0
23 Undeniable Signs Your Life Revolves Around Fandoms,1,1,7,37,0,7,2,44,0
This Is Not a Drill: You Can Now Intern for Barack and Michelle Obama,1,2,11,44,1,13,0,55,0
"A timeline of Obama's best jokes, from red-hot zingers to corny puns",1,2,2,52,3,11,0,54,0
21 Gardening Projects To Get You Through Winter,1,1,7,31,0,7,2,38,0
The Internet Is Going Bonkers Over Bani J Sharing A Friendly Kiss With Friend Sapna Bhavnani,1,3,16,61,0,15,0,77,0
21 Pictures You'll Only Understand If You're Introverted,1,1,7,38,2,7,2,45,0
Why Warp Speed Will Never Happen,1,3,6,21,0,5,0,27,0
Eli Manning Has The Most Incredible New Nickname,1,1,8,33,0,7,0,41,0
Are You More Like Queen Cersei Or Queen Margaery,1,1,9,31,0,8,0,40,0
Catcher elbows runners trying to score - ESPN Video,1,3,6,36,1,8,0,42,0
What Should Your Squad Be For Halloween This Year,1,1,9,32,0,8,0,41,0
16 People Who Shouldn't Be Allowed To Fly,1,1,7,24,1,7,2,31,0
"25 jobs where you can earn more than $100,000 a year",1,2,0,32,2,10,8,32,0
Brit Awards 2017: Watch Chris Martin's George Michael tribute,1,3,7,40,2,8,4,47,0
17 Times Wednesday Addams Truly Spoke To Your Soul,1,1,8,32,0,8,2,40,0
2016’s Box-Office Winners and Losers,1,3,4,22,2,4,4,26,0
"Can You Match The ""Orphan Black"" Quote To The Clone",1,1,10,30,2,9,0,40,0
This Red Dot Test Will Determine How Easily You Get Angry,1,1,11,36,0,10,0,47,0
"Holiday cookie bakers, here’s your secret weapon: 1 dough, 5 fabulous results",1,3,1,59,4,11,2,60,0
"Exclusive–Rep. Dana Rohrabacher: General Flynn Was Treated Unfairly, Perhaps Illegally",1,3,11,62,4,9,0,73,0
A Man Walks For The First Time After Years Of Paralysis And It's Incredibly Inspiring,1,1,15,55,1,14,0,70,0
"22 Times Creed Bratton From ""The Office"" Did Something That Raised A Lot Of Questions",1,1,14,53,2,14,2,67,0
"Alexander Dugin - The one Russian linking Donald Trump, Vladimir Putin and Recep Tayyip Erdogan",1,3,11,68,2,14,0,79,0
Does Scott Give You Eastwood,1,1,5,19,0,4,0,24,0
Trump just promised the biggest tax cut in history. Here’s how big it would have to be.,1,3,2,66,3,16,0,68,0
Watch Mariah Carey Internally Scream When She's Asked To Sing,1,1,10,41,1,9,0,51,0
Ed Sheeran tour: Tickets to go on sale for additional show celebrating 10th anniversary of the O2 Arena,1,3,5,77,1,17,3,82,0
11 Charts That Are Way Too Real For Singers,1,1,8,25,0,8,2,33,0
4 Habits Every Millennial Should Bring To Work,1,3,7,31,0,7,1,38,0
27 Faces Anyone Who's Tried To Eat Healthy Will Recognize,1,1,9,36,1,9,2,45,0
"OMG You Guys, There Is A Dress Version Of Those Mermaid Pillows",1,1,14,37,1,11,0,51,0
Pulse Massacre Jihadi’s Wife Arrested on Charges of Aiding Foreign Terror Group,1,3,10,57,1,11,0,67,0
"Want to be neighbors with the Obamas, Ivanka Trump and Jeff Bezos? Here’s what it will cost you.",1,2,7,68,4,17,0,75,0
21 Instant Pot Dinner Ideas You Need To Try,1,3,8,25,0,8,2,33,0
How ‘Survivor’ and CBS Prepared for Outrage at Transgender Contestant’s Outing ,1,3,10,55,3,11,0,65,0
DJ Khaled’s Baby Is Winning Instagram [Video],1,3,8,28,3,6,0,36,0
15 Mountains To Climb For Beginners,1,1,5,23,0,5,2,28,0
Trump's travel ban leaves residents feeling like 'prisoners' in the United States,1,3,3,64,3,11,0,67,0
‘Detroit Free Press’ Sports Op-Ed Insists Players Should Become Left-Wing Activists,1,3,13,56,4,10,0,69,0
Jason Biggs' Apple Pie Legacy Lives On With His Son,1,1,10,31,1,9,0,41,0
"What the world's nations are best at, revealed in one map",1,3,1,44,2,10,0,45,0
This Man Takes The Most Stunning Photos Of Saskatchewan's Skies,1,1,10,43,1,9,0,53,0
15 Items Only Thirtysomethings Would Have In Their Amazon Shopping Cart,1,1,10,49,0,10,2,59,0
Syria war: Risking all to escape,1,3,2,24,1,5,0,26,0
Trump's executive order: Who does travel ban affect?,1,3,2,40,3,7,0,42,0
An Adorable Animals Advent Calendar: December 10,1,1,6,33,1,6,2,39,0
This Presidential Election Will Be Decided On A Coin Toss,1,3,10,38,0,9,0,48,0
"Which Character From ""The White Queen"" Are You",1,1,8,29,2,7,0,37,0
Cruises Europe's 11 most beautiful rivers,1,3,2,31,1,5,2,33,0
Watch The Evolution Of Men's Eyewear In Under Three Minutes,1,1,10,39,1,9,0,49,0
23 Little Things You Still Have Time To Do In 2015,1,1,9,25,0,10,6,34,0
Are India and Pakistan set for water wars?,1,3,3,31,1,7,0,34,0
People Show How 2016 Has Changed Them In The Year's Most Depressing Meme,1,3,12,43,1,12,4,55,0
Free college tuition could become a reality — at least in these states,1,2,1,56,1,12,0,57,0
"Dubai Guy Leaks Aamir Khan's 'Dangal', Posts The Entire Movie On His Facebook Profile",1,3,14,54,4,13,0,68,0
24 Bizarre Animals That Are Named After Celebrities,1,1,7,35,0,7,2,42,0
10 simple pranks for April Fools' Day,1,3,3,25,1,6,2,28,0
Fun And Surprising Facts That Women Themselves Don’t Know About Their Bodies,1,3,12,52,1,11,0,64,0
"There Are About 450 Terrorists In J&K, Mostly 'Locals' And It Is A Matter Of Concern For Security Agencies",1,2,19,62,4,18,3,81,0
How A 16-Year-Old Made Himself An Empire,1,2,8,22,2,6,2,30,0
A Guy Calculated How Much Money Has Been Spent Saving Matt Damon,1,1,12,41,0,11,0,53,0
22 Things You'll Only Understand If You've Been On Holiday With Your Mum,1,1,12,44,2,12,2,56,0
"Can You Answer These Tough Questions About ""The Princess Bride""",1,1,10,42,2,9,0,52,0
House Republicans Unveil Bullet Points for Obamacare Repeal,1,3,7,45,0,7,0,52,0
"42 Things I Thought During ""American Horror Story: Hotel"" Episode 7",1,1,9,42,3,10,3,51,0
"79 Thoughts We've All Had While Watching ""The Bachelor""",1,1,8,34,3,8,2,42,0
What Your Pinterest Account Looks Like Right Before The New Year,1,1,11,43,0,10,0,54,0
Tom Hanks replies to fan mail and helps woman win a bet,1,3,2,42,0,11,0,44,0
"Can You Identify The ""Game Of Thrones"" Characters By Their Eyes",1,1,11,40,2,10,0,51,0
Guy sets new world record for most finger snaps in a minute,1,3,1,47,0,11,0,48,0
How To Make Proper Nepali Goat Curry,1,1,7,23,0,6,0,30,0
"15 Signs You Are, Without A Doubt, A Target Mom",1,2,9,25,2,9,2,34,0
Try the ‘Dressing Room Challenge’ to Feel More Confident Shopping,1,3,8,46,2,9,0,54,0
Can You Pass The Most Viral Quiz Ever,1,1,8,22,0,7,0,30,0
We Know What You Play In Your Private Sessions,1,1,9,29,0,8,0,38,0
"The Best Books Of 2015, According To Goodreads",1,1,7,27,1,7,4,34,0
Cytomegalovirus: The most common infectious disease in babies you may never have heard of,1,3,2,73,1,13,0,75,0
13 Ways To Secretly Nap At The Office,1,1,7,21,0,7,2,28,0
This optical illusion is confusing the internet – can you work it out? ,1,3,1,55,2,13,0,56,0
Did the Warriors Diss Russell Westbrook on Twitter Before Matchup With Kevin Durant?,1,2,11,60,1,12,0,71,0
The world's fastest growing religion? Islam,1,3,2,34,2,5,0,36,0
Syrian Refugee Hala Kamil Made A Powerful Red Carpet Statement And Here's Why It's Important,1,3,15,61,2,14,0,76,0
"Of Course Louis CK Jokes About Suicide, Abortion & Race In His New Netflix Special",1,3,15,51,2,14,0,66,0
Signs You're An Old Married Couple,1,1,6,22,1,5,0,28,0
15 Holiday Treats That Are Basically The Reason For The Season,1,1,10,40,0,10,2,50,0
Here's What's Actually Going On With The Missing Black Girls In DC,1,3,13,40,2,11,0,53,0
The 27 cities with the worst quality of life in the world,1,3,1,43,0,11,2,44,0
Get Ready For A Bond Meltdown,1,3,6,18,0,5,0,24,0
The #InMySkinIWin Hashtag Proves That All Skin Is Beautiful,1,1,13,37,1,8,0,50,0
"15 Manga Series You Should Read, Based On Your Favorite Books",1,1,10,38,1,10,2,48,0
He’s going home for Christmas. But most people at his prestigious college have no idea what he’s facing there.,1,3,3,85,4,18,0,88,0
7 pro tips to help you learn how to cook in 2017,1,2,0,32,0,11,5,32,0
17 Times Shonda Rhimes Ruled The Damn World,1,1,7,27,0,7,2,34,0
ABC’s ‘Nightline’ Issues Correction After Misrepresenting Fleischer to Make Him Seem More Critical of Spicer,1,3,15,76,3,14,0,91,0
This Man Has Been Growing His Fingernails For 62 Years And It's Crazy,1,1,12,42,1,12,2,54,0
17 Situations That Are Made Better By The Holidays,1,1,8,32,0,8,2,40,0
19 Unbelivably Rude Texts From Your Hangover,1,1,6,30,0,6,2,36,0
23 Easy Peasy Packed Lunch Ideas,1,1,5,20,0,5,2,25,0
Report: Trump Deporting 4K Somali Migrants,1,2,6,29,1,5,1,35,0
What I Learned From My Neuroatypical Partner,1,1,7,31,0,6,0,38,0
Meet The Male Model Who Is Working To Help People Learn To Love Their Skin,1,1,15,45,0,14,0,60,0
His Job Went To Mexico And All He Got Was This Lousy Severance,1,3,13,37,0,12,0,50,0
We Know Where You Left Your Keys,1,1,7,19,0,6,0,26,0
"Annoyed By Flight Delay, Man Tweets 'Hijack' To PM Modi, Gets Deplaned And Arrested",1,3,15,51,4,13,0,66,0
"Finally, a Politician With a Good Idea: Paid F*ck Breaks for Workers",1,3,9,45,3,11,0,54,0
This Is What Drake Songs Would Be Titled If They Were Honest,1,1,12,37,0,11,0,49,0
25 Presents For People Who Fucking Love Stationery,1,1,7,34,0,7,2,41,0
Depending On How You Look At It Scientology Had A Great Year,1,1,12,37,0,11,0,49,0
"Sorry, no refunds: why do men think they should get their money back after a bad date? ",1,3,1,66,3,17,0,67,0
These Illustrations Capture The Joy Of Living Alone,1,1,8,36,0,7,0,44,0
Casual Reminder: There's No Such Thing As Reverse Racism,1,3,9,37,2,8,0,46,0
This Gran Can: Reckon you're too old to get fit? These middle-aged women will make you think again,1,2,5,72,4,17,0,77,0
24 Jokes You Won’t Get If You Don’t Wear Glasses,1,3,9,26,2,9,2,35,0
"Hold Up, Did You Know That Channing Tatum Can Sing Like An Angel",1,1,13,38,1,12,0,51,0
Bus driver buys hats and gloves for children in need on his route,1,3,1,52,0,12,0,53,0
Meet The Pakistani-American Artist Taking A Stand To Normalise Body Hair,1,1,12,49,1,10,0,61,0
Will Apple help get people addicted to news?,1,2,2,34,1,7,0,36,0
19 Breakfasts That Changed The Game In 2015,1,1,6,24,0,7,6,30,0
How A Fake Viral News Story Wrecked Three People’s Lives,1,2,10,36,1,9,0,46,0
17 Depressingly Real Struggles Of Dating In Generation Text,1,1,8,41,0,8,2,49,0
When You're Have To Have The Newest Thing,1,1,8,25,1,7,0,33,0
Seth Meyers has a lot of questions about Melania Trump's  'Vanity Fair' cover,1,3,6,55,3,13,0,61,0
We Know Your Bodily Talent Based On Three Questions,1,1,9,34,0,8,0,43,0
21 Struggles Everyone Who Has Done A Dissertation Will Understand,1,1,9,45,0,9,2,54,0
NYT’s Thomas Friedman: ‘I Fear That a Lot of Americans Are Getting Addicted’ to Trump,1,2,14,53,4,14,0,67,0
31 Gorgeous Non-Diamond Engagement Rings You’ll Totally Fall For,1,3,9,43,2,8,2,52,0
13 Moments You'll Only Understand If You Have A Mexican Mom,1,1,10,36,1,10,2,46,0
17 Passive-Aggressive People Who Are More Savage Than You,1,3,9,37,1,8,2,46,0
Star Wars: How to bluff your way through the new Rogue One movie,1,2,5,46,1,12,0,51,0
"You Can Make ""Harry Potter"" Hilarious By Replacing Every ""Wand"" With ""Penis""",1,1,12,47,6,11,0,59,0
This Really Hot Guy Looks Like The Love Child Of Zayn And Liam From One Direction,1,1,16,50,0,15,0,66,0
The Most Annoying Parts Of Halloween,1,1,6,25,0,5,0,31,0
This Is What Life Was Like When Justin Bieber's Nudes Leaked,1,1,11,38,1,10,0,49,0
"Report: Maddow’s Trump Tax Scoop Sparks Battle Between NBC, MSNBC Bosses",1,2,17,42,3,10,0,59,0
16 Truths For People Who Get Major Anxiety When Texting,1,1,9,35,0,9,2,44,0
There's a tiny red button on Trump's desk â here's what happens when he presses it,1,3,2,62,5,15,0,64,0
19 Insanely Cute Trays That Will Help Keep Your Things Organized,1,1,10,42,0,10,2,52,0
You Need To See This Insanely Sexy Cartoon Lion,1,1,9,30,0,8,0,39,0
16 Pictures That Will Make You Want To Move To Sri Lanka,1,1,11,32,0,11,2,43,0
Snipers and green tea on Helmand's front line,1,3,2,35,1,7,0,37,0
What's The Biggest Misconception About Being A Military Spouse,1,1,9,44,1,8,0,53,0
Snowy hill proves to be every car's worst nightmare,1,2,1,41,1,8,0,42,0
Which Subtle Tattoo Should You Get Based On Your Zodiac Sign,1,1,11,39,0,10,0,50,0
16 Indie Songs From The Early 2000s You Totally Forgot About,1,1,9,35,0,10,6,44,0
The weird names the CIA gives its hacking tools,1,2,4,35,0,8,0,39,0
31 Kids Who Are Too Honest For Their Own Good,1,1,9,25,0,9,2,34,0
Olsen Twin Or Stylish Senior? You Decide.,1,3,7,26,2,6,0,33,0
Couple reveals pregnancy with twins in amazing photo with 452 IVF needles - Yahoo,1,2,5,59,1,13,3,64,0
New Nike Kobe AD Releasing Next Week,1,3,8,22,0,6,0,30,0
11-Year-Old Girl And Her Dog Heroically Save A Mother Goat And Her Baby From Dying In The Snow!,1,3,19,54,3,17,2,73,0
Watch This Tiny Puppy Get A Massage For 30 Minutes,1,1,9,30,0,9,2,39,0
11 super-smart technologies in the 2017 Mercedes E-Class,1,3,3,38,2,7,6,41,0
17 YouTube Channels That Will Teach You A Damn Thing,1,1,10,31,0,9,2,41,0
The biggest shopping day of the holiday season is still to come,1,3,1,51,0,11,0,52,0
Which Music Video Starring Gigi Hadid Are You,1,1,8,30,0,7,0,38,0
"The World Watched Marlene Pinnock Get Beaten By A Cop, So Why Is She Still On The Streets",1,1,18,53,1,17,0,71,0
A Bar In Kerala Just Made A 250m-Long Maze Wall To Beat Supreme Court's 500m Rule,1,3,15,43,2,15,6,58,0
What you'll see happen at the Final Four before it happens,1,2,3,44,1,10,0,47,0
These are the two worst high dives you will ever see,1,2,1,41,0,10,0,42,0
30 Under 30 2017: Sports,1,3,2,9,1,4,8,11,0
19 Times Drake Had The Last Laugh,1,1,6,19,0,6,2,25,0
The Ten Best Songs That Sample Tears for Fears,1,2,8,30,0,8,0,38,0
Poll: Half of College Students Believe Their Student Loans Will Be Forgiven,1,2,11,52,1,11,0,63,0
26 Things You'll Just Get If You've Ever Been Heartbroken,1,1,9,35,2,9,2,44,0
8 TED talks that will change how you think about human psychology,1,3,3,50,0,11,1,53,0
8 apps that can help you improve your mental and physical health,1,3,0,52,0,11,1,52,0
Raise Your Kitchen Game With The BuzzFeed Food Newsletter,1,1,10,39,0,8,0,49,0
"Israeli Minister on UN Vote, Kerry Speech: ‘We Don’t Need This America’",1,3,12,43,5,11,0,55,0
A Year of Surprises: A Look Back at NBC News’ Best Features of 2016,1,2,12,36,2,13,4,48,0
'Outlander' Season 3: 10 burning questions we have about Claire and Jamie's reunion,1,2,4,60,4,12,3,64,0
"The Cast Of ""Maze Runner"" Imitated Dylan O'Brien On The Red Carpet",1,1,13,39,3,11,0,52,0
20 Gifts Every Wannabe Mermaid Needs To Ask For This Year,1,1,10,35,0,10,2,45,0
15 People Who Brought Laziness To A Whole New Level,1,1,9,31,0,9,2,40,0
How The Shale Boom Turned The World Upside Down,1,3,9,30,0,8,0,39,0
"This Egg, Bean, And Cheese Pita Pizza Is Better Than A Burrito",1,1,12,37,2,11,0,49,0
The Biggest New Car Flops Of 2016,1,3,6,17,0,6,4,23,0
‘Our House Is Down!’: Heartbreaking 911 Calls From Families Killed in Texas Floods,1,3,11,52,4,12,3,63,0
"The ""Firefly"" Cast Spent A Lot Of Time In Bed Together On Set",1,1,13,34,2,12,0,47,0
Can We Guess Where You Are In 5 Questions?,1,3,8,24,1,8,1,32,0
How the Stars Spent Christmas 2016,1,3,4,21,0,5,4,25,0
13 Times Headphones Were On A Mission To Destroy Our Beauty,1,1,10,37,0,10,2,47,0
Fan trolls Andre Iguodala about 'The Block' before upcoming birthday,1,3,5,52,2,9,0,57,0
This is what happens when Donald Trump attacks a private citizen on Twitter,1,2,4,59,0,12,0,63,0
31 Things That Didn't Look At All Like Penises In 2015,1,1,9,28,1,10,6,37,0
19 Memes That Totally Made Parents Laugh In 2015,1,1,7,27,0,8,6,34,0
22 Pictures That Prove There's No Place On Earth Like Planet Fitness,1,1,11,43,1,11,2,54,0
Did Victoria Beckham’s ‘Carpool Karaoke’ Appearance Tick Off Mel B?,1,3,10,44,4,9,0,54,0
'Emotional' Jim Harbaugh greets pope during Wolverines' visit to Vatican City,1,3,6,58,3,10,0,64,0
7 Things We Want To Hear On J. Cole's '4 Your Eyez Only',1,3,11,27,4,12,2,38,0
This Video Beautifully Shows How Difficult It Can Be To Read Lips,1,1,12,42,0,11,0,54,0
This Question Will Determine What Style Glasses You Should Get,1,1,10,43,0,9,0,53,0
"No Time For A Workout? No Problem, Just Switch To Brown Rice As It Has The Same Effect As A 30-Minute Brisk Walk!",1,2,23,62,4,22,2,85,0
How Thanksgiving Are You,1,1,4,17,0,3,0,21,0
"Fans Sang ""Happy Birthday"" To David Bowie Just Days Before His Death",1,1,12,43,2,11,0,55,0
The fashion industry really wants you to wear pajamas on the street. Don’t do it!,1,3,2,62,3,14,0,64,0
France Warns Trump: Moving U.S. Embassy to Jerusalem A ‘Provocation’,1,3,10,44,5,9,0,54,0
"20 Ways To Live Forever, According To The News",1,1,8,27,1,8,2,35,0
23 Adorable Pins To Give Someone You Love,1,1,7,25,0,7,2,32,0
The 10 hardest Oxbridge degrees to get accepted on,1,3,2,38,0,8,2,40,0
17 Things People Who Don't Need Glasses Will Never Understand,1,1,9,40,1,9,2,49,0
"David Parnes And James Harris Take Our ""Which 'Million Dollar Listing' Agent Are You?"" Quiz",1,1,15,57,5,14,0,72,0
11 Valentine's gifts for your f*ck buddy,1,2,1,29,2,6,2,30,0
Hero mom sends her son a care package full of garbage,1,3,1,42,0,10,0,43,0
What Kind Of Relationship Do You Deserve Based On Your Personality,1,1,11,45,0,10,0,56,0
21 Bold AF Hair Colors To Try In 2016,1,1,8,15,0,8,6,23,0
"12 Filthy French Euphemisms, Translated Literally",1,1,5,36,1,5,2,41,0
31 Books That Will Restore Your Faith In Humanity,1,1,8,31,0,8,2,39,0
40 Yankee Candles We're Really Glad Don't Exist,1,1,7,29,2,7,2,36,0
John Krasinski Talking About How Much He Loves Emily Blunt Will Destroy You,1,1,13,50,0,12,0,63,0
24 Ways To Have The Creepy AF Bedroom Of Your Dreams,1,1,11,29,0,10,2,40,0
The Magical World Of Underground Night Personalities,1,1,7,39,0,6,0,46,0
"Which ""Big Brother 17"" House Guest Is The Best",1,1,8,26,2,8,2,34,0
17 Wicked Items That'll Bring Out Your Inner Disney Villain,1,1,9,38,1,9,2,47,0
An Inside View From Nine Months On The Campaign Trail With President Trump,1,3,13,49,0,12,0,62,0
Golden Globes Nominations: Snubs and Surprises,1,3,5,35,1,5,0,40,0
"Issa Rae's ""Insecure"" Is Coming To HBO At Long Last",1,1,12,27,3,9,0,39,0
What will change for your finances in 2017,1,3,1,30,0,7,4,31,0
Destinations 19 photographs that prove Japan is the most beautiful place on Earth right now,1,3,3,72,0,14,2,75,0
21 Little Joys Tall People Will Never Get To Experience,1,1,9,35,0,9,2,44,0
A New Dad Proposed To His Girlfriend Right After The Birth Of Their Baby,1,1,14,45,0,13,0,59,0
"From Prince Tees to Vivienne Westwood, These Are 5 Vintage Trends Making a Comeback in 2017",1,3,11,59,1,15,5,70,0
The 27 Best Animal Tweets From 2015,1,1,5,18,0,6,6,23,0
Can You Wear Camouflage to the Office?,1,3,5,26,1,6,0,31,0
"33 Times ""Spongebob"" Fans Killed It On Tumblr",1,1,7,27,2,7,2,34,0
32 Times Lady Gaga Slayed The Shit Out Of Us On Instagram,1,1,11,33,0,11,2,44,0
Pick A New Year's Cat To Find Out What 2016 Holds For You,1,1,12,28,1,12,4,40,0
17 Life-Changing Beauty Products That Are Worth The Investment,1,3,9,42,1,8,2,51,0
13 Black Women Share Their Postpartum Depression Experience,1,1,7,43,0,7,2,50,0
P.K. Subban crashed a street hockey game -- and made this young fan's day,1,2,3,52,5,13,0,55,0
How to Safely Defend Yourself From Police Brutality,1,3,7,37,0,7,0,44,0
How to get the stained glass look in your own home,1,2,1,39,0,10,0,40,0
Florida senator resigns amid outcry over racist remarks,1,3,1,47,0,7,0,48,0
23 Mexican Breakfasts That'll Make Every Morning A Freakin' Fiesta,1,2,9,44,2,9,2,53,0
17 Things Only '00s Disney Kids Will Remember,1,1,6,27,1,7,4,33,0
"Parents Are Furious at This Bestselling Author for Buying $23,600 Worth of ‘Hatchimals’",1,2,9,57,4,12,5,66,0
February recap: 5 trending topics to spark watercooler conversation (Sponsored Content by belVita),1,3,4,78,3,12,1,82,0
The curious case of a hidden abbot and a besieged temple,1,3,1,45,0,10,0,46,0
Pool party organizer: He didn't have to use aggression - CNN Video,1,2,6,46,3,11,0,52,0
Israel and the Palestinians: What are alternatives to a two-state solution?,1,3,3,59,3,10,0,62,0
Britney Spears 9 Years Ago Vs. Today,1,1,6,22,1,6,1,28,0
Can We Talk About Mahershala Ali For A Minute?,1,3,9,28,1,8,0,37,0
This Man And His Wolfdog Will Make You Want To Go Hiking Right Now,1,1,14,39,0,13,0,53,0
Couples Who Met On Dating Apps Look Back On Their Very First Messages,1,1,13,44,0,12,0,57,0
19 People Who Were Thirsty For Anderson Cooper During The Democratic Debate,1,1,11,51,0,11,2,62,0
Politics Live – readers' edition: Tuesday 11 April,1,2,4,34,3,7,2,38,0
"Gujarat Boy Who Went Missing During 2001 Earthquake, Returns 16 Years Later As Monk",1,3,12,51,1,13,6,63,0
U.S. Soccer Star Abby Wambach: Playing on Turf a ‘Nightmare’,1,2,9,37,5,9,0,46,0
Here’s what Metro’s Inauguration Day and Women’s March ridership numbers really mean,1,3,6,64,3,11,0,70,0
This Color Test Will Determine How Old Your Soul Is,1,1,10,32,0,9,0,42,0
Can You Guess The Celebrity By Their First Tweet,1,1,9,31,0,8,0,40,0
"The New ""Alice In Wonderland"" Movie Looks Really Creepy",1,1,9,36,2,8,0,45,0
Could an app really replace the contraceptive pill?,1,3,1,42,1,7,0,43,0
"#OscarsSoWhite Creator ‘Still Waiting’ for LGBT Romantic Comedies, Disabled Superheroes",1,3,14,60,4,9,0,74,0
We Tested Four Different Mascaras To See Which One Lasts The Longest,1,1,12,45,0,11,0,57,0
Visit Myanmar’s Capital Now! There’s Still a Lot Not to See,1,3,9,37,3,10,0,46,0
Touching moment five-year-old girl is reuinted with her sailor father after six months,1,3,1,71,2,12,0,72,0
Dan Savage: Melania Trump Is ‘Ugly on the Inside’,1,3,7,31,3,8,0,38,0
Show Us The Best Halloween Costume You've Ever Made,1,1,9,33,1,8,0,42,0
Latinas Search Through The #Latina Hashtag And This Is What Happened,1,1,11,46,1,10,0,57,0
17 Kids Who Aren’t Playing Around,1,3,5,20,1,5,2,25,0
The Wiz Live! Has Made Hate-Watching Obsolete,1,1,8,29,2,6,0,37,0
15 Insanely Cool Gifts No Sane Person Can Refuse,1,1,8,30,0,8,2,38,0
Are You More Meredith Grey Or Izzie Stevens,1,1,8,28,0,7,0,36,0
I Tried 5 Ikea Hacks To See How Cheap And Easy They Really Are,1,1,13,35,0,13,1,48,0
23 Things You’ll Only Get If You’re 50% Hella Organised 50% Hot Mess,1,3,10,36,4,12,6,46,0
"Corset training, a celebrity weight loss trend, largely busted",1,3,1,51,2,8,0,52,0
This Band Surprised Dancers Auditioning For Their Music Video In The Best Way,1,1,13,52,0,12,0,65,0
"19 Times Lindsay From ""You're The Worst"" Was You AF",1,1,10,27,3,9,2,37,0
How to (Seriously) Upgrade Your Gin and Tonic,1,3,6,30,2,7,0,36,0
"This Is What ""Home Alone"" Would Be Like If It Were Set In 2015",1,1,13,30,2,13,4,43,0
"Woman Makes Obscene Video With Man At Gunpoint, Then Blackmails Him For Rs 20 Lakh!",1,3,14,51,2,14,2,65,0
Pakistani Loco Drivers In Trouble After Stopping Their Train In Front Of A Dhaba ...To Eat Pakoras,1,3,17,62,3,16,0,79,0
The 13 best places to eat ramen in New York City,1,3,4,32,0,10,2,36,0
Anne Hathaway Can't Win,1,1,4,15,1,3,0,19,0
18 Unsettling Wikipedia Pages That'll Totally Freak You Out,1,1,8,40,1,8,2,48,0
"India was gripped by fictional girl, as its search trends for 2016 reveal",1,3,1,55,1,12,4,56,0
Who will be Twitter's next CEO? Volunteers include rapper Snoop Dogg,1,2,8,48,2,10,0,56,0
If Donald Trump Tweets Were Motivational Posters,1,1,7,35,0,6,0,42,0
"FKA Twigs Covers Sia's ""Elastic Heart"" And It's The Most Perfect Thing Ever",1,1,15,44,4,12,0,59,0
"Which ""Harry Potter"" Movie Should You Watch Right Now",1,1,9,34,2,8,0,43,0
Vote: Which finalist will win this year's Heisman?,1,2,3,37,3,7,0,40,0
Obama Warns of ‘Tribalism’ At Pearl Harbor: ‘Resist the Urge to Demonize Those Who Are Different’,1,2,13,64,5,15,0,77,0
If Dentists Were Honest,1,1,4,16,0,3,0,20,0
Here's Proof That Cats Know They're The Boss Of Everyone,1,1,10,35,2,9,0,45,0
What Movie Do You Use To Prove You Have Good Taste,1,1,11,29,0,10,0,40,0
Is the Beauty Industry Finally Starting to Recognize Curvy Models?,1,2,8,48,1,9,0,56,0
California to Declare ‘Legal War’ Against Trump Administration,1,3,7,46,2,7,0,53,0
"Ramadan 2015: As holy month approaches, debate emerges over how long Muslims in northern Europe should fast",1,3,4,81,2,16,4,85,0
Dudley The Cow Got A New Prosthetic Leg And Is So Happy Now,1,1,13,34,0,12,0,47,0
Debt-Free RNC Raised $6 Million More Than 2012 In Final Weeks of Campaign Season,1,3,14,46,2,13,5,60,0
This Dog And Baby React The Same Exact Way To Daddy Coming Home,1,1,13,38,0,12,0,51,0
18 Hilarious Bollywood Movie Reviews From Commenters On Torrent Sites,1,1,9,49,0,9,2,58,0
"11 Times ""$ave Dat Money"" Was The Song Of Our Generation",1,1,9,32,3,10,2,41,0
How Well Do You Know The Ninja Turtles,1,1,8,23,0,7,0,31,0
One Chart Showing What Goldman Expects Trump to Accomplish This Year,1,3,10,48,0,10,0,58,0
5 Fixable Job Search Mistakes That Are Holding You Back From Interviews,1,3,11,48,0,11,1,59,0
"Every ""The Office"" Relationship, Definitively Ranked",1,1,6,38,3,5,0,44,0
Blockbusters assemble: can the mega movie survive the digital era?,1,3,1,54,2,9,0,55,0
19 Pictures That Perfectly Sum Up Becoming An Adult,1,1,8,33,0,8,2,41,0
24 Guys Who Totally Rocked The Man Bun In 2015,1,1,8,23,0,9,6,31,0
What's The Most Embarrassing Thing Your Dad Has Ever Done,1,1,10,37,1,9,0,47,0
What's The Best Pizza Place You've Ever Eaten At In The U.S,1,1,13,32,3,11,0,45,0
Three Questions To Ask Before Quitting Your Job,1,2,8,32,0,7,0,40,0
What ‘La La Land’ and ‘Fifty Shades’ Get Wrong About Love,1,3,10,33,4,10,0,43,0
"'Message in a bottle' found 9,000 miles away with a tech twist",1,2,1,43,3,11,4,44,0
22 Things You Should Tell Your Best Friend Right Now,1,1,9,32,0,9,2,41,0
Here's How You Can Actually Find The Cheapest Flights Ever,1,1,10,38,1,9,0,48,0
27 Struggles People Who Don't Have Big Boobs Will Never Understand,1,1,10,43,1,10,2,53,0
Women Are Turning Viral Memes Into Eye Makeup And It’s Hilarious,1,2,11,42,1,10,0,53,0
The Most Practical Cars And Crossovers For 2017,1,2,7,29,0,7,4,36,0
"24 Illustrations That Will Make You Really, Really Nostalgic About School",1,2,10,50,1,10,2,60,0
One little drop of your blood may someday predict how long you’ll live,1,2,1,56,1,12,0,57,0
A New View of the Refugee Crisis,1,3,5,21,0,6,0,26,0
10 Best Music Memes of 2016,1,2,3,13,0,5,6,16,0
22 Pictures That Prove 2004 Was A Truly Different Time,1,3,8,31,0,9,6,39,0
Science Says These Five Things Prove You're Smart,1,2,8,33,1,7,0,41,0
"21 Steps To Becoming Obsessed With ""Hamilton""",1,1,6,29,2,6,2,35,0
Airbus Reveals New Modular Cabin Concept That Could Change How We Fly,1,2,12,46,0,11,0,58,0
Some Little Girls Gave Grown Women Dating Advice And It Was Pretty Fantastic,1,1,13,51,0,12,0,64,0
7 Easy Dinner Ideas To Try This Week,1,1,7,21,0,7,1,28,0
Aleppo filmmaker: 'This could be my last message',1,3,2,37,3,7,0,39,0
3 things that could be making you unhappy,1,2,0,33,0,7,1,33,0
Boys Noize Shares Unreleased Remixes in 2016 Recap Video: Watch,1,3,8,41,1,9,4,49,0
19 Parents Share Their Most Nightmarish Trick-Or-Treating Stories,1,1,9,45,2,7,2,54,0
Which TV Couple Are You And Your Significant Other,1,1,10,32,0,8,0,42,0
What does the U.S. import from Mexico? A whole lot,1,2,5,33,3,9,0,38,0
These Photos Of Hot Men And Cats Will Make You Feel Things,1,1,12,35,0,11,0,47,0
What's The Most Embarrassing Thing You've Done At The Doctor's Office,1,1,11,45,3,10,0,56,0
"Oh My God, Rob Kardashian Might Be Dating Tyga's Ex",1,1,10,30,2,9,0,40,0
27 Things So Gloriously Awkward You Won't Be Able To Look Away,1,1,11,37,1,11,2,48,0
7 FinTech Companies Helping Millennials Dominate Their Finances This Year,1,3,10,53,0,9,1,63,0
Carrie Fisher's French Bulldog Will Brighten Your Day,1,1,8,37,1,7,0,45,0
This Adorable And Friendly Quokka Can't Get Enough Of The Man Who Took A Selfie With Him,1,3,17,54,1,16,0,71,0
How Many Iconic '70s Films Have You Seen,1,1,7,23,1,7,2,30,0
Here's The Top Ten Most Liked Instagram Posts Of 2015,1,1,9,30,1,9,4,39,0
"Which Character From ""Red Oaks"" Are You",1,1,7,24,2,6,0,31,0
Do You Know These Disney Films Based On Just Three Words,1,1,11,35,0,10,0,46,0
Hilary Duff Chopped Off Her Hair And Now You're Really Going To Want A Bob,1,1,15,44,1,14,0,59,0
7 Ways Men Think All Women's Legs Can Move Because Of Bad Porn,1,1,12,36,1,12,1,48,0
The BuzzFeed Love Test,1,1,5,14,0,3,0,19,0
16 Young Indians You Should Watch Out For In 2016,1,1,8,26,0,9,6,34,0
Two Bleeding People Left To Die In One Week. Does India Need A 'Duty To Help' Law?,1,3,17,45,4,16,0,62,0
Latino Vs Hispanic,1,1,3,13,0,2,0,16,0
Give It To Me Straight: Is This Thing A Sandwich Or Not?,1,2,12,31,2,11,0,43,0
Listen To Women Talk Honestly About Loving Their Bodies,1,1,9,38,0,8,0,47,0
25 Recipes That Prove Bacon Is The True Star Of Thanksgiving,1,1,10,38,0,10,2,48,0
11 Times Tumblr Combined Your Love Of Animals And Video Games,1,1,10,39,0,10,2,49,0
Here We Go Again: Obama Sends Arms Trade Treaty to Senate for Ratification,1,3,11,50,1,12,0,61,0
We Can Predict Your Romantic Future With Just 3 Questions About Your Taste In Bollywood Movies,1,1,15,63,0,15,1,78,0
"Listen To This Incredible Isolated Vocal Of David Bowie Singing ""Starman""",1,1,11,50,2,10,0,61,0
This poster of celebrities the world has lost in 2016 is just heartbreaking The list,1,2,2,64,0,14,4,66,0
"Then Vs. Now: The Cast Of ""Aquamarine""",1,1,7,21,4,6,0,28,0
Are Night Owls Better Off Changing Their Sleep Patterns to Be Healthier?,1,2,11,49,1,11,0,60,0
What Were You Like In High School,1,1,7,20,0,6,0,27,0
This Guy Totally Nailed What A Modern Day Aladdin Would Look Like,1,1,12,42,0,11,0,54,0
The unmistakable anatomy of a President Trump flip-flop,1,3,3,44,1,7,0,47,0
Can We Guess What Your Barista Writes On Your Cup,1,1,10,30,0,9,0,40,0
People Try Snapchat's New Selfie Filters,1,1,6,28,1,5,0,34,0
31 Elf On The Shelf Ideas Guaranteed To Win Christmas,1,1,9,33,0,9,2,42,0
What Crazy Sex Tip Should You Try Based On Your Zodiac Sign,1,1,12,36,0,11,0,48,0
22 BuzzFeed Readers Share How They Actually Spent The Snowstorm,1,1,10,42,0,9,2,52,0
When You're Bored At Work - YouTube,1,3,7,20,2,6,0,27,0
It's 2016 And Britney Spears Now Does A Backflip During Her Vegas Show,1,1,12,41,1,12,4,53,0
"Dividend stocks aren't as great as they used to be (KO, MO)",1,3,5,39,4,11,0,44,0
When You Just Can't Focus,1,1,5,15,1,4,0,20,0
31 Of The Most Useful Things To Subscribe To On Amazon,1,3,10,32,0,10,2,42,0
What's The Best Vacation Spot For When You Need To Figure Out Your Life,1,1,14,43,1,13,0,57,0
6 Struggles Only Atheists Understand,1,1,4,27,0,4,1,31,0
This Is How Indian And Bangladeshi Border Guards Celebrated Holi Together,1,3,11,52,0,10,0,63,0
Pak Defense Minister Threatens To Nuke Israel After Reading A Fake News Article!,1,2,13,54,1,12,0,67,0
United kicks bride and groom heading for their wedding off flight,1,3,1,54,0,10,0,55,0
Alys Fowler: how to give your seedlings the best start in life,1,3,2,48,1,11,0,50,0
Australian man died after 'courageous leap from cruise ship to save girlfriend',1,2,1,65,2,11,0,66,0
Can You Identify The Disney Character By Just Their Eyes,1,1,10,37,0,9,0,47,0
17 Animals That Have Had Enough Of 2016,1,3,6,20,0,7,6,26,0
"ISIS still holds thousands of slaves, giving brisk business to human smugglers",1,2,4,62,1,11,0,66,0
How Much Do You Actually Know About Vegetarian Food,1,1,9,34,0,8,0,43,0
Why Bond Bears Look Poised to Come Out of Hibernation...Again,1,3,9,40,3,9,0,49,0
29 Incredibly Delicious Ways To Eat Eggs For Every Meal,1,1,9,35,0,9,2,44,0
Big Government Republicans Rebuke Trump Budget,1,2,6,35,0,5,0,41,0
23 Times North Carolina Had No Damn Chill,1,1,7,25,0,7,2,32,0
"Donald Trump, Aleppo, Golden Globes: Your Monday Evening Briefing ",1,3,9,45,3,9,0,54,0
Now We Know Why Sasha Obama Skipped Dad's Farewell Address  Insider,1,2,11,44,1,11,0,55,0
21 Ways To Completely Win At Dating,1,1,6,21,0,6,2,27,0
31 Hilarious Tweets That Totally Sum Up The Crappy Year That 2016 Was,1,3,11,40,0,12,6,51,0
19 Celtic Names So Beautiful You'll Want To Have Children,1,1,9,36,1,9,2,45,0
North West And Penelope Disick Were The Best Squad Of 2015,1,1,10,34,0,10,4,44,0
10 challenges of 2016 that taught us teens still rule the world,1,3,0,46,0,11,6,46,0
Here's What Happened When Dudes Tried On Sanitary Pads,1,1,9,36,1,8,0,45,0
Mark Ruffalo And Jared Leto Both Went To Comic-Con Disguised In Hideous Masks,1,1,14,50,1,12,0,64,0
BOKHARI: Bill Nye Destroyed His ‘Scientific’ Credibility In A Single Netflix Episode,1,3,18,52,3,11,0,70,0
April the giraffe: Pregnant woman's spoof video goes viral,1,3,2,46,2,8,0,48,0
Can We Guess Your Age Based On Your Taste In M&Ms,1,1,12,26,1,10,0,38,0
"23 Times ""30 Rock"" Perfectly Summed Up Finals Week",1,1,7,29,2,8,4,36,0
Nostalgic! TV's Iconic Bahus Parvati And Tulsi Pose For An Epic Selfie With Ekta Kapoor,1,2,16,55,2,14,0,71,0
"Which ""Boogie Nights"" Character Is Your Kindred Spirit",1,1,8,37,2,7,0,45,0
What Kind Of Candy Are You Actually,1,1,7,22,0,6,0,29,0
How Much Of A Stereotypical Person Are You,1,1,8,27,0,7,0,35,0
27 Tweets That Will Make Tall People Laugh Out Loud,1,1,9,31,0,9,2,40,0
In Trump They Trust: Inside The Global Web Of Partners Cashing In On The President,1,3,15,52,1,14,0,67,0
What Sport Would You Compete In During The Olympics,1,1,9,34,0,8,0,43,0
"British University Fined £400,000 For Almost Killing Students During 'Coffee Experiment'",1,3,10,58,4,10,6,68,0
How George Michael’s Wham! baffled Communist China and inspired its youth,1,3,6,55,2,10,0,61,0
What New Song Should Be Your Jam This Weekend,1,1,9,28,0,8,0,37,0
People Try Virtual Reality Porn For The First Time,1,1,9,33,0,8,0,42,0
Watch E! News Now Season 2017 Excerpt Free Online - Inside Beyonce's Fabulous Life | Yahoo View,1,3,14,57,4,16,4,71,0
Tesla Changes Its Name: Don't Try This At Home,1,2,9,27,2,8,0,36,0
11 Things No One Tells Women About Relationships In Their Twenties,1,1,10,44,0,10,2,54,0
Ukip candidate Gisella Allen says she would bring back the death penalty by guillotine,1,3,3,70,0,13,0,73,0
What Should Your Drunk Food Be,1,1,6,19,0,5,0,25,0
Black Students at University of Michigan Demand Segregated Space,1,2,7,49,0,8,0,56,0
The 10 hottest housing markets for 2017,1,2,1,26,0,6,6,27,0
Business Interests Benefitting from Castro Regime Urge Trump to Be Friendly to Cuba,1,2,10,61,0,12,0,71,0
22-YO Jaipur Woman Files Fake Gangrape Report To Blackmail A Youth,1,3,12,41,1,10,2,53,0
21 Times Pit Bulls Were Good People,1,1,6,21,0,6,2,27,0
15 Texts Everyone Dreads Getting During Fall,1,1,6,30,0,6,2,36,0
Spotify Executive Confirmed as British Victim of Sweden Terror Attack,1,2,8,52,0,9,0,60,0
"Honestly, Rory Gilmore Sucks",1,3,4,20,1,3,0,24,0
Leap Second: Here’s Why 2016 Is Going to Be Just a Tiny Bit Longer,1,3,11,36,2,13,4,47,0
"25 Questions ""Harry Potter And The Cursed Child"" Needs To Answer",1,1,10,40,2,10,2,50,0
Here's What Happens When You Go To A Different Meetup Every Day For A Month,1,1,15,45,1,14,0,60,0
What Was The Most Ridiculous Rumour That Went Around Your School,1,1,11,43,0,10,0,54,0
ASOS's Upcoming Wedding Dress Line Is Insanely Pretty And Affordable,1,1,13,45,1,9,0,58,0
28 Essential Items Every Guy Needs To Own This Fall,1,1,9,31,0,9,2,40,0
26 Tweets About Sex That Will Make You Laugh Every Time,1,1,10,33,0,10,2,43,0
15 People Who Legitimately Believe They're Part Of The Jedi Order,1,1,10,42,1,10,2,52,0
Ruby Rose Totally Slayed The MTV EMAs Red Carpet After Injuring Her Leg,1,1,17,42,0,12,0,59,0
"Mukesh Khanna Just Dropped A Major Hint About Shaktimaan's Comeback On TV And Yes, We're Excited!",1,2,17,61,4,15,0,78,0
Here's why Donald Trump is obsessed with the 2016 electoral map,1,3,3,45,1,10,4,48,0
Here's What A Half Century Of Love Really Looks Like,1,1,10,32,1,9,0,42,0
"Which ""Friends"" Character Are These Guest Stars Linked To",1,1,9,38,2,8,0,47,0
Why Everyone Needs To Stop Body-Shaming Cheryl Fernandez-Versini,1,1,10,45,2,7,0,55,0
I Had My Hair And Makeup Done Like Kim Kardashian For A Week And Here's What Happened,1,1,17,51,1,16,0,68,0
This Phone Accessory Will Make Your Photos Look Sick As Hell,1,1,11,39,0,10,0,50,0
Can You Guess The Celebrity By Their Sister,1,1,8,28,0,7,0,36,0
National Immigration Law Center Exec Director: Sessions Has a ‘Very Clear White Supremacist Agenda’,1,3,13,70,3,13,0,83,0
Why aren't men changing their name after marriage?,1,2,1,40,2,7,0,41,0
17 Things You Only Know If You're The Better-Looking Sibling,1,1,10,37,2,9,2,47,0
Apple Pay is about to get much better - Business Insider,1,2,4,41,1,10,0,45,0
UNICEF USAVoice: Ten-Year-Old Syrian Refugee Hiba Tells How She Survived A Harrowing Journey,1,3,23,54,3,12,0,77,0
"Yes, LaVar Ball is ridiculous ... and college basketball could use more people like him",1,3,4,65,4,14,0,69,0
"If You Get 11/15 On This Quiz, You Can Basically Be President",1,2,11,33,2,11,4,44,0
The Real Guide To Finding Which Hairstyle Flatters Your Face,1,1,10,41,0,9,0,51,0
This Optimistic Man Tried To Sneak 14 Bottles Of Liquor Into Saudi Arabia In His Underwear,1,1,15,58,0,15,2,73,0
These Engagement Pictures Of Adorable Pups Are Breaking All Records Of Cuteness!,1,3,12,56,1,11,0,68,0
Detailed security footage shows the alleged journey of Tom Brady's stolen Super Bowl jersey,1,3,5,72,1,13,0,77,0
We Tried Five Weeks Of Ballet Fitness And This Is What Happened,1,1,12,40,0,11,0,52,0
21 Of The Most Hilarious Things People Have Done While High,1,1,10,37,0,10,2,47,0
19 Powerful Photos That Capture The Havoc Wreaked By The Chennai Rains,1,1,11,46,0,11,2,57,0
Roommates Divide and Conquer With Temporary Walls ,1,3,6,37,0,7,0,43,0
11 Steamy Lyrics That Will Make See You Selena Gomez In A New Light,1,1,13,39,0,13,2,52,0
This Double-Face Halloween Makeup Look Is Trippy AF,1,1,10,33,1,7,0,43,0
BMX star turns abandoned Silverdome into his own decaying playground,1,2,4,55,0,9,0,59,0
"There’s A Store Making Donuts Based Off Of ’90s Snacks, Because Heaven Is Real",1,2,13,47,3,13,2,60,0
20 Times Aidy Bryant Was Literally The Cutest Person In The World,1,1,11,41,0,11,2,52,0
27 Insanely Delicious Soups From Around the World,1,1,6,34,0,7,2,40,0
"21 ""Simpsons"" Quotes That Perfectly Sum Up Life",1,3,7,29,2,7,2,36,0
14 Disgustingly Honest Confessions From Couples Who Enjoy Doing Gross Things Together,1,1,11,61,0,11,2,72,0
We Know Your Favorite Halloween Movie Based On Your Zodiac Sign,1,1,11,42,0,10,0,53,0
19 Hilarious Holiday Puns About Books,1,3,5,25,0,5,2,30,0
The sun is totally your smiling dad,1,2,1,28,0,6,0,29,0
This Video Perfectly Captures The Sriracha Lover's Struggle,1,1,8,43,1,7,0,51,0
The ultimate app guide to Super Bowl Sunday,1,3,4,32,0,7,0,36,0
21 Moments When You Actually Appreciate The Little Things,1,1,8,39,0,8,2,47,0
Can You Guess The Magazine After We Remove Its Title,1,1,10,33,0,9,0,43,0
Valve kills Steam Greenlight – here's why it matters,1,3,3,39,2,8,0,42,0
What's Your Absolute Favorite Song To Sing At Karaoke,1,1,9,35,1,8,0,44,0
We Know What You're Most Excited For Right Now Based On One Question,1,1,13,42,1,12,0,55,0
Dr Karl: Can you get pregnant during a pregnancy? Featured Stories Additional stories,1,3,6,65,2,12,0,71,0
Eating More of This Will Make You Live Longer,1,2,8,29,0,8,0,37,0
This Word Test Will Reveal If You Think With Your Head Or Your Heart,1,2,14,41,0,13,0,55,0
These Cute Handbags Are Designed To Hide The Smell Of Your Weed,1,1,12,40,0,11,0,52,0
16 Cats Who Are Just As Confused As You,1,1,8,21,0,8,2,29,0
These Could Be The Last Days Of The Messiest Party On Earth,1,1,12,36,0,11,0,48,0
"When media use pictures of drunk girls in alcohol stories, we’re being misled",1,2,1,62,2,12,0,63,0
"Leonardo DiCaprio Almost Saved The ""Star Wars"" Prequels By Playing Anakin Skywalker",1,1,13,57,2,11,0,70,0
"11 Things People With Motion Sickness Are Sick, Tired And Nauseated Of Hearing",1,3,12,51,1,12,2,63,0
29 Hilarious Music Tweets That Will Make You Laugh Every Time,1,1,10,39,0,10,2,49,0
Basically every college student has Netflix (but guess how many pay for it),1,3,2,59,2,12,0,61,0
Celebrity conspiracy theory: Marisa Tomei wasn't supposed to win an Oscar,1,2,4,57,2,10,0,61,0
5 travel credit card sign-up bonuses to fund your summer trip,1,3,0,49,1,10,1,49,0
"12 Reasons Kendrick Sampson From ""HTGAWM"" Is The Ultimate Bae",1,1,14,34,2,9,2,48,0
"Can You Guess The Hogwarts House Of These ""Harry Potter"" Characters",1,1,11,44,2,10,0,55,0
7 things to expect in esports in 2017,1,3,0,25,0,7,5,25,0
19 Gifts For The Laziest Person You Know,1,1,7,24,0,7,2,31,0
Why humans have always worn uncomfortable shoes,1,2,1,40,0,6,0,41,0
"Which ""How I Met Your Mother"" Home Should You Live In",1,1,11,30,2,10,0,41,0
We Tried The Condom Challenge Because Why Not,1,1,8,30,0,7,0,38,0
A New Study Shows 92% Of College Students Prefer To Read Paper Books,1,1,12,41,1,12,2,53,0
The 30 Most Criminally Underrated Pop Songs Of 2015,1,1,7,30,0,8,6,37,0
What Happened When Venezuela Outlawed Its Own Currency ,1,3,8,39,0,8,0,47,0
Ted Koppel to Sean Hannity: You Are ‘Bad for America’,1,3,8,33,3,9,0,41,0
Kerry on Trump: ‘We Have a Problem’ if Policy Is Made in 140 Characters,1,3,9,43,3,13,3,52,0
Gordon Ramsay Offered A Chef With Epilepsy A Job After He Was Fired,1,1,13,42,0,12,0,55,0
22 Things All Non-Baby People Will Relate To,1,1,8,26,1,7,2,34,0
Cuban on Trump: ‘I Don’t Think He Lasts Four Years’,1,3,9,29,4,9,0,38,0
19 Tweets About Chipotle That'll Actually Make You Laugh,1,1,8,37,1,8,2,45,0
9 Things Every Woman Secretly Does In Winter,1,3,7,29,0,7,1,36,0
"The Trump inauguration, seen in infrared",1,3,2,32,1,5,0,34,0
17 Things Only Super Close Sisters Will Understand,1,1,7,34,0,7,2,41,0
"17 Rounds Of ""Never Have I Ever"" With Ed Sheeran And Jamie Lawson",1,1,12,37,2,12,2,49,0
Girl On The Net: Leading UK sex blogger reveals how maintaining anonymity helped lead to a mental breakdown,1,3,7,82,1,17,0,89,0
20 Great Ideas That Ended In The Worst Possible Way,1,1,9,31,0,9,2,40,0
Why Diversity Is A 'Selfish' Goal At This Mobile Gaming Company,1,3,11,40,2,10,0,51,0
"Britney Spears' ""My Only Wish"" Is The Most Iconic Christmas Song Of All Time",1,1,14,46,3,13,0,60,0
Watch Iconic Mexican-American Beauty Looks Throughout History,1,1,8,46,1,6,0,54,0
Ever Wondered Why Some People Have That Tiny Extra Hole In Their Ear?,1,2,13,43,1,12,0,56,0
The Secrets Behind Russell Westbrook's Extreme Physique,1,2,7,41,1,6,0,48,0
The World's Most Reputable Companies In 2017,1,3,6,27,1,6,4,33,0
How Much of a Drug Is Safe for Preemies?,1,3,6,25,1,8,0,31,0
Charity Shop Finds Mystery Widower Who Pinned Heartfelt Note to Wedding Gown - Yahoo,1,3,12,58,1,13,0,70,0
IBMVoice: How Cognitive Computing Can Help To Prevent Phishing Attacks,1,3,13,47,1,9,0,60,0
Why women marched against a Conservative MP as well as Donald Trump,1,3,6,50,0,11,0,56,0
21 Things You Need If You Love Burgers Too Much,1,1,9,27,0,9,2,36,0
19 Dogs Who Are Total Fuzz Buckets,1,1,6,20,0,6,2,26,0
America Will Very Soon See 'A Day Without A Woman'. Organisers Of Women's March To Hold Strike,1,3,17,57,4,16,0,74,0
21 Cozy Velvet Things That Will Make Your Life Fancier,1,1,9,34,0,9,2,43,0
Dad DIYs his daughter's sleep onesie into a NASA space suit,1,3,8,40,1,10,0,48,0
"Director Of Adele's ""Hello"" Video Said The Reaction To Her Flip Phone ""Drives Me Crazy""",1,1,15,53,5,14,0,68,0
Building a Board Game Empire on Disney’s Shoulders,1,3,6,36,1,7,0,42,0
Jeff Sessions on Immigration Law: ‘I’m Going to Follow The Laws Passed By Congress’,1,3,12,54,4,13,0,66,0
Meryl Streep has hit on star-struck Trump’s big weakness,1,3,3,43,2,8,0,46,0
This Presidential Election Will Be Decided On A Coin Toss,1,2,10,38,0,9,0,48,0
29 Things You Need If You're Mysteriously Evil,1,1,7,29,1,7,2,36,0
A Paper Airplane Drone That’s Nearly Indestructible,1,3,7,37,1,6,0,44,0
17 Times Pizza Was Disrespected In The Worst Possible Ways,1,3,9,38,0,9,2,47,0
7 high-paying jobs for people who hate people,1,3,0,36,1,7,1,36,0
14 Chilling Pictures of Incredible Underwater Sculptures,1,3,5,43,0,6,2,48,0
Berlin Christmas market attack: What we know so far,1,3,3,39,1,8,0,42,0
Nigeria Uyo church collapse: Footage of aftermath,1,3,3,39,1,6,0,42,0
A Complete Guide to This Weekend's Sneaker Releases,1,2,7,36,1,7,0,43,0
Can You Guess Which Celeb This Person Thinks They Look Like,1,1,11,38,0,10,0,49,0
Tom Selleck Clears Up That 'Three Men and a Baby' Ghost Rumor [Video],1,2,11,42,4,12,0,53,0
Children From Latino Families Reveal Sacrifices Their Parents Made,1,1,9,49,0,8,0,58,0
The Only Way You Should Be Making Your Sweet Potatoes For Thanksgiving Dinner,1,1,13,52,0,12,0,65,0
The Returned Gets Even Creepier In Season 2,1,1,7,28,0,7,1,35,0
"It's Easier To Start A Company In India Than Shutting It Down, Thanks To The Maze Of Laws",1,2,18,52,2,17,0,70,0
This Santa Refused To Wake a Sleeping Baby And Took The Most Adorable Photos,1,1,13,50,0,13,0,63,0
18 Undeniable Things Filipinos Do During Christmas Season,1,1,7,41,0,7,2,48,0
"Ahead Of Polls In 5 States, SC Says Politicians Can't Seek Votes In Name Of Caste Or Religion",1,3,18,55,2,17,1,73,0
Heavy Rains Spawn California Wildflower Super Bloom that Can Be Seen from Space,1,3,11,56,0,12,0,67,0
Which Blonde HBIC Are You,1,1,8,13,0,4,0,21,0
"How Trump’s America is looking from the outside, according to the world’s cartoonists",1,3,3,67,3,12,0,70,0
11 Cute Little Poems That Accurately Describe Love,1,1,7,34,0,7,2,41,0
25 Moments Only The Laziest Of Lazy People Will Get,1,3,9,31,0,9,2,40,0
Here’s Why Sasha Was Absent During President Obama’s Farewell Address,1,3,10,48,2,9,0,58,0
How to beat UK energy price rises,1,3,3,24,0,6,0,27,0
This Androgynous Model Is Changing The Face Of Victoria's Secret,1,1,10,44,1,9,0,54,0
Remy Ma Released Another Nicki Minaj Diss Track and Twitter Blew Up,1,3,11,45,0,11,0,56,0
"Do You Remember The Names Of These ""Full House"" Characters",1,1,10,37,2,9,0,47,0
Amazon just created its own version of Skype to improve your company meetings â here's how it works,1,3,2,79,3,17,0,81,0
BBC Trending,1,2,4,7,0,1,0,11,0
"'Water world' found just 39 light years away represents leap forward in search for aliens, scientists say",1,3,1,83,3,16,2,84,0
Controversial Turkish Marriage Guide Allows Wife-Beating,1,3,7,43,1,5,0,50,0
How To Get '70s Inspired Nails,1,1,5,17,1,5,2,22,0
The untouchable Red Bull heir in Thailand,1,3,4,31,0,6,0,35,0
When You Hate PDA,1,1,6,8,0,3,0,14,0
5 Skin-Care Hacks Every Traveler Needs [Video],1,3,7,29,3,6,1,36,0
This online dating preference changes with age,1,3,1,39,0,6,0,40,0
Women and film: Is it still a man's world behind the camera?,1,2,2,44,3,11,0,46,0
"If ""Harry Potter"" Characters Had Instagram In The '90s",1,1,8,33,3,8,2,41,0
18 Reasons Disney's Prince Philip Deserves Some Damn Credit,1,1,8,40,1,8,2,48,0
"When People Think You Don't ""Look Latina""",1,1,7,25,3,6,0,32,0
Can We Guess If You're A Belieber Or Directioner,1,1,9,30,1,8,0,39,0
The Way This Horse Brings His Girlfriend Hay So They Can Eat Together Will Melt Your Heart,1,1,17,57,0,16,0,74,0
For Everyone Who's Sexually Attracted To Deacon From Fallout 4,1,1,9,42,1,9,1,51,0
You Won't Believe Why This Woman Is Suing Chipotle for Over $2 Billion,1,2,11,44,2,12,1,55,0
States Aim to Lure College Dropouts Back to School ,1,3,7,35,0,9,0,42,0
19 Amazing DIY Gifts That Only Look Expensive,1,1,9,27,0,7,2,36,0
The Hottest Socks In Tech,1,1,5,16,0,4,0,21,0
"16 Blind Auditions From ""The Voice"" That Will Give You All The Feels",1,1,12,40,2,12,2,52,0
President Trump's tech policy is a mystery,1,3,2,33,1,6,0,35,0
Can You Guess Which Letter Has Been Added,1,1,8,26,0,7,0,34,0
"Which ""Laguna Beach"" Romance Did You Ship",1,1,7,26,2,6,0,33,0
13 Insanely Clever Oatmeal Tricks You Need To Try,1,1,8,31,0,8,2,39,0
A Photo Of A Trauma Nurse Cuddling With Her Son After Work Is Going Viral For All The Right Reasons,1,1,20,60,0,19,0,80,0
H-1B Visa Overhaul Could Actually Benefit Big Tech Companies,1,3,10,40,1,8,1,50,0
Check Out These New Bizarre Laws For 2017  Insider,1,3,8,29,0,9,4,37,0
ANALYSIS: What we learned from Rex Tillerson's debut on the world stage ,1,3,11,47,2,12,0,58,0
Which Famous Car Are You,1,1,5,15,0,4,0,20,0
"Paying off bet, Zoo Atlanta names cockroach after Tom Brady",1,3,5,44,1,9,0,49,0
Role Models? Parents Glued to Screens 9 Hours a Day,1,3,7,33,1,9,1,40,0
This horrible tale of a pantless plane passenger will leave you in tears,1,3,1,59,0,12,0,60,0
Kristen Bell And Dax Shepard Dancing Through Africa Will Restore Your Faith In Love,1,1,14,56,0,13,0,70,0
"Another Round, Episode 31: You Gon' Get This Blackness",1,1,8,33,3,8,2,41,0
Denzel Washington on fake news and information overload,1,2,2,46,0,7,0,48,0
This Mom Perfectly Captures What It's Like To Be Pregnant In Her Hilarious Comics,1,1,14,53,1,13,0,67,0
21 Low-Key Things You Can Wear To Show Your Halloween Spirit,1,1,11,36,1,10,2,47,0
20 Ridiculously Awesome Pieces Of Furniture You Wish You Could Afford,1,1,10,47,0,10,2,57,0
9 Products Your Vagina Will Love,1,3,5,21,0,5,1,26,0
Which Valentine's Day Anthem Matches Your Birth Month,1,1,8,37,1,7,0,45,0
"22 Of The Most Incredible ""First"" Pictures From History",1,1,8,35,2,8,2,43,0
11 Of Your Favorite Actors' Very First Headshots,1,1,7,31,1,7,2,38,0
21 Fearful Confessions From People Entering New Relationships,1,1,7,45,0,7,2,52,0
Listen To What This Guy Says In His Sleep And Just Try Not To Laugh,1,3,15,38,0,14,0,53,0
32 Things That Happen When Your BFF Is Also Your Soulmate,1,1,12,33,0,10,2,45,0
The strongest (and weakest) American cities,1,3,2,34,2,5,0,36,0
"Sheriff Clarke: ‘Fake News’ Started With ‘Hands Up, Don’t Shoot’ Lie",1,3,11,40,7,10,0,51,0
Bill O'Reilly talked about the 'white establishment' and Twitter went into meltdown,1,3,4,65,3,11,0,69,0
"Adele Cut Her Hair Into A Short Bob, Looks As Flawless As Ever",1,1,13,36,1,12,0,49,0
A New Parchment Declaration of Independence Surfaces. Head-Scratching Ensues. ,1,2,9,57,3,9,0,66,0
16 Hilarious Disney Vines That Totally Nailed It,1,1,7,32,0,7,2,39,0
"Here's Everything You Need To Know About ""Star Wars"" In Under Three Minutes",1,1,13,47,3,12,0,60,0
Can You Identify These Famously Awful Premier League Footballers,1,1,9,47,0,8,0,56,0
Footballer scores world's sneakiest penalty in truly stylish fashion,1,3,1,58,1,8,0,59,0
"The ""Making A Murderer"" Filmmakers Don't Think Steven Avery Is Guilty",1,1,11,45,3,10,0,56,0
Anthony Bourdain And Eric Ripert Share Their Best Travel Tips,1,3,10,42,0,9,0,52,0
The Best And Worst States For Business 2016,1,3,7,25,0,7,4,32,0
Players on rise in Fantasy Baseball drafts after hot spring training,1,3,3,55,0,10,0,58,0
Which Celebrity's Twitter Bio Are You Based On Your Zodiac,1,1,10,38,1,9,0,48,0
25 Years After The Great Missouri Earthquake That Never Happened,1,1,9,44,0,9,2,53,0
Drake Finally Dropped His New Album And People Are Shook,1,2,10,37,0,9,0,47,0
11 Horrifyingly Cute Halloween Emojis,1,1,4,27,0,4,2,31,0
BuzzFeed Crossword: Drop A Beat,1,1,6,20,1,4,0,26,0
Kids who watch 'Sesame Street' do better in school,1,3,3,37,2,8,0,40,0
Shawn Mendes' 10 Best Deep Cuts,1,2,5,18,1,5,2,23,0
"Meet Ashlee Simpson And Evan Ross' New Baby Girl, Jagger Snow",1,1,11,38,2,10,0,49,0
14 Life-Changing Ways To Bake With Avocados,1,1,7,27,1,6,2,34,0
"Lady Gaga's halftime show messages: 'inclusion,' 'equality'",1,3,2,44,7,6,0,46,0
How Well Can You Actually See,1,1,6,18,0,5,0,24,0
What Does Your Choice In Colors Say About You,1,1,9,28,0,8,0,37,0
"Lane From ""Gilmore Girls"" Maybe Definitely Confirmed The Revival Is Happening",1,1,11,54,2,10,0,65,0
We Know Your Celebrity Ex Based On One Question,1,1,9,30,0,8,0,39,0
Here Are All The Reasons You're Wrong If You Don't Think Ariana Grande Is Everything,1,1,15,53,2,14,0,68,0
10 Times Male Celebrities Got Real About Body Image,1,3,8,33,0,8,2,41,0
19 Hilarious Tweets About God That'll Make You Laugh Every Time,1,1,10,40,1,10,2,50,0
6 Social Impact Business Ideas That Could Change The World From The Under 30 Summit EMEA,1,3,17,53,0,15,3,70,0
Taylor Swift's Family Took Halloween To A Whole New Level This Year,1,1,12,43,1,11,0,55,0
"The Hard Lessons Catherine Hardwicke Learned From ""Twilight""",1,1,8,43,2,7,0,51,0
"Only Watch The Trailer For ""The Purge: Election Year"" If You Want Nightmares",1,1,13,48,3,12,0,61,0
Google Home spreads bizarre conspiracy theory about Barack Obama ,1,3,4,52,0,9,0,56,0
Here's what happens when you give cash to the extremely poor,1,3,1,48,1,10,0,49,0
19 Things People Looked Like At The Grammys,1,3,7,27,0,7,2,34,0
A Man Made An Eye-Opening Video Getting Interviewed By His Younger Self,1,1,13,46,1,11,0,59,0
Millions might lose health coverage? Not to hear Republican leaders tell it.,1,3,3,60,2,11,0,63,0
How Do You Make Friends As An Adult,1,1,8,20,0,7,0,28,0
This Polite Golden Retriever Is Just Too Much,1,1,8,30,0,7,0,38,0
Everything We Learned From Our 'Spider-Man: Homecoming' Set Visit,1,3,10,43,4,8,0,53,0
17 Times The Internet Got Too Real About Instagram,1,1,8,32,0,8,2,40,0
This Woman Is Using Dead Fish As A Makeup Accessory,1,1,10,32,0,9,0,42,0
Are You In The Christmas Spirit,1,1,6,20,0,5,0,26,0
21 Greeting Cards That Need To Calm Down,1,1,7,24,0,7,2,31,0
"Tiger Cub Found Roaming The Streets In Southern California, Search Is On For The Owner",1,1,15,56,1,14,0,71,0
Survey Points to Challenges NATO Faces Over Russia ,1,2,10,33,0,8,0,43,0
Can You Ace This Extremely Difficult Color Matching Quiz,1,1,9,39,0,8,0,48,0
"Forget gap years and get a job in JD Sports, advises City lawyer",1,3,5,46,1,12,0,51,0
BuzzFeed Scoop: Sebastian Gorka Not a Nazi or Anti-Semite,1,3,9,38,2,8,0,47,0
Obama ditched the cargo shorts â and so should you,1,3,1,40,2,9,0,41,0
"Which ""Pretty Little Liars"" Character Are You Based On Your Zodiac Sign",1,1,12,46,2,11,0,58,0
Can Donald Trump's Arab honeymoon last?,1,2,4,28,2,5,0,32,0
"What It's Like To Hear ""Just Get Better""",1,1,8,22,3,7,0,30,0
17 Beauty Hacks You Should Try In 2016,1,1,6,19,0,7,6,25,0
Dating Struggles For Extroverted Ladies,1,1,5,30,0,4,0,35,0
Here Are Some Of The Weirdest Christmas Trees You'll Ever See,1,3,11,39,1,10,0,50,0
Is Australia handling charity the wrong way?,1,3,2,35,1,6,0,37,0
"The hipster is dead, and you might not like who comes next",1,2,1,45,1,11,0,46,0
Bay Area Public Radio Mourns Obama’s ‘Food Legacy’,1,3,8,32,3,7,0,40,0
Cam Newton's Pants Aren't Even The Worst Thing In This Picture,1,1,11,39,2,10,0,50,0
What Stephen Curry’s Free Throws Can Teach Investors - The Experts,1,3,10,44,2,10,0,54,0
19 Struggles Only People Who Don't Drink Tea Will Understand,1,1,9,39,1,9,2,48,0
27 Batshit Lines From Mike Tyson's Autobiography,1,1,6,33,1,6,2,39,0
My friend stole her boyfriend from my sister – should I snub their wedding?,1,2,2,58,2,13,0,60,0
Just 27 Really Wholesome Celeb Encounter Stories That’ll Make You Want To Meet Your Idols,1,2,14,58,1,14,2,72,0
Are There Health Benefits To Exposing Our Immune Systems To Bacteria?,1,3,11,47,1,10,0,58,0
"Which ""Breaking Bad"" Character Is Your Soulmate Based On Your Zodiac",1,1,11,45,2,10,0,56,0
The stunning fall of Aaron Hernandez,1,2,3,28,0,5,0,31,0
"It Took Us A Serious Minute To Figure Out Who The Famous Person On The Cover Of ""Elle"" Is",1,1,19,50,2,18,0,69,0
17 Polite Suggestions For Canadian Superheroes,1,1,5,34,0,5,2,39,0
Muslim Mob Rapes 15 Christian Women in ‘Revenge Attack’ for Conversions,1,3,8,49,2,10,2,57,0
48 Books You Need To Read In Your 30s,1,1,7,18,0,8,4,25,0
Why this inspiring teen went right back to work after car accident,1,3,1,54,0,11,0,55,0
PROMO: Puma Asks—What Is Your Legacy?,1,3,11,18,3,5,0,29,0
The 22 Best Adele Memes,1,1,4,13,0,4,2,17,0
Why It's So Cold In Outer Space,1,2,7,17,1,6,0,24,0
"Please Stop Saying ""Literally""",1,1,4,21,2,3,0,25,0
Are You More Queen Elsa Or Jack Frost,1,1,8,22,0,7,0,30,0
Love Actually: Last Christmas we found out what happened to Harry and Karen,1,3,6,56,1,12,0,62,0
Did She Fake Her Orgasm,1,1,5,14,0,4,0,19,0
27 Reasons You Should Watch The Local News More Often,1,1,9,33,0,9,2,42,0
'Game of Thrones': Ranking the Penultimate Episodes,1,3,5,37,3,6,0,42,0
New Yorker: White House Press Corps Livid over Trump’s ‘Trolling’,1,3,9,43,4,9,0,52,0
28 Charming Ways To Use Your Kids' Art As Decor,1,1,9,26,1,9,2,35,0
26 Female-Fronted Bands That Rule,1,3,5,21,1,4,2,26,0
19 Secrets Hotel Receptionists Will Never Tell You,1,1,7,34,0,7,2,41,0
We Had Celebrities Compete In A Wrap Battle And Here's What Happened,1,1,12,44,1,11,0,56,0
Floyd Mayweather vs. Conor McGregor: Money Says Potential Bout Is 'Very Close',1,3,12,51,4,11,0,63,0
Tom Selleck Clears Up That 'Three Men and a Baby' Ghost Rumor [Video],1,3,11,42,4,12,0,53,0
"An Open Letter To The Taquero, The Greatest Human In The World",1,1,12,38,1,11,0,50,0
We Competed To Make The Best Pizza For Wolfgang Puck And It Was A Total Mess,1,1,16,45,0,15,0,61,0
Literally Just 17 Awesome Science GIFs,1,1,7,24,0,5,2,31,0
The day two men talking about cancer on the radio made the nation stop,1,3,1,56,0,13,0,57,0
"Madeleine Albright Remembers Her Awesomely Weird ""Gilmore Girls"" Guest Appearance",1,1,10,60,2,9,0,70,0
"This man raised over £250,000 to make a very NSFW Donald Trump doll The list",1,3,8,46,2,14,6,54,0
29 Things You'll Understand If You Went To Uni In The Mid '00s,1,1,11,33,2,12,4,44,0
"79 Thoughts I Had Watching ""Star Wars: Episode V"" For The First Time",1,1,12,39,3,12,2,51,0
Controversial Trump aide Bannon elevated to WH security council,1,2,5,50,0,8,0,55,0
"Do You Really Remember The Halloween Episode Of ""Boy Meets World""",1,1,11,42,2,10,0,53,0
People are sending EPA employees chocolate chip cookies and thank you cards,1,3,4,60,0,11,0,64,0
"Karan Johar Becomes A Father To Twins, Irrfan Khan Gets Mobbed In Gangtok & More From Ent",1,2,16,55,2,16,0,71,0
A 17-Year-Old Syrian Refugee Brought His Puppy All The Way To Greece,1,1,13,40,2,11,2,53,0
24 Hilariously True Tweets For Retail Workers About The Plastic Bag Charge,1,1,11,50,0,11,2,61,0
19 Popsicle Stick DIYs That Are Actually Awesome,1,1,9,30,0,7,2,39,0
"Mark Ruffalo, Michael Moore, Alec Baldwin to Lead Anti-Trump Protest in NYC",1,3,13,48,3,11,0,61,0
28 Insanely Clever Halloween Costumes For Your Inner Geek,1,1,8,39,0,8,2,47,0
"Mindy Kaling Thinks It's ""Badass"" To Live In P.E.I. And We're Like",1,1,14,34,7,11,0,48,0
25 BuzzFeed Posts My Parents Want Me To Write,1,1,9,26,0,8,2,35,0
15 Chocolate Desserts To Console You This Valentine's Day,1,1,8,38,1,8,2,46,0
"The Hardest ""America's Next Top Model"" Quiz You'll Take Today",1,1,10,38,4,9,0,48,0
12 Countries With The Most Unfilled Jobs,1,3,6,26,0,6,2,32,0
How Tesla emerged from the brink of bankruptcy to become America's coolest car company,1,3,3,69,1,13,0,72,0
18 Reasons Being Single During The Winter Is Actually Amazing,1,1,9,41,0,9,2,50,0
We Can Predict Your Future Based On Your Eye Color,1,1,10,31,0,9,0,41,0
24 Times The Internet Was Completely Accurate About Midterms Week,1,1,9,45,0,9,2,54,0
"Man makes impressively bizarre hotel request, hotel delivers",1,3,1,51,1,7,0,52,0
6 Reasons Why Old-school Idealism Is Constantly Challenged In The 21st Century Material World,1,3,12,64,1,13,3,76,0
Watch Spice Girl Emma Bunton Prank British Airways Customers for Red Nose Day 2017,1,3,12,53,0,13,4,65,0
Do You Actually Know How To Write Cursive,1,1,8,26,0,7,0,34,0
A Quick Guide to Backing Up Your Critical Data ,1,3,8,30,0,9,0,38,0
21 Desserts That Are As Delicious As They Are Colorful,1,1,9,34,0,9,2,43,0
What's The Best Budget-Friendly Trip You've Ever Been On,1,1,10,35,3,8,0,45,0
'Detroit' trailer sends John Boyega back into the 1960s,1,3,3,38,2,8,4,41,0
Six Supreme Court cases Justice Neil Gorsuch could rule on,1,3,6,43,0,9,0,49,0
Under Armour has a Trump dilemma,1,3,3,24,0,5,0,27,0
10 Celebs That Have Been Drinking From The Fountain Of Youth,1,1,10,38,0,10,2,48,0
"Zac Efron Twerking On ""Ellen"" Will Make You Feel Things",1,1,10,34,2,9,0,44,0
‘Frozen Ever After:’ An Exclusive Look at Disney’s Upcoming Attraction - Speakeasy,1,2,10,56,5,11,0,66,0
Psychologists Think Your Lies About Santa Will Damage Your Kids,1,3,10,44,0,9,0,54,0
Obama's economic recovery has ended. Here's how he did,1,3,2,41,3,8,0,43,0
IBMVoice: 3 Signs It's Time To Evolve Start-Up Thinking To Support Growth,1,2,15,43,3,11,1,58,0
"Fmr Clinton Spox: Comey Letter Was ‘Decisive’ Without It, ‘Hillary Clinton Would Be the 45th President’",1,2,14,66,6,15,2,80,0
17 Practical Items That Will Soothe Your Type-A Soul,1,1,9,32,1,8,2,41,0
University of Wisconsin-Madison: ‘Problem of Whiteness’ Course Not Meant to Be Offensive,1,3,10,63,4,11,0,73,0
Would You Use A Switch That Turns Off Your Sperm,1,1,10,29,0,9,0,39,0
23 Jokes Only Classics Nerds Will Laugh At,1,1,7,26,0,7,2,33,0
What's the best way to consolidate holiday debt?,1,3,1,38,2,7,0,39,0
Why Some Consumers Want No Logos on Their Gifts This Season,1,2,10,39,0,10,0,49,0
"Can You Spot The Real ""Peanuts"" Character From The Fake",1,1,10,34,2,9,0,44,0
If Horror Novels Had More Accurate Titles,1,1,7,28,0,6,0,35,0
Why are dreams of flying so common when it is so alien to us?,1,3,1,46,1,13,0,47,0
We Know Your Personality Based On Your T.V. Show Opinions,1,1,11,35,2,9,0,46,0
Tell Us About Yourself(ie): Tone Bell,1,1,6,23,3,5,0,29,0
One Woman Got 11 Tattoos In A Week To Show 100 Years Of Inked History,1,1,13,37,0,14,5,50,0
Inside T's Beauty Issue,1,3,4,15,1,3,0,19,0
What Should You Name Your Next Child,1,1,7,23,0,6,0,30,0
This is what astronauts see when they look out their window,1,3,1,48,0,10,0,49,0
We Can Tell You Who You Should Date With Just Four Questions About Biryani,1,1,14,47,0,13,0,61,0
25 Pictures That Are True For Absolutely No Good Reason,1,1,9,35,0,9,2,44,0
39 Gifts You’d Buy If Money Were No Object,1,3,8,23,1,8,2,31,0
"Kate Winslet Was Told To Settle For ""Fat Girl"" Parts As A Teenager",1,1,13,39,2,12,0,52,0
21 Apps That Will Make Your Christmas Shopping Easy,1,1,8,33,0,8,2,41,0
Bank Error in Your Favor? But… Can You Keep the Cash?,1,2,9,31,3,10,0,40,0
"If Hogwarts Students Were ""Mean Girls"" Characters",1,1,7,34,2,6,0,41,0
Heartbreaking: Terminally Ill Boy Dies in Santa's Arms  Insider,1,3,8,44,2,9,0,52,0
"I'm Fat, But I'm Not",1,1,5,8,3,4,0,13,0
'Game of Thrones' Season 7 gets a release date...and it's in ice?,1,3,3,43,7,11,1,46,0
25 Things Everyone Who Studied In Australia Is Guilty Of Doing,1,1,10,40,0,10,2,50,0
Do You Have The Best Photo Of A Kid Freaking Out With Santa,1,1,13,34,0,12,0,47,0
Why Building Community Is Way Better For Your Career Than Networking,1,2,11,47,0,10,0,58,0
What Does The Fox Say Duo Skewers Pentatonix And A Capella,1,1,11,37,0,10,0,48,0
Here's Taylor Swift On The Cover Of GQ Magazine,1,1,10,28,1,8,0,38,0
19 Little Things We Do That Are Not OK When People Do It To Us,1,3,15,31,0,14,2,46,0
The 18 Best Plays And Musicals Of 2015,1,1,6,19,0,7,6,25,0
These Beautiful Pieces Of Trans Artwork Offer Glimpses Into Diverse Trans Experiences,1,1,12,62,0,11,0,74,0
REPORT: Ann Coulter Cancels UC Berkeley Speech,1,3,13,26,1,6,0,39,0
How Donald Trump used bankruptcy to stay rich,1,3,3,35,0,7,0,38,0
Here's What Happens When Baked Potatoes And Nachos Collide,1,1,9,40,1,8,0,49,0
"21 ""Sailor Moon"" Tattoos That You Will Truly Fall In Love With",1,1,11,36,2,11,2,47,0
So THAT'S Why There's A Little Diamond Patch On Some Backpacks,1,3,15,35,2,10,0,50,0
You Definitely Need To Be Following January Jones On Instagram,1,1,10,43,0,9,0,53,0
22 Obnoxiously Cozy Things That'll Help You Embrace The Cold,1,1,9,39,1,9,2,48,0
Which Golden Globe Red Carpet Look Are You Based On Your Zodiac Sign,1,1,13,43,0,12,0,56,0
What Feminist Quote Are You,1,1,5,18,0,4,0,23,0
Can Sideways Toe-Stretching Defeat Foot Problems? ,1,3,7,35,2,6,0,42,0
This Piglet And Puppy's Unlikely Friendship Will Melt Your Heart,1,1,10,44,1,9,0,54,0
These People Tried Goth For A Week And It Was Fucking Epic,1,1,12,35,0,11,0,47,0
Samira Wiley’s Opinion On 21 Random Things,1,2,6,27,1,6,2,33,0
25 Products For Your Kitchen That Are Actually Worth Spending Your Money On,1,1,12,49,0,12,2,61,0
World's biggest dinosaur footprint found in 'Australia's Jurassic Park',1,3,4,55,4,8,0,59,0
23 Gifts You Need To Ask For This Year,1,1,8,20,0,8,2,28,0
17 Perfect Gifts For Anyone Who Loves “Friends”,1,3,7,29,2,7,2,36,0
This Touching Photo Of A Bride And Her Service Dog Is Going Viral,1,1,13,40,0,12,0,53,0
Do You Think These Rom-Com Couples Stayed Together After The Movie Ended?,1,3,13,47,2,11,0,60,0
"Which ""The Force Awakens"" Character Are You",1,1,7,28,2,6,0,35,0
"Michael J Fox And Christopher Lloyd Crashed ""Jimmy Kimmel Live"" As Marty McFly And Doc Brown",1,1,17,58,2,15,0,75,0
Brace Yourself For More Bank Queues As Limits On Cash Withdrawal May Not End On December 30,1,3,16,57,0,16,2,73,0
Molly Crabapple Is The Writer Who Made Me A Writer,1,1,10,31,0,9,0,41,0
"This Super Hot Guy Secretly Played Chewbacca In ""The Force Awakens""",1,1,11,44,2,10,0,55,0
Panetta: Trump Cannot Govern Through Executive Order,1,3,7,38,1,6,0,45,0
"We Know Your Favorite ""Harry Potter"" Character Based On Your Favorite Puppy",1,1,12,50,2,11,0,62,0
Here Is Trump's Absurd Defense For His Wiretap Claim,1,3,9,34,1,8,0,43,0
19 Things That Mildly Irritate All Farmers,1,1,6,28,0,6,2,34,0
"These People Complaining About ""The Wiz"" Seem To Have Forgotten That ""The Wizard Of Oz"" Exists",1,1,16,59,4,15,0,75,0
"Dude, We Should Hang Out",1,1,5,14,1,4,0,19,0
Here's How Trump Could Make Mexico Pay for the Border Wall  Insider,1,2,10,44,1,12,0,54,0
"Jamie Scott on the Secret to Writing Hits for One Direction, Justin Bieber & Niall Horan",1,3,11,60,2,15,0,71,0
26 Things About Hospitals That Are All Too True For Nurses,1,3,10,36,0,10,2,46,0
These Guys Greeted Strangers At The Airport And It Will Make You Feel Things,1,1,14,49,0,13,0,63,0
14 Heartbreaking Confessions From People In A Sexless Marriage,1,1,8,44,0,8,2,52,0
Stash Some Cash -- You're One Surprise Away From Going Broke,1,2,10,37,3,10,0,47,0
Jon Jones Offers Ronda Rousey Career Advice Following Her Loss,1,2,10,43,0,9,0,53,0
Small town coverup of deputy’s use-of-force shows what can happen when there are no videos,1,3,1,72,3,14,0,73,0
So many questions: Hilarious photos from around the world capture people in VERY puzzling scenarios,1,3,6,78,1,14,0,84,0
We Know What Kind Of Instagrammer You Are Based On Your Choice Of Emoji,1,1,14,44,0,13,0,58,0
Your Life In Numbers,1,1,4,13,0,3,0,17,0
Turkey Faces a New Political Reality,1,2,5,26,0,5,0,31,0
When You Have A Girl Crush,1,1,6,15,0,5,0,21,0
19 Photos That Won't Make Sense To You If You Don't Wear A Bra,1,1,13,32,2,13,2,45,0
10 Ways You Can Help Victims Of The #ChennaiRains Right Now,1,1,11,35,1,10,2,46,0
24 Obscenely Awesome Products To Decorate Your Space,1,1,7,36,0,7,2,43,0
Should You Date David Gandy Or Jamie Dornan,1,1,8,28,0,7,0,36,0
Here Are All The Cat Breeds You Never Knew Existed,1,1,10,31,0,9,0,41,0
Why we lose our memories when we age - and what you can do to stop it ,1,3,1,51,1,17,0,52,0
Here’s Why Your Boobs Aren’t Perfectly Symmetrical,1,2,7,35,2,6,0,42,0
Can You Guess The Urban Dictionary Definition Of These Words,1,1,10,41,0,9,0,51,0
"Fifth-grader asks police for help with math homework, and this was their response",1,2,1,66,2,12,0,67,0
Gap InternationalVoice: From Vision To Results: How To Lead Growth At Your Company,1,3,14,54,2,12,0,68,0
5 Times Madonna Was a Badass & Said Exactly What She Was Thinking,1,3,10,41,1,12,1,51,0
"How Well Do You Remember ""30 Rock""",1,1,6,18,2,6,2,24,0
"Ellen Absolutely Grilled Ben Higgins, AKA The Bachelor",1,1,10,36,1,7,0,46,0
Celebrities: Then (2014) And Now (2015),1,1,4,17,5,5,8,21,0
This Is The Most Cringeworthy Telenovela Death Of All Time,1,1,10,39,0,9,0,49,0
Which Zodiac Sign Are You Based On Your Zodiac Sign,1,1,10,32,0,9,0,42,0
See Moment When Conjoined Twins Reunite After Surgery,1,3,8,38,0,7,0,46,0
7 Hot Guys From Music Videos You Should Definitely Follow On Instagram,1,1,11,47,0,11,1,58,0
The Trump Resistance Will Be Commercialized ,1,3,6,32,0,6,0,38,0
Business Interests Benefitting from Castro Regime Urge Trump to Be Friendly to Cuba,1,3,10,61,0,12,0,71,0
Koç pops up at Bilderberg: could this be the year to let it all hang out?,1,2,2,54,2,15,0,56,0
"We're All So Over ""Columbus Day"" And We're Going To Rename It",1,1,12,34,4,11,0,46,0
"Why we buy milk, bread and toilet paper when it snows",1,3,1,41,1,10,0,42,0
17 Gifts For People Whose Best Friend Is A Pomeranian,1,1,9,33,0,9,2,42,0
"Are You More Henry VIII, Edward VI, Mary I, Or Elizabeth I",1,1,16,28,3,11,0,44,0
Oprah And Shonda Rhimes Reveal Why Marriage Isn't For Them,1,1,10,38,1,9,0,48,0
33 Tweets About Being A Lesbian That Will Make You Wet Yourself... With Laughter,1,1,13,49,3,13,2,62,0
15 Confessions From People Who Literally Think That Sex Is The Best Workout,1,1,12,49,0,12,2,61,0
"Can You Identify A Show By Looking At An Old ""TV Guide"" Cover",1,1,14,33,2,12,0,47,0
Here's What It Actually Means To Have A Work Wife,1,1,10,29,1,9,0,39,0
"Germany hunts possible accomplices of Berlin suspect, arrests in Tunisia",1,2,3,59,1,9,0,62,0
"Here's Everything We Know About ""Game Of Thrones"" Season 6 (So Far)",1,1,11,39,5,11,1,50,0
Are You More Demi Lovato Or Miley Cyrus,1,1,8,24,0,7,0,32,0
"15 Things That Make The Cast Of ""Scream Queens"" Scream Bloody Murder",1,1,11,42,2,11,2,53,0
Here's George W. Bush trying his best to figure out how ponchos work at the inauguration,1,3,4,67,2,15,0,71,0
Carly Rae Jepsen Recorded A Song In Simlish And You're Actually Going To Love It,1,1,15,50,1,14,0,65,0
Emma Watson Has Finally Responded To Noma Dumezweni Being Cast As Hermione,1,1,12,51,0,11,0,63,0
Can You Tell Who These Model's Famous Parents Are,1,1,9,31,1,8,0,40,0
"Which Hogwarts Houses Do These ""Gossip Girl"" Characters Belong In",1,1,10,44,2,9,0,54,0
"17 Female Friendship Truths, As Told By Amy Poehler And Tina Fey",1,1,11,39,1,11,2,50,0
‘Equal Pay Day’ Reminds Us That the Gender Wage Gap Myth Persists,1,2,11,41,2,11,0,52,0
Where Apple Ranks In Warren Buffett's Portfolio,1,2,7,33,1,6,0,40,0
Do Attractive People Earn A Fatter Paycheck?,1,3,7,30,1,6,0,37,0
"Tunnels, Disguises and Sewers: Clinton Prison’s Inmates Have Found Many Ways to Flee ",1,2,11,58,3,13,0,69,0
11 Women Who Did Drake Better Than Drake (On Halloween),1,1,9,33,2,9,2,42,0
Being In A Relationship During The Holidays: Expectations Vs. Reality,1,1,10,48,2,9,0,58,0
This incredible device makes the veins underneath your skin glow,1,3,1,54,0,9,0,55,0
What's Your Personal Slogan,1,1,4,19,1,3,0,23,0
32 Questions From Pop Songs Answered With Actual Data,1,3,8,35,0,8,2,43,0
So THAT'S What 'OK' Stands For,1,3,11,11,3,5,0,22,0
Is Your Local Sears or Macy’s Store Closing? Check This List,1,2,10,38,2,10,0,48,0
23 Images For College Students Who Are So Fucking Done,1,1,9,34,0,9,2,43,0
"9 Photos Of Successful Career Women, According To The Media",1,1,9,39,1,9,1,48,0
"26 Things Taylor Swift Did In 2008 That She Would Never, Ever Do Now",1,1,12,36,1,13,6,48,0
Touch of Faith - Video - NYTimes.com,1,3,6,21,3,6,0,27,0
14 Drinks Lindsey Graham Would Drink In The Oval Office,1,1,9,35,0,9,2,44,0
19 Things Women Who Love Wine Just Get,1,1,7,22,0,7,2,29,0
The 100 Most Important Fails Of All Time,1,1,7,23,0,7,3,30,0
17 Food Questions You Didn't Know You Needed An Answer To,1,1,10,34,1,10,2,44,0
We Can't Stop Looking At This Dashing Silver Fox Who Appeared At An NDP Rally,1,1,17,45,1,14,0,62,0
40 Celebrity Pixie Cuts So Good You'll Want to Go for It,1,3,9,33,1,11,2,42,0
"26 Ways The World Was Different Before ""Twilight"" Came Into Our Lives",1,1,11,43,2,11,2,54,0
Career Change By Staying Put: How To Make A Lateral Move Within The Same Company,1,3,15,50,1,14,0,65,0
You Need To Stop And Look At These Happy Reindeer Right Now,1,1,12,36,0,11,0,48,0
SNL Cut A Skit From Last Week's Show And It's A Gem,1,1,14,24,2,11,0,38,0
In A Giving Mood? Don't Write Checks To Charities Without A Strategy,1,3,12,43,2,11,0,55,0
23 Times Tumblr's Love For Captain America Got It Right,1,1,9,34,1,9,2,43,0
Kim Kardashian's Posh Spice Costume Was Blessed By Queen Victoria Herself,1,1,11,51,1,10,0,62,0
China's Enrichment Spawns Mature Problem -- Middle Class Angst,1,3,8,43,3,8,0,51,0
Which Pair Of Damn Daniel's Shoes Are You,1,1,8,25,1,7,0,33,0
A Bhopal Government Official Was Caught Watching Porn During A Council Meeting,1,1,12,55,0,11,0,67,0
"Which ""House Hunters"" Spinoff Should You Be On",1,1,8,29,2,7,0,37,0
Man with rifle arrested at DC restaurant targeted by fake news conspiracy theories ,1,2,3,67,0,13,0,70,0
Can You Match The Cat To Their Celebrity Owner,1,1,9,29,0,8,0,38,0
A Productive Person’s Guide to a Little Bit of LSD,1,3,9,31,1,9,0,40,0
19 Items Anyone Who Loves Burgers Needs To Own,1,1,8,28,0,8,2,36,0
11 Inspiring Stories Of People Who Bounced Back After Failing,1,3,9,41,0,9,2,50,0
"Which Look From Rashida Jones' ""Flip And Rewind"" Are You",1,1,10,34,3,9,0,44,0
The reason why this entire Canadian town's water turned hot pink,1,3,2,51,1,10,0,53,0
"7 Essays To Read: When Schools Are Racist, ""Depressiongrams,"" And #ShoutYourAbortion",1,1,12,55,6,10,1,67,0
Online quiz helps undocumented immigrants find free legal help,1,3,1,53,0,8,0,54,0
"YouTube's 10 most-viewed Christmas videos revealed, number 1 may leave you scratching your head",1,2,3,73,3,13,3,76,0
Chinese millennials reflect on their roots at New Year,1,3,3,43,0,8,0,46,0
This Restaurant’s Comfort Food Will Make You Want To Be A Kid Again,1,3,13,41,1,12,0,54,0
Police: Facebook Live Murder Suspect Steve Stephens Killed Himself During Pursuit,1,2,11,59,1,10,0,70,0
"Proof That ""Futurama"" Is The Funniest, Cleverest Show In History",1,1,10,42,3,9,0,52,0
Tom Daley Touching Dustin Lance Black's Butt Is Somehow Really Precious,1,1,11,49,1,10,0,60,0
"Retirement Questions, Answered: What Those Who Are Exceeding Goals Should Know",1,3,11,55,2,10,0,66,0
This Color Test Will Determine Who You Are In Your Friend Group,1,1,12,40,0,11,0,52,0
U.S. Car Makers Idle Plants Amid Oversupply Concerns ,1,2,9,34,2,8,0,43,0
"20 Years Ago, This Is What Winter Looked Like",1,1,8,26,1,8,2,34,0
Vegemite being bought by -- surprise -- Australians,1,3,2,38,4,7,0,40,0
If Disney Movies Were Way More Accurate And Badass,1,1,9,33,0,8,0,42,0
"A Guy Just Did The Most Epic ""Cha Cha Slide"" Dance Ever",1,1,12,30,2,11,0,42,0
Halloween Party Drinks To Spook Your Friends,1,1,7,31,0,6,0,38,0
British Adults Try Sweets From Their Childhoods,1,1,7,34,0,6,0,41,0
Destinations British Airways is offering business class seats for less than £100,1,3,3,62,1,11,3,65,0
Which Iconic Britney Spears Song Are You Based On Three Questions,1,1,11,44,0,10,0,55,0
24 Designers Who Failed So Hard They Almost Won,1,1,8,29,0,8,2,37,0
Dopamine dressing – can you dress yourself happy?,1,3,1,39,2,7,0,40,0
11 reasons driving a supercar isn't as cool as you think,1,3,0,43,1,10,2,43,0
Jabrill Peppers: I'm a pretty damn good safety,1,3,3,34,2,7,0,37,0
The Best Christmas Songs to Dance to,1,3,5,25,0,6,0,30,0
What's Your Favorite Halloween-Themed TV Episode,1,1,8,33,2,5,0,41,0
"Strangers living ""around the corner"" from each other discover they're sisters",1,2,1,63,3,10,0,64,0
27 Fucked-Up Things People Actually Ate As Children,1,1,8,33,1,7,2,41,0
Remember Lionel Messi's 5-Year-Old Afghan Fan? He Finally Got To Meet His Idol,1,3,14,47,4,12,1,61,0
What we do - and don't - know about Donald Trump's taxes ,1,3,3,38,4,12,0,41,0
Get creeped out by this tense trailer for the new WikiLeaks documentary,1,2,3,57,0,11,0,60,0
Lucy Worsley: the 20 best historic houses to visit,1,3,2,37,1,8,2,39,0
Meat Is A Key Ingredient In A Lot More Than Food,1,2,11,27,0,10,0,38,0
What's Your Ex Doing Right Now,1,1,6,18,1,5,0,24,0
Here Are The Flawless Pics From Sofia Vergara And Joe Manganiello's Honeymoon,1,1,12,53,1,11,0,65,0
This Aunty Ji Just Swinging At The Park Will Remind You To Never Grow Up,1,1,15,43,0,14,0,58,0
"Son Of An Auto Driver, Pacer Mohammed Siraj Lands Rs 2.6 Cr Deal With Sunrisers Hyderabad",1,3,15,55,2,15,2,70,0
New £1 coin: Your coins could be worth a small fortune online,1,2,2,45,2,11,1,47,0
Chef Roasts Diner Who Left Note Calling Christmas Music 'Offensive',1,2,10,46,2,9,0,56,0
This Lion Got Into A Wheelbarrow At A Zoo And It Was Pretty Whimsical,1,1,14,42,0,13,0,56,0
The biggest 2016 fantasy football lessons you shouldn’t forget next draft season,1,2,1,63,1,11,4,64,0
Donald Trump Loved To Cite The Nonpartisan Agency His Aides Are Now Discrediting,1,3,13,55,0,12,0,68,0
This Hilarious Harry Potter Comic Shows Why Snape Always Sucked,1,1,10,44,0,9,0,54,0
This Color Test Will Predict How Much Longer You'll Be Single,1,1,11,39,1,10,0,50,0
Here's Why Paris Won't Have A Street Named After Steve Jobs,1,3,11,36,2,10,0,47,0
17 Cats Enjoying The Finer Things,1,1,5,21,0,5,2,26,0
International Day of Happiness: 45 joyous things that will make you instantly happy,1,3,3,65,1,12,2,68,0
Amazon broke the internet with a typo,1,3,1,30,0,6,0,31,0
Why Australia's AAA credit rating is doomed,1,3,5,31,1,6,0,36,0
You Need To See This Video Of Alan Rickman Pranking Daniel Radcliffe,1,1,12,45,0,11,0,57,0
Girl Savagely Edits Her Former Friend Out of Picture See the Hilarious Results,1,3,11,55,0,12,0,66,0
How to Stay Sane in a World of Crazy News,1,3,6,26,0,9,0,32,0
What You Actually Want To Say During a First Date,1,1,9,31,0,9,0,40,0
‘Devastated’ Madonna Breaks Down Over Trump: ‘Haven’t Had a Good Night’s Sleep’ Since Election,1,3,13,61,7,13,0,74,0
26 Hilarious Tweets About Birth Control That Will Get You Every Time,1,1,11,44,0,11,2,55,0
A Complete Guide to This Weekend's Sneaker Releases,1,3,7,36,1,7,0,43,0
"Someone Calculated How Much Money Jim Spent Pranking Dwight On ""The Office"" And It's Crazy",1,1,15,58,3,14,0,73,0
57 Ways People With Eating Disorders Got Well,1,1,7,29,0,7,2,36,0
This Interview With Jennifer Lawrence Is The Most Jennifer Lawrence Thing To Happen,1,1,13,58,0,12,0,71,0
"This Reporter Responded To A Vulgar Comment With An Awesome ""Your Mama"" Joke",1,1,13,49,2,12,0,62,0
"What Tiny, Kind Act Should You Perform Today",1,1,8,28,1,7,0,36,0
15 Tumblr Posts About YA Novels That'll Make You Laugh Every Time,1,1,12,39,1,11,2,51,0
"Mindy Kaling Really Likes To Troll ""Star Wars"" Fans",1,1,9,32,2,8,0,41,0
Brothers jailed for trafficking people from Poland to work at Sports Direct,1,3,4,60,0,11,0,64,0
19 Times Kendall Jenner And Cara Delevingne's Friendship Was So Perfect It Was Actually Painful,1,1,14,64,1,14,2,78,0
This 509-year-old map contains the first known use of the word 'America' — but not where you may think,1,3,2,74,5,18,3,76,0
"There’s LeBron, and Then There’s Everyone Else (Michael Jordan Included)",1,3,10,48,5,9,0,58,0
44 Things Every Emo Kid Thinks During The Holidays,1,1,8,32,0,8,2,40,0
31 Stocking Stuffers For Every Harry Potter Fan,1,1,7,31,0,7,2,38,0
Facebook Live attack: Four Chicago accused denied bail,1,3,4,42,1,7,0,46,0
This Is What Happens When You Ask Queer Women About Dental Dams,1,1,12,40,0,11,0,52,0
17 Times The Internet Perfectly Summed Up Being A Sagittarius,1,1,9,41,0,9,2,50,0
"Call Off Dora The Explorer, Rob Was ""Around"" At The Kardashian's Thanksgiving",1,1,12,50,4,11,0,62,0
"As car crash deaths rise, experts say ""we're not doing the right things"" to prevent them",1,2,1,68,4,15,0,69,0
19 Vintage Photos Of Sean Connery That Will Make You Thirsty AF,1,1,12,38,0,11,2,50,0
7 Things Wildly Successful People Do Before 7:30 a.m.,1,3,6,32,3,8,4,38,0
Here's the cold LinkedIn message that prompted a CEO to give the sender a job,1,3,6,56,1,14,0,62,0
The Bedtimes Of The World’s Most Successful People Might Surprise You,1,3,11,47,1,10,0,58,0
Wedding Dresses You Would Never Know Were Made From Toilet Paper [Video],1,3,12,47,2,11,0,59,0
"FKA Twigs Radiates Power On The Cover Of ""Paper,"" Loves Cake",1,1,13,34,3,10,0,47,0
8 Pairs Of Socks That Are Probably In Your Drawer Right Now,1,3,11,36,0,11,1,47,0
A Chef’s Recipe for Getting Fit,1,3,5,20,1,5,0,25,0
Someone Illustrated Leslie Knope Compliments And They Rock,1,1,8,43,0,7,0,51,0
Can You Guess These Celebrity Fragrances By Their Descriptions,1,1,9,45,0,8,0,54,0
2016 in 17 words - CNN Video,1,3,4,11,1,6,6,15,0
"Can You Guess The ""Pretty Little Liars"" Episode Based On The Screencap",1,1,12,45,2,11,0,57,0
The science behind why you should stop stalking your ex on Facebook this Christmas,1,2,3,66,0,13,0,69,0
"This girl didn't get into Oxford, so she did this to her rejection letter The list",1,3,3,62,2,15,0,65,0
Shocked villagers capture monstrous snake that gorged on TWO of their goats and became too stuffed to move,1,3,4,85,0,17,0,89,0
11 Music Videos That Will Make You Feel High AF,1,1,10,26,0,9,2,36,0
You Will Never Think Of Pizza The Same Way After Trying This Dip,1,1,13,39,0,12,0,52,0
Burger King's secret fried chicken 'color guide' has been discovered,1,3,2,54,3,9,0,56,0
We Made Mouth-Watering Pasta Six Ways And You're Going To Instantly Crave Pasta,1,1,14,51,2,12,0,65,0
"24 Jokes About Everyone On The Internet That Are Way, Way Too Real",1,3,12,39,1,12,2,51,0
How To Have A Mouthgasm At Taco Bell,1,1,8,21,0,7,0,29,0
"17 Pieces Of Oreo Art More Beautiful Than The ""Mona Lisa""",1,1,10,33,2,10,2,43,0
This $15 gift is perfect for gamers â especially if you canât find an NES Classic,1,3,5,58,5,15,2,63,0
19 Words You Don't Actually Understand Unless You Went To The University Of Michigan,1,1,13,55,1,13,2,68,0
"Yazidi Activist: Islamic State Cut Open My Friend, Raped Her Baby, Then Raped Her",1,2,14,51,3,13,0,65,0
6 ways you can help your child thrive with dyslexia,1,3,0,41,0,9,1,41,0
A machine that used to be considered punishment is now a $1.4 billion fitness industry,1,2,1,67,2,14,2,68,0
This geyser erupting on a frigid day will make your winter solstice,1,3,1,55,0,11,0,56,0
9 Sweet Stories Of Roommates Who Became Best Friends,1,1,8,35,0,8,1,43,0
24 Funniest Animal Posts On Tumblr In 2015,1,1,6,23,0,7,6,29,0
"VISA Debit, Credit Cards Can Be Hacked In Just A Few Seconds, Finds A Research In UK",1,3,21,45,2,16,0,66,0
Steven Avery's New Lawyer Is Publicly Arguing His Case On Twitter,1,1,11,43,1,10,0,54,0
Ellen DeGeneres Scared The Shit Out Of Emily Blunt While She Was Dressed As Lady Liberty,1,1,17,56,0,15,0,73,0
"ABC’s Stephanopoulos: Trump in Denial Amid Questions About His Competence, Credibility",1,3,12,61,3,10,0,73,0
21 Times You Instantly Fell In Love With Kendall Jenner,1,1,9,35,0,9,2,44,0
What Would The Room Of Requirement Show You,1,1,8,28,0,7,0,36,0
23 Beautiful Cakes That Will Make Your Dreams Come True,1,1,9,35,0,9,2,44,0
Kristen Wiig Pretending To Be Peyton Manning Is Just Too Much,1,1,11,40,0,10,0,51,0
A map of the world's happiest countries The list,1,3,2,37,1,8,0,39,0
This Tiny Lion Can't Roar Yet But That's Fine Because He's Adorable,1,1,12,41,3,11,0,53,0
What people talk about before they die,1,3,1,31,0,6,0,32,0
"Kanye West Auditioned For ""American Idol"" This Weekend",1,1,8,37,2,7,0,45,0
17 Photos Of Mushrooms You'll Weirdly Enjoy,1,1,6,28,1,6,2,34,0
Chocolate Abuelita Is The Best Hot Chocolate Ever And You Should Try It,1,1,13,46,0,12,0,59,0
Justin Bieber Just Broke A Record Set By The Beatles,1,1,10,33,0,9,0,43,0
Can You Guess The 25 Most Common Passwords,1,1,7,26,0,7,2,33,0
5 Things About ISRO’s World Record Launch That Will Make You A Proud Indian,1,3,16,44,1,13,1,60,0
14 Pictures That Will Make Any Indian Incredibly Angry,1,1,8,36,0,8,2,44,0
"Snoopy Got A Star On The Walk Of Fame And Seemed A Little Hungover, TBH",1,1,17,39,1,14,0,56,0
"21 ""Law And Order"" Tumblr Posts That Are Fucking Funny Because They’re True",1,3,12,46,3,12,2,58,0
I tried to watch as much ‘Fox & Friends’ as the president. Here’s what I learned.,1,3,5,55,6,15,0,60,0
16 Taylor Swift Pumpkins,1,1,3,16,0,3,2,19,0
How Ready For Christmas Are You,1,1,6,20,0,5,0,26,0
31 Gifts For People Who Freakin' Love Fruit,1,1,7,26,1,7,2,33,0
22 Perfect Responses To Wrong Number Texts,1,1,6,28,0,6,2,34,0
"There's another United horror story, and it will break your heart",1,3,2,51,2,10,0,53,0
Let The Tarot Help You With Your Crush,1,1,8,23,0,7,0,31,0
2017 NFL Free Agency: Best Move Every Team Can Still Make,1,3,12,30,1,10,4,42,0
Here's A 3-Ingredient Cheese Dip You Can Make In Minutes,1,1,10,34,2,9,1,44,0
CPAC Straw Poll Finds Overwhelming Support for Donald Trump,1,3,11,40,0,8,0,51,0
29 Insanely Delicious Indian Recipes You Need To Try,1,1,8,34,0,8,2,42,0
Can You Guess Which Famous Author Gave This Writing Advice,1,1,10,39,0,9,0,49,0
Do You Live In The Matrix,1,1,6,14,0,5,0,20,0
"24 Reasons Why The Best Bit Of ""Friends"" Was Actually Monica And Chandler",1,1,12,45,2,12,2,57,0
Could A Planet Like Coruscant Exist?,1,2,6,24,1,5,0,30,0
Can You Finish These Music Puns,1,1,6,20,0,5,0,26,0
Women Were Pranked With Awful Makeovers... And It Was Hilarious,1,1,10,41,3,9,0,51,0
Southeast Asian walking fish lives up to its name,1,2,2,39,0,8,0,41,0
These Are 15 Things Every Grown-Ass Woman Should Have,1,1,9,33,1,8,2,42,0
16 Reasons The Addams Family Is The Best Family Ever,1,1,9,32,0,9,2,41,0
14 Honest Instagrams About Fall,1,1,4,21,0,4,2,25,0
Photos that could only happen in Jordan: News & Videos about Photos that could only happen in Jordan - CNN iReport,1,2,10,81,3,20,0,91,0
This Guy Draws Octopuses On Portraits Of Vice Presidents,1,1,9,39,0,8,0,48,0
18 Reasons Gryffindors Are The Absolute Worst,1,1,6,31,0,6,2,37,0
Do You Know Which Emo Band Sang This,1,1,8,21,0,7,0,29,0
21 Grandmas Who Have Zero Fucking Filter,1,1,6,26,0,6,2,32,0
"Al Gore: Global Warming a ‘Principal’ Cause of the Syrian Civil War, Brexit",1,2,10,49,4,12,0,59,0
14 Times Blair Waldorf Was Right About Everything,1,1,7,33,0,7,2,40,0
Leonardo DiCaprio Had The World's Most Awkward High Five At The Golden Globes,1,1,14,50,1,12,0,64,0
These Teriyaki Chicken Pineapple Boats Are Actually So Easy,1,1,9,42,0,8,0,51,0
18 Confessions About Pubic Hair That Will Surprise You,1,1,8,36,0,8,2,44,0
How to make limoncello with just four ingredients and in just 10 days,1,3,1,54,0,12,2,55,0
Swedish Police Officers Torn from Patrol Car During Riot,1,3,8,40,0,8,0,48,0
"Your Hair Dye Is Killing You, According to This Advocacy Group",1,2,10,41,1,10,0,51,0
You're Going To Start Seeing Live Photos on Facebook,1,1,8,35,1,8,0,43,0
These are the world's worst tax havens,1,3,1,30,1,6,0,31,0
30 Qualities Of A Good Home Cook,1,1,6,18,0,6,2,24,0
18 Things People Who Love Christmas Do In December,1,1,8,32,0,8,2,40,0
"Plug in, tune out: 30 podcasts to get you through the holidays",1,3,1,46,2,11,2,47,0
"Dear Dixie Chicks, We Really Need You",1,1,7,23,1,6,0,30,0
What It's Like to Live on Mars [Video],1,3,6,22,3,7,0,28,0
"Which ""Harry Potter"" Wizarding School Would You Go To",1,1,9,34,2,8,0,43,0
Can You Tell If It's A Bukowski Poem Or Actually A Porno,1,1,12,32,1,11,0,44,0
Kim Kardashian's Horrifying Police Statement Following Paris Robbery Has Been Released,1,3,11,64,1,10,0,75,0
Let Shia LaBeouf Show You The Proper Way To Wear Sweatpants,1,1,12,37,0,10,0,49,0
"The ""dead snap"" is revolutionizing the quarterback-center exchange",1,2,1,55,3,7,0,56,0
Where the Next Crisis Will Come From,1,3,6,24,0,6,0,30,0
Report: Trump May Designate Muslim Brotherhood a Terrorist Organization,1,3,8,54,1,8,0,62,0
These Are The Recipes That Won 2015,1,1,6,19,0,6,4,25,0
"Here Is ABC Family's ""Hocus Pocus"" Schedule For Halloween",1,1,11,35,3,8,0,46,0
The Should-Be-Bigger Bracket: See Which Artist Won It All,1,2,11,35,3,8,0,46,0
This Cat Making Biscuits On Himself Is The Most Magical Thing Ever,1,1,12,43,0,11,0,55,0
If Gordon Ramsay's Insults Were Motivational Posters,1,1,7,38,1,6,0,45,0
2015 Was The Year Shibas Proved They Were More Than A Meme,1,1,11,32,0,11,4,43,0
31 '90s Products You Can Still Find,1,1,5,19,1,6,4,24,0
This man quit booze and coffee for two years. This is what happened next The list,1,3,3,62,1,15,0,65,0
"19 GIFs That Will Make You Say ""Ahhhhhhh""",1,1,9,21,2,7,2,30,0
"If You Takes Photos And Shoot Videos Instead Of Helping Accident Victims, May Be You Need To Be Punished",1,3,19,66,1,18,0,85,0
"Can You Identify Which Language These ""Hellos"" Are In",1,1,9,34,2,8,0,43,0
25 Life-Changing Things Chrissy Teigen Instagrammed In 2015,1,1,7,38,1,7,6,45,0
"7 Stock Moves To Watch In 2017: Chipotle, Under Armour And More",1,3,10,35,2,11,5,45,0
"The Goddam Internet Did It Again With This Lip-Dub Of Olivia From ""The Bachelor""",1,1,15,49,3,13,0,64,0
Tell Us About Yourself(ie): Derek Theler,1,1,6,26,3,5,0,32,0
Millennials At Work: Expectations Vs. Reality,1,1,6,32,2,5,0,38,0
15 Cute Ways To Let Everyone Know You Love Manatees,1,1,9,31,0,9,2,40,0
Chicago Vs. New York: The Ultimate Showdown,1,1,7,28,2,6,0,35,0
23 Hot AF Male Models That Will Sexually Awaken You,1,1,10,30,0,9,2,40,0
'Moonlight' director Barry Jenkins' next project is about the Underground Railroad,1,3,5,64,3,10,0,69,0
Watch NBC TODAY Show Excerpt Free Online - Single Mom Builds Home by Watching YouTube Videos | Yahoo View,1,2,23,62,2,18,0,85,0
16 Cheat Sheets For Anyone Who Loves Drinking Wine,1,2,8,32,0,8,2,40,0
"Which Episode Of ""Law And Order: SVU"" Should You Watch This Halloween",1,1,14,41,3,11,0,55,0
Gay student comes out to his parents with a brilliant yearbook quote,1,3,1,56,0,11,0,57,0
The Seventies on Spotify  - CNN.com,1,3,6,21,2,6,0,27,0
Are You More Troye Sivan Or Shawn Mendes,1,1,8,25,0,7,0,33,0
What's Your Best Australian-Inspired Halloween Costume,1,1,7,40,2,5,0,47,0
Bei Bei The Baby Panda Waved At A Camera And It Will Make You So Happy,1,1,16,39,0,15,0,55,0
Here's Every Tweet Drake Has Ever Favorited,1,1,7,29,1,6,0,36,0
How Tom Brady's Super Bowl jersey was found -- the inside story,1,2,5,44,3,11,0,49,0
Watch All the Performances at the 2017 Grammys,1,2,4,31,0,7,4,35,0
Remember When Anderson Cooper Was A Reality TV Host,1,1,10,33,0,8,0,43,0
I Used The Crap Out Of The New iPhone 6s And This Is What Happened,1,1,14,37,0,14,1,51,0
Why 2017 Is a Pivotal Year for K-Pop,1,2,6,18,1,7,4,24,0
Attorney General Lynch to Incoming Trump Administration: Facts Are Helpful,1,3,9,55,1,9,0,64,0
'Power Rangers' fans are hyped about that credits scene—here's why,1,2,2,51,4,9,0,53,0
Here's What 19 Painfully Handsome Male Models Look Like Without Makeup,1,1,10,47,1,10,2,57,0
43 Overlooked Places All Travel Lovers Should Have On Their List,1,1,10,42,0,10,2,52,0
Men Have Learned How To Braid Their Hair And They're Not Looking Back,1,1,13,43,1,12,0,56,0
18 People Who Just Couldn't Be Fucked With Work That Day,1,1,10,33,1,10,2,43,0
Horrifying Video Shows Teen Jumping to His Death in Snapchat Stunt Gone Wrong,1,2,11,54,0,12,0,65,0
Can You Really Work Off a Bad Diet?,1,2,7,20,1,7,0,27,0
North Pole to be 50 degrees hotter than normal in pre-Christmas heatwave,1,3,3,55,1,11,2,58,0
13 Pictures To Brighten Your Bad Day,1,1,6,22,0,6,2,28,0
18 Very Sweary British Words You Need To Use Right Now,1,1,10,32,0,10,2,42,0
Prepare To Have Your Inbox Carpet Bombed,1,3,7,27,0,6,0,34,0
A List of Everything Taylor Swift Has Destroyed in Music Videos,1,3,9,44,0,10,0,53,0
I made an exact replica of Donald Trump in 'The Sims 3' and a lot of wild things happened,1,3,5,63,2,18,1,68,0
18 Glorious Nail Art Designs For Fall,1,1,6,23,0,6,2,29,0
28 Times Celebrities Asked Hilarious Questions On Twitter,1,3,7,41,0,7,2,48,0
Ten Truly Remote Places Where Your Boss Can’t Track You Down,1,3,11,38,1,10,0,49,0
5 Great Books To Read In December,1,3,6,20,0,6,1,26,0
23 Disney-Themed Kitchen Gadgets You Definitely Need,1,1,7,36,1,6,2,43,0
"The Stars Of ""Million Dollar Listing: Los Angeles"" Guess How Much These Luxury Homes Cost",1,1,15,57,3,14,0,72,0
How Much Do You Actually Love Christmas Movies,1,1,8,31,0,7,0,39,0
"How Well Do You Remember The ""Slutty Pumpkin"" Episode Of ""HIMYM""",1,1,15,35,4,10,0,50,0
"Welcome to the Triple-Double Era: NBA Stars, Legends Shocked How We Got Here",1,3,14,47,3,12,0,61,0
Here's What It's Like To Live With Anxiety,1,1,8,25,2,7,0,33,0
"27 Moments From ""The Simple Life"" That Belong In A Damn History Textbook",1,1,12,44,2,12,2,56,0
14 Celebrities Who Blessed Us By Joining Instagram In 2015,1,1,8,35,0,9,6,43,0
17 Genius Ingredients To Make You A Better Cook In 2016,1,1,9,30,0,10,6,39,0
Tell Us Your Most Embarrassing Onstage Moment,1,1,7,32,0,6,0,39,0
12 Countries With The Most Unfilled Jobs,1,2,6,26,0,6,2,32,0
When And How You Should Ask For A Raise: The Dos And Don'ts,1,2,13,32,2,12,0,45,0
19 Faces You'll Recognise If You're Lazy,1,1,6,24,2,6,2,30,0
Ranking Kanye West's Albums From Worst To Best,1,3,8,30,1,7,0,38,0
23 Delicious Ways To Layer Up For Fall,1,1,7,22,0,7,2,29,0
"Ed Sheeran Is Going To Be Acting In The New ""Bridget Jones"" Movie",1,1,13,38,2,12,0,51,0
Which Badass Movie Lady Are You,1,1,6,20,0,5,0,26,0
Jeff Sessions on Immigration Law: ‘I’m Going to Follow The Laws Passed By Congress’,1,2,12,54,4,13,0,66,0
24 Hilarious Tweets About Food That Are The Story Of Your Life,1,1,11,38,0,11,2,49,0
So What’s in This Year’s Oscars Swag Bag?,1,2,7,24,3,7,0,31,0
Google Training Ad Placement Computers to Be Offended ,1,3,7,39,0,8,0,46,0
17 Cheating Revenge Stories That Will Make You Glad You're Single,1,1,10,42,1,10,2,52,0
Homeless people 'exploited for sex' by online adverts,1,3,1,43,2,7,0,44,0
Sears has a bigger problem than plunging sales â but nobody's talking about it,1,2,1,63,3,13,0,64,0
24 People Who Were Truly Born To Do Their Jobs,1,1,9,26,0,9,2,35,0
22 Things That Will Make You Feel Like An Adult In February,1,3,11,35,0,11,2,46,0
This 8-Picture Test Will Reveal A Deep Truth About You,1,1,10,33,1,9,1,43,0
"U.K.’s Brexit Plan: Prepare for Failure, Hope for Success",1,3,8,36,5,8,0,44,0
19 Things You'll Probably Only Ever See In Vegas,1,1,8,29,1,8,2,37,0
19 Things You Saw Every Single Time You Went To Grandma's House,1,1,11,38,1,11,2,49,0
What's The Most Underrated Place To Get Cute Clothes For Work,1,1,11,39,1,10,0,50,0
How an American Tech Icon Bet on Nuclear -- and Lost its Way,1,2,8,38,2,12,0,46,0
16 Faces You'll Recognize If You Hate Talking On The Phone,1,1,10,35,1,10,2,45,0
10 books that will make you a better person in 2017 The list,1,3,1,41,0,12,6,42,0
ESPN picks: Do experts like UNC or Gonzaga to win it all?,1,3,9,35,2,11,0,44,0
17 Pictures That Show Just How Different Coachella Was 10 Years Ago,1,3,10,42,0,11,4,52,0
13 Things To Do For Your Friend With Post-Natal Depression,1,1,10,36,1,9,2,46,0
Travel Around The World With 46 Cookie Recipes,1,1,7,30,0,7,2,37,0
"Here’s How ""Keeping Up With The Kardashians"" Dealt With The Paris Robbery",1,3,12,47,3,11,0,59,0
"Here Are The Thoughts I Had While Watching ""Harry Potter"" For The First Time",1,1,14,47,2,13,0,61,0
Watch People Struggle Trying To Guess Urban Dictionary Terms,1,1,9,43,0,8,0,52,0
This Little Girl Reacting To The Reveal Of Luke Skywalker's Father Is All Of Us,1,1,15,49,1,14,0,64,0
Ariana Grande Is MAC's Newest Spokesperson,1,1,8,28,1,5,0,36,0
Shopper's random act of kindness for woman delights the internet ,1,3,1,53,1,10,0,54,0
18 Eye-Popping Science Instagrams You Should Follow In 2016,1,1,8,36,1,8,6,44,0
Kim Kardashian Had a Scare Sunday Night,1,3,6,27,0,6,0,33,0
13 Times Tina Belcher And Harry Potter Were The Same Person,1,1,10,37,0,10,2,47,0
19 Things Picky Eaters Can't Get Away With,1,2,7,25,1,7,2,32,0
A Mom's Shocking Facebook Photo Shows Why You Should Be Wary Of People Kissing Your Baby,1,1,16,56,1,15,0,72,0
This Is What Breakfast Looks Like Around The World,1,1,9,33,0,8,0,42,0
This Woman Hid A Positive Pregnancy Test In An Apple Watch Box To Surprise Her Husband On His Birthday,1,1,19,65,0,18,0,84,0
Little girl photobombed by huge venomous snake,1,2,1,39,0,6,0,40,0
How Sex Attractive Are You,1,1,5,17,0,4,0,22,0
We Had Pro Gamers Compete Against Vets At A Shooting Range,1,1,11,37,0,10,0,48,0
Mom's 34-Second Video Filmed In A Pantry Is Pretty Much Parenthood,1,3,11,41,2,10,2,52,0
Take This Food Test And Prove If You're A Real Californian,1,1,11,36,1,10,0,47,0
"If ""Harry Potter"" Characters Were Cast As All Black Actors",1,1,10,37,2,9,0,47,0
A Year in the Life of Detroit: How the Auto Industry Won 2016,1,2,8,36,1,12,4,44,0
"The Long Journey To ""Freeheld""",1,1,5,19,2,4,0,24,0
FinTech 50 2016: The Future Of Your Money,1,3,7,20,1,7,6,27,0
Designers Lining Up to Dress Melania Trump for Inauguration,1,3,7,44,0,8,0,51,0
The 25 Best Drama Movies Streaming on Netflix Right Now,1,3,8,36,0,9,2,44,0
People Can Relate Hard To This Raccoon That Got Stuck On A Trash Truck,1,2,14,43,0,13,0,57,0
16 Incredibly Rude Texts Your Boobs Would Send You,1,1,8,32,0,8,2,40,0
"Listen: Fireworks Erupt as Trump, Clinton Aides Clash at Harvard Forum",1,3,9,49,2,10,0,58,0
Confessions To The One That Got Away,1,1,7,23,0,6,0,30,0
12 Signs You're Just Not That Into Relationships,1,1,7,31,1,7,2,38,0
21 Misconceptions Extroverts Want To Set Straight,1,1,6,35,0,6,2,41,0
Which Fantastic Magical Beast Are You Based On Your Zodiac Sign,1,1,11,42,0,10,0,53,0
Apple's Big Developers Conference Is Today. Here's What to Expect. [Video],1,3,10,48,6,10,0,58,0
"Which ""Made In The A.M."" Song Is Actually The Best",1,1,11,26,4,9,0,37,0
Who's That Unknown Caller,1,1,4,17,1,3,0,21,0
We Know Your Favorite Disney Song Based On Your Birth Month,1,1,11,38,0,10,0,49,0
How Do Your Denim Habits Compare To Everyone Else,1,1,9,32,0,8,0,41,0
Can You Actually Name These Pixar Characters,1,1,7,31,0,6,0,38,0
29 Enchanting Images Guaranteed To Make Your Day Better,1,1,8,37,0,8,2,45,0
Bark helps parents monitor kids' online activity but preserve some privacy,1,3,1,62,1,10,0,63,0
This Is What Canada Looked Like Before This Ridiculously Long Election Started,1,1,12,55,0,11,0,67,0
24 Pictures Will Make You A Much Happier Person,1,3,8,29,0,8,2,37,0
17 Extremely Festive Ways To Get Drunk,1,2,6,24,0,6,2,30,0
"Gabby Giffords, Mark Kelly Target Arizona with New Gun Control Group",1,3,10,47,1,10,0,57,0
The real story behind Trump's fake Irish/Nigerian 'proverb',1,3,4,44,4,7,0,48,0
Democrat Gutierrez Blames Chicago’s Gun Violence on NRA,1,3,9,38,1,7,0,47,0
How posh is your fridge? Take the 'Tatler test' to find out,1,3,3,42,3,11,0,45,0
Brokaw: ‘Democrats Have a Lot of Reconstruction to Do of Their Own Party’,1,3,9,49,3,12,0,58,0
2 Ways To Be Happier -- Today,1,2,5,15,2,6,1,20,0
How To Make A Seafood Stew To Warm Every Heart,1,1,10,27,0,9,0,37,0
14 Types Of People At Every College Party,1,1,7,25,0,7,2,32,0
The Internet Is Going Crazy Over This Harry Potter-Themed Christmas Tree And We Can Totes See Why,1,3,18,62,1,16,0,80,0
9 Things People With Unusual Career Goals Are Tired Of Hearing,1,1,10,41,0,10,1,51,0
We Know Your Favorite Pop Song Based On Your Zodiac Sign,1,1,11,35,0,10,0,46,0
Which Books Have Helped You Manage Your Anxiety,1,1,8,32,0,7,0,40,0
How Much Is Your College-Basketball Team Worth?,1,3,8,31,2,6,0,39,0
19 '00s Teen Movies Summed Up In One Sentence,1,1,7,25,1,8,4,32,0
Raiders Punter Marquette King Had a Savage Response to Travis Kelce Stealing His Dance,1,2,12,61,0,13,0,73,0
16 Times Amy Schumer Made Us Cry From Laughing So Hard,1,1,10,32,0,10,2,42,0
Rick Perry thinks America needs a president who’s served in the military. Will voters agree?,1,2,4,71,3,14,0,75,0
Which Male Celebrity Are You Most Compatible With Based On Your Zodiac,1,1,12,47,0,11,0,59,0
Here's Justin Trudeau Walking The Wrong Way Up An Escalator For All Eternity,1,1,13,50,1,12,0,63,0
17 Things All Overachievers Want You To Know,1,1,7,28,0,7,2,35,0
24 People Who Failed The Fuck Out Of Social Media In 2015,1,1,10,30,0,11,6,40,0
Couples Discuss Mental Illness,1,1,4,23,0,3,0,27,0
24 Giant Salads That Will Make You Feel Amazing,1,1,8,29,0,8,2,37,0
19 Photos That You Really Shouldn't Laugh At If You're An Adult,1,1,11,37,2,11,2,48,0
16 Sinfully Delicious Chocolate Desserts,1,1,4,30,0,4,2,34,0
Bacon-Wrapped Sriracha Onion Rings,1,1,5,25,1,3,0,30,0
26 Asian Beauty Products You Should Totally Spend Your Hard-Earned Money On,1,1,12,49,1,11,2,61,0
"#OscarsSoWhite Creator ‘Still Waiting’ for LGBT Romantic Comedies, Disabled Superheroes",1,2,14,60,4,9,0,74,0
This is the CNN reporter that just got into a yelling match with Donald Trump,1,3,6,57,0,14,0,63,0
Sword-Wielding Man Dressed as The Joker Was Arrested in Virginia,1,3,9,45,1,9,0,54,0
19 Of The Most Totally Amazing Body-Shaming Clap Backs Of 2015,1,1,10,35,1,10,6,45,0
"12 Valentine's Day Cards To Help You Say ""Bae Mine""",1,2,9,28,3,9,2,37,0
Congressional Black Caucus to Re-Hang Anti-Cop ‘Police as Pigs’ Painting in Capital Citing ‘Constitution’,1,2,13,73,6,13,0,86,0
The hidden cost of made-in-America retail bargains,1,3,2,40,2,6,0,42,0
"The Minute Sasikala Was Sentenced To Four Years Imprisonment, Twitter Hosted An Epic Roast Party",1,3,15,66,1,14,0,81,0
Is the church's culture of shame increasing abortions?,1,3,1,44,2,7,0,45,0
What kind of fraud would YOU fall for?,1,3,4,26,1,7,0,30,0
"Asos Removes ""Slave"" Shirt Pictured On Black Model Amid Backlash",1,1,10,43,2,9,0,53,0
19 Secrets People Who Work In Office Will Never Tell You,1,1,10,34,0,10,2,44,0
MRC: 3 Networks Covered Sessions 7x More Than Eric Holder Being Held in Contempt of Congress,1,3,14,60,1,15,2,74,0
"If Ryan Adams Can Cover Taylor Swift's ""1989"" Then BuzzFeed Can Cover Pitchfork's Review",1,1,14,53,4,13,4,67,0
19 Times AB Soto SLAYED More Than You Will Ever Slay In Your Life,1,1,19,31,0,13,2,50,0
One woman's journey from Thai village to techno stardom,1,3,2,44,1,8,0,46,0
"A Trump Bump, From Canada",1,3,5,15,1,4,0,20,0
"So, Apparently Giles From ""Buffy"" Runs Some Kind Of Animal Rescue Charity",1,1,12,47,3,11,0,59,0
"I'm Native, But I'm Not",1,1,5,11,3,4,0,16,0
21 Times The Mall Failed So Hard It Just Failed,1,1,9,27,0,9,2,36,0
19 Controversial Topics That Will Tear Families Apart On Thanksgiving,1,1,9,49,0,9,2,58,0
13 Awards You Deserve If You've Ever Had A Period,1,1,9,28,1,9,2,37,0
Can You Identify These Skate Logos From Your Teenage Years,1,1,10,39,0,9,0,49,0
A Canadian Journalist Had No Chill About Being Retweeted By Taylor Swift,1,1,12,49,0,11,0,61,0
"If Your Childhood Idols Were Mary-Kate And Ashley Olsen, This One's For You",1,2,14,46,3,12,0,60,0
What Three Bold Lip Colors Look Like On Six Different Skin Tones,1,1,12,41,0,11,0,53,0
"One Direction Revisited Natalie Imbruglia's ""Torn"" And It Will Give You The Feels",1,1,13,53,3,12,0,66,0
Read The Charming Letter David Bowie Sent To A 14-Year-Old Fan,1,1,12,36,2,10,2,48,0
27 Things To Eat If You Have Social Anxiety And Don't Want To Talk To Anyone At A Party,1,1,18,48,1,18,2,66,0
I Pretended To Be Salad On Tinder And This Is What Happened,1,1,12,36,0,11,0,48,0
The most expensive homes you can buy in 28 countries,1,2,1,40,0,9,2,41,0
Which Anchor From E! News Are You,1,1,7,19,1,6,0,26,0
This Is For Everyone Who's Watched Their Parents Freak Out Before Company Arrives,1,1,13,55,1,12,0,68,0
"Guys, There's A Mashup Called ""Hotline Bing"" Of Chandler Dancing To ""Hotline Bling""",1,1,13,52,6,12,0,65,0
This Is The Most Epic Netflix And Chill Story Ever,1,1,10,31,0,9,0,41,0
13 Things To Think About The Next Time You Say Sorry,1,1,10,30,0,10,2,40,0
17 Things You Should Know Before You Date A Couple,1,1,9,30,0,9,2,39,0
"Guys, There's A Tumblr That's Only Dedicated To Cakes In Bollywood Movies",1,1,12,47,3,11,0,59,0
"28 Flower-Inspired Baby Names That Aren't ""Rose""",1,1,7,29,4,6,2,36,0
15 Penis Horror Stories That Will Make You Want To Vomit,1,1,10,34,0,10,2,44,0
Pretty Little Liars Quotes As Motivational Posters,1,1,7,37,0,6,0,44,0
I Made My Friend Wear A Left Shark Costume For The Entire Super Bowl And Here's What Happened,1,1,18,57,1,17,0,75,0
"Viola Davis, Misty Copeland, And More Tell Us Who Should Be On The $10 Bill",1,1,14,42,3,14,2,56,0
Alan Dershowitz: Ellison ‘The Worst Possible Person’ In the History of the Party For Dems to Pick As Chair,1,3,15,70,3,18,0,85,0
22 Times Cate Blanchett Proved To Be The Most Glamorous Woman On Earth,1,1,12,44,0,12,2,56,0
"What $2,000 Rent Gets You In San Francisco Vs. Everywhere Else",1,1,10,35,3,10,4,45,0
The Diverse World Of London As Seen Through Bus Windows,1,1,10,36,0,9,0,46,0
23 Wildly Entertaining Wedding-Night Stories From Real People,1,1,8,43,1,7,2,51,0
What Should You Watch On Netflix This October,1,1,8,30,0,7,0,38,0
President Obama Hits Twitter to Celebrate Legacy,1,3,6,36,0,6,0,42,0
"Stop What You're Doing And Listen To This Remix Of Adele's ""Hello""",1,1,12,39,4,11,0,51,0
'Drugs fix room is like my second home',1,3,1,29,2,7,0,30,0
Strangers Talked About What Having Sex With Each Other Would Be Like,1,1,12,45,0,11,0,57,0
What Happens When Girls Do Each Other's Makeup,1,1,8,30,1,7,0,38,0
These Engagement Pictures Of Adorable Pups Are Breaking All Records Of Cuteness!,1,2,12,56,1,11,0,68,0
What will happen to the naked tourists of Malaysia?,1,2,2,40,1,8,0,42,0
22 Memes You'll Only Understand If You're About To Graduate College,1,3,10,43,2,10,2,53,0
"Watch This Guy Play Out The Entire 2017 Oscars, Impressions And All",1,3,11,40,1,11,4,51,0
Soda’s New Enemy: San Francisco,1,2,5,20,2,4,0,25,0
21 Crockpot Soups Guaranteed To Help You Brave The Cold,1,1,9,35,0,9,2,44,0
Syfy's 'The Magicians' does 'some g*ddamn magic' at Brooklyn installation,1,3,4,54,6,9,0,58,0
"Can You Remember All The Women In Lou Bega's ""Mambo No. 5""",1,1,11,31,4,11,1,42,0
This Agency Is Trying To Remind Federal Workers They Still Have Rights,1,3,12,47,0,11,0,59,0
20 Tweets About Outfits That'll Make You Laugh Out Loud,1,1,9,34,1,9,2,43,0
Russia Appears To Defend Michael Flynn With Super-Weird Message On Twitter,1,3,12,51,1,10,0,63,0
The one question that will let you instantly read someone's personality The list,1,2,2,65,1,12,0,67,0
33 Impossibly Cute Ways To Cover Your Body In Books,1,1,9,31,0,9,2,40,0
What Have You Created Out Of Depression Or Anxiety,1,1,9,33,0,8,0,42,0
The biggest 2016 fantasy football lessons you shouldn’t forget next draft season,1,3,1,63,1,11,4,64,0
Demi Lovato Just Signed A Modeling Contract With Wilhemina Models,1,1,10,46,0,9,0,56,0
18 Holiday Mug Cakes Worth Feasting On,1,1,6,24,0,6,2,30,0
"2017: New year, same weird stuff in Parliament House",1,2,3,35,2,8,4,38,0
17 Things Only Children Want You To Know,1,1,7,24,0,7,2,31,0
This Google Chrome and Firefox Phishing Scam Is 'Practically Impossible to Spot',1,3,10,57,2,11,0,67,0
What Were Your Favorite Reality TV Moments Of 2015,1,1,9,29,0,8,4,38,0
"Get Your Slow Cooker Out, Because These Ribs Are Going To Make You Happy",1,1,14,44,1,13,0,58,0
Adrien Broner Arrest Video Released After Fighter Shot at in SUV,1,2,11,43,0,10,0,54,0
What Inside Joke Do You Share With Your Family,1,1,9,29,0,8,0,38,0
We Know Exactly When You'll Break Your New Year's Resolution,1,1,10,39,2,9,0,49,0
Can You Guess If These Celebrities Related Or Not,1,1,9,32,0,8,0,41,0
"14 ""Game Of Thrones"" Trivia Questions Every True Fan Should Be Able To Answer",1,1,13,47,2,13,2,60,0
Spike Lee Looks Back On The 19 Movies That Have Defined His Career,1,1,12,40,0,12,2,52,0
Pagan Priest Wins Right to Wear Goat Horns in License Photo for Religious Reasons,1,3,11,57,0,13,0,68,0
Former The Jump contestant Louise Hazel tells athletes to quit competition before they get hurt,1,2,5,76,0,14,0,81,0
29 Emo Songs You Haven't Thought About Since 2007,1,1,7,27,1,8,6,34,0
23 Reasons Luke Cage Is The Marvel Bae We've Been Waiting For,1,1,11,36,1,11,2,47,0
Here's How To Make The Only Birthday Cake You'll Ever Need,1,1,11,35,2,10,0,46,0
"For Marketers, TV Sets Are an Invaluable Pair of Eyes ",1,3,9,34,1,10,0,43,0
What Would You Text Back,1,1,5,15,0,4,0,20,0
21 Animals You Should Have Been Following In 2015,1,1,7,28,0,8,6,35,0
"What's The Worst Thing Michael Scott Did On ""The Office""",1,1,10,34,3,9,0,44,0
Just for Men released a shampoo that claims to permanently turn gray hair back to its original color,1,3,2,81,0,17,0,83,0
"It's Been 9 Years Since J.T. Died On ""Degrassi"" And We're Still Not Over It",1,1,15,39,6,14,1,54,0
Is Selena Gomez Worth $10 Million? [Video],1,2,6,24,4,6,2,30,0
Gluten-free diets linked to reduced risk of type 2 diabetes,1,2,1,47,1,9,1,48,0
"The Saddest Storyline In ""Love Actually"" Just Got Even Sadder",1,1,10,40,2,9,0,50,0
The First Time Someone Asked Julia Roberts For An Autograph She Was On The Toilet,1,1,15,52,0,14,0,67,0
PSA: Leg Shaving Season Is Officially Over,1,1,9,26,1,6,0,35,0
For Everyone Who Is Obsessed With Daryl's Arms,1,1,8,30,1,7,0,38,0
11 Things You Can Do Right Now To Make Winter Feel Less Awful,1,1,12,35,0,12,2,47,0
The Hardest Food Quiz You'll Ever Take,1,1,7,24,1,6,0,31,0
Republicans’ alarming proposal would end Medicaid as we know it,1,3,2,51,1,9,0,53,0
What People Who Go To Therapy Want You To Know,1,1,10,27,0,9,0,37,0
Clip-On Man Buns Are Here And They Absolutely Must Be Stopped,1,1,12,38,1,10,0,50,0
Oscars Shocker: Warren Beatty and Faye Dunaway Read Wrong Best Picture Winner,1,2,11,54,1,11,0,65,0
Trump: ‘I’m a Nationalist and a Globalist’,1,3,4,28,4,6,0,32,0
"Chris Brown, Soulja Boy to Settle Twitter Beef with $1M Boxing Match",1,2,10,44,2,11,1,54,0
Elle May Have Just Changed The Women's Magazine Game With Its February Covers,1,1,13,51,1,12,0,64,0
These Dogs Couldn't Care Less About The Canadian Rockies,1,1,9,38,1,8,0,47,0
13 Healthy Thanksgiving Tricks That No One Will Even Notice,1,1,9,39,0,9,2,48,0
Watch Live: White House Welcomes New England Patriots,1,2,8,37,1,7,0,45,0
22 Tumblr Posts That Hilariously Sum Up Video Game Culture,1,1,9,38,0,9,2,47,0
Moby says he'll DJ at Trump's inauguration under one condition,1,3,4,47,2,9,0,51,0
Selena Gomez Had The Cutest Reaction To Taylor Swift Winning A Grammy,1,1,12,46,0,11,0,58,0
Lauren Conrad Is A Redhead Now And It Looks So Good It Hurts,1,1,13,35,0,12,0,48,0
19 Tweets About Relationships That Are So Cute You'll Vomit,1,1,9,38,1,9,2,47,0
'90s Cartoons With Human Eyes May Ruin Your Childhood,1,1,8,34,1,8,2,42,0
"Chief of Dentsu, Japanese Ad Agency, to Resign Over Employee’s Suicide ",1,3,9,48,3,11,0,57,0
Trump defense secretary pick received emails from woman in Petraeus case,1,3,2,60,0,10,0,62,0
"Oregon School District Bans Santa Claus Decorations, Seeks Religious Tolerance",1,3,10,58,1,9,0,68,0
Prison officers acted unlawfully in restraining inmate who later died,1,2,1,59,0,9,0,60,0
The traditional cures threatening Myanmar's wildlife – in pictures,1,2,2,54,2,8,0,56,0
Two-child limit on benefits: are you going to be affected?,1,3,1,45,3,9,0,46,0
7 Common Health Issues That Are Often Ignored But You Should Think About,1,3,12,47,0,12,1,59,0
33 Pictures From The Glory Days Of The Warped Tour,1,1,9,30,0,9,2,39,0
18 People Who Probably Regret Becoming Stock Photo Models,1,1,8,39,0,8,2,47,0
18 Tweets About Health Insurance That Will Make You Laugh And Cry At The Same Time,1,1,15,50,0,15,2,65,0
No one can believe how much hair this baby has The list,1,3,2,42,0,11,0,44,0
Israel and the Palestinians: What are alternatives to a two-state solution?,1,2,3,59,3,10,0,62,0
35 Things You're Never Going To Get For Christmas Again,1,1,9,34,1,9,2,43,0
Chef Roasts Diner Who Left Note Calling Christmas Music 'Offensive',1,3,10,46,2,9,0,56,0
I wrote this Rachel Dolezal headline. Here are 14 others you’ll probably read today.,1,2,4,62,3,13,2,66,0
3. Wonder Woman,1,3,2,9,1,2,1,11,0
15 Insanely Delicious Stuffed Cookies That Are Better Than A Boyfriend,1,1,10,48,0,10,2,58,0
This Is What NYC Looked Like 100 Years Ago,1,1,10,21,0,8,3,31,0
This Is The Easiest Way To Have Eggs And Toast For Breakfast,1,1,12,37,0,11,0,49,0
Mysterious metallic sound in the Mariana Trench finally identified,1,2,3,55,0,8,0,58,0
What Is Your Vagina Horror Story,1,1,6,21,0,5,0,27,0
The Rock Had To Put One Of His Puppies To Sleep After It Ate A Poisonous Mushroom,1,1,17,48,0,16,0,65,0
"Why You Need to Go to Oman Now, in 16 Incredible Photos",1,3,8,33,1,11,2,41,0
"Which Character From ""Mob City"" Are You",1,1,7,24,2,6,0,31,0
Katy Perry Sang At Allison Williams' Wedding While Tom Hanks Officiated It,1,1,12,50,1,11,0,62,0
Emily Blunt Is Not A Fan Of John Krasinski's Hot New Bod,1,1,12,32,1,11,0,44,0
A researcher discovered how cavemen cleaned their teeth. It will make you want to brush yours.,1,3,2,75,2,15,0,77,0
People Are Criticizing Victoria's Secret For This Photoshop Fail,1,1,9,46,1,8,0,55,0
"You Have To Look At This Man Who Will Play Johnny In ABC's ""Dirty Dancing"" Remake",1,1,18,45,3,15,0,63,0
'You're joking' - Watch the moment Ian Stewart is arrested for murdering Helen Bailey,1,3,6,62,4,13,0,68,0
The Best Luxury Pot Accessories for a High Class Smoke,1,3,8,37,0,9,0,45,0
34 Movie-Inspired Cakes All Film Fans Will Appreciate,1,1,8,35,1,7,2,43,0
28 Memes That Pretty Much Sum Up Life In 2015,1,1,8,22,0,9,6,30,0
Virat Kohli's Fluent Hundred Keeps India Afloat Even As England Make Dents In Their Batting Order,1,2,16,65,1,15,0,81,0
21 Things You Should Never Say To A Skinny Girl,1,1,9,27,0,9,2,36,0
"The Hardest ""Harry Potter"" Spelling Test You'll Ever Take",1,1,9,37,3,8,0,46,0
"Sorry, But 11 Reasons Why Dudley The Dragon Was Better Than Barney",1,1,11,41,1,11,2,52,0
18 Confessions From Husbands About Their Wives' Pregnancies,1,1,7,42,1,7,2,49,0
People in wheelchairs couldn’t see Yayoi Kusama’s ‘Infinity Mirrors.’ The museum found an innovative fix.,1,3,6,79,6,14,0,85,0
We Know Your Celebrity Crush Based On The First Letter Of Your Name,1,1,13,42,0,12,0,55,0
"27 Reasons We All Need To Make Our Kids Watch ""Friends""",1,1,10,31,2,10,2,41,0
"The Official Trailer For ""Zoolander 2"" Has Dropped And It Features Benedict Cumberbatch Without Eyebrows",1,1,14,73,2,14,1,87,0
'Walking Dead' fans have an interesting theory about how one character might die in the finale,1,3,2,75,2,15,0,77,0
What Running A Business Has Taught Me About Investing,1,3,9,36,0,8,0,45,0
15 things successful people do over holiday breaks,1,2,0,41,0,7,2,41,0
Tell Us Your Zodiac Sign And We'll Guess When You Went To Bed Last Night,1,1,15,42,1,14,0,57,0
What Does Love Feel Like,1,1,5,15,0,4,0,20,0
5 Smart Ways To Spend Your Tax Refund,1,2,7,22,0,7,1,29,0
Watch People Get Their Mind Blown To The Possibility Of Winnie The Pooh Being A Girl,1,1,16,53,0,15,0,69,0
This Man Is Giving His Software Away For Free To Help People With Disabilities,1,1,14,51,0,13,0,65,0
Katharine Hepburn’s Brownies Recipe - NYT Cooking,1,3,8,33,2,6,0,41,0
What Annoying Misconception Do People Make About Extroverts,1,1,8,44,0,7,0,52,0
How Do Companies Quietly Raise Prices? They Do This,1,2,9,33,1,8,0,42,0
"If You Love Drake's ""Hotline Bling"" Video, You're Probably Gonna Love This Guy's Stuff",1,1,14,53,6,13,0,67,0
23 Things That Were Cool In 2005 But Definitely Aren't Now,1,1,9,32,1,10,6,41,0
This Girl's Secretly Dyed Hair Is Giving Us So Much Life Right Now,1,1,13,40,1,12,0,53,0
The most spoken language in the world is the one plants use to talk to each other The list,1,3,2,70,0,18,0,72,0
Can You Name The Classic Emo Album By The Cover Art,1,1,11,30,0,10,0,41,0
"To Stay in Shape, Just Add Squash",1,3,6,20,1,6,0,26,0
Lea Salonga And 33 Other Epic Filipino-Americans Got Together For A Big Family Photo,1,1,14,54,1,13,2,68,0
"We’re at the controls on planet Earth, but we’re not in control",1,3,2,47,3,11,0,49,0
"Grab Your Earphones, You Need To Hear This Magical A Cappella Disney Medley",1,1,13,49,1,12,0,62,0
This Guy Who Can See Out Of Only One Eye Bought A Dog With One Eye That No One Wanted,1,1,20,46,0,19,0,66,0
"Rihanna Talks Chris Brown, Thinks Rachel Dolezal Is Kind Of A Hero",1,1,12,42,1,11,0,54,0
Here's A Look At The Illustrations Inside Jason Segel's Children's Books,1,1,11,48,3,10,0,59,0
Trump: Intelligence Briefing Shows ‘Absolutely No Effect’ of Cyber Attacks on Election Results,1,3,11,68,3,12,0,79,0
Washington Post Seethes at Conservative Pushback over ‘Muslim Ban’ Fake News,1,3,9,55,2,10,0,64,0
Let's Talk About Your Most Important Gaming Opinions,1,1,8,36,1,7,0,44,0
The 6 Countries You Must Visit Since Their Currencies Got Cheap Last Year,1,2,12,48,0,12,1,60,0
This Girl Used Makeup To Turn Herself Into Gigi Hadid And It's So Good,1,1,14,42,1,13,0,56,0
Facebook Engineer Arrested for Allegedly Soliciting Sex from 15-Year Old Girl,1,3,9,55,1,10,2,64,0
Ellen DeGeneres As A Member Of One Direction Is Too Perfect,1,1,12,37,0,10,0,49,0
Donald Trump Questions ‘Sick Guy’ Barack Obama for ‘Wire Tapping’ His Campaign,1,2,11,52,4,11,0,63,0
Kris Jenner Got A Pie In The Face For Not Knowing North West's Middle Name,1,1,15,44,1,14,0,59,0
27 Gifts Under $50 For The Sea Witch In Your Life,1,1,9,25,1,10,4,34,0
"The #Blessed Life Of Kaskade, EDM's Voice Of Reason",1,1,11,29,3,8,0,40,0
This '13 Reasons Why' Actor Became A Meme For Being Too Grown And Sexy,1,3,13,40,2,13,2,53,0
9 Cult Skincare Products That Really And Truly Work,1,2,8,34,0,8,1,42,0
29 Products For Anyone Who Is Actually A Disney Princess,1,1,9,36,0,9,2,45,0
There's A Cheeky Nando's Music Video And It Is Insane,1,1,10,32,2,9,0,42,0
This Marathon Runner Who Helped A Competitor Finish The Race Is Winning Hearts All Over The Internet,1,3,17,67,0,16,0,84,0
What cocaine does to your body and brain,1,2,1,32,0,7,0,33,0
Should You Study For Finals Or Watch Netflix,1,1,8,29,0,7,0,37,0
Zimbabweans To Pay 35 Quadrillion Local Dollars For $1 As Currency Dies,1,3,10,46,1,11,3,56,0
42 Movies You Will Be Talking About This Awards Season,1,1,9,34,0,9,2,43,0
Literally Just 20 Pictures Of Tom Hiddleston,1,1,6,30,0,6,2,36,0
17 Of The Worst Dares People Have Actually Done,1,1,8,29,0,8,2,37,0
18 Celebrity Snapchat Accounts That'll Change Your Snap Life,1,1,8,41,1,8,2,49,0
17 Very Honest Confessions About Moving In With Boyfriends,1,1,8,40,0,8,2,48,0
"We're Halfway Through The Election! Here's What We've, Um, Learned",1,1,10,41,6,9,0,51,0
17 Struggles Every Clean Roommate Knows To Be True,1,1,8,32,0,8,2,40,0
How “Colossal” Tore Nice-Guy Syndrome To Shreds,1,2,8,30,3,6,0,38,0
Which Starbucks Holiday Beverage Are You,1,1,6,29,0,5,0,35,0
In search of the dream greenhouse: how Instagram has given glasshouses a new life,1,2,2,65,1,13,0,67,0
25 Delightfully Cozy Gifts For Anyone Who Hates Leaving The House,1,1,10,43,0,10,2,53,0
Here's How To Roast A Leg Of Lamb For Eid,1,1,10,21,1,9,0,31,0
Trump’s Ecstatic Brazilian Partner Sees Big Deals in His Future,1,3,9,44,1,9,0,53,0
Here's Why Comcast Is Investing In Snap,1,3,7,25,1,6,0,32,0
"Kanye Releases ""Real Friends"" And A Snippet Of Kendrick Lamar Collab",1,1,11,45,2,10,0,56,0
The 21 hottest women-founded startups to watch in 2017,1,3,1,38,1,8,6,39,0
28 Limited Too Items That Will Have You Feeling Nostalgic,1,1,9,37,0,9,2,46,0
"The worst mistake everybody makes when cooking steak, according to Anthony Bourdain",1,2,3,68,1,11,0,71,0
Your colleague has asked you to sign her out. Here’s why you shouldn’t.,1,3,2,53,4,12,0,55,0
Student creates enormous 'Simpsons' portrait on his college's wintry lawn,1,3,2,59,3,9,0,61,0
Hundreds of Thousands of Demonstrators Attend Women’s March on Washington,1,2,7,56,1,9,0,63,0
19 Things Only People Who Love Cooking But Are Fucking Lazy Will Understand,1,3,12,49,0,12,2,61,0
This Photo Could Prove The Kardashians Have Forgiven Scott And Caitlyn,1,1,11,49,0,10,0,60,0
"Will Smith Is Really Sad His ""Independence Day"" Character Died",1,1,10,41,2,9,0,51,0
Cooper Hefner shares Hugh Hefner advice - Business Insider,1,2,6,43,1,8,0,49,0
Four Hollywood Icons On What Made Them Proud To Be A Woman In 2015,1,1,13,36,0,13,4,49,0
Epic Fail: Rachel Maddow Mocked After Dragging Out Trump Tax ‘Scoop’,1,2,11,44,3,10,0,55,0
Alessia Cara’s Lorde Impression Is Fucking Impressive,1,3,7,39,1,6,0,46,0
49 People Tell Us When They Realised Being Open About Their Sexuality Mattered,1,3,12,52,0,12,2,64,0
Here's How To Actually Eat Healthier This Year,1,1,8,30,1,7,0,38,0
"Naked People Slaughter a Sheep at Auschwitz Death Camp, Chain Themselves to Gate",1,2,10,57,1,12,0,67,0
Behold: The sass master behind Wendy's Twitter,1,3,4,34,2,6,0,38,0
10 Celebrity Red Carpet Looks That Are Out Of This World,1,1,10,34,0,10,2,44,0
What About You Are People Most Attracted To,1,1,8,28,0,7,0,36,0
When You're A Girl With A Dirty Mind,1,1,8,20,1,7,0,28,0
Here's the Full List of 2017 Academy Awards Nominees,1,2,6,33,1,8,4,39,0
How to Remake the Most Famous Airport in the World,1,3,6,35,0,9,0,41,0
"Paris, Bill O’Reilly, Venezuela: Your Thursday Evening Briefing ",1,2,9,43,4,8,0,52,0
Will Your Future Partner Stare At Your Boobs The Way Will Smith Stares At Jada's,1,1,15,50,1,14,0,65,0
41 Songs You Need In Your Life This Month,1,1,8,23,0,8,2,31,0
How (And Why) This Man Lived In His Car For Over A Year,1,1,13,28,2,12,0,41,0
Rahul Raj Feels Kamya Punjabi Releasing Pratyusha Banerjee's Short Film Is A Publicity Stunt,1,2,14,64,1,13,0,78,0
One of the biggest hedge fund launches of all time is shutting down,1,3,1,54,0,12,0,55,0
Why some Trump voters in Texas oppose Mexico border wall,1,3,4,43,0,9,0,47,0
27 Times BBC News Failed So Hard It Just Failed,1,1,11,25,0,9,2,36,0
We Know Your Gender Based On These Five Questions,1,1,9,32,0,8,0,41,0
Lessons from a men's street style photographer,1,3,1,38,1,6,0,39,0
Mall Owners Find Relief From Unlikely Source: Online Retailers ,1,2,9,44,1,9,0,53,0
Which Sex Toy Matches Your Personality,1,1,6,27,0,5,0,33,0
15 People Who Are Christmas AF,1,1,6,17,0,5,2,23,0
A look at the mundane jobs that would suck in the Pokemon world,1,3,2,49,0,12,0,51,0
Guy Uses Facial Recognition To Get Info About Random Strangers To Send One Very Important Message,1,3,16,66,0,15,0,82,0
"Inauguration Protesters Light Fire in Street, Throw Embers at Police",1,3,8,50,1,9,0,58,0
"The Zodiac Signs As ""High School Musical"" Characters",1,1,8,35,2,7,0,43,0
22 Behind-The-Scenes Photos Backstage At The Victoria's Secret Fashion Show,1,1,11,50,3,9,2,61,0
Twitter Roasts Golden State Warriors for All-Star Photo Shoot,1,3,9,43,1,8,0,52,0
"NYT: ‘Fake News’ Backfires as Breitbart, Conservatives ‘Appropriated the Term’",1,3,10,53,6,9,0,63,0
"Which ""Walking Dead"" Character Should You Eat As A Zombie",1,1,10,36,2,9,0,46,0
"People Can't Get Over How Hot The New ""Daily Show"" Host Is",1,1,12,32,3,11,0,44,0
George Takei And Half Of Twitter Make The Same Joke About Russia And Oscar Night,1,3,15,51,0,14,0,66,0
How Do You Keep The Romance Alive After Kids,1,1,9,27,0,8,0,36,0
We Know What Cat GIF Will Make You Smile Based On Your Birthstone,1,1,15,38,0,12,0,53,0
We Need To Talk About The Perfection That Is Leonardo DiCaprio's BAFTAs Suit,1,1,18,45,1,12,0,63,0
21 Easy Ways To Save Money This Month,1,3,7,21,0,7,2,28,0
27 Gluttonous Foods To Eat Before Your New Year's Resolution Kicks In,1,1,11,44,1,11,2,55,0
"Yes, Trump Is Being Held Accountable ",1,3,6,24,1,6,0,30,0
Virus lottery: What could be next epidemic?,1,2,2,33,2,6,0,35,0
How The Internet Gave Birth To 'Troll Politics' And President-Elect Trump,1,3,12,48,3,10,0,60,0
"There’s A Store Making Donuts Based Off Of ’90s Snacks, Because Heaven Is Real",1,3,13,47,3,13,2,60,0
Can You Identify These Disney Movies From Just The Backgrounds,1,1,10,43,0,9,0,53,0
This Pregnant Mom Took Her Love Of Starbucks To The Next Level,1,3,12,39,0,11,0,51,0
Sean Spicer went full Melissa McCarthy today,1,3,5,33,0,6,0,38,0
Which Adele Song Perfectly Sums Up Your Miserable Love Life,1,1,10,40,0,9,0,50,0
NYT: Amnesty Is the ‘Only Long-Term Solution’,1,3,9,26,4,6,0,35,0
7 Failed Disney Storylines You Have To Read To Believe,1,2,9,35,0,9,1,44,0
Polar vortex returns: Here’s where it’ll be coldest,1,3,2,39,3,7,0,41,0
The most and least free countries mapped The list,1,3,2,39,0,8,0,41,0
30 cities where everyone under 30 wants to live right now,1,2,0,43,0,10,4,43,0
Can You Name These Muppets,1,1,5,17,0,4,0,22,0
Ivanka Trump Pushes White House Agenda to Human Trafficking,1,3,8,43,0,8,0,51,0
The U.S. government grows some seriously garbage weed for research,1,3,3,52,2,9,0,55,0
Women of the world united,1,3,1,20,0,4,0,21,0
"24 Times ""Arrested Development"" Perfectly Described Finals Week",1,1,7,45,2,7,2,52,0
Gaston And LeFou Were Probably Fucking,1,1,7,26,0,5,0,33,0
This Is How To Make Your Very Own Harry Potter Feast,1,2,11,31,0,10,0,42,0
Amy Schumer Has Been Instagramming The Perfect Responses To Unwanted Texts,1,1,11,53,0,10,0,64,0
Exclusive–Rep. Steve King: ‘This Is the Most Optimistic I Have Ever Felt on any Swearing-In Day’,1,3,15,60,6,15,0,75,0
We Know Your Zodiac Sign Based On Your Favorite Cats,1,1,10,33,0,9,0,43,0
The Indian politician with the reputation of a Bond villain,1,2,3,47,0,9,0,50,0
27 Reasons Why Paris Is The Capital Of The World,1,1,9,28,0,9,2,37,0
Which Rom-Com Movie BFF Are You,1,1,9,16,1,5,0,25,0
"Why every mammal (including humans), takes 12 seconds to poop - but no word on why your man spends 15 minutes in the loo",1,3,1,88,4,23,4,89,0
37 Of The Most Hilarious Shaq Tweets Of All Time,1,1,9,28,0,9,2,37,0
21 Times Tumblr Got Really Awkward About Sex,1,1,7,28,0,7,2,35,0
"33 Charming Moments From ""Wallace And Gromit"" That Will Make You Laugh Every Time",1,1,13,51,2,13,2,64,0
These Cute Kids Were Hooked Up To A Lie Detector Test In Front Of Santa And It Was Adorable,1,1,19,54,0,18,0,73,0
"24 ""American Horror Story"" GIFs That Perfectly Sum Up Having Your Period",1,1,13,44,2,11,2,57,0
Bull Riders Become Perfume Pitchmen After Hollywood Takeover,1,3,8,45,0,7,0,53,0
22 Times Ariana Grande Was Actually Pretty Damn Surprising,1,1,8,40,0,8,2,48,0
21 Makeup Tutorials That Will Help You Recreate Iconic Music Video Looks,1,1,11,48,0,11,2,59,0
We Got Brave And Tried The New Starbucks Fruitcake Frappuccino,1,3,10,43,0,9,0,53,0
17 Last-Minute Super Bowl Recipes That You Need In Your Life,1,1,11,36,1,10,2,47,0
America's 13 Best Restaurants — in Gas Stations,1,3,5,31,2,7,2,36,0
29 Things Only Late Twentysomethings Who Stay At Hostels Will Understand,1,1,10,50,0,10,2,60,0
Why don't more African Americans become organ donors?,1,2,3,41,2,7,0,44,0
If Phoebe Buffay Quotes Were Motivational Posters,1,1,7,36,0,6,0,43,0
Pope Francis Urges Immigrants to Respect ‘Local Laws and Customs’,1,2,8,46,2,9,0,54,0
22 Words That Have A Totally Different Meaning In Austin,1,1,9,36,0,9,2,45,0
Why It's So Cold In Outer Space,1,3,7,17,1,6,0,24,0
21 Pictures Literally Every Girl Has Taken,1,1,6,28,0,6,2,34,0
"""Wire tapping"" and 11 other words and phrases Trump has tweeted in quotes",1,2,2,55,2,12,2,57,0
Hinds: A Lesson In Cool From Spain's New Faces Of Garage Rock,1,1,12,36,2,11,0,48,0
15 Of The Most Expensive Pictures In The World,1,1,8,28,0,8,2,36,0
Can You Pass This Spelling Test Designed For 10-Year-Olds?,1,2,10,35,3,8,2,45,0
19 Times Ryan Reynolds' Instagram Made Him Even More Irresistible,1,1,9,44,1,9,2,53,0
Can People In Your State Drive,1,1,6,19,0,5,0,25,0
25 Pictures That Sum Up Being A Cashier,1,1,7,23,0,7,2,30,0
"London, Donald Trump, Keystone Pipeline: Your Evening Briefing ",1,2,8,44,3,8,0,52,0
Kellogg’s to Shutter 39 Distribution Centers as Layoffs Loom,1,3,6,43,1,8,2,49,0
OPEC Threatened by Tiny Oklahoma Town With Soaring Supplies,1,3,11,40,0,8,0,51,0
This man created his own sex doll and it’s as weird as you think The list,1,2,2,55,1,15,0,57,0
10-year-old autistic girl singing 'Hallelujah' will give you goosebumps,1,3,1,56,4,8,2,57,0
12 Times Adulting Just Was Too Hard,1,1,6,21,0,6,2,27,0
"This ""Orange Is The New Black"" Version Of ""Twas The Night Before Christmas"" Is Awesome",1,1,15,53,4,14,0,68,0
"Can You Guess The Song From Adele's ""25"" From These Emojis",1,1,10,33,3,10,2,43,0
Watch Kids Cry In Slow Motion With Santa And Try Not To Laugh,1,1,13,36,0,12,0,49,0
27 Ways To Decorate Your Home That Are Actually Inspirational,1,1,9,41,0,9,2,50,0
The German supermarket known for creating amazing viral ads has a new commercial about losing weight,1,3,2,83,0,15,0,85,0
24 Hilarious Tweets About Moms That Will Make You Laugh Out Loud,1,1,11,40,0,11,2,51,0
"This Is What $1,000 A Month In Rent Would Get You All Around The U.S",1,1,15,32,3,14,4,47,0
Meet Cannabrand: The first ever marijuana marketing brand,1,3,3,46,1,7,0,49,0
Bionic Leaf Makes Fertilizer From Sunlight And Air,1,2,8,35,0,7,0,43,0
Rare Whale Species Captured on Video for the First Time,1,3,7,39,0,9,0,46,0
How Do Companies Quietly Raise Prices? They Do This,1,3,9,33,1,8,0,42,0
Which Severus Snape Quote Matches Your Zodiac Sign,1,1,8,35,0,7,0,43,0
"Which ""Power Up"" Character Are You",1,1,6,21,2,5,0,27,0
17 Times Pacey Witter Made Your Heart Flutter,1,1,7,29,0,7,2,36,0
This Beautiful Dance Tells A Breakup Story In The Most Emotional Way,1,1,12,45,0,11,0,57,0
24 Pictures That Are Way Too Real For People With Resting Bitchface,1,1,11,43,0,11,2,54,0
"Alice From ""Alice In Wonderland"" Is The Worst Disney Character Of All Time",1,1,13,47,2,12,0,60,0
"Oldest living Dodgers fan, 108, always excited to see Jackie Robinson",1,3,4,50,2,10,3,54,0
Gunshot survivors bare all for photographer,1,3,1,37,0,5,0,38,0
15 People Who Got Dumped In Really Terrible Ways,1,1,8,30,0,8,2,38,0
"We Know Your Favorite ""Harry Potter"" Character Based On Your Go-To Ice Cream Flavor",1,1,15,52,3,13,0,67,0
8 Ways To Deal With Dumb Questions About Canada,1,1,8,30,0,8,1,38,0
Do You Know The Alter Egos Of These Superheroes,1,1,9,30,0,8,0,39,0
Why This Big Wave Surfer Is Only Interested In Tackling The Biggest Monsters,1,3,13,51,0,12,0,64,0
Labour MP: Russian Hackers ‘Probably’ Swayed Brexit Vote,1,3,9,37,3,7,0,46,0
Can You Look At Thanksgiving The Same Way After Watching This,1,1,11,40,0,10,0,51,0
Convicted Palestinian Terrorist Among Organizers of Anti-Trump Women’s Protest,1,2,9,59,2,8,0,68,0
Here's What Actually Happened To Your Hogwarts Letter,1,1,8,37,1,7,0,45,0
"The Podesta Group Loses Alphabet, Google’s Parent Company, as Client",1,3,9,47,3,9,0,56,0
"Trump thinks something terrible happened in Sweden, so here come the IKEA and ABBA jokes",1,3,10,63,1,14,0,73,0
14 Strangely Satisfying Videos Of Melting Cheese,1,2,6,34,0,6,2,40,0
31 Brides Who Absolutely Rocked Short Hair On Their Wedding Day,1,1,10,41,0,10,2,51,0
23 Things You Probably Shouldn't Say To Someone With Depression,1,1,9,42,1,9,2,51,0
20 Texts That Require No Response,1,1,5,21,0,5,2,26,0
"We Know What You Hate About The ""Harry Potter"" Movie Adaptations",1,1,11,41,2,10,0,52,0
Rihanna Shut Down Azealia Banks’ Xenophobic Instagram Shade With an Epic Clapback,1,3,11,58,1,11,0,69,0
15 Travel Tips Every Introvert Needs To Know,1,1,7,28,0,7,2,35,0
"As Trump Makes Threats, Iran Makes Friends",1,2,7,28,1,6,0,35,0
Would You Make It In The Keating Five,1,1,8,22,0,7,0,30,0
This is the precise time to go to bed if you want to wake feeling refreshed tomorrow,1,3,1,67,0,16,0,68,0
How to heat up your style during the cold season (Paid content by UNIQLO),1,2,8,50,2,13,0,58,0
Obama at G-7 Leaves Iraq’s Prime Minister Abadi Hanging,1,2,8,36,2,8,1,44,0
The 71 Most Highly Anticipated Movies At The 2016 Sundance Film Festival,1,1,10,45,0,11,6,55,0
Tiny brain and greasy hair found INSIDE ovary of 16-year-old girl,1,3,7,44,2,10,2,51,0
15 Harper Lee-Inspired Tattoos Because We'll Never Forget,1,1,8,38,2,7,2,46,0
Pentagon 'lily pad' strategy could increase U.S. troops in Iraq,1,2,4,46,4,9,0,50,0
You Need These 5 DIY Hair Masks In Your Life,1,1,11,23,0,9,1,34,0
Want to Bet That Jeb Bush Is Running? ,1,2,7,22,1,8,0,29,0
23 Tweets About Mall Santas That Are Guaranteed To Make You Laugh,1,1,11,41,0,11,2,52,0
Which Famous Alien Are You Based On Your Zodiac Sign,1,1,10,33,0,9,0,43,0
"How Long Would You Survive At ""Runway"" Magazine",1,1,8,30,2,7,0,38,0
23 Behind-The-Scenes Moments From Puppy Bowl XII,1,1,10,28,2,6,2,38,0
"Report: Maddow’s Trump Tax Scoop Sparks Battle Between NBC, MSNBC Bosses",1,3,17,42,3,10,0,59,0
18 Images That Only Women Will Truly Understand,1,3,7,31,0,7,2,38,0
The 20-year-old leading the March Against Revenge Porn,1,2,5,38,2,7,2,43,0
I Hung Out With Jeremy Bentham's Severed Head And This Is What I Learned,1,1,14,44,1,13,0,58,0
22 Pictures That'll Give You Intense Flashbacks To 2006,1,1,7,33,1,8,6,40,0
Immigrant Accused of Child Rape Disappears after Posting Bond,1,3,7,46,0,8,0,53,0
26 Products Every Whale Lover Needs In Their Home,1,1,8,31,0,8,2,39,0
Women Openly Share Why They Love Their Stretch Marks,1,1,9,35,0,8,0,44,0
22 Things Celebrity Couples Do In Life That Normal People Couldn't,1,1,10,43,1,10,2,53,0
Connecticut High School Principal Denounces ‘Trump!’ Basketball Game Chant as ‘Hate Speech’,1,3,11,64,5,11,0,75,0
10 incredible photos of defiance from history The list,1,3,1,43,0,8,2,44,0
Don't Try To Make Your Own Homemade Creme Eggs Because It's More Trouble Than It's Worth,1,1,16,54,3,15,0,70,0
Americans Try Brazilian Sweets,1,1,4,23,0,3,0,27,0
We Know Where You Should Travel In 2016 Based On Your Sign,1,1,11,32,0,11,4,43,0
What's The Weirdest Thing You've Gotten While Trick-Or-Treating,1,1,10,42,4,7,0,52,0
Kris Jenner Didn't Like That Kylie Got Her Lips Done,1,1,10,32,1,9,0,42,0
Los Angeles Angels of Anaheim Draft Mike Trout's Girlfriend's Brother,1,3,9,49,2,9,0,58,0
"Bank of America beats on the bottom line, misses on the top",1,3,2,45,1,11,0,47,0
21 Things That Prove Periods Are Actually Pretty Funny,1,1,8,36,0,8,2,44,0
22 Delicious Ways To Bring In 2016 With A Bang,1,1,8,23,0,9,6,31,0
Danny Meyer explains the biggest mistake he's made while starting burger chain Shake Shack,1,3,4,72,1,13,0,76,0
FYI: You Can Now Buy Stuffed Toys Of Your Favourite Indian Foods,1,1,14,38,1,11,0,52,0
Women Discuss The Worst Things You Can Do While Texting,1,1,10,36,0,9,0,46,0
22 Times Pedro Pascal Was Human Perfection,1,1,6,28,0,6,2,34,0
A Group Of Soldiers Posed For A Photo Breastfeeding Their Children In Uniform,1,1,13,52,0,12,0,65,0
15 NYC Restaurants To Try If You're Obsessed With Instagram,1,1,11,36,1,9,2,47,0
12 Heart Breaking Facts That Show World's Water Crisis Is Getting Worse,1,3,11,46,1,11,2,57,0
This Dessert Test Will Reveal How Many Grandchildren You’ll Have,1,2,10,44,1,9,0,54,0
19 Times Ben Whishaw Proved He's A Flawless Human Being,1,1,9,34,1,9,2,43,0
What's Your Zodiac Sign's Ice Cream Flavor,1,1,7,27,2,6,0,34,0
9 Incredible Photo Stories You Absolutely Can’t Miss,1,3,7,36,1,7,1,43,0
O'Reilly: Why Isn't Australia Condemned for Its Tough Immigration Laws?  Insider,1,3,11,54,4,11,0,65,0
Skeleton Makeup Tutorial,1,1,3,19,0,2,0,22,0
Which '90s Cartoons Are These Villains From,1,1,6,28,1,6,2,34,0
Who Will Be Your First Celebrity Ex-Husband,1,1,8,28,1,6,0,36,0
27 Times Tumblr Was Beautifully Wholesome,1,3,5,29,0,5,2,34,0
21 Times Things Got Too Real Too Fast,1,1,7,21,0,7,2,28,0
We Need To Talk About Nickelback,1,1,6,21,0,5,0,27,0
16 Models Who Are Gonna Blow Your Mind In 2016,1,1,8,23,0,9,6,31,0
Quiz: Is this a real headline or a satirical one from Trump's 100 days?,1,2,3,49,3,13,3,52,0
ESPN's NFL MVP Poll: Derek Carr takes top spot,1,3,13,23,2,8,0,36,0
'Game of Thrones' Season 5 Finale Predictions,1,2,5,31,2,6,1,36,0
100-year-old woman says the secret to a long life is 'a lot of booze',1,3,0,49,4,13,3,49,0
This Bride Spent 8 Months Creating Her Dream Wedding Dress By Hand,1,1,11,43,0,11,1,54,0
When A T-Shirt About Whitewashing Is Worth A Thousand Words,1,3,11,38,1,9,0,49,0
Heartbreaking: Terminally Ill Boy Dies in Santa's Arms  Insider,1,2,8,44,2,9,0,52,0
Here Are Six Nostalgic Two-Wheelers That Are Immortalised In Our Memories!,1,3,12,50,2,10,0,62,0
Beauty: your hair regime doesn’t have to be hard work,1,2,1,41,2,9,0,42,0
This Clip Perfectly Captures The Difference Between The U.S. And U.K,1,1,13,42,3,10,0,55,0
Everyone Is Eating Cereal Wrong And It's Incredibly Upsetting,1,1,9,43,1,8,0,52,0
"Swedish Woman Allegedly Gangraped By Three Young Men, Her Torture Broadcast On Facebook Live",1,3,14,64,1,13,0,78,0
"Yes, You Can Now Deep Fry Your Pumpkin Spice Latte And It's Way Too Easy",1,1,15,41,2,14,0,56,0
14 Confessions From People Who Are Afraid To Admit They Believe In God,1,1,12,44,0,12,2,56,0
"17 Things Only People Who Really, Really Love Music Will Understand",1,1,10,44,1,10,2,54,0
23 Ways To Cover Yourself In Black History Month Pride,1,1,9,34,0,9,2,43,0
"Farhan-Ranveer's Funny Race, SRK's Promise To Acid Attack Survivors And More From Ent World",1,2,17,57,4,13,0,74,0
Can You Guess The Movie From The Bed,1,1,8,21,0,7,0,29,0
Trust Records Show Trump Is Still Closely Tied to His Empire ,1,3,10,40,0,11,0,50,0
"As car crash deaths rise, experts say ""we're not doing the right things"" to prevent them",1,3,1,68,4,15,0,69,0
How Well Do You Actually Match Colors,1,1,7,24,0,6,0,31,0
The Annual Kitchen Gift Guide for a Brave New World,1,3,8,34,0,9,0,42,0
Which Christmas Movie Is Actually The Best,1,1,7,29,0,6,0,36,0
"How to Set, And Keep, Your Personal-Finance Resolutions   ",1,3,8,37,3,10,0,45,0
19 Bizarre Inventions That Should Probably Stay In 2015,1,1,7,34,0,8,6,41,0
How long before your cosmetic products should be replaced? - Yahoo,1,2,2,52,2,10,0,54,0
Lego Reportedly Responds To Requests For Inclusivity With New Toy In Wheelchair,1,1,12,56,0,11,0,68,0
These Spicy Slow Cooker Carnitas Are The Perfect Weeknight Dinner,1,1,10,46,0,9,0,56,0
23 Truths That All Old Souls Will Relate To,1,1,8,25,0,8,2,33,0
Burkina Faso's new war against militant Islamists,1,3,3,39,1,6,0,42,0
This Girl Trying To Carry All Her Groceries At Once Is All Of Us,1,1,14,37,0,13,0,51,0
"SZA Shares Video for New Song ""Love Galore"" f/ Travis Scott",1,3,11,35,3,10,0,46,0
Frank Ocean Just Released Another New Song And People Are Losing It,1,3,12,44,0,11,0,56,0
"For Marketers, TV Sets Are an Invaluable Pair of Eyes ",1,2,9,34,1,10,0,43,0
These Guys Sang Mariah Carey's Christmas Smash For A Great Reason,1,3,11,43,1,10,0,54,0
Super Bowl LI: What You Need To Know,1,2,9,19,1,7,0,28,0
11 Haunted Hotels In The UK You Can Actually Stay In This Halloween,1,1,13,40,0,12,2,53,0
17 Incredibly Cool Gifts Your Kids Haven't Gotten Yet,1,1,8,34,1,8,2,42,0
This Comedy Duo Has Some Surprisingly Helpful Office Hacks To Make Your Work Life Better,1,1,15,59,0,14,0,74,0
This Is What Happened When We Showed Non-Australians Photos Of Aussie Stuff,1,3,13,50,1,11,0,63,0
"Samsung Galaxy S8 Review: Great Phone, But That’s Not All That Matters ",1,3,12,43,3,12,1,55,0
Here's what life is like after you quit being a porn star The list,1,3,2,50,1,13,0,52,0
Why you'll NEVER get a flat stomach eating these surprising foods (including healthy broccoli and watermelon),1,3,6,85,3,15,0,91,0
How To Make Delicious Two-Ingredient Sauces That Go With Everything,1,1,11,46,1,9,0,57,0
"Of Course Paul Reubens Will Play Penguin's Dad On ""Gotham""",1,1,10,36,3,9,0,46,0
‘The smell of death was everywhere’: Inside the world’s most dangerous mines,1,2,2,59,4,11,0,61,0
Bacon-Wrapped Appetizers,1,1,3,19,1,1,0,22,0
"Are You Ellen, Paige, Or Ellen Page",1,1,7,20,2,6,0,27,0
8 Things Nobody Tells You About Graduation And Depression,1,1,8,40,0,8,1,48,0
"Glitz, Gowns and Politics at This Year's Oscars ",1,3,6,32,2,8,0,38,0
I Wore Skirts For A Week As A Man And This Is What Happened,1,1,14,32,0,13,0,46,0
"Can You Remember How To Solve The Puzzles From ""Putt-Putt Saves The Zoo""",1,1,14,43,3,12,0,57,0
This Mom Ended “E-Cigging” At Her Teen’s Party In The Most Extra Way,1,3,14,38,4,12,0,52,0
How President Obama used a eulogy to explain his vision of public service,1,3,3,58,0,12,0,61,0
10 things we want to see in 'Fast 9' (or whatever it ends up being called),1,3,1,51,4,15,3,52,0
"This 4 Question ""Gilmore Girls"" Quiz Will Determine What Kind Of Coffee Drinker You Are",1,1,14,56,2,14,1,70,0
If Celebrities' Instagrams Were On Myspace,1,1,6,30,1,5,0,36,0
19 Moments In 2015 That'll Make You Proud To Be Indian,1,1,9,28,1,10,6,37,0
7 Simple (and Cheap) Ways to Upgrade Your Kitchen,1,2,6,32,2,8,1,38,0
Best Deals In Crossovers And SUVs: Rebates Up To $6K And Leases As Low As $169 A Month,1,3,19,43,3,17,4,62,0
People Are Freaking Out About This Teen’s Foot That Was Punctured By A Phone Charger,1,3,15,54,1,14,0,69,0
Which Member Of The Order Of The Phoenix Are You Based On Your Zodiac Sign,1,1,15,45,0,14,0,60,0
NAACP Leader Rachel Dolezal Allegedly Faked Being A Black Woman For Years,1,2,16,46,0,11,0,62,0
How theme parks like Disney World left the middle class behind,1,3,3,49,0,10,0,52,0
21 Words You Won't Truly Understand Unless You're From Miami,1,1,9,38,2,9,2,47,0
This Guy Hilariously Obsessing Over Patti Labelle's Pies Is Everything,1,1,10,50,1,9,0,60,0
Ranking the NBA's Top 50 Free Agents This Summer,1,3,9,28,1,8,2,37,0
Which Ellen DeGeneres Celebrity Scare Is Your Favorite,1,1,9,38,0,7,0,47,0
Here's How To Step Up Your Selfie Game By Thinking Creatively,1,1,11,39,1,10,0,50,0
The 18 biggest breakthroughs for self-driving cars expected by 2030,1,2,1,50,1,9,6,51,0
"You Need To Watch ""Jane The Virgin"" Right This Second",1,1,10,32,2,9,0,42,0
Hereâs what the liquid on top of your yogurt is â and why you should stop pouring it out,1,2,1,69,4,18,0,70,0
28 Tweets About Dieting That Will Make You Laugh Out Loud,1,1,10,35,0,10,2,45,0
These Majestic Photos Will Give You A Spacegasm,1,1,8,32,0,7,0,40,0
16 Celebrity Families Who Are Just Too Adorable On Instagram,1,1,9,40,0,9,2,49,0
Do You Deserve To Join The Ranks Of The Marauders,1,1,10,30,0,9,0,40,0
Man Fights Off Cougar Outside Tim Hortons to Save His Dog,1,2,10,37,0,10,0,47,0
29 Nintendo Presents That Will 1-Up Your Gift-Giving Game,1,1,9,35,2,8,3,44,0
25 Real AF Struggles Anyone Who Works Out Will Recognize,1,1,10,35,0,9,2,45,0
How Astronauts Will Ring in the New Year,1,2,6,27,0,7,0,33,0
"Yahoo hack: How to know if your account has been breached, and what to do next",1,3,2,59,2,15,0,61,0
Which Latina Beauty Bloggers Should Everyone Be On The Lookout For,1,1,11,45,0,10,0,56,0
17 Cheesy Soups That Are Equal Parts Gooey And Delicious,1,1,9,36,0,9,2,45,0
For Everyone Who Goes To Ikea For The Food,1,1,9,25,0,8,0,34,0
Taraji P. Henson Has The Most Perfect Reactions To Being Caught On Camera When She Sings,1,1,16,56,1,15,0,72,0
17 Pictures That Will Leave You With One Very Important Question,1,1,10,42,0,10,2,52,0
Name That Disney Reptile,1,1,4,17,0,3,0,21,0
How Intensely Michigan Are You,1,1,5,21,0,4,0,26,0
Hijab-Wearing Beauty Contestant Lands Prestigious Modeling Contract  [Video],1,3,9,56,3,8,0,65,0
This Girl’s Solo Euro Trip Is Finally Coming To An End With A Grand Reveal,1,3,15,44,1,14,0,59,0
Netflix adds button to skip opening credits of TV shows,1,3,3,43,0,9,0,46,0
23 Gifts For People Who Love Pizza More Than They Love You,1,1,11,34,0,11,2,45,0
The 25 funniest tweets about 2016 The list,1,3,2,27,0,7,6,29,0
True Detective season two – everything we know about new plot and cast,1,3,2,55,1,12,0,57,0
6 USB-C accessories that'll let your new MacBook actually connect to stuff,1,3,6,54,2,11,1,60,0
Dozens of couples went to a top fertility clinic. It may have used the wrong sperm.,1,2,2,64,2,15,0,66,0
19 Images That Are Way Too Real For Anyone Who Uses Instagram,1,1,11,37,0,11,2,48,0
"Four Musicians Played ""Rock Band""  For The First Time And Here's What Happened",1,1,13,49,3,13,0,62,0
"COLUMN-The facts about Social Security, Medicare may surprise you",1,3,10,45,2,8,0,55,0
Donald Trump: ‘Nobody Believes’ Susan Rice,1,2,6,28,3,5,0,34,0
Why Do People Drink Coffee,1,1,5,17,0,4,0,22,0
Which TV Pineapple Are You,1,1,6,16,0,4,0,22,0
12 Must-Haves For An Extremely Classy Christmas,1,1,7,31,1,6,2,38,0
Our Articles on the Attacks Trump Says the Media Didn’t Cover ,1,2,8,42,1,11,0,50,0
Vice President Pence Appears to Support EU Freedom of Movement,1,3,9,44,0,9,0,53,0
"9 ""Ugly"" Animals Going Extinct That Need Love Too",1,1,8,30,2,8,1,38,0
The Complete Evolution Of Donald Trump's Hair,1,1,7,31,1,6,0,38,0
Quiz: Can you spot the 'fake news' headlines about Donald Trump? ,1,3,4,46,4,11,0,50,0
"Advertisers are fleeing Bill O’Reilly, but viewers aren’t",1,3,4,43,3,7,0,47,0
Japan's Startup Founders Are Flocking to This Seaside City in Japan,1,2,9,47,1,10,0,56,0
"Joseph Gordon-Levitt Spectacularly Re-Creates Janet Jackson's ""Rhythm Nation"" Dance",1,1,11,59,5,8,0,70,0
6 Items That Totally Overreact To Being Microwaved,1,2,7,35,0,7,1,42,0
Internet Reacts to Cavaliers' Matthew Dellavedova's Huge Game 3 vs. Warriors,1,3,8,54,3,10,1,62,0
"An unexpectedly beautiful view of fatherhood, from the bathroom floor",1,3,1,58,1,9,0,59,0
The unmistakable anatomy of a President Trump flip-flop,1,2,3,44,1,7,0,47,0
29 Los Angeles Sentences And What They Really Mean,1,1,8,32,0,8,2,40,0
10 Of The Most In-Love Couples On The 2017 Oscars Red Carpet,1,3,11,31,1,11,6,42,0
Pretend To Buy Some Expensive Shit And We’ll Guess Your Exact Age,1,2,12,41,1,11,0,53,0
Cleveland Weatherman Voices Displeasure Over LeBron James' No-Call Foul on TV,1,3,13,52,2,10,0,65,0
5 ways Trump's Supreme Court pick may influence business,1,3,3,43,1,8,1,46,0
19 Ridiculously Clever Products That Will Level Up Your Meal Prep,1,3,10,43,0,10,2,53,0
We visited Wawa and discovered why it's the greatest convenience store chain in America,1,3,3,70,1,13,0,73,0
This Is What It Feels Like To Recover From Maternal Mental Illness,1,1,12,43,0,11,0,55,0
The girl who was 'stolen' by a soldier,1,3,1,28,2,7,0,29,0
Watch This Pup Hilariously Call Out Her Sister For Leaving A Mess In The Kitchen,1,1,15,51,0,14,0,66,0
Which Bath & Body Works Fall Candle Are You,1,1,8,26,1,8,0,34,0
The 10 best tennis moments in culture,1,2,1,28,0,6,2,29,0
These are the two worst high dives you will ever see,1,3,1,41,0,10,0,42,0
The XX Factor: Inside The Fight To Reinvent Financial Advice For Women,1,3,13,45,1,11,0,58,0
How Well Do You Know The Periodic Table Of Elements,1,1,10,32,0,9,0,42,0
What Was Your Worst Cooking Fail,1,1,6,21,0,5,0,27,0
"Wait, What The Fuck Is Going On With This Water Pouring Illusion",1,1,12,40,1,11,0,52,0
Most Brits Think Terrorism Is Inspired by ‘Religious Views’,1,2,8,41,2,8,0,49,0
Man on a sinking car desperately throws infant to stranger on dry land,1,3,1,57,0,12,0,58,0
24 things to consider before taking Adderall,1,2,1,35,0,6,2,36,0
"People Who Have Never Seen ""Star Wars"" Guess Character Names And Fail Adorably",1,1,13,51,2,12,0,64,0
People Try Making Presidential Candidates More Likable,1,1,7,41,0,6,0,48,0
"Can You Guess The Season Of ""How I Met Your Mother"" Based On Lily's Hair",1,1,15,40,3,14,0,55,0
"Heather Graham Rides A Garbage Truck, Remains Perfect",1,1,8,37,1,7,0,45,0
What's Your All-Time Favorite Halloween Movie,1,1,7,31,2,5,0,38,0
Cartel Gunmen Wish Merry Christmas by Beheading Rival in Front of His Children,1,3,10,56,0,12,0,66,0
29 Tried And True Tips Every Brand New Parent Needs,1,1,9,31,0,9,2,40,0
Days Of Our Lives Just Revealed Who The Serial Killer Is,1,1,11,35,0,10,0,46,0
Can We Guess What Type Of School You Went To,1,1,10,25,0,9,0,35,0
21 Photos Short Girls Will Definitely Relate To,1,1,7,31,0,7,2,38,0
ESPN’s Jemele Hill: Trump Should Denounce Racist Acts Done in His Name Instead of Bashing SNL on Twitter,1,3,20,65,2,17,0,85,0
Can You Make It Into This Top Secret Club,1,1,9,24,0,8,0,33,0
27 Times Ellen Won Throw Back Thursday,1,1,6,24,0,6,2,30,0
This Woman Survived One Of The Deadliest Snake Attacks,1,3,9,37,0,8,0,46,0
15 Breathtaking Eyelash Transformations That’ll Shock You,1,3,6,42,1,6,2,48,0
We Know Which Actor You Should Marry Based On Your Favorite YA Book Series,1,1,15,46,0,13,0,61,0
Which Netflix Original Series Are You,1,1,6,26,0,5,0,32,0
What Advice Do You Want From Little Mix,1,1,8,24,0,7,0,32,0
The Americans volunteering to watch executions,1,3,2,39,0,5,0,41,0
Why your phone's battery life gets shorter over time,1,3,1,42,1,8,0,43,0
Tell Us About The Best Valentine's Day Gift You've Ever Received,1,1,11,41,2,10,0,52,0
What Is Your Eyesight Score,1,1,5,18,0,4,0,23,0
"29 Times The ""13 Reasons Why"" Cast Were IRL Friendship Goals",1,2,11,33,2,10,4,44,0
We Need To Talk About Selena Gomez At The Victoria's Secret Fashion Show,1,1,13,46,1,12,0,59,0
Middlesbrough severed penis man's death 'misadventure',1,2,1,45,3,5,0,46,0
9 Period Hacks,1,1,2,9,0,2,1,11,0
Can You Pass This IPA Quiz,1,1,8,13,0,5,0,21,0
33 Tips For Having The Best Sex Of Your Life,1,1,9,24,0,9,2,33,0
13 Valentine's Day Cards For People Who Are Bad At Feelings,1,1,10,36,1,10,2,46,0
"Microsoft’s Scaring Windows 7 Users, Claims It’s Highly Insecure, But Don’t Worry",1,3,11,53,5,11,1,64,0
"Hark, These Public Libraries Are Dueling To The Death to Defend Their Baseball Teams",1,1,13,57,1,13,0,70,0
Adults Revisit Their Imaginary Friends,1,1,5,29,0,4,0,34,0
News Anchor Learns About Her Husband's Death During Live Broadcast,1,3,10,46,1,9,0,56,0
10 Perks Of Having Small Boobs,1,1,5,18,0,5,2,23,0
7 Facts About Potatoes That You Didn’t Know And Will Now Want To Tell Everyone,1,3,14,48,1,14,1,62,0
Amy Schumer Thanking Her Smokey Eye At The Emmys Is All Of Us,1,1,13,36,0,12,0,49,0
26 Cats Working Towards The Destruction Of The Patriarchy,1,1,8,39,0,8,2,47,0
10 Anime Series You Need To Watch Before You Die,1,1,9,28,0,9,2,37,0
How to make peace with close friends and family who backed the other candidate,1,2,1,64,0,13,0,65,0
North West Has The Cutest Closet Of All Time,1,1,9,27,0,8,0,36,0
This Swiss Ski Station Makes More Money When No Snow Falls,1,3,11,37,0,10,0,48,0
Should we be allowed to use superannuation on house deposits?,1,2,1,50,1,9,0,51,0
Beyond Hennessy: Get Fancy With These Five Cognacs,1,3,8,34,1,7,0,42,0
Ryan Reynolds Mentored A Bunch Of X-Men Children As Deadpool,1,1,11,39,1,9,0,50,0
Kimchi Quesadillas,1,1,2,15,0,1,0,17,0
"24 Reasons To Start Watching ""Vicious"" Right Now",1,1,7,30,2,7,2,37,0
19 Cozy Onesies You'll Want To Wear Everywhere,1,1,7,29,1,7,2,36,0
"A Pug And A Frenchie Recreated ""Lady And The Tramp"" And It Was Beautiful",1,1,14,43,2,13,0,57,0
"Israel, Apple, Debbie Reynolds: Your Thursday Briefing ",1,3,7,38,3,7,0,45,0
24 Disappointing White Elephant Gifts People Have Actually Ended Up With,1,1,10,50,0,10,2,60,0
20 Celebrities Who Made A Difference In 2015,1,1,6,25,0,7,6,31,0
Fake News: Judge Neil Gorsuch Did Not Found a ‘Fascist Club’ in School,1,3,11,44,3,12,0,55,0
15 Ooey Gooey Snacks That Take Cheese To The Next Level,1,1,10,33,0,10,2,43,0
How Well Do You Know Sandwiches,1,1,6,20,0,5,0,26,0
"Ezekiel Elliott laments pace of NFL's probe, wants 'closure'",1,3,5,43,4,8,0,48,0
These Cops Took Care Of A Sick Woman's Five Children When She Went To The Hospital,1,1,16,50,1,15,0,66,0
"This Is The New ""Lollipop Lipstick"" Trend And Yeah It’s Gonna Be A No From Me, Dawg",1,3,17,46,4,16,0,63,0
Trump said he wants to replace Obamacare with something 'better' â here's what he could learn from the British,1,3,3,86,5,18,0,89,0
13 Signs You Deserve A Little Break,1,3,6,21,0,6,2,27,0
Mermaid Instructor? Canine Masseuse? The Oddest Hotel Jobs on Earth,1,2,9,47,2,9,0,56,0
If Adele Quotes Were Motivational Posters,1,1,6,30,0,5,0,36,0
Try These Cocktails While You Watch Your Favorite CW Show,1,1,11,37,0,9,0,48,0
Chris Pratt As Santa Claus Is Exactly What You Need Today,1,2,11,36,0,10,0,47,0
Black Hawk Down: The Somali battle that changed US policy in Africa,1,3,8,47,1,11,0,55,0
We Know Your Favorite Celeb Based On Your Least Favorite Celebs,1,1,11,42,0,10,0,53,0
How Does The Way You Read Compare To Everyone Else,1,1,10,31,0,9,0,41,0
Demi Lovato Gave The Best And Worst Possible Answer During This Interview,1,1,12,50,0,11,0,62,0
Which Red Hot Chili Peppers Member Are You,1,1,8,27,0,7,0,35,0
New planet discovered by 15-year-old intern,1,3,1,33,2,5,2,34,0
20 Miranda Sings Tweets To Brighten Your Monday,1,1,7,31,0,7,2,38,0
Buying or Selling MLB Players Turning Heads at Spring Training,1,3,10,43,0,9,0,53,0
De Blasio: NYC Will Be at Risk of Terror If Sessions Cuts Law Enforcement Funding to Sanctuary Cities,1,2,17,66,1,17,0,83,0
27 Insanely Delicious Mexican Recipes You Should Know,1,1,7,37,0,7,2,44,0
Do You Have ESP,1,1,6,6,0,3,0,12,0
Attention Everyone: You Seem To Have Forgotten That Thanksgiving Exists,1,1,10,51,1,9,0,61,0
Scientists have created a fluid with negative mass – but what does it tell us?,1,3,1,61,2,14,0,62,0
"A Silicone Ring Worn Around Your Penis Can Improve Your Sex Life Via An App. Lovely, Isn't It?",1,3,18,55,4,17,0,73,0
Reviving This Law Would Mean the End of Megabanks: QuickTake Q&A,1,2,11,41,2,10,0,52,0
These Earbuds Give You Superhuman Hearing -- And Could Treat Autism & PTSD,1,2,14,45,3,12,0,59,0
Surprise: Good Economic News Isn’t Always Great News for Investors,1,2,9,46,2,9,0,55,0
Amazon’s Jeff Bezos Exploring Legal Challenge to Trump Travel Ban,1,2,9,46,1,9,0,55,0
Natanyahu issues stern warning on Iran in exclusive interview with Fox News ,1,3,4,60,0,12,0,64,0
Why Fox stock is immune to Bill O'Reilly scandal,1,3,5,34,1,8,0,39,0
Merkel Will Pay Migrants Millions To Leave Germany,1,3,8,35,0,7,0,43,0
These Artists Made Tattoos Come To Life And It's Mesmerizing,1,1,10,40,1,9,0,50,0
"The Triumphs And Mistakes That Got J.J. Abrams Ready For ""Star Wars""",1,1,13,40,4,11,0,53,0
"Are You More Like Chanel Or Hester On ""Scream Queens""",1,1,10,32,2,9,0,42,0
"You’re Not Busy, You’re Just Rude",1,2,6,19,3,5,0,25,0
"27 Times Urban Outfitters Went Way, Way Too Far",1,1,8,28,1,8,2,36,0
Dad’s Touching Reaction to Daughter’s Wet Pants Makes Him a Hero [Video],1,2,10,47,4,11,0,57,0
What People Said About Celebrities 9 Years Ago Vs. Today,1,1,9,36,1,9,1,45,0
A Hilariously Accurate Guide To Dog Owners In New York City,1,1,11,38,0,10,0,49,0
18 Things That Are Too Real For People With Onychophagia,1,1,9,36,0,9,2,45,0
"If you're unsure what Theresa May actually meant in that Brexit speech, I've deconstructed it line by line",1,3,5,81,3,17,0,86,0
24 Times Tumblr Felt Things For Jeremy Corbyn,1,1,7,29,0,7,2,36,0
"Sheriff’s Report Provides New Details on Tamir Rice’s Death, but Leaves Questions ",1,3,10,57,3,12,0,67,0
17 Photos About Thanksgiving That'll Make You Laugh Out Loud,1,1,9,39,1,9,2,48,0
The Secrets of 'Something Rotten's' Biggest Number,1,2,6,35,3,6,0,41,0
13 Lesbian Sorority Confessions,1,1,3,23,0,3,2,26,0
Watch Alec Baldwin Deliver Another Brutal Trump Takedown,1,3,8,41,0,7,0,49,0
Airbus-Boeing Speed Race Increasingly Takes Place on the Ground,1,3,8,46,1,8,0,54,0
17 People Who've Been Personally Victimized By Their GPS,1,1,10,35,1,8,2,45,0
"Pair Of Google Home Devices Claim They’re Human, Quote Nickelback",1,2,10,44,2,9,0,54,0
The shattering of an all-American town,1,3,2,30,1,5,0,32,0
An incredible campaigner for women's rights has died and you might not even know her name The list,1,3,2,78,1,17,0,80,0
"Ahead Of Polls In 5 States, SC Says Politicians Can't Seek Votes In Name Of Caste Or Religion",1,2,18,55,2,17,1,73,0
Family holidays Why our parents did holidays better than us,1,3,2,48,0,9,0,50,0
Big Border Tax,1,3,3,9,0,2,0,12,0
Are You More Like General Or Princess Leia,1,1,8,27,0,7,0,35,0
Now You Can Take Your Cat Literally Everywhere With This Genius Pet Carrier,1,1,13,50,0,12,0,63,0
Tyron Woodley: Race a factor in status as 'worst-treated' UFC champ,1,3,6,47,4,10,0,53,0
23 Temporary Tattoos That Make Halloween Makeup Easy,1,1,7,36,0,7,2,43,0
23 People Who Totally Nailed The Black Lipstick Trend,1,1,8,35,0,8,2,43,0
Frightening Celebrity Statues,1,2,3,24,0,2,0,27,0
I Spent My Birthday Alone And I Fucking Loved It,1,1,10,29,0,9,0,39,0
Do You Actually Remember What Cereal Mascots Look Like,1,1,9,37,0,8,0,46,0
US President Obama surprises spokesman at White House briefing,1,3,6,48,0,8,0,54,0
Dash cam captures a man rescuing a teeny kitten that wandered into traffic,1,3,1,61,0,12,0,62,0
Here's 100 Years Of Bollywood Cinema In Under Four Minutes,1,1,9,36,1,9,3,45,0
24 Of The World's Most Insane Record Attempts,1,1,7,28,1,7,2,35,0
Financial Spring Cleaning: What To Keep & What To Toss After Tax Day,1,3,12,42,2,12,0,54,0
The Walking Dead season 7 finale episode: The 5 characters who might die,1,2,4,53,1,12,2,57,0
How Many Of Shia LaBeouf's Movies Have You Seen,1,1,10,28,1,8,0,38,0
29 Things That Will Improve Your Day Immeasurably,1,1,7,33,0,7,2,40,0
"18 Ways ""Fallout"" Has Ruined You For Life",1,1,7,23,2,7,2,30,0
9 Struggles Of Being A K-Pop Fan When You're Not Korean,1,1,11,31,2,10,1,42,0
18 Times You Saw Something Hilarious On The Internet,1,1,8,34,0,8,2,42,0
Lindsey Graham Meets Donald Trump for Lunch–Gives Him New Cell Phone Number,1,2,12,51,1,11,0,63,0
Cat Caught in Garage Door Saved by Deputy ,1,3,6,28,0,8,0,34,0
15 Songs You Loved (But Forgot About) From 10 Years Ago,1,1,9,30,2,10,4,39,0
250 Nuns Just Cycled All The Way From Kathmandu To New Delhi,1,1,11,35,0,11,3,46,0
Rice Pilaf Recipe - NYT Cooking,1,3,7,18,1,5,0,25,0
"Shares in Pearson, Premier Foods and Mitie plunge after profit warning strike",1,3,5,60,1,11,0,65,0
These are the world's drunkest countries The list,1,3,2,39,1,7,0,41,0
Chuck E. Cheese goes to Wall Street: $1 billion IPO reportedly in the works,1,3,8,50,3,13,1,58,0
I Gave Up Sugar For Two Months And Here's What Happened,1,1,11,33,1,10,0,44,0
"Hyderabad Blasts Case: Yasin Bhatkal, 4 Other Indian Mujahideen Operatives Sentenced To Death",1,3,12,66,2,12,1,78,0
10 Celebrities Who Look Exactly Like '00s Disney Channel Characters,1,1,8,45,1,9,4,53,0
19 Life-Changing Ways To Eat Mashed Potatoes This Thanksgiving,1,1,9,42,1,8,2,51,0
A Mexican politician just took his protest right through Trump’s front door,1,3,3,60,1,11,0,63,0
The 17 Most Important Welsh Things That Happened In 2015,1,1,8,33,0,9,6,41,0
When You're Single For The Holidays,1,1,6,23,1,5,0,29,0
22 Pictures That Prove Everyone Is Totally Faking It,1,1,8,34,0,8,2,42,0
"The First Trailer For ""X-Men: Apocalypse"" Is Here And It's Damn Good",1,1,13,39,5,11,0,52,0
19 Christmas Eve Traditions You Probably Didn't Know About,1,1,8,39,1,8,2,47,0
The new £1 coin is here and still causing problems,1,3,1,38,1,9,1,39,0
Gay couple who were technically father and (adoptive) son allowed to marry,1,3,1,60,2,11,0,61,0
Syria chemical attack: Sarin gas likely weapon used in Idlib as experts say Russian claims 'don't add up',1,3,4,80,4,17,0,84,0
23 Delightfully Weird Office Items Every Medical Nerd Will Love,1,1,9,43,0,9,2,52,0
Sign Up For BuzzFeed's 10-Day Best Semester Ever Course,1,1,10,33,2,8,2,43,0
"28 Reasons Absolutely Everyone Hates Hamilton, Ontario",1,1,6,39,1,6,2,45,0
"Today Is National Working Naked Day, So Take Off All Your Clothes",1,1,12,41,1,11,0,53,0
We Know Whether Your Relationship Status Will Change This Year,1,1,10,43,0,9,0,53,0
"A third of US millennials still live at home, census report finds",1,3,3,50,1,11,0,53,0
Cyclone Debbie: Meet the storm chaser who gets a thrill from severe weather,1,3,3,59,1,12,0,62,0
Caddell: ‘It’s a Trump White House But Is This Going to Be a Ryan Government?’,1,2,12,47,5,14,0,59,0
"Which ""Jessica Jones"" Character Should You Team Up With",1,1,9,36,2,8,0,45,0
The Oscars: Everything you need to know (and some things you don't),1,3,3,49,4,11,0,52,0
18 Pics Of You On Thanksgiving,1,1,5,18,0,5,2,23,0
5 things Australians need to know from Apple's 2015 WWDC keynote,1,3,6,42,1,10,5,48,0
23 Hilarious Memes That Explain Greek Life At A Black School,1,1,10,38,0,10,2,48,0
Eat These 8 Foods to Fight Your Crappy Cold,1,3,7,27,0,8,1,34,0
Fake News: Guardian Caught Deceptively Editing Quotes from Julian Assange Interview,1,3,10,62,1,10,0,72,0
"17 Images That Will Make You Say ""I Had No Idea""",1,1,10,24,2,10,2,34,0
Hair-Raising Photos From The World Beard Championship 2015,1,1,8,38,1,7,4,46,0
How Gross Is Your Relationship Compared To Everyone Else's?,1,3,9,40,2,8,0,49,0
"Here are the missiles North Korea just showed off, one by one.",1,3,3,46,2,11,0,49,0
Do You Know How To Pronounce GIF,1,1,9,17,0,6,0,26,0
"31 Things That Actually Happen In Episode 1 Of ""The Young Pope""",1,3,10,37,2,11,3,47,0
24 Times Kris Jenner Was Shut Down By Her Own Kids,1,1,10,28,0,10,2,38,0
"How the 20,699-word iTunes T&Cs became this year's hottest graphic novel",1,3,4,49,4,10,5,53,0
Here's How You Should Actually Be Eating Thanksgiving Leftovers,1,1,9,45,1,8,0,54,0
"22 Lady Gaga Looks That’ll Leave You, Honestly, Shook",1,3,8,32,3,8,2,40,0
These Cheap And Fancy Faux Brass Hangers Will Upgrade Your Space,1,1,11,43,0,10,0,54,0
Prince Harry And Harry Styles Met And All Our Harry Dreams Came True,1,1,13,43,0,12,0,56,0
"SC Hears Nirbhaya's Rapists Death Penalty Appeal, ISRO Launches 104 Rockets And Other Must Reads",1,3,18,59,2,14,3,77,0
26 Heavenly Pumpkin Desserts That Are Better Than Pumpkin Pie,1,1,9,41,0,9,2,50,0
18 Delicious Indian Foods That Aren't Curry,1,1,6,28,1,6,2,34,0
Who Said It: Tyrion Lannister Or Ron Swanson,1,1,8,28,1,7,0,36,0
"Why All Those Samsung Phones Caught On Fire, According To Samsung",1,2,11,43,1,10,0,54,0
How Well Do You Remember These '90s Premier League Goalkeepers,1,1,9,41,1,9,2,50,0
Are you a young person thinking of entering politics?,1,2,1,43,1,8,0,44,0
Movement for Third Gender Option 'Exploding' in U.S.,1,2,7,34,4,7,0,41,0
19 Hilarious Jokes About Being An Intellectual That Will Make You Say “Me”,1,2,12,46,2,12,2,58,0
35 Photos Of People Taken The Moment They Got The Fright Of Their Lives,1,1,13,43,0,13,2,56,0
100 Genius Hacks Guaranteed To Make A Parent’s Job Easier,1,2,9,35,1,9,3,44,0
"The Year's Biggest Breakout Stars In Film, TV, And Theater",1,1,11,35,3,9,0,46,0
18 Dating Stories That Will Make You Want To Ask Out Your Crush,1,1,12,37,0,12,2,49,0
15 Delicious Dessert Dips Guaranteed To Satisfy Your Sweet Tooth,1,1,9,44,0,9,2,53,0
This Trainer Intentionally Gained 70 Pounds So He Could Help A Client Lose Weight,1,1,13,53,0,13,2,66,0
The activist tackling Mumbai's rubbish mountain,1,3,2,39,1,5,0,41,0
This Moving Ad For 'Rogue One' Has People In Tears,1,3,10,29,2,9,0,39,0
19 People Who Contoured Better Than You In 2015,1,1,7,26,0,8,6,33,0
"What ""Force Awakens"" Fan Art Should We Draw",1,1,8,26,2,7,0,34,0
The 2016 ranking of the 10 most innovative universities in the world,1,3,1,50,0,11,6,51,0
Here's A Look Inside This Adult Coloring Book About The Beauty Of Natural Hair,1,1,14,50,1,13,0,64,0
2017 Horoscopes for Your Favorite Dealmakers,1,2,4,31,0,5,4,35,0
"NAACP’s Barber: Before the Russian Hack, There Was a Racist Hack",1,3,13,38,3,10,0,51,0
18 Things You Didn't Know You Could Do In San Diego,1,1,10,28,1,10,2,38,0
24 Breathtaking Spots You Need To Visit In Western Australia,1,1,9,40,0,9,2,49,0
These GIFs Of Joseph-Gordon Levitt Will Definitely Make You Smile,1,1,13,42,1,9,0,55,0
Ernesto Zedillo: Mexico can thrive without Trump,1,2,4,37,1,6,0,41,0
"DHS Kelly Slams Obama’s Policies, Proclaims ‘Sacred Duty’ To Protect America",1,2,13,49,4,10,0,62,0
What's The Worst Thing You've Ever Put In Your Mouth,1,1,10,31,2,9,0,41,0
This Instagram Account Satirizing Fancy Dining Is Actually The Work Of A Canadian Chef,1,1,14,59,0,13,0,73,0
21 Bite-Size Desserts That Are More Satisfying Than A Boyfriend,1,1,10,41,1,9,2,51,0
Tragic kingdoms – the Disney lands that flopped,1,3,2,37,1,7,0,39,0
How Well Do You Know The Lyrics To 5 Seconds Of Summer's Songs,1,1,12,36,1,12,1,48,0
90-year-old man writes tips to combat loneliness after losing his wife and sister,1,2,0,65,2,12,2,65,0
22 Things You Totally Forgot You Used To Do On Facebook,1,1,10,33,0,10,2,43,0
5 Ways a Smart Assistant Can Transform Your Morning,1,2,7,35,0,8,1,42,0
We Tried The Kylie Jenner Lip Kit And Had A Great Time,1,1,12,31,0,11,0,43,0
Kim Kardashian and Chrissy Teigen have officially launched a book club,1,3,4,56,0,10,0,60,0
A Husband Planned A Surprise For His Wife Before He Died,1,3,11,35,0,10,0,46,0
How Well Do You Know HBO Shows,1,1,9,15,0,6,0,24,0
21 Hilarious Tweets That Perfectly Capture Your Feelings About Dating,1,1,9,49,0,9,2,58,0
What surprises foreigners about the US - Business Insider,1,3,5,43,1,8,0,48,0
"20 Holiday Makeup Looks, Because Sometimes a Girl Needs Options",1,2,8,43,1,9,2,51,0
How protesters plan to get under Trump’s skin wherever he goes,1,3,2,49,1,10,0,51,0
India's First Queer Graphic Anthology Is Here And It Looks Freaking Amazing,1,1,12,51,1,11,0,63,0
19 Pictures That Are Way Too Real For All-Girl Friend Groups,1,1,11,36,1,10,2,47,0
The 10 Most Popular Celebrities On Twitter In 2015,1,1,7,29,0,8,6,36,0
These Straight Men Asked Gay Men Questions About Life And Sex,1,1,11,40,0,10,0,51,0
Everything You Need to Know About How a Supreme Court Nominee Gets Confirmed ,1,3,11,53,0,13,0,64,0
This Dog Begging For His Human's Forgiveness Is The Cutest Thing You'll See Today,1,1,14,52,2,13,0,66,0
"Alexander Melamid Begins Artenol, an Art Magazine ",1,2,6,36,1,7,0,42,0
Mall Owners Find Relief From Unlikely Source: Online Retailers ,1,3,9,44,1,9,0,53,0
"Trump: Christian Refugees ‘Horribly Treated,’ ‘We Are Going to Help Them’",1,3,10,47,6,10,0,57,0
World's 'most colourful 5k run',1,3,1,22,3,4,1,23,0
Here's The Best Irish Bar In Every State,1,1,8,24,1,7,0,32,0
Donald Trump thinks he can convince Rand Paul on Republicans’ Obamacare replacement. Here’s how.,1,3,7,72,4,13,0,79,0
"How Well Do You Remember Season 1 Of ""Friends""",1,1,8,27,2,8,1,35,0
The Cubs’ Theo Epstein had a home run response to getting named the ‘world’s greatest leader’,1,3,4,70,4,15,0,74,0
"Muslims Globally Are Condemning Islamophobia By Tweeting Support For Paris With ""I Am A Muslim""",1,1,15,64,2,14,0,79,0
"Bollywood Music Videos Without Music Are The Funniest Thing Online, And We Need More",1,1,14,56,1,13,0,70,0
Braces Can Be Beautiful. Here’s Proof.,1,3,6,24,3,5,0,30,0
This Is What Dating Looks Like Early On Vs. After A Long Time,1,1,13,35,1,12,0,48,0
Caerphilly farmer may get full payout after 24 year wait,1,3,1,44,0,9,2,45,0
These Women Wore Cargo Shorts For A Week And Decided They Were OK,1,1,14,39,0,12,0,53,0
"Here's What The Cast Of ""High School Musical"" Looks Like Now",1,1,11,36,3,10,0,47,0
25 Times Gina Rodriguez Was The Most Adorable Celeb On Instagram,1,1,10,42,0,10,2,52,0
The Original Wiggles Might Reunite This Winter And This Is Not A Drill,1,1,13,45,0,12,0,58,0
Smartphone thefts drop as kill switch usage grows,1,3,1,41,0,7,0,42,0
Here Are the Best and Worst 2017 April Fools' Day Pranks So Far,1,2,10,36,1,12,4,46,0
"Sunil Grover Writes An Open Letter To Pm Modi, Urges Him To Get Dawood Nabbed",1,3,15,47,1,14,0,62,0
This Is Not a Drill: You Can Now Intern for Barack and Michelle Obama,1,3,11,44,1,13,0,55,0
27 Important Questions All Teachers Have Asked,1,1,6,32,0,6,2,38,0
What Kind Of Pet Should You Adopt Based On Your Birth Month,1,1,12,36,0,11,0,48,0
Should You Be A Fan Of 5SOS Or The 1975,1,1,11,14,0,9,5,25,0
Women React To Awful Sex Advice Throughout History,1,1,8,35,0,7,0,43,0
"McCain, Graham Join Democrats, Demand Probe into Claims of Russian Hacking",1,2,10,52,2,10,0,62,0
Chemists have bad news about your cough syrup,1,3,1,37,0,7,0,38,0
This Robot Nerd Can Do A Rubik's Cube In One Second,1,1,11,29,1,10,0,40,0
People Are Losing Their Shit At That New Mysterious Adele Advert,1,1,11,43,0,10,0,54,0
"Britney Spears Went Hiking, Slayed Some Mountains, Slaughtered Some Streams",1,1,10,54,2,9,0,64,0
We Found Out Who The BABE Was Sitting Behind Jake Tapper At The GOP Debate,1,1,20,40,0,14,0,60,0
Here’s How Women Used The Internet In 2016 To Give All The Fucks,1,3,12,35,1,12,4,47,0
Paris Police: 16 Arrested Over Kim Kardashian West Jewelry Heist,1,3,9,43,1,9,2,52,0
12 Inspiring Fashion Illustrators To Follow On Instagram,1,1,7,40,0,7,2,47,0
Must-have 'fatbit' fitness gadgets can exaggerate your step count by 25% every day ,1,2,1,63,4,13,2,64,0
"The Little Girl From ""Titanic"" Is All Grown Up And Still Crazy Adorable",1,3,13,44,2,12,0,57,0
We Made People Try Unusual Toothpastes,1,1,6,27,0,5,0,33,0
31 Gorgeous Furniture Upgrades For Your Grown Up Apartment,1,1,8,40,0,8,2,48,0
24 Leonardo DiCaprio Oscar Jokes Because He Might Win One Soon,1,1,11,39,0,10,2,50,0
We Know Which Celebrity You Should Marry Based On Your Sign,1,1,11,38,0,10,0,49,0
"If ""Oregon Trail"" Was Made For Twentysomethings",1,1,7,32,2,6,0,39,0
19 Things You Missed At The 2017 SAG Awards,1,3,9,20,0,8,6,29,0
25 Stereotypes Feminists Are Sick And Tired Of Hearing,1,1,8,36,0,8,2,44,0
Wondering About Your Job Application? The Best Way To Follow Up On Your Resume,1,3,14,50,1,13,0,64,0
Lisa Frank Illustrations Used To Outline The Pointlessness Of It All,1,1,11,47,0,10,0,58,0
Pork Tenderloin Stuffed With Herbs and Capers Recipe - NYT Cooking,1,3,11,44,1,10,0,55,0
8 Things No One Tells You About Working With Anxiety,1,1,9,33,0,9,1,42,0
People Are Hashtagging #IWillNotApologizeForBeingDarkSkin To Celebrate Their Complexion,1,1,15,64,1,7,0,79,0
How Do You Survive Getting Married When Your Parents Are Divorced,1,1,11,44,0,10,0,55,0
"Meet Dhee, Bangladesh's First Lesbian Comic Book Character",1,1,8,41,2,7,0,49,0
"£100,000 lottery funding given to suspected illegal faith schools",1,2,0,49,2,8,6,49,0
What To Do After You Get Rejected,1,1,7,20,0,6,0,27,0
23 Products Everyone Who Loves To Wine Should Own,1,1,8,31,0,8,2,39,0
Americans Review Australian Currency,1,1,4,29,0,3,0,33,0
This documentary inspires pilots to 'fly like a girl',1,3,1,42,2,8,0,43,0
21 Things That Happen When You Get Drunk With Your Colleagues,1,1,10,39,0,10,2,49,0
"The Internet Was Fucking Me Up: Patrick DeWitt On Books, Bubbles, & Bullshit",1,1,13,47,4,12,0,60,0
Where The Wealthiest Women Celebrities Go On Vacation,1,2,8,38,0,7,0,46,0
Here come ADP private payrolls ...,1,3,4,22,3,5,0,26,0
Are You More Sally Or Jack Skellington,1,1,7,25,0,6,0,32,0
Dabbing or sneezing at Congress photocall?,1,3,2,34,1,5,0,36,0
Fatah Spokesperson: Trump Moving U.S. Embassy to Jerusalem Will ‘Open the Gates of Hell’,1,2,12,58,5,13,0,70,0
"The Meaning Of Life, According To 19 Normal People",1,1,8,31,1,8,2,39,0
Joe Biden Has Some Strong Words For Betsy DeVos,1,3,10,29,0,8,0,39,0
21 Things Military Spouses Won't Tell You,1,1,6,26,1,6,2,32,0
Eric Holder to help investigate Uber sexual harassment allegations,1,2,3,55,0,8,0,58,0
Are You More BB-8 Or R2-D2,1,1,8,8,2,5,3,16,0
"How Well Do You Remember The Lyrics To ""Everybody (Backstreet's Back)""",1,1,11,44,5,10,0,55,0
13 Climate Scientists On What Makes Them Optimistic,1,1,7,35,0,7,2,42,0
19 Things You'll Understand If You Refuse To Answer Your Phone,1,1,10,39,1,10,2,49,0
19 Things Everyone With Naturally Thick Eyebrows Knows To Be True,1,1,10,43,0,10,2,53,0
19 Things Everyone Should Do After A Break-Up,1,1,8,27,1,7,2,35,0
Where In Wales Should You Actually Live,1,1,7,26,0,6,0,33,0
Are You A Power Player Or A Big Baby,1,1,9,19,0,8,0,28,0
Dudes Re-Create The NFL's Greatest Plays,1,1,9,24,2,5,0,33,0
16 Shows On Netflix You Should Definitely Binge-Watch This Weekend,1,1,10,44,1,9,2,54,0
"25 Questions All ""One Tree Hill"" Fans Need Answered",1,1,8,31,2,8,2,39,0
"Which Lana Del Rey ""Honeymoon"" Song Are You",1,1,8,26,2,7,0,34,0
19 Valentine's Day Treats That Are Actually Better Than A Boyfriend,1,1,10,44,1,10,2,54,0
Things We Still Ask Our Dads,1,1,6,17,0,5,0,23,0
Who Said It: Donald Trump Or Kanye West,1,1,8,23,1,7,0,31,0
Pentagon to NATO: ‘We Want Everyone to Pay Their Fair Share’,1,2,12,35,3,10,0,47,0
15 Behind-The-Scenes Pics Of Vance Joy From The 1989 World Tour,1,1,11,34,2,10,6,45,0
"Here's The Body-Positive Reason ModCloth Ditched Their ""Plus"" Section",1,1,11,46,4,8,0,57,0
Here's why your iPhone has a tiny hole next to the camera,1,3,2,43,1,11,0,45,0
27 Vines That Will 100% Make You Laugh,1,1,6,19,1,7,5,25,0
The Try Guys Try Coding With Girls Who Code,1,1,9,26,0,8,0,35,0
13 Easy Bedroom Upgrades To Change The Way You Sleep,1,1,9,32,0,9,2,41,0
For Everyone Who Thinks Hermione Should Have Ended Up With Harry,1,1,11,43,0,10,0,54,0
Can You Identify The Romantic Comedy Based On A Single Quote,1,1,11,39,0,10,0,50,0
Teens Tried To Text Using T9 And Hated Life,1,1,9,25,0,8,1,34,0
"Crazy Sumit's Kiss-And-Run Video Had Over One Lakh Hits, Earned Him Around Rs 70,000!",1,3,15,46,6,13,5,61,0
"A Video, a Wheelchair, a Suitcase: Mystery of Vanished Tycoon Deepens ",1,3,8,48,3,11,0,56,0
We Know How Tall You Are,1,3,6,13,0,5,0,19,0
Women of the world united,1,2,1,20,0,4,0,21,0
15 Things People Are 100% Sure About Until They Have Kids,1,1,9,32,1,10,5,41,0
"Which Secondary ""Vampire Diaries"" Character Are You",1,1,7,36,2,6,0,43,0
Republicans Unfazed by Controversies Surrounding Cabinet Nominees ,1,3,6,53,0,7,0,59,0
23 First Tweets From Famous Authors,1,1,5,23,0,5,2,28,0
George Washington University History Majors No Longer Required to Take U.S. History,1,2,12,58,2,11,0,70,0
Which HGTV Show Should You Watch When You're Filled With Existential Dread,1,1,15,47,1,11,0,62,0
This Video Of A Man Pushing A Bin Up An Icy Path Is The Funniest Thing You'll See Today,1,1,19,49,1,18,0,68,0
"Super Bowl 2017: Schedule, Time, Channel and Date for Patriots vs. Falcons ",1,2,8,47,4,12,4,55,0
'Game of Thrones' fan deciphers the tiny reflections in Season 7 promo,1,3,3,53,2,11,1,56,0
If Beauty Ads Only Used The Actual Product Being Advertised,1,1,10,40,0,9,0,50,0
Jim Harbaugh shares milk with mail truck driver who hit him as kid,1,3,2,52,0,12,0,54,0
What's The Best Halloween Costume Your Kid Has Ever Worn,1,1,10,36,1,9,0,46,0
11 Scientific Predictions About The Future That Are Seriously Crazy,1,1,9,47,0,9,2,56,0
Norway Moves Towards ‘Third Gender’ Option for Passports,1,3,7,40,2,7,0,47,0
Leonardo DiCaprio Vaped At The SAG Awards And The Internet Lost Its Mind,1,1,16,44,0,12,0,60,0
"'Lucky to Be Alive,' Says Woman Who Claimed to See Escaped Murderers After New York Prison Break",1,3,15,62,3,16,0,77,0
Does Your Favorite Superhero Movie Pass The Bechdel Test,1,1,9,39,0,8,0,48,0
Which Fictional Couple Are You And Your Fictional Significant Other,1,1,10,48,0,9,0,58,0
"The Cast Of ""The Office"" Reimagined As Disney Characters",1,1,9,37,2,8,0,46,0
33 Insanely Beautiful Formal Dresses You Can Actually Afford,1,3,8,42,0,8,2,50,0
What Basic Fall Activity Should You Do With Your S.O,1,1,11,31,1,9,0,42,0
U.S. Soccer Star Abby Wambach: Playing on Turf a ‘Nightmare’,1,3,9,37,5,9,0,46,0
For Everyone Who Wasn't Allowed To Celebrate Halloween,1,1,8,38,1,7,0,46,0
The Try Guys Try Korean Cooking,1,1,6,20,0,5,0,26,0
This Is What Disney Characters Would Look Like On Instagram,1,1,10,40,0,9,0,50,0
We Know Your Relationship Status Based On Your Opinions About 2015,1,1,10,42,0,10,4,52,0
11 Celebrity #TBT Photos You May Have Missed This Week,1,1,11,31,1,9,2,42,0
This Facebook message prank is a genius way to troll your friends ,1,2,2,52,0,12,0,54,0
Soulja Boy Reveals The Very Sad Reason He's Been Beefing With Chris Brown,1,3,13,47,1,12,0,60,0
China's Great Balance Sheet Play,1,2,5,22,1,4,0,27,0
Predictions on the top free agent for each NFL team,1,3,4,38,0,9,0,42,0
42 Very Urgent Questions I Have For Cats,1,1,7,24,0,7,2,31,0
An oral history of the night baseball stopped to retire No. 42 forever,1,3,2,53,1,12,2,55,0
Teenagers who smoke cannabis damage their brains for LIFE and may be more likely to develop schizophrenia,1,3,5,84,0,16,0,89,0
Nostalgic! TV's Iconic Bahus Parvati And Tulsi Pose For An Epic Selfie With Ekta Kapoor,1,3,16,55,2,14,0,71,0
23 Things Americans Can Honestly Never Understand About Britain,1,1,8,45,0,8,2,53,0
19 Viral Videos That Will Be 10 Years Old In 2016,1,1,8,23,0,10,8,31,0
17 Things People Obsessed With Eye Makeup Will Relate To,1,1,9,36,0,9,2,45,0
"13 Things That Will Definitely Maybe Happen In ""Game Of Thrones"" Season 6",1,1,11,45,2,12,3,56,0
Are These Pumpkin Spice Products Real Or Fake,1,1,8,30,0,7,0,38,0
Good Morning America had an incredibly offensive way of introducing Hillary Clinton The list,1,3,6,73,0,13,0,79,0
Bill Murray Came To BuzzFeed And Gave Us Some Damn Good Life Advice,1,1,14,41,0,12,0,55,0
Caddell: ‘It’s a Trump White House But Is This Going to Be a Ryan Government?’,1,3,12,47,5,14,0,59,0
21 Secrets Victoria's Secret Employees Will Never Tell You,1,1,8,39,1,8,2,47,0
The Trouble With Disney’s Remake Machine,1,3,6,28,1,5,0,34,0
School Van Driver Held For Raping Minor Girls In His Car For Over 6 Months,1,3,14,45,0,14,1,59,0
Cartoon Network Just Released Its First Original Mobile Game,1,1,9,43,0,8,0,52,0
Obama âThe Obamas came from a place we all came fromâ,1,3,3,40,4,10,0,43,0
Answer These Five Questions And We'll Tell You Where You Should Live In The U.S,1,1,16,47,2,14,0,63,0
9 incredible ways we're using drones for social good,1,3,0,42,1,8,1,42,0
21 Hilarious Tweets About Pizza,1,1,4,21,0,4,2,25,0
B/R Presents: NFL1000 Guide to Day 2 of the 2017 NFL Draft,1,3,12,24,2,11,9,36,0
19 Surprising Things You Probably Didn't Know About Herpes,1,1,8,39,1,8,2,47,0
17 Siblings Who Are About To Be In So Much Trouble,1,1,10,28,0,10,2,38,0
Which Celeb Does This Person Think They Look Like,1,1,9,32,0,8,0,41,0
Which Famous Couple Are Actually Your Parents?,1,2,7,32,1,6,0,39,0
Snoop Dogg - the next CEO of Twitter?,1,3,6,22,2,7,0,28,0
We Know Your Approximate Age Based On Popular Movies You Haven't Seen,1,1,12,45,1,11,0,57,0
17 weird jobs you probably didn't know exist,1,3,0,34,1,7,2,34,0
"Ellen Page Gets Her Flirt On With Julianne Moore In The First ""Freeheld"" Clip",1,1,14,48,2,13,0,62,0
"Let's Be Honest, GOP Candidate Lindsey Graham Has Dazzlingly Beautiful Eyes",1,1,13,50,2,10,0,63,0
Here are 7 Easy Fall Dinners To Make This Week,1,1,8,28,0,9,1,36,0
21 Reasons Michael B. Jordan Is Everything On Instagram,1,1,8,36,1,8,2,44,0
It's Time To Talk About How The Recast Dumbledore Was Literally The Worst,1,1,13,47,1,12,0,60,0
What's My Tax Bracket?,1,2,4,13,2,3,0,17,0
What Video Games Are These Cheat Codes From,1,1,8,28,0,7,0,36,0
Meet The Hottest Cop Ever,1,1,5,16,0,4,0,21,0
"'Orphan Black' Season 3, episode 9 recap: Family ties",1,2,4,35,4,8,2,39,0
Can You Identify The Justin Bieber Music Video By Its YouTube Comment,1,1,13,45,0,11,0,58,0
We Asked A Bunch Of Married Lesbian Couples: How Did You Pop The Question,1,1,14,45,1,13,0,59,0
20 Cereal Recipes to Stress-Eat Between New Episodes of Serial,1,1,8,42,1,9,2,50,0
Marshawn Lynch teases Raider Nation with cryptic tweet,1,2,4,43,0,7,0,47,0
"For These Women, A Period Triggers A Living Hell",1,3,9,30,1,8,0,39,0
Rachel Maddow Is The Only Cable News Host On List Of Most-Streamed Primetime Programs,1,2,15,56,1,13,0,71,0
17 Early '00s Kids Shows You Probably Forgot About,1,1,7,30,1,8,4,37,0
"Salt Bae voted, and it definitely deserves a new Photoshop Battle",1,3,4,50,1,10,0,54,0
Optimism Among U.S. CEOs Shows Biggest Increase Since 2009,1,3,11,33,2,8,4,44,0
"Steve Kerr gave Kevin Durant a ruthless assignment against the Thunder, and it worked the way they planned",1,3,5,83,1,17,0,88,0
15 Things That May Or May Not Be Amaze,1,1,8,20,0,8,2,28,0
Swedes ‘Scream and Cry’ as ‘Refugee Children’ Deported for Lying About Their Age,1,3,10,54,4,12,0,64,0
Can You Solve This New Years Crossword,1,1,7,25,0,6,0,32,0
Bryan Cranston Married A Couple On A Plane Because He Can Do Anything,1,1,13,44,0,12,0,57,0
"Is this ancient, bag-like sea creature our earliest ancestor?",1,3,1,49,3,8,0,50,0
42 Amazing Makeup Palettes That Are Almost Too Pretty To Use,1,3,10,38,0,10,2,48,0
Bros Give Money Advice,1,1,4,15,0,3,0,19,0
How Alice's 'Resident Evil' homecoming will change everything (Paid Content by Sony),1,3,7,61,5,11,0,68,0
8 Comics About A Talking Dog Who Knows The Truth,1,1,9,29,0,9,1,38,0
Christmas: The weird and wonderful ways the world is celebrating,1,3,2,52,1,9,0,54,0
19 Times Women Perfectly Demonstrated How To Slay Fuckboys On Tinder,1,1,10,46,0,10,2,56,0
"These 24 Moments From ""Pride & Prejudice"" Will Make Your Heart Melt",1,1,10,41,3,11,2,51,0
7 adrenaline-fuelled activities that will chase the post summer blues away (Toyota C-HR),1,3,4,67,4,12,1,71,0
Russia and the art of 'kompromat',1,2,1,25,2,5,0,26,0
"Oh, No, It’s Snowing! What’s Poor Portland to Do?",1,3,8,27,6,8,0,35,0
Why the Olympics Washington didn’t win could still transform the city,1,2,3,55,1,10,0,58,0
Celebrity Names According To Justin Bieber,1,1,6,31,0,5,0,37,0
22 Adorable Things You Need If You Love Pandas,1,1,8,28,0,8,2,36,0
Pot's thriving black market,1,3,1,22,1,3,0,23,0
US Prepares to Seek Arrest of Julian Assange,1,3,7,30,0,7,0,37,0
Here's A T-Rex Riding A Soccer-Playing Horse Because Of Course,1,1,12,38,3,9,0,50,0
U.S. to Deploy 300 Marines to Taliban Hotbed to Train Afghan Soldiers,1,3,9,44,2,11,3,53,0
14 Times Space Was Trippier Than LSD,1,1,8,20,0,6,2,28,0
Watch people face their greatest fear and put an iPhone underwater on purpose,1,3,2,63,0,12,0,65,0
It Looks Like JPMorgan Is Building a Robo Adviser,1,3,10,31,0,8,0,41,0
"This Cover Of AC/DC's ""Thunderstruck"" On Bagpipes Is Fierce AF",1,1,14,35,4,9,0,49,0
"Black Mirror Creator On David Cameron's PigGate: ""I Didn't Try To Predict This""",1,1,14,48,5,12,0,62,0
27 Hilarious Tweets About Med School That Will Make You Laugh Then Cry,1,1,12,44,0,12,2,56,0
How Confident Are You Actually,1,1,5,21,0,4,0,26,0
The Ultimate Original Vs. Sequel Movie Quiz,1,3,7,29,1,6,0,36,0
12 Trees That Would Be Getting Tons Of Ass If They Were Human,1,1,12,35,0,12,2,47,0
Looking For An Ideal Calcium Rich Recipe To Keep Those Bones Healthy? Here You Go!,1,3,15,51,2,14,0,66,0
15 Life-Changing Stuffings Guaranteed To Impress Your In-Laws,1,1,9,41,2,7,2,50,0
This Might Be One Of The Most Vivid Sex Ed Books Ever,1,1,12,30,0,11,0,42,0
Please Drop Everything And Tell Us Whether You're A Morning Person Or A Night Owl,1,1,15,51,1,14,0,66,0
We Got Very Drunk (At Work) On Kingfisher's New Breezer-Style Drink,1,1,12,41,4,10,0,53,0
What your Facebook profile picture says about you The list,1,2,3,46,0,9,0,49,0
21 Last-Minute Punches And Cocktails To Get You Through Thanksgiving Weekend,1,1,11,52,1,10,2,63,0
This ’00s Quiz Will Reveal Your Age And Location,1,2,8,29,1,8,2,37,0
Has LIGO Already Discovered Evidence For Quantum Gravity?,1,3,11,38,1,7,0,49,0
We Know What TV Show You Should Watch Based On Your Mood,1,3,13,32,0,11,0,45,0
Here's What Happens When You Photoshop Men Out Of The Workplace,1,1,11,41,1,10,0,52,0
Ranking Kanye West's Albums From Worst To Best,1,2,8,30,1,7,0,38,0
How Many British Movies Did You Watch In 2015,1,1,8,25,0,8,4,33,0
"Trump, a Free-Form Leader, Experiments and Invites Drama ",1,3,7,39,3,8,0,46,0
42 Seriously Useful Tips Every Clean Freak Needs To Know,1,1,9,36,0,9,2,45,0
A Daughter Is Turning To Social Media After She Realized Her Mom Was Lonely,1,1,14,48,0,13,0,62,0
20 Funny Tweets About Getting Old That Are Too Real,1,3,9,31,0,9,2,40,0
The end is nigh for the World Health Organisation,1,2,4,37,0,8,0,41,0
This Facebook Post About A Love Story From The 1970s Has Gone Massively Viral,1,1,13,47,0,13,4,60,0
We Know Your Zodiac Sign Based On Which Tissue Box You Choose,1,1,12,38,0,11,0,50,0
Pakistan's bloody week: Who is really to blame?,1,3,2,35,3,7,0,37,0
North Koreans set to celebrate leader amid tensions,1,3,2,42,0,7,0,44,0
20 Pictures That Are Way Too Real If You Are A Biryani Addict,1,1,12,35,0,12,2,47,0
"A Woman Was Shocked To See Semen Stains On Her Jeans, As A Man Masturbated At Her During A Festival",1,3,20,59,1,19,0,79,0
Venus Williams Was Compared To A 'Gorilla' By A Commentator And Now He's Dropped!,1,3,14,50,4,13,0,64,0
"Everything you want to know about the Trump Cabinet confirmation hearings, votes",1,3,3,65,1,11,0,68,0
Report: Court Documents Show FBI Used Best Buy ‘Geek Squad’ to Gather Evidence,1,3,14,49,3,12,0,63,0
"23 Gifts Every ""Legend Of Zelda"" Fan Will Love",1,1,8,26,2,8,2,34,0
Sean Spicer: More and More Reports Show Obama Administration Spied on Trump,1,2,10,53,1,11,0,63,0
This Woman Does Yoga With Her Pet Goat And It's Almost Too Cute,1,1,13,37,1,12,0,50,0
These Calculations About Student Loans Might Be Too Real,1,1,9,39,0,8,0,48,0
"A third of US millennials still live at home, census report finds",1,2,3,50,1,11,0,53,0
The House ethics committee is investigating Devin Nunes. What does that mean?,1,3,5,59,2,11,0,64,0
21 Secrets McDonald's Employees Won't Tell You About,1,1,8,33,2,7,2,41,0
"7 Essays To Read: Finding Feminism, Loss, And Having Brain Surgery While Awake",1,1,12,50,3,12,1,62,0
17 Alleged Mexican Cartel Operatives Charged in Colorado,1,3,6,41,0,7,2,47,0
Facts That Will Be Truly Upsetting To '90s Girls,1,2,8,29,1,8,2,37,0
What Does GOP Even Stand For,1,1,8,15,0,5,0,23,0
Surprise! Trump is listening to critics,1,3,2,31,1,5,0,33,0
20 Badass Tattoos Inspired By Health And Wellness,1,1,7,33,0,7,2,40,0
"Twenty years on, where is the legacy of Tiger Woods’ defining Masters triumph?",1,3,4,59,3,12,0,63,0
"How an unknown 25-year-old won an election spending $1,300 on Facebook promotion",1,2,2,57,4,11,6,59,0
"Can You Match The ""Gilmore Girls"" Season 1 Character To The Quote",1,1,11,40,2,11,1,51,0
Grammy Winners 2017 ,1,3,2,11,0,3,4,13,0
Speaker Paul Ryan’s Approval Rating Plummets as He Fails to Deliver for President Trump,1,2,11,62,1,13,0,73,0
22 Mixtapes To Get Ready For In 2016,1,1,6,17,0,7,6,23,0
"The ""Fuller House"" Teaser Is Here And It Looks A Lot Like ""Full House""",1,1,14,39,4,13,0,53,0
"For The First Time Ever, A Black Woman Will Be Headlining Coachella",1,3,12,43,1,11,0,55,0
Struggles Everyone With Contacts Knows,1,1,5,29,0,4,0,34,0
Candy Corn Arranged To Look Like Actual Corn May Ruin You,1,1,11,36,0,10,0,47,0
What Magic From Harry Potter Would Benefit You The Most,1,1,10,36,0,9,0,46,0
7 Winter Dinners That Anyone Can Make,1,1,6,24,0,6,1,30,0
Tell Us About Yourself(ie): Ta'Rhonda Jones,1,1,7,27,4,5,0,34,0
"Are These Characters From ""Fallout 3"" Or ""Fallout: New Vegas""",1,1,9,37,5,9,1,46,0
Why facts aren't always more important than opinions,1,3,1,43,1,7,0,44,0
What Inspired You To Seek Help For Mental Health,1,1,9,31,0,8,0,40,0
This is the best beard style for every face shape,1,3,1,39,0,9,0,40,0
Can You Make It Through 27 Hilarious Photos of Michael Scott Saying The Absolute Wrong Thing Without Laughing,1,1,16,74,0,17,2,90,0
Game Of Thrones Just Made Emmy History,1,1,7,25,0,6,0,32,0
Girl who lost all her hair dazzles with inspiring response at school ,1,2,1,56,0,12,0,57,0
We Tested $1 Vs. $55 Lipstick And This Is What Happened,1,3,9,30,3,10,3,39,0
The 50 best young footballers in Italy,1,2,2,28,0,6,2,30,0
How Can We Miss a President Who Won’t Go Away?,1,3,9,26,2,9,0,35,0
14 Recipes That We’ve Actually Tried and Loved This Month,1,3,8,37,1,9,2,45,0
"Without tip from 19-year-old, Tom Brady's stolen jerseys might not have been recovered",1,3,3,65,4,12,2,68,0
"We're Geeking Out Over This ""Star Trek"" News",1,1,8,26,3,7,0,34,0
This Is Your Brain On Coffee,1,1,6,17,0,5,0,23,0
This Batman-themed pregnancy announcement is a geek couple's dream,1,3,2,54,2,8,0,56,0
Woman Helps Man Abandoned By His Mother Reclaim Life After Being Homeless For 3 Years,1,2,14,56,0,14,1,70,0
"Here's What An Obsessive Tea Drinker Thinks Of The New ""Nespresso For Tea"" Machine",1,1,14,52,3,13,0,66,0
The Culture of Nastiness ,1,3,3,18,0,4,0,21,0
"This Is What Would Happen If ""Goosebumps"" Books Were Set In LA",1,1,13,36,2,11,0,49,0
This Writer's Book Sold Out on Amazon Thanks To A Twitter Army,1,1,11,39,1,11,0,50,0
Awesome Irn-Bru Cocktails,1,1,4,18,1,2,0,22,0
Brandon Darby: Border Patrol Agents Feel Betrayed by the Trump Administration,1,2,9,57,1,10,0,66,0
We Tested Four Long-Wear Lipsticks To See Which One Lasted The Longest,1,1,13,45,1,11,0,58,0
16 Times Bollywood Stars Shut Down Their Trolls Perfectly,1,1,8,39,0,8,2,47,0
Slovenia vs England: How the players fared,1,2,3,32,1,6,0,35,0
26 Reasons Engagement Rings Are So Much Better When They're Colorful,1,1,10,45,1,10,2,55,0
Breaking Up: Women Vs. Men,1,1,5,15,2,4,0,20,0
He’s going home for Christmas. But most people at his prestigious college have no idea what he’s facing there.,1,2,3,85,4,18,0,88,0
29 Italian Dishes Everyone Should Know,1,1,5,26,0,5,2,31,0
The secret history of women's football,1,2,1,31,1,5,0,32,0
PegaVoice: Disruptors Wanted: How Successful Companies View Employees And Customers,1,2,11,61,2,9,0,72,0
Fort Lauderdale shooting: Australian man reveals how he survived deadly airport attack,1,3,3,71,1,11,0,74,0
Azealia Banks Reminds Sia Why She’s the Queen of the Clapback,1,3,8,42,1,10,0,50,0
18 Problems Only People Who Are Always Cold Understand,1,1,8,36,0,8,2,44,0
Leaked Snapchat Allegedly Shows Malia Obama Playing Beer Pong On A College Visit,1,1,13,55,0,12,0,68,0
Cab Driver Praises John Elway Without Realizing He's in Back Seat,1,3,10,44,1,10,0,54,0
Will Carrigan's suicide sparks Where There's A Will campaign for mental health programs in schools,1,2,6,76,2,14,0,82,0
How Well Do You Know Regina George,1,1,7,21,0,6,0,28,0
30 Videos That Will Make You Laugh Every Time,1,1,8,27,0,8,2,35,0
31 Cats Who Just Want To Watch The World Burn,1,1,9,25,0,9,2,34,0
These Hot Guys Holding A Puppy Will Make You Feel Things,1,1,11,35,0,10,0,46,0
The FCC just gave you a reason to hold off on buying a 4K TV,1,3,7,38,0,14,1,45,0
8 Great Wall Of China Reviews That Will Make You Question Humanity,1,1,11,43,0,11,1,54,0
Are You More Like Lana Del Rey Or Halsey,1,1,9,23,0,8,0,32,0
22 Tweets About Job Interviews That'll Actually Make You Laugh,1,1,9,41,1,9,2,50,0
27 Emotions Every Actor Should Know,1,1,5,23,0,5,2,28,0
"Where the most attractive people in the US come from, according to dating app Hinge",1,2,4,64,1,14,0,68,0
Snarky Texts That All Siblings Send Each Other,1,1,8,31,0,7,0,39,0
Report: Mitt Romney Fired; Trump Chooses Exxon CEO Rex Tillerson for Secretary of State,1,2,14,58,2,13,0,72,0
Someone Illustrated Leslie Knope's Compliments And They're Pretty Damn Cool,1,1,10,54,2,9,0,64,0
25 Things That Happen When Your Best Friend Gets Married,1,1,9,36,0,9,2,45,0
Why many Syrians welcomed US strikes on Assad regime targets,1,2,5,46,0,9,0,51,0
I Was Added To A Group Chat With Eight Strangers And It Got Incredibly Weird,1,1,15,47,0,14,0,62,0
What It's Like To Live With Your Best Friend,1,1,9,26,1,8,0,35,0
"Randeep Hooda Talks About Gurmehar Case, Mandira Bedi To Adopt A Girl And More From Ent",1,2,16,55,1,15,0,71,0
"It's like online dating, but for someone to have your baby",1,3,1,45,2,10,0,46,0
Which Footballer Should You Marry Based On Your Favorite Action Star,1,1,11,47,0,10,0,58,0
Here's Why Everyone Should Keep A Journal,1,1,7,27,1,6,0,34,0
UPDATED: A brief and incomplete list of the dumbest things presidential campaigns have ever spent money on,1,3,8,81,1,16,0,89,0
This BBC interview went horribly wrong in an amazing way The list,1,3,5,49,0,11,0,54,0
"'Ugliness And Handicap' Are Reasons Behind Higher Dowry, Teaches Maharashtra School Textbook",1,3,12,66,3,11,0,78,0
Los Angeles Angels of Anaheim Draft Mike Trout's Girlfriend's Brother,1,2,9,49,2,9,0,58,0
This Man Helped Build The Trump Meme Army — Now He Wants To Reform It,1,3,14,40,1,14,0,54,0
The Struggle Of Being Mixed Race,1,1,6,21,0,5,0,27,0
What Were You Like In High School Based On Your Zodiac Sign,1,1,12,36,0,11,0,48,0
India’s Growth Doesn’t Have a Story,1,3,5,23,2,5,0,28,0
‘Prison Break’: 5 Things to Know Before Season 5 [Video],1,3,7,33,5,9,2,40,0
"A Man Shared A Photo Of His Tireless, Devoted Girlfriend To Show His Gratitude",1,1,14,50,1,13,0,64,0
MMA Fighter Attempts Spinning Kick and Fails in the Most Hilarious Way Possible,1,3,12,55,0,12,0,67,0
Uh-oh: Your favorite aloe vera product might not have any aloe vera in it after all,1,3,2,64,2,15,0,66,0
People Talk About Having Divorced Parents During The Holidays,1,1,9,44,0,8,0,53,0
Which Windows 3.0 Solitaire Deck Are You,1,1,6,25,1,6,2,31,0
Chris Hardwick Just Got Engaged,1,1,5,22,0,4,0,27,0
Evocative Photos Highlight New Zealand's Largest Street Gang,1,3,8,44,1,7,0,52,0
This Professional Cuddler Says He Has 'The Best Job In The World',1,3,12,40,2,11,0,52,0
Buyer wanted: Tiny Oregon town for sale ,1,3,3,29,1,7,0,32,0
"A Woman Named Her Baby ""Uber"" After She Gave Birth In An Uber",1,1,13,34,2,12,0,47,0
The Iconic Beatles Ashram In Rishikesh Is Once Again Open To The Public,1,1,13,46,0,12,0,59,0
Divers find leg attached to cinder block in search for missing woman,1,3,1,56,0,11,0,57,0
20 Times Mamrie Hart Was Just Too Damn Funny,1,1,8,26,0,8,2,34,0
Tech Startups Woo Investors With Unconventional Financial Metrics — but Do Numbers Add Up?,1,2,12,63,2,13,0,75,0
How safe is your DNA?,1,3,4,12,1,4,0,16,0
Which Of The Four Major Temperaments Are You,1,1,8,29,0,7,0,37,0
53 Wonderfully Pointless Facts About The English Language,1,1,7,41,0,7,2,48,0
Shox the Fox gets smoked - ESPN Video,1,3,7,22,1,7,0,29,0
"Which Hogwarts Houses Do These ""Game Of Thrones"" Characters Belong In",1,1,11,46,2,10,0,57,0
15 Resolutions To Make Good On In 2016,1,1,6,19,0,7,6,25,0
26 Delectable Chocolate Treats To Seduce Your Valentine With,1,1,8,42,0,8,2,50,0
31 Things Every Person From Western Massachusetts Understands,1,1,7,45,0,7,2,52,0
The Best Oscars Dresses That You’ve Probably Never Seen [Video],1,2,10,41,3,9,0,51,0
Why you need to binge-watch Carrie Fisher's final TV show immediately,1,3,5,52,2,10,0,57,0
"Which Version Of ""1989"" Should You Be Listening To",1,1,8,28,2,8,4,36,0
Vatican Accepts Payment in Blood to Access Museums,1,3,6,37,0,7,0,43,0
25 Music Videos We Watched Over And Over Again In 2015,1,1,9,29,0,10,6,38,0
10 Life-Changing Things To Try In November,1,1,7,26,1,6,2,33,0
Kelly Ripa As Katy Perry Might Be Better Than Katy Perry As Katy Perry,1,1,14,43,0,13,0,57,0
This Is What Disney Heroes And Villians Look Like With Their Faces Swapped,1,1,13,49,0,12,0,62,0
Northwestern MutualVoice: Don't Make This Common Investing Mistake,1,2,9,48,2,7,0,57,0
Career Advice From HBO's 'Big Little Lies',1,2,9,24,3,6,0,33,0
This Fake Black Friday Movie Trailer Needs To Be A Real Thing,1,1,12,38,0,11,0,50,0
Netflix UK and US - new in February 2017: From Santa Clarita Diet to American Crime Story: The People v OJ Simpson,1,3,18,68,3,21,4,86,0
"Which ""How The Grinch Stole Christmas"" Character Are You",1,1,9,37,2,8,0,46,0
Women Have Turned A Cruel Meme Into Seriously Funny Jokes,1,1,10,38,0,9,0,48,0
"Can You Still Remember The Robots From ""Robot Wars""",1,1,9,32,2,8,0,41,0
Solar Jobs Aren't What They're Cracked Up To Be,1,2,9,28,2,8,0,37,0
"We're all talking about the Centrelink debt controversy, but what is 'robodebt' anyway?",1,3,2,68,5,12,0,70,0
"Family Fights To Ban USDA Wildlife Trap That Killed Their Dog, Injured Son",1,3,16,45,1,12,0,61,0
"If Women Want To Be Taken Seriously By A Doctor, Just Do One Of These Things",1,3,16,44,1,15,0,60,0
The 27 Funniest Tweets About Narendra Modi From 2015,1,1,7,31,0,8,6,38,0
28 Creepy Tim Burton Costumes That Will Inspire Low-Key Goth Ladies,1,1,11,43,1,10,2,54,0
21 Hungry Dogs Who Want All Your Food,1,1,7,21,0,7,2,28,0
16 Slightly Incorrect Names For Animals,1,1,5,27,0,5,2,32,0
25 Hilarious Tweets About Sweating That Everyone Can Relate To,1,1,9,42,0,9,2,51,0
9 Ways To Avoid Uncomfortable Conversations With Your Relatives This Thanksgiving,1,1,10,60,0,10,1,70,0
15 Times Chris Traeger Inspired You To Be Your Best Self,1,1,10,34,0,10,2,44,0
Why Military Suicide Prevention Fails,1,1,5,28,0,4,0,33,0
Hoping for an Inheritance? You May Not Get as Much as You Expect,1,2,9,42,1,12,0,51,0
"O’Keefe: Dems, Left, and Media Should Be Asked If They Disavow Violent Inauguration Protesters",1,2,14,63,4,13,0,77,0
These opening movie title sequences are pure masterpieces,1,2,1,49,0,7,0,50,0
12 Pregnancy Test Confessions,1,1,3,21,0,3,2,24,0
Find Out Your Horoscope For The Week Of November 23,1,1,9,31,0,9,2,40,0
What's Really Going On With Your Late-Night Bathroom Trips,1,3,10,38,2,8,0,48,0
How You Can Get Selena Gomez's Adorable Daisy Coachella Dress,1,3,10,41,1,9,0,51,0
18 Hot And Delicious Slow Cooker Stews,1,1,6,24,0,6,2,30,0
11 Bollywood Actresses Who Obviously Took A Tumble In 2015,1,1,8,35,0,9,6,43,0
Here's the part of the UK that has the most sex The list,1,3,4,39,1,12,0,43,0
This Is What Other Countries Truly Think About Halloween In The U.S,1,1,13,42,1,11,0,55,0
13 Things Everyone In Germany Can Agree On,1,1,7,26,0,7,2,33,0
Can We Tell If You're An Introvert Or Extrovert With Colors,1,1,11,37,1,10,0,48,0
18 Slogans That Perfectly Sum Up Twitter,1,1,6,26,0,6,2,32,0
27 Hilarious Tweets About Donald Trump,1,1,5,26,0,5,2,31,0
"Charlie Hebdo Two Years On: ‘Gone Soft’, Won’t Draw Muhammad",1,3,10,36,5,9,0,46,0
Build Your Ideal Boyfriend And We'll Guess Your Favorite Starbucks Drink,1,2,11,50,1,10,0,61,0
The 27 Most Important Things Cats Did On The Internet In 2015,1,1,10,34,0,11,6,44,0
Making Yoga an Exercise in Democracy ,1,3,4,27,0,6,0,31,0
21 Martinis For People Who Are Definitely Not James Bond,1,1,9,36,0,9,2,45,0
Watch: Celebrities Sing ‘I Will Survive’ Ahead of Trump Inauguration,1,3,9,47,3,9,0,56,0
"21 ""Friends"" Facts That Will Legitimately Make You Feel Old",1,1,9,37,2,9,2,46,0
Which Albus Dumbledore Quote Should Be Your Life Motto,1,1,9,37,0,8,0,46,0
21 Ridiculous Ways People Have Actually Injured Themselves,1,1,7,42,0,7,2,49,0
FLYNN: Did Trump Jump the Shark When He Dropped Those Bombs?,1,3,14,34,2,10,0,48,0
IMDb Adds Special ‘F’ Rating System for ‘Feminist’ Films,1,3,10,34,4,8,0,44,0
Police Use 'Fake News' in Sting Aimed at California Gang ,1,3,8,37,2,10,0,45,0
35 Things That Happen When You Move To A New City,1,1,10,27,0,10,2,37,0
23 Magical Gifts Every Black Girl Deserves,1,1,6,28,0,6,2,34,0
23 Essential Songs For Your Anti-Valentine’s Day Playlist,1,3,8,38,2,7,2,46,0
Just 41 Facts About Anna Faris And Chris Pratt’s Adorable Relationship,1,3,10,47,1,10,2,57,0
21 Pictures That Are Way Too Real For People Who Grew Up With Strict Parents,1,1,14,46,0,14,2,60,0
Can You Match The Actor To Their Animated Film Roles,1,1,10,33,0,9,0,43,0
This woman is strong and healthy at 90. Here’s how she does it.,1,3,2,44,3,12,2,46,0
"Hollywood Agency CAA to Host Diversity Summit with J.J. Abrams, Kerry Washington",1,2,13,53,3,11,0,66,0
Deal of the Week: Akzo Nobel Fends Off PPG,1,2,9,24,1,8,0,33,0
"Hockey, weed and taxes? 11 Canadian stereotypes debunked",1,2,2,43,2,7,2,45,0
"3,600 guests at Ghana's record-breaking dinner table",1,2,1,38,3,6,4,39,0
11 Things You Probably Didn’t Know Were Funded With Help From The National Endowment For The Arts,1,3,16,62,1,16,2,78,0
29 Amazing Literary Magazines You Need To Be Reading,1,1,8,34,0,8,2,42,0
How the face of MLB's steroid era is getting closer to the Hall of Fame,1,3,6,50,1,14,0,56,0
Malaysia and North Korea - a friendship on ice,1,3,3,34,1,8,0,37,0
22 Products Every Dog Lover Needs In Their Lives,1,1,8,30,0,8,2,38,0
Here's What Young Indian Women Really Think About Premarital Sex,1,1,10,44,1,9,0,54,0
22 Tips For Hiking With Kids That Every Parent Should Know,1,1,10,36,0,10,2,46,0
Watch This Seahorse Shoot Baby Seahorses Out Of Its Stomach,1,1,10,40,0,9,0,50,0
"30 Years Later, The Creepy Max Headroom Broadcast Interruption Remains Unsolved",1,2,10,56,1,10,2,66,0
Business Insiderâs 2016 Car of the Year: The 15 finalists,1,3,5,36,3,9,6,41,0
"Democratic Party Is Losing Its Moderate Members, Says Gallup",1,2,9,42,1,8,0,51,0
21 People Who Made Pretty Questionable Decisions,1,1,6,34,0,6,2,40,0
Every Girl With A Lot Of Hair Has These Struggles,1,1,10,30,0,9,0,40,0
"24 Essential Life Lessons ""The Perks Of Being A Wallflower"" Taught Us",1,1,11,43,2,11,2,54,0
"VA Dentist Resigns After Possibly Infecting 600 Veterans with HIV, Hepatitis",1,3,12,50,1,10,3,62,0
15 fascinating facts about North Korea,1,2,2,29,0,5,2,31,0
The Hardest Weasley Family Quiz You'll Ever Take,1,1,8,32,1,7,0,40,0
19 Chokers That Will Sexually Awaken Your Look,1,1,7,30,0,7,2,37,0
Italy: Muslim Mother Shaves Head of Daughter Who Refused to Wear Veil,1,3,10,47,1,11,0,57,0
"DJ Khaled Is Planning Something Major With Chance the Rapper, Justin Bieber, and Migos",1,3,13,58,2,13,0,71,0
Star Wars Fans Will Start Hyperventilating Over These Amazing Shoes,1,1,10,48,0,9,0,58,0
The 10 Best Wordless Choruses of the 21st Century,1,3,5,32,0,8,4,37,0
Dying from cancer: Could your location determine your fate?,1,3,2,47,2,8,0,49,0
World’s Best-Yielding Stock Market Is Set to Get Even Better,1,2,10,39,2,9,0,49,0
"Six False Accusations by John Lewis, Hero-Turned-Hack",1,3,8,36,3,6,0,44,0
Lilly Singh: How a 28-year old Canadian rapped and vlogged her way into the Youtuber millionaire's club,1,3,5,77,3,16,2,82,0
"Trump asked African Americans what they had to lose. For this rural Kentucky community, the answer is tangible.",1,2,5,86,3,17,0,91,0
These engineers rigged a device to let you control Netflix with your mind,1,3,2,59,0,12,0,61,0
Minimalism no more! How I discovered the joy of recluttering,1,2,3,47,1,9,0,50,0
"32 Questions We Have Every Time We Watch ""Fixer Upper"" On HGTV",1,1,14,33,2,11,2,47,0
For Everyone Who Thinks Ulta Is The Best Makeup Store,1,1,10,34,0,9,0,44,0
Should You Be Worried About Political Risk? (Hint: Insurers Are),1,2,10,41,4,9,0,51,0
This woman gave up her porn career and became a pastor The list,1,2,2,49,0,12,0,51,0
18 Rotties Who Are Actually Just Big Teddy Bears,1,1,8,30,0,8,2,38,0
The 17 Most Offensive Things People Say To Someone With Small Boobs,1,1,11,43,0,11,2,54,0
This Caramel Apple Tart Will Have You Drooling All Over The Floor,1,1,12,42,0,11,0,54,0
"This Band Did A New, Terrifying Thing With Their Phones And It Will Give You Anxiety",1,1,16,52,1,15,0,68,0
Why some Trump voters in Texas oppose Mexico border wall,1,2,4,43,0,9,0,47,0
How Much Of A Picky Dater Are You Really,1,1,9,23,0,8,0,32,0
"An Alarming Number Of People Think ""The Martian"" Is A True Story",1,1,12,39,2,11,0,51,0
Public Service Announcement: Zayn Is Now On Snapchat,1,1,8,36,1,7,0,44,0
The brilliant answer to what the world would look like without Muslims The list,1,3,3,63,0,13,0,66,0
Changing One Letter Makes Most Halloween Candy Sound Gross,1,1,9,41,0,8,0,50,0
Year of the flood: The nation’s 10 most extreme weather events of 2016,1,3,2,48,2,12,6,50,0
Facebook Engineer Arrested for Allegedly Soliciting Sex from 15-Year Old Girl,1,2,9,55,1,10,2,64,0
James Franco Just Got Bar Mitzvahed,1,1,6,24,0,5,0,30,0
13 Beautiful Reasons Why You Should Go On An Adventure With Your Partner This Year,1,1,14,52,0,14,2,66,0
17 Healthier Desserts That Are Actually Delicious,1,1,6,35,0,6,2,41,0
University of Wisconsin-Madison: ‘Problem of Whiteness’ Course Not Meant to Be Offensive,1,2,10,63,4,11,0,73,0
12 Low-Carb Bowls Of Soup That'll Warm Your Soul This Fall,1,1,11,33,2,10,2,44,0
18 Things You'll Understand If You're The Easy Target In Your Friendship Group,1,1,12,50,2,12,2,62,0
Drake and Jay Z Clearly Had A Blast At The Warriors Game,1,1,11,34,0,11,0,45,0
Why this pastor believes American Girl’s boy doll is ‘a trick of the enemy’,1,3,3,56,3,13,0,59,0
Donald Trump ‘Winning’ War with CNN,1,3,7,21,2,5,0,28,0
OBAMA: Here's what I miss most about the White House,1,3,9,32,2,9,0,41,0
The Supreme Court’s controversial ruling on an executive order,1,3,3,50,1,8,0,53,0
"I Tried To Quit Sugar, But Failed Without Realizing Why",1,3,10,35,1,9,0,45,0
Emma Stone Is The Music Video Queen We've Always Dreamed Of,1,1,11,37,1,10,0,48,0
Here are the biggest names that have been let go by ESPN in its latest round of layoffs,1,3,5,65,0,17,0,70,0
We Know Your Favorite Animal Based On These Random Questions,1,1,10,41,0,9,0,51,0
Amy Schumer Netflix Special Flooded with One-Star Reviews: ‘I’ve Had Migraines That Were Funnier’,1,2,14,65,5,13,0,79,0
From ‘mom shorts’ to Wham! blazers – 10 ways to update your spring style,1,3,2,51,4,13,2,53,0
Indian Basketball Star Satnam Singh Looks To Move Into Prowrestling As He Is Seen Training With WWE,1,2,19,64,0,16,0,83,0
24 Beautiful Little Phrases To Tattoo On Yourself,1,1,7,33,0,7,2,40,0
5 U.S. Cities Poised To Become Tomorrow's Tech Meccas,1,3,9,32,3,8,1,41,0
WaPo: Gun Sales Dropping — Except Among Minorities Scared of Trump Administration,1,3,11,57,2,11,0,68,0
EXCLUSIVE: Mama June Reveals Exactly How Much She Weighs Today After Stunning Transformation,1,3,21,58,1,12,0,79,0
Why General Motors Has Already Lost to Tesla,1,3,7,30,0,7,0,37,0
How a President Can Use Orders and Memos and Who Can Stop Them - Yahoo,1,2,11,44,1,14,0,55,0
Christian on Trial for Blasphemy Wins First Round of Jakarta Gubernatorial Election,1,3,9,63,0,11,0,72,0
31 Two-Person Costumes Guaranteed To Up Your Halloween Game,1,1,9,39,1,8,2,48,0
21 Movies And Shows To Stream When It's Too Cold Out,1,1,10,29,1,10,2,39,0
Jeb Bush: Trump Has Become ‘a Distraction in and of Himself’,1,3,7,40,3,10,0,47,0
Hillary Clinton's Campaign Accidentally Tweeted About Pizza And Anal,1,1,9,50,1,8,0,59,0
4 Ways To Know If PPC Is Right For Your Business,1,3,12,25,0,10,1,37,0
Baahubali Fans Rejoice! Rajamouli Has Announced A Mini TV Series Based On Sivagami,1,3,14,55,1,12,0,69,0
BFFs Build Blanket Forts,1,1,6,15,0,3,0,21,0
This Story About Love In The Time Of War Will Melt You To A Mush Of Feels,1,1,17,40,0,16,0,57,0
"The First Teaser For ""Game Of Thrones"" Season 6 Is Heartbreaking",1,1,10,41,2,10,1,51,0
"We Bet You Never Noticed This Detail From ""The Grinch"" As A Kid",1,1,13,36,2,12,0,49,0
What Stephen Curry’s Free Throws Can Teach Investors - The Experts,1,2,10,44,2,10,0,54,0
Native Americans Confessed How They Feel About America And It Got Real,1,1,12,47,0,11,0,59,0
Eight billionaires 'as rich as world's poorest half',1,2,1,41,3,7,0,42,0
"Which ""Friday Night Lights"" Quarterback Is Your Soulmate",1,1,8,39,2,7,0,47,0
27 Weird AF Kitchen Products You Didn’t Know Existed,1,3,9,32,1,8,2,41,0
These Are The Top Parenting Searches On Pinterest In 2016 (So Far),1,1,11,38,2,11,4,49,0
"Nikki Haley: Syrian People ‘Don’t Want’ ‘Disgusting,’ ‘War Criminal’ Assad",1,3,10,46,9,9,0,56,0
Exclusive–Khizr Khan: ‘I Really Have No Animosity Towards’ President-Elect Trump,1,3,12,54,5,9,0,66,0
"Take A Look Inside The New ""Doctor Who"" Coloring Book",1,1,10,32,2,9,0,42,0
17 Places All Music Lovers Should Go In London,1,1,8,28,0,8,2,36,0
Should I Get Bings,1,1,4,11,0,3,0,15,0
24 Beauty Secrets You Should Really Know,1,1,6,26,0,6,2,32,0
"FYI, The Love Child Of Zayn And Liam From One Direction Has Been Found",1,1,16,40,1,13,0,56,0
People Have Set Up A Memorial For A Bus-Stop Cat Who Was Viciously Killed,1,1,15,44,1,13,0,59,0
Which Beloved Children's Cartoon Character Should You Hook Up With,1,1,10,46,1,9,0,56,0
18 Times People Took Their Modi Obsession Too Damn Far,1,1,9,34,0,9,2,43,0
What Britney Spears Instagram Looks Like Vs. Other Pop Stars' Instagrams,1,1,11,49,2,10,0,60,0
Report: AI Predicts When Patients Will Die from Heart Failure,1,3,10,41,1,9,0,51,0
31 Celebrity Bulges That Went Hard In 2015,1,1,6,23,0,7,6,29,0
Black-ish Will Tackle The N-Word In Season Premiere,1,1,9,33,2,7,0,42,0
This is why you should let a stranger choose your profile picture The list,1,3,2,59,0,13,0,61,0
"Economy healed under Obama, but unhappy voters chose Trump",1,2,3,46,1,8,0,49,0
IT: Pennywise scares up a frenzy as trailer breaks record for most views in a single day,1,3,3,68,1,16,0,71,0
"The Official ""AHS: Hotel"" Opening Credits Are Creepy As Hell",1,1,12,36,3,9,0,48,0
22 Times Tumblr Was Actually Better Than Sex Ed,1,1,8,29,0,8,2,37,0
27 Behind-The-Scenes Comments You Only Hear At The Puppy Bowl,1,1,11,37,2,9,2,48,0
22 Times Supermarkets Got Completely Out Of Hand,1,1,7,32,0,7,2,39,0
"46 Things That Would Have Been Different If ""Friends"" Were Set In L.A",1,1,13,39,3,12,2,52,0
15 Of The Most Surprising Baby Announcements Of 2015,1,1,7,31,0,8,6,38,0
"London, Donald Trump, Keystone Pipeline: Your Evening Briefing ",1,3,8,44,3,8,0,52,0
Macron - not the only young achiever,1,2,1,28,1,6,0,29,0
People Eat King Cake For The First Time,1,1,8,24,0,7,0,32,0
How to Keep Your Office Holiday Party From Going Off the Rails ,1,3,10,41,0,12,0,51,0
The Chris Pratt School of Acting in 3 minutes,1,2,5,31,0,8,1,36,0
Google Home spreads bizarre conspiracy theory about Barack Obama ,1,2,4,52,0,9,0,56,0
Public University Threatened to Punish Student Over His Refusal to Remove Trump Sign from Dorm Window,1,3,13,73,0,15,0,86,0
22 Hilarious #NetflixPHShows That Should Actually Exist,1,1,9,37,1,6,2,46,0
Justin Bieber's New Purple Hair In Six Instagram Photos,1,1,9,37,1,8,0,46,0
14 Photos That’ll Make You Laugh If Your Sense Of Humor Is Stuck In Middle School,1,2,15,48,1,15,2,63,0
"This Is What The ""Arthur"" Voice Actors Look Like In Real Life",1,1,12,36,2,11,0,48,0
21 Wardrobe Staples For Every '00's Girl Who Swore By Abercrombie & Fitch,1,1,10,44,3,12,4,54,0
The Hardest Premier League Badge Quiz You'll Ever Take,1,1,9,36,1,8,0,45,0
Adele And Lady Gaga's Hot Bodyguard Will Leave You Compulsively Thrusting,1,1,11,51,1,10,0,62,0
Can You Guess The Artist Based On Their Hit Album Cover Art,1,1,12,36,0,11,0,48,0
This Year’s IRS Audits Are Bad News for the Rich,1,3,10,28,1,9,0,38,0
Octavia Spencer Jokes About 'Hidden Fences' in Her 'SNL' Monologue,1,3,11,42,4,9,0,53,0
"The top 10 foods to eat to beat bloating and get a flat stomach, from trendy apple cider vinegar to Korean kimchi",1,3,2,87,1,21,2,89,0
"Watch A Priest, Rabbi And Atheist Smoke Weed And Talk Religion",1,3,11,40,1,10,0,51,0
18 Very Sweary Scottish Words You Need To Use Right Now,1,1,10,33,0,10,2,43,0
16 Times Eddie Redmayne Was The Most Magical Human Alive,1,1,9,36,0,9,2,45,0
"Can You Identify These Minor Characters From ""30 Rock""",1,1,8,34,2,8,2,42,0
"Mad Men Mashes Up Perfectly With ""Parks And Rec"" And It's Hilarious",1,1,12,41,3,11,0,53,0
Why airlines are making it harder for us to buy a cheap ticket,1,3,1,49,0,12,0,50,0
"There's A New ""Potter Puppet Pals"" Here Just In Time For Halloween",1,1,12,40,3,11,0,52,0
17 Winter Struggles Only Canadians Parents Can Truly Understand,1,1,8,45,0,8,2,53,0
The Guy Who Invented The Rorschach Test Was Really Hot,1,1,10,35,0,9,0,45,0
22 Times People Got Hilariously Drunk In 2016,1,2,6,26,0,7,6,32,0
10 Senior Photos That'll Make You Glad You Graduated,1,1,8,33,1,8,2,41,0
Matt Schlapp: Kansas Special Election ‘a Warning Shot to All Members of Congress’ Used to Winning Easily,1,3,13,72,3,16,0,85,0
This New Video Of A Dwarf Planet Will Make You Feel Like A Fucking Astronaut,1,1,15,47,0,14,0,62,0
18 Sweet And Savory Dinner Combos That Will Blow Your Mind,1,1,10,36,0,10,2,46,0
He Cheated. Now His Ex-Girlfriend Has Some Heartbreaking Questions,1,2,10,46,2,8,0,56,0
My First-Ever Pro Golf Experience Was the 2017 Masters—It Was Magic,1,3,11,40,2,10,4,51,0
Delectable Vegan Dinners,1,1,3,19,0,2,0,22,0
How Well Do You Remember The Most Popular Weddings Of 2015,1,1,10,34,0,10,4,44,0
Are You More Whatsapp Or Viber,1,1,6,19,0,5,0,25,0
Fast and Furious 8 star Vin Diesel finally comments on Dwayne 'The Rock' Johnson feud,1,3,8,60,2,14,1,68,0
Draft Do-Overs Every NFL Team Wishes It Could Have,1,3,12,29,1,8,0,41,0
19 Words That Have A Totally Different Meaning In New Mexico,1,1,10,38,0,10,2,48,0
"23 Adorable Ways To Say ""I Love You"" To Your Best Friend",1,1,11,30,2,11,2,41,0
"Bizarre! Female Cricketer Scores 160, Teammates 0 In The Most Lopsided Batting Scorecard You' ll Ever See",1,2,14,68,3,16,4,82,0
How To Negotiate When The Other Person Won't Play Fair,1,3,10,34,1,9,0,44,0
21 Puppies Who Absolutely Cannot Be Trusted,1,1,6,29,0,6,2,35,0
"With The Authorities Completely Failing To Revive It, Here's Why We Can Say That Yamuna Is Dead",1,3,17,60,2,16,0,77,0
18 Cats Who Are Very Happy With Themselves,1,1,7,26,0,7,2,33,0
All the fiery reactions to that crazy 'Game of Thrones' twist,1,3,3,46,2,10,0,49,0
"If ""Mean Girls"" Were About Nuns",1,1,6,18,2,5,0,24,0
Watch These Americans Try Different International Food Combos,1,1,8,46,0,7,0,54,0
For Everyone Still Haunted By That Fucking Shirley Temple Informercial,1,1,10,51,0,9,0,61,0
9 Perks Of Having Big Hair,1,1,5,15,0,5,1,20,0
These are the most-loved CEOs in America,1,2,5,28,1,6,0,33,0
"17 Of Chuckie Finster's Best Lines On ""Rugrats""",1,1,7,28,3,7,2,35,0
The Internet Is Trying To Find This Rockstar Masquerading As A Fruit Seller,1,1,13,50,0,12,0,63,0
Jeff Sessions Slams Deal to Monitor Baltimore Police,1,2,7,38,0,7,0,45,0
The New Will Ferrell-Themed Bar In New York City Is Amazing,1,1,12,36,1,10,0,48,0
New Cases of FGM Reported Every Hour in UK,1,2,10,24,0,8,0,34,0
"You Probably Missed This Adorable Foreshadowing In ""Parks And Recreation""",1,1,10,52,2,9,0,62,0
It's Time To Talk About How Good Olive Garden Is,1,1,10,28,1,9,0,38,0
"It Doesn't Sound Like Milo Ventimiglia Has Good ""Gilmore Girls"" News For Team Jess Fans",1,1,15,55,3,14,0,70,0
19 Foods That Should Never Have Been Invented,1,1,7,29,0,7,2,36,0
We're not in a recession. That's good news ... isn't it?,1,3,2,36,8,10,0,38,0
Can You Pass This Texas Food Test,1,1,7,20,0,6,0,27,0
An Engineering Student Eloquently Pointed Out Why Female Classmates Aren't Equal,1,1,11,58,1,10,0,69,0
22 Dogs Who Totally Nailed Their Geeky Halloween Costumes,1,1,8,39,0,8,2,47,0
Literally Just 17 Dick Jokes That’ll Make You Laugh,1,3,8,32,1,8,2,40,0
No-show for Prince William and Prince Harry at traditional Christmas Eve football match,1,2,7,67,1,12,0,74,0
FED: Wages are going up 'modestly' across most of America,1,3,5,40,3,9,0,45,0
We Know Your Favorite Ed Sheeran Song Based On The Taylor Swift You Choose,1,1,14,47,0,13,0,61,0
13 Movie Theater Hacks To Make Your Moviegoing Experience Better,1,1,9,44,0,9,2,53,0
21 Things Anyone Who Has Ever Been A Student Can Relate To,1,1,11,34,0,11,2,45,0
"How Long Would You Survive In ""Game Of Thrones"" Based On Your Sign",1,1,13,39,2,12,0,52,0
Fyre Festival will take place in 2018: 'We will not do it ourselves',1,2,3,46,3,12,4,49,0
Everyone Stop And Appreciate T.I.'s Fur Jacket,1,1,8,29,3,6,0,37,0
Here's how the US military is sticking it to Beijing in the South China Sea,1,3,7,53,1,14,0,60,0
We Know Your Favorite Britney Spears Song Based On Your Zodiac Sign,1,1,12,44,0,11,0,56,0
'Rogue One': The One Prop Felicity Jones Very Much Wants to Keep [Video],1,3,12,43,5,12,0,55,0
Native Americans Asked These Sensitive Questions To White People,1,1,9,47,0,8,0,56,0
90-year-old man writes tips to combat loneliness after losing his wife and sister,1,3,0,65,2,12,2,65,0
Gorsuch dives into the fray at first Supreme Court arguments,1,3,3,48,0,9,0,51,0
Justin Timberlake Goes To Hogwarts,1,1,5,25,0,4,0,30,0
Minor leaguer Buddy Baumann gets unfortunate haircut after losing a bet,1,2,3,58,0,10,0,61,0
22 Dogs Who Just Want To Watch The World Burn,1,1,9,25,0,9,2,34,0
13 People Who Seem To Really Be Struggling With This Wine Thing,1,1,11,39,0,11,2,50,0
Big Government Republicans Rebuke Trump Budget,1,3,6,35,0,5,0,41,0
'Outlander' Season 3: 10 burning questions we have about Claire and Jamie's reunion,1,3,4,60,4,12,3,64,0
This Man Is Changing The Autumn Game With His Patio-Cleaning Drone,1,1,12,43,1,10,0,55,0
There’s Now A Fragrance That Smells Like Fear,1,3,8,29,1,7,0,37,0
19 Insanely Gorgeous Lipstick Colors Worth Every Penny,1,1,7,38,0,7,2,45,0
This Charity Calendar Of French Firefighters Will Leave You Hot And Bothered,1,1,12,53,0,11,0,65,0
Will Ferrell And Mark Wahlberg Realize They Don't Know Each Other At All,1,1,13,46,1,12,0,59,0
What zapping your brain with electricity feels like,1,3,1,43,0,7,0,44,0
19 Incredibly Easy Ways To Get Your Shit Together,1,1,8,31,0,8,2,39,0
Prince Harry's Ginger Beard Deserves A Damn Award,1,1,8,33,1,7,0,41,0
The Human Zoo: Documentary sheds light on stolen Aboriginal people 'treated as animals',1,3,5,67,3,12,0,72,0
"Eating protein and salty foods at lunch causes food comas, says new study",1,3,1,59,1,12,0,60,0
24 Perfectly Cozy And Delicious Treats To Bake This Fall,1,1,9,36,0,9,2,45,0
The Circle That Gives Fruit Flies Direction ,1,3,7,30,0,7,0,37,0
17 Animals That Have Had Enough Of 2016,1,2,6,20,0,7,6,26,0
Republican Insiders Push for a Carbon Tax at White House Meeting,1,3,8,46,0,10,0,54,0
The 12 Stages Of Gay Sex,1,1,5,12,0,5,2,17,0
Should Black Cars Be Banned,1,1,5,18,0,4,0,23,0
Surprising celebrity friendships,1,2,1,29,0,2,0,30,0
6 of the Wildest Celebrity Quotes in 2016 [Video],1,3,4,30,2,8,5,34,0
The Ultimate Superman Moral Decision Making Quiz,1,1,7,35,0,6,0,42,0
The Most -- And Least -- Educated States In The U.S. In 2017,1,3,11,27,6,12,4,38,0
The Food Porn Industry Will Never Be The Same Because Of This Huevos Rancheros Recipe,1,1,15,56,0,14,0,71,0
Pigskin A Blanket: NFL Week 3 Picks,1,1,8,19,1,6,1,27,0
17 Fucking Infuriating Things That Happen In Every Porno,1,2,8,38,0,8,2,46,0
One restaurant group stands to be the big winner if Trump cuts everyone's taxes,1,3,2,63,1,13,0,65,0
"The greatest reporter of our time, and why we should never forget him",1,3,1,55,1,12,0,56,0
Syrian Airfield Strike: What Is a Tomahawk Land Attack Missile?,1,3,9,43,2,9,0,52,0
Vanderbilt Football Team Stars in Sorority Recruitment Video Spoof,1,3,8,50,0,8,0,58,0
"I'm Bisexual, But I'm Not",1,1,5,13,3,4,0,18,0
Space Scientists Will Pay Men to Stay in Bed for 60 Days,1,2,8,35,0,11,2,43,0
26 Times Celebrity Couples Defined Relationship Goals In 2015,1,1,7,40,0,8,6,47,0
Why Facebook isn't telling you everything it knows about you The list,1,3,3,54,1,11,0,57,0
Clearest Blue By Chvrches Is One Of The Year's Best Songs,1,1,11,35,1,10,0,46,0
"21 Times ""The IT Crowd"" Made You Literally LOL",1,1,11,23,2,8,2,34,0
This Amazing Wine Glass Makes You Look As Drunk As You Feel,1,1,12,36,0,11,0,48,0
What Is Your Furniture IQ,1,1,6,15,0,4,0,21,0
How Much Of A Dick Are You,1,1,7,13,0,6,0,20,0
13 Totally Genius Birthday Cakes For Kids,1,1,6,27,0,6,2,33,0
"Which ""Transparent"" Character Are You",1,1,5,26,2,4,0,31,0
15 Rude Texts Your Tears Would Send You,1,1,7,23,0,7,2,30,0
Queen Bey's pregnancy is a lifeline for humanity,1,2,2,38,1,7,0,40,0
Pigskin A Blanket: NFL Week 17 Picks,1,1,8,19,1,6,2,27,0
"Hallelujah, Gigi Hadid Is Single Again",1,1,6,26,1,5,0,32,0
Here Are The Real Places That Inspired Disney's Magic Kingdoms,1,1,10,42,1,9,0,52,0
Fox News Moving Tucker Carlson to Megyn Kelly’s Timeslot,1,3,8,39,1,8,0,47,0
29 Times Japanese Twitter Lost Its Shit Over Kawaii Critters,1,1,9,40,0,9,2,49,0
What A 100-Year-Old Man Can Teach Us About Leadership,1,3,10,30,2,8,3,40,0
The strongest (and weakest) American cities,1,2,2,34,2,5,0,36,0
Leah Remini's Reddit AMA reveals juicy secrets of Scientology,1,3,7,45,1,8,0,52,0
How everyone else reacted to Theresa May's snap general election The list,1,3,4,57,1,11,0,61,0
How Well Do You Actually Know The US States?,1,3,10,25,1,8,0,35,0
These Are The Coolest Products From 2015,1,1,6,24,0,6,4,30,0
Division III Football Players Arrested in Murder Investigation,1,3,9,46,0,7,0,55,0
Kelly Promises to Build Trump’s Wall in 2 Years or Less,1,3,7,36,1,10,1,43,0
13 Things You Should Know About Sex Shops,1,1,7,25,0,7,2,32,0
The Next Facebook? Wall Street Sizes Up Snap’s IPO,1,3,11,29,2,8,0,40,0
This Stop-Motion Music Video Starring Cereal Is Totally Mesmerizing,1,1,10,48,1,8,0,58,0
Australia’s Dinosaur Laboratory,1,2,3,25,1,2,0,28,0
All The President's Billionaires: A Guide To Trump's Gilded Inner Circle,1,3,11,48,3,10,0,59,0
13 Classic ’00s Songs That Were Actually Meant For Other Artists,1,3,9,40,1,10,4,49,0
How Well Do You Know YA Books,1,1,8,15,0,6,0,23,0
The 30 most stunning photos Business Insider took in 2016,1,3,3,39,0,9,6,42,0
"Which Hogwarts Houses Do These ""Friends"" Characters Belong In",1,1,9,42,2,8,0,51,0
Host of stars 'turned down' Great British Bake Off presenting role,1,3,5,49,2,10,0,54,0
What It's Like To Be A Lesbian Couple With A 20-Plus-Year Age Difference,1,1,14,41,3,12,2,55,0
The clever pun pictures (that aren't as easy as you think) baffling the Internet... so how many can YOU solve?,1,3,5,79,7,19,0,84,0
42 Storage Ideas That Will Organize Your Entire House,1,1,8,35,0,8,2,43,0
Sid The Beagle Is Running For Austin Mayor And He Means Business,1,1,12,41,0,11,0,53,0
"If The Cast Of ""The Office"" Were Disney Characters",1,1,9,31,2,8,0,40,0
Explore The Planet With The New And Improved Google Earth,1,2,10,38,0,9,0,48,0
Trump Warns 'Pocahontas' May Run For President In 2020,1,3,8,32,2,8,4,40,0
18 Things Everyone Who Had Chunky Highlights Will Relate To,1,1,9,39,0,9,2,48,0
For Everyone Personally Devastated About Tabitha The Goat,1,1,8,42,0,7,0,50,0
Will snow rescue Swiss Alps after dry start to winter?,1,3,3,41,1,9,0,44,0
Trump: 'If something happens blame' the judge,1,2,2,34,3,6,0,36,0
Here's What Actually Happens When You Start Lifting Weights,1,1,9,41,1,8,0,50,0
This Video Sums Up What Every Tech Support Person Wants To Say,1,1,12,39,0,11,0,51,0
This Is What Happens When Your Sister Is Your Best Friend,1,1,11,36,0,10,0,47,0
18 Vegan Mac 'N' Cheese Recipes That'll Make You Drool,1,1,9,31,3,9,2,40,0
Which Drunken Photo From My iPhone Are You,1,1,8,27,0,7,0,35,0
Faith Hill Responded To Tim McGraw's Marriage Proposal In The Most Adorable Way Possible,1,1,15,59,1,13,0,74,0
This Penguin Couple Had A Better Valentine's Day Than You,1,1,10,37,1,9,0,47,0
14 Similarities Between A Black Hole And My Love Life,1,1,9,33,0,9,2,42,0
"Kristen Bell on why her daughters don't watch ""Frozen,"" holiday plans",1,3,3,52,4,10,0,55,0
How Much Would Chris Traeger Like You Based On Your Zodiac Sign,1,1,12,40,0,11,0,52,0
What Is The Craziest Thing You've Seen As A Dentist,1,1,10,31,1,9,0,41,0
Here's What Young Indian Women Had To Say About The Jasleen Kaur Case,1,1,13,43,1,12,0,56,0
Would You Pass Fourth-Grade Science Today,1,1,7,28,1,5,0,35,0
This Wife Surprised Her Husband With An Amazing Batman-Themed Family Photo Shoot,1,2,13,55,1,11,0,68,0
Watch: Police and Journalists Attacked During Swedish School Riot,1,3,8,48,1,8,0,56,0
Neil Patrick Harris And His Kids Singing In The Morning Will Make You Wish You Were Part Of His Family,1,1,20,63,0,19,0,83,0
7 Reasons Rey Is Definitely Luke Skywalker's Daughter,1,1,7,37,1,7,1,44,0
12 Signs You Grew Up Next To A Slate Quarry,1,1,9,23,0,9,2,32,0
The 17 Funniest Tweets About Grammar In 2015,1,1,6,25,0,7,6,31,0
His Friend Was Really Happy To See Him After Long And This Doctor Got A Hug That Broke His Ribs,1,3,20,56,0,19,0,76,0
If Native Americans Said The Stuff White People Say,1,1,9,34,0,8,0,43,0
You Should Be Eating Pork And Avocado Sandwiches For Dinner,1,1,10,40,0,9,0,50,0
CNN’s Tapper: There Are ‘Fair Critiques of the Media’ for Running Early Trump Rallies ‘Start to Finish’,1,3,15,66,6,16,0,81,0
47 Hacks People With ADD/ADHD Use To Stay On Track,1,1,15,23,1,9,2,38,0
"Can You Get 100% On This ""Parks And Rec"" Character Quote Quiz?",1,2,11,33,4,11,3,44,0
The Year 2015 In Haikus,1,1,4,11,0,4,4,15,0
RBI Official Caught For Exchanging Notes Illegally + 5 Other Interesting Reads From Today,1,3,14,60,1,13,1,74,0
This Super Fast Trick To Getting Faux Locs Just Changed Every Lazy Human's Life,1,1,14,51,1,13,0,65,0
"Have you decorated your Christmas tree yet? If so, we want to see it",1,3,3,50,2,13,0,53,0
These Guys Recreated Pizza Rat And People Lost Their Shit,1,1,10,38,0,9,0,48,0
Ayesha Curry Has Sparked A Debate About How Women Dress,1,1,10,36,0,9,0,46,0
19 Ways To Make Everyone Who Works Retail Hate You,1,1,9,30,0,9,2,39,0
The Cat Box Bed Is The Solution To Literally All Of Your Problems,1,1,13,40,0,12,0,53,0
Why scientists are studying whales off New York's coast,1,3,3,43,1,8,0,46,0
Eight billionaires 'as rich as world's poorest half',1,3,1,41,3,7,0,42,0
17 Teachers Who Are So Extra It’ll Make You Smile,1,3,9,28,1,9,2,37,0
12 Lucius Beebe Quotes That Will Restore Your Faith In Urbanity,1,1,10,41,0,10,2,51,0
17 Brilliant Artists To Follow When You're In A Creative Slump,1,1,10,39,1,10,2,49,0
"The best movies of 2016: ‘Moonlight,’ ‘Manchester by the Sea’ and ‘Southside With You’ make the top 10",1,3,7,64,8,17,6,71,0
"106 ""Star Wars"" Quotes That Make Perfect Instagram Captions",1,1,8,38,2,8,3,46,0
Do red lights need innovating? This car company thinks so,1,3,2,45,1,9,0,47,0
21 Must-Do Things At Disneyland On Halloween,1,1,7,28,1,6,2,35,0
26 State Fair Foods From 2015 That Will Blow Your Mind,1,1,9,29,0,10,6,38,0
Would You Rather: The New Years Resolution Edition,1,1,8,34,1,7,0,42,0
New York's Best Wings Festival Was Amazewing!,1,3,7,30,2,6,0,37,0
15 Random Ways to Make Money in Sports Without Being an Athlete,1,3,8,42,0,11,2,50,0
This Test Will Determine What Type Of Sex Matches Your Personality,1,1,11,45,0,10,0,56,0
This Is What $100 A Night Can Get You At Airbnbs Around The World,1,1,13,35,1,13,3,48,0
Hilary Duff's Son Luca Might Be An Actual Angel,1,1,9,29,1,8,0,38,0
"24 Words Only  ""How I Met Your Mother"" Fans Really Understand",1,1,10,36,2,11,2,46,0
Arnold Schwarzenegger Negged Nickelback and They Hit Back,1,2,7,43,0,7,0,50,0
Charity Shop Finds Mystery Widower Who Pinned Heartfelt Note to Wedding Gown - Yahoo,1,2,12,58,1,13,0,70,0
Mike Lee: Health Care Bill ‘Is Going to Fail’,1,3,8,26,3,8,0,34,0
19 Gadgets Every Adult Needs In Their Kitchen,1,1,7,29,0,7,2,36,0
Slippery bottle solves ketchup problem,1,3,1,33,0,4,0,34,0
29 Hilarious Tweets About Going To The Gym,1,1,7,26,0,7,2,33,0
"500 Storm Troopers Invade Great Wall Of China, Star Wars Hype Crushes All Global Resistance",1,1,14,59,1,14,3,73,0
21 Videos Of Eggs That Are Actually Porn,1,1,7,24,0,7,2,31,0
The Controversial Chinese Economist Uncovering Tough Truths,1,3,7,46,0,6,0,53,0
What the Repeal of Online Privacy Protections Means for You ,1,3,7,43,0,10,0,50,0
Where Carl Icahn the Adviser and Carl Icahn the Investor Meet ,1,3,8,43,0,11,0,51,0
16 Exit Songs To Walkout Of Your Last Final To,1,1,9,26,0,9,2,35,0
Snoop Dogg wants to be Twitter's new CEO,1,2,6,26,1,7,0,32,0
17 Colorado Trails That Should Be On Every Hiker's Bucket List,1,1,10,39,1,10,2,49,0
Donald Trump's First 100 Days in Office President Trump to Chris Christie: Try the Meatloaf,1,3,11,61,2,14,3,72,0
Which Female Celebrity Is Your Shoe Size Twin,1,1,8,30,0,7,0,38,0
"Thanks To Hollywood Economics, TV Diversity Wins Big At The Golden Globes",1,2,13,48,1,11,0,61,0
This Is How BuzzFeed New York Does Halloween,1,1,9,28,0,7,0,37,0
"A cyclist told a driver to f*ck off, then promptly fell off his bike",1,3,1,52,2,13,0,53,0
This moment between 2 quiz show contestants is so gloriously awkward,1,3,1,56,0,10,1,57,0
7 ‘Fatty Foods’ To Add To Your Grocery List To Cut Back Your Body Fat And Reduce The Risk Of Heart Disease,1,3,21,61,2,21,1,82,0
"The Russians Hacked Democrats’ Plans to Cheat in the General Election, Too",1,2,9,52,2,11,0,61,0
Everything we know so far about the Stockholm terror attack,1,3,2,48,0,9,0,50,0
The Evolution Of Natalie Dormer,1,1,5,22,0,4,0,27,0
17 Mouthwatering Risottos Guaranteed To Change Your Life,1,1,7,40,0,7,2,47,0
"This ""Toy Car"" Is Better Than My Real Car",1,1,9,22,2,8,0,31,0
"Which ""Gotham"" Character Are You Based On Your Zodiac Sign",1,1,10,37,2,9,0,47,0
Let's All Take A Moment To Appreciate The Uncontested Queen That Is Julie Andrews,1,1,14,53,1,13,0,67,0
"22 Reasons ""Love Actually"" Is Not A Good Movie",1,1,8,26,2,8,2,34,0
This Corgi Went To A Museum For His Third Birthday And He Looked Very Happy,1,2,15,46,0,14,0,61,0
Donald Trump's First 100 Days in Office President Trump to Chris Christie: Try the Meatloaf,1,2,11,61,2,14,3,72,0
Crystal meth haul,1,2,1,14,0,2,0,15,0
"Winchester is best place to live in the UK, study reveals",1,2,3,43,1,10,0,46,0
‘Duck Dynasty’ Producers Fired and Sued by ITV ,1,2,8,29,2,8,0,37,0
Tell Us: Have You Ever Snapped One Off At Work,1,1,10,26,1,9,0,36,0
20 Incredibly Honest Confessions About What It Is Really Like To Be A Stepparent,1,1,13,52,0,13,2,65,0
Future's 'HNDRXX' on Pace for No. 1 Debut,1,2,10,19,4,7,1,29,0
I Was Ghosted 3 Times In The Last Year. Here Are 6 Things I Learned.,1,3,13,37,2,14,2,50,0
The Cloud And Container News That Made Headlines In 2016 -- Part 1,1,3,10,37,2,12,5,47,0
23 Insane Pictures Of Trump Before He Was President,1,3,8,33,0,8,2,41,0
Best honeymoon destinations  - Business Insider,1,3,3,37,1,6,0,40,0
Here Are Some of Justin Bieber's Cutest Moments With His Fans,1,3,10,40,1,10,0,50,0
"How to shear a sheep, and win",1,2,1,21,1,6,0,22,0
18 Times James Blunt Took No Shit On Twitter In 2015,1,1,9,27,0,10,6,36,0
I Used To Be An Alcoholic. Now I'm A Stoner Who Has A Drink Sometimes,1,1,15,38,2,14,0,53,0
18 Awesome Gifts For Your Best Friend Who's Over Valentine's Day,1,1,10,40,2,10,2,50,0
A Genius Figured Out How To Take The Perfect Selfie With Your Dog,1,1,13,40,0,12,0,53,0
New Vaccine Could Slow Disease That Kills 600 Children a Day ,1,2,9,38,0,11,3,47,0
Black Mirror's 'San Junipero': 2016's most life-affirming piece of television,1,3,4,54,6,9,4,58,0
Which Movies Are So Much Better The Second Time,1,1,9,30,0,8,0,39,0
UPDATE: The 'Serial' Team Is Releasing A New True-Crime Show You'll Inevitably Binge,1,2,19,48,5,12,0,67,0
4 lessons about how millennials spend money from MTV's new reality competition show,1,3,3,66,1,12,1,69,0
Oh My God There's A Drake Coloring Book,1,1,8,23,1,7,0,31,0
Comcast wants be your new cellphone carrier. Here’s everything you need to know.,1,3,2,63,3,12,0,65,0
Amy Schumer Netflix Special Flooded with One-Star Reviews: ‘I’ve Had Migraines That Were Funnier’,1,3,14,65,5,13,0,79,0
"Donald Trump Gets Royally Trolled By The Man Who 'Really Makes' The iPhones & It’s So Honest, It's Hilarious",1,2,18,66,6,18,0,84,0
24 Catholic Tweets That Will Make You Laugh So Hard You’ll Have To Go To Confession,1,2,15,50,1,15,2,65,0
Liberal ladies: You're killing it on OKCupid,1,2,5,31,2,6,0,36,0
"Black Twitter Had No Chill About ""The Wiz Live!""",1,1,9,28,3,8,0,37,0
17 Passive-Aggressive People Who Are More Savage Than You,1,2,9,37,1,8,2,46,0
Actor T.J. Miller Arrested for Allegedly Slapping Uber Driver,1,3,9,42,2,8,0,51,0
Sol Campbell plans London mayor bid as Conservative,1,3,4,40,0,7,0,44,0
SEIU Budget Slashed by $90 Million over Union Fears of Trump,1,2,10,37,1,10,2,47,0
18 Celebrity Men Who Are Actually Just Really Pleased To See You,1,1,11,40,0,11,2,51,0
"Flight compensation: Delta to offer nearly £8,000 to overbooked passengers",1,3,2,56,3,9,4,58,0
Man miraculously survives having a nail HAMMERED into his brain after vicious attack at a Chinese pool hall,1,3,10,80,0,17,0,90,0
"Gummy Bear Maker Haribo to Build Plant in Wisconsin, Creating 400 Jobs",1,2,9,46,1,11,3,55,0
Can Work Life Balance Be a Reality? This Company Makes it Possible,1,3,10,44,1,11,0,54,0
How to make Dorie Greenspan’s cheese and bacon apéro quick bread,1,2,3,50,1,10,0,53,0
22 Insanely Adorable DIY Decorations For Holiday Parties,1,1,9,38,0,7,2,47,0
"How Well Do You Remember ""The Nightmare Before Christmas""",1,1,9,38,2,8,0,47,0
26 Very Important Nonfiction Books You Should Be Reading,1,1,8,38,0,8,2,46,0
Best places to swim with sharks,1,2,1,25,0,5,0,26,0
Did Kim Kardashian hint at a divorce before her long-awaited return to Instagram?,1,2,4,63,2,12,0,67,0
Which Type Of Dance Music Matches Your Favorite Cat Breed,1,1,10,38,0,9,0,48,0
12 Trees Looking Sexy AF,1,1,5,13,0,4,2,18,0
Africa's week in pictures: 21-27 April 2017,1,2,2,24,3,6,8,26,0
27 Subtle And Tasteful White Ink Tattoos,1,1,6,26,0,6,2,32,0
Tell Us About Your Educational Non-Traditional Path,1,1,8,36,1,6,0,44,0
John Mayer Has More to Say: The Outtakes ,1,2,7,25,1,8,0,32,0
Trump says China won’t be labeled a currency manipulator,1,3,2,45,1,8,0,47,0
What It's Like Having PPD As A Black Woman,1,1,11,22,1,8,0,33,0
Chocolate Rainbow Surprise Cake,1,1,4,24,0,3,0,28,0
Amandla Stenberg Co-Wrote A Comic Starring A Young Black Hero,1,1,11,40,1,9,0,51,0
22 Breakout Movie Stars of 2016,1,3,3,17,0,5,6,20,0
23 Of The Most Satisfying Gaming Achievements,1,1,6,31,0,6,2,37,0
Can You Identify These Films Using Only Half Of The Characters' Faces,1,1,12,45,1,11,0,57,0
Hope for troops as antibiotics show they could be 'exciting new treatment' for PTSD,1,2,5,63,2,13,0,68,0
A ‘Firefly’ Reboot Could Happen If This One Person Is On Board,1,3,12,37,2,11,0,49,0
15 Things That Marwaris Are Tired Of Hearing,1,1,7,28,0,7,2,35,0
17 Realizations All Women Have While Jean Shopping,1,1,7,34,0,7,2,41,0
This 100 Years Of Zombie Evolution Is Amazing,1,1,7,28,0,7,3,35,0
Being A Gay Guy: Thoughts Vs. Real Life,1,1,8,22,2,7,0,30,0
29 Playlists To Listen To When Everything Sucks,1,1,7,31,0,7,2,38,0
North West Took Out Her Bun And Rocked Her Natural Curls,1,1,11,35,0,10,0,46,0
Isis fighters kill 15 people after tricking Mosul residents by posing as liberating Iraqi soldiers,1,3,3,79,0,14,2,82,0
Everything You Need To Know About Lush's Bath Bomb Factory,1,1,10,38,1,9,0,48,0
15 Of The Most Hilarious Tweets About College Life In India,1,1,10,37,0,10,2,47,0
Can You Pass This Lie Detector Test?,1,3,7,22,1,6,0,29,0
19 Savory Vegetarian Dishes That'll Warm You Up This Winter,1,1,9,38,1,9,2,47,0
UK's first centre for Brexit studies launched at Birmingham City University,1,3,6,58,1,10,0,64,0
An anti-Trump movement is calling for the boycott of these 36 DAPL-linked banks,1,2,6,57,2,12,2,63,0
Peak Delly: How a kid from country Victoria got his own signature shoe,1,3,4,53,1,12,0,57,0
Hate Crimes Against Africans Continue As Another Man Thrashed Badly By A Mob In Greater Noida,1,3,16,62,0,15,0,78,0
An Ode To The Humble Dal,1,1,6,13,0,5,0,19,0
7 Steps To Rebound From Student Loan Refinancing Rejection,1,2,8,41,0,8,1,49,0
Adele The Frenchie Wants To Say Hello,1,1,7,24,0,6,0,31,0
"Obama: ‘Corrosive Nature’ of Talk Radio, Fake News Has Ruined Democracy",1,3,10,47,4,10,0,57,0
Rachel Maddow Is The Only Cable News Host On List Of Most-Streamed Primetime Programs,1,3,15,56,1,13,0,71,0
15 Easy And Affordable Stocking Fillers To Buy Right Now,1,1,9,36,0,9,2,45,0
"Tourists Flee ‘Nightmare’ Paris Amidst Rising Theft, Assaults, Terror",1,3,9,48,4,8,0,57,0
Which Marvel TV Show Should You Give A Shot,1,1,10,25,0,8,0,35,0
15 Really Random Things That Make Adorable Stamps,1,1,7,33,0,7,2,40,0
18 Of The Laziest Employees You Will Ever Meet,1,1,8,28,0,8,2,36,0
"Marriage is more beneficial to men than women, study finds",1,2,1,47,1,9,0,48,0
17 Images Of Candy That Are True Works Of Art,1,1,9,25,0,9,2,34,0
11 Charts That Will Speak To Anyone Who Really Fucking Loves Swearing,1,1,11,45,0,11,2,56,0
Choose Some Squiggles And I'll Tell You What Everybody Loves About You,1,3,12,46,1,11,0,58,0
Ta'Rhonda Jones Auditioned For The Role Of Ramona Singer And It Is Perfect,1,1,14,47,1,12,0,61,0
How Well Do You Actually Know Kourtney Kardashian,1,1,8,34,0,7,0,42,0
Let's All Congratulate Twitter On Not Verifying Kamaal R. Khan,1,1,10,41,2,9,0,51,0
What psychologists really think about you lying to your kids about Santa,1,3,2,59,0,11,0,61,0
Executive Edge,1,2,2,11,0,1,0,13,0
"21 Reasons You Should Follow ""Dogs Taking Dumps"" On Instagram",1,1,9,39,2,9,2,48,0
The U.S. Economy’s Full-Tank Conundrum,1,3,7,23,4,4,0,30,0
15 Scrumptious Oreo Desserts We Are Literally Not Worthy Of,1,1,9,39,0,9,2,48,0
Fact Check: Trump’s Critiques of the Affordable Care Act ,1,3,7,39,2,9,0,46,0
Britain's oldest Olympian: Hitler stopped me getting a medal so I bombed him,1,2,4,58,2,12,0,62,0
What's The Most Beautiful College Campus In The World,1,1,9,35,1,8,0,44,0
Cubs dominate MLB's list of most popular jerseys,1,2,4,36,1,7,0,40,0
How the Flash Crash Trader’s $50 Million Fortune Vanished,1,2,7,38,2,8,2,45,0
Detectives Play Clue,1,1,3,15,0,2,0,18,0
26 Inspiring Dogs From NYC's Biggest Halloween Parade,1,1,9,34,1,7,2,43,0
A List of Everything Taylor Swift Has Destroyed in Music Videos,1,2,9,44,0,10,0,53,0
17 Reasons Every Gryffindor Needs A Hufflepuff Best Friend,1,1,8,40,0,8,2,48,0
Helen Mirren’s Instagram Is The Most Delightful Thing You’ll See Today,1,3,11,47,2,10,0,58,0
Report: Pornography Use Tied to Relationship Dissatisfaction,1,3,6,47,1,6,0,53,0
Gay Men Gave Lesbians Makeovers And The Result Was Disastrous,1,1,10,42,0,9,0,52,0
Here are the must-see movies that are going to win Oscars in 2017,1,2,2,46,1,12,4,48,0
"One Hatchback, 68 Tons of Meat: Arrest Ends Swiss Smuggling Case",1,2,9,41,2,10,2,50,0
23 Things Everyone With A Penis Needs To Know,1,1,8,27,0,8,2,35,0
11 Beautiful Florida Beach Towns You Need To Visit,1,1,8,32,0,8,2,40,0
Couples Who Prove Opposites Attract,1,1,5,26,0,4,0,31,0
23 Secrets Museum Stewards Will Never Tell You,1,1,7,30,0,7,2,37,0
Try These Tasty Treats For Your Super Bowl Party,1,1,9,31,0,8,0,40,0
"20 Years Ago, TV Looked Very Different",1,3,7,22,1,6,2,29,0
Adults Review Popular Kids' Toys: Cleverkeet,1,1,6,31,2,5,0,37,0
9 New Facts That Prove Hollywood Has A Diversity Problem,1,1,9,37,0,9,1,46,0
"We Know Which Plastic You Are Based On ""Mean Girls"" Halloween Trivia",1,1,12,43,2,11,0,55,0
John Leguizamo: ‘Jeff Sessions Should Never Be Attorney General’,1,3,9,44,3,8,0,53,0
Find Out Which Hilarious Dog GIF Is 100% You With Just One Question,1,1,14,37,1,12,3,51,0
What to know about Air Defense Identification Zones ,1,3,5,39,0,8,0,44,0
Details emerge of George Michael's many quiet acts of kindness,1,3,3,49,1,9,0,52,0
19 Painfully Honest Confessions From People Who Experience Panic Attacks,1,1,9,52,0,9,2,61,0
18 Ultra-Personalized Gifts To Keep For Yourself,1,1,7,32,1,6,2,39,0
21 Times Idris Elba Gave You Life,1,1,6,19,0,6,2,25,0
"Katniss Tells Johanna That Snow Has To Die In This Exclusive ""Hunger Games"" Clip",1,1,14,51,2,13,0,65,0
Fix Is In: Comey Praised DNC-Hired Cybersecurity Firm Even After Botched Report,1,2,15,51,2,11,0,66,0
I’ve lost faith in men. They seem incapable of genuine affection or loyalty,1,2,2,59,2,12,0,61,0
"13 signs you have a work spouse, even if doesn't feel like it",1,3,0,45,2,12,2,45,0
These Hollywood Actors Performed Monologues Of Other Women's Abortion Stories,1,1,10,57,1,9,0,67,0
21 Times Neville Longbottom Out-Longbottomed Himself In 2015,1,1,7,39,1,7,6,46,0
The Struggles Of Being Twins,1,1,5,19,0,4,0,24,0
People Are Putting Instant Coffee In Their Spaghetti Bolognaise For Some Reason,1,1,12,56,0,11,0,68,0
"Australia on cusp of large-scale solar boom as setup costs tumble, experts say",1,3,1,63,2,12,0,64,0
Going 'Wild': Why more women are seeking out adventure,1,3,3,40,3,8,0,43,0
Cat owner learns the hard way to read those Amazon descriptions carefully,1,3,2,60,0,11,0,62,0
PROMO: Toyota and Photographer Anthony Supreme Get to Know the Unknown,1,3,12,47,1,10,0,59,0
Why Blue States Are the Real ‘Tea Party’ ,1,2,7,24,2,8,0,31,0
21 Insanely Creepy Santa Claus Photos That May Ruin Your Christmas,1,1,10,44,0,10,2,54,0
Demi Lovato Is Being Accused Of Stealing The Sample In Her New Song,1,1,13,42,0,12,0,55,0
"Capitol: Painting Depicting Police as Pigs Violates Rules, Will Be Removed  Insider",1,2,11,58,2,12,0,69,0
Teen wants to take grandma to prom -- his high school says no,1,3,1,46,2,12,0,47,0
How Big Is GE Capital? It Depends,1,3,8,18,1,6,0,26,0
"DHS Kelly Slams Obama’s Policies, Proclaims ‘Sacred Duty’ To Protect America",1,3,13,49,4,10,0,62,0
"Are You More Disney's ""Sleepy Hollow"" Or ""Wind In The Willows""",1,1,11,36,5,10,0,47,0
I JUST POOPED MY PANTS,1,1,18,0,0,4,0,18,0
Find Out Your Horoscope For The Week Of October 26,1,1,9,30,0,9,2,39,0
24 Horrifying But Fascinating True-Crime Podcasts You Must Listen To,1,3,10,46,1,9,2,56,0
The Cubs’ Theo Epstein had a home run response to getting named the ‘world’s greatest leader’,1,2,4,70,4,15,0,74,0
Freshman killed during hammer throw while volunteering at Wheaton College track and field event,1,3,3,79,0,13,0,82,0
"21 Times Tumblr Was Funniest About ""Game Of Thrones""",1,1,8,32,2,8,2,40,0
33 Things Kim Kardashian Has 100% Actually Said,1,1,6,28,1,7,5,34,0
The Story Of A Woman Who Might Be Posing As Black Totally Owned The Internet,1,2,15,47,0,14,0,62,0
"'I do, I did, I'm done': The hilarious DIVORCE cakes couples are ordering to celebrate the end of their marriages",1,3,11,77,6,19,0,88,0
Why We Don’t Value Flextime Enough,1,3,6,22,1,5,0,28,0
19 Pictures That Smell Just Like Your Childhood,1,1,7,31,0,7,2,38,0
21 Tweets That Prove Instagram Is Just The Worst,1,1,8,30,0,8,2,38,0
We Need To Talk About Brazil,1,1,6,17,0,5,0,23,0
This Tiny Corgi Hates His Tiny Pumpkin,1,1,7,25,0,6,0,32,0
Why Does That One Dude From Pentatonix Look Like Howie From Backstreet Boys,1,1,13,50,0,12,0,63,0
The ‘social sickie’ – a sure-fire way to avoid the Christmas party,1,2,2,49,4,11,0,51,0
"How Well Do You Remember The Lyrics To LFO's ""Summer Girls""",1,1,13,33,3,10,0,46,0
"15 Photos That Prove Goats Are Underrated, Majestic Beings",1,1,8,39,1,8,2,47,0
Check Out Full Credits for Harry Styles' 'Sign of the Times' Single,1,3,9,44,3,11,0,53,0
"Which ""Law And Order: SVU"" Character Are You Based On Your Zodiac",1,1,14,37,3,11,0,51,0
Jimmy Fallon Keeps On Getting Injured,1,1,6,26,0,5,0,32,0
The 16 Best Movies and Television Shows About High School Football,1,3,9,45,0,10,2,54,0
"Thoughts I Had While Watching The Season 11 Premiere Of ""Keeping Up With The Kardashians",1,1,14,57,1,14,2,71,0
"Obama and the Middle East - too little, too late?",1,3,3,34,3,9,0,37,0
19 Snacks From Your Childhood You Literally Forgot About Until Right Now,1,2,11,48,0,11,2,59,0
How to Do Warrior II: The Yoga Pose That Can Tone Your Butt,1,3,13,33,1,12,0,46,0
Which Female TV Character Is Your Soulmate Based On Your Favorite Foods,1,1,13,47,0,11,0,60,0
Briton killed in New Zealand paraglider accident,1,3,3,39,0,6,0,42,0
"'Jimmy Kimmel' Asks Warriors Fans About Fake Issues, Gets Hilariously Serious Responses",1,3,12,61,3,11,0,73,0
Literally Every Time Meryl Streep Has Been Nominated For An Oscar,1,3,11,44,0,10,0,55,0
What Would You Get For Chanel-O-Ween Based On Your Birth Month,1,1,13,37,2,10,0,50,0
Sebastian Gorka likes to be called ‘Dr. Gorka.’ He gets his way only in conservative media.,1,3,5,66,5,15,0,71,0
"No One Like Those ‘Saggy Batwings’, Here Is How You Can Have Toned Arms",1,3,14,41,3,13,0,55,0
Galleries Britain's 20 most 'crap' towns - and why we love them,1,2,2,44,4,11,2,46,0
China state broadcaster CCTV launches global media network to help rebrand China overseas,1,3,6,71,0,12,0,77,0
10 Bizarre Fast-Food Questions That’ll Stump Literally Anyone,1,3,8,42,2,7,2,50,0
Graphic: The A-Z of Tony Blair's global business deals,1,2,6,37,3,8,0,43,0
How Well Do You Know Popular Slogans,1,1,7,23,0,6,0,30,0
The 50 Most Powerful Pictures In American History,1,1,7,33,0,7,2,40,0
Zendaya Coleman Is Officially The Newest CoverGirl,1,1,8,36,0,6,0,44,0
North America is so cold right now this happened The list,1,3,3,44,0,10,0,47,0
A Navy SEAL explains why you should end a shower with cold water,1,3,6,46,0,12,0,52,0
Chuck Berry: Seven of the king of rock 'n' roll's best songs,1,3,3,42,4,11,0,45,0
Stephen Curry's Wife Zings Cavaliers Fans with Post About Sleeping Riley,1,3,10,51,1,10,0,61,0
How Many Movies Did You Actually See In 2016?,1,2,8,24,1,8,4,32,0
Turn Disappointment Into Opportunity: The 3 Steps Leaders Take That Will Turn Your Career Around Now,1,3,15,68,1,15,1,83,0
Biographer Claims Barack Obama Called America ‘Racist Society’ in Unpublished Manuscript,1,3,10,66,2,10,0,76,0
People Try Kombucha,1,1,3,14,0,2,0,17,0
These Pictures Of India's Most Popular Office Will Make You Want To Quit Your Job,1,1,15,51,1,14,0,66,0
These People Got Facials And Extractions....And It Was Pretty Gross,1,1,11,43,4,9,0,54,0
27 Of The Best Emo Songs To Add To Your Breakup Playlist,1,1,11,32,0,11,2,43,0
WATCH! This week's episode of Henry Blodget's new markets and economics show,1,3,8,54,3,11,0,62,0
Men Transform Into Superheroes,1,1,4,23,0,3,0,27,0
Five people who waited until their wedding night to have sex describe what it was like,1,2,1,70,0,15,0,71,0
A Zoo Has Just Allowed These Tiny Meerkat Pup's Outside For The First Time,1,1,14,46,1,13,0,60,0
18 Must-Have Shoes For Fall,1,1,5,15,1,4,2,20,0
"23 Pictures People Over 5'5"" Will Never Understand",1,1,6,31,2,7,4,37,0
Slow Cooker Mexican Dishes,1,1,4,19,0,3,0,23,0
MSNBC’s Hunt to Sen Warren: Is McConnell ‘Sexist’?,1,3,12,26,5,7,0,38,0
These Ice Cream Bites Will Have Everyone Screaming For Ice Cream,1,1,11,43,0,10,0,54,0
Watch This Boyfriend Blindly Guess Which Hand Belongs To His Boyfriend,1,1,11,49,0,10,0,60,0
Tell Us The Funniest Reason You've Skipped A Workout,1,1,9,34,1,8,0,43,0
"Celebrities Read The Lyrics To ""Sorry"" And Got So Freakin' Into It",1,1,12,40,3,11,0,52,0
Inside the largest Earth science event: 'The time has never been more urgent',1,3,3,59,3,12,0,62,0
5 gutsy highlights from Carrie Fisher's one-woman show,1,3,2,42,2,7,1,44,0
Here's how much the average family in their 40s has saved for retirement,1,3,1,56,1,12,2,57,0
"Psychic Attempts to Prove He's Immortal, Accidentally Stabs Himself to Death",1,2,9,55,2,10,0,64,0
36 Things That Will Make Riding In Your Car So Much Better,1,1,11,34,0,11,2,45,0
19 Things You Can Only Say During Sex If You're Emo,1,1,10,28,1,10,2,38,0
"Lockheed CEO Pledges 1,800 New Jobs, Lower F-35 Costs",1,3,10,26,3,8,6,36,0
WATCH: Speaker Paul Ryan Ad Uses Donald Trump to Sell Healthcare Bill,1,2,15,42,1,11,0,57,0
Desperation Sets in for House Hunters in Toronto’s Red-Hot Market,1,3,8,46,2,9,0,54,0
We Got Snake Massages And It Was Actually Relaxing,1,1,9,33,0,8,0,42,0
"Advice about conquering fear, from this year’s graduation speakers",1,3,1,55,2,8,0,56,0
How to Keep Your Belongings Safe in the Gig Economy,1,3,7,35,0,9,0,42,0
The Weirdest Misheard Christmas Lyrics Of All Time,1,1,8,35,0,7,0,43,0
What’s a little oil between neighbors? Venezuela-Guyana tensions flare.,1,2,3,56,4,8,0,59,0
Here's How To Make Spinach Artichoke Garlic Bread,1,1,8,33,1,7,0,41,0
Only People With Perfect Vision Can Get Through These Mazes,1,3,10,40,0,9,0,50,0
Elon Musk just took advice from a super smart 5th grader,1,2,2,43,0,10,1,45,0
Video Shows Beauty Store Manager Pinning Customer Accused of Shoplifting,1,3,9,54,0,9,0,63,0
3 things that could be making you unhappy,1,3,0,33,0,7,1,33,0
53 Pictures Only Introverts Can Truly Appreciate,1,3,6,34,0,6,2,40,0
Are You More Vincent Crabbe Or Gregory Goyle,1,1,8,29,0,7,0,37,0
"23 Of The Funniest ""Nancy Drew"" Game Memes",1,1,7,24,2,7,2,31,0
23 Yahoo Questions That Will Destroy Your Faith In Humanity,1,1,9,39,0,9,2,48,0
"Oh My God, This Cake Changes Colors When You Turn It",1,1,11,30,1,10,0,41,0
Which Animated TV Show Family Should You Live With,1,1,10,32,0,8,0,42,0
Behind The Scenes Of Bloomberg Businessweek's Epic Explanation Of Code,1,2,10,50,1,9,0,60,0
27 Big Things People Are Letting Go Of This Year,1,1,9,28,0,9,2,37,0
"18 Times Pam Beesly Proved She's The Best Character On ""The Office""",1,1,11,40,3,11,2,51,0
Star Wars: What do fans make of the trailer for The Last Jedi?,1,3,6,42,2,12,0,48,0
18 Hot Dudes That Proved 2016 Was The Year Of Thirst,1,3,9,27,0,10,6,36,0
Think Twice Before You 'Like' These Viral Facebook Posts,1,3,9,37,2,8,0,46,0
Jeb Bush to Trump: ‘Stop saying things that aren’t true’,1,3,4,39,4,9,0,43,0
We Know Which GIF Will Make You Laugh Based On Your Birth Month,1,1,15,36,0,12,0,51,0
Should Bradley Cooper Or Ryan Gosling Be Your Leading Man,1,1,10,38,0,9,0,48,0
Just Making Sure Everyone In The World Knows That Deepika Padukone Is A Flawless Goddess,1,1,15,59,0,14,0,74,0
This Dessert Test Will Reveal How Many Grandchildren You’ll Have,1,3,10,44,1,9,0,54,0
"MSNBC’s Roberts: Dems Have ‘Fever Dream,’ Getting ‘the Horse Before the Cart’ with Mike Flynn",1,2,16,56,7,14,0,72,0
Elderly resident unaccounted for after Dallas condo fire ,1,2,2,47,0,8,0,49,0
Ridiculously Easy Recipes for When You've Lost an Hour’s Sleep  - Recipes from NYT Cooking,1,3,13,59,3,15,0,72,0
Poor woman got her hand stuck in a toilet so badly that she had to call the police,1,2,1,64,0,17,0,65,0
How many U.S. adults are transgender?,1,3,3,26,3,5,0,29,0
"Another Kerala Man Hosts Lavish Wedding For Daughter, Recreates Delhi's Akshardham Temple",1,2,12,64,2,11,0,76,0
26 Brilliant Gifts Only English Nerds Will Appreciate,1,1,7,37,0,7,2,44,0
These Delicious Ice Pops Will Get You Drunk,1,1,8,28,0,7,0,36,0
This is how you grow old like a superhuman The list,1,3,2,39,0,10,0,41,0
An exercise scientist reveals how to get six-pack abs,1,3,1,43,1,8,0,44,0
This One Question Will Determine Whether You Should Live In New York,1,1,12,45,0,11,0,57,0
22 ways to be healthier with minimal effort,1,3,0,34,0,7,2,34,0
WATCH! This week's episode of Henry Blodget's new markets and economics show,1,2,8,54,3,11,0,62,0
Mistletoe is actually a tree-killing parasite â here's how it became a Christmas icon,1,3,2,68,4,13,0,70,0
Amazon's New Credit Card Primed To Disrupt Retail,1,2,8,33,1,7,0,41,0
A Man Had A Three-Day Boner After Taking An Herbal Supplement,1,1,12,38,1,10,0,50,0
What % Annoying And What % Useful Are Your Boobs?,1,3,8,29,3,9,0,37,0
Did You Ruin Everything,1,1,4,16,0,3,0,20,0
15 Game-Changing Eyeliner Charts If You Suck At Makeup,1,1,9,34,1,8,2,43,0
"18 Notable Butts In Bosch's ""Garden Of Earthly Delights""",1,1,8,35,3,8,2,43,0
Sunset Hair Has Arrived And It's Drop-Dead Beautiful,1,1,9,34,2,7,0,43,0
Oprah Winfrey Had The Best Possible Response When Asked About T.I.'s Recent Comments,1,1,14,55,3,12,0,69,0
Niall Horan's New Glasses Are Causing Everyone To Lose Their Damn Minds,1,1,12,47,1,11,0,59,0
26 Movies That Will Ruin Your Appetite,1,1,6,24,0,6,2,30,0
A Bride And Groom Went To A Kansas City Royals Playoff Game During Their Wedding,1,1,15,51,0,14,0,66,0
30 Halloween Costumes Only True Pun-Lovers Will Appreciate,1,1,8,40,1,7,2,48,0
Instagram Caused An Outrage After Deleting A Post-Mastectomy Tattoo Account,1,1,11,54,1,9,0,65,0
How Much Do You Actually Know About Gay Sex,1,1,9,26,0,8,0,35,0
A Groom Just Put Every Other Guy To Shame By Creating A Mash-Up Song For His Wedding Vows,1,1,19,52,1,17,0,71,0
Donald Trump announces abrupt change to US foreign policy,1,2,4,45,0,8,0,49,0
The 5 most dramatic moments for Team Internet in 2016,1,3,3,36,0,9,5,39,0
Jesse Watters: Under Armour Should ‘Rip Up’ Steph Curry’s Contract After Criticizing Company for Trump Support,1,2,15,76,4,15,0,91,0
22 Celebrity Faces That Summed Up This Year's Golden Globes,1,1,9,38,1,9,2,47,0
The Risk of Rising Consumer Borrowing ,1,3,5,27,0,6,0,32,0
Report: Mitt Romney Fired; Trump Chooses Exxon CEO Rex Tillerson for Secretary of State,1,3,14,58,2,13,0,72,0
Who Should Be Your Celebrity Sugar Daddy,1,1,7,27,0,6,0,34,0
The gender identity terms you need to know,1,3,1,34,0,7,0,35,0
11 Fat-Shaming Confessions,1,1,3,18,1,2,2,21,0
Lil Bub Has A New Yule Log Video That You Need To See,1,1,13,28,0,12,0,41,0
Who wore the best Christmas kicks?,1,3,2,26,1,5,0,28,0
How modern witches are gathering online to stop Trump,1,3,2,43,0,8,0,45,0
Jimmy Kimmel: Trump EPA Nominee Scott Pruitt a ‘Piece of Sh*t’,1,3,11,37,4,10,0,48,0
Tucker Carlson Takes Over Bill O'Reilly's Time Slot In More Ways Than One,1,2,14,45,2,12,0,59,0
17 Faces Everyone Who's Experienced Halloween In The Cold Will Understand,1,1,10,50,1,10,2,60,0
Which Famous Blonde Will You Marry,1,1,6,23,0,5,0,29,0
18 Things That Are Way Too Real For People Who Stay Up Late,1,1,12,33,0,12,2,45,0
39 Stars We Couldn't Get Enough Of In 2015,1,1,7,20,1,8,6,27,0
We Gave Celebs A Fifth Grade Spelling Test And They Bombed It,1,1,12,38,0,11,0,50,0
Which Christmas Movie Matches Your Zodiac Sign,1,1,7,33,0,6,0,40,0
"Learning To Say The Word ""Depression"" Saved My Life",1,1,9,32,2,8,0,41,0
19 Lies All Parents Are Guilty Of Telling In Public,1,1,9,31,0,9,2,40,0
This Model Just Made History At The Victoria's Secret Fashion Show,1,1,11,44,1,10,0,55,0
"Winchester is best place to live in the UK, study reveals",1,3,3,43,1,10,0,46,0
This One Tweet Helped The Indian Railway Ministry Save A 19-Year-Old From Human Traffickers,1,1,15,59,2,13,2,74,0
"I'm A Democrat, But I'm Not",1,1,6,13,3,5,0,19,0
11 Quotes About Friendship That Will Make You Text Your BFF,1,1,12,35,0,10,2,47,0
21 Photos People Who Skipped Science Won't Understand,1,1,7,36,1,7,2,43,0
21 Reasons You Should Fall In Love With A Cat Person,1,1,10,30,0,10,2,40,0
Why We Desperately Need To Bring Back Vocational Training In Schools,1,3,11,47,0,10,0,58,0
17 Free Ways To Make Your Grown-Up Apartment So Freaking Cozy,1,1,11,37,1,10,2,48,0
The year music died: Remembering the icons who left us in 2016,1,3,2,44,1,11,4,46,0
"Family Fights To Ban USDA Wildlife Trap That Killed Their Dog, Injured Son",1,2,16,45,1,12,0,61,0
What Role Would You Play In A Band,1,1,8,19,0,7,0,27,0
"Thomas Friedman Bemoans Moving US Embassy to Jerusalem: ‘Madness,’ ‘The Full Employment for Iran Act’",1,3,14,67,6,14,0,81,0
2015's Best News Bloopers Are Here And They're Out Of Control,1,1,10,35,2,10,4,45,0
Frank Gaffney: Leaders like Merkel Still ‘Scratching Their Heads’ over Motivations of Jihadis,1,2,10,68,3,12,0,78,0
I Got Drunk With The Funeral Industry To Find Out What Happens When We Die,1,1,15,45,0,14,0,60,0
Seeing E-Cigarettes May Increase Your Desire To Smoke,1,2,9,36,1,7,0,45,0
"16 Times 2015 Proved ""Harry Potter"" Will Never Die",1,1,7,27,2,8,6,34,0
24 Sounds That Will Take You Back To 2004,1,1,7,20,0,8,6,27,0
‘He’s dead. And soon I will be too’: Father accused of throwing 7-month-old son from bridge,1,3,4,64,7,15,1,68,0
We Know Which Trump Rally Dance Move You Are Based On One Question,1,1,13,41,0,12,0,54,0
Alec Baldwin mocks Donald Trump’s slogan ‘Make American Great Again’ – in Russian,1,3,9,56,4,12,0,65,0
19 Of The Sassiest Responses Women Gave To Men On Tinder In 2015,1,1,11,35,0,12,6,46,0
28 Challenging Puzzles That Are Anything But Basic,1,1,7,34,0,7,2,41,0
What Does Your Favorite Classic Video Game Mascot Say About You,1,1,11,42,0,10,0,53,0
12 Amazing YA Books By Latino Authors You Wont Be Able To Put Down,1,1,14,37,0,13,2,51,0
"Congrats, Denzel Washington! Actor To Receive The Cecil B. DeMille Award",1,1,12,47,3,10,0,59,0
Happy Pugsgiving,1,1,2,13,0,1,0,15,0
27 Ridiculously Weird Things Kids Actually Got While Trick-Or-Treating,1,1,10,48,2,8,2,58,0
The Struggles Of Being An Android User In An iPhone World,1,1,11,36,0,10,0,47,0
The 10 Most Stressful Jobs In 2017,1,3,5,17,0,6,6,22,0
There Was A Magical Wizard At The Democratic Presidential Debate,1,1,10,45,0,9,0,55,0
We Know What Unnecessary Chore Your Parents Will Make You Do By Your Zodiac Sign,1,1,15,51,0,14,0,66,0
Here's What's Wrong With All Those Articles Claiming Champagne Improves Your Memory,1,1,12,58,2,11,0,70,0
"19 Facts Guaranteed To Make All ""Harry Potter"" Fans Feel Old",1,1,10,36,2,10,2,46,0
Should You Go Camping,1,1,4,14,0,3,0,18,0
29 Beauty Products You Should Try In 2017,1,2,6,22,0,7,6,28,0
Politico: Hillary Clinton Is Running Again,1,3,6,30,1,5,0,36,0
"A Student Just Made The Best Cover Of Adele's ""Hello"" You May Ever Hear",1,1,14,41,3,13,0,55,0
9 bizarre things that are still canon in the 'Star Wars' universe,1,3,2,49,2,11,1,51,0
35 Things That Will Hit You Right In The Childhood,1,1,9,30,0,9,2,39,0
"Celebrities Reading The Lyrics To ""Hotline Bling"" Is Hilarious",1,1,9,43,2,8,0,52,0
14 Instagrams That Prove Shweta Tripathi Is Literally The Cutest Human Being,1,1,11,52,0,11,2,63,0
I am the woman in this picture and this is what it was like The list,1,2,2,51,0,15,0,53,0
"Here's What You Need To Know About The Women Of ""Transcendent""",1,1,11,38,3,10,0,49,0
"Young, gifted, and cut down by a stupid war",1,3,1,32,2,8,0,33,0
These are the only countries that have banned harmful microbeads The list,1,3,2,60,0,11,0,62,0
23 Times Zayn Malik's Twitter Was The Most Profound Place On The Internet,1,1,12,46,1,12,2,58,0
These People Tried To Figure Out Where Max And Ruby's Parents Are,1,1,12,41,1,11,0,53,0
Four ways technology is transforming the museum experience,1,2,1,50,0,7,0,51,0
Which HBO Series Should You Watch Based On Your Sign,1,1,12,31,0,9,0,43,0
Which Badass Anime Character Are You,1,1,6,25,0,5,0,31,0
20 tweets from Cher that will help you remember 2016 in a better light,1,2,1,50,0,13,6,51,0
How Much Of A Cheese Addict Are You Really,1,1,9,25,0,8,0,34,0
Which Adele Album Are You Actually,1,1,6,23,0,5,0,29,0
25 Facts About 2015 That Will Make You Feel Old AF,1,1,10,24,0,10,6,34,0
Are you being held to ransom with an engagement ring?,1,2,1,42,1,9,0,43,0
17 Struggles Of Having Parents Who Hate The Way You Dress,1,1,10,35,0,10,2,45,0
21 Times Seth Rogen Spat The Hilarious Truth On Twitter,1,1,9,35,0,9,2,44,0
"The 22 Most Hilariously Accurate Moments From ""Being Canadian""",1,1,8,42,2,8,2,50,0
31 Reasons Potatoes Are The Best Thing At Thanksgiving,1,1,8,36,0,8,2,44,0
"We Need To Talk About The Music From ""A Goofy Movie""",1,1,11,29,2,10,0,40,0
"We Know Your Fave ""Harry Potter"" Character Based On Your Favorite Kitten",1,1,12,47,2,11,0,59,0
16 Ridiculously Pretty Bras You'll Want To Keep On All Day,1,1,10,35,1,10,2,45,0
"Round 1 takeaways: QB heists, Browns lament, more",1,3,4,34,3,7,1,38,0
Mexico’s Potential Weapons if Trump Declares War on Nafta ,1,3,7,41,1,9,0,48,0
8 Celebrity-Approved Workout Classes to Try in 2017,1,3,5,33,1,7,5,38,0
7 Healthy Eating Tricks You Should Try This Week,1,1,8,31,0,8,1,39,0
"18 Jokes That’ll Make You Be Like, “Ha!”",1,3,7,19,5,7,2,26,0
You May Want to Marry My Husband ,1,2,6,20,0,7,0,26,0
We Know Which Harry Styles Tweet You Are Based On Your Birth Month,1,1,13,41,0,12,0,54,0
When your wife refuses conventional cancer treatment,1,3,1,45,0,6,0,46,0
33 Healthy Things To Eat After You Work Out,1,1,8,25,0,8,2,33,0
The Best Places To Retire Without A Car,1,2,8,24,0,7,0,32,0
It’s Official: Millennial Drivers Are the Most Reckless Behind the Wheel,1,3,9,51,2,10,0,60,0
Top Model Jourdan Dunn Looks Fabulous On The Cover Of Vogue Brasil,1,1,12,43,0,11,0,55,0
How Well Do You Remember 2015,1,1,5,15,0,5,4,20,0
23 Golden Retriever Puppies Who’ll Remind You There Are Still Good Things In This World,1,2,14,56,1,14,2,70,0
17 Images You Won't Be Able To Unsee,1,1,7,19,1,7,2,26,0
What Disney Home Should You Live In,1,1,7,22,0,6,0,29,0
16 London Street Foods That Will Change Your Life,1,1,8,31,0,8,2,39,0
"What's Your Favorite ""Mean Girls"" Quote Of All Time",1,1,9,31,3,8,0,40,0
People Don't Know Who David Bowie Is And We're Here To Clear That Up,1,1,14,39,2,13,0,53,0
"Alison Krauss Talks 'Windy City,' Reveals Which Artist Her Son Warned Her Not to Cover",1,3,14,55,3,14,0,69,0
14 Halloween Movies That Actually Take Place On Halloween,1,1,8,39,0,8,2,47,0
Snack Makeover - Yogurt,1,1,3,16,1,3,0,19,0
"22 Reasons Fans Are Obsessed With ""The Walking Dead""",1,1,8,32,2,8,2,40,0
What's The Most Terrifying Unsolved Crime You've Ever Heard Of,1,1,10,41,2,9,0,51,0
15 Insane Confessions Of A Buckingham Palace Guard,1,1,7,34,0,7,2,41,0
Americans Guess German Curse Words,1,1,5,25,0,4,0,30,0
32 Of The Greatest Things That Happened On Tumblr In 2015,1,1,9,32,0,10,6,41,0
Facepalms of the week,1,2,1,17,0,3,0,18,0
What's Your Horoscope For The Week Of November 9,1,1,8,30,1,8,1,38,0
Here's Why No One Should Have An American Car,1,1,9,27,1,8,0,36,0
How women are using their Tinder matches to scam money off men,1,2,2,49,0,11,0,51,0
9 Things I Wish Someone Had Told Me About Relationships In My Twenties,1,1,12,45,0,12,1,57,0
"The inventor of the red solo cup, Robert Leo Hulseman, has died at the age of 84",1,3,4,56,2,16,2,60,0
19 Gifts Every Classical Music Nerd Will Love,1,1,7,29,0,7,2,36,0
Black Lives Matter to Attempt Disruption of Super Bowl Attendees’ Arrival,1,3,9,53,1,10,0,62,0
"Yes, really: '1984' is now sold out on Amazon",1,2,2,27,4,8,4,29,0
"California company wants to ‘hover’ buildings, protecting against earthquakes ",1,3,1,65,3,9,0,66,0
California Today: The Tale of the Laguna Beach Jumper ,1,2,7,37,1,9,0,44,0
9 Realities For People Who Are Delicate Fucking Flowers,1,1,8,38,0,8,1,46,0
The Walking Dead season 7 finale episode: The 5 characters who might die,1,3,4,53,1,12,2,57,0
Quesadillas Are The Best Thing Ever And We Are Not Worthy,1,1,11,36,0,10,0,47,0
5 Ridiculous Things Science Claimed About Bearded Men In 2015,1,1,8,39,0,9,5,47,0
We Know If You Have An iPhone Based On The Emoji You Choose,1,1,13,34,0,12,0,47,0
This Color Blot Test Will Reveal Your Inner Fear,1,1,9,31,0,8,0,40,0
"VanNess: Linda Sarsour, Women’s March Organizer and Fake Feminist",1,3,9,45,3,8,0,54,0
Test Your Random Knowledge With This Themeless Crossword,1,1,8,41,0,7,0,49,0
18 Teeny Tiny Silver Necklaces You 100% Need,1,1,6,25,1,7,5,31,0
Indian Basketball Star Satnam Singh Looks To Move Into Prowrestling As He Is Seen Training With WWE,1,3,19,64,0,16,0,83,0
What's The Worst Valentine's Day Present You've Ever Received,1,1,9,41,3,8,0,50,0
"What career you're most likely to have whether you're the oldest, middle or youngest child",1,3,1,72,3,14,0,73,0
24 Pictures That Make Way Too Much Sense If You Drive,1,1,10,31,0,10,2,41,0
This Little Kid Perfectly Directing Traffic In The Middle Of A Jam Should Be Your New Hero,1,1,17,57,0,16,0,74,0
6 Easy Tricks That Will Make You Way More Productive,1,3,9,33,0,9,1,42,0
Uber whistleblower exposes breach in driver-approval process,1,3,1,52,1,6,0,53,0
"Do You Still Know The Original ""Sister, Sister"" Theme Song",1,1,10,36,3,9,0,46,0
The 27 Most Annoying Things Every Bartender Has To Endure,1,1,9,37,0,9,2,46,0
Galleries The world's 18 greatest cities for food,1,2,2,37,1,7,2,39,0
Angelina Jolie Slams Refugee Order: Trump ‘Playing with Fire’,1,3,8,42,3,8,0,50,0
Grammy Winners 2017 ,1,2,2,11,0,3,4,13,0
10 things you need to know before the opening bell,1,2,0,39,0,9,2,39,0
"Rent Chickens, Sell the Eggs: Eye on Chinese Media",1,2,7,33,2,8,0,40,0
"Watch Joey Badass Freestyle Over Future's ""Mask Off""",1,2,8,34,3,7,0,42,0
UPS Tweeted -- Then Deleted -- A Bizarre MLK Jr Message,1,2,13,28,4,10,0,41,0
Meet The Chinese Company That Wants To Be The Intel Of Personalized Medicine,1,2,13,51,0,12,0,64,0
"The Myth Of The Hymen And Virginity Gets Busted On ""Adam Ruins Everything""",1,1,13,47,2,12,0,60,0
A Blind Gamer Won A 'Street Fighter V' Tournament Game Thanks To His Super Sensitive Ears,1,3,16,56,2,15,0,72,0
27 stunning images that were taken by Google Street View,1,2,3,42,0,9,2,45,0
18 Of The Worst Things You Can Say To Someone Who Lives In Toronto,1,1,13,38,0,13,2,51,0
These Body Charts Of Little Girls' Role Models Are Horrifying,1,1,10,41,1,9,0,51,0
31 Actually Helpful Tips For Dealing With Panic Attacks,1,1,8,37,0,8,2,45,0
Derrick Rose says winning higher priority than money in free agency,1,2,2,55,0,10,0,57,0
Here's the reason United Airlines can kick you off your flight,1,2,3,48,1,10,0,51,0
5 Skin-Care Hacks Every Traveler Needs [Video],1,2,7,29,3,6,1,36,0
"The way you write l, t, i, and y reveals a lot about your personality",1,3,1,51,3,14,0,52,0
Commuter Barbie Is Here and the Internet Is Losing It,1,3,8,36,0,9,0,44,0
Anna Wintour 'meets with Donald Trump' after slating the President-elect on train,1,3,5,62,3,11,0,67,0
19 Kitchen Horror Stories That’ll Make You Give Up Cooking Forever,1,2,10,43,1,10,2,53,0
Malala Yousafzai Is Pretty Much Good At Everything,1,1,8,35,0,7,0,43,0
Which Video Game Couple Matches Your Relationship,1,1,7,36,0,6,0,43,0
How everyone else reacted to Theresa May's snap general election The list,1,2,4,57,1,11,0,61,0
8 Pictures Of Calvin Harris Literally Just Buying Rugs,1,1,8,37,0,8,1,45,0
Uber Driver Saves 16-Year-Old Girl From Sex Trafficking,1,3,9,35,2,7,2,44,0
The Easiest Patronus Quiz You'll Ever Take,1,1,7,28,1,6,0,35,0
Hoping for an Inheritance? You May Not Get as Much as You Expect,1,3,9,42,1,12,0,51,0
"Robert Pattinson Thought His ""Twilight"" Character Was ""Suicidally Depressed""",1,1,9,55,4,8,0,64,0
Jaden Smith Looks Amazing In A Dress In The New Vogue Korea,1,1,12,36,0,11,0,48,0
Bill Gates: Pathogen could kill 30m in a year,1,2,3,31,1,8,2,34,0
"22 Impossible ""Who Wore It Best"" Questions For Animal Lovers",1,1,9,38,2,9,2,47,0
America’s Troops Celebrate Christmas Around the World,1,2,6,40,1,6,0,46,0
You’ll Only Understand These 28 Photos If You Went To Elementary School In The ‘90s,1,3,13,50,2,14,4,63,0
The Best Thing That's Happened To Cereal Since Cereal,1,1,9,35,1,8,0,44,0
"Rihanna Was Literally Incredibly, Amazingly Beautiful At The Dior Paris Fashion Week Show",1,1,13,63,1,12,0,76,0
How Many Of These Gamer Terms Do You Actually Know,1,1,10,31,0,9,0,41,0
Sandra Bullock And The Case For Flipping More Men's Roles For Women,1,1,12,43,1,11,0,55,0
"'Don't eat the kebabs' – Tupac, Kurt, and the best musician-to-musician letters",1,3,3,57,8,11,0,60,0
17 Creepy London Walks You Must Take,1,1,6,22,0,6,2,28,0
TONY ROBBINS: How to make a good first impression,1,3,12,28,1,8,0,40,0
"Are You Josh Flagg Or Josh Altman From ""Million Dollar Listing""",1,1,11,40,2,10,0,51,0
21 Times Adele Was Actually Fucking Hilarious,1,1,6,31,0,6,2,37,0
Carrie Fisher And Domhnall Gleeson Totally Stole The Show Backstage At The BAFTAs,1,1,17,52,0,12,0,69,0
Here's The Feminist Advice Lucille Ball Gave To Carol Burnett,1,1,10,41,1,9,0,51,0
Tell Us Whether These Things Are Foods Or Drinks,1,1,9,31,0,8,0,40,0
Welcome to the jazzy 'Bad and Boujee' remix the internet has needed,1,3,3,51,2,11,0,54,0
Can You Guess The Name Of This Nail Polish Color,1,1,10,29,0,9,0,39,0
"22 Female Friendship Lessons From Phoebe, Monica, And Rachel",1,1,8,40,2,8,2,48,0
"Here's How ""Keeping Up With The Kardashians"" Addressed Lamar Odom's Overdose",1,1,11,51,4,10,0,62,0
"Fake Antibiotics Being Sold Containing Flour, Starch And Paracetamol",1,3,9,50,1,8,0,59,0
England v Slovenia: Hodgson says Euro 2016 win all that matters,1,3,4,44,1,10,4,48,0
"The Alphabet According To ""Gilmore Girls""",1,1,6,28,2,5,0,34,0
The new Star Wars episode title means more than you think,1,3,3,44,0,10,0,47,0
Who Is Your Celeb Mom Based On Your Birth Month,1,1,10,28,0,9,0,38,0
"Answer These Questions And We'll Tell You Which ""Bring It On"" Cheerleader Audition You Are",1,1,15,58,3,14,0,73,0
Can You Identify Celebrities When They Don't Have Faces,1,1,9,37,1,8,0,46,0
"Watch: Fox News’ Griff Jenkins, Cameraman Get Caught in Middle of Violent Protest",1,3,11,55,3,12,0,66,0
"Donald Trump Issues New Immigration Order, Legal Challenges Remain Likely",1,3,10,53,1,9,0,63,0
9 Toilets That Will Make You Choose To Shit Your Pants,1,1,10,33,0,10,1,43,0
People think this new Nike advert is about sportswomen in the Middle East The list,1,3,5,63,0,14,0,68,0
The Best Cable-Cutting Device For People Who Are Broke As Hell,1,1,12,39,1,10,0,51,0
19 Life Hacks That Will Make You Feel Like You Have Your Shit Together,1,1,13,42,0,13,2,55,0
"Sascha Radetsky Looks Back On ""Center Stage"" And Ahead To ""Flesh & Bone""",1,1,12,43,5,12,0,55,0
Housing Outlook 2017: Eight Predictions From The Experts,1,3,7,37,1,7,4,44,0
How Well Do You Remember The NES Mario Games,1,1,11,25,0,8,0,36,0
15 Times The Try Guys Went A Little Too Far In 2015,1,1,10,24,0,11,6,34,0
"Daisy Takes Control On ""Agents Of S.H.I.E.L.D""",1,1,12,21,7,6,0,33,0
Day 1 Of BuzzFeed's 7-Day Clean Eating Challenge,1,1,8,29,2,7,2,37,0
8 Urban Dictionary Definitions You Need To Know,1,1,7,32,0,7,1,39,0
21 Theories About Jack On “This Is Us”,1,3,7,20,2,7,2,27,0
Julianne Hough Gets Honest About Dealing With Endometriosis,1,3,8,44,0,7,0,52,0
Which Award Show Host Are You,1,1,6,18,0,5,0,24,0
The Reasons Why We Can't Put Down Our Smartphones,1,2,9,31,1,8,0,40,0
"This Guy Shot An Entire Wedding On An iPhone, And It Looks Stunning",1,1,13,41,1,12,0,54,0
How Do Victoria's Secret Angels Unwind After the Show? [Video],1,3,9,40,4,9,0,49,0
Beyonce And Jay-Z Singing Along At A Britney Spears Concert Will Give You Life,1,1,15,49,1,13,0,64,0
This Guy Who Cosplays As Deadpool Every Year Is Almost As Funny As Ryan Reynolds,1,1,15,51,0,14,0,66,0
Do You Know Which Social Network Is Older,1,1,8,26,0,7,0,34,0
17 Photos That Won't Make Any Sense To Men,1,1,8,23,1,8,2,31,0
17 Times The Internet Nailed What It's Like Being A Virgo,1,1,10,34,1,10,2,44,0
29 Toys Every '90s Boy Secretly Wishes They Still Had,1,1,8,31,1,9,4,39,0
Don't carry these 5 things in your wallet,1,3,1,31,1,7,1,32,0
"Gabrielle Union And Jimmy Fallon Hilariously Parodied Popular Songs On ""The Tonight Show""",1,1,13,62,2,12,0,75,0
31 Tumblr Posts That Will Straight Up Fuck You Up,1,1,9,29,0,9,2,38,0
"Are You More Arlo Or Spot From ""The Good Dinosaur""",1,1,10,29,2,9,0,39,0
"Channing Tatum To ""Lip Sync Battle"" Jenna Dewan Tatum",1,1,9,34,2,8,0,43,0
9 Things You Should Know If You Wear A Bra,1,1,9,23,0,9,1,32,0
Do You Actually Know How Much Alcohol You're Drinking,1,1,9,35,1,8,0,44,0
Dem Rep Moulton Warns of Possible Nuclear War With Russia,1,3,9,39,0,9,0,48,0
Dads Everywhere Have Fallen In Love With Adele,1,1,8,31,0,7,0,39,0
Prince of Wales tries out a traditional dance in Romania,1,3,3,44,0,9,0,47,0
The Currys Had An Adorable Family Play Date At The Playground,1,1,11,40,0,10,0,51,0
Polish Christmas advert about grandfather who learns English touches hearts around the world,1,3,3,77,0,12,0,80,0
Taraji P. Henson Responded Perfectly When Her Golden Globes Speech Was Almost Cut Short,1,1,14,59,1,13,0,73,0
Tim Tebow's debut gives fans what they wanted: heroics,1,2,2,42,2,8,0,44,0
"In a first, woman delivers baby after transplant of her frozen childhood ovarian tissue",1,2,1,72,1,13,0,73,0
22 Breakout Movie Stars of 2016,1,2,3,17,0,5,6,20,0
This Dude Has His Tinder Profile Overhauled By Co-Workers,1,1,10,38,1,8,0,48,0
10 Books That Will Get You In The Mood On Valentine's Day,1,1,11,32,1,11,2,43,0
If Couples Honestly Updated Their Facebook,1,1,6,31,0,5,0,37,0
What Happens When Little Girls Help Men Create The Perfect Texts To Their Crushes,1,1,14,54,0,13,0,68,0
International Day of Happiness: 45 joyous things that will make you instantly happy,1,2,3,65,1,12,2,68,0
Paul Ryan: Devin Nunes Source a ‘Whistleblower Type’,1,3,7,35,3,7,0,42,0
High-risk pancreatic cancer candidates to be tested for first time in fight against deadly disease,1,3,1,82,1,14,0,83,0
Katy Perry's New Song Will Get You In The Holiday Spirit,1,1,11,34,1,10,0,45,0
IBMVoice: 3 Signs It's Time To Evolve Start-Up Thinking To Support Growth,1,3,15,43,3,11,1,58,0
23 Things Only Girls With Small Boobs Will Understand,1,1,8,35,0,8,2,43,0
"Gay Schoolteacher, Partner Accused of Sexually Abusing 8 Boys Kill Themselves",1,3,9,56,1,10,1,65,0
"Why ""Math Circus"" Is The Most Important Game Of Our Generation",1,1,11,39,2,10,0,50,0
7 hidden iPhone tricks that only power users know about,1,2,1,44,0,9,1,45,0
Two MTSU Football Players Suspended After Puppy Abuse Video Surfaces,1,3,13,46,0,9,0,59,0
*NSYNC Vs. Backstreet Boys,1,1,8,13,2,3,0,21,0
'Not This White Woman' clothing line launched for women to show they didn't vote for Donald Trump,1,2,6,72,3,16,0,78,0
Inside the restaurant staffed almost entirely by refugees,1,3,1,49,0,7,0,50,0
Aaron Tveit Walks Us Through His Career Milestones,1,1,8,35,0,7,0,43,0
"FYI, Drake Made One Really Hot Basketball Coach",1,1,10,29,1,7,0,39,0
"18 Photos That Prove The ""Harry Potter"" Actors Are Actually Their Characters",1,1,11,50,2,11,2,61,0
16-year-old devises system to save heart attack victims while on work experience ,1,3,0,65,2,12,2,65,0
27 Names You Should Never Name Your Kid Unless You Want Them To Be A Huge DB,1,3,17,41,0,16,2,58,0
An Adorable Animals Advent Calendar: December 17,1,1,6,33,1,6,2,39,0
"How Well Do You Know The First Episode Of ""Buffy""",1,1,10,28,2,9,0,38,0
12 Acapella Christmas Songs To Get You In The Mood,1,1,9,30,0,9,2,39,0
What's The Weirdest Punishment You Got As A Kid,1,1,9,29,1,8,0,38,0
I Tried Different Meditation Apps To Ease My Anxiety,1,1,9,35,0,8,0,44,0
Which TV mum are you?,1,2,3,13,1,4,0,16,0
The world's longest airline routes,1,3,1,28,1,4,0,29,0
We Know How You Should Spend Your Valentine's Day Based On Your Favourite Justin,1,1,14,52,1,13,0,66,0
19 Totally Underrated Places To Get Affordable Jewelry Online,1,1,8,43,0,8,2,51,0
The Complete Beginner's Guide To Big Data In 2017,1,2,8,28,1,8,4,36,0
"Paul Rudd Dancing In His ""Ant-Man"" Costume Is The Cutest Thing You'll See Today",1,1,15,47,4,13,0,62,0
This Video Of A Grandpa Singing To His 93-Year-Old Dying Wife Will Give You All The Feels,1,1,18,51,2,16,2,69,0
P.K. Subban crashed a street hockey game -- and made this young fan's day,1,3,3,52,5,13,0,55,0
What Should You Be When You Grow Up,1,1,8,20,0,7,0,28,0
24 Women On What Being Plus Size Means,1,1,7,22,0,7,2,29,0
Pigskin A Blanket: NFL Week 4 Picks,1,1,8,19,1,6,1,27,0
Quick And Easy Vegan Mac & Cheese,1,1,6,20,1,6,0,26,0
What you need to know about NATO as Trump meets with its secretary general ,1,2,6,55,0,14,0,61,0
21 Savage Kourtney Kardashian Burns We Still Haven’t Recovered From,1,2,9,46,1,9,2,55,0
"18 Face-Swaps That Will Make You Say “Not Today, Satan”",1,2,10,30,4,9,2,40,0
13 Things You Can Bulk-Buy On Amazon To Make You Feel Like An Adult,1,3,14,37,1,13,2,51,0
Italy sex case dropped because woman 'did not scream',1,2,1,42,2,8,0,43,0
50 Cent Talks Kanye West Hospitalization: 'You Could See That Coming',1,2,10,44,3,10,2,54,0
Is 2016 the Best Year for Animation Ever? [Video],1,2,6,28,3,8,4,34,0
Trump Slashing of Obama Regulations Will Save $10 Billion Over Next 20 Years,1,3,10,49,1,12,4,59,0
New O’Keefe Video: Leftists Planning Stink Bombs at ‘Deploraball’,1,3,9,44,4,8,0,53,0
A Mall Santa Did Everything He Could To Make An Autistic Child Feel Comfortable,1,1,14,52,0,13,0,66,0
America's airlines are shameless. But United has just set a new low,1,3,3,51,2,11,0,54,0
"What the Freedom Caucus wants in the GOP health-care bill, and why it’s not getting it",1,2,6,62,3,15,0,68,0
The One Thing You Probably Didn't Notice About Gaga At The Golden Globes,1,1,13,46,1,12,0,59,0
10 Times Martha Stewart Was Exactly As Campy As She Wanted To Be,1,1,12,38,0,12,2,50,0
Here's Why Drake Is Calling 'More Life' A Playlist And Not An Album,1,3,13,39,3,12,0,52,0
"Drop Everything, Emo Kids, Because Jack's Mannequin Is Reuniting",1,1,9,44,3,8,0,53,0
UK child with rare condition launches appeal for funds to pay for life-saving operation,1,3,2,71,1,13,0,73,0
Management Advice From Google's Eric Schmidt How Google Works - Business Insider,1,3,11,56,2,11,0,67,0
Why Twitter Is Vital and Struggling at Same Time: QuickTake Q&A,1,3,11,40,2,10,0,51,0
Are You More Black Widow Or Scarlet Witch,1,1,8,26,0,7,0,34,0
18 Weird-Ass Sex Toys That Might Actually Be Genius,1,2,9,31,1,8,2,40,0
If '90s Toys Were Honest,1,1,4,13,1,4,2,17,0
A Disney Cover Band Got People To Kiss In New York City By Singing,1,1,14,39,0,13,0,53,0
Ryan Gosling whispered in this woman's ear at the Oscars and we need to know what he said! The list,1,3,4,74,2,19,0,78,0
What's Ahead For Luxury Travel In 2017?,1,2,6,21,2,6,4,27,0
25 Best Jobs That Pay More Than $100K,1,3,7,17,1,7,5,24,0
22 Things You Need To Know About Emetophobia,1,1,7,28,0,7,2,35,0
2 Charts That Debunk The Bullish Case For Stocks,1,3,8,31,0,8,1,39,0
12 Photos Of People Who Have Won Millions Playing Powerball,1,1,9,39,0,9,2,48,0
Dollar Regains Reflation Mojo as Hedge Fund Bets Get Flushed Out,1,3,10,44,0,10,0,54,0
Should we be allowed to use superannuation on house deposits?,1,3,1,50,1,9,0,51,0
Club Mate Is The Hipster Energy Drink You Need To Try,1,1,11,32,0,10,0,43,0
"Madonna's Carpool Karaoke is here and, well, you just need to see it for yourself",1,2,3,61,3,14,0,64,0
17 Bitchy Texts Your Contact Lenses Would Send You,1,1,8,32,0,8,2,40,0
Baseball hall-of-famer's heart transplant beats with inspiration,1,3,1,54,3,6,0,55,0
"Non-Bailable Warrant Issued Against Mamta Kulkarni In Rs 2,000 Crore Drugs Case",1,3,12,50,2,11,4,62,0
Why I Went To A Black College,1,1,7,16,0,6,0,23,0
Trumpocrat David ‘Mudcat’ Saunders: Charges of Racism and White Nationalism Against Steve Bannon Are ‘Insane’,1,3,13,77,5,14,0,90,0
"25 Things That Totally, Definitely, 100% Absolutely Happened",1,1,6,39,3,7,5,45,0
Doctors Reveal Stent Makers Are Striking Secret Hospital Deals To Sell At Inflated Prices,1,3,14,62,0,13,0,76,0
The Truth Behind Media’s New Favorite Euphemism: ‘Muslim-Majority Countries’,1,2,10,53,5,8,0,63,0
NFL Free Agency: Predicting the Biggest Busts of 2017 Signings,1,3,9,39,1,9,4,48,0
'Shots Fired' is the most vital show on TV right now,1,2,4,36,2,10,0,40,0
Page Not Found - Yahoo,1,3,4,13,1,4,0,17,0
For Everyone Who Is Slightly Obsessed With Texas Roadhouse Bread,1,1,10,45,0,9,0,55,0
Don’t Call It a ‘Tesla Killer’ — But the Lucid Electric Car Might Be Exactly That,1,3,13,49,4,15,0,62,0
"If You Thought Your Hotel Safe Was Secure, Think Again",1,1,10,34,1,9,0,44,0
Syrian photographer who rescued child from Aleppo bus bombing speaks out,1,3,2,60,0,10,0,62,0
Dog valiantly trying to catch a toy gets the Photoshop battle he deserves,1,3,2,59,0,12,0,61,0
16 Of The Most Important Dog Vines Of 2015,1,1,7,21,0,8,6,28,0
"33 Important Things We Learned From ""Ab Fab""",1,1,7,26,2,7,2,33,0
You Need To Take The New Pottermore Sorting Quiz Immediately,1,1,10,41,0,9,0,51,0
"26 Hilarious ""Elf"" Quotes That'll Make You Laugh Every Time",1,1,9,36,3,9,2,45,0
Why is Harvard putting puritans in the stocks?,1,3,2,36,1,7,0,38,0
9 Little Things All Long-Term Couples Do,1,3,7,25,1,6,1,32,0
22 Things Only Cat Owners Understand About Cats,1,1,7,31,0,7,2,38,0
18 Easy Ways to Become a Morning Runner Without Even Trying,1,1,8,39,0,10,2,47,0
Proof That National Treasure Shia LaBeouf Transcended In 2015,1,1,9,40,0,8,4,49,0
16 Truths For People Who Assign Personalities To Numbers And Letters,1,1,10,46,0,10,2,56,0
19 Things That Are Too Real When Your Mom Is A Teacher,1,1,11,30,0,11,2,41,0
15 Rad Lunch Boxes Every '90s Girl Begged For,1,1,7,25,1,8,4,32,0
16 Cats Who Don't Care If You Like Them,1,1,8,20,1,8,2,28,0
Sweet 16 Big Board: Ranking the tourney's best draft prospects,1,2,4,45,2,9,2,49,0
Australian Police Arrests Man On Charges Of Helping ISIS Develop Missile Technology,1,3,15,57,0,11,0,72,0
A Mom Shared The Annoying Things Said About Her Daughter With Down Syndrome And Other Moms Joined In,1,3,18,65,0,17,0,83,0
Pelosi: Trump’s Executive Order on Power Plants Is ‘Sinful’,1,2,8,39,4,8,0,47,0
Where The Hell Is The Redhead Emoji,1,1,7,22,0,6,0,29,0
When My Pet Died,1,1,4,9,0,3,0,13,0
If Introverts Posted Honest Captions On Their Instagrams,1,1,8,41,0,7,0,49,0
A YouTube Chef Makes the M&M-Covered Spaghetti Breakfast From 'Elf',1,2,12,42,4,9,0,54,0
Tell Us About A Time You Really Fucked Up,1,1,9,24,0,8,0,33,0
School bans pupils from spending too much time in the toilets as police called to rowdy protest,1,3,1,78,0,16,0,79,0
"Ancient Chaco society passed on power through elite women, new DNA evidence finds",1,2,5,63,1,12,0,68,0
"When I heard warplanes, I never thought our hospital was the target",1,3,3,52,1,11,0,55,0
"Here's How To Start Running, Stick With It, And Not Totally Hate It",1,1,13,39,3,12,0,52,0
Which Person Should Write You A Haiku For Valentine's Day,1,1,10,37,1,9,0,47,0
I Had A Dance-Off With Meghan Trainor And Taught Her About Man Buns,1,1,14,40,1,12,0,54,0
Donald Trump Has Found Something Mysterious For Rudy Giuliani To Do,1,3,11,46,0,10,0,57,0
9 Scapegoats Progressives Blame for Hillary Clinton’s Stunning Loss,1,3,7,50,1,8,1,57,0
What you'll see happen at the Final Four before it happens,1,3,3,44,1,10,0,47,0
21 Things You Should Actually Do If You Win The Lottery,1,1,10,33,0,10,2,43,0
"Do You Know The Lyrics To ""Bullfrog In Love"" From ""The Office""",1,1,12,35,4,11,0,47,0
Ring The 'Ol Cheating Alarm: Calvin Harris Was Spotted Leaving A Grocery Store,1,1,13,51,2,12,0,64,0
Strangers Gave This Dying Groom His Dream Wedding,1,1,8,34,0,7,0,42,0
Is This A Fucking Christmas Movie Or Not?,1,2,8,25,1,7,0,33,0
7 hidden iPhone tricks that only power users know about,1,3,1,44,0,9,1,45,0
Undercover Journo Report: Migrant Centres ‘Breeding Ground for Terrorists’,1,2,8,55,3,8,0,63,0
Supreme Court nominee Neil Gorsuch was just tripped up by a horse-sized duck,1,3,4,59,1,12,0,63,0
67 Jay Z Lyrics For When You Need An Instagram Caption,1,1,10,32,0,10,2,42,0
15 Problems People Who Are Tired All The Time Know All Too Well,1,1,12,37,0,12,2,49,0
Transgender Star Eligible for Male and Female Oscar Categories,1,3,7,47,0,8,0,54,0
What I’m really thinking: the gay Christian,1,2,3,32,2,6,0,35,0
This Tattoo Artist Retouched His Wife's Tattoo Of Their Trans Son To Reflect His True Identity,1,1,16,62,1,15,0,78,0
"Kendall Jenner Told Kim Kardashian She's ""Pregnant,"" And Kim Gave No Fucks",1,1,12,47,4,11,0,59,0
19 Reasons Brazil Is Still The World's Favourite Team,1,1,8,34,1,8,2,42,0
"Earth's Skies Are Violet, We Just See Them As Blue",1,3,10,29,2,9,0,39,0
Signs It’s Time For a Career Change | Ashford University,1,3,8,37,2,9,0,45,0
The 3 plays in sports everybody will be talking about today,1,3,1,47,0,10,1,48,0
Sarah Michelle Gellar Is Ready To Fight Her Next Battle,1,1,10,36,0,9,0,46,0
"Against All Odds, One Match Was All He Needed ",1,3,9,27,1,9,0,36,0
Here's The Selena Gomez-Justin Bieber Mashup You've Been Waiting For,1,1,11,45,3,9,0,56,0
How Celebrities Spent New Year’s Eve,1,3,6,24,1,5,0,30,0
15 Ways We Can All Relate To Squidward Tentacles In The Winter,1,1,11,38,0,11,2,49,0
44 Perfect Songs To Listen To While You Write,1,1,8,27,0,8,2,35,0
Which Very Nervous Baseball Fan Are You,1,1,7,26,0,6,0,33,0
How The Hole In My Heart Almost Killed Me,1,1,9,24,0,8,0,33,0
22 Tweets About Procrastination That Will Make You Laugh Out Loud,1,1,10,43,0,10,2,53,0
Eric Holder’s Airbnb Runs Controversial #WeAccept Multiculturalism Ad,1,3,9,51,2,7,0,60,0
"This Is The Story Of How I Saw James Franco Get A Live ""Circumcision"" At His Bar Mitzvah",1,1,18,51,2,17,0,69,0
"Tom Hanks And Jimmy Fallon Act Out ""Bridge Of Spies"" In Its Truest Form",1,1,14,42,2,13,0,56,0
"Demi Lovato Revealed That Disney Asked Her To ""Fix"" Her Gap Teeth Before Filming ""Camp Rock""",1,1,16,57,4,15,0,73,0
PolitiFact Pulls 2014 ‘Mostly True’ Rating of John Kerry’s Claim of Eliminating Syrian Chemical Weapons,1,3,13,69,3,14,4,82,0
Man wires up smart home for a more comfy life,1,3,1,35,0,9,0,36,0
"This TBT Of Taylor Swift Will Make You Go ""Awww""",1,1,12,25,2,9,0,37,0
Which Super Bowl Halftime Show GIF Are You Based On Your Birth Month,1,1,15,41,0,12,0,56,0
15 Bumper Stickers All Twentysomethings Need,1,1,5,32,0,5,2,37,0
WAR ON SPEECH: Chicago Review Of Books Boycotts Simon & Schuster Over MILO Deal,1,3,24,40,2,13,0,64,0
"What ""Friends"" Quote Should Be Your Life Motto",1,1,8,29,2,7,0,37,0
"20 Outfits From ""Mean Girls"" That No One Would Ever Wear Now",1,1,11,34,2,11,2,45,0
This Couple With Down Syndrome Threw The Most Magical Wedding,1,2,10,42,0,9,0,52,0
"How Well Do You Know The Lyrics To ""I Can't Feel My Face"" By The Weeknd",1,1,16,37,3,15,0,53,0
Are You More Regina George Or Lord Voldemort,1,1,8,29,0,7,0,37,0
Can You Name All Of These Dog Breeds?,1,2,8,21,1,7,0,29,0
How Russia and Turkey brokered peace in Syria -- and sidelined the US,1,3,6,49,2,12,0,55,0
"Anti-ageing breakthrough: Reprogramming the body could extend lifespan, say scientists",1,2,2,72,3,9,0,74,0
Which Lady Gaga Outfit Are You Based On Your Birth Month,1,1,11,35,0,10,0,46,0
America Will Very Soon See 'A Day Without A Woman'. Organisers Of Women's March To Hold Strike,1,2,17,57,4,16,0,74,0
How a President Can Use Orders and Memos and Who Can Stop Them - Yahoo,1,3,11,44,1,14,0,55,0
"Here's what it's like to interview for the CIA, from people who have done it",1,2,4,55,3,14,0,59,0
16 Pets Who Just Want To Bring A Lil' Sunshine Into Your Life,1,1,12,34,1,12,2,46,0
31 Really Valid Questions I Have For Nursery Rhymes,1,1,8,33,0,8,2,41,0
Which Classic Car Should You Be Driving,1,1,7,26,0,6,0,33,0
Iraq Just Held Its First Beauty Pageant In More Than 40 Years,1,1,11,37,0,11,2,48,0
Here Are 18 Facts We Didn’t Know At The Start Of February,1,2,11,32,1,11,2,43,0
17 Things Girls Love To Do With Their Boobs,1,1,8,25,0,8,2,33,0
What Will Your Next Boyfriend Be Like,1,1,7,24,0,6,0,31,0
We Know Your McDonald's Order Based On Your Birth Month,1,1,11,34,1,9,0,45,0
Kasich: Completely Getting Rid of Obamacare ‘Not Acceptable’,1,3,7,43,3,7,0,50,0
"Man proves, once again, that kindness can be a calling",1,3,1,42,2,9,0,43,0
19 Intimate Confessions From Couples Who Feel Pressure To Get Married,1,1,10,47,0,10,2,57,0
21 Babies Who Look Remarkably Like Other People,1,1,7,31,0,7,2,38,0
Black mother tells Texas police her 7-year-old was assaulted and they arrest her instead,1,3,2,70,2,13,1,72,0
19 People Who Are Already Having A Shitty 2017,1,2,7,25,0,8,6,32,0
What Are Your Best Tips For Keeping The Weight Off,1,1,10,31,0,9,0,41,0
Meet The 195 Billionaire Newcomers Of 2017,1,3,5,24,0,6,7,29,0
Evan Rachel Wood Just Made The Most Amazing Comments About Bisexuality,1,1,11,49,0,10,0,60,0
Can You Guess The Celeb From The Pixelated Image,1,1,9,31,0,8,0,40,0
"25 Photos That Will Make All Makeup Addicts Say ""Oh God, Yes!""",1,1,11,34,4,11,2,45,0
A record number of poor kids are eating breakfast — thanks to a program many conservatives hate,1,3,1,77,1,16,0,78,0
Canadians: Can You Get Through This Post Without Being Viscerally Enraged,1,1,11,51,1,10,0,62,0
Confessions of a disappointing dad - the five things I regret the most,1,3,2,55,1,12,0,57,0
Pogue’s Basics: Money - The light-switch myth demolished,1,3,4,41,4,7,0,45,0
We Asked A Food Stylist To Review Cheap Burgers,1,1,9,30,0,8,0,39,0
Is this mysterious rumbling coming from Metro? Listen for yourself,1,3,3,53,1,9,0,56,0
The Funniest Tweets From Parents This Week,1,3,7,29,0,6,0,36,0
This Guy Made A Root Beer Float From Scratch And It Cost Him $900,1,1,13,35,1,13,3,48,0
12 Secrets Plus-Size Models Want You To Know,1,1,8,26,1,7,2,34,0
Adele Said A Mic Dropped In The Piano And That's Why Her Grammy Performance Was Off,1,1,16,51,1,15,0,67,0
This French Braid Bun Is So Damn Pretty It Hurts,1,1,10,29,0,9,0,39,0
How Many Cats Can You Find Hiding In This Photo,1,1,10,28,0,9,0,38,0
17 Delectable No-Bake Desserts That'll Change Your Life,1,1,8,36,2,7,2,44,0
10 Scrumptious Gluten-Free Treats That Don't Feel Like A Compromise,1,1,10,44,2,9,2,54,0
"This week in apps: Instagram hits 700 million, Apple's new music deal, and more",1,3,3,56,4,13,3,59,0
6 Easy Ways To Shorten Your Resume And Make It Stand Out,1,3,11,33,0,11,1,44,0
"High heels row: government response 'a cop-out', says worker",1,3,1,46,5,8,0,47,0
The Trader Joe's Frozen Food Section Is Basically Lazy Paradise,1,1,10,43,1,9,0,53,0
'Game of Thrones' Season 5 Finale Predictions,1,3,5,31,2,6,1,36,0
My Weekend at Mar-a-Lago: Reporter’s Notebook ,1,3,6,30,4,6,0,36,0
19 Things Everyone Who Loves Harry Potter And Booze Needs To Own,1,1,11,40,0,11,2,51,0
Jonathan Cheban Is Kind Of A Dick On Social Media,1,1,10,30,0,9,0,40,0
A quarterback prospect who started 13 games in college has suddenly become the key to the NFL Draft,1,2,5,75,0,17,2,80,0
7 Conservative Classics Every American Should Read,1,3,6,37,0,6,1,43,0
A plan to make America 1953 again,1,2,2,21,0,6,4,23,0
A Star Goldman Trader Goes Cold,1,3,6,20,0,5,0,26,0
"This Woman Just Wrote The Feminist Version Of ""Hotline Bling""",1,1,10,40,2,9,0,50,0
‘House of Cards’ Creator’s New ‘Script’: Flood Trump DC Hotel With Phone Calls,1,3,13,47,6,12,0,60,0
Which Halsey Song Should You Have Sex To Tonight,1,1,9,31,0,8,0,40,0
"Which ""The Secret Circle"" Character Are You",1,1,7,28,2,6,0,35,0
One California high school just made millions from Snap's IPO,1,3,6,45,1,9,0,51,0
21 Mouthwatering Breakfast Casseroles That'll Change Your Life,1,1,7,45,1,7,2,52,0
"Jennifer Lawrence Texted Amy Schumer That She Looked ""Pretty But Not Smart"" At The Emmys",1,1,15,57,2,14,0,72,0
Which Kardashian-Jenner Girl Are You,1,1,6,25,1,4,0,31,0
There's finally something awesome to do with Google Glass,1,3,3,45,1,8,0,48,0
We Had Women Photoshopped Into Stereotypical Comic Book Poses And It Got Weird,1,1,13,53,0,12,0,66,0
17 Memes To Send To Your Trash Ex,1,3,7,17,0,7,2,24,0
"Happy 10th Birthday, iPhone! What’s Next?",1,2,5,25,4,5,2,30,0
"At BlackRock, Machines Are Rising Over Managers to Pick Stocks ",1,3,10,42,1,10,0,52,0
"How Well Do You Know The Lyrics To ""It Wasn't Me"" By Shaggy",1,1,13,31,3,12,0,44,0
Man learns why you shouldn't try to take a selfie with a sea lion,1,2,1,50,1,13,0,51,0
Be Honest: Would You Hit That,1,1,6,17,1,5,0,23,0
31 Halloween Costumes That Require Absolutely No Skill,1,1,7,38,0,7,2,45,0
These Five Sisters Did A Photo Shoot To Thank Their Parents For Paying For All Of Their Weddings,1,1,18,61,0,17,0,79,0
What Makes Us: 'Syd' - ESPN Video,1,2,9,14,4,6,0,23,0
37 Things The Kardashians Have 100% Actually Said,1,1,6,30,1,7,5,36,0
Vote: Which teams deserved spots in the CFP?,1,3,5,30,2,7,0,35,0
Whatever Is Happening With Anne Hathaway Here Is Very Good,1,1,10,39,0,9,0,49,0
"A Guy Is Selling ""Authentic"" Fall Leaves, And People Are Actually Buying Them",1,1,13,49,3,12,0,62,0
EU Court Allows Ban On Headscarves And Other 'Religious Symbols' At Workplaces,1,2,13,52,2,11,0,65,0
"After the US, far right says 2017 will be the year Europe wakes up",1,3,4,44,1,13,4,48,0
We Need To Talk About How Incredibly Amazing Jennifer Lopez Looks In 2016,1,1,12,45,0,12,4,57,0
Report: Only 2.65 Percent of Immigrants into Italy Are Refugees,1,3,7,42,2,9,3,49,0
8 New Types Of Goth That Are Better Than Health Goth,1,1,10,31,0,10,1,41,0
14 People Who You Totally Have Saved In Your Phone,1,1,9,30,0,9,2,39,0
28 Things Literally Everyone Does Without Realizing It,1,1,7,38,0,7,2,45,0
"An Adorable Girl Has Become ""Spider-Mable"" To Fight Crime In Edmonton",1,1,12,44,3,10,0,56,0
Sweden's badass bikini police officer has just quit her job The list,1,3,2,54,1,11,0,56,0
"Which Character From ""The Suite Life Of Zack And Cody"" Are You",1,1,12,37,2,11,0,49,0
Kentucky ranked worst state for animal safety for 10th consecutive year,1,2,1,58,0,10,2,59,0
7 Incredible Things We Learned About Jennifer Lawrence From Her Glamour Magazine Interview,1,1,12,65,0,12,1,77,0
Shia LaBeouf Anti-Trump Art Project Shut Down for Fourth Time After Move to UK,1,3,15,49,1,13,0,64,0
What Trump could learn from George Washington’s first executive order,1,3,4,55,1,9,0,59,0
Eight Creative People Recommend Their Favorite Classic Books ,1,3,8,45,0,8,0,53,0
Acupuncture Can Effectively Treat Chronic Pain And Depression And That's A Good News For Many,1,3,15,63,1,14,0,78,0
The best photos from the NCAA Tournament so far,1,2,6,33,0,8,0,39,0
15 Foolproof DIYs You'll Want To Try In 2016,1,1,9,20,1,8,6,29,0
Would You Be Friends With Blair Or Serena,1,1,8,26,0,7,0,34,0
Notre Dame Students Complain After Mike Pence Announced as Commencement Speaker,1,2,10,59,0,10,0,69,0
18 Random Good Deeds That Will Restore Your Faith In Humanity,1,1,10,39,0,10,2,49,0
"Watch Sourav Ganguly Play Gully Cricket On Streets Of Kolkata, That Too Right-Handed!",1,2,14,56,3,12,0,70,0
"Morgan StanleyVoice: In 2017, Software Eats The World",1,3,8,32,2,7,4,40,0
"New on Netflix May 2017: House of Cards, Master of None, F Is for Family returning in streaming service's best month yet",1,3,10,81,4,21,4,91,0
21 Times Larry David Spoke For Everyone Who Hates People,1,1,9,36,0,9,2,45,0
What Women Really Think of Men ,1,3,5,20,0,6,0,25,0
Trevor Noah: One thing Donald Trump is honest about is his lies,1,2,5,46,1,11,0,51,0
No one wants to think about losing a parent. But not planning for it makes it worse.,1,3,2,64,2,16,0,66,0
"Did The New ""Star Wars"" TV Spot Give Away A Secret About Han Solo",1,1,15,35,2,13,0,50,0
"A 10-Year-Old Wrote A Letter Encouraging The Troops To Kill ""Those ISIS Fucks""",1,1,17,43,4,12,2,60,0
It’s Official! Donald Trump Speaking at CPAC,1,2,9,27,2,6,0,36,0
Transgender-Cisgender Couples Talk About Their Relationships,1,1,7,47,1,5,0,54,0
23 Things To Do To Improve Your Mental Health In 2016,1,1,9,28,0,10,6,37,0
25 Tumblr Posts That Will Make Socially Awkward People Cringe,1,1,9,41,0,9,2,50,0
"These Hilarious ""Harry Potter"" Comics Ask James And Lily Potter Questions",1,1,11,50,2,10,0,61,0
Delia Smith’s recipe for creme caramel – what could go wrong?,1,2,2,46,3,10,0,48,0
Eman Lost 120 Kilos After Surgery But She Is Suffering From Failure In Heart And Frequent Epileptic Fits,1,2,17,67,0,17,3,84,0
Here's How To Save Money During The 2016 Clean Eating Challenge,1,1,10,38,1,10,4,48,0
Federal Judge Who Blocked Trump Travel Ban Will Rule on Plaintiffs Request to Double Number of Refugees in FY 2017,1,3,16,75,0,19,4,91,0
Cop In Madhya Pradesh Gets Thrashed Brutally For Issuing A Fine To A BJP Leader's Relatives,1,2,18,57,1,15,0,75,0
These Two Dogs Are The Real Life Elsa And Anna,1,1,10,27,0,9,0,37,0
Career Advice From HBO's 'Big Little Lies',1,3,9,24,3,6,0,33,0
Nicki Minaj 'baby bump photo' sends singer's fans into a frenzy,1,3,2,48,3,10,0,50,0
"How Well Do You Actually Remember ""The Lizzie McGuire Movie""",1,1,11,38,2,9,0,49,0
9 Tips For Dealing With Depression And Anxiety At University,1,1,9,41,0,9,1,50,0
35 Memes You Should Send To Your Childhood BFF Right Now,1,3,12,32,0,10,2,44,0
19 Signs You're The Mum Of Your House,1,1,7,20,1,7,2,27,0
The world's biggest industrial companies can't stop talking about 'going digital',1,3,1,66,4,10,0,67,0
Mulder And Scully Might Be Kissing In The First 'X-Files' Set Photos,1,2,13,41,3,11,0,54,0
8 Indian Women Who Made Headlines In 2015 For Calling Off Their Weddings,1,1,11,44,0,12,5,55,0
Brexit: British Government Loses Court Fight — What’s Next?,1,2,8,39,4,8,0,47,0
24 Pictures That Perfectly Prove You Don't Have It So Bad,1,1,10,34,1,10,2,44,0
26 Sex Toys That Actually Get The Job Done,1,2,8,24,0,8,2,32,0
"Syria, Gorsuch, United Airlines: Your Monday Evening Briefing ",1,3,8,43,3,8,0,51,0
Watch: Adam ‘Pacman’ Jones Kicks Reporter Asking About His Arrest Out of Interview,1,3,12,55,3,12,0,67,0
24 Pop Songs You Couldn't Help But Sing Along To In 2007,1,1,10,28,1,11,6,38,0
Can You Actually Name These 12 Classic Cocktails,1,1,7,32,0,7,2,39,0
Women May Soon Lose The Ability To Get An Abortion Via Webcam,1,2,12,38,0,11,0,50,0
23 Women In Television You Need To Be Watching,1,1,8,28,0,8,2,36,0
He found a sick bear cub and faced a choice — let it die or risk his life to save it.,1,3,1,62,2,20,0,63,0
19 Ways To Not Look Like A Giant-Ass Sleeping Bag This Winter,1,1,12,35,1,11,2,47,0
13 Of The Most Random Christmas Rap Songs Ever,1,1,8,28,0,8,2,36,0
27 Kids Who Totally Nailed This Halloween Thing,1,1,7,31,0,7,2,38,0
This Old Fight Between Geeta Phogat And Sakshi Malik Will Give You The Feel Of Dangal,1,3,16,54,0,15,0,70,0
Bow Wow Had No Clue How To Kill Time During The Grammys And It Was Hilarious,1,1,16,45,0,15,0,61,0
Ra-ra-ah-ah-ah: The 7 Best Lady Gaga Songs for Karaoke,1,2,7,33,5,8,1,40,0
The 15 Best Accidental Butts Of 2015,1,1,5,19,0,6,6,24,0
"This Cat Spent 17 Years As A ""Rodent Control Officer"" Aboard A Famous Ship",1,1,13,44,2,13,2,57,0
Your best photographs on the theme of empowerment,1,2,1,41,0,7,0,42,0
17 Inexplicably Delightful GIFs,1,1,5,21,0,3,2,26,0
"Kelly Ripa Thanking You For Watching Her On ""Live"" Will Bring You To Tears",1,1,14,45,2,13,0,59,0
"59 Times Celebrities Made You Go ""WTF"" In 2015",1,1,9,21,2,8,6,30,0
Free-range eggs crisis prevented as Government finally agrees farmers can let chickens outside ,1,3,2,79,1,13,0,81,0
Giant whale shark caught on camera by US divers,1,3,3,36,0,8,0,39,0
22 Hilarious Tweets That Prove Grindr Was At Its Worst In 2015,1,1,10,35,0,11,6,45,0
Injectable Fillers Reportedly Left Woman Blind in One Eye With Disfigured Face,1,3,11,56,0,11,0,67,0
What Do I Owe Again? 6 Tips For College Seniors Facing Down Student Loan Debt,1,3,14,47,1,14,1,61,0
We Talked To People Who Are Preparing For The End Of The World,1,1,13,37,0,12,0,50,0
9 surprising ways meditation changes your brain,1,3,0,40,0,6,1,40,0
A Court Keeps People Out of Rikers While Remaining Tough ,1,2,9,38,0,10,0,47,0
NHL star recalls double life under fugitive dad ,1,3,3,37,0,8,0,40,0
"Dear Australia, We Need To Talk About Macca's",1,1,8,28,2,7,0,36,0
Samantha Bee Mocks Brain Cancer Patient at CPAC For Having ‘Nazi Hair’,1,3,14,43,2,11,0,57,0
17 Insanely Creative Cupcakes That Are Guaranteed To Win Halloween,1,1,9,46,0,9,2,55,0
16 Times Tumblr Made You Think Too Hard,1,1,7,23,0,7,2,30,0
Can You Identify The Elements From Their Periodic Symbols,1,1,9,40,0,8,0,49,0
Which Pretty Little Liar Are You Based On Your Style,1,1,10,33,0,9,0,43,0
These heartbreaking images reveal the dreams of refugees,1,2,1,48,0,7,0,49,0
23 Absolute Nightmares All Makeup Lovers Have Experienced At Some Point,1,1,10,49,0,10,2,59,0
Attorney General Lynch to Incoming Trump Administration: Facts Are Helpful,1,2,9,55,1,9,0,64,0
Can We Guess Your Favorite Hobby Based On Random Questions,1,1,10,39,0,9,0,49,0
Psychology Explains Why You're Always Late,1,3,6,30,1,5,0,36,0
What Karaoke Song Should You Sing Based On Your Zodiac Sign,1,1,11,38,0,10,0,49,0
20-Minute Chicken Recipes To Add Your Arsenal,1,1,7,29,1,6,2,36,0
11 Cookie Lyon Greeting Cards For Every Occasion,1,1,7,32,0,7,2,39,0
Here's What The Oscar Nominations Should Look Like,1,3,8,34,1,7,0,42,0
Grads of LifeVoice: How To Address The Workforce Diversity Gap,1,3,10,42,1,9,0,52,0
MILO: ‘America Has a Problem With Fake Hate Crimes’,1,3,11,29,3,8,0,40,0
This Woman Had The Best Response When Her Tinder Date Asked For His $5 Back,1,1,14,45,1,14,1,59,0
Everyone Is Talking About This Genius Couch From The Netherlands,1,1,10,45,0,9,0,55,0
10 things in tech you need to know today,1,3,0,30,0,8,2,30,0
Virgil: The Beltway Assures Us the Deep State Doesn’t Exist,1,3,9,39,2,9,0,48,0
"Knotts Berry Farm ride traps 21 people 100 feet in the air, officials say",1,3,3,51,1,13,5,54,0
"If Sunday Is For Church, This Group Wants Saturdays For Activism",1,2,11,42,1,10,0,53,0
How to Use Instagram to Lose Weight and Get Healthier (Really!),1,3,8,42,3,10,0,50,0
"Are You More Harry Or Marv From ""Home Alone?""",1,1,9,25,3,8,0,34,0
10 Delicious Recipes That Are Made With Coconut Milk,1,1,8,34,0,8,2,42,0
Pakistan honour killings continue despite tough new laws,1,3,1,48,0,7,0,49,0
What Was The Best Thing That Happened To You In 2015,1,1,10,28,0,10,4,38,0
Which Random Hogwarts Student Are You Based On Your Zodiac Sign,1,1,11,42,0,10,0,53,0
"In One Facebook Post, Three Misleading Statements by President Trump About His Immigration Order ",1,3,13,69,1,14,0,82,0
13 Secrets About The Muppets You Probably Don’t Know,1,3,8,33,1,8,2,41,0
Pigskin A Blanket: NFL Week 5 Picks,1,1,8,19,1,6,1,27,0
How Well Do You Know Earth From Space,1,1,8,22,0,7,0,30,0
"NBA - Redrafting 2009, would Blake Griffin go No. 1 or Stephen Curry, James Harden?",1,2,11,48,5,14,5,59,0
"17 Tweets For Anyone Who Loves Jughead And Kinda Hates Archie On ""Riverdale""",1,3,12,48,2,12,2,60,0
Chrissy Teigen decided to protest Casey Affleck’s Oscar in a perfect way The list,1,3,6,61,1,13,0,67,0
This Is Actually Why Your Hands And Feet Are Always Cold,1,1,11,35,0,10,0,46,0
A map of the world's happiest countries The list,1,2,2,37,1,8,0,39,0
Thieves Kept Stealing And Then Crashing This Poor Canadian Guy's Truck,1,1,11,48,1,10,0,59,0
Watchdog Group’s Trump Suit Hinges on Risky Legal Argument,1,2,8,41,1,8,0,49,0
Mum warns parents after baby suffers severe reaction to Nurofen,1,3,2,52,0,9,0,54,0
Trump’s Phone Call With Taiwan President Sparks China Complaint,1,3,9,45,1,8,0,54,0
New Office Sensors Know When You Leave Your Desk,1,3,9,31,0,8,0,40,0
17 Times The Internet Perfectly Summed Up Being A Gemini,1,1,9,36,0,9,2,45,0
The 17 Best Things Matt Bellassai Whined About In 2015,1,1,8,31,0,9,6,39,0
The 5 largest airports in the world,1,3,1,27,0,6,1,28,0
These 2 hidden iPhone features will change the way you get your texts,1,3,2,54,0,12,1,56,0
Leonardo DiCaprio Is Turning A YA Novel That Addresses Climate Change Into A Movie,1,1,16,53,0,13,0,69,0
26 Quotes About Parenthood That Are Painfully True,1,1,7,34,0,7,2,41,0
"22 Reasons Why ""Clue"" Is Your Favorite Movie",1,1,7,26,2,7,2,33,0
This Family Photo Has Everybody On The Internet Freaking Out,1,1,10,41,0,9,0,51,0
EU Court Allows Ban On Headscarves And Other 'Religious Symbols' At Workplaces,1,3,13,52,2,11,0,65,0
Player Protests Have Put The NFL In A No-Win Situation,1,3,13,31,1,9,0,44,0
"Maxine Waters: If We Impeach Trump, He Can’t Build The Wall",1,3,11,35,3,10,0,46,0
"35 Questions We Want The ""Gilmore Girls"" Revival To Answer",1,1,9,36,2,9,2,45,0
Can You Match These Eyebrows To Their Celebrity Owners,1,1,9,37,0,8,0,46,0
17 Words You've Been Pronouncing Wrong For Years,1,1,7,31,1,7,2,38,0
"Seth Rogen, Joseph Gordon-Levitt, And Anthony Mackie Play An Epic Game Of ""Never Have I Ever""",1,1,17,56,5,15,0,73,0
16 Weird Things We Will Have To Say To Our Grandkids,1,1,10,30,0,10,2,40,0
Which Halsey Song Are You,1,1,5,16,0,4,0,21,0
Why The Pay Gap Widens As Women Get Older,1,3,9,24,0,8,0,33,0
This Incredible Canadian Instagram Account Will Literally Kill You,1,1,9,49,0,8,0,58,0
Here's What 100 Years Of East African Beauty Looks Like In Just Over A Minute,1,1,14,45,1,14,3,59,0
How Well Do You Remember Ross's List Of Reasons Not To Date Rachel,1,1,13,40,1,12,0,53,0
Newsweek Interviews Far-Left ‘Community Organizers’ Involved in Berkeley Riot,1,3,9,57,3,8,0,66,0
"Bieber, Sheeran, Beyoncé And More: These 7 Albums Sent Every Song Onto The Hot 100",1,3,13,48,3,14,4,61,0
"I Tweeted That Ariana And Frankie Grande Were ""The New Michael And Janet"" And People Freaked The Fuck Out",1,1,19,66,2,18,0,85,0
STOCKS DROP: Here's what you need to know,1,3,11,21,2,7,0,32,0
26 People Who Should Not Be Left Alone,1,1,7,22,0,7,2,29,0
The Definitive Housing Market And Interest Rate Forecast For 2017,1,3,9,43,0,9,4,52,0
17 Amazing Emma Watson Gifts You Need Right Now,1,1,8,29,0,8,2,37,0
If Michelle Tanner Quotes Were Motivational Posters,1,1,7,38,0,6,0,45,0
21 Weird Reports Coming From British Columbia And We Are Very Concerned,1,1,11,47,0,11,2,58,0
"Super Bowl cheat sheet: On Brady, Curry, Gaga and Falcons' best chance",1,3,7,48,4,11,0,55,0
"Adele, Jennifer Lawrence, And Emma Stone Have Just Set Friendship Goals To Epic Proportions",1,1,14,62,2,13,0,76,0
"Mariah Carey And YG Link Up In The Video For ""I Don't""",1,3,13,27,3,11,0,40,0
17 Easy Slow Cooker Snacks To Eat While You Watch Sunday Football,1,1,11,41,0,11,2,52,0
Twitter Turned An Old Photo Of Meryl Streep Into An Incredible Meme,1,3,12,44,0,11,0,56,0
24 Things You Can Sympathise With If You've Ever Been Broke In London,1,1,12,42,1,12,2,54,0
Fans predict what will happen on season 7 of 'Game of Thrones',1,2,3,45,2,11,1,48,0
The Most Badass Graphic Novel Ever Created Has Been Published,1,1,10,42,0,9,0,52,0
Director Joss Whedon Calls Ivanka Trump a Dog,1,3,7,31,0,7,0,38,0
16 Situations People Who Love Gossip Know Too Well,1,1,8,32,0,8,2,40,0
Kentucky is going to ban having sex with your cat The list,1,3,2,45,0,11,0,47,0
16 Confessions From Librarians That'll Surprise You,1,1,6,36,1,6,2,42,0
"Obama commuted his sentence. Then a masked gunman ‘executed him,’ police say.",1,3,2,59,5,11,0,61,0
Can You Name The Last 15 World Series Champions,1,1,8,29,0,8,2,37,0
How Emotional Neglect Is Turning Too Many Of Pakistan's Boys Into Criminals,1,1,12,51,1,11,0,63,0
22 Karl Pilkington Quotes That Are Just Too Perfect For Instagram,1,1,10,43,0,10,2,53,0
"These Pictures Of Avril Lavigne And Bruce Willis Are So, So Awk",1,1,12,39,1,11,0,51,0
"Which ""Goldbergs"" Character Are You",1,1,5,24,2,4,0,29,0
Rihanna Dyed Her Hair Blue And It's Pretty ZOMG,1,1,12,26,1,8,0,38,0
18 Ways Your Mom Tortured You And Called It Love,1,1,9,28,0,9,2,37,0
27 People Who Have Reached Peak College,1,1,6,25,0,6,2,31,0
These currencies got crushed in 2016,1,2,1,26,0,5,4,27,0
18 Things You Need To Know About Drinking Coffee,1,1,8,30,0,8,2,38,0
What Questions Do You Have For The Pretty Little Liars,1,1,10,35,0,9,0,45,0
Round the world record: French sailor Thomas Coville sets new mark,1,3,4,51,1,10,0,55,0
#FlotusBars Is The Best Thing You'll See All Day,1,1,10,28,2,8,0,38,0
"66 Thoughts I Had While Watching Season 5, Episode 9 Of “Game Of Thrones”",1,2,11,42,3,13,4,53,0
Washington Officer Shot Identified; Remains Critical ,1,3,6,40,1,6,0,46,0
51 Things That Happen When Your BFF Has Depression,1,1,10,30,0,8,2,40,0
How a raw Aussie giant became a football recruiting sensation,1,3,2,50,0,9,0,52,0
"Which ""Inside Amy Schumer"" Amy Are You",1,1,7,23,2,6,0,30,0
26 Things That Won't Actually Make Sense Unless You're In Your Twenties,1,1,11,45,2,11,2,56,0
Watch Lady Gaga Give Drag Queens a Pep Talk on 'RuPaul's Drag Race' Season 9 Premiere: Exclusive,1,3,15,60,4,16,1,75,0
Online Companies Meet FCC in Bid to Preserve Net Neutrality Rule,1,3,11,43,0,10,0,54,0
Trump: 'If something happens blame' the judge,1,3,2,34,3,6,0,36,0
This Is What Your Favourite Emojis Actually Mean,1,1,8,33,0,7,0,41,0
What's The Best All-Natural Beauty Product Out There,1,1,9,34,2,7,0,43,0
All hail Halo - Xbox’s master game,1,2,3,23,2,6,0,26,0
The 19 Best Horror Films Of 2015,1,1,5,15,0,6,6,20,0
17 Unexpectedly Useful Gift Ideas For Procrastinators,1,1,6,39,0,6,2,45,0
Donald Trump says he will follow 'two simple rules' - and now everyone's making the same joke The list,1,2,3,77,4,18,0,80,0
Caerphilly farmer may get full payout after 24 year wait,1,2,1,44,0,9,2,45,0
22 Secrets Teen Magazine Staffers Will Never Tell You,1,1,8,35,0,8,2,43,0
24 Healthy On-The-Go Breakfast Ideas,1,1,6,22,2,4,2,28,0
Which 5SOS Guy Are You,1,1,7,10,0,4,1,17,0
Airliners of the Future May Sport Some Very Unusual Designs,1,2,8,42,0,9,0,50,0
Show Us Your Tiny Or Subtle Tattoos,1,1,7,22,0,6,0,29,0
18 Things That Happen When You're Way Younger Than Your Siblings,1,1,10,41,1,10,2,51,0
"Pepsi, I wrote your next great commercial for you for free",1,3,2,45,1,10,0,47,0
How Much Do You Really Know About Emojis,1,1,8,25,0,7,0,33,0
Kanye West Called Out Wiz Khalifa On Twitter And It Was Incredible,1,1,12,43,0,11,0,55,0
Here's How Talking About Money Can Improve Your Bottom Line,1,3,10,39,1,9,0,49,0
Are You More YouTube Or YouPorn,1,1,8,18,0,5,0,26,0
Which Starbucks Frappuccino Should You Try Based On Your Zodiac Sign,1,1,11,47,0,10,0,58,0
Here's What You Need To Know About Budget 2017 + 5 Other Important Stories From Today,1,3,13,50,2,15,5,63,0
2 HDFC Bank Officials Booked In Gurgaon For Illegally Swappiing Old Notes With New,1,3,16,52,0,13,1,68,0
21 Last-Minute Halloween Decorations You Can Make Yourself,1,1,8,40,1,7,2,48,0
The Trouble With Screenshorts,1,3,4,22,0,3,0,26,0
These Are The Best Products You Can Get With Your Sephora Gift Card,1,1,13,42,0,12,0,55,0
Women Talk About Men's Nipples,1,1,5,20,1,4,0,25,0
8 Life-Changing Things You Should Actually Try In December,1,3,9,39,1,8,1,48,0
19 Tweets That Sum Up Female Friendship,1,1,6,25,0,6,2,31,0
17 Fucking Infuriating Things That Happen In Every Porno,1,3,8,38,0,8,2,46,0
What Major City Should You Actually Live In,1,1,8,28,0,7,0,36,0
Ars Technica: White House Fails to Make Case that Russian Hacking Tampered with Election,1,2,11,63,1,13,0,74,0
17 Dogs Who Just Want Their Beds Back,1,1,7,21,0,7,2,28,0
Captivating Animal Pictures of 2016 Photos ,1,3,4,29,0,6,4,33,0
We Know What Movie You Like To Re-Watch Based On Your Age,1,1,13,32,1,11,0,45,0
We Know Your Favorite Ryan Based On One Question,1,1,9,31,0,8,0,40,0
"19 Awesome Gifts Every ""Game Of Thrones"" Fan Should Have On Their Wish List",1,1,13,45,2,13,2,58,0
21 Polly Pocket Sets That Will Give Every '90s Kid Intense Nostalgia,1,1,10,42,1,11,4,52,0
David Bowie's Most Iconic Fashion Moments,1,1,6,29,1,5,0,35,0
Barack Obama and family's final White House Christmas card inspires widespread grief on social media,1,3,5,80,1,14,0,85,0
Demi Lovato On Her Mental Health Journey,1,1,7,27,0,6,0,34,0
"Ranking The Winners Of ""Top Model"" From Worst To Best",1,1,10,32,2,9,0,42,0
"How ""Smallville"" Changed Tom Welling Forever",1,1,6,31,2,5,0,37,0
"From Franklin Graham to Tony Campolo, some evangelical leaders are splitting over gay marriage",1,2,5,75,1,13,0,80,0
8 Changes Your Bedroom Needs So You Can Sleep Better,1,2,9,33,0,9,1,42,0
22 Cats We've All Been At Some Point In Our Lives,1,1,10,26,1,10,2,36,0
21 Tweets About Having Braces That Are Way Too Real,1,1,9,31,0,9,2,40,0
What we can learn from North Korean military parades,1,3,3,41,0,8,0,44,0
21 Things All Boston University Students Know To Be True,1,1,9,36,0,9,2,45,0
Big Batch Breakfast Bakes,1,1,4,18,0,3,0,22,0
"24 Unusual, Subtle, And Beautiful Scottish Tattoos",1,1,6,34,2,6,2,40,0
"After Sonakshi Sinha, Her Brother Takes A Dig At Amaal & Armaan Malik, Gets A Kickass Reply",1,3,16,56,3,16,0,72,0
Weird Things You Do When You Have A Secret Crush,1,1,10,29,0,9,0,39,0
Free Credit Score? Not Necessarily. Credit Bureaus Busted for Deception,1,3,9,51,2,9,0,60,0
The 15 Most Badass Feminist Moments In Canada In 2015,1,1,8,30,0,9,6,38,0
17 Things Only American Students Studying In The UK Will Understand,1,1,11,44,0,10,2,55,0
Less-educated Middle-age US Whites Dying Younger Than Others,1,2,9,42,2,7,0,51,0
"What Should You Get For Christmas Based On Your Favorite ""Big Bang Theory"" Character",1,1,14,55,2,13,0,69,0
Stop What You're Doing And Look At These New Pluto Photos,1,1,11,35,1,10,0,46,0
Babysitter's Porn And Dead Hamsters: What The Fuck Do You Do,1,1,11,37,2,10,0,48,0
31 Delicious Things You Should Eat In January,1,1,7,29,0,7,2,36,0
For Everyone Who's OBSESSED With Ina Garten And Her Husband Jeffrey,1,1,18,38,1,10,0,56,0
"Yep, Lyft gained users from #DeleteUber, and we now know how many",1,3,4,47,3,11,0,51,0
"Yes, the 'Game of Thrones' showrunners hated HBO's stupid melting ice stunt as much as you did",1,3,6,68,4,16,0,74,0
Destinations #WeAreNotAfraid: 45 reasons why we will always love London,1,3,6,52,2,9,2,58,0
Famous Person Justin Bieber Randomly Ran Into Other Famous Person Adam Sandler On The Street,1,1,15,63,0,14,0,78,0
"Very Lonely Luke Is The Latest Hilarious ""Star Wars"" Parody Twitter Account",1,1,12,50,2,11,0,62,0
Cheap Vs. Expensive Vodka Taste Test,1,1,6,24,1,5,0,30,0
"I Wonder If That Woman From ""Magic Mike XXL"" Is Still In That Sex Swing",1,1,17,38,2,14,0,55,0
‘The Wolfpack’ Tells How the Six Angulo Brothers Were Saved by the Movies,1,2,10,49,2,12,0,59,0
"Katy Perry Dressed Up As Guy Fieri, And You'll Never Unsee The Result",1,3,13,42,2,12,0,55,0
"Here's Our First Look At Eddie Redmayne In ""Fantastic Beasts And Where To Find Them""",1,1,15,52,3,14,0,67,0
Nintendo’s weird and wonderful Switch console may be a hard sell for some,1,3,2,58,1,12,0,60,0
How Much Do You Know About Supermodels,1,1,7,25,0,6,0,32,0
4 Things That You're Probably Doing Wrong With Your Swimsuit,1,2,9,40,1,9,1,49,0
"Can You Name The 30 Most Mentioned Characters In The ""Hunger Games"" Books",1,1,12,45,2,12,2,57,0
This 7-Picture Test Will Reveal A True Difficulty You Have In Life,1,1,12,41,1,11,1,53,0
'Rogue One' Sound Editors Reveal How They Found Princess Leia's 'Hope' and More Production Secrets,1,3,14,65,5,14,0,79,0
19 Beautiful Ways To Use Sampaguita Flowers In Your Wedding,1,1,9,39,0,9,2,48,0
How Much Of A Potato Addict Are You Really,1,1,9,25,0,8,0,34,0
"Wiz Khalifa Sang Over Adele's ""Hello"" To Create The Perfect Stoner Anthem",1,1,12,47,3,11,0,59,0
Photos of nightstands empower people with chronic illnesses,1,3,1,51,0,7,0,52,0
Which Minor Minor Character From 30 Rock Are You,1,1,8,30,0,8,2,38,0
SAPVoice: How High-Tech Investments Make Smart Cities,1,3,11,34,2,6,0,45,0
Are You More Blondeney Or Brunetteney,1,1,6,26,0,5,0,32,0
Who Said It: The Disney Insult Edition,1,1,7,24,1,6,0,31,0
21 Times Hipsters Went Too Damn Far,1,1,6,21,0,6,2,27,0
"Swedish Library Bans Factual Book on Immigration, Says Contents are ‘Contrary to Human Rights’",1,3,11,67,3,13,0,78,0
What Color Would Your Lightsaber Be Based On Your Zodiac Sign,1,1,11,40,0,10,0,51,0
This Is The World's First Cryptocurrency Issued By A Hedge Fund,1,3,11,41,1,10,0,52,0
It's Not Your Job To Make Everyone Like You,1,1,9,25,1,8,0,34,0
Can We Guess How Much Money You Made In 2015,1,1,9,22,0,9,4,31,0
The Extreme Procrastinator’s Guide to Holiday Gifts,1,2,6,38,1,6,0,44,0
Q. & A.: How to Give Back During the Holidays ,1,3,7,25,4,10,0,32,0
A reason for hope for (almost) every team,1,3,1,31,2,7,0,32,0
Obamacare on the Ropes as House Follows Senate in Voting to Repeal,1,2,7,48,0,11,0,55,0
How Dirty Minded Are You Really,1,1,6,20,0,5,0,26,0
23 Questions You Probably Have For Lesbian Movies,1,2,7,33,0,7,2,40,0
7 infamous deleted scenes that cost movie studios millions,1,3,0,49,0,8,1,49,0
Kylie Jenner's Snapchat Is Going To Kill Someone,1,1,8,32,1,7,0,40,0
Funeral Home Staffers' Sharp Eyes Lead to Murder Charges,1,2,8,39,1,8,0,47,0
Make The Holidays Simple With The BuzzFeed DIY Newsletter,1,1,12,37,0,8,0,49,0
The nations of the world spending the most to prepare for World War Three The list,1,2,5,62,0,15,0,67,0
"35 ""ANTM"" GIFs That Perfectly Sum Up Working In Retail",1,1,14,27,2,9,2,41,0
"Chris Brown Gets Real About Drugs, Rihanna, And More In New Documentary",1,3,12,46,2,11,0,58,0
People Are Losing It After This Student Publicly Roasted His College With Two Words,1,2,14,56,0,13,0,70,0
Foot Locker Responds to Allegations of Shady Sneaker Release,1,3,7,45,0,8,0,52,0
17 Jokes About Chelsea Guaranteed To Make You Laugh,1,1,8,33,0,8,2,41,0
People Are Screaming After A Guy Hilariously Called Out His Mom For Lying On Facebook,1,2,15,56,0,14,0,71,0
Kim Kardashian's 6-Year-Old Nephew Had No Comment About Her Deodorant,1,1,11,45,3,9,1,56,0
Can You Guess These Disney Sidekicks By Just Their Colors,1,1,10,38,0,9,0,48,0
Couples Try To Make Each Other Laugh,1,1,7,23,0,6,0,30,0
This new game is like PokÃ©mon GO â but you can catch cash prizes instead,1,2,5,53,3,14,0,58,0
14 Ways Doing Theater As A Kid Can Help You As An Adult,1,1,12,29,0,12,2,41,0
"29 ""Fallout 4"" Easter Eggs That Will Blow Your Mind",1,1,8,29,2,9,3,37,0
"Everyone Lost Their Minds About New ""Gilmore Girls"" Episodes Officially Coming To Netflix",1,1,13,62,2,12,0,75,0
CNNVerifizierter Account,1,3,5,18,0,1,0,23,0
Bruce Springsteen's protest song to Donald Trump,1,3,4,37,1,6,0,41,0
Where Is America’s Heartland? Pick Your Map ,1,3,7,28,2,7,0,35,0
"Are You A Chip Or Joanna From ""Fixer Upper""",1,1,9,24,2,8,0,33,0
This Giant Gray Blobby Thing Has Become A Huge Meme In Russia For Some Reason,1,2,15,48,0,14,0,63,0
13 Weird Italian Expressions Translated Literally Into English,1,1,7,46,0,7,2,53,0
17 Confessions From People Who Have Never Masturbated,1,1,7,37,0,7,2,44,0
Which Economies Will Grow And Which Ones Will Fail Over Next Three Years,1,2,13,47,0,12,0,60,0
ABC’s ‘Nightline’ Issues Correction After Misrepresenting Fleischer to Make Him Seem More Critical of Spicer,1,2,15,76,3,14,0,91,0
Serena Williams And Colton Haynes Are Your New Favorite Celebrity BFFs,1,1,13,47,0,10,0,60,0
"The Princess Diarist by Carrie Fisher review – fame, sex and Harrison Ford",1,3,7,53,2,12,0,60,0
"Christopher Walken Reading Edgar Allan Poe's ""The Raven"" Will Make Your Literary-Loving Heart Explode",1,1,15,69,4,13,0,84,0
Alec Baldwin to Revive Donald Trump Role on ‘SNL’ Following Inauguration,1,3,11,49,2,10,0,60,0
The 3 Longest Flights In The World Are Not For The Faint Of Heart,1,2,13,38,0,13,1,51,0
A Marine Responded To Donald Trump's #MuslimID Comments And It Was Perfect,1,1,14,47,2,11,0,61,0
"This man raised over £250,000 to make a very NSFW Donald Trump doll The list",1,2,8,46,2,14,6,54,0
Report: Grand Juries to Hear Testimony Over Bill de Blasio Fundraising Probes,1,3,10,55,1,11,0,65,0
Here's What Gift To Buy Someone Based On Their Favorite TV Show,1,1,13,38,1,11,0,51,0
German killed by elephant,1,3,1,21,0,3,0,22,0
A Surprising Thing Happened When Kids Were Asked To Choose Between Happiness And Money,1,1,14,59,0,13,0,73,0
17 Secrets We Want To Tell Our Exes,1,1,7,19,0,7,2,26,0
An Indestructible Coffee Machine for Extreme Caffeine,1,2,6,41,0,6,0,47,0
"North Carolina-Gonzaga about firsts, big men and bad ankles",1,3,3,46,2,8,0,49,0
Aretha Franklin slams Dionne Warwick for her comment at Whitney Houston's funeral,1,3,6,63,1,11,0,69,0
The internet slams Steve King's straight-up racist tweet,1,2,3,44,2,7,0,47,0
7 Revelations from ‘Shattered’: New Book Detailing Hillary Clinton’s Failed Campaign,1,3,9,60,4,10,1,69,0
Think again before you post those pics of your kids,1,2,1,41,0,9,0,42,0
"This Gym Teacher Taught His Class a Cardio Version of ""Nae Nae"" and It's Everything",1,1,12,54,3,14,0,66,0
81 Things Yuccies Like To Talk About,1,3,6,22,0,6,2,28,0
Why Only Americans Are Interested in the Hunt for Alien Life,1,2,8,42,0,10,0,50,0
"Trump’s New Ban Leaves Few Spots for Refugees, Even the Hunted ",1,2,9,41,2,11,0,50,0
Which MLB Team Has the Most Elite Young Talent?,1,2,10,28,1,8,0,38,0
29 Ways To Design Your Kid's Dream Bathroom,1,1,7,26,1,7,2,33,0
Donald Trump Thinks He Can Endure More Controversy And Pain Than You,1,3,12,45,0,11,0,57,0
Can You Match The Horror Film To The Screencap,1,1,9,29,0,8,0,38,0
17 Badass Women You Probably Didn’t Hear About In 2016,1,3,8,30,1,9,6,38,0
No Jail Time for Walk of Fame Trump Star Smasher,1,3,8,31,0,9,0,39,0
Pet 'emotion trackers' and intelligent jeans are here. But do we want them?,1,3,2,57,4,12,0,59,0
Jane Fonda Pitches ‘Trumpers’ Adult Diapers to ‘Help With All the Leaks’,1,3,10,47,4,11,0,57,0
58 French Villages That Should Be On Your Bucket List,1,1,9,33,0,9,2,42,0
15 Truths All Feminists Will Understand,1,1,5,27,0,5,2,32,0
How Much Do You Spoil Your Dog,1,1,7,17,0,6,0,24,0
18 Gorgeous University Campuses That Will Make You Proud To Be Canadian,1,1,11,47,0,11,2,58,0
Saturday Night Live Made Fun Of Taylor Swift's #Squad,1,1,9,34,2,8,0,43,0
27 Underrated Makeup Brands Everyone Should Know About,1,1,7,38,0,7,2,45,0
Beyond Hennessy: Get Fancy With These Five Cognacs,1,2,8,34,1,7,0,42,0
24 Delicious Thanksgiving Desserts That Aren't Pie,1,1,6,35,1,6,2,41,0
Photographers Took Wildly Different Pictures Of This One Guy Because Of Backstory,1,1,12,58,0,11,0,70,0
Watch Kacey Musgraves’ “Biscuits” Video And Life Will Be Gravy,1,2,10,40,3,9,0,50,0
27 Secrets Waiters In Pubs Will Never Tell You,1,1,8,28,0,8,2,36,0
Here's why cats sleep so much,1,3,1,22,1,5,0,23,0
18 Times Taylor Swift Made Us Jealous On Instagram,1,1,8,32,0,8,2,40,0
17 Impressive DIY Gifts You Can Make With Things From Around The House,1,1,14,42,0,12,2,56,0
Ever Wondered Why Some People Have That Tiny Extra Hole In Their Ear?,1,3,13,43,1,12,0,56,0
Growth Stories: Finding Growth In Low-Growth Markets,1,3,8,36,2,6,0,44,0
8 Brilliant Philosophers Who Taught Us A Great Deal About Life,1,2,10,41,0,10,1,51,0
48 Rules All Long-Term Female Friends Follow,1,1,7,28,1,6,2,35,0
Renaissance Feud Spills Over to Hedge Fund Poker Night ,1,2,8,38,0,9,0,46,0
Here's How Dietitians Actually Eat Healthy Without Going Broke,1,1,9,44,1,8,0,53,0
Which TV Show Lesbian Should Be Your Imaginary Girlfriend,1,1,10,39,0,8,0,49,0
21 Easy 3-Ingredient Snacks That Are Actually Good For You,1,1,9,36,1,9,3,45,0
"44 Leaders, Legislators And Artists Sum Up Trump's First 100 Days",1,3,9,39,2,10,5,48,0
What Does Your Taste In Candy Say About Your Taste In Men,1,1,12,34,0,11,0,46,0
21 Things You Know If You Prefer Dirty Eating To Clean Eating,1,3,11,37,0,11,2,48,0
When Someone Farts At Work,1,1,5,17,0,4,0,22,0
"A top investment expert at a $487 billion fund on her outlook for 2017, Europe and Trump",1,3,3,60,2,16,7,63,0
"Kellogg Foundation Gave Big to Soros Organization, Tides Foundation",1,3,8,50,1,8,0,58,0
"Soldier Suicide Probe, Shashi Tharoor On British Colonial History And Other Must Read Stories",1,3,14,65,1,13,0,79,0
If Beauty Products Were Named Honestly,1,1,6,27,0,5,0,33,0
What Your Favorite Golden Girl Says About You,1,1,8,30,0,7,0,38,0
Siri Can Have Conversations With Other A.I. And I'm Horrified,1,1,11,38,3,9,0,49,0
Radiohead Release Rejected Bond Theme Song And It's Haunting,1,1,9,42,1,8,0,51,0
LIVE: Yahoo earnings,1,2,5,12,1,2,0,17,0
Parents Are Scaring Their Children Using The New Snapchat Filters,1,1,10,46,0,9,0,56,0
27 Delicate Tattoos For Nature Lovers,1,3,5,25,0,5,2,30,0
Here's A Fun Reminder That There's No Such Thing As Gay Blood,1,1,12,36,2,11,0,48,0
Tell Us How You Keep A Healthy Diet In College,1,1,10,27,0,9,0,37,0
Former 'Brady Bunch' Star Under Fire After Report Of Homophobic Rant,1,2,11,45,2,10,0,56,0
A Contouring Fail Is The Reason Khloe Kardashian Looks So Different,1,1,11,46,0,10,0,57,0
26 Ridiculously Clever Products With A Secret,1,1,6,31,0,6,2,37,0
Justin Bieber's Dad Sent This Really Awkward Tweet About His Son's Penis,1,1,12,47,2,11,0,59,0
Brent Musburger: Olbermann Should Stick to Sports,1,2,6,36,1,6,0,42,0
Critics of Turkey's President Recep Tayyip Erdogan tell of intimidation ahead of crucial referendum,1,3,6,79,1,13,0,85,0
The First Day Of Frosh Week Vs. The Last Day Of Frosh Week,1,1,13,32,1,12,0,45,0
Alec Baldwin: ‘Thoughtless Pig’ Voicemail to Daughter Gets ‘Thrown’ in My Face Every Day,1,3,12,58,5,13,0,70,0
22 Struggles Everyone Who Lives With A Cat Knows Too Well,1,1,10,35,0,10,2,45,0
These Women Shaved Their Heads And They Look Fly AF,1,1,11,31,0,9,0,42,0
10 Movies With A Shit-Ton Of Lesbian Subtext,1,1,8,26,1,7,2,34,0
Which Footballer Do You Weigh The Same As,1,1,8,26,0,7,0,34,0
Stop What You're Doing And Add Lady Gaga On Snapchat,1,1,10,32,1,9,0,42,0
"How Well Do You Remember ""The Vampire Diaries"" Murder House Party",1,1,11,42,2,10,0,53,0
The 26 Biggest Rebels On The Entire Fucking Planet,1,1,8,32,0,8,2,40,0
Why being a 'weekend warrior' is still good for your health,1,3,1,46,2,10,0,47,0
"Where does Warren stand? Liberal icon tangling with Dems, base ",1,3,4,47,2,10,0,51,0
Can You Spell These Commonly Misspelled Canadian Words,1,1,8,39,0,7,0,47,0
We Found Some Of The Most L.A. Foods Ever,1,1,10,21,2,8,0,31,0
This Is What Pizza Huts Look Like Now,1,1,8,22,0,7,0,30,0
"Trump Picks His Enemy, Accuses China Of Currency Manipulation. Chinese Media Says He's 'Inexperienced'",1,3,14,70,5,13,0,84,0
Director Joss Whedon Calls Ivanka Trump a Dog,1,2,7,31,0,7,0,38,0
30 Under 30 2017: Celebrities,1,3,2,14,1,4,8,16,0
"The New ""Suicide Squad"" Cast As Iconic Animated Characters",1,1,9,39,2,8,0,48,0
Krauthammer: Obama’s ‘Deluding Himself’ When He Says Race Relations Have Improved,1,3,11,56,4,10,0,67,0
7 ‘Fatty Foods’ To Add To Your Grocery List To Cut Back Your Body Fat And Reduce The Risk Of Heart Disease,1,2,21,61,2,21,1,82,0
21 Gifts For Your Best Friend Who Is Also A Dog,1,1,10,25,0,10,2,35,0
Build A Monster And We Will Tell You Your Deepest Fear,1,3,11,33,0,10,0,44,0
Here's What 100 Years Of Black Men's Hair Trends Look Like,1,1,10,33,2,10,3,43,0
There's An Instagram Account That Makes Fun Of Instagram Accounts,1,1,10,45,1,9,0,55,0
Wasserman Schultz: Donald Trump Believes He ‘Was Elected as a Dictator’,1,3,9,49,3,10,0,58,0
Everything You Need To Know About Floating Iceberg Hot Chocolate,1,1,10,45,0,9,0,55,0
Reading American cities: books about Honolulu,1,3,3,36,1,5,0,39,0
We Know Which Katy Perry Song Matches Your Zodiac Sign,1,1,10,35,0,9,0,45,0
Let’s Talk About How Fucking Repulsive Eggnog Is,1,3,8,32,1,7,0,40,0
Songwriters Accuse Radio Stations of 'Illegal Cartel',1,2,6,39,2,6,0,45,0
The Forbes 2017 Tax Guide,1,2,4,13,0,4,4,17,0
What's Your Craziest Bachelorette Party Experience,1,1,6,38,1,5,0,44,0
17 Times Sex Almost Went Too Fucking Far In 2016,1,3,8,25,0,9,6,33,0
13 Heritage Minutes That Canadians Need Right Now,1,1,7,33,0,7,2,40,0
"16 Perfect Tweets About Gender That Will Make You Whisper “Yes, Thank You” Under Your Breath",1,2,15,57,3,15,2,72,0
"Salt Bae voted, and it definitely deserves a new Photoshop Battle",1,2,4,50,1,10,0,54,0
DARPA’s Humanoid Robots Take a Slow-Motion Leap Forward,1,3,12,34,2,7,0,46,0
17 Beer Fests Around The World That Aren't Oktoberfest,1,1,8,35,1,8,2,43,0
Zayn Malik's First Solo Single Is Coming Out This Week,1,1,10,34,1,9,0,44,0
How Psychic Are You Actually,1,1,5,19,0,4,0,24,0
"23 Gifts For The Baby ""Star Wars"" Geek In Your Life",1,1,10,27,2,10,2,37,0
23 Ways You May Have Internalised Misogyny Without Even Realising,1,2,9,45,0,9,2,54,0
Would A Brown Dwarf Near Us Cook The Earth?,1,3,9,25,1,8,0,34,0
21 Funny Tweets That Perfectly Sum Up Your Hatred For People,1,1,10,38,0,10,2,48,0
17 Red Velvet Recipes Guaranteed To Satisfy Your Sweet Tooth,1,1,9,40,0,9,2,49,0
Wall Street is changing how it trades the world's hottest investment product,1,3,2,62,1,11,0,64,0
Your Horoscope For The Week Of December 28,1,1,7,26,0,7,2,33,0
For Everyone Who's Sick And Tired Of Washing Their Goddamn Hair,1,1,11,41,1,10,0,52,0
17 Branches Of Engineering Summed Up Cleverly In Minimalist Posters,1,1,9,47,0,9,2,56,0
This is why you shouldn’t wear a green tie on television The list,1,3,2,50,1,12,0,52,0
How Do Painkillers Know Where The Pain Is,1,1,8,26,0,7,0,34,0
"14 Things You Should Never, Ever Say To A Lesbian",1,1,9,28,1,9,2,37,0
Wiley – five landmarks in the godfather of grime's career,1,3,1,45,2,9,0,46,0
Only Solve This Crossword If You're Good At Seeing Patterns,1,1,10,39,1,9,0,49,0
Can We Guess Your Favorite Girl Scout Cookie Based On Your Zodiac,1,1,12,42,0,11,0,54,0
Are You More Of A Cromwell Or Sanderson Sister,1,1,9,29,0,8,0,38,0
Are Your Instagram Habits Like Everyone Else's?,1,2,7,32,2,6,0,39,0
6 ways you can help your child thrive with dyslexia,1,2,0,41,0,9,1,41,0
Stuffed Monkey Bread,1,1,3,15,0,2,0,18,0
Scarlett Johnsson calls Ivanka Trump 'cowardly' following 'complicit' interview,1,3,4,63,4,8,0,67,0
"If You Have No Hopes From 2017, This AIB Video Shows Why The Next Year Is Going To Be The Bomb",1,3,22,47,1,20,4,69,0
Donald Trump tweeted a photo and people are pointing out there's something very wrong with it The list,1,3,3,81,1,17,0,84,0
"Can You Guess Which ""Harry Potter"" Character Would Send This Text",1,1,11,42,2,10,0,53,0
Which Celebrity Quote Should Be Your Next Instagram Caption,1,1,9,42,0,8,0,51,0
"Kristen Stewart Thinks People Should ""Do Something"" About The Lack Of Gender Equality",1,1,13,58,2,12,0,71,0
North West Is Sick Of Her Mom Taking Pictures Of Her,1,1,11,31,0,10,0,42,0
A Hairy Canadian Man Just Made The Sexiest Boudoir Photo Album Of 2016,1,1,12,42,0,12,4,54,0
"How Well Do You Actually Know The Lyrics From ""Hamilton""",1,1,10,35,2,9,0,45,0
VIDEO: Officer Drives Over Woman as She Allegedly Shoots at Police,1,2,13,42,1,10,0,55,0
A few snow chances over the next week we need to keep our eye on,1,2,1,49,0,14,0,50,0
23 Hilariously Genius Lies Parents Actually Told Their Kids,1,2,8,41,0,8,2,49,0
100 Women: How South Korea stopped its parents aborting girls,1,3,4,44,1,9,3,48,0
27 Reactions You Definitely Had To The 2016 Golden Globe Nominations,1,1,9,43,0,10,6,52,0
What Happens to Your Skin When You Wear Makeup to the Gym?,1,3,9,37,1,11,0,46,0
This Brainteaser Is Getting Shared All Over Facebook And Driving People Crazy,1,1,12,54,0,11,0,66,0
‘What should be pristine white is littered with blue’ – Timo Lieber’s Arctic photography,1,3,4,67,4,13,0,71,0
All the best (and geekiest) signs from Marches for Science around the world,1,2,3,58,2,12,0,61,0
"Can You Tell What Band Is On A Cover Of ""NME""",1,1,13,20,2,10,0,33,0
Fast Food Fried Chicken Taste Test,1,1,6,23,0,5,0,29,0
"22 Times People Met Celebrities And It Was Really, Really Lovely",1,1,10,41,1,10,2,51,0
Kitchen gadgets review: coconut grater – an ugly pleasure of the flesh,1,3,1,56,2,11,0,57,0
"17 People Holding Signs, Ranked",1,1,4,20,1,4,2,24,0
Which Wild Animal Is Your Sexual Nature,1,1,7,26,0,6,0,33,0
Men Watch Other Men Get Vasectomies And It Scarred Them For Life,1,1,12,41,0,11,0,53,0
Britain’s already fragile union is at risk - not from Scotland but its own government,1,3,2,67,2,14,0,69,0
This Photo Shoot With A Pregnant Woman As A Model Is Absolutely Stunning,1,1,13,47,0,12,0,60,0
People Can't Stop Talking About This Dude's Awesomely Nerdy Hair,1,1,10,43,2,9,0,53,0
How Many Logan Lerman Movies Have You Seen,1,1,8,27,0,7,0,35,0
Could You Pass Your Potions O.W.L,1,1,8,18,2,5,0,26,0
24 Secrets People Who Work In Garden Centres Will Never Reveal,1,1,10,40,0,10,2,50,0
No Animal Should Be Allowed To Be This Round,1,1,9,27,0,8,0,36,0
This 14-Year-Old Found Out She Was The Next Disney Princess And Her Reaction Was Amazing,1,1,16,54,2,14,2,70,0
17 Times David Beckham Proved He Really Was The Sexiest Damn Man Alive,1,1,12,44,0,12,2,56,0
"This Woman Had The Perfect Response To The Final Question On ""Jeopardy""",1,1,12,46,2,11,0,58,0
21 Absolutely Fucking Perfect Moments In Sporting Caption History,1,1,8,47,0,8,2,55,0
One in three Conservative MPs to join anti-EU campaign group,1,3,6,44,1,9,0,50,0
This Police Officer Showed Up To A Routine Call And Ended Up Falling In Love With A Puppy,1,1,18,54,0,17,0,72,0
4 Surprising Reasons You Have Bags Under Your Eyes,1,2,8,33,0,8,1,41,0
"A 1,000-Year-Old Skeleton Was Ripped From The Earth After A Storm Blew A Giant Tree Down",1,1,17,49,3,15,4,66,0
Trump Warns 'Pocahontas' May Run For President In 2020,1,2,8,32,2,8,4,40,0
15 People Who Underestimated The Cold,1,1,5,25,0,5,2,30,0
Can We All Take A Moment To Appreciate Ben Whishaw's Hair Right Now,1,1,13,41,1,12,0,54,0
Megyn Kelly-Roger Ailes Sexual Harassment Allegations Film Set from ‘Big Short’ Writer,1,3,12,60,3,11,0,72,0
"Emma Stone And Lena Dunham Came Up With 11 Things You Can Call Them Other Than ""Sweetheart""",1,1,16,55,2,16,2,71,0
How the Stars Spent Christmas 2016,1,2,4,21,0,5,4,25,0
"After A Hungry Thief Stole This Guy's Kit Kat, The Company Sent Him 6,500 Free Chocolate Bars!",1,3,16,54,4,16,4,70,0
The wait is over: The UK’s greatest ever sportsperson is revealed,1,3,4,49,2,10,0,53,0
Which Fall Out Boy Song Are You Based On Your Zodiac Sign,1,1,12,34,0,11,0,46,0
"Jamie Scott on the Secret to Writing Hits for One Direction, Justin Bieber & Niall Horan",1,2,11,60,2,15,0,71,0
Arnold Schwarzenegger Negged Nickelback and They Hit Back,1,3,7,43,0,7,0,50,0
He Cheated. Now His Ex-Girlfriend Has Some Heartbreaking Questions,1,3,10,46,2,8,0,56,0
This Groom And His Best Man Celebrated Their Bromance With A Photo Shoot,1,1,13,47,0,12,0,60,0
37 Photos That Will Annoy You More Than Is Actually Reasonable,1,1,10,40,0,10,2,50,0
How To Make Sheet Pan Salmon With Crispy Kale,1,1,9,28,0,8,0,37,0
"Which ""Sherlock"" Character Is Your Soulmate Based On Your Taste In Food",1,1,12,46,2,11,0,58,0
Solve This Crossword Puzzle For A Good Cause,1,1,8,29,0,7,0,37,0
"Sussanne And I Aren’t Trying To Set Any Example, Says Hrithik Roshan On His Friendship With Her",1,2,17,60,2,16,0,77,0
Inside An MIT Incubator: What It's Really Like To Learn Entrepreneurship At MIT,1,3,17,48,2,12,0,65,0
The Most Famous And Magical Treehouse In Canada You Didn't Know About,1,1,12,45,1,11,0,57,0
PROMO: 5 Essential Tech Additions to Your Holiday Travel Gear,1,2,12,38,1,9,1,50,0
Happy children & happy cows,1,3,1,21,1,4,0,22,0
Get Your Children Good and Dirty,1,3,5,22,0,5,0,27,0
Amy Schumer And Serena Williams Just Posed Topless,1,1,8,35,0,7,0,43,0
Donald Trump Shared A Proverb With His 'Irish Friends.' It Likely Wasn't Irish.,1,2,13,49,5,12,0,62,0
"Here's Why ""Paw Patrol"" Is A Terrible Kids' Show",1,1,9,27,4,8,0,36,0
When You Have A Crush On Someone Athletic,1,1,8,26,0,7,0,34,0
German killed by elephant,1,2,1,21,0,3,0,22,0
The Most Famous Celebrity Pet Accounts on Instagram [Video],1,3,8,41,2,8,0,49,0
I Worked At An Aquarium For A Day And This Is What I Learned,1,1,14,33,0,13,0,47,0
Which MLB Team Has the Most Elite Young Talent?,1,3,10,28,1,8,0,38,0
21 People Who Forgot A Word And Just Made Some Shit Up,1,2,11,30,0,11,2,41,0
Literally Just A Bunch Of Really Funny Tweets,1,1,8,30,0,7,0,38,0
People Are Not Happy With Justin Bieber After He Posted A Picture With Cornrows,1,1,14,52,0,13,0,66,0
George Osborne's Mansion House speech,1,3,4,28,1,4,0,32,0
How to Recognize Signs of Holiday Stress in Your Dog,1,3,7,36,0,9,0,43,0
The Most Desirable Passports On Earth Don’t Include America’s,1,3,9,42,2,8,0,51,0
Here's the difference between a psychopath and a sociopath,1,2,1,48,1,8,0,49,0
These smart knobs will prevent a kitchen disaster,1,2,1,41,0,7,0,42,0
"In American Towns, Private Profits From Public Works ",1,3,8,36,1,8,0,44,0
This Quiz Will Tell You Which Breakfast Cereal Matches Your Personality,1,1,11,50,0,10,0,61,0
What Gift Should You Buy Your Favorite Geek,1,1,8,28,0,7,0,36,0
A Bunch Of Millennials Lay In A Coffin And Talked About Their Ideal Funeral,1,1,14,48,0,13,0,62,0
Manmohan Singh's Office Knew Changing Requirements To Fit AgustaWestland's Bid Says SP Tyagi,1,3,15,63,2,12,0,78,0
The two ages you're happiest at The list,1,3,2,30,1,7,0,32,0
Street Photographer at Port Authority Captures Another Era ,1,2,7,44,0,8,0,51,0
13 Times Harry Potter Was A Gift We Didn't Deserve,1,1,9,29,1,9,2,38,0
28 Teeny Tiny Gifts That Prove Good Things Come In Small Packages,1,3,11,41,0,11,2,52,0
How Wild Is Your Sex Life,1,1,6,14,0,5,0,20,0
This Absurd Forever 21 Choker Has People Hilariously Done With The Choker Trend,1,3,12,53,0,12,2,65,0
12 Types Of Drunk Friend Everyone Knows,1,1,6,25,0,6,2,31,0
This Food Test Will Determine Your Boyfriend's Personality,1,1,8,42,1,7,0,50,0
10 Most Mesmerizing Latte Art Videos Of 2015,1,1,6,25,0,7,6,31,0
People Read The Craziest Shit Grandmas Have Ever Said,1,1,9,36,0,8,0,45,0
Pornhub Has A Hilarious Christmas Advert Now,1,1,7,31,0,6,0,38,0
IRS Audit Traps & 5 Ways To Steer Clear,1,3,9,20,1,8,1,29,0
14 Irresistible Pumpkin-Scented Beauty Products,1,1,5,35,1,4,2,40,0
Stephen Colbert Has the Perfect 'Dumbass' Answer to Kid Rock's Badass Grill,1,2,10,51,3,11,0,61,0
Can You And Your Family Finish This Freestyle Crossword,1,1,9,38,0,8,0,47,0
Texas Woman Sentenced to 8 Years in Prison for Illegal Voting,1,2,7,43,0,10,1,50,0
19 Stunning Vintage-Inspired Engagement Rings That'll Make You Swoon,1,1,9,47,2,8,2,56,0
"Drop Everything, Justin Bieber And Selena Gomez Just Released A Surprise Duet",1,1,12,53,1,11,0,65,0
Which Marijuana Strain Should You Smoke Based On Your Zodiac Sign,1,1,11,44,0,10,0,55,0
Girl Scout Sells More Than 15K Cookie Boxes After Writing Brutally Honest Cookie Review - Yahoo,1,3,15,62,1,15,2,77,0
"Sage Northcutt, Max Holloway Go Ham on Houston Rockets Mascot",1,3,9,42,1,9,0,51,0
EXCLUSIVE: CDC Chief Frieden: How to end America's growing opioid epidemic ,1,3,16,45,3,11,0,61,0
Rainbow Freckles Are The New Beauty Trend And The Future Is Bright,1,1,12,43,0,11,0,55,0
4 Ways Entrepreneurs Can Use Technology To Stay Fit On The Road,1,3,11,40,0,11,1,51,0
"This Is What The ""Harry Potter"" Characters Looked Like In The First Movie Vs. The Last",1,1,16,52,3,15,0,68,0
53 Pictures Only Introverts Can Truly Appreciate,1,2,6,34,0,6,2,40,0
The Hardest 2000s Music Quiz You'll Ever Take,1,1,7,26,1,7,4,33,0
"The Dude Who Follows His Wife Around The World Came Back To India, And He's Still Killing It",1,1,18,55,2,17,0,73,0
15 Instrumental Covers Of Pop Songs That Are Better Than The Original,1,1,11,45,0,11,2,56,0
Prince George steals the show as Royal Family leaves Christmas Day service,1,3,6,57,0,11,0,63,0
This Woman's Deliciously Unhealthy Instagram Account Is Hilarious,1,1,8,49,1,7,0,57,0
Which Donald Trump Quote Are You Based On Your Zodiac Sign,1,1,11,37,0,10,0,48,0
Women Share Their First Queer Crush,1,1,6,24,0,5,0,30,0
How to share Apple's Live Photos on Instagram,1,3,5,32,1,7,0,37,0
32 Strikingly Beautiful Wedding Dress Details,1,1,5,33,0,5,2,38,0
The safest way to walk on ice is to impersonate a penguin â here's why,1,3,1,54,3,14,0,55,0
"D.C. Area ICE Roundup Nets 82, Including MS-13 Members",1,2,12,26,4,8,4,38,0
This Simple Test Will Reveal Your Dominant Emotion,1,1,8,35,0,7,0,43,0
Here Are Some Practical Ways You Can Help The People Of Aleppo,1,3,12,39,0,11,0,51,0
"Here's What The Cast Of ""She's The Man"" Looks Like Today",1,1,11,31,4,10,0,42,0
15 Pictures Of Renaissance Women With Spectacular Gravity-Defying Boobs,1,1,9,51,1,8,2,60,0
Who Should Be Your First Celebrity Boyfriend,1,1,7,31,0,6,0,38,0
Greg Ip: Three Economic Puzzles Are Now Less Puzzling - Real Time Economics,1,3,12,49,2,12,0,61,0
Awkward Selfie Stick Prank,1,1,4,19,0,3,0,23,0
Stunning Vintage Photos Reveal The Brief Life Of Artist Eva Hesse,1,1,11,44,0,10,0,55,0
This Dad Finding Out His Wife Is Pregnant Will Make Your Uterus Skip A Beat,1,1,15,46,0,14,0,61,0
John Krasinski's View On Fatherhood Will Explode Your Ovaries,1,1,9,43,1,8,0,52,0
16 Eyebrow Products That Are Actually Worth The Hype,1,1,8,34,0,8,2,42,0
Your Choice Of Christmas Cupcake Will Reveal Your Darkest Secret,1,1,10,45,0,9,0,55,0
George Clooney: Trump and Bannon the Real ‘Hollywood Elitists’,1,3,7,44,3,8,0,51,0
"19 Pictures That Will Make You Say ""Seriously?""",1,1,7,28,3,7,2,35,0
The Huntsman Looks Absolutely Bonkers,1,1,5,28,0,4,0,33,0
Aziz Ansari Had The Best Joke At The Golden Globes,1,1,10,31,0,9,0,41,0
Stumped On Holiday Gift Ideas? Let Forbes' 30 Under 30 Alumni Help,1,3,10,39,2,11,4,49,0
Jennifer Lawrence And Her Itchy Butt Almost Killed Someone On 'Hunger Games' Set,1,3,13,53,2,12,0,66,0
23 Flaws Every Sneakerhead Has,1,1,4,20,0,4,2,24,0
14 Crazy Tricks That'll Actually Make You Warmer,1,1,7,31,1,7,2,38,0
17 DIYs For People Who Can't Keep Plants Alive,1,1,10,25,1,8,2,35,0
Health Insurers List Demands if Affordable Care Act Is Killed ,1,3,9,43,0,10,0,52,0
Are You More Llama Or Alpaca,1,1,6,17,0,5,0,23,0
25 Valentine's Day Gifts For The Most Important Person In Your Life (You),1,3,12,44,3,12,2,56,0
"31 Of The Funniest Moments To Ever Happen On ""Desperate Housewives""",1,1,10,43,2,10,2,53,0
18 Things Everyone With An Intense Fear Of Heights Can Relate To,1,1,11,40,0,11,2,51,0
"What ""Stitchers"" Character Are You Based On Your Zodiac Sign",1,1,10,39,2,9,0,49,0
"President Obama's ""Comedians In Cars Getting Coffee"" Episode Is Hilarious",1,1,10,51,3,9,0,61,0
27 Simple Costumes You Can Totally Make The Day Before Halloween,1,1,10,42,0,10,2,52,0
These Are the 10 Best Fashion Moments From Beyonce's 'B'Day Anthology Video Album',1,3,12,52,4,12,2,64,0
27 Life-Changing Products That Really Helped People With Acne,1,1,9,41,1,8,2,50,0
"17 Times Ben H. From ""The Bachelor"" Was Adorable On Instagram",1,1,10,36,3,10,2,46,0
The smart way to think about that trade deficit with Mexico,1,2,2,47,0,10,0,49,0
ESPN is laying off a bunch of its on-air talent,1,3,4,33,1,9,0,37,0
5 Ways To Empower And Engage Employees To Lead Change,1,3,9,34,0,9,1,43,0
What Music Do You Listen To While You Write,1,1,9,26,0,8,0,35,0
These Are the World's 50 Best Restaurants,1,2,5,27,1,6,2,32,0
This Man's Beautiful Story About His Wife Will Make You Believe In True Love,1,1,14,48,1,13,0,62,0
Newly found planet could be just right for life,1,3,1,38,0,8,0,39,0
A Brief Reminder That Norman Reedus Is Really Damn Fine,1,1,10,36,0,9,0,46,0
"Valerie Jarrett: Trump Victory Was ‘Soul-Crushing,’ ‘Punch to the Stomach’",1,3,9,49,7,9,0,58,0
Curt Schilling: I’d Be Voted in MLB HOF if I Said ‘Lynch Trump’,1,3,15,32,4,12,0,47,0
"After 40 Years, Maxine Hong Kingston’s Iconic Book, ‘The Woman Warrior,’ Still Resonates",1,3,12,56,6,12,2,68,0
A Closer Look Into The World Of India's Dog Pageants,1,1,10,32,1,9,0,42,0
15 Pictures That Accurately Sum Up Your Relationship With Your BFF,1,1,12,42,0,10,2,54,0
Four box office lessons Hollywood can learn from 2016,1,3,2,39,0,8,4,41,0
"This Mashup Of ""Love Yourself"" And ""Hands To Myself"" Is Really, Really Good",1,1,13,45,5,12,0,58,0
How To Make Veggie Stir-Fry That's Even Better Than Takeout,1,1,11,37,2,9,0,48,0
23 Recent Books By Women You Should Read ASAP,1,3,11,24,0,8,2,35,0
"Oscars 2017: Who will win, should win, and should have been nominated",1,3,2,49,3,11,4,51,0
Dutch IVF centre probes suspected sperm mix-up,1,2,4,35,1,6,0,39,0
Here's why golf balls have dimples,1,2,1,27,1,5,0,28,0
Here Are Twilight's Bella And Edward Gender-Swapped,1,1,8,35,2,6,0,43,0
The 10 things in advertising you need to know today,1,3,1,39,0,9,2,40,0
Scientists Make Doomsday Clock Announcement Video ,1,3,6,38,0,6,0,44,0
Build A Wedding And We’ll Tell You If You’re Single,1,3,10,30,2,9,0,40,0
Let's Talk About Peeing In The Shower,1,1,7,23,1,6,0,30,0
"Can't sleep? Insomniacs should try camping, say scientists",1,3,2,46,3,7,0,48,0
22 Hilarious Memes About Netflix’s “The OA”,1,3,7,25,3,6,2,32,0
19 Jokes About Period Sneezes That Are Fucking Perfect,1,2,8,36,0,8,2,44,0
We Need To Talk About American Thanksgiving,1,1,7,30,0,6,0,37,0
20 Things That Will Make Total Sense If You Lift Weights,1,1,10,34,0,10,2,44,0
Shah Rukh Khan Just Sent Paulo Coelho The Most Amazing Gift,1,1,11,38,0,10,0,49,0
We Know Your Age Based On The Words You Hate The Most,1,1,12,30,0,11,0,42,0
Deadpool 2: Director Tim Miller breaks silence over why he left the sequel,1,3,4,56,1,12,1,60,0
Thoughts During A Manicure,1,1,4,19,0,3,0,23,0
22 Things That Will Be Way Too Real If You're A Girl Who Likes Girls,1,1,14,37,1,14,2,51,0
"Inside Magic Leap, The Secretive $4.5 Billion Startup Changing Computing Forever",1,2,10,55,3,10,2,65,0
This Dog Has Kept Her Toy All Her Life And It's The Cutest,1,1,13,32,1,12,0,45,0
A look back at the life of Martin McGuinness,1,3,4,32,0,8,0,36,0
"UK teacher becomes one of youngest people to die from dementia, aged 40",1,2,2,54,1,12,2,56,0
"14 Perfect Holiday Gifts For The ""Community"" Fan In Your Life",1,1,10,37,2,10,2,47,0
30 Under 30 2017: The Young Innovators Redefining Marketing And Advertising,1,3,8,48,1,10,8,56,0
A Gaza ‘Tunnel Millionaire’ Falls on Hard Times ,1,3,7,31,2,8,0,38,0
"How ""The Martian"" Went From A Best-Selling Novel To A Blockbuster Film",1,1,13,43,3,11,0,56,0
Millions Of People Are In Love With This Elderly Man Waiting At The Airport,1,1,14,48,0,13,0,62,0
Asian Women Watched Asian Porn And They Were Horrified,1,1,9,37,0,8,0,46,0
20 Kids Who Are Definitely Going Places,1,1,6,25,0,6,2,31,0
Donald Trump's Tweets Reimagined as an Early '00s Emo Song,1,2,7,38,2,9,2,45,0
Here Are 8 Totally Different Ways To Relieve Stress,1,1,8,34,0,8,1,42,0
Which Movie Do You Think Is Most Honest About Depression,1,1,10,37,0,9,0,47,0
7 Facts You Can Blurt Out During Awkward Silences This Weekend,1,2,10,41,0,10,1,51,0
Your Taste In Emojis Will Reveal A Truth About Your Personality,1,1,11,42,0,10,0,53,0
This Man Went Abroad And Brought Back A Disease U.S. Doctors Had Never Seen,1,3,15,45,2,13,0,60,0
Marijuana Helped the World's Top Hedge Fund Gain 145%,1,3,7,33,2,8,3,40,0
What Is Your Favourite David Bowie Song Of All Time,1,1,10,32,0,9,0,42,0
This ‘Walking Dead’ shirt was banned from stores for racism,1,3,3,45,2,9,0,48,0
Santa Claus Sightings From Around The World Photos ,1,2,8,35,0,8,0,43,0
"Faulty appliances cause 12,000 fires, Which? research finds",1,2,2,42,3,7,5,44,0
Can You Tell If These Are Texts Or Sexts,1,1,9,23,0,8,0,32,0
Unlucky Seven: New Hong Kong Chief Gets Unfortunate Nickname,1,3,9,42,1,8,0,51,0
17 Jokes You’ll Only Understand If You’re Well Read,1,3,8,31,2,8,2,39,0
The science of being IMMORAL: Researchers find our brain at first views acts as 'impossible',1,3,9,66,3,14,0,75,0
Report: Obama Administration Spent $77 Million to Promote Obamacare in 2016,1,3,7,50,2,10,6,57,0
"How Well Do You Remember The First Episode Of ""Supernatural""",1,1,10,39,2,9,0,49,0
"How High Is Your ""Seinfeld"" IQ",1,1,7,16,2,5,0,23,0
24 Gifts All Drink Lovers Should Ask For This Year,1,1,9,30,0,9,2,39,0
Davos 2017: Teens' virtual reality challenge,1,3,2,31,2,5,4,33,0
"The $207 Phone Case Beyonce, Kendall Jenner, and Other Celebrities Are Obsessed With",1,3,11,55,3,12,3,66,0
23 Gendered Products That Prove How Truly Fragile Masculinity Is,1,1,9,44,0,9,2,53,0
Russell Westbrook defends Thunder teammates: 'Don't try to split us up',1,3,4,53,4,10,0,57,0
"Do You ~Have~ To ""Like"" That Picture",1,1,7,19,4,6,0,26,0
"The Economics of a New York City Blizzard, at $1.8 Million an Inch",1,3,8,41,3,12,2,49,0
"What ""Bro"" Really Means",1,1,4,14,2,3,0,18,0
16 Maharashtrian Foods You Need In Your Life Right Now,1,1,9,34,0,9,2,43,0
Destinations Revealed: The cheapest place for a last-minute half-term holiday,1,3,3,62,3,9,0,65,0
This Instagram Of People Putting Objects On Their Eyeballs Will Make You Cringe,1,1,13,54,0,12,0,67,0
Hate Hoax: Pro-Trump Students Cleared of Harassment Claims,1,2,8,41,2,7,0,49,0
Phillies surprise fan and his daughter with tickets to Autism Awareness game,1,3,3,62,0,11,0,65,0
"The Podesta Group Loses Alphabet, Google’s Parent Company, as Client",1,2,9,47,3,9,0,56,0
No Wonder the Republicans Hid the Health Bill ,1,2,6,32,0,8,0,38,0
'47 Meters Down' is the Mandy Moore shark movie we didn't know we wanted,1,3,4,50,3,13,2,54,0
We Know Your Favorite Disney Movie Based On Your Favorite Dog,1,1,11,40,0,10,0,51,0
23 Of The Bleakest Christmas Trees In The World,1,1,8,29,0,8,2,37,0
The New Hercules Looks Like A Leather Daddy With A Man Bun,1,1,12,35,0,11,0,47,0
This Year's Extreme Weather Was One For The Books,1,3,9,31,1,8,0,40,0
What's Your Subconscious Obsessed With,1,1,5,28,1,4,0,33,0
9 Totally Awesome Things You Didn't Realize You Could Do With Your Cool New Phone,1,1,14,51,1,14,1,65,0
Target Retailer Hits $15 Billion Loss Since Pro-Transgender Announcement,1,3,9,51,2,8,2,60,0
What Kind Of Introvert Are You,1,1,6,19,0,5,0,25,0
"5 Album Covers Kanye West Should Consider For ""Waves""",1,1,8,34,2,8,1,42,0
Why This 6th-Grade Girl Purposefully Broke Her School's Sexist Dress Code,1,2,11,49,2,10,1,60,0
Can You Match These Iconic Foods To Their Home States,1,1,10,34,0,9,0,44,0
Are You More Yuppie Or Hipster,1,1,6,19,0,5,0,25,0
David Bowie's Son Revealed He's Going To Be A Father With A Very Sweet Cartoon,1,1,15,47,2,14,0,62,0
"How Well Do You Remember Characters' Superpowers On ""Heroes""",1,1,9,40,3,8,0,49,0
"Seven Years Later, Mumbaikars Recall The Horrific Events Of The 26/11 Terrorist Attacks",1,1,12,57,2,12,4,69,0
Are You More Stark Or Lannister,1,1,6,20,0,5,0,26,0
19 Hilarious Tweets About Coachella That Will Make You Actually LOL,1,3,12,43,0,10,2,55,0
17 Texts Your Mom Has Definitely Sent You,1,1,7,25,0,7,2,32,0
People Are Dying Over This Hilariously Lazy Cashier Drawing In “The Proud Family”,1,2,13,54,2,12,0,67,0
12 Life Lessons The Barbershop Taught Me,1,1,6,26,0,6,2,32,0
Fast and Furious 8 early screening reactions: 'Another winning entry',1,3,3,53,3,9,1,56,0
McDonald's Cashier's Act Of Kindness Toward A Boy With Autism Is An Inspiration,1,2,14,51,2,12,0,65,0
These Three Questions Will Determine Which Kind Of Man Turns You On,1,1,12,44,0,11,0,56,0
Drake Performed At A Bat Mitzvah And Made Some Tweens Very Happy,1,1,12,41,0,11,0,53,0
19 Of Your Most Horrifying Thanksgiving Family Drama Stories,1,1,8,42,0,8,2,50,0
"Is your child struggling at school? Feed them kale, spinach and red meat if you want them to get top marks",1,2,2,82,2,20,0,84,0
Here's How To Make Bulleit Bread Pudding With Bourbon-Soaked Cherries,1,1,11,47,2,9,0,58,0
The lies of the right that debase civilised society,1,3,1,42,0,8,0,43,0
Family holidays Why our parents did holidays better than us,1,2,2,48,0,9,0,50,0
Britney Spears Songs Reimagined As Telenovelas,1,1,6,35,0,5,0,41,0
#FreeTheNipple Investigated By Naked Mike,1,1,7,29,1,4,0,36,0
Which Of These Cute Animals Would Kill You If They Had The Chance,1,1,13,40,0,12,0,53,0
This woman was threatened with murder because she uncovered her hair in Saudi Arabia The list,1,3,4,74,0,15,0,78,0
13 Small Victories For Anyone Going Home For The Holidays,1,1,9,37,0,9,2,46,0
Seattle Jogger Shares the 5 Self-Defense Tips She Drew On to Defeat Rapist,1,3,11,49,1,12,1,60,0
This Colour Test Will Tell You How Old You Really Are,1,1,11,32,0,10,0,43,0
Michael Bay Has Made A Real Tragedy Into A Dumb Action Movie,1,1,12,37,0,11,0,49,0
"I'm A Feminist, But I'm Not",1,1,6,13,3,5,0,19,0
50 Women Guaranteed To Make You Want Short Bangs,1,1,8,30,0,8,2,38,0
"This Kashmiri College Student Was Accused Of Planting Bomb In A DTC Bus In 2005, Only To Be Acquitted After 12 Years",1,3,22,66,1,21,6,88,0
"Years & Years' Cover Of ""Toxic"" Will Have You Dancing In Your Seat",1,1,12,38,4,12,0,50,0
20 Heartbreaking Confessions From People Who Called Off Their Weddings,1,1,9,50,0,9,2,59,0
Country Star Jason Aldean Wore Blackface On Halloween To Dress Up As Lil Wayne,1,1,14,51,0,13,0,65,0
How To Build Respect With Difficult People,1,3,7,29,0,6,0,36,0
"28 Moments That Will Make You Say ""Nice""",1,1,7,22,2,7,2,29,0
Clinton to Trump: You Cannot Speak of ‘Protecting Syrian Babies’ and ‘Close America’s Doors to Them’,1,3,12,67,6,15,0,79,0
23 Things All Work Best Friends Know To Be True,1,1,9,27,0,9,2,36,0
Who Will Design Melania Trump’s Inaugural Ball Gown?,1,3,8,35,2,7,0,43,0
17 Super-Necessary Hacks For Anyone With A Car,1,1,8,28,1,7,2,36,0
School Suspends 12-Year-Old Boy Attacked on Bus for Wearing a ‘Make America Great Again’ Hat,1,2,13,59,4,14,2,72,0
Calvin Harris Congratulated Taylor Swift With A Cute Instagram Post,1,1,10,48,0,9,0,58,0
9 Very Gross Food Choices You Need To Make,1,3,8,25,0,8,1,33,0
31 Apartment Hunting Tips Everyone Needs To Know,1,1,7,32,0,7,2,39,0
A Rescue Dog And Her Handler Who Worked At Ground Zero During 9/11 Were Honored With An Amazing Day,1,1,18,59,1,18,3,77,0
Top Flickr photos of 2016,1,3,2,15,0,4,4,17,0
It’s Not Just You. Americans Are Having Less Sex. ,1,3,9,29,3,9,0,38,0
"MSNBC’s Alter: Obama’s Not Most Anti-Israel President, Look At Iran Nuke Deal and Other Policies",1,3,19,58,5,14,0,77,0
"Disabled veteran, beaten for trying to save turtle's life, gets big surprise",1,2,1,61,3,11,0,62,0
This Crossword Is Full Of Fucked Up Celebrities,1,1,8,32,0,7,0,40,0
Parents Are Actually Using Drones To Pull Out Their Kids' Teeth,1,1,11,41,1,10,0,52,0
23 Times Amy Schumer Got Way Too Real About Being A Woman,1,1,11,33,0,11,2,44,0
This Quiz Will Determine What Song Is Your Personal Catwalk Jam,1,1,11,42,0,10,0,53,0
"The ""X-Files"" Cast On When Mulder Fell In Love With Scully",1,1,12,33,3,10,0,45,0
An Astronaut Just Tweeted Some Awe-Inspiring Photos Of South India From Space,1,1,13,52,1,11,0,65,0
This Guy Dressed As Aladdin Rode A Magic Carpet Through New York,1,1,12,41,0,11,0,53,0
What Retailers Can Do To Beat Amazon,1,3,7,23,0,6,0,30,0
McDonald's Cashier's Act Of Kindness Toward A Boy With Autism Is An Inspiration,1,3,14,51,2,12,0,65,0
27 Superhero Tweets Guaranteed To Make You Laugh Every Time,1,1,9,39,0,9,2,48,0
The Evolution Of Michael Clifford's Hair,1,1,6,28,1,5,0,34,0
What Would Disney Animals Look Like As Humans,1,1,8,30,0,7,0,38,0
2016: The Year of the Canada Fan,1,3,4,17,1,6,4,21,0
Can We Guess Your Favorite Beatle,1,1,6,22,0,5,0,28,0
17 Adorably SpooOOOooky Knits For Halloween,1,1,8,28,0,5,2,36,0
How to get free refills at Starbucks,1,2,2,28,0,6,0,30,0
26 Sex Toys That Actually Get The Job Done,1,3,8,24,0,8,2,32,0
13 Brutally Honest E-Cards For Anyone Who Loves Birth Control,1,1,10,39,1,9,2,49,0
23 Cleverly Creative Ways To Decorate Your Rented Apartment,1,1,8,41,0,8,2,49,0
Is Russia clamping down on Jehovah Witnesses?,1,3,4,34,1,6,0,38,0
12 Chili Recipes To Curl Up With This Fall,1,1,8,24,0,8,2,32,0
15 Next-Level Buffalo Snacks For Your Superbowl Party,1,1,8,35,1,7,2,43,0
"Which ""X-Files"" Character Are You Based On Your Zodiac Sign",1,1,11,36,3,9,0,47,0
This Woman Got Post-Mastectomy Tattoos To Reclaim Her Body After Breast Cancer,1,1,13,53,1,11,0,66,0
Name That Disney Fish,1,1,4,14,0,3,0,18,0
17 Times Americans Went Too Hard On Valentine’s Day,1,2,8,32,1,8,2,40,0
15 Crucial Holiday Storage Hacks That Will Make Your Life Easier,1,1,10,42,0,10,2,52,0
These Loyal Elephants Refused To Abandon Their Dead Friend After He Broke A Leg And Got Shot!,1,3,17,59,1,16,0,76,0
What Does Your Most-Used Emoji Say About You,1,1,9,27,1,7,0,36,0
Where are they now? The women tipped to make it in 'a man's world',1,3,2,47,4,13,0,49,0
UCLA Commit LaMelo Ball Gets Crossed to the Floor in California Playoff Game,1,3,14,50,0,12,0,64,0
"The Biggest Changes Obamacare Made, and Those That May Disappear ",1,2,9,45,1,10,0,54,0
"We Need To Talk About Lex Luthor In ""Batman V Superman""",1,1,11,32,2,10,0,43,0
"Here's How You Can Get Paid $16,000 to Lie in Bed All Day",1,3,10,27,3,12,5,37,0
19 Super Stylish Things So You Can Dress Like A Witch Every Damn Day,1,1,13,40,0,13,2,53,0
"21 Things The ""Harry Potter"" Video Games Taught Us About Life",1,1,10,37,2,10,2,47,0
13 Powerful Stories About College Students Living With Depression,1,1,8,47,0,8,2,55,0
17 Things You'll Understand If You're Addicted To Snacking,1,1,8,38,2,8,2,46,0
I Literally Can't Tell The Difference Between Nolte And Busey,1,1,10,41,1,9,0,51,0
Peter Thiel Obtained New Zealand Citizenship Possibly Because Of 'Exceptional Circumstances',1,3,11,69,2,10,0,80,0
Easy DIY Halloween Nails,1,1,6,15,0,3,0,21,0
Northern soul: a fashion showcase,1,3,1,27,1,4,0,28,0
It's official: Uber's Travis Kalanick and Emil Michael are actually the worst,1,3,6,57,3,11,0,63,0
"Beyonce-Adele's Powerful Grammys' Speeches, Taimur Ali Khan's New Pic & More From Ent!",1,2,13,54,7,12,0,67,0
DBS BankVoice: How To Live Luxe For Less,1,2,11,21,1,7,0,32,0
15 Stunning Gift Wrapping Ideas For The Minimalist In You,1,1,9,37,0,9,2,46,0
39 British Men Who Want To Rip Off Your Clothes Right Now,1,3,11,33,0,11,2,44,0
Everyone's Favourite Childhood Anthem Just Got An Epic Makeover,1,1,9,45,1,8,0,54,0
How Many Iconic '00s Films Have You Seen,1,1,7,23,1,7,2,30,0
This Picture Sums Up Why Wedding Guests Should Put Down Their Damn Phones,1,1,13,48,0,12,0,61,0
The company that makes America's engagement rings plans to open a bunch of stores and close even more,1,3,2,81,1,17,0,83,0
18 Times Britain Got Seriously Burned By Tumblr,1,1,7,31,0,7,2,38,0
This Electric Car Startup Is Missing Just One Thing: Cash,1,3,10,37,1,9,0,47,0
Can You Figure Out The Secret Texting Acronyms In This Crossword,1,1,11,43,0,10,0,54,0
We Know Your Age Based On Your Favorite Horror Movies And TV Shows,1,1,14,40,0,12,0,54,0
30 Online Shops Based In The Northeast You Should Be Shopping At,1,1,11,40,0,11,2,51,0
6 Ways To Get In Shape For 2016,1,1,6,13,0,7,5,19,0
This Is Actually The Best Way To Make A Turkey For Thanksgiving,1,1,12,40,0,11,0,52,0
"How to survive 2017: believe in protest, barricade your uterus and tax yourself",1,3,1,60,2,12,4,61,0
17 Away Messages Every Emo Kid Used In 2007,1,1,7,22,0,8,6,29,0
16 Real-Life Achievements For People Who Procrastinate,1,1,7,38,1,6,2,45,0
This March Madness team has a 'good luck charm' that will melt your heart,1,3,3,55,2,13,0,58,0
Why conservatives gave up fighting gay marriage,1,2,1,40,0,6,0,41,0
Men Are Injecting Their Balls With Botox in Disturbing New Trend,1,3,10,44,0,10,0,54,0
This Movie Trailer Perfectly Captures The Post-Grad Struggle Of Unemployment,1,1,11,55,1,9,0,66,0
Kerry Washington Said It's Important To Address Abortion On TV,1,1,11,41,1,9,0,52,0
Hug Haters Get Surprise Group Hugs,1,1,6,23,0,5,0,29,0
What's The Worst Gift You've Gotten,1,1,6,22,2,5,0,28,0
"Natalia Tena Sorts ""Harry Potter"" Characters Into ""Game Of Thrones"" Houses",1,1,11,49,4,10,0,60,0
"Noma Dumezweni Has Called Criticism Of Her Hermione ""Ignorant"" And ""Unimaginitive""",1,1,11,57,4,10,0,68,0
Wilkes-Barre Faces Heroin Scourge Turning It Into ‘the Most Unhappy Place in America’,1,3,12,58,3,12,0,70,0
"This woman's story is a lesson in why you should always, always listen to your girlfriend The list",1,3,2,77,2,17,0,79,0
21 Pictures That Will Make Every Dad Angry,1,1,7,26,0,7,2,33,0
11 Times The Indian Internet Literally Had Zero Chill,1,1,8,35,0,8,2,43,0
"I Just Noticed This About ""Easy A"" And My Mind Is Blown",1,2,12,30,2,11,0,42,0
27 Stunning Reasons To Get A Tim Burton Tattoo,1,1,8,28,0,8,2,36,0
This Cat Has The Best Selfie Game You'll Ever See,1,1,10,29,1,9,0,39,0
Large asteroid to hurtle past Earth on April 19,1,2,3,34,0,8,2,37,0
21 Candid Photos Of Old Hollywood Celebs,1,1,6,26,0,6,2,32,0
Who Is This Person's Famous Mom Or Dad,1,1,8,22,1,7,0,30,0
Jessica Williams And Phoebe Robinson Are Asking Hollywood To Shift Its Default,1,1,12,55,0,11,0,67,0
"Donald Trump travel ban: This time 'there should be no surprises', the administration says",1,3,3,70,4,13,0,73,0
GOP rep stands by controversial health care comments to mom,1,3,3,47,0,9,0,50,0
Migrant Stabs Bouncer at Gay Nightclub After Being Refused Entry,1,3,9,46,0,9,0,55,0
How Obsessed With Kitchen Gadgets Are You,1,1,7,28,0,6,0,35,0
CenturyLinkVoice: New Product Launch: Testing The Waters With Social Media,1,3,12,51,2,9,0,63,0
21 Signs You're Addicted To Your Goddamn iPhone,1,1,7,30,1,7,2,37,0
Have You Tried The Hot New Street Drug Zank,1,1,9,26,0,8,0,35,0
Source: Impending Layoffs Send ESPN Talent Into ‘Panic of Biblical Proportions’,1,2,13,53,3,10,0,66,0
19 Things People Who Love Going To Bed Early Will Understand,1,1,10,38,0,10,2,48,0
Tell Us Who You Think Wore It Best To The Emmys,1,1,11,26,0,10,0,37,0
27 Insanely Delicious Salads You Need For Thanksgiving,1,1,7,38,0,7,2,45,0
Good Morning America had an incredibly offensive way of introducing Hillary Clinton The list,1,2,6,73,0,13,0,79,0
Samsung estimates best profit in nearly 4 years despite turmoil,1,3,1,52,0,9,1,53,0
18 Pictures That Prove Offices Are The Grossest Places On Earth,1,1,10,41,0,10,2,51,0
Has Trump started a new deportation drive?,1,3,2,33,1,6,0,35,0
The 'Saved by the Bell' diner is coming to a city near you,1,2,3,41,2,12,0,44,0
How Many Of These Classic Chick Flicks Have You Seen,1,1,10,33,0,9,0,43,0
This Entrepreneur Started A Travel Company That Can Help You Quit Your Job,1,3,13,49,0,12,0,62,0
21 Times Tumblr Users Perfectly Explained What It's Like To Fight With Your Brain,1,1,13,52,1,13,2,65,0
"Ahsaan Qureshi Slams Sunil Grover, Twinkle Takes A Dig At Yogi Adityanath & More From Ent",1,3,15,57,2,15,0,72,0
23 Times Hayley Atwell Gave Us New Glamour Goals,1,1,8,30,0,8,2,38,0
The 17 Best Bars In Buenos Aires You Must Visit In 2016,1,1,10,28,0,11,6,38,0
21 Pictures That Will Make You Die A Little Inside,1,1,9,30,0,9,2,39,0
5 Times Madonna Was a Badass & Said Exactly What She Was Thinking,1,2,10,41,1,12,1,51,0
"Illegal Immigrant Accused of Repeatedly Raping, Kidnapping Autistic Woman",1,2,8,56,1,8,0,64,0
Mariah Carey has NYE performance fiasco ,1,2,5,29,0,6,0,34,0
23 Signs You're Completely Obsessed With YouTube,1,1,7,32,1,6,2,39,0
European debt crisis: It's not just Greece that's drowning in debt,1,2,3,50,3,10,0,53,0
29 Products To Help You Have The Organized Home Of Your Dreams,1,3,11,38,0,11,2,49,0
How Many Of 2015's Top-Selling Singles Can You Hum,1,1,9,27,2,8,4,36,0
Health trends not worth keeping in 2017,1,3,1,28,0,6,4,29,0
A few snow chances over the next week we need to keep our eye on,1,3,1,49,0,14,0,50,0
"17 ""Princess Bride"" Gifts You Need In Your Life",1,1,8,27,2,8,2,35,0
2016 was even worse than you thought because we lost these 14 great minds,1,3,0,54,0,13,6,54,0
Which Holiday Drink Are You,1,1,5,18,0,4,0,23,0
Three times North Korea nearly provoked the U.S. into war,1,3,5,41,2,9,0,46,0
18 Miyazaki Nail Art Designs That Will Blow You Away,1,1,9,32,0,9,2,41,0
Kim Noble And The Art Of Turning Suicide Into Theatre,1,1,10,34,0,9,0,44,0
What Does Your Favorite Musical Symbol Say About Your Personality,1,1,10,46,0,9,0,56,0
Evidence for one of the most bizarre theories about Trump is mounting The list,1,3,3,62,0,13,0,65,0
Mother’s Day 2017: The best fashion and beauty gifts,1,3,3,35,2,8,4,38,0
Seven 'Green' Buildings From Around The World Prove That Architecture Can Be Environment-Friendly,1,2,14,68,3,12,0,82,0
Mona Lisa Gives A Perfect Reply To Karan Johar's Remark On Her Marriage Being A 'Fake',1,2,16,52,3,15,0,68,0
Justin Bieber's Mystery Instagram Girl Crush Has Been Found,1,1,9,41,1,8,0,50,0
Which Amy Poehler Are You Based On Your Taste In Waffles,1,1,11,35,0,10,0,46,0
19 Photos That Won't Make Sense To Anyone Who Doesn't Wear Makeup,1,1,11,39,2,11,2,50,0
15 Times Michael Scott Was All Of Us Graduating From College,1,1,10,38,0,10,2,48,0
How Much Will You Earn Working From Home,1,1,8,25,0,7,0,33,0
"22 People Who Are Keeping ""Yolo"" Alive",1,1,6,22,2,6,2,28,0
23 T-Shirts That Are Guaranteed To Impress Any Cat Person,1,1,10,35,1,9,2,45,0
"12 ""Harry Potter"" Quotes That Could Totally Be About Your Desi Life",1,1,11,41,2,11,2,52,0
Japan's Startup Founders Are Flocking to This Seaside City in Japan,1,3,9,47,1,10,0,56,0
17 Dogs Who Just KNOW,1,1,7,8,0,4,2,15,0
14 Creative Ways To Reuse Empty Wine Bottles,1,3,7,28,0,7,2,35,0
27 Low-Carb Dinners That Are Actually Delicious,1,1,7,31,1,6,2,38,0
President Trump Quietly Rolling Back Obama-Era Gun Controls,1,3,9,42,1,7,0,51,0
18 Triggers People With Zero Patience Will Immediately Recognize,1,1,8,46,0,8,2,54,0
18 Ads From 1915 That Prove We've Come A Long Way In 100 Years,1,1,11,28,1,13,9,39,0
This is exactly how long until Donald Trump is no longer President The list,1,3,5,57,0,13,0,62,0
Leonardo DiCaprio Told Ellen About How He Almost Died On Two Separate Occasions,1,1,14,53,0,12,0,67,0
"We Got Advice From Margaret Cho, And It Was Just As Real As You'd Think",1,1,15,40,2,14,0,55,0
The Uruguayan jail where inmates set up shop,1,2,2,35,0,7,0,37,0
This One Emoji Question Will Decide What Job You Should Have,1,1,11,39,0,10,0,50,0
What's A Word Only Disney Fans Will Understand,1,1,8,30,1,7,0,38,0
"Here's What Matilda Would Have Been Like At Hogwarts, According To Mara Wilson",1,1,13,51,2,12,0,64,0
Bill Gates limits his children's use of technology,1,3,2,40,1,7,0,42,0
Kohl’s Stores Are Opening for 107 Hours Straight Before Christmas,1,3,8,44,1,9,3,52,0
24 Ways Chrissy Teigen Is Slaying The Pregnancy Game,1,1,8,34,0,8,2,42,0
"Kanye West Perfectly Responded To Drake's ""Nice Pool"" Lyric",1,1,9,39,3,8,0,48,0
Can You Make It Through 10 Rounds Of These Random Questions,1,1,10,37,0,10,2,47,0
We Know Your Zodiac Sign Based On Your Favorite Foods,1,1,10,34,0,9,0,44,0
If Cinderella Were Cuban-American,1,1,5,24,1,3,0,29,0
"These Kids Turned Their Bratz Dolls Into Rey From ""The Force Awakens""",1,1,12,44,2,11,0,56,0
31 Recipes That Prove You Should Be Making Thanksgiving Brunch Instead Of Dinner,1,1,12,54,0,12,2,66,0
'Anxiety Sensitivity' Is Real. Here's How To Know If You're Caught In This Spiral.,1,3,14,49,6,13,0,63,0
The One Way To Ask Someone Out,1,1,7,17,0,6,0,24,0
Tax Reform: Five Headlines You're Sure To Read,1,3,8,29,2,7,0,37,0
"If You’re Behind on Retirement Savings, Here’s How to Catch Up ",1,3,9,40,3,11,0,49,0
"Kesha Has A New Band Called ""Yeast Infection,"" So",1,1,9,29,3,8,0,38,0
Student Makeup Artists In London Take Halloween To A Whole Other Level,1,1,12,47,0,11,0,59,0
Woman's rare genetic disorder could hold the key to weight loss,1,2,1,51,1,10,0,52,0
Are You More Mario Or Link,1,1,6,15,0,5,0,21,0
The place where children can be very unlucky with their names,1,3,1,50,0,10,0,51,0
Cat Caught in Garage Door Saved by Deputy ,1,2,6,28,0,8,0,34,0
"A former model starved to death, but not from anorexia ",1,3,1,43,1,10,0,44,0
These Baby Koala Joeys Are Too Cute,1,1,7,22,0,6,0,29,0
In The Event Of My Untimely Disappearance,1,1,7,28,0,6,0,35,0
This photo of Earth peaking out between Saturn's rings will make you feel small,1,3,3,62,1,13,0,65,0
23 Sports Fans Who Made A Huge Mistake,1,1,7,22,0,7,2,29,0
"Nancy Sinatra Slams CNN, Congratulates Trump: ‘Why Do You Lie, CNN?’",1,2,15,37,6,10,0,52,0
The 50 Best Notorious B.I.G. Songs,1,2,7,17,3,5,2,24,0
24 Of The Most Powerful Photos Of This Week,1,1,8,25,0,8,2,33,0
A Mysterious Flash From a Faraway Galaxy ,1,3,6,28,0,7,0,34,0
Ten Ways to Get a Good Return on Your Cash (Stocks Not Included),1,3,10,40,2,12,0,50,0
The top 5 sources of salt in U.S. diet (potato chips didn't make the list),1,3,3,51,5,14,1,54,0
Will 'masala' bonds spice up the Indian economy?,1,3,2,36,3,7,0,38,0
Losing my job wasn't devastating because of a habit I built 6 years in advance,1,3,2,60,1,14,1,62,0
23 Cat Portraits That Describe Your Life Goals,1,1,7,30,0,7,2,37,0
19 Products All HGTV Obsessives Need,1,3,8,21,0,5,2,29,0
House Republicans Are Having The Worst Spring Break Ever,1,3,9,39,0,8,0,48,0
"17 Shocking Similarities Between ""Mean Girls"" And ""Angela Anaconda""",1,1,8,45,4,8,2,53,0
How the Carbon XPrize Is Turning Airborne Trash Into Treasure,1,3,10,42,0,9,0,52,0
Here's what happens to your brain and body when someone breaks your heart,1,3,1,59,1,12,0,60,0
This Impressions Sketch Gets So Real So Quick About Breakups,1,1,10,41,0,9,0,51,0
"Tamil Nadu Farmers Protest, Arms Racket Busted In Delhi And Other Must Read Stories",1,2,14,55,1,13,0,69,0
Are You Middle Class Enough to Deserve a Health Care Tax Break? ,1,3,10,41,1,12,0,51,0
What Movie Helped You During Your Depression,1,1,7,31,0,6,0,38,0
"13 Movies That Have Iconic Mermaids That Aren't ""The Little Mermaid""",1,1,10,43,3,10,2,53,0
Unsecured car falls off back of moving ferry into water,1,2,1,45,0,9,0,46,0
"The One Thing You Never Noticed About ""Home Alone""",1,1,9,31,2,8,0,40,0
How Many Food Court Places Have You Eaten At,1,1,9,27,0,8,0,36,0
"Another Round, Episode 39: The Betrayer Of The Patriarchy",1,1,8,37,2,8,2,45,0
Cheers! The secret to finding the perfect champagne this Christmas is choosing one with BIG bubbles,1,2,6,77,1,15,0,83,0
"24 Illustrations That Will Make You Really, Really Nostalgic About School",1,3,10,50,1,10,2,60,0
Detroit Rapper Molly Brazy Seen Pointing Gun at a Toddler’s Head in Video,1,3,10,50,1,12,0,60,0
What Angry Pop-Punk Christmas Song Are You,1,1,8,27,1,6,0,35,0
Stop trying to hush up the truth about election hacking,1,3,1,45,0,9,0,46,0
Hereâs what the liquid on top of your yogurt is â and why you should stop pouring it out,1,3,1,69,4,18,0,70,0
A Couple Did A Stunning Photo Shoot With Their Baby After Learning She Had An Inoperable Brain Tumor,1,1,18,65,0,17,0,83,0
A man has invented the most ridiculous way for women to deal with their periods The list,1,3,2,70,0,16,0,72,0
Warren Sapp doesn't think Myles Garrett is deserving of No. 1,1,3,5,43,2,10,1,48,0
"17 Gifs, Vines And Pictures That Prove Magic Is Legit Real",1,1,10,35,1,10,2,45,0
"In Fake News Era, Facebook Still Struggling With Bogus Ads",1,2,10,38,1,9,0,48,0
Are You Super Dramatic Or Super Chill,1,1,7,24,0,6,0,31,0
12 Horrifyingly Cute Zombie Treats You Can Actually Make,1,1,8,38,0,8,2,46,0
Can You Guess Which Drugstore Makeup Product Costs The Most,1,1,10,40,0,9,0,50,0
Katy Perry Vs. A Brazilian Fan Who Is Probably Rolling,1,1,10,34,1,9,0,44,0
17 Horrible Pairs Of Tube Socks That Need To Be Stopped,1,1,10,33,0,10,2,43,0
15 fantastic non-toy gifts for the holidays,1,2,0,34,1,6,2,34,0
15 Life Changing Beauty Products You Need,1,1,6,27,0,6,2,33,0
Not Able To Sleep Well At Night? Here Are 6 Things People Actually Do For A Good Night's Rest,1,2,18,54,2,18,1,72,0
Children Who Lost Parents In 9/11 Sent A Powerful Message Of Hope To Paris,1,1,13,44,1,13,3,57,0
Here's How To Actually Do A Killer Abs Workout In Just 15 Minutes,1,1,12,38,1,12,2,50,0
'The Voice' Crowns Season 11 Winner,1,2,5,21,2,5,2,26,0
Ever Wondered Why Some People Snore And Some Don't? Here's Your Answer To What Causes Snoring,1,2,16,59,3,15,0,75,0
"Mixed message: 84 Lumber's Super Bowl ad spurs outrage, confusion ",1,3,4,47,3,10,2,51,0
"Obama Has Refused to Deport 820,000 Illegal Immigrants Guilty of Murder, Rape, Drug Offenses, and Other Crimes",1,2,13,71,4,16,6,84,0
17 Truths Only People Who Adore Wine Could Possibly Understand,1,3,9,42,0,9,2,51,0
People Are Trolling Sean Spicer on Venmo With Hilarious Requests,1,3,9,46,0,9,0,55,0
The money-making secrets that rich people swear by (and they're VERY simple to follow once you know what they are) ,1,3,5,86,4,20,0,91,0
Watch Deepika Padukone Make Fun Of Ranbir Kapoor For Being Terrible At The Internet,1,1,14,56,0,13,0,70,0
"27 Random As Hell Photos That Will Make You Miss ""TRL""",1,1,12,28,2,10,2,40,0
"If ""Back To The Future"" Were Actually Set In 2015",1,1,9,25,2,9,4,34,0
19 Reasons Why Morning People Need To Be Stopped,1,3,8,30,0,8,2,38,0
We Know Which Cute Baby Panda GIF You Need To See Today,1,1,14,30,0,11,0,44,0
The 40 Most Important Corgis Of 2015,1,1,5,19,0,6,6,24,0
This Woman Sneaking Pictures Of The Rock's Butt Is Human Goals,1,2,11,40,1,10,0,51,0
Americans Try Hong Kong Desserts For The First Time,1,1,9,34,0,8,0,43,0
"Here's What The New ""Filled Cupcake"" Oreo Flavor Tastes Like",1,1,10,38,3,9,0,48,0
What Percentage Dog Are You,1,1,5,18,0,4,0,23,0
Can We Guess How Big Your Boobs Are,1,1,8,20,0,7,0,28,0
Scotch Experts Review Cheap Whiskey,1,1,5,26,0,4,0,31,0
Health care could be behind Canada's longer life expectancy,1,2,2,48,1,8,0,50,0
International Women's Day: Meet the grannies going to school,1,3,4,46,2,8,0,50,0
"Credit Suisse Says Plan to Hire 10,000 Muslim Refugees Is Hurting Starbucks’ Brand and Sales",1,3,12,59,2,14,5,71,0
"Here Are The Actual Places On Mars Where ""The Martian"" Is Set",1,1,12,36,2,11,0,48,0
Find Out Your Badass Harry Potter Roller Derby Name,1,1,9,34,0,8,0,43,0
"These People In Thailand Singing ""Happy Birthday"" To Ganesha Is The Cutest Thing Ever",1,1,14,56,2,13,0,70,0
Reports: Democrat Anthony Weiner Facing Child-Porn Charges,1,3,8,42,2,6,0,50,0
Warring neighbours delight internet with intense 'sign war',1,2,1,49,2,7,0,50,0
Jennifer Garner ‘Looking Forward to Helping’ President Trump,1,3,7,44,2,7,0,51,0
Richard Madden Looking Attractive On A Horse,1,1,7,31,0,6,0,38,0
"Which ""Shameless"" Character Are You Based On Your Zodiac Sign",1,1,10,40,2,9,0,50,0
Pelosi: ‘I Think the Press Were Accomplices in the Undermining of Our Election’,1,3,9,55,3,12,0,64,0
EXCLUSIVE – Clinton Sex Accusers Slam ‘Hypocritical’ Media over Bill O’Reilly Coverage,1,3,19,52,4,11,0,71,0
The Two Ways You Look At Yourself In The Mirror,1,1,10,28,0,9,0,38,0
17 Paleo Breakfasts That Are Actually Delicious,1,1,6,33,0,6,2,39,0
11 Beautiful Fucking Baby Names I Made Up,1,1,7,25,0,7,2,32,0
LeBron James issues warning shot to outspoken LaVar Ball,1,3,6,42,0,8,0,48,0
These Are the Worst Airports in America,1,2,5,28,0,6,0,33,0
6 Google products and services you never even knew existed,1,3,1,47,0,9,1,48,0
Improve Your Life In 2016 With A BuzzFeed Life Challenge,1,1,10,33,0,9,4,43,0
"Taking the Pill can trigger mood swings and make women miserable, 'alarming' research shows",1,3,2,73,3,13,0,75,0
Is 2016 The Year You Stop Being Single,1,1,7,20,0,7,4,27,0
12 Indian Webcomics Every Twentysomething Should Be Reading Right Now,1,1,9,49,0,9,2,58,0
Juan Williams: Dems Run the Risk of Looking Like ‘Hypocrites’ for Not Accepting Election Results,1,3,12,67,3,14,0,79,0
Here's Why You Actually Bruise So Easily,1,1,7,26,1,6,0,33,0
19 Celebrities Open Up About Dealing With Their Eating Disorders,1,1,9,44,0,9,2,53,0
"The Cast Of ""Zoey 101"" Basically Just Dropped A Bombshell",1,1,9,34,2,9,3,43,0
Couples Photoshop Each Other,1,1,4,21,0,3,0,25,0
Apple updates iPhone & Mac software,1,2,3,26,1,5,0,29,0
17 Glitches So WTF They'll Make You Laugh Uncontrollably,1,1,10,35,1,8,2,45,0
This New Infographic Shows Exactly Why You Need To Get Tested,1,1,11,40,0,10,0,51,0
The 26 Funniest #UrbanOutfittersBeLike Tweets,1,1,7,31,1,4,2,38,0
Oscars 2017: A breakdown of the audience reactions to La La Land-Moonlight Best Picture blunder,1,3,8,67,2,14,4,75,0
This Beautiful Video Explores The Lighter Side Of Being A Member Of The Indian LGBTQ Community,1,1,20,59,0,15,0,79,0
19 Fabulous Hacks To Make Your Shoes Look And Fit Perfectly Every Time,1,1,12,44,0,12,2,56,0
Sometimes Jessica Chastain Just Pretends She Is Bryce Dallas Howard,1,1,10,48,0,9,0,58,0
31 Ridiculously Delightful Gifts You Can Make Yourself,1,1,7,38,0,7,2,45,0
The U.S. and Australia keep each other safer. Here’s how.,1,3,5,38,5,9,0,43,0
16 Weird Relationship Milestones,1,1,3,24,0,3,2,27,0
Who is Donald McGahn?,1,3,4,13,1,3,0,17,0
Selena Gomez & The Weeknd Snuggle Up in Sweet Instagram Selfie,1,3,9,42,1,10,0,51,0
"How Well Do You Remember The First ""Harry Potter"" Movie",1,1,10,34,2,9,0,44,0
"Ramadan 2015: As holy month approaches, debate emerges over how long Muslims in northern Europe should fast",1,2,4,81,2,16,4,85,0
Can You Solve These Logic Riddles,1,1,6,22,0,5,0,28,0
18 Texts From Moms That Have NO IDEA What They're Doing,1,1,14,28,1,10,2,42,0
What Should Every Tourist Know Before Coming To London,1,1,9,37,0,8,0,46,0
Chris Long Says He Won't Visit White House to Honor Super Bowl 51 Win,1,2,12,41,1,13,2,53,0
51 Rock Albums That Early 2000s Teens Listened To,1,3,7,28,0,8,6,35,0
This mystifying metal is liquid like mercury but safe to touch with bare hands,1,3,1,64,0,13,0,65,0
"WTF, It Looks Like This Twitter Account “Predicted” Beyoncé’s Pregnancy Announcement",1,2,13,57,4,10,0,70,0
"Cops Break Into Car To Free 'Frozen' Elderly Woman, Find It's A Mannequin",1,2,13,44,4,12,0,57,0
The Toddler Who Was Devastated To Find Out That Adam Levine Is Married Has Finally Met Him,1,1,17,57,0,16,0,74,0
How Stereotypically Twentysomething Are You,1,1,5,34,0,4,0,39,0
"19 Times ""Lizzie McGuire"" Was The Realest Teen Show On TV",1,1,12,31,2,10,2,43,0
29 Faces You'll Immediately Recognize If You've Ever Been To The Gyno,1,1,11,43,2,11,2,54,0
"A Pair Of Twins Got Married To Another Pair Of Twins, Officiated By A Pair Of Twins",1,1,17,49,1,16,0,66,0
This Artist Turns Pantone Colors Into Delicious Smoothies,1,1,8,42,0,7,0,50,0
"Which Guy From ""Are You The One?"" Would Be Your Perfect Match",1,1,12,35,3,11,0,47,0
Mark Zuckerberg Just Answered The Question That Every Facebook User Has Wanted To Ask Him,1,1,15,60,0,14,0,75,0
Britney Spears Googled A Picture Of Corn To Post On Instagram,1,1,11,40,0,10,0,51,0
Woman Allegedly Texts Boyfriend by Mistake About Waxing Entire Body to Cheat on Him,1,3,11,59,0,13,0,70,0
If Harry Potter Book Titles Were Honest,1,1,7,26,0,6,0,33,0
"23 ""X-Files"" Gifts That Are Out Of This World",1,1,9,23,3,8,2,32,0
Copper Prices Zigzagged Wildly When Almost No One Was Trading,1,3,10,42,0,9,0,52,0
Did You Get Engaged In The Past 24 Hours,1,1,8,22,0,8,2,30,0
You can now order a Trump troll doll and it's very NSFW,1,3,6,37,1,11,0,43,0
Can We Guess Your Age Based On Which Colors Your Choose,1,1,11,34,0,10,0,45,0
11 Non-Human Disney Characters Who Made You Feel Things ~Down There~,1,1,11,42,3,10,2,53,0
"Yes, LaVar Ball is ridiculous ... and college basketball could use more people like him",1,2,4,65,4,14,0,69,0
Everything You Need to Know About the Executive Order on Sanctuary Cities ,1,2,9,53,0,12,0,62,0
Bearded Women Kiss Their Boyfriends To Show Men How It Feels To Kiss A Beard,1,1,15,47,0,14,0,62,0
How Technology Is Driving Logistics This Holiday Season,1,3,8,40,0,7,0,48,0
The 25 Most Powerful Passports in the World,1,3,5,29,0,7,2,34,0
Snape Is Probably Still Alive & This Fan Theory Proves It,1,2,10,36,1,10,0,46,0
24 Perfect Gordon Ramsay GIFs Perfect For Every Situation,1,1,10,37,0,8,2,47,0
Which TV Character Alter Ego Are You,1,1,8,22,0,6,0,30,0
"Two Women Get Into Wild Brawl In Walmart Shampoo Aisle, Child Joins In",1,3,13,44,1,12,0,57,0
Here's Everything You Need To Know About Renters Insurance,1,1,9,40,1,8,0,49,0
Who Is Your Celeb BFF Based On Your Birth Month,1,1,12,26,0,9,0,38,0
21 Dads Who Were Clearly Meant To Be Dads,1,1,8,23,0,8,2,31,0
13 TV Shows All Political Junkies Should Watch,1,1,8,29,0,7,2,37,0
"17 People Who Thought Bryan Adams Covered Taylor Swift's ""1989""",1,1,8,37,3,9,6,45,0
Why Green Lantern can still recover and become the multi-movie franchise we deserve,1,2,3,67,1,12,0,70,0
"Watch What Happens When Teens React To ""Back To The Future Part II""",1,1,14,39,2,12,0,53,0
This May Be The First Couple To Have An Official Wedding Hashtag,1,1,12,41,0,11,0,53,0
"Someone Made Elsa The Villain Of ""Frozen"" And It's Everything",1,1,10,39,3,9,0,49,0
What India’s Microloan Meltdown Taught One Entrepreneur ,1,3,7,41,1,7,0,48,0
"Which Evan Peters Character Are You From ""American Horror Story""",1,1,10,43,2,9,0,53,0
Hillary Clinton Absolutely Burns Michael Flynn With A Single Tweet,1,3,10,47,0,9,0,57,0
Sessions: Improper Tax Credit Payments to ‘Mostly Mexicans’ Could Fund Border Wall,1,3,11,57,3,11,0,68,0
30 Things Girls Who Are Always Cold Understand,1,1,7,30,0,7,2,37,0
Rihanna Released A New Song But The Internet Can't Understand The Words,1,1,12,47,1,11,0,59,0
We Know Which Food Is Your Bae With This One Question,1,1,11,32,0,10,0,43,0
Ammo Ban: The Obama Administration’s ‘Parting Shot’ at Hunting Community,1,3,9,50,4,9,0,59,0
25 Things Kylie Jenner Does On Instagram That Most People Can't,1,1,10,40,1,10,2,50,0
Era of Email Overload May Never Arrive in Myanmar,1,3,7,34,0,8,0,41,0
Can You Look At These Wedding Photos Without Yelling OMG WTF NO,1,1,17,35,0,11,0,52,0
13 Art History Hotties You'll Want To Fuck,1,1,7,25,1,7,2,32,0
Just Foolin’ Around: 7 Books From Comics and Humorists ,1,3,7,36,2,9,1,43,0
How to make Dorie Greenspan’s cheese and bacon apéro quick bread,1,3,3,50,1,10,0,53,0
Canadians In The Prairies Are Cracking Jokes Because It's Laughably Cold,1,1,11,50,1,10,0,61,0
What's The Strangest Way You've Lost A Tooth,1,1,8,27,2,7,0,35,0
Can We Guess How Many Times You Had Sex In 2015,1,1,10,23,0,10,4,33,0
25 Adorable Animals To Brighten Your Day,1,1,6,26,0,6,2,32,0
"No More Cash Withdrawal Restrictions, Crorepatis Dominate UP Assembly And Other Must Reads",1,3,14,63,1,12,0,77,0
A machine that used to be considered punishment is now a $1.4 billion fitness industry,1,3,1,67,2,14,2,68,0
21 Ways To Use Chocolate And Strawberries Outside Of The Bedroom,1,1,10,42,0,10,2,52,0
Two Female Texas Teachers Accused of Middle School Sex,1,3,8,38,0,8,0,46,0
30 Things You Need To Know About Rob Schneider,1,1,8,28,0,8,2,36,0
Why Didn't Drake And Steph Curry Invite Us To In-N-Out Burger Last Night,1,1,15,42,3,12,0,57,0
What Do You Want To See On BuzzFeed's Snapchat Story,1,1,11,31,1,9,0,42,0
The Most Confident Yearbook Photos Of All Time,1,1,8,31,0,7,0,39,0
26 Questions Cats Just Need To Answer,1,1,6,23,0,6,2,29,0
17 Confessions From People Who Struggle To Save Money,1,1,8,35,0,8,2,43,0
32 Pictures That Will Take You Back To When Life Was So Damn Simple,1,3,13,39,0,13,2,52,0
"19 Confessions From People Who Are ""Defining The Relationship""",1,1,8,42,2,8,2,50,0
Obama’s Organizing for Action Throws Fire Sale: 60% Off ‘Don’t Tread on My Obamacare’ Bumper Sticker,1,3,13,64,6,15,2,77,0
"Bollywood Is Cheering For Priyanka Chopra's ""Quantico"", And It's The Cutest Thing Ever",1,1,13,56,5,12,0,69,0
This Quiz Will Answer What You Should Give Up For Lent,1,1,11,33,0,10,0,44,0
"Ugh, Facebook, don't give us even more tabs",1,3,2,31,3,7,0,33,0
Republicans divided over how to help people buy health insurance,1,3,1,54,0,9,0,55,0
13 Charts That Will Make Total Sense To People With Impostor Syndrome,1,1,11,45,0,11,2,56,0
54 Leather Bags That Are Actual Leather And Actually Affordable,1,1,9,43,0,9,2,52,0
17 Of Life's Most Awesome Moments,1,1,5,20,1,5,2,25,0
47 Things Everybody Did While Twitter Was Down,1,1,7,30,0,7,2,37,0
"12 Valentine's Day Cards To Help You Say ""Bae Mine""",1,3,9,28,3,9,2,37,0
Can You Make It Through These GIFs Of Smiling Actors Without Squealing,1,1,14,45,0,11,0,59,0
"If You Are Super Rich, You Probably Live in the U.S.: Chart",1,3,11,33,4,11,0,44,0
Can We Guess Who Your Celebrity Spirit Guide Is Based On These 3 Questions,1,1,13,47,0,13,1,60,0
How Merriam-Webster stays relevant in national conversations,1,2,3,50,1,6,0,53,0
"How Well Do You Remember The Second Season Of ""The Simpsons""",1,1,11,37,2,10,0,48,0
7 Ways Life Is Just One Big Game Of Tetris,1,1,9,23,0,9,1,32,0
Assaults on Border Patrol Agents Up 143 Percent,1,2,6,31,0,7,3,37,0
"Brie Larson's Response To Being Called An ""It Girl"" Will Make Your Day",1,1,13,42,3,12,0,55,0
‘Everything is destroyed’: A deadly surge of violence strikes eastern Ukraine,1,3,3,61,3,10,0,64,0
Star-Studded Guest List Set for Obama’s Final White House Bash,1,2,10,41,2,9,0,51,0
"Trump Immigration Order Marks Worst Day ‘Since Japanese Internment’, Says Seattle Mayor",1,2,12,61,3,11,0,73,0
Apprehensive Putin Says No To 'Diplomatic Dog' Gifted By Japan's PM Shinzo Abe,1,3,14,49,3,12,0,63,0
Syria: Here's what you need to know about Trump's strike on air base,1,3,3,50,3,12,0,53,0
The New And Improved Eva Longoria,1,1,6,22,0,5,0,28,0
EastEnders: every Christmas knees-up and punch-up – ranked,1,3,3,44,4,7,0,47,0
Sudden Weather Change Brings Snowstorm To UAE And Other Gulf States,1,2,13,44,0,10,0,57,0
Cara Delevigne's Dog Had A More Glamorous Day Than Most Of Us Ever Will,1,1,14,43,1,13,0,57,0
"Kendall Jenner, Gigi, And Bella Hadid Are Transforming Into Supermodels Before Our Eyes",1,1,13,60,2,12,0,73,0
25 Gifts For The Ultimate Wine Lover In Your Life,1,1,9,29,0,9,2,38,0
People Are Dying Over This Hilariously Lazy Cashier Drawing In “The Proud Family”,1,3,13,54,2,12,0,67,0
Grammys 2017: What to Watch For ,1,2,4,17,1,6,4,21,0
Watch One Man Get Transformed Into Three Tim Burton Characters,1,1,10,43,0,9,0,53,0
"Tebow Launches Several Homers in Batting Practice, During First Day of Mets Spring Training",1,2,12,65,1,13,0,77,0
"Michelle Gomez Took Our ""Which Doctor Are You"" Quiz",1,1,9,32,2,8,0,41,0
There will only be one loser in the aftermath of Obama's attack on Israel – the United Nations,1,3,5,70,2,17,0,75,0
"Dude, Here's How To Make Your Clothes Last Longer",1,1,9,30,2,8,0,39,0
25 Amazingly Cool Gadget Gifts You May Want To Keep For Yourself,1,3,11,40,0,11,2,51,0
"23 Funny Tweets Only ""The Sims"" Fans Will Get",1,1,8,25,2,8,2,33,0
Great white shark attacks boat in real life Jaws moment,1,2,2,44,0,9,0,46,0
‘Gilmore Girl’ Lauren Graham on Growing Up Around the World,1,3,8,40,2,9,0,48,0
12 Charts That Explain What It's Like To Date Every Zodiac Sign,1,1,11,38,1,11,2,49,0
"There's A Crazy Dessert Trend This Year Called ""Piecaken""",1,1,9,37,3,8,0,46,0
23 Sins Everyone Who Grew Up Drinking In Britain Has Committed,1,1,10,40,0,10,2,50,0
"Drop Everything: Demi Lovato Covered Adele's ""Hello""",1,1,7,35,4,6,0,42,0
Can We Guess Your College Major With Random Questions,1,1,9,36,0,8,0,45,0
‘Don’t play identity politics!’ The primal scream of the straight white male,1,3,2,59,4,11,0,61,0
"18 Confessions That Prove You're Not Alone In Your ""The Bachelor"" Obsession",1,1,11,48,3,11,2,59,0
28 Makeup Charts That'll Make Your Life So Much Easier,1,1,9,33,1,9,2,42,0
Jake Gyllenhaal makes it clear he doesn't want to talk about Taylor Swift in awkward interview,1,3,4,74,1,15,0,78,0
This Surprising Video Shows How Depression Isn't Always Obvious,1,1,9,45,1,8,0,54,0
You Could Be Entitled To $25 If You Bought Starkist Tuna In The Past Six Years,1,1,15,45,1,15,2,60,0
These currencies got crushed in 2016,1,3,1,26,0,5,4,27,0
"Stop What You're Doing And Listen To This Hilarious ""Golden Girls"" Remix",1,1,12,46,3,11,0,58,0
"The Guy Who Wrote ""Hamilton"" Also Wrote The New ""Star Wars"" Cantina Song",1,1,13,43,4,12,0,56,0
28 Kids Whose Futures Burn As Bright As The Sun,1,1,9,27,0,9,2,36,0
"16 Tweets, Memes, And Reactions That Capture Modi's Surprise Visit To Pakistan",1,1,11,51,3,11,2,62,0
We Gave Up Masturbation For A Month And It Completely Changed Us,1,1,12,41,0,11,0,53,0
UPDATE: The 'Serial' Team Is Releasing A New True-Crime Show You'll Inevitably Binge,1,3,19,48,5,12,0,67,0
Going Home For Thanksgiving Expectations Vs. Reality,1,1,7,38,1,6,0,45,0
17 Times The Internet Told The Truth About Money,1,1,8,30,0,8,2,38,0
Here's Why You Actually Get Depressed In The Winter,1,1,9,33,1,8,0,42,0
"Schools Are Warning Parents About ""13 Reasons Why""",1,3,7,32,2,7,2,39,0
The one question that will let you instantly read someone's personality The list,1,3,2,65,1,12,0,67,0
Speaker Paul Ryan’s Approval Rating Plummets as He Fails to Deliver for President Trump,1,3,11,62,1,13,0,73,0
Watch Mike Pence try to defend Trump’s false claim that ‘millions’ voted illegally,1,3,4,63,3,12,0,67,0
What's The Best Healthy Recipe You Made This Year,1,1,9,31,1,8,0,40,0
"Emma Watson Was Told Not To Use The Word ""Feminism"" During A Speech About Equality",1,1,15,51,2,14,0,66,0
SA power: What is load shedding and why is it happening?,1,3,3,41,2,10,0,44,0
ALERT: Pierce Brosnan Is Looking Hotter Than Ever,1,1,12,29,1,7,0,41,0
"The First Semester Of College, As Told By My Bar Mitzvah Pictures",1,1,12,41,1,11,0,53,0
Saving the Easter bunnies of the Brecks,1,2,3,30,0,6,0,33,0
19 Times Zac Efron Proved He's An Insta-God,1,1,8,24,2,7,2,32,0
15 Beautiful Stories From People Who Met Their Soulmates At Black Colleges,1,1,11,50,0,11,2,61,0
"The Hardest ""True Or False"" Space Quiz You'll Take Today",1,1,10,34,3,9,0,44,0
'The Rock' Reduced A Roomful Of People To Tears When He Reunited A Military Family On A Show!,1,3,18,55,3,17,0,73,0
Five Secrets For Public Speaking Success,1,3,6,29,0,5,0,35,0
Netflix UK and US - new in February 2017: From Santa Clarita Diet to American Crime Story: The People v OJ Simpson,1,2,18,68,3,21,4,86,0
This Hilarious Photo Series Highlights How Much Cricket Has Changed Over The Years,1,1,13,57,0,12,0,70,0
Weird Thoughts You Have At The Dentist,1,1,7,25,0,6,0,32,0
What's really in that weed? - CNN Video,1,3,5,24,3,7,0,29,0
Are You More Empire Or More Rebellion,1,1,7,24,0,6,0,31,0
Vin Diesel and Dwayne Johnson's 'The Fate of the Furious' Feud: A Complete Timeline,1,3,11,55,4,13,0,66,0
Russian teenagers 'set on fire' while trying to take the 'ultimate selfie' on train roof,1,3,1,69,4,14,0,70,0
Americans Try Canadian Candy For The First Time,1,1,8,32,0,7,0,40,0
Here's What To Listen To While You Wait For Your Fave's Next Album,1,1,13,39,2,12,0,52,0
NYT Calls for Transgender Education in Emergency Rooms,1,3,8,39,0,7,0,47,0
19 Things American Teens Had That British Girls Were Insanely Jealous Of,1,1,11,48,0,11,2,59,0
Do You Need A New Best Friend,1,1,7,16,0,6,0,23,0
Watch This Teenager's Emotional Reaction To Waking Up From Heart Surgery,1,1,11,50,1,10,0,61,0
AG Sessions: Sanctuary Cities That Fail to Comply with Immigration Laws Risk Losing Federal Dollars,1,3,14,70,1,14,0,84,0
What's Up With These Pitch Perfect 3 Cast Photos?,1,3,8,30,2,8,1,38,0
25 Marvelous Gifts That'll Make You A Better Person,1,1,8,32,1,8,2,40,0
Horoscopes For The Week Of December 7,1,1,6,24,0,6,1,30,0
A Year of Surprises: A Look Back at NBC News’ Best Features of 2016,1,3,12,36,2,13,4,48,0
"Do You Remember ""Northern Downpour"" By Panic! At The Disco",1,1,10,36,3,9,0,46,0
19 Things Only Indecisive People Will Understand,1,1,6,34,0,6,2,40,0
How Dad Is Your Dad,1,1,5,10,0,4,0,15,0
Are YOU suffering from midlife malnutrition? How your FACE reveals the nutrients your body really needs ,1,3,9,78,1,16,0,87,0
Man unearths dad's never-before-seen footage of JFK,1,2,4,38,3,6,0,42,0
All The Big Winners From The 2016 Grammy Awards,1,1,8,27,0,8,4,35,0
"Ryan Reynolds Really Didn't Mind Being Nude On The ""Deadpool"" Set",1,1,11,41,3,10,0,52,0
Bad Lip Reading Nails It Again with Look Back at 2016 NFL Season,1,3,12,36,0,12,4,48,0
13 Body Positive Instagram Accounts You Need To Be Following,1,1,9,40,0,9,2,49,0
24 Tweets That'll Make You Feel Better About Your Student Debt,1,1,10,39,1,10,2,49,0
What I’m really thinking: the professor’s wife,1,2,2,35,3,6,0,37,0
Facebook Is Going Wild For This Organist Paying An Emotional Tribute To David Bowie,1,1,14,56,0,13,0,70,0
VMwareVoice: Making Spirits Bright: Top Mobility Trends This Holiday Season,1,3,12,52,2,9,0,64,0
Kids Battling Cancer Board Flight to the North Pole - Yahoo,1,3,8,40,1,10,0,48,0
"Bad News For Yusuf Pathan, BCCI Revokes No Objection Ceritificate Which Would Allow Him To Play In Hong Kong",1,3,22,67,1,18,0,89,0
19 Snapchats Only People In L.A. Would Send,1,1,8,24,2,7,2,32,0
When You Can't Tell If He's Gay Or Metro,1,1,9,21,2,8,0,30,0
Watch: Greg Maddux goes incognito to prank Kris Bryant,1,2,5,40,1,8,0,45,0
"In the Face of A.L.S., Simon Fitzmaurice Finds His Fire Inside ",1,2,11,37,4,11,0,48,0
EU split over pace of reform as crisis bites,1,3,2,34,0,8,0,36,0
"The IRS’s Annual Report Card Is In, and It Isn’t Pretty",1,3,12,30,3,10,0,42,0
"Are You More ""In The Heights"" Or ""Hamilton""",1,1,8,24,4,7,0,32,0
"Inside Syria Part 3: Last Hospital Destroyed, Aleppo Faces Biggest Bloodbath In Recent History",1,2,13,65,2,13,1,78,0
12 Maps Only British People Will Find Funny,1,1,7,27,0,7,2,34,0
"Which Character From ""The Flash"" Should You Marry",1,1,8,32,2,7,0,40,0
Can You Pet The Right Cat,1,1,6,14,0,5,0,20,0
21 Winter Tips To Trick People Into Thinking You’re Stylish,1,3,9,38,1,9,2,47,0
Hillary Clinton Absolutely Burns Michael Flynn With A Single Tweet,1,2,10,47,0,9,0,57,0
"Apple release 'Clips', a Snapchat-like app that could signal its augmented reality ambitions",1,3,3,73,4,12,0,76,0
16 Things Filipinos Say Vs. What They Actually Mean,1,1,8,32,1,8,2,40,0
"So Excited About Snap! But, Ummm, What’s an IPO Again?",1,3,11,29,5,9,0,40,0
Beyond the Headlines: Five Things to Watch in China’s GDP Report,1,3,10,42,2,10,0,52,0
"How Well Do You Know Season One Of ""Buffy""",1,1,9,23,2,8,0,32,0
How To Kill A Cockroach,1,1,5,14,0,4,0,19,0
12 Reasons Moxie Is The Best Soda On Earth,1,1,8,24,0,8,2,32,0
26 Gorgeous New Covers For Classic Books,1,1,6,26,0,6,2,32,0
Odd Lots: What the Berkshires Learned by Launching its Own Currency,1,3,8,48,1,10,0,56,0
9 British and Irish Christmas traditions you need to adopt right now,1,3,3,53,0,11,1,56,0
How Do You Make Your New Year's Eve Actually Bearable,1,1,10,33,1,9,0,43,0
"Jon Snow Danced On TV To Drake's ""Hotline Bling"" And It Made People's Christmas",1,1,15,47,4,13,0,62,0
"Here are the perfect male and female bodies, according to men and women The list",1,2,2,63,1,14,0,65,0
"21 Times Rose From ""Titanic"" Was A Terrible Human",1,1,8,29,2,8,2,37,0
"People Fought About The Best Breakfast, What Side Won",1,1,9,35,1,8,0,44,0
"NBA - Redrafting 2009, would Blake Griffin go No. 1 or Stephen Curry, James Harden?",1,3,11,48,5,14,5,59,0
"Dear World, A Word Of Advice From India: Your Butts Are Dirty",1,1,12,36,2,11,0,48,0
If We Gender Flipped The Way We Talk About Food,1,1,10,28,0,9,0,38,0
Talking-Car Safety Mandate Hits Unexpected Pothole of Opposition,1,3,8,48,1,7,0,56,0
21 Things That Mildly Thrill Everyone Who Works In Retail,1,1,9,37,0,9,2,46,0
Shocking New Details Emerge in Aaron Hernandez's Double Murder Trial,1,3,9,49,1,9,0,58,0
Is it ok to cry at work?,1,3,1,16,1,6,0,17,0
Everyone's Freaking Out Over This Morrisons Pizza Because It Looks Rude,1,1,11,49,1,10,0,60,0
What Should Your Instagram Theme Be,1,1,6,24,0,5,0,30,0
28 Savage Kardashian Burns We Still Haven't Recovered From,1,3,8,39,1,8,2,47,0
'Beauty and the Beast' in VR delivers Disney magic you can touch,1,3,5,46,2,11,0,51,0
What Fictional Character Do You Look Like,1,1,7,28,0,6,0,35,0
That Could Be Us But You Playin',1,1,7,18,1,6,0,25,0
The 50 Funniest Tweets From Women In 2016,1,3,6,22,0,7,6,28,0
'Their childhoods shouldn't be owned': readers on children and social media,1,2,1,60,4,10,0,61,0
Trump and Kelly ‘Dismantle’ Obama’s ‘Progress’ for Illegal Immigrants,1,3,7,49,5,8,0,56,0
25 Of 2015's Highest-Paid Musicians According To Forbes,1,1,7,33,2,7,6,40,0
A Best-Selling Author Dismissed Postpartum Depression Screening As A Pharmaceutical Conspiracy,1,1,12,71,1,10,0,83,0
White House staffer's tweet calling for primary challenge opens Republican rift,1,3,3,65,1,10,0,68,0
"Bruce Springsteen invites young fan to perform 'Growin' Up' with him onstage, brings the house down",1,3,4,76,4,15,0,80,0
Guys Get '90s Boyband Makeovers For Their Significant Others,1,1,8,41,1,8,2,49,0
'Gilligan's Island' star Dawn Wells talks Mary Ann's sex appeal ,1,3,6,44,4,10,0,50,0
Which Zodiac Sign Should You Date Based On Your Favourite Disney Character,1,1,12,51,0,11,0,63,0
17 Things All Girls With Too Much Hair Will Understand,1,1,9,34,0,9,2,43,0
"24 Perfectly Snarky Tweets About 'The Bachelor' Season 21, Episode 9",1,2,8,42,3,10,5,50,0
This Is What Los Angeles Looked Like In Its Glory Days,1,1,11,33,0,10,0,44,0
The Full Story Behind The 'La La Land' And 'Moonlight' Oscars Mix-Up,1,3,13,39,5,11,0,52,0
11 Weird Things Your Brain Does,1,1,5,19,0,5,2,24,0
GM Food - Cultivating Fear,1,2,5,16,1,4,0,21,0
Facts That Will Be Truly Upsetting To '90s Girls,1,3,8,29,1,8,2,37,0
Is This A Real Forever 21 Tee Slogan Or Am I Just Fucking With You,1,1,14,36,0,14,2,50,0
Black Friday Brawl Video Of A Woman Stealing From A Little Kid Is Probably Fake,1,1,15,50,0,14,0,65,0
How 'the sultana exercise' can help you lose weight,1,3,1,40,2,8,0,41,0
Life and death on Thailand's lethal roads,1,3,2,32,1,6,0,34,0
The Guardian view on Brexit and the arts: a backlash against the modern,1,3,3,55,1,12,0,58,0
4 things the IRS doesn't want you to know,1,3,3,28,1,8,1,31,0
The Most Amazing Celebrity Biopic Transformations [Video],1,3,7,42,2,6,0,49,0
Which 2015 Meme Are You Based On Your Zodiac Sign,1,1,9,27,0,9,4,36,0
Donald Trump's closest advisor Steve Bannon thinks there will be war with China in the next few years,1,3,5,78,1,17,0,83,0
21 Tweets About Disney That Will Make You Laugh Out Loud,1,1,10,34,0,10,2,44,0
"Former Hillary Clinton Surrogate James P. Rubin: Angela Merkel, Not Trump, Is ‘The Leader of The Free World’",1,3,17,68,6,17,0,85,0
Parisian mayor fires back at Trump after claiming his friend is too scared to visit French capital,1,3,3,79,0,16,0,82,0
"Liam Payne Bought The Flying Ford Anglia From ""Harry Potter""",1,1,10,39,2,9,0,49,0
"Life Is Crazy And Rich People Can Send Themselves To Space, WTF",1,1,14,37,1,11,0,51,0
Panic! At The Disco's New Music Video Is The Creepiest Thing You'll See All Week,1,1,15,48,3,14,0,63,0
Old Friends Senior Dog Sanctuary Is The Best Facebook Page Ever And You Need To Follow It,1,1,17,56,0,16,0,73,0
Why Netflix released 'Orange Is the New Black' season 3 early - Business Insider,1,3,8,55,3,13,1,63,0
What Does Your Hair Say About You,1,1,7,20,0,6,0,27,0
This video of a woman talking with her cheating ex has gone viral The list,1,2,2,58,0,14,0,60,0
"Have YOU ever choked on your food? Revealed, the DIY guide to saving your own life...",1,3,8,57,5,15,0,65,0
How Bleak Is Your Town’s Christmas?,1,3,6,22,2,5,0,28,0
Facebook Life Achievements Only Book Lovers Will Understand,1,1,8,44,0,7,0,52,0
Do You Belong With Anakin Skywalker Or Kylo Ren,1,1,9,30,0,8,0,39,0
This Pastry Chef Matches His Treats To His Outfit And It Works,1,1,12,39,0,11,0,51,0
All The Best Deals On The Internet Today,1,3,8,25,0,7,0,33,0
15 People Who Are Definitely Not On The Drake Train,1,1,9,31,0,9,2,40,0
Here's The Right Kind Of Lube For Every Kind Of Sex,1,1,11,29,1,10,0,40,0
Watch E! News Now Season 2016 Excerpt Free Online - Inside Kris Jenner's Holiday Home | Yahoo View,1,2,15,58,4,17,4,73,0
Scientists Make Doomsday Clock Announcement Video ,1,2,6,38,0,6,0,44,0
Trump’s To-Do List: What to Expect From an Unexpected President,1,3,9,42,3,9,0,51,0
"When using headphones to listen to music, how loud is too loud for kids?",1,3,1,56,2,13,0,57,0
"NBA awards, Part 1: MVP, ROY, COY, DPOY, Sixth Man, MIP",1,3,22,15,7,10,1,37,0
Incredible journey of missing dog who trekked 60 miles to find his owner,1,3,1,57,0,12,2,58,0
16 Most Imaginative Art Vines Of 2015,1,1,5,20,0,6,6,25,0
26 Poses Every Single Person Will Immediately Recognize,1,3,7,39,0,7,2,46,0
The One Thing You Never Noticed About Aladdin,1,1,8,30,0,7,0,38,0
Which Will Ferrell Movie Are You,1,1,6,21,0,5,0,27,0
"British woman, 22, forgoes heart, lung transplants to finish bucket list   ",1,2,1,56,3,13,2,57,0
"Bill Hader And Fred Armisen Gave A Weird, Wonderful Interview",1,1,10,41,1,9,0,51,0
"Barkley: Muslims, Immigrants, LGBT People ‘Getting to Feel What Black People Feel Like Now’",1,3,16,57,5,13,0,73,0
California Today: The Tale of the Laguna Beach Jumper ,1,3,7,37,1,9,0,44,0
Trump’s true ideology has been revealed,1,2,1,32,1,5,0,33,0
"Here's The Original ""Ghostbusters"" Concept Art, From Stay Puft To Slimer",1,1,11,47,4,10,0,58,0
17 Simple Reasons Fall Is The Most Wonderful Time Of The Year,1,1,11,37,0,11,2,48,0
"Can You Guess The ""Friends"" Season Based On Joey's Fridge",1,1,10,35,3,9,0,45,0
Just A Reminder That Chace Crawford Looks Flawless AF Right Now,1,1,12,41,0,10,0,53,0
32 Jaw-Dropping Halloween Makeup Ideas,1,1,5,26,1,4,2,31,0
Taylor Swift Missed A Note And Cried At The Grammys,1,1,10,32,0,9,0,42,0
Lindsey Graham Warns Trump ‘Don’t Empower Russia’,1,3,7,33,3,6,0,40,0
Agatha Christie festival to host cookery demonstration with poisonous twist,1,2,2,64,0,9,0,66,0
The names of the women 'most likely' to get pregnant in 2017 The list,1,2,2,48,2,13,4,50,0
Snapchat Ran An Ad For Booze During Its Hajj Story,1,1,10,31,0,9,0,41,0
This Is What It’s Like To Have ADHD In Your Twenties,1,2,14,27,1,10,0,41,0
"Zaza Pachulia Fouls, Stares Down Russell Westbrook",1,3,7,36,1,6,0,43,0
Can We Guess Your Personality Based On Your Favorite Things,1,1,10,40,0,9,0,50,0
"This Couple's ""Drunk History"" Version Of How They Met Is Pure Gold",1,1,12,40,3,11,0,52,0
13 Holiday Drinking Games To Get You Drunk This Christmas,1,1,9,37,0,9,2,46,0
23 Things You'll Definitely Find In Every Mexican Household,1,1,8,40,1,8,2,48,0
Why BMW’s C 650 GT Scooter Beats a Motorcycle Any Day,1,3,12,27,1,10,3,39,0
Which Horror Movie Villain Are You,1,1,6,23,0,5,0,29,0
What Is Happening With Trump’s Cabinet This Week ,1,3,8,32,1,8,0,40,0
"29 Things You Learn When You Hang Out With The Cast Of ""Con Man""",1,1,13,34,2,13,2,47,0
Why this pastor believes American Girl’s boy doll is ‘a trick of the enemy’,1,2,3,56,3,13,0,59,0
15 Reasons You Need Cheese In Your Life,1,1,7,23,0,7,2,30,0
"5 things for Monday, April 3: China, Supreme Court, Colombia",1,3,6,39,4,9,2,45,0
Obama's big trade setback is an ominous sign - Business Insider,1,2,3,48,2,10,0,51,0
Netflix Reinvents Reality TV by Making Same Show Six Times,1,3,10,39,0,9,0,49,0
Facebook Suspends YouTuber for Disliking ‘Transgender Mother’ Commercial,1,2,8,55,2,7,0,63,0
"Rajkummar's Newton Gets A Standing Ovation, Bieber's Concert's Ticket Prices & More From Ent!",1,2,13,61,6,13,0,74,0
What's Your Worst Audition Horror Story,1,1,6,27,1,5,0,33,0
The 50 Worst Things On The Internet In 2016,1,3,7,22,0,8,6,29,0
Why I Quit Working In Nail Salons,1,3,7,20,0,6,0,27,0
19 Jack-O'-Lanterns Who Really Understand The Struggle,1,1,8,35,3,6,2,43,0
11 Signs You're At A Filipino Party,1,1,6,20,1,6,2,26,0
27 Ways To Celebrate International Men's Day,1,1,6,29,1,6,2,35,0
Ukraine: Inside civilians' living nightmare,1,2,2,35,2,4,0,37,0
"Is This Netflix And Chill, Or Netflix And ~Chill~ ;o",1,1,9,30,4,9,0,39,0
Taylor Swift Wrote A Novel At The Age Of 14,1,1,9,23,0,9,2,32,0
Here’s Why Dozens of Celebrities Are Making the ‘W’ Sign [Video],1,3,9,40,5,10,0,49,0
This Pattern Test Can Guess Your Relationship Status So Freaking Accurately,1,2,11,54,0,10,0,65,0
Heal thyself: meet the doctors living with the conditions they treat,1,3,1,56,1,10,0,57,0
15 Hanukkah Desserts That Will Make You Verklempt,1,1,7,33,0,7,2,40,0
Merkel Says Weak Euro Isn't Her ‘Problem’ in Stand on Trump,1,3,9,37,3,10,0,46,0
How To Build Respect With Difficult People,1,2,7,29,0,6,0,36,0
This Video Is For Every Girl Who Can't Do Makeup,1,1,10,28,1,9,0,38,0
"Do You Remember The Lyrics To ""Imagine"" By John Lennon",1,1,10,33,2,9,0,43,0
Why Is Jinger Duggar Getting Backlash for Wearing Pants? [Video],1,3,9,43,3,9,0,52,0
7 Dialogues That Prove Ishwar 'Langda' Tyagi From Omkara Deserves A Standalone Movie,1,3,12,57,2,12,1,69,0
These Polar Bears Got Real Snow To Play With For Christmas And They Went Wild,1,1,15,48,0,14,0,63,0
"With Just One Question, We Can Tell You If You're The Very Worst Of Humanity",1,1,15,45,2,14,0,60,0
"Marvel Reveals Carrie-Anne Moss Is Playing Genderbent Character In ""Jessica Jones""",1,1,12,57,3,10,0,69,0
Tear Gas Attack On Hamburg Metro Affects 50,1,3,7,27,0,7,2,34,0
19 Songs To Listen To When The Patriarchy's Got You Down,1,1,10,33,1,10,2,43,0
15 Halloween Snacks Guaranteed To Gross Out Your Guests,1,1,8,37,0,8,2,45,0
"'Counter-Strike' semifinals highlights: Near misses, killing sprees and chaos",1,2,3,61,5,8,0,64,0
Schumer: Trump So Far Is ‘a President of Little Impact’,1,3,8,35,3,9,0,43,0
Uber Driver Saves 16-Year-Old Girl From Sex Trafficking,1,2,9,35,2,7,2,44,0
"There’s LeBron, and Then There’s Everyone Else (Michael Jordan Included)",1,2,10,48,5,9,0,58,0
26 Beautiful Wedding Photos To Inspire You This Month,1,1,8,35,0,8,2,43,0
Characteristics of Men Who Are More Likely to Go Bald [Video],1,3,9,40,2,10,0,49,0
10 Great Pop Songs From March You Might've Missed,1,3,8,30,1,8,2,38,0
How Not to Hate Doing Your Taxes,1,2,6,20,0,6,0,26,0
For Anyone Who Truly Appreciates Rihanna's Remarkable Beauty,1,1,8,44,1,7,0,52,0
"The $100,000 Oscars Gift Bags Tone Down The Extravagance This Year",1,3,10,38,2,10,6,48,0
We Know How Many Times You've Had Sex This Week,1,1,10,27,1,9,0,37,0
These baskets are perfect for people who want to shop in solitude,1,3,1,53,0,11,0,54,0
Gay Hair Salon Owner Installs Anti-Bigotry Sign After Homophobic Incident,1,3,11,52,1,9,0,63,0
How second-hand smoke will affect your baby BEFORE you get pregnant ,1,3,7,49,1,11,0,56,0
Trump’s shell game on Russia makes everything look suspicious,1,3,2,50,1,8,0,52,0
Chelsea Clinton’s Husband Shut Down Hedge Fund Month After Hillary Loss,1,3,11,49,1,10,0,60,0
"Scarlett Johansson Leads Superhero-Filled List of 2016's ""Top Grossing Actors""",1,3,9,52,4,9,4,61,0
29 Ways To Manage Your ADHD At Work,1,1,10,16,0,7,2,26,0
"The One Thing You Never Noticed In ""Parks And Recreation""",1,1,10,36,2,9,0,46,0
"Democrats block confirmation votes for Sessions, Price and Mnuchin",1,2,4,53,1,8,0,57,0
"Do You Remember The First Word In These Videos From ""Total Request Live""",1,1,13,45,2,12,0,58,0
This man made a sexist joke about his wife. She got the ultimate revenge The list,1,3,3,62,1,15,0,65,0
"17 Thoughts You Had Watching ""Making A Murderer""",1,1,7,30,2,7,2,37,0
This Man’s Heartbreaking Tribute To His Dog Is Incredibly Moving,1,3,10,44,1,9,0,54,0
Dying author pens heartbreaking dating profile for her beloved husband,1,3,1,60,0,9,0,61,0
Why Cardiologists Are Prescribing Mindfulness For Heart Health,1,3,8,47,0,7,0,55,0
"The One Thing Donald Trump Finds Underrated, According To His Tweets",1,3,11,46,1,10,0,57,0
41 WTF Cat Pictures That Will Make You Laugh Every Time,1,1,12,31,0,10,2,43,0
Today's The Day Chandler Bing Is Supposed To Call Julia Roberts,1,1,11,41,1,10,0,52,0
The two-word phrase President Trump relies on most,1,3,3,39,1,7,0,42,0
24 Heat-Activated Mugs You Never Knew You Needed,1,1,8,30,1,7,2,38,0
17 Things You Need To Know Before You Meet Your New Bae's Kids,1,1,12,35,1,12,2,47,0
"Trump Orders a Wall Built, but Congress Holds the Checkbook ",1,3,7,42,1,10,0,49,0
7 Other Times French Montana Put His Foot In His Mouth,1,2,10,33,0,10,1,43,0
"How Well Do You Know The Lyrics To ""The Christmas Song?""",1,1,11,32,3,10,0,43,0
The 13 best memes of 2016,1,3,1,13,0,5,6,14,0
Thoughts You Have While Waiting To Get Tested,1,1,8,30,0,7,0,38,0
Justin Trudeau Throws Some Grade-A Shade At Donald Trump,1,3,10,37,1,8,0,47,0
Do You Belong In England Or Scotland,1,1,7,23,0,6,0,30,0
"23 Rihanna Memes That’ll Make You Say “Me, I Am Rihanna”",1,3,10,30,4,10,2,40,0
Teen surprised by giant graffiti penis lurking in senior photo,1,2,1,52,0,9,0,53,0
20 Things You'll Only Understand If You're Slightly Obsessed With Meal Prep,1,1,11,49,2,11,2,60,0
17 Reasons You Should Definitely Bring A Sweater,1,1,7,32,0,7,2,39,0
The 15 worst cities for rush hour traffic,1,3,1,31,0,7,2,32,0
"You Can Buy The Mansion From ""Four Weddings And A Funeral""",1,1,11,35,2,10,0,46,0
Poll: Democratic Women Most Likely to Block or Unfriend Someone over Politics,1,2,9,56,1,11,0,65,0
This Comic About Kylo Ren And Chewbacca Will Wreck You,1,1,10,35,0,9,0,45,0
7 Disgusting Things On The Subway More Offensive Than Period Underwear Ads,1,1,11,51,0,11,1,62,0
People Drink Coffee That Has Been Digested By An Animal,1,1,10,36,0,9,0,46,0
What New Book Should You Read This Winter,1,1,8,26,0,7,0,34,0
11 Photos Of The Beatles And One Direction Presented Without Comment,1,1,10,46,0,10,2,56,0
Alan Cartwright murder: Teen denies killing cyclist,1,3,3,41,1,6,0,44,0
Why Does Mount Rushmore Exist? ,1,3,5,20,1,5,0,25,0
Can Donald Trump's Arab honeymoon last?,1,3,4,28,2,5,0,32,0
Meryl Streep's hilarious reaction to that Oscars mix-up is the perfect meme for 2017,1,2,3,62,2,13,4,65,0
Is It Delivery Or DiGiorno,1,1,6,16,0,4,0,22,0
What It's Like To Watch Shia LaBeouf Movies With Shia LaBeouf,1,1,13,37,1,10,0,50,0
Here's How Emma Watson Felt About Hermione Granger's Bushy Hair,1,1,10,42,2,9,0,52,0
"How Well Do You Know The Lyrics To ""Frosty The Snowman?""",1,1,11,32,3,10,0,43,0
Financial Spring Cleaning: What To Keep & What To Toss After Tax Day,1,2,12,42,2,12,0,54,0
New Research Shows Zombies Would End the Human Race in 100 Days,1,2,9,40,0,11,3,49,0
Women: have you experienced a workplace problem?,1,2,1,39,2,6,0,40,0
How Well Do You Really Know The Map Of Canada,1,1,10,26,0,9,0,36,0
For Anyone Whose Face Is Permanently Frozen With One Expression,1,1,10,44,0,9,0,54,0
Calais Child Migrants Are Being Lost to Prostitution and Slavery in the UK,1,2,10,52,0,12,0,62,0
"7 Essays To Read: Sex Scenes That Are Actually Sexy, Confident Black Men, And Debt",1,1,14,50,3,14,1,64,0
22 Gifts Your Dude Will Actually Want For Valentine’s Day,1,2,9,36,1,9,2,45,0
"We Know If You're An '80s, '90s, Or A '00s Kid",1,1,8,16,6,10,6,24,0
Being A Desi Girl In Your Early Twenties Vs. Your Late Twenties,1,1,12,39,1,11,0,51,0
Here’s the real story about the Churchill bust in the Oval Office,1,3,4,49,1,11,0,53,0
Who Said It: Nicki Minaj Or Elizabeth Cady Stanton,1,1,9,32,1,8,0,41,0
21 Stellar Ideas For An Astronomy-Themed Wedding,1,1,7,32,1,6,2,39,0
Bubba Watson Sinks Wild Putt with Back Turned to Hole at US Open Practice,1,3,12,48,0,13,0,60,0
Tom Hiddleston Explained Gothic Literature And The Geekiness Is Surprisingly Hot,1,1,11,59,0,10,0,70,0
Here Are the Best and Worst 2017 April Fools' Day Pranks So Far,1,3,10,36,1,12,4,46,0
Why I’m Breaking Up With the Apple Watch ,1,3,7,25,1,8,0,32,0
Psychologists have identified 10 factors that explain why and how we fall in love,1,2,1,65,0,13,2,66,0
The Try Guys Watch K-Pop For The First Time,1,1,10,24,1,8,0,34,0
These Girls Learned The Hard Way You Should Always Test A DIY Face Mask On Your Hand,1,1,19,49,0,16,0,68,0
26 Little Things That Ruin Every Teacher’s Day,1,3,7,29,1,7,2,36,0
DJ Kool Herc Reminisces About Biggie,1,3,7,24,0,5,0,31,0
30 Questions You Should Ask Yourself Before 2016,1,1,6,29,0,7,6,35,0
13 New Ways To Style Your Hair In 2016 That Are Actually Pretty,1,1,11,34,0,12,6,45,0
29 Photos That Will Make Developers Laugh Every Time,1,1,8,34,0,8,2,42,0
21 Coffee Hacks To Step Your Game Up Immensely,1,3,8,28,0,8,2,36,0
12 Pictures Of Water Bodies In India That Could Become Your New Happy Place,1,1,13,47,0,13,2,60,0
9 Women In Movies Who Somehow Brought In All The Money This Year,1,1,12,39,0,12,1,51,0
This Oscars Dress Has a Really Powerful Message Behind It,1,3,9,39,0,9,0,48,0
4 Must-Have Dividend-Growth Stocks For 2017,1,3,6,25,2,5,5,31,0
18 Pictures of Celebrities as Bridesmaids to Remind You You're Not Alone,1,3,8,50,1,11,2,58,0
Literally Just 100 Funny Tweets That Sum Up Parenting,1,2,8,34,0,8,3,42,0
"What NOT to say to someone with cancer, according to 6 patients",1,3,4,46,1,11,1,50,0
21 Reasons Daniel Norris Is Absolute Human Perfection,1,1,7,37,0,7,2,44,0
One in three Conservative MPs to join anti-EU campaign group,1,2,6,44,1,9,0,50,0
This Korean man's instructional video on U.S. v UK accents is glorious,1,2,6,50,3,11,0,56,0
"A Reporter Claims She Was Harassed And Called ""Prostitute"" At A March To Show India's Tolerance",1,1,16,61,3,15,0,77,0
This Inkblot Test Will Determine What You Hate The Most,1,1,10,36,0,9,0,46,0
What Life-Changing Product Do You Wish You'd Owned Earlier,1,1,10,38,2,8,0,48,0
This Chocolate Dessert Is Completely Mesmerizing,1,1,6,37,0,5,0,43,0
"This is what a venture capitalist in deep, deep denial sounds like: Theranos backer Tim Draper",1,3,4,73,2,15,0,77,0
17 Ways To Eat Healthier This Christmas Season,1,1,7,30,0,7,2,37,0
Robert Pattinson Has Grown A Humongously Bushy Beard,1,1,8,37,0,7,0,45,0
CHINAH share video for 'Even Love' - premiere,1,3,8,27,3,7,0,35,0
Chris Evans on Trump Presidency: ‘I Feel Rage. I Feel Fury’,1,3,10,35,4,10,0,45,0
"Floyd Mayweather: Fight with Conor McGregor 'getting very, very close'",1,2,6,51,4,9,0,57,0
The Truth About Shaving Your Pubes,1,1,6,23,0,5,0,29,0
7 Family Finance Tips To Consider For The New Year,1,3,9,31,0,9,1,40,0
9 Reasons Why You Need To Travel Solo At Least Once In Your Lifetime!,1,3,13,41,1,13,1,54,0
21 Things People With ADHD Want You To Know,1,1,11,22,0,8,2,33,0
Gutfeld: Massive Bomb Sent the 'Mother of All Messages' to North Korea  Insider,1,2,10,53,3,13,0,63,0
Who's The Worst Person You've Ever Sat Next To On A Plane,1,1,12,32,2,11,0,44,0
Which Knowles Sister Are You,1,1,5,19,0,4,0,24,0
McCain: Trump’s Attacks on Press Are ‘How Dictators Get Started’,1,3,10,41,4,9,0,51,0
The 22 Most Mesmerizing Space Photos Of 2015,1,1,6,25,0,7,6,31,0
13 Things to Know About the Charts This Week: Michael Jackson's 'Thriller' Is All-Time No. 1 R&B/Hip-Hop Album,1,2,18,63,9,17,3,81,0
Schoolboy on work experience discovers planet,1,2,1,39,0,5,0,40,0
"After a toddler accidentally shot and killed his older sister, a family’s wounds run deep",1,2,1,72,2,14,0,73,0
10 Life-Changing Things To Try In December,1,1,7,26,1,6,2,33,0
"5 hacks for shopping at Macy’s, Gap and Kohl’s",1,3,3,31,3,8,1,34,0
"UK's Slow Response To Ebola Cost Thousands Of Lives, Says Report",1,1,12,40,2,10,0,52,0
42 Things You'll Understand If Your Life Is Literally A Sitcom,1,1,10,39,1,10,2,49,0
"Today in Trump: January 25, 2017",1,2,3,16,2,5,6,19,0
8 Creative Hobbies To Take Up In 2017,1,3,6,19,0,7,5,25,0
46 Taylor Swift Lyrics For When You Need An Instagram Caption,1,1,10,39,0,10,2,49,0
A Cancer Survivor Became A Meme After People Compared Him To Stephen Curry,1,1,13,49,0,12,0,62,0
Are You Actually A Meme Bob Or A Meme Snob,1,1,10,23,0,9,0,33,0
42 Slightly Gross Things All Female Best Friends Have Secretly Done,1,3,10,45,0,10,2,55,0
You Will Not Be Able To Handle The New Real Housewives Of Atlanta Trailer,1,1,14,46,0,13,0,60,0
Are You The Only Person Who Doesn't Care To Watch The New Star Wars Movie,1,1,15,43,1,14,0,58,0
This is what astronauts see when they look out their window,1,2,1,48,0,10,0,49,0
If Nancy Drew Had Instagram,1,1,5,18,0,4,0,23,0
"Which Character From ""Arrested Development"" Are You Based On Your Zodiac",1,1,11,49,2,10,0,60,0
"19 Thoughts Everyone Has While Watching ""House Hunters""",1,1,7,37,2,7,2,44,0
"Someone On YouTube Made A ""Hotline Bling"" Version With Obama And It's Amazing",1,1,14,48,3,12,0,62,0
Olsen Twin Or Stylish Senior? You Decide.,1,2,7,26,2,6,0,33,0
How Obsessed Are You With Surviving,1,1,6,24,0,5,0,30,0
14 successful CEOs and entrepreneurs share their best business advice,1,3,3,55,0,9,2,58,0
A 17-Year-Old Built A Bridge So That Underprivileged Kids Could Get To School Safely,1,1,15,52,2,13,2,67,0
Some women are striking from smiling today. Here’s why.,1,3,2,42,3,8,0,44,0
32 Tweets About Sleep That Will Make You Laugh Out Loud,1,1,10,33,0,10,2,43,0
This Cream Cheese Banana Bread Will Blow Your Fucking Mind,1,1,10,39,0,9,0,49,0
Which Gay Tribe Do You Belong To,1,1,7,19,0,6,0,26,0
This Is How Much Halloween Has Changed Over The Years,1,1,10,34,0,9,0,44,0
The Psychology Behind Bad Gift-Giving: Where Buyers Go Wrong,1,3,10,40,2,8,0,50,0
Here are the potential sinister motives behind Donald Trump's voter fraud lie,1,3,3,62,1,11,0,65,0
Should Big Data Pick Your Next Doctor?,1,3,7,24,1,6,0,31,0
Tony Blair’s global network: Ten things we learned,1,2,3,38,2,7,0,41,0
Pak Hit By India's Water Wars + 5 More Stories You Need To Read From This Sunday,1,3,15,46,2,16,1,61,0
This Is How They Make The Eggs At McDonald's,1,1,10,25,1,8,0,35,0
There's a super easy way to find out what Trump has tweeted about any given subject,1,3,2,65,1,15,0,67,0
"How Well Do You Know One Direction's ""Perfect?""",1,1,8,28,4,7,0,36,0
Must-have 'fatbit' fitness gadgets can exaggerate your step count by 25% every day ,1,3,1,63,4,13,2,64,0
These Portraits Celebrate The Joy Of Having Freckles,1,1,8,37,0,7,0,45,0
27 Times What Happened In The Gay Bar Didn't Stay In The Gay Bar,1,1,13,35,1,13,2,48,0
"A Woman Flushed Her Ring Down The Toilet, Lived Everyone's Nightmare",1,1,11,45,2,10,0,56,0
Selfridges invents coffee spread containing espresso shots,1,2,1,51,0,6,0,52,0
Horrifying moment daredevil plunges four floors after climbing out of a window in a block of flats,1,3,1,81,0,16,0,82,0
Will Dishonesty Kill Cleantech?,1,3,4,23,1,3,0,27,0
Is Justin Trudeau the Anti-Trump?,1,2,5,22,2,4,0,27,0
Watch: Greg Maddux goes incognito to prank Kris Bryant,1,3,5,40,1,8,0,45,0
I Went To The IRL Derek Zoolander Center And It Was Ridiculously Cool,1,1,15,42,0,12,0,57,0
Jennifer Aniston Had To Give Herself A 'Tanning Intervention',1,3,9,42,2,8,0,51,0
"18 Questions We Have After Watching ""Star Wars: The Force Awakens""",1,1,10,41,3,10,2,51,0
"Woman with Huntington's disease has trouble eating, so waiter steps in to help",1,3,2,62,2,12,0,64,0
Are You More Ja Rule And Ashanti Or Ja Rule And J.Lo,1,1,13,27,1,11,0,40,0
15 Bottomless Boozy Brunches That Will Change Your Life,1,1,8,37,0,8,2,45,0
"Walter Cronkite Awards Dub Jake Tapper, Jorge Ramos, and Katy Tur Best Reporters of 2016 Election",1,3,13,63,2,15,4,76,0
16 Things Martha Stewart Tweeted In 2015 That Will Make You Laugh For Absolutely No Reason,1,1,14,55,0,15,6,69,0
Do You Even Remember The Real Colors Of These Logos?,1,3,10,32,1,9,0,42,0
"How These High School Sweethearts Are Saving Nearly $100,000 A Year To Retire Early",1,3,13,49,2,13,6,62,0
4 Great Books To Read In March,1,3,6,17,0,6,1,23,0
These Dads Dancing Ballet with Their Daughters Will Steal Your Heart  Insider,1,2,11,54,0,12,0,65,0
Football Club Could Segregate Black Fans From White Fans,1,1,9,39,0,8,0,48,0
Will we be able to cryogenically freeze organs one day?,1,3,1,44,1,9,0,45,0
21 Times Tumblr Users Perfectly Explained How It Feels To Be A Not-Quite Adult,1,1,14,48,1,13,2,62,0
"Two Russian Compounds, Caught Up in History’s Echoes ",1,3,7,36,2,8,0,43,0
Ripcord Removes the Pain of Paper Cuts With Robot Digital Filers,1,3,9,45,0,10,0,54,0
"9 Texts You Send Your Best Friend, And What They Actually Mean",1,1,11,38,1,11,1,49,0
Are You More Kathie Lee Or Hoda,1,1,7,18,0,6,0,25,0
26 Things You'll Understand If You're Sightly Obsessed With Wine,1,1,9,42,2,9,2,51,0
How Many Songs On Justin Bieber's Album Are About Selena Gomez,1,1,11,40,1,10,0,51,0
Women May Soon Lose The Ability To Get An Abortion Via Webcam,1,3,12,38,0,11,0,50,0
Mike Lee: Health Care Bill ‘Is Going to Fail’,1,2,8,26,3,8,0,34,0
37 Films to get excited about in 2017,1,3,1,23,0,7,6,24,0
Doug The Pug Tries On Sexy Halloween Costumes And Wows Everyone,1,1,11,42,0,10,0,53,0
19 Products That Will Change Every Booze Lover's Life,1,1,8,34,1,8,2,42,0
Alia Bhatt And Varun Dhawan's 'Tamma Tamma' Will Teleport You To Good Old Days Of 90s,1,3,15,50,3,15,2,65,0
"20 ""Doctor Who"" Questions That Are Impossible To Answer",1,1,8,35,2,8,2,43,0
19 Pictures People Who Haven't Shopped At Aritzia Will Not Understand,1,1,10,46,1,10,2,56,0
29 Things That Will Make You Cringe So Hard You'll Never Recover,1,1,11,39,1,11,2,50,0
What We're Reading ,1,3,3,12,1,3,0,15,0
These People Had Touching Reactions When Confronted With Homophobia,1,1,9,50,0,8,0,59,0
28 Jaw-Dropping Close-Up Photographs Of Nature,1,1,7,30,2,5,2,37,0
Watch This Golden Retriever Experience True Joy As He Rides A Merry-Go-Round,1,1,14,49,2,11,0,63,0
Show Them the Money: These 13 Athletes Deserve a Raise,1,2,7,35,1,9,2,42,0
Patriots Owner Bob Kraft Reveals How Donald Trump Helped Him Through a Difficult Life Crisis,1,3,14,64,0,14,0,78,0
17 Things You'll Recognize If You Grew Up In Florida,1,1,9,31,1,9,2,40,0
Heal thyself: meet the doctors living with the conditions they treat,1,2,1,56,1,10,0,57,0
Flight attendants reveal the 5 most annoying things people do on airplanes,1,2,1,61,0,11,1,62,0
19 People Who Are Never Allowed To Use A Microwave Again,1,1,10,34,0,10,2,44,0
You Truly Are 100% Emo If You Can Finish These Lyrics,1,3,10,29,1,10,3,39,0
Mexican Nationals Arrested in Sex-for-Money With Underage Girls Bust,1,2,9,49,2,8,0,58,0
This Urinal May Have Taken The Greatest Leak Of All Time,1,1,11,35,0,10,0,46,0
18 Apple Desserts That Will Totally Change Your Life Forever,1,1,9,40,0,9,2,49,0
18 Pop-Punk Holiday Songs Only True Emo Kids Will Appreciate,1,1,10,38,1,9,2,48,0
All The Best Deals On The Internet Today,1,3,8,25,0,7,0,33,0
How posh is your fridge? Take the 'Tatler test' to find out,1,2,3,42,3,11,0,45,0
Amazing Prom Dresses for Frustrated Curvy Girls [Video],1,3,7,39,2,7,0,46,0
An Artist Reimagined Disney Princesses At Their Current Ages And The Results Are Gorgeous,1,1,14,62,0,13,0,76,0
18 Reasons My Dad Is Basically Ron Swanson In Disguise,1,1,9,34,0,9,2,43,0
21 Charts That'll Help You Get In Shape When You're Lazy AF,1,1,12,32,2,11,2,44,0
16 Fucking Creepy Things That Actually Happened In 2016,1,3,7,34,0,8,6,41,0
Saudis Temper Call for Cuts and Russia Digs In,1,3,7,31,0,8,0,38,0
What to Know Before Using Free Tax-Return Services,1,3,8,34,1,7,0,42,0
Are You More Of A Mixtape Or Playlist Type Of Person,1,1,11,31,0,10,0,42,0
The Most Moving Personal Essays You Needed To Read In 2015,1,1,10,34,0,10,4,44,0
People Revisit Their Old Instagrams,1,1,5,26,0,4,0,31,0
14 Pairs Of Cat Socks To Kick Off The Mew Year In Style,1,1,12,29,0,12,2,41,0
"There Was A Mini ""Harry Potter"" Reunion In Florida Over The Weekend",1,1,12,42,2,11,0,54,0
Which New 5 Seconds Of Summer Song Is Your Favorite,1,1,9,32,0,9,1,41,0
Can We Guess If You're Suffering From Post-Christmas Sadness,1,1,10,40,2,8,0,50,0
People Are Bullying This Woman On Facebook After Pictures Of Her Eyebrows Went Viral,1,1,14,57,0,13,0,71,0
The Top 20 Jobs For Getting Ahead In 2017,1,3,7,20,0,8,6,27,0
Which 2016 Movie Should You See Based On Your Zodiac Sign,1,1,10,33,0,10,4,43,0
18 Reasons Why Parents Can't Stand Caillou,1,1,6,27,1,6,2,33,0
Here's What Happens When You Accidentally Buy Your Girlfriend 144 Pairs of Fuzzy Socks,1,2,12,57,1,13,3,69,0
15 Reasons Why North West And Penelope Disick Are The Cutest BFFs,1,1,13,39,0,11,2,52,0
Miley Cyrus posed nude with a pig on the cover of 'Paper Magazine',1,2,4,48,2,12,0,52,0
Indian Doctor Wins Rs 17.5 Crore In Lottery In UAE!,1,3,11,26,2,9,3,37,0
What's Ahead For Luxury Travel In 2017?,1,3,6,21,2,6,4,27,0
These Are the World's 50 Best Restaurants,1,3,5,27,1,6,2,32,0
15 Real-Life Achievements For Canadians,1,1,5,27,1,4,2,32,0
"OK, We Need To Talk About How Amazing Usher's Bulge Is",1,1,12,30,2,10,0,42,0
Nick Saban’s Grand Recruitment Tool: A Piano,1,3,7,29,2,6,0,36,0
Isabel Gayther: Messages appear on missing London student's Facebook page as manhunt continues,1,3,5,75,2,12,0,80,0
17 Power Snacks Every College Student Should Know,1,1,7,33,0,7,2,40,0
The secret life of Father Christmas: chats about poo and requests for a sibling,1,3,3,62,1,13,0,65,0
"Which ""Orange Is The New Black"" Inmate Would Be Your Prison Nemesis",1,1,12,42,2,11,0,54,0
How Hip Were You In 2015,1,1,5,10,0,5,4,15,0
13 Things You Didn't Know About Extreme Poverty,1,1,7,30,1,7,2,37,0
15 Things People Who Grew Up With Young Parents Will Understand,1,1,10,41,0,10,2,51,0
19 Super-Interesting Disney Music Facts,1,1,5,27,1,4,2,32,0
The top 50 hospitals that gouge patients the most,1,2,1,38,0,8,2,39,0
Disney Princes With Male Pattern Baldness,1,1,6,30,0,5,0,36,0
Argentina tried a Trump-like tariff -- and it went horribly wrong,1,2,2,50,3,10,0,52,0
9 Couples Costumes That Will Make You Glad You're Single,1,1,9,36,1,9,1,45,0
If You Can Get 90% On This Quiz You’re A “Fast & The Furious” Expert,1,3,13,34,5,14,2,47,0
Mark Cuban explains Twitter experiment: 'Just knew it would drive people crazy',1,3,4,61,3,11,0,65,0
21 Squirrels Who Need To Back The Eff Off,1,1,8,23,0,8,2,31,0
23 Reasons You Should Never Watch American Football,1,1,7,35,0,7,2,42,0
"On Thanksgiving, Caring For Those Who Cared For Us",1,1,9,32,1,8,0,41,0
We Decided To Deep Fry Christmas Dinner And It's Life Changing,1,1,11,40,1,10,0,51,0
17 Relationship Goals That Are Actually Worth Achieving,1,1,7,39,0,7,2,46,0
17 Things You'll Understand If You're Slightly Obsessed With Singing In The Car,1,1,12,51,2,12,2,63,0
What's A Quote Or Lyric That Best Describes Your Depression,1,1,10,39,1,9,0,49,0
Pak's Passport Officer Thinks There Are 31 Days In Feb & Internet Is Having Fun At His Expense!,1,2,16,57,3,17,2,73,0
Jennifer Lawrence Does Her Best Britney Spears Impression In This Endearingly Awkward Video,1,1,13,66,0,12,0,79,0
Ranking best games of 2017 NFL season: Super Bowl rematch is No. 1,1,3,7,40,2,12,5,47,0
34 Times Tumblr Taught You Everything You Need To Know About Bisexuality,1,1,11,48,0,11,2,59,0
"19 Times ""Adventure Time"" Really Wanted To Make You Cry",1,1,9,33,2,9,2,42,0
When You Can't Tell She's Flirting,1,1,6,21,2,5,0,27,0
"This Is Julia, Sesame Street's First Character With Autism",1,1,9,39,2,8,0,48,0
These Cereal Cocktails Will Give You The Breakfast You Deserve,1,1,10,43,0,9,0,53,0
Ex-Florida State DB Myron Rolle to begin Harvard medical residency,1,3,8,48,1,9,0,56,0
The Most Attractive Market Picks as Funds Flow Back to Asia,1,3,9,40,0,10,0,49,0
Arkansas Faces Another Hurdle in Upcoming 8 Executions — Finding Witnesses,1,2,8,54,1,10,1,62,0
We celebrate 25 years of 'Wayne's World' with wacky film facts,1,3,3,44,3,10,2,47,0
Michael Moore: U.S. ‘Sh*ts On Their Own’ People More than Any Other Country,1,3,13,44,6,12,0,57,0
Dates On Food Labels May Actually Start To Make Some Sense,1,3,11,37,0,10,0,48,0
Which Taco Bell Menu Item Matches Your Zodiac Sign,1,1,9,33,0,8,0,42,0
21 Gifts For People Who Are Completely Obsessed With Tea,1,1,9,36,0,9,2,45,0
"19 Moments That Prove ""Step Brothers"" Is The Funniest Movie Ever",1,1,10,40,2,10,2,50,0
World’s Best-Yielding Stock Market Is Set to Get Even Better,1,3,10,39,2,9,0,49,0
13 Terrifying Urban Legends That Will Make You Wish You Hadn't Read This,1,1,12,45,1,12,2,57,0
What Should Be Your Secret Service Nickname,1,1,7,30,0,6,0,37,0
Behar: Trump’s Limited Vocabulary ‘Appeals to People Who Are Afraid of Things’,1,2,10,53,4,11,0,63,0
12 Pictures You’ll Only Understand If You’re Madly In Love With The Perfect Person,1,3,13,52,2,13,2,65,0
10 jobs that will make you happy and rich,1,3,0,31,0,8,2,31,0
Type 'ceo' into your iPhone keyboard for a sexist surprise,1,3,2,45,2,9,0,47,0
8 Foods That Should Have Warning Labels,1,2,6,26,0,6,1,32,0
Which Pop Diva Alter Ego Are You,1,1,7,19,0,6,0,26,0
"A Lake In Australia Turns Pink, Looks Good In Pictures But Isn't Advisable For Swimming",1,3,15,56,2,14,0,71,0
This Story Is For Anyone With Reservations About Bringing Syrian Refugees To Canada,1,1,13,58,0,12,0,71,0
17 Reasons Why People Regret Their Open Relationships,1,1,7,37,0,7,2,44,0
British singer's open letter about racist encounter on a train,1,2,1,51,1,9,0,52,0
Which Quote In Literature Helped You Out With Your Depression,1,1,10,42,0,9,0,52,0
11 Times Bollywood Stars Bravely Opened Up About Their Deepest Personal Struggles,1,1,11,57,0,11,2,68,0
This Raccoon Was The Most Polite Passenger On Toronto's Subway,1,1,10,42,1,9,0,52,0
You'll Miss Carrie Fisher Even More After Watching Ellen DeGeneres' Touching Tribute,1,2,13,58,2,11,0,71,0
The culture around Trump and the troubling message to police,1,3,2,49,0,9,0,51,0
33 Products Under $15 That Are Basically Already In Your Shopping Cart,1,3,10,44,1,11,4,54,0
How to Navigate New Airline Carry-On Rules ,1,3,7,28,1,7,0,35,0
19 Insanely Unique Thrift Shops You Need To Visit ASAP,1,1,12,31,0,9,2,43,0
How to make peace with close friends and family who backed the other candidate,1,3,1,64,0,13,0,65,0
Fyre Festival will take place in 2018: 'We will not do it ourselves',1,3,3,46,3,12,4,49,0
Take This Makeup Picture Test To Determine Your Dominant Trait,1,1,10,43,0,9,0,53,0
Mike Barnicle: ‘This President Has Been Scandal-Free’,1,2,8,35,4,6,0,43,0
"Will Smith Appeared On ""Good Morning America"" To Talk About The Oscars",1,1,12,45,2,11,0,57,0
There's an internet language dedicated entirely to talking about dogs The list,1,2,2,64,1,11,0,66,0
"Von Miller Rocks Fur Vest, Cowboy Hat and Bandana at Coachella Music Festival",1,3,11,53,1,12,0,64,0
Revealed in the Telegraph: the mystery of the Sherlock baby name,1,3,3,50,1,10,0,53,0
8 Things No One Tells Guys With Body Image Anxiety,1,1,9,31,0,9,1,40,0
I revamped my work wardrobe with almost no effort with this personal shopping service,1,3,1,71,0,13,0,72,0
"11 Breathtaking ""Grand Designs"" Homes You Can Actually Stay In",1,1,9,40,2,9,2,49,0
Teacher Placed on Administrative Leave After Her Past as an Adult Film Star Was Exposed,1,3,12,61,0,14,0,73,0
This Worried Golden Retriever Thought She Lost Her Teddy Bear,1,1,10,42,0,9,0,52,0
Danish dental student pulls out own wisdom tooth and - naturally - posts a video of the grisly procedure online,1,2,1,89,2,19,0,90,0
Can you spot the problem with this photo? The list,1,3,2,38,1,9,0,40,0
Watch This Man Transform Into An Entire K-Pop Group,1,1,10,32,1,8,0,42,0
World's first penis transplant patient is set to become a FATHER after announcing his girlfriend is pregnant,1,2,7,84,1,16,0,91,0
An Adorable Animals Advent Calendar: December 1,1,1,6,33,1,6,1,39,0
Top Bishop: Europe Will Soon Be Muslim Because of Our Stupidity,1,3,10,42,1,10,0,52,0
"15 Sexy Winter Drinks For The Next Time You ""Netflix And Chill""",1,1,11,37,2,11,2,48,0
Women Try A Diva Cup For The First Time,1,1,9,22,0,8,0,31,0
22 Harry Potter Tumblr Posts That Will Give You So Many Feels,1,1,11,37,0,11,2,48,0
This Angry Cat Was Rescued From A Shelter And Now Is Taking Over The Internet,1,1,15,48,0,14,0,63,0
Lindsey Graham Meets Donald Trump for Lunch–Gives Him New Cell Phone Number,1,3,12,51,1,11,0,63,0
"29 Quotes From The Ladies Of ""The Office"" That Still Are Hilarious",1,1,11,40,2,11,2,51,0
Do You Actually Know The Difference Between Mary-Kate And Ashley?,1,2,11,43,2,9,0,54,0
Signs You Need To Get Your Shit Together,1,1,8,25,0,7,0,33,0
We Taught These Grandmas How To Do The Nae Nae And It Was Cute AF,1,1,16,35,0,14,0,51,0
The brutal dictatorship the world keeps ignoring,1,3,1,41,0,6,0,42,0
"Inside Syria Part 3: Last Hospital Destroyed, Aleppo Faces Biggest Bloodbath In Recent History",1,3,13,65,2,13,1,78,0
"Arjun Kapoor Was In ""Neerja"" And No One Noticed",1,1,9,28,2,8,0,37,0
Ryan Reynolds Had The Perfect Response To The Sexist Marketing Of Superhero Movies,1,1,13,57,0,12,0,70,0
Which Taylor Swift Single Is Your Favorite,1,1,7,29,0,6,0,36,0
Anushka Sharma Has A PSA For Everyone Celebrating Diwali,1,1,11,37,0,8,0,48,0
14 Cats Who Don't Quite Understand This Christmas Thing,1,1,8,36,1,8,2,44,0
Why's Trump threatening Canada over milk?,1,3,3,31,2,5,0,34,0
We Know Which Thanksgiving Side You Are Based On Your Zodiac,1,1,11,39,0,10,0,50,0
Billboard's Top 10 Most Popular Holiday Songs,1,2,6,30,1,6,2,36,0
Is civil rights activist lying about her race?,1,3,1,37,1,7,0,38,0
"Thane Call Centre Scam Mastermind Arrested, After Air India, FIA Lifts Ban On Gaikwad And Other Must Reads",1,3,20,67,2,17,0,87,0
"A 16-Year-Old Girl Was Saved From Pimps, All Thanks To This Uber Driver's Alertness",1,3,15,49,4,13,2,64,0
"In Denmark, Passage of Rules on Immigration Called for Cake ",1,3,7,42,1,10,0,49,0
16 Reasons Your Best Friend Is Your Best Friend,1,1,8,29,0,8,2,37,0
Mormon Confessions,1,1,2,15,0,1,0,17,0
We Already Have a Magic Wand to Protect Fish -- Let's Use It,1,3,10,35,3,12,0,45,0
21 Tweets That Are Way Too Real For Anyone Who's Obsessed With Instagram,1,1,12,45,1,12,2,57,0
Who Are the Producers on Harry Styles' Album?,1,3,6,30,2,7,0,36,0
11 Celebrity Quotes About Being Depressed,1,1,5,29,0,5,2,34,0
13 Theories About Pixar Movies That’ll Really Make You Think,1,3,9,39,1,9,2,48,0
This Clydesdale Horse Already Has The Best Photobomb Of 2016,1,1,9,38,0,9,4,47,0
Is UNICEF helping all the child victims of peacekeeper sex abuse? ,1,2,7,47,1,11,0,54,0
"Which ""ANTI"" Song Are You Based On Your Zodiac Sign",1,1,13,27,2,9,0,40,0
"In Europe, Four Main Concerns About Trump",1,2,7,27,1,6,0,34,0
What to Do If You Can’t Pay Your Tax Bill in Full,1,3,10,27,1,11,0,37,0
Great Moments In Roomfuls Of Men Legislating Women's Bodies,1,2,9,41,1,8,0,50,0
22 Amazing Apps That Will Revitalize Your Love Of Reading,1,1,9,37,0,9,2,46,0
"17 ""Home Alone"" Tweets That Will Make You Laugh Out Loud",1,1,10,32,2,10,2,42,0
27 Unique And Fun Date Ideas You’ll Wish You Thought Of First,1,3,11,36,1,11,2,47,0
19 Things All Couples With Two Years Between Them Understand,1,1,9,40,0,9,2,49,0
Are You And Your S.O. More Jack & Sally Or Morticia & Gomez,1,1,12,31,4,12,0,43,0
This Test Will Determine If You're Actually From The Western Balkans,1,1,11,46,1,10,0,57,0
China Gives ‘Hedge Fund Brother No.1’ 5 1/2 Years in Prison,1,2,8,33,4,10,4,41,0
"Tom Hanks, David Nott and Dustin Hoffman: 10 men whose Desert Island Discs you must listen to",1,3,9,64,2,16,2,73,0
Blast from the past: Why collectors are investing in retro jukeboxes,1,3,2,55,1,10,0,57,0
12 Aussies Reveal What They Love And Hate About Britain,1,1,9,35,0,9,2,44,0
A 5-year-old boy left a heartbreaking note for a woman. Now she's trying to find him The list,1,3,3,68,4,17,1,71,0
This Is What Life Looks Like For Quiet People,1,1,9,28,0,8,0,37,0
"'Lucky to Be Alive,' Says Woman Who Claimed to See Escaped Murderers After New York Prison Break",1,2,15,62,3,16,0,77,0
Curious world of North Korea's exports – from badger furs to 'strength pills',1,2,3,58,4,12,0,61,0
28 Times Naya Rivera Was The Most Flawless Person On Instagram,1,1,10,40,0,10,2,50,0
"18 Cringeworthy Moments From The First New Episode Of ""First Dates""",1,1,10,43,2,10,2,53,0
12 Times Zendaya Schooled Us All In 2015,1,1,6,21,0,7,6,27,0
Trump Spokeswoman: ‘Media Constantly Wants to Talk About Something That Doesn’t Exist’,1,3,11,60,4,11,0,71,0
"Meet The Five New Playable Characters From ""Battleborn""",1,1,8,38,2,7,0,46,0
We Know Your Hogwarts House Based On The Things You Hate,1,1,11,35,0,10,0,46,0
Young Aussie surfer photo bombed by shark that shared wave,1,3,2,47,0,9,0,49,0
19 Kardashian Pregnancy Moments That Were Way Too Relatable,1,1,8,41,0,8,2,49,0
"BMW's new 7 Series is the luxury car of the future, here today",1,2,4,43,2,12,1,47,0
Are You More Hogwarts Or Xavier's,1,1,6,21,1,5,0,27,0
17 Times Spencer Boldman Was The Most Perfect Man On Instagram,1,1,10,40,0,10,2,50,0
Our Favorite LGBT Essays We Published This Year,1,1,11,29,0,7,0,40,0
14 things successful people do in the first week of a new job,1,2,0,47,0,12,2,47,0
The Walking Dead: Negan actor Jeffrey Dean Morgan slams Primark t-shirt controversy,1,2,8,62,2,11,0,70,0
Here's How Ten Countries Approach Mental Health,1,1,7,33,1,6,0,40,0
22 Kids Who Are Winning At Thanksgiving,1,1,6,25,0,6,2,31,0
Trading Up: Billionaire Herb Chambers Happily Builds And Sells Yachts,1,3,10,49,1,9,0,59,0
"The Toughest Game Of ""Would You Rather"": Hot Guys Vs. Grilled Cheese",1,1,12,41,4,11,0,53,0
5 Must-Have Qualities For USC's Next Football Coach,1,1,10,31,2,7,1,41,0
What People With Natural Hair Really Hear,1,1,7,28,0,6,0,35,0
She was on course for stardom. Then she entrusted her career to USA Swimming,1,2,6,56,1,13,0,62,0
Tracy Morgan Receives Standing Ovation At The Emmys After Traumatic Brain Injury,1,1,12,57,0,11,0,69,0
"If ""Twelve Days Of Christmas"" Were Written In 2015",1,1,8,28,2,8,4,36,0
10 Reasons Why The ‘Average’ Student Is More Successful After Graduation,1,3,10,48,2,10,2,58,0
"The Hardest ""Walking Dead"" Video Game Quiz You'll Ever Take",1,1,10,37,3,9,0,47,0
9 tricks for remembering everything you read,1,2,0,37,0,6,1,37,0
Are You Ready To Sync Your Vagina With Your Smartphone,1,1,10,35,0,9,0,45,0
This News Channel Green Screened A Reporter Into The Chennai Floods,1,1,11,46,0,10,0,57,0
25 Autumn Tattoos You'll Fall In Love With,1,1,7,25,1,7,2,32,0
Five Cringe-Worthy Moves That Make You Look Unprofessional,1,3,9,41,1,7,0,50,0
People Are Appropriately Freaking Out ’Cause This 2-Year-Old Looks Just Like Ed Sheeran,1,3,14,57,3,12,1,71,0
19 Things Only Science-Geek Parents Will Understand,1,1,7,35,1,6,2,42,0
Aubrey Plaza Tried To Play With Robert De Niro's Nipples But Did Not Succeed,1,1,14,48,1,13,0,62,0
Can You Name These Christmas Movies From Their Posters,1,1,9,37,0,8,0,46,0
Anna Faris Thinks Chris Pratt's Balls Are Sexy And Perfect,1,1,10,38,1,9,0,48,0
Miserable Cat With 5 Pounds Of Matted Fur Undergoes Incredible Transformation,1,2,10,56,0,10,1,66,0
"A Man Returned His Wife's ""Woman Of The Year"" Award After Caitlyn Jenner Received One",1,1,15,53,3,14,0,68,0
Create A Pizza And We'll Reveal When Your Best Friend Will Get Married,1,3,13,44,1,12,0,57,0
"11 Times Helena From ""Orphan Black"" Was Too Cute To Be A Psychopath",1,1,12,39,2,12,2,51,0
Donald Trump As Dumplings Is Everything You Need In Life,1,1,10,37,0,9,0,47,0
We Know What Your Relationship Status Will Be In 2017,1,3,9,31,0,9,4,40,0
Will Moonlight beat La La land? Our final Oscars 2017 awards predictions,1,3,6,50,1,11,4,56,0
27 Fictional Couples That Will Restore Your Faith In Black Love,1,1,10,41,0,10,2,51,0
Russian man to undergo world's first full head transplant,1,3,1,47,1,8,0,48,0
"Hannity: ‘No Knowledge’ If Surveilled — Threatens Lawsuit Against Obama, Ben Rhodes, Susan Rice If True",1,3,15,67,6,15,0,82,0
"VISA Debit, Credit Cards Can Be Hacked In Just A Few Seconds, Finds A Research In UK",1,2,21,45,2,16,0,66,0
"A Couple Received Letters Meant For Santa, So They Started Answering Them",1,2,12,49,1,11,0,61,0
Krauthammer Blasts U.N.: Trump Should Turn Manhattan HQ  'Into Condos'  Insider,1,3,13,49,5,12,0,62,0
WrestleMania Stories Collide in the Ring ,1,3,5,30,0,6,0,35,0
"How Well Do You Remember ""I Know What You Did Last Summer""",1,1,12,33,2,11,0,45,0
A Guideline For Using Household Objects As Sex Toys,1,1,9,34,0,8,0,43,0
How To Profit From Trump Inflation,1,3,6,23,0,5,0,29,0
Tweetbot 3 for Mac review - Business Insider,1,2,4,31,1,7,1,35,0
The Definitive Ranking Of Breakfasts,1,1,5,27,0,4,0,32,0
"23 Reasons ""The Office"" Is The Worst Show Of All Time",1,1,10,29,2,10,2,39,0
"Hands On With Apple Music: Slick, but Nothing Special",1,2,8,35,2,8,0,43,0
A Group Of People Tried Journaling Every Day For A Month And It Got A Little Too Introspective,1,1,18,59,0,17,0,77,0
"Hindu Leaders Are Protesting ""X-Men: Apocalypse"" For Comparing Its Villain To Lord Krishna",1,1,14,60,4,12,0,74,0
Can We Guess Your Secret Sexy Talent,1,1,7,23,0,6,0,30,0
Man's commentary of a NY train giving zero f*cks about people is comedy gold,1,3,3,58,2,13,0,61,0
"Discontinued Starbucks Polar Bear Cookies Are Getting Dragged Into Another ""War On Christmas""",1,1,13,66,2,12,0,79,0
How To Write An Autobiographical Novel,1,1,6,27,0,5,0,33,0
Taraji P. Henson Embraced Her Natural Beauty And Went Weave-Less For This Fashion Magazine,1,1,15,60,2,13,0,75,0
"I Moved Back To My Parent's House At 29, And It Wasn't The End Of The World",1,1,16,38,3,16,2,54,0
Alan Cartwright murder: Teen denies killing cyclist,1,2,3,41,1,6,0,44,0
Show Us The Funniest Picture You've Taken Of Your Dog,1,1,10,33,1,9,0,43,0
Can You Match The Song Lyrics To The Disney TV Movie,1,1,12,30,0,10,0,42,0
This couple earn a six-figure salary by travelling the world,1,2,1,49,1,9,0,50,0
This Video Beautifully Shows You The Many Faces Of Kerala,1,1,10,38,0,9,0,48,0
Best Nontoxic Beauty Gifts for Kids and Tweens,1,3,6,33,0,7,0,39,0
This One Question Will Show What Career You Should Actually Have,1,1,11,43,0,10,0,54,0
21 Ridiculously Cool Last-Minute Gifts Under $50,1,1,6,30,2,6,4,36,0
21 Hilarious Tweets That Prove Tyra Is The Most Relatable Supermodel Ever,1,1,11,49,0,11,2,60,0
17 Underrated Everyday Products That'll Change Your Life In 2016,1,1,8,40,1,9,6,48,0
"I Read The New Gender-Swapped ""Twilight"" Book So You Don't Have To",1,1,13,38,4,11,0,51,0
It’s prime derecho season in Washington: Everything you need to know,1,3,3,53,2,10,0,56,0
MILO Resigns from Breitbart News,1,2,7,21,0,4,0,28,0
Andrea Mitchell: Trump’s Attacks on Hillary’s Health Would Not Have Worked on a Man,1,3,11,56,3,13,0,67,0
"How Well Do You Know ""The Maze Runner""",1,1,8,21,2,7,0,29,0
17 Reasons You Should Love Eddie Redmayne,1,1,6,27,0,6,2,33,0
This Video Of A Bridge Collapsing Shows Just How Dangerous The Chennai Floods Are,1,1,14,54,0,13,0,68,0
This Week In History: 14-19 September,1,1,5,21,2,5,4,26,0
Dominatrix reveals what it's like to run a sex dungeon hotel,1,2,1,48,1,10,0,49,0
Do You Know What A Bathroom Is,1,1,7,17,0,6,0,24,0
Russia out of tune with Ukraine's Eurovision show,1,3,3,38,1,7,0,41,0
Kate Hudson's brother posts hilarious response to Brad Pitt rumours,1,2,4,53,1,9,0,57,0
"IMO, Early December Is The Best Time To Start New Year’s Resolutions",1,2,14,41,2,11,0,55,0
4 Simple Ways Women Can Help Women Succeed In Business,1,2,9,35,0,9,1,44,0
People On Facebook Are Taking A Stand After A Meteorologist Was Bullied For Her Baby Bump,1,1,16,58,0,15,0,74,0
21 Animal Vines That Will Make You Smile Every Time,1,1,9,31,0,9,2,40,0
"This Woman Is Trying To Reclaim The Saree In America, And It's Working",1,1,13,43,2,12,0,56,0
"Can You Pass This ""Christmas Shoes"" Test",1,1,7,25,2,6,0,32,0
19 Coming Home Outfits You Need For Your Newborn,1,1,8,30,0,8,2,38,0
13 Photographs Of Teens' Bedrooms That'll Show You How They Live,1,1,10,40,2,10,2,50,0
16 Products That Will Have Your Instagram Account Looking Fire,1,3,9,42,0,9,2,51,0
The Chinese people given enormous amounts of food - by their parents,1,3,2,54,1,11,0,56,0
A relationship expert reveals how to keep the spark in a long-term relationship,1,2,1,65,1,12,0,66,0
Here's A Bunch Of Things You Should Never Say To An Engineering Student,1,1,13,45,1,12,0,58,0
"Denver Muslim on Murder Charges Says He Acted ‘Solely For Pleasure of Allah,’ CBS Says Motive ‘Still Unclear’",1,3,18,69,5,17,0,87,0
7 Adorable Crossbreed Dogs You Never Knew Existed,1,1,7,34,0,7,1,41,0
Newborn Abducted From Hospital Bed Set To Reunite With Her Family After 18 Years!,1,3,13,52,1,13,2,65,0
Space Scientists Will Pay Men to Stay in Bed for 60 Days,1,3,8,35,0,11,2,43,0
This Baby Polar Bear Hitched A Ride On Its Mom's Butt,1,1,11,31,1,10,0,42,0
"Rihanna Gave The Right Amount Of Shade When Asked About Taylor Swift's ""Squad""",1,1,13,50,3,12,0,63,0
Which Shia LaBeouf GIF Matches Your Zodiac Sign,1,1,11,29,0,7,0,40,0
This Guy Ran A Marathon Shirtless With His Name On His Back And Got A Lot Of Attention,1,1,18,51,0,17,0,69,0
25 Tweets That Are Too Real For People Who Collected Pokemon Cards,1,1,11,42,0,11,2,53,0
15 Things You Hear When You Date Someone Obsessed With IMDB,1,1,13,34,0,10,2,47,0
"Buchanan on Syria: McCain, Graham, Rubio Are Not Going to Get ‘the War They Want’",1,3,13,49,5,14,0,62,0
Up Your Style Game With BuzzFeed's Health & Beauty Newsletter,1,1,10,40,2,9,0,50,0
We Know What TV Show You Should Watch Based On Your Mood,1,2,13,32,0,11,0,45,0
23 Actually Hilarious Jokes About Lying,1,3,5,27,0,5,2,32,0
Ryan Curry Was Definitely The Cutest Baby Born In 2015,1,1,9,32,0,9,4,41,0
"In A Rare Move, Supreme Court Allows 24-Week Pregnant Woman To Abort",1,3,12,41,2,11,2,53,0
The 5 Worst Super Bowl Halftime Performers Ever,1,3,7,32,0,7,1,39,0
Are You Above Average,1,1,4,14,0,3,0,18,0
27 Things You Would Never See On The Kardashians Today,1,1,9,34,0,9,2,43,0
Everything You Need To Know About The 38 Best Diets For Health,1,3,11,38,0,11,2,49,0
16 Hidden Gems to Binge On Over the Holidays,1,3,6,28,0,8,2,34,0
Animal Rights Activists Outraged as Micheal Bloomberg’s Daughter Dates Trophy Hunter,1,2,10,63,1,10,0,73,0
What's The Most Gorgeous Quote From A 2015 Book You Read This Year,1,1,12,37,1,12,4,49,0
Delhi Just Hosted India's First Ever Dog Beer Festival And Everything About It Was Amazing!,1,3,15,60,2,14,0,75,0
The Word Of The Day Is Thanks To Queen Amy Poehler,1,1,11,29,0,10,0,40,0
"Do You Actually Remember The First Episode Of ""The West Wing""",1,1,11,38,2,10,0,49,0
Find Out How Far You Can Drive Your Car on Empty,1,3,10,28,0,10,0,38,0
17 Things You Did And Cared About In 2005 That You Would Never Do Today,1,1,13,38,0,14,6,51,0
Ellen DeGeneres Made Herself A Victoria's Secret Angel And It's Absolutely Amazing,1,1,13,56,2,11,0,69,0
This Cheesy Mashed Cauliflower Is What Heaven Looks Like,1,1,9,39,0,8,0,48,0
‘Star Wars: Episode VIII’ Title Revealed,1,2,9,23,3,5,0,32,0
Most Brits Think Terrorism Is Inspired by ‘Religious Views’,1,3,8,41,2,8,0,49,0
Which Taylor Swift Music Video Stud Should You Date Based On Your Birth Month,1,1,14,50,0,13,0,64,0
26 YouTube Comments That Will Actually Make You Laugh,1,1,9,34,0,8,2,43,0
This Is What Disney Princesses Would Look Like In Real Life,1,1,11,38,0,10,0,49,0
Here's The Awesome Thing You Can Do With Your Election Day Pantsuit,1,3,12,43,1,11,0,55,0
People Try Activated Charcoal Drinks,1,1,5,27,0,4,0,32,0
Instagram's New Update Is a Game-Changer,1,2,6,27,2,5,0,33,0
These Charts Show New Winners of China's Transition to Wealth,1,3,8,43,1,9,0,51,0
19 New Things J.K. Rowling Taught Us About Harry Potter In 2015,1,1,11,33,2,11,6,44,0
Mary-Kate Olsen's Wedding Decor Was Just Bowls Of Cigarettes,1,1,10,40,2,8,0,50,0
Day 2 Of BuzzFeed's 7-Day Clean Eating Challenge,1,1,8,29,2,7,2,37,0
17 Practical Things Every Girl Needs,1,1,5,24,0,5,2,29,0
Kendall Jenner Was Super Excited To Be On DJ Khaled's Snapchat,1,1,12,39,1,10,0,51,0
16 Kids Who Are Figuring Out Life Faster Than You Are,1,3,10,31,0,10,2,41,0
23 Tweets That Are Way Too Funny For People Who Wear Makeup,1,1,11,35,0,11,2,46,0
36 Things You Probably Didn't Know About Nando's,1,1,7,30,2,7,2,37,0
Uber whistleblower exposes breach in driver-approval process,1,2,1,52,1,6,0,53,0
9 Really Important Things Every Black Woman Should Know About Her Edges,1,1,11,48,0,11,1,59,0
11 Things Everyone With A Vagina Needs To Know About Pap Smears,1,1,11,39,0,11,2,50,0
18 Resolutions You Won't Regret Making In 2016,1,1,6,26,1,7,6,32,0
21 Things Everyone Who Does BodyCombat Will Understand,1,1,8,37,0,7,2,45,0
Watch this slow-motion pile up unfold on an icy Montreal street,1,3,2,50,1,10,0,52,0
23 Valentine's Day Gift Ideas You'll Wish You Thought Of First,1,1,10,38,2,10,2,48,0
"Man Hangs Himself With Girlfriend's Dupatta, She Says It Was A Joke Gone Wrong",1,2,14,49,2,13,0,63,0
Which TV Family Should You Eat Thanksgiving With,1,1,9,32,0,7,0,41,0
19 Things That Prove Being Beautiful Can Be Scary,1,1,8,31,0,8,2,39,0
"8 Fall Shows To Be Excited About, 10 To Give A Chance, And 6 To Avoid",1,1,13,35,2,15,4,48,0
31 Times Frankie Boyle's Twitter Was Out Of Control,1,1,8,32,1,8,2,40,0
24 Pictures That Will Straight Up Fuck You Up,1,1,8,27,0,8,2,35,0
Here's How To Do The Rainbow Snapchat Filter IRL For Halloween,1,1,13,38,1,10,0,51,0
These Charts Perfectly Sum Up What It's Like Being A Teacher,1,1,11,38,1,10,0,49,0
Democrats Fundraise Off Lewis-Trump Feud,1,3,6,29,1,4,0,35,0
21 Chocolate And Booze Combinations That Are Better Than A Valentine,1,1,10,46,0,10,2,56,0
How Trump was able to order U.S. strikes on Syria without congressional approval,1,3,5,61,2,12,0,66,0
Heartbreaking Photos of Vets Being Neglected at VA Spark Outrage  Insider,1,3,10,52,0,11,0,62,0
Puppies Eat Peanut Butter For The First Time,1,1,8,29,0,7,0,37,0
Dad Blasts His Son's Poor Grades With Sign at Cavaliers Game Against Hornets,1,3,12,51,1,12,0,63,0
17 Life-Changing Ways To Eat M&M's,1,1,7,17,3,5,2,24,0
15 Most Inspiring Grilled Cheese Sandwiches Of 2015,1,1,6,32,0,7,6,38,0
Here's Why These Ikea Items Are Cheaper Now Than They Were 30 Years Ago,1,3,13,42,1,13,2,55,0
The Winners And Losers Of Asian Representation In Hollywood In 2015,1,1,10,43,0,10,4,53,0
Here's An Easy Way To Make Jambalaya,1,1,7,22,1,6,0,29,0
One of the biggest hedge fund launches of all time is shutting down,1,2,1,54,0,12,0,55,0
12 Tips for Gracefully Returning Holiday Gifts,1,3,5,33,0,6,2,38,0
34 Workout Tips For Anyone Who Has No Idea What They're Doing,1,1,11,36,1,11,2,47,0
25 Family Halloween Costumes That'll Convince You To Have Kids,1,1,9,41,1,9,2,50,0
Merriam-Webster thinks Apple lovers are sheeple,1,3,3,38,1,5,0,41,0
"The Best Fast Food, Picked by the World’s Top Chefs",1,3,8,32,2,9,0,40,0
"When Employers Ask About Your Salary History, Say This",1,2,9,36,1,8,0,45,0
People Mash Up Various Fast Foods To Create The Ultimate Food,1,1,11,40,0,10,0,51,0
Can We Guess Your Favorite Color Based On Your Birth Month,1,1,11,37,0,10,0,48,0
What Type Of Fall Sweater Are You,1,1,7,20,0,6,0,27,0
This Is What It’s Like To Work At Lisa Vanderpump’s Restaurant,1,3,11,39,2,10,0,50,0
16 Hilarious Revelations That All Wine-Lovers Can Relate To,1,1,9,39,1,8,2,48,0
22 Honest Comebacks Retail Workers Wish They Could Use,1,1,8,36,0,8,2,44,0
"'Students should mark each other's tests to improve grades', says top school head",1,3,1,64,4,12,0,65,0
'90s Kids Recreate Their Childhood Halloween Costumes,1,1,6,38,1,6,2,44,0
Train row almost pulls Kosovo and Serbia off the rails,1,3,3,42,0,9,0,45,0
42 Cat GIFs Guaranteed To Make You Laugh Every Time,1,1,11,29,0,9,2,40,0
8 Weird Things Only Gamers Do,1,1,5,18,0,5,1,23,0
"Michel Roux Jr, here’s a recipe for tipping",1,3,3,31,2,7,0,34,0
The company that makes America's engagement rings plans to open a bunch of stores and close even more,1,2,2,81,1,17,0,83,0
Are You Pee Or Poo,1,1,5,9,0,4,0,14,0
Are You More Thanksgiving Or Christmas,1,1,6,27,0,5,0,33,0
8 Ways To Prove You're From San Diego,1,1,7,21,1,7,1,28,0
What's Your Personality Type Based On Your Opinion Of Eggs,1,1,10,38,1,9,0,48,0
How Well Do You Know Your Poodle Mixes,1,1,8,23,0,7,0,31,0
21 Terrifyingly Perfect Gifts For Shark-Loving Kids,1,1,7,35,1,6,2,42,0
What 10 World Landmarks Could Look Like In An Epic Drought,1,1,10,36,0,10,2,46,0
25 Of The Most Epic Celebrity Glo Ups,1,3,7,21,0,7,2,28,0
Here's Your Sunday BuzzFeed Comics Roundup,1,1,7,29,1,5,0,36,0
Just 27 Surprisingly Funny Tweets About Cats,1,1,6,30,0,6,2,36,0
Sears Admits It Has 'Substantial Doubt' About Its Ability To Survive,1,3,11,45,2,10,0,56,0
The 29 Most WTF TV Moments Of 2015,1,1,9,12,0,7,6,21,0
The Dystopia Project: 'It Can't Happen Here' -- and it hasn't yet,1,2,7,40,7,11,0,47,0
21 Lies All Men Have Told About Sex,1,1,7,19,0,7,2,26,0
10 PlayStation Experience reveals you might have missed,1,2,3,43,0,7,2,46,0
It's Actually Impossible For J.Lo To Look Anything Other Than Flawless,1,1,12,46,2,10,0,58,0
52 Places to Go in 2017 ,1,2,2,10,0,6,6,12,0
21 Vines That You'll Think Are Actual Magic,1,1,7,26,1,7,2,33,0
"Thank Goodness, Demi Lovato And Selena Gomez Are Still Friends",1,1,10,42,1,9,0,52,0
22 Struggles Of People With Zero Athletic Ability,1,1,7,33,0,7,2,40,0
17 Faces Paleta Payaso Made That You Could Relate To,1,1,9,32,0,9,2,41,0
This man could soon be handling America’s most politically charged investigation,1,3,2,67,1,10,0,69,0
CNN Crew Caught Joking About Donald Trump’s Plane Crashing (Video),1,2,12,42,3,9,0,54,0
11 Things People Recovering From Anorexia Want You To Know,1,1,9,38,0,9,2,47,0
What Does Your Favorite Part Of A Man's Body Say About You,1,1,12,34,1,11,0,46,0
Were You More Selena Gomez Or Kendall Jenner In 2015,1,1,9,30,0,9,4,39,0
This Couple Lost Two Rings Within Two Days Of Marriage,1,1,10,35,0,9,0,45,0
24 Couples Who Didn't Let Bad Weather Ruin Their Engagement Photos,1,3,10,43,1,10,2,53,0
19 Pictures That Sum Up Life When You're Bad At Math,1,1,10,29,1,10,2,39,0
Fox Sports Talker Joe Buck Advises Announcers to ‘Stick to Sports’,1,3,9,45,2,10,0,54,0
We Know Your Favorite Unexpected Disney Or Pixar Villain Based On Your Favorite Taylor Swift Song,1,1,16,66,0,15,0,82,0
We Scared Olympic Athletes With Live Turkeys,1,1,7,31,0,6,0,38,0
15 Mind-Blowing Ways To Eat Apples,1,1,6,20,1,5,2,26,0
22 Landlords Who Need To Be Fucking Stopped,1,1,7,27,0,7,2,34,0
Game of Thrones fan does an ultra geeky deep dive into death,1,3,2,47,0,11,0,49,0
What It's Like Inside Disney World's New Private Cabanas,1,3,9,37,2,8,0,46,0
The map of where food is most expensive in Europe The list,1,3,3,44,0,11,0,47,0
42 Heart-Pounding Moments From The Non-Stop BBC Four Sleigh Ride,1,1,13,38,2,9,2,51,0
This New Cruise Ship Reimagines What It Means to Be Outdoors,1,3,10,40,0,10,0,50,0
Once You See Jamie Fraser Your Life Will Never Be The Same Again,1,1,13,39,0,12,0,52,0
If White People Thought About Race Like People Of Color,1,1,10,36,0,9,0,46,0
Give It To Me Straight: Is This Thing A Sandwich Or Not?,1,3,12,31,2,11,0,43,0
The Bottom Line: 'Homesick For Another World' By Ottessa Moshfegh,1,3,10,43,3,9,0,53,0
"Lil Bub Is Announcing Her First Album Right Here, Right Now",1,1,11,37,1,10,0,48,0
Which 2006 Hit Single Are You Based On Your Star Sign,1,1,10,29,0,10,4,39,0
Which Selena Gomez Album Should You Be Listening To,1,1,9,34,0,8,0,43,0
"Yahoo India Has Named The ""Cow"" India's Top Personality Of The Year",1,1,12,41,3,11,0,53,0
Bank Tellers Draw Scrutiny Over Security,1,3,6,29,0,5,0,35,0
Here's How You Can Recycle Beer Bottles To Make Totally Cool Drinking Glasses,1,1,13,51,1,12,0,64,0
Only A True Crime Expert Can Get More Than 7/10 On This Quiz,1,3,12,32,1,12,3,44,0
21 Genius Ways To Eat Peanut Butter And Jelly,1,1,8,27,0,8,2,35,0
21 Secrets Build-A-Bear Employees Will Never Tell You,1,1,9,33,2,7,2,42,0
Iman's Recent Instagram Posts Are Heartbreaking,1,1,6,35,1,5,0,41,0
Who Should Lead The Squad,1,1,5,16,0,4,0,21,0
Make Your Instagram Captions Sound Profound With These Elliott Smith Lyrics,1,1,11,54,0,10,0,65,0
"Kanpur Train Accident Could Be Linked To ISI, Dawood Ibrahim Says Bihar Police",1,3,15,50,1,12,0,65,0
Italian TV presenter gives viewers a real news flash when she forgets she is sitting behind a glass desk,1,3,3,83,0,18,0,86,0
'World's original sports car' to be sold at auction,1,3,1,39,3,8,0,40,0
A Dad Was Shocked When He Found Out He Accidentally Ran Over His Own Son,1,1,15,43,0,14,0,58,0
How Many Of These Iconic Teen Movies Have You Seen,1,1,10,31,0,9,0,41,0
"Donald Trump, Quebec City, Patriots: Your Monday Evening Briefing ",1,3,9,45,3,9,0,54,0
Justin Theroux Just Posted A Pic For Jennifer Aniston’s Birthday And OUR HEARTS ARE MELTING,1,2,30,46,1,14,0,76,0
This Video Of Bros Dancing To Justin Bieber On Hoverboards Is Perfect,1,1,12,46,0,11,0,58,0
CPAC Straw Poll Finds Overwhelming Support for Donald Trump,1,2,11,40,0,8,0,51,0
23 Food Truths Only Mexicans Would Understand,1,1,6,31,0,6,2,37,0
17 Indian Musicians Who Changed The Damn Game In 2015,1,1,8,30,0,9,6,38,0
How Republics End ,1,3,3,12,0,3,0,15,0
This Dog Smiling For The Camera Is The Happy You Need Today,1,1,12,36,0,11,0,48,0
Eight ways President Donald Trump will make history,1,3,4,40,0,7,0,44,0
The 18 Best Moments For '90s Kids In 2015,1,1,6,18,1,8,8,24,0
"How Well Do You Know The Words To Eminem's ""My Name Is""",1,1,12,29,3,11,0,41,0
This Is All The Exercise You'll Have To Do To Burn Off Your Thanksgiving Dinner,1,1,15,49,1,14,0,64,0
This Is How People On Twitter Reacted To Jose Mourinho Leaving Chelsea,1,1,12,47,0,11,0,59,0
This A Capella Cover Of The 'Jurassic Park' Theme Song Is Simply Dino-Mite,1,2,14,45,3,12,0,59,0
31 Brilliant Words You Didn't Know You Needed In 2015,1,1,8,29,1,9,6,37,0
12 Famous Writers Told Us About The Book They're Most Thankful For,1,1,11,41,1,11,2,52,0
Kendall Jenner And Hailey Baldwin Had The Funnest Shopping Date In Beverly Hills,1,1,13,55,0,12,0,68,0
14 Questions British People Have About The French Language,1,1,8,40,0,8,2,48,0
iOS 9 and OS X El Capitan: The little features we can't wait to use,1,3,8,42,2,14,1,50,0
Table 19 review – divorce yourself from this unfunny wedding comedy,1,3,1,53,1,10,2,54,0
9 Leadership Lessons From 'Hidden Figures' About Workplace Diversity And Inclusion,1,2,10,59,2,10,1,69,0
Here's Why Science Says It's Totally Possible To Make Bread With Your Vaginal Yeast,1,1,14,54,2,13,0,68,0
MTV Spring Break Throwback Photos,1,3,7,22,0,4,0,29,0
"AFL-CIO Praises President Trump’s Move to Withdraw from TPP, Renegotiate NAFTA, Target Big Pharma",1,3,23,57,4,13,0,80,0
"Before She Was Famous, Katy Perry Was A Backup Singer For POD",1,1,14,35,1,11,0,49,0
Evidence for one of the most bizarre theories about Trump is mounting The list,1,2,3,62,0,13,0,65,0
How the face of MLB's steroid era is getting closer to the Hall of Fame,1,2,6,50,1,14,0,56,0
This optical illusion is baffling the internet The list,1,3,2,45,0,8,0,47,0
"Which Hogwarts Houses Do These ""Doctor Who"" Characters Belong In",1,1,10,43,2,9,0,53,0
"13 Reasons Tatiana Maslany Deserves The Emmy For ""Orphan Black""",1,1,9,41,2,9,2,50,0
"Who Would You Leave ""Bachelor In Paradise"" With Based On Your Zodiac Sign",1,1,13,46,2,12,0,59,0
Which Troye Sivan Song Should Be Your Anthem,1,1,8,29,0,7,0,37,0
The Secret to a Happy Marriage? Two Master Bedrooms,1,3,7,35,1,8,0,42,0
18 Dogs Who Are Stuck In Things But Doing Just Fine,1,1,10,29,0,10,2,39,0
Here’s how much you should be tipping your hairdresser,1,3,1,44,1,8,0,45,0
A Divided America: How We Die Depends on Where We Live,1,3,10,33,1,10,0,43,0
Study: Kids can learn as much from ‘Sesame Street’ as from preschool,1,2,4,50,3,11,0,54,0
21 Times Victoria And David Beckham Proved Love Is Real In 2015,1,1,10,36,0,11,6,46,0
12 Bizarre Christmas Traditions From Around The World,1,1,7,37,0,7,2,44,0
Pilot walked away after plane crashes nose first on Maine highway ,1,3,2,53,0,11,0,55,0
How could things get worse for Trump?,1,2,2,28,1,6,0,30,0
How Well Do You Remember '00s Rom Coms,1,1,7,21,1,7,2,28,0
SNL Audience Cheers Wildly After Character Calls Donald Trump ‘Little White Bitch’,1,3,14,55,2,11,0,69,0
Big Show: The giant with the six-pack,1,2,3,26,2,6,0,29,0
"Turns Out No One Knows The Words To ""Waterfalls""",1,1,9,29,2,8,0,38,0
Which Justin Timberlake Lyric Matches Your Zodiac,1,1,7,36,0,6,0,43,0
"Selena Gomez And Chloe Grace Moretz Are The New Supremes In Trailer For ""Neighbors 2""",1,1,14,54,2,14,1,68,0
Why Does Hot Water Sometimes Freeze Faster Than Cold Water?,1,3,10,39,1,9,0,49,0
A Photo Of Demi Lovato Has Now Become A Huge Meme Called Poot,1,1,13,36,0,12,0,49,0
29 Professions That Will Make Your Parents Proud,1,1,7,32,0,7,2,39,0
"Here's Our Best Look Yet At The Harry Potter ""Fantastic Beasts"" Movie",1,1,12,43,3,11,0,55,0
"Watch The Trailer For J. Cole's ""Forest Hills Drive: Homecoming"" HBO Special",1,1,14,46,5,11,0,60,0
"This teenager used to walk miles to work to take care of his mother, then everything changed The list",1,2,2,80,1,18,0,82,0
David Beckham Just Got Romeo The Best Birthday Present,1,1,9,37,0,8,0,46,0
This is how you and your child select the right college,1,3,1,44,0,10,0,45,0
Dieses Video ist nicht verfügbar. This little girl shows how to do the best bottle flip ever!,1,3,3,72,2,16,0,75,0
We Put Sandra Bullock And Billy Bob Thornton's Friendship To The Test,1,1,12,45,1,11,0,57,0
This Woman Shares Her Story Of When She Really Hurt Her Vagina,1,1,12,39,0,11,0,51,0
29 Gorgeous Ways To Forget All About Your Ex,1,1,8,26,0,8,2,34,0
13 Unbelievably Weird Ways People Actually Eat Chocolate Bars,1,1,8,43,0,8,2,51,0
We Can Guess Your Chipotle Burrito Order With A Single Question,1,1,11,42,0,10,0,53,0
Situation vacant: Running Rome's Colosseum,1,2,4,32,2,4,0,36,0
Your Friend Who's Back From Traveling,1,1,6,25,1,5,0,31,0
Are You More Alexander Hamilton Or Aaron Burr,1,1,8,30,0,7,0,38,0
This Is What Being On Tumblr Before 2011 Was Like,1,1,9,27,0,9,4,36,0
Meet Pumpkin The Raccoon,1,1,4,17,0,3,0,21,0
What's The Sexiest Book You Ever Read,1,1,7,23,1,6,0,30,0
"Here Is Everything Jessica Jones Drinks In ""Jessica Jones""",1,1,9,39,2,8,0,48,0
38 Celebrities Who Are Celebrating Birthdays In December,1,1,7,40,0,7,2,47,0
21 Things That Will 100% Happen When You Move In With Your S.O.,1,3,12,31,3,12,5,43,0
27 Things You Need To Know About Andy Grammer,1,1,8,27,0,8,2,35,0
Kylie Jenner's Wheelchair Mag Cover Blasted By Disability Advocates,1,1,9,49,1,8,0,58,0
Greg Ip: Three Economic Puzzles Are Now Less Puzzling - Real Time Economics,1,2,12,49,2,12,0,61,0
Free online resources to improve productivity - Business Insider,1,3,3,52,1,8,0,55,0
‘Deaths of Despair’ Are Surging Among the White Working Class,1,3,8,42,2,9,0,50,0
Can You Guess Why Ross Geller Is Freaking Out From A Screenshot,1,1,12,40,0,11,0,52,0
21 Incredible Ways To Eat More Ranch Dressing In 2016,1,1,8,30,0,9,6,38,0
The sad story behind the lyrics to East 17’s ‘Stay Another Day’,1,3,5,42,3,11,2,47,0
Which Taylor Swift Tattoo Should You Get,1,1,7,27,0,6,0,34,0
17 Truths Only Female Best Friends Will Understand,1,1,7,34,0,7,2,41,0
18 Times Khloe Kardashian Was The Coolest Aunt In The World,1,1,10,37,0,10,2,47,0
Stephen Hawking: Jeremy Corbyn is a disaster for Labour,1,3,5,41,1,8,0,46,0
Intel's lead anthropologist: The 4 questions every tech entrepreneur should ask,1,2,2,64,2,10,1,66,0
Beauty Brands That Broke Diversity Barriers in 2016 [Video],1,3,7,38,2,8,4,45,0
Which Michael Cera Are You,1,1,5,17,0,4,0,22,0
First Comes Tinder. Then Comes Marriage? ,1,3,6,27,2,6,0,33,0
9 Bearded Guys Who Slayed The No-Makeup Makeup Look,1,1,9,32,1,8,1,41,0
When You Text Your Ex,1,1,5,12,0,4,0,17,0
Magna Carta: Everything You Need to Know About the 800-Year-Old Document,1,2,10,46,3,10,3,56,0
Pacey Vs. Dawson: Who Had The Hotter Dec. 9,1,1,8,23,3,8,1,31,0
Men Have a Harder Time With Aging Than We Thought. Here’s How to Deal With It [Video],1,3,15,50,4,16,0,65,0
16 Beautifully Touching Tattoos That Honor Moms,1,1,6,33,0,6,2,39,0
Here Are The Top Trending Recipes Googled In 2015 And Ways To Eat Them,1,1,13,40,0,13,4,53,0
"Molly Ringwald Thinks You're Great Too, Claire Danes",1,1,8,35,2,7,0,43,0
33 Healthy Eating Habits Lazy College Students Will Appreciate,1,1,8,44,0,8,2,52,0
16 Cosplayers Share The Kindest Thing Someone Has Done For Them,1,1,10,41,0,10,2,51,0
The Case For Queer Superhero Films,1,1,6,23,0,5,0,29,0
Taxes From A To Z (2017): A Is For Affordable Care Act Reporting,1,2,12,33,3,12,4,45,0
Conglomerate Feels Heat From China’s Anger at South Korea   ,1,2,8,40,1,11,0,48,0
37 Things Your Cat Thinks You're Doing When You Leave,1,1,9,32,1,9,2,41,0
Tell Us About Yourself(ie): Kaitlin Doubleday,1,1,6,31,3,5,0,37,0
15 Things Anyone With An Alcohol Allergy Is Tired Of Hearing,1,1,10,38,0,10,2,48,0
Flash mob brings love and money to mom battling cancer,1,3,1,44,0,9,0,45,0
Newly-Released Clinton Email: Huma Sent ‘Secure Document’ While Hillary Did Yoga,1,3,12,54,4,10,0,66,0
Are You A Feminist Or A Meninist,1,1,7,19,0,6,0,26,0
Why Chance the Rapper is donating $1m to Chicago schools,1,3,4,41,1,9,1,45,0
"Alexander Dugin - The one Russian linking Donald Trump, Vladimir Putin and Recep Tayyip Erdogan",1,2,11,68,2,14,0,79,0
The Hardest Pixar Character Quiz You Will Ever Take,1,1,9,34,0,8,0,43,0
21 Insane Things That Were Actually Said To People Of Color,1,1,10,37,0,10,2,47,0
Pearl Harbor: Wounds of war still hurt for 95yo Japanese veteran,1,2,4,47,1,10,2,51,0
"Can You Guess The ""Friends"" Episode Title From Emojis",1,1,9,34,2,8,0,43,0
"Which ""Friends"" Character Are You Based On Your Birth Month",1,1,10,38,2,9,0,48,0
11 Scary Movies That Would Actually Horrify Musicians,1,1,7,37,0,7,2,44,0
14 Things You Did To Look Cool As Teens That Aren't Cool Now,1,1,12,33,1,12,2,45,0
35 Costumes Guaranteed To Win Halloween,1,1,5,27,0,5,2,32,0
The 25 Most Cringeworthy Band Photos Of All Time,1,1,8,30,0,8,2,38,0
Dating With Schizophrenia ,1,2,3,20,0,3,0,23,0
This Hairstylist Reinterprets Famous Paintings As Hair Colors,1,1,8,46,0,7,0,54,0
This is what happens to your penis as you get older The list,1,3,2,46,0,12,0,48,0
16 Products That Will Have Your Instagram Account Looking Fire,1,2,9,42,0,9,2,51,0
Getting Management to See Your Big Ideas | Ashford University,1,3,8,43,1,9,0,51,0
Which Of Taylor Swift's Grammys Are You,1,1,7,25,1,6,0,32,0
Which Rachel Green Hairstyle Are You,1,1,6,25,0,5,0,31,0
The 20 Funniest Tweets From Women This Week,1,3,7,27,0,7,2,34,0
This Comic Shows The True Struggle Of Adulting While Awkward,1,1,10,41,0,9,0,51,0
"Which ""Harry Potter"" Sweet Should You Eat This Halloween",1,1,9,37,2,8,0,46,0
Is This A Sunset Or A Grilled Cheese,1,1,8,21,0,7,0,29,0
Tell Us About Yourself(ie): Luke Bryan,1,1,6,24,3,5,0,30,0
"Generation X, Y and Baby Boomers: Why every generation feels entitled",1,3,6,51,2,10,0,57,0
Tall Girls Wore Heels For A Week And Decided It Was Kinda Cool,1,1,13,37,0,12,0,50,0
"13 Texts From The ""Star Wars"" Characters",1,1,6,24,2,6,2,30,0
Can You Pick The Right Dog,1,1,6,15,0,5,0,21,0
Newly Married Woman Murdered Her Husband Because Her Friends Said He Wasn't Handsome Enough To Match Her,1,3,17,70,1,16,0,87,0
Get fit in just FIFTEEN minutes: The simple exercise you can do at home to get your heart racing ,1,3,9,68,1,19,0,77,0
Purdue's Caleb Swanigan has changed his body and his life,1,3,3,44,1,9,0,47,0
The Hardest Football Stadium Quiz You'll Take Today,1,1,8,35,1,7,0,43,0
This Is Actually Why Coffee Makes You Shit,1,1,8,27,0,7,0,35,0
"I Called Luke's Phone Number On ""Gilmore Girls"" And Here's What Happened",1,1,12,45,4,11,0,57,0
12 Celebrity #TBT Photos You Need To See This Week,1,1,11,27,1,9,2,38,0
This Company May Have Just Created The Most Comfortable Men's Underwear,1,1,11,49,1,10,0,60,0
International Women's Day: Five reasons life is hard for women in 2017 (and what you can do to improve it),1,3,4,75,4,19,4,79,0
What we do and don't know about Russia's interference in the  presidential election,1,3,2,66,2,13,0,68,0
14 Dogs Who Definitely Didn't Peek At Their Presents,1,1,8,33,1,8,2,41,0
If You Love “Harry Potter” You Won’t Be Able To Get Through This Post Without Crying,1,2,16,50,3,15,0,66,0
Obama Wishes Jews ‘Happy Hanukkah’ — as He Stabs Israel at UN,1,2,10,37,3,11,0,47,0
Who Is Your Celebrity Ex Based On Your Zodiac,1,1,9,28,0,8,0,37,0
‘Clock Boy’ Dad Vows to Appeal Tossed Case,1,2,7,26,2,7,0,33,0
How Posh Are Your Food Habits,1,1,6,18,0,5,0,24,0
Can You Pass This Basic Algebra Quiz,1,1,7,23,0,6,0,30,0
19 Gross Kitchen Habits You Probably Definitely Have,1,1,7,36,0,7,2,43,0
21 Totally Unexpected Holiday Cards To Send This Year,1,1,8,35,0,8,2,43,0
Why One Middle School Has Adopted Gender-Neutral Uniforms,1,2,9,40,1,7,0,49,0
Will the federal budget launch a new era in social and affordable housing?,1,3,1,60,1,12,0,61,0
Americans Listen To Japanese Pop Music For The First Time,1,1,10,38,0,9,0,48,0
25 Marketing Influencers To Watch In 2017,1,3,5,24,0,6,6,29,0
How Anyone Can Invest Like Warren Buffett,1,2,7,28,0,6,0,35,0
"Liam Neeson and 22 other actors who have gained or lost weight for film roles, in pictures",1,3,2,69,1,16,2,71,0
"Here's How To Play ""Fallout 4"" As Imperator Furiosa",1,1,8,31,3,8,1,39,0
Are You An Introvert Or Are You Just High,1,1,9,24,0,8,0,33,0
Liked ‘Serial’? Here’s Why the True-Crime Podcast ‘S-Town’ Is Better ,1,2,11,40,8,10,0,51,0
‘Trump’s Worst Day as President’: Celebs Rejoice as GOP Healthcare Bill Fails,1,3,12,50,4,11,0,62,0
GOP Sen Collins: House Healthcare Bill ‘Dead on Arrival’ in Senate,1,3,11,42,3,10,0,53,0
23 Totally Amazing BodyCon Looks You'll Wanna Rock This Fall,1,1,10,38,1,9,2,48,0
19 Heartbreakingly Honest Confessions About Dating As A Transgender Person,1,1,9,54,0,9,2,63,0
Thierry Henry's Reaction To Brendan Rodgers Being Sacked Is Utterly Brilliant,1,1,11,55,1,10,0,66,0
100 Women 2016: Indian women 'loiter' in public places at night,1,2,2,41,3,10,7,43,0
What prosecutors have to prove in order for you to be charged with a financial crime,1,3,1,68,0,15,0,69,0
This Woman's Powerful Photos Show The Dangers Of Tanning,1,3,9,38,1,8,0,47,0
We Know Your Age And Relationship Status Based On Your Chinese Zodiac,1,1,12,46,0,11,0,58,0
Beauty Blogger Gives Her Mom With Cancer a Stunning Makeover [Video],1,3,10,46,2,10,0,56,0
How To Flirt With Queer Girls Without Making A Total Fool Of Yourself,1,1,13,44,0,12,0,57,0
"Inside the cult of Secret Wedding Pinterest, where fiances are optional",1,3,4,56,1,10,0,60,0
21 Top Secret Devices From The Dangerous World Of Spies,1,3,9,35,0,9,2,44,0
"Here's Why You Should Go To The Doctor Every Year, According To A Doctor",1,1,14,43,2,13,0,57,0
Donald Trump's Administration Will Be the Wealthiest in Modern U.S. History,1,3,10,52,3,10,0,62,0
Piper And Alex Are Totally Back On In The New Season Of “Orange Is The New Black”,1,2,17,46,2,16,0,63,0
Bryan Cranston Just Revealed The Marvel Villain He's Dying To Play,1,1,11,44,1,10,0,55,0
Have You Had A Real-Life Meet-Cute,1,1,8,19,2,5,0,27,0
"The ""Star Wars"" Cast Recorded An A Cappella Version Of The Famous Theme",1,1,13,44,2,12,0,57,0
The 20 Funniest Tweets From Women This Week,1,2,7,27,0,7,2,34,0
What Type Of Thot Are You,1,1,6,14,0,5,0,20,0
"Europe’s drug use, in 2 maps",1,2,1,19,2,5,1,20,0
"IIT Madras Website Hacked, Pro-Pakistan Messages Posted On Page",1,3,12,41,2,8,0,53,0
Conway: Dems Have Time to ‘Cry and Weep’ at Airports But Not Vote on Trump Nominations,1,3,12,56,3,15,0,68,0
"Wait, Are Quavo and Karrueche Dating?",1,2,5,25,2,5,0,30,0
You big babies! Giant sumo wrestlers wince as they receive a flu jab ,1,3,2,53,1,13,0,55,0
Kate Winslet Had The Time Of Her Life At This Year's BAFTAs,1,1,16,31,1,11,0,47,0
We Know Your Taste In Men Based On One Horror Movie Question,1,1,12,37,0,11,0,49,0
23 Times Shah Rukh Khan Was The Cutest Dad Ever,1,1,9,27,0,9,2,36,0
"I'm Adopted, But I'm Not",1,1,5,12,3,4,0,17,0
"Disney Has Released The First Two Teasers For Tim Burton's ""Alice Through The Looking Glass""",1,1,15,60,3,14,0,75,0
Fake News: How a Partying Macedonian Teen Earns Thousands Publishing Lies,1,3,10,52,1,10,0,62,0
This Guy Married His Third-Grade Crush After Tagging Her In A Class Picture On Facebook,1,1,16,56,1,14,0,72,0
Britney Spears Or BS,1,1,5,12,0,3,0,17,0
New safety advice issued for combined oral contraceptives after review into pill and blood clot risk,1,3,1,84,0,15,0,85,0
Why Is Kimmy Gibbler Doing The Whip And The Nae Nae,1,1,11,30,0,10,0,41,0
"Hey Ed Westwick, Why",1,1,4,12,1,3,0,16,0
PA Police: Hillary Fan Bashed Elderly Woman’s Head with Chair During Election Argument,1,3,13,59,2,12,0,72,0
"Turkey’s general election deals blow to Erdogan, creates political uncertainty",1,3,2,65,2,9,0,67,0
A problem for senators hesitating over Trump nominees: The alternative might be worse,1,3,3,69,1,12,0,72,0
BuzzFeed Openlab Blog,1,1,4,15,0,2,0,19,0
This 3-Year-Old Kid Has His Own Roller Coaster in His Backyard!  Insider,1,3,12,44,3,12,1,56,0
Which Bachelor Or Bachelorette Is Your True Love Based On Your Zodiac,1,1,12,46,0,11,0,58,0
ADPVoice: How Does Your Organization Stack Up In Health Benefits Spending?,1,3,14,48,2,10,0,62,0
7 Ways To Eat Healthier This Week,1,2,6,20,0,6,1,26,0
The Most Powerful Brands In 2017,1,2,5,18,0,5,4,23,0
26 Seriously Fucked-Up Things People Have Done To Their Sims,1,1,10,38,1,9,2,48,0
"This Is What Thousands Of People Singing ""Sweet Child O' Mine"" Together Sounds Like",1,1,14,53,3,13,0,67,0
Destinations #WeAreNotAfraid: 45 reasons why we will always love London,1,2,6,52,2,9,2,58,0
"According To ""The Tonight Show"" Sandra Bullock Should Not Work In Food Service",1,1,13,51,2,12,0,64,0
26 Apps That Will Help You Get Shit Done This Year,1,1,10,28,0,10,2,38,0
Donald Trump Shared A Proverb With His 'Irish Friends.' It Likely Wasn't Irish.,1,3,13,49,5,12,0,62,0
This Stunning New Clothing Line Bridges Fashion And Feminism,1,1,9,43,0,8,0,52,0
22 Pictures That Men Will Just Never Ever Understand,1,2,8,34,0,8,2,42,0
Hello world! Polar bear cub gives a wave to the cameras at German zoo which is asking for the public to name it ,1,3,3,85,1,23,0,88,0
"24 Hauntingly Beautiful Tattoos Featuring No Face From ""Spirited Away""",1,1,9,48,2,9,2,57,0
America Needs Small Apartment Buildings. Nobody Builds Them,1,3,8,43,1,7,0,51,0
"The Hardest ""10 Things I Hate About You"" Quiz You'll Ever Take",1,1,11,35,3,11,2,46,0
Hear A Taste Of Zayn Malik's Solo Material,1,1,8,26,1,7,0,34,0
"Actress Sarah Wynter: GOP Wants to Allow Concealed Carry for the Blind, Mentally Ill",1,3,13,56,2,13,0,69,0
16 Hilarious Dieting Fail Confessions That Are Way Too Real,1,1,9,39,0,9,2,48,0
"31 Deep, Wise, And Hilarious Things We Overheard At NH7 Weekender Pune",1,1,12,42,2,11,3,54,0
We Tried The Sexy Donald Trump Costume And It Was A Disaster,1,1,12,37,0,11,0,49,0
This One Makeup Question Will Determine Your Dominant Character Trait,1,1,10,50,0,9,0,60,0
How Glamorous Are You Actually,1,1,5,21,0,4,0,26,0
Obama Deploying Dozen-Strong Team to ‘Keep Tabs’ on Trump Administration,1,3,9,51,3,9,0,60,0
Suns deny Russell Westbrook of triple-double mark: 'Not versus us',1,2,4,49,4,9,0,53,0
Why Arsenal need Zlatan Ibrahimovic,1,3,4,27,0,4,0,31,0
"Which Season Of ""American Horror Story"" Should You Binge Before ""Hotel""",1,1,11,46,4,10,0,57,0
Stars Share Their Hilarious Pre-Golden Globes Moments,1,1,8,38,1,6,0,46,0
American Santas Try International Sweets,1,1,5,31,0,4,0,36,0
6 things you should never store on your work computer,1,2,0,43,0,9,1,43,0
7 Healthy Eating Tricks That Are Actually Doable,1,1,7,33,0,7,1,40,0
19 Fucking Infuriating Things About Women's Clothing,1,3,6,37,1,6,2,43,0
17 Birds Who Are Complete Assholes,1,1,5,22,0,5,2,27,0
This Cajun Pasta Dish Is The Ultimate Comfort Food,1,1,9,33,0,8,0,42,0
14 Perfect Japanese Words You Need In Your Life,1,3,8,29,0,8,2,37,0
Santa Monica Firefighter Uses CPR to Save Dog’s Life,1,3,10,33,1,8,0,43,0
Jennifer Lawrence Confessed She Has Made Out With Liam Hemsworth In Real Life,1,1,13,52,0,12,0,65,0
This Video Perfectly Captures The Struggles Indian Women Face When Finding A Public Toilet,1,1,14,63,0,13,0,77,0
For Anyone Who Experiences Regret After Ejaculating,1,1,7,38,0,6,0,45,0
Is There Another 'You' Out There In A Parallel Universe?,1,3,10,34,3,9,0,44,0
A Superior Chicken Soup ,1,3,4,16,0,4,0,20,0
19 Hilarious Jokes All Book Nerds Will Appreciate,1,1,7,33,0,7,2,40,0
Washington Capitals' ‘Social Night’ Fails Epically After They Mistake Real Picture for Face Swap,1,3,13,67,3,13,0,80,0
11 Quick Facts About A Potential Government Shutdown,1,3,7,36,0,7,2,43,0
What's Mom Sharing Now,1,1,4,14,1,3,0,18,0
What’s in and what’s out for retirees in 2017,1,3,1,30,2,8,4,31,0
Here Are 10 Things That Are Less White Than The Oscars,1,1,10,32,0,10,2,42,0
"29 Times ""Hocus Pocus"" Was The Best Halloween Movie Of All Time",1,1,11,37,2,11,2,48,0
"Mike Barnicle: ‘Delegitimization of the Presidency Is Taking Hold’ – ‘Now, It’s Like, Trump’s President? Really?’",1,3,13,73,12,15,0,86,0
Recalled Newsweek ‘Madam President’ Clinton issue hits eBay,1,2,6,44,2,7,0,50,0
Here's What It Would Look Like If We Arranged Divorces The Way We Arrange Marriages,1,1,15,53,1,14,0,68,0
17 Reasons You Should Never Wear Makeup,1,1,6,25,0,6,2,31,0
How the Berlin attack suspect slipped through authorities' net,1,2,2,51,1,8,0,53,0
29 Things You Actually Need To Hear If You're Trying To Lose Weight,1,1,12,40,1,12,2,52,0
35 Gifts For the Wanderlust-Obsessed Person In Your Life,1,3,8,37,1,8,2,45,0
"Here's The First Press Shot For The New ""Absolutely Fabulous"" Movie",1,1,11,43,3,10,0,54,0
Taylor Swift Is At A Loss Of What To Do During A Fire Alarm,1,1,14,32,0,13,0,46,0
Russia bath lotion kills 48 drinkers in Irkutsk,1,3,2,36,0,7,2,38,0
The Style Evolutions of Sasha and Malia Obama,1,3,6,32,0,7,0,38,0
Destinations 17 images of Ireland that will make you want to visit immediately,1,3,2,62,0,12,2,64,0
Boy Has The BEST Reaction To Being Adopted After 832 Days In Foster Care,1,3,16,40,0,13,3,56,0
Pigskin A Blanket: NFL Week 2 Picks,1,1,8,19,1,6,1,27,0
"32 Artists Across The Globe Created An Insane Snapchat Trailer For ""Deadpool""",1,1,11,51,2,11,2,62,0
Odd Lots: How an Old-School Chess Shop Survives in Modern New York,1,2,11,42,2,11,0,53,0
23 Times Tumblr Blew Your Damn Mind,1,1,6,21,0,6,2,27,0
Are These Celebrities Naturally Blonde Or Brunette,1,1,7,37,0,6,0,44,0
What's made Canada's Slims River disappear?,1,3,4,31,3,5,0,35,0
"31 Tattoos That Will Make You Scream ""Nooooo""",1,1,7,27,2,7,2,34,0
15 Animals That'll Restore Your Faith In This World,1,1,8,32,1,8,2,40,0
"Cara Delevingne Looks Horrifically Unrecognizable As ""Suicide Squad's"" Enchantress",1,1,9,62,3,8,0,71,0
Hereâs what would happen if the Earth stopped rotating,1,3,2,44,2,8,0,46,0
Why Beijing’s Grip on the Yuan Is Becoming Tenuous,1,3,7,34,1,8,0,41,0
"North Carolina, Berlin, Delta: Your Thursday Briefing ",1,3,7,37,3,7,0,44,0
Are You More Barry White Or Luther Vandross,1,1,8,28,0,7,0,36,0
Americans React To Old Racial Slurs,1,1,6,24,0,5,0,30,0
Watch A Man React To The Modern World After 44 Years In Prison,1,1,12,36,0,12,2,48,0
7 Things To Know Before You Travel Back In Time,1,1,9,28,0,9,1,37,0
What's The Funniest Infomercial Fail Of All Time,1,1,8,32,1,7,0,40,0
7 Excellent Deals You Can Get This Weekend,1,1,7,27,0,7,1,34,0
"Taking On Student Debt, and Refusing to Pay ",1,2,6,29,1,8,0,35,0
We Know Your Relationship Status Based On Your Taste In Shoes,1,1,11,40,0,10,0,51,0
5 myths about your New Year 'detox' - debunked,1,3,2,32,3,8,1,34,0
A Student Body President Was Sent Home From School For Wearing This Outfit,1,1,13,49,0,12,0,62,0
Training Your Brain So That You Don’t Need Reading Glasses ,1,3,10,38,1,10,0,48,0
Which Naughty Disney Fantasy Do You Belong In,1,1,8,30,0,7,0,38,0
21 Healthier Eats For People Who Hate Salad,1,1,7,27,0,7,2,34,0
Thought Mike Ashley was hard to work for? Meet Jennifer Hardy,1,3,6,44,1,10,0,50,0
"The Truth Is, Katy Perry Is The Actual Queen Of Halloween",1,1,11,35,1,10,0,46,0
An Adorable Animals Advent Calendar: December 3,1,1,6,33,1,6,1,39,0
These kids toys have very detailed genitalia and people want to know why The list,1,3,2,65,0,14,0,67,0
How Can We Take The Trump Administration Seriously When It Can't Even Spell?,1,2,13,49,2,12,0,62,0
25 Places In Canada That Basically Look Like A Bob Ross Painting,1,1,11,40,0,11,2,51,0
18 Ways To Avoid The Holiday Blues This Year,1,1,8,26,0,8,2,34,0
People Are Outraged Over This Mannequin With Impossibly Thin Legs,1,1,10,46,0,9,0,56,0
We Can Guess What Your Dog's Name Is In A Single Try,1,1,12,28,1,11,0,40,0
"Obamacare Architect Gruber: ACA Opponents Haven’t Been Hurt From Law, They’ve ‘Just Heard’ ‘Misinformation’",1,3,16,70,8,13,0,86,0
"Here's Proof That One Direction Feel Really, Really Awkward Talking About Zayn",1,1,12,53,2,11,0,65,0
"Times Of India Called Alan Rickman The Villain Of The ""Harry Potter"" Series In His Obituary",1,1,16,58,2,15,0,74,0
Ranking All 124 Episodes Of 'It's Always Sunny In Philadelphia',1,2,9,39,3,9,3,48,0
"What I've ""Learned"" From Porn",1,1,5,17,3,4,0,22,0
Palestinian Authority Names Youth Camp After Terrorist Who Killed 38 Israelis,1,3,10,55,0,10,2,65,0
Climate Scientist Fires Back at House Science Committee During Hearing,1,2,9,52,0,9,0,61,0
Cheap train tickets: Here's how you can beat the illogical pricing system,1,3,2,58,2,11,0,60,0
7 ways you're completely killing your iPhone battery,1,2,1,42,1,7,1,43,0
"We Know Your Favorite Christmas Song Based On Your Favorite ""Frozen"" Character",1,1,12,53,2,11,0,65,0
How you can help the world's oceans stay pure and clean,1,3,1,43,1,10,0,44,0
Which Puppy Should Give You A Pep Talk,1,1,8,23,0,7,0,31,0
The Rock Wore A Crushed-Velvet Suit And Nothing Will Ever Be The Same,1,1,14,42,1,12,0,56,0
Matthew McConaughey Has Reached Peak Hot Dad Mode,1,1,9,33,0,7,0,42,0
This 10-Second Clip Will Make All Your Embarrassing Moments Seem Like A Gift,1,1,13,48,1,12,2,61,0
"Inside Magic Leap, The Secretive $4.5 Billion Startup Changing Computing Forever",1,3,10,55,3,10,2,65,0
Roommates Tell Each Other Long-Held Secrets,1,1,7,30,1,5,0,37,0
"Harrowing moments after cop shot in Oklahoma caught on audio, video",1,3,2,54,1,10,0,56,0
"11 of the weirdest foods you should try, according to the internet The list",1,3,1,58,1,13,2,59,0
We Rode Hoverboards Around New York City And Here's What Happened,1,1,11,43,1,10,0,54,0
Girlfriends Lived A Morning In The Life Of Their Boyfriends And Learned So Many Things,1,1,15,57,0,14,0,72,0
What's Your Horoscope For The Week Of December 14,1,1,8,30,1,8,2,38,0
"Are You More Rey Or Finn From ""Star Wars: The Force Awakens""",1,1,12,34,3,11,0,46,0
Scientists Discover Dead Cockroaches Make Excellent Magnets Than Alive Ones!,1,2,10,56,1,9,0,66,0
9 Houses That Look Normal On The Outside But Are Anything But On The Inside,1,1,14,46,0,14,1,60,0
Here's A Map Of Canada If It Were Westeros,1,1,9,24,1,8,0,33,0
We Need To Talk About How Cute Royalty Brown Is,1,1,10,28,0,9,0,38,0
"Do You Remember The Lyrics To ""Last Friday Night"" By Katy Perry",1,1,12,38,2,11,0,50,0
Celebrities Turned Out in Droves in Support of Nationwide Women's Marches,1,3,8,54,1,10,0,62,0
"Charles Barkley laughs off LeBron James' barbs, stands by critique of Cavaliers star",1,3,6,64,2,12,0,70,0
How Harry Potter Fanfic Helped Me Discover My Sexuality,1,1,9,38,0,8,0,47,0
This Dad Accidentally Held His GoPro The Wrong Way His Whole Vacation,1,1,13,45,0,11,0,58,0
Which Pop Artist/Producer Duo Are You,1,1,7,24,1,5,0,31,0
14 Strangely Satisfying Videos Of Melting Cheese,1,3,6,34,0,6,2,40,0
The Hardest Musical Decisions You'll Ever Make,1,1,7,32,1,6,0,39,0
"Women's memory can begin to decline in their 50s, claims new study",1,3,1,50,2,11,2,51,0
"The New ""Little Mermaid"" Is Going To Be Blonde And People Aren't Happy",1,1,13,42,3,12,0,55,0
Bank Error in Your Favor? But… Can You Keep the Cash?,1,3,9,31,3,10,0,40,0
73 Thoughts Every Woman On Tinder Has,1,1,6,23,0,6,2,29,0
Julianne Hough Gets Honest About Dealing With Endometriosis,1,2,8,44,0,7,0,52,0
"Great cough syrup con: Medicines we buy from the chemist have virtually no effect, say scientists ",1,3,2,78,2,16,0,80,0
15 Insanely Delicious Pumpkin Beverages To Try This Fall,1,1,8,38,0,8,2,46,0
Here's What No One Tells You About Having Both Depression And Anxiety,1,1,12,45,1,11,0,57,0
Everybody Hates Mark From Match.com,1,1,5,25,1,4,0,30,0
These award-winning photos show planet Earth in ways you've never seen it,1,2,2,58,2,11,0,60,0
How Do You Keep Panic Attacks From Ruining Your Life,1,1,10,33,0,9,0,43,0
How Trump ended Democrats' 144-year winning streak in one county,1,2,3,47,2,9,3,50,0
These Are The Survivors' Memories Of The Rana Plaza Building Collapse,1,1,11,47,1,10,0,58,0
22 Pictures People Who Are Good Students Will Never Understand,1,1,9,42,0,9,2,51,0
17 Times Social Media Saved The Day In 2015,1,1,7,22,0,8,6,29,0
Here Are The Different Types Of Moms You Meet,1,1,9,28,0,8,0,37,0
13 Meet-Cute Stories That Actually Happened In Real Life,1,1,9,36,1,8,2,45,0
"Overwhelmed by emotion, Jason Day did the only thing he could",1,3,3,47,1,10,0,50,0
The World's Most Ethical Companies 2017,1,3,5,24,1,5,4,29,0
Previously Deported Sex Offender Arrested near U.S. Border,1,3,8,41,2,7,0,49,0
Supreme Is Tight But Maybe Not These Hoodies With Hentai On Them,1,1,12,41,0,11,0,53,0
"18 Lines From ""The Princess Bride"" That You Definitely Still Quote",1,1,10,42,2,10,2,52,0
Why Women in India Still Don’t Report Sexual Assault - India Real Time,1,3,11,45,2,12,0,56,0
Trump Taps Linda McMahon to Run Small Business Administration,1,2,9,44,0,8,0,53,0
27 Awesome Easy Lunches To Bring To Work,1,1,7,24,0,7,2,31,0
"Watch The ""Family Feud"" Answer Steve Harvey Just Called His Favorite Of All Time",1,1,14,51,2,13,0,65,0
"Do You Think ""Post To Be"" Is One Of The Greatest R&B Collaborations Of All Time",1,1,17,44,3,15,0,61,0
This group are giving away 4200 joints at Trump's inauguration and smoking them The list,1,2,3,66,1,14,4,69,0
Do You Think America Might Have A Free Speech Problem?,1,2,10,34,1,9,0,44,0
7 Perfectly Appropriate Responses To Someone Asking You To Smile,1,1,9,45,0,9,1,54,0
21 Alarmingly WTF Celebrity Outfits From The '90s,1,1,8,29,1,7,4,37,0
The 23 Most Terrifying Things Justin Bieber Fans Have Done,1,1,9,38,0,9,2,47,0
15 Things You Really Shouldn't Say To Trans People,1,1,8,31,1,8,2,39,0
Secret Service Taking ‘Appropriate Action’ Against Agent Who Suggested She Wouldn’t Defend Trump from Bullet,1,3,14,77,3,14,0,91,0
Gujarati Diamond Multi-Millionaire Pays For The Weddings OF 236 Fatherless Girls,1,2,12,54,1,10,3,66,0
15 Deliciously Awesome Items For Anyone Who Loves Tacos,1,1,8,37,0,8,2,45,0
Kate Hudson's brother posts hilarious response to Brad Pitt rumours,1,3,4,53,1,9,0,57,0
23 Of The Most Satisfying Things That Can Happen While Driving,1,1,10,40,0,10,2,50,0
Miserable Cat With 5 Pounds Of Matted Fur Undergoes Incredible Transformation,1,3,10,56,0,10,1,66,0
"19 Out -Of-This-World ""Star Wars"" Crafts To Keep Die-Hard Fans Busy",1,1,13,36,6,10,2,49,0
Each MLB Team's Biggest 2017 Early-Season Question Mark,1,3,10,32,2,7,4,42,0
The 27 Most Important Snapchats Of 2015,1,1,5,22,0,6,6,27,0
24 Perfectly Normal Things Horror Movies Have Ruined For All Of Us,1,1,11,42,0,11,2,53,0
"People On Twitter Are Really Confused About ""The Ghost Of Ladbrokes""",1,1,11,45,2,10,0,56,0
10 Celebrities You Might Not Know Were Muslim,1,1,7,29,0,7,2,36,0
Groundhogs Aren't The Only Animals Who Can Predict The Future,1,1,10,41,1,9,0,51,0
These rising architectural stars could change India's skylines forever,1,2,2,59,1,8,0,61,0
How Bleak Is Your Town’s Christmas?,1,2,6,22,2,5,0,28,0
"Alan Rickman Narrates The New ""Alice Through The Looking Glass"" Trailer",1,1,11,48,2,10,0,59,0
"27 Jokes From ""The Big Bang Theory"" That Will Never Get Old",1,1,11,33,2,11,2,44,0
Carry on sexting? That’s no way to help your kids…,1,3,2,36,3,9,0,38,0
"Illegal Immigrant Accused of Repeatedly Raping, Kidnapping Autistic Woman",1,3,8,56,1,8,0,64,0
"The best TV show of every year since 2000, according to critics",1,3,3,44,1,11,4,47,0
"Nissan recalls more than 56,000 cars, cites power steering ",1,2,1,42,2,9,5,43,0
31 Photos That’ll Make Every Nurse Laugh Out Loud,1,3,8,30,1,8,2,38,0
Snack Bars Push the Price Envelope and Find Consumers Don’t Push Back ,1,2,10,47,1,12,0,57,0
Paris Hilton's 8 Hottest Halloween Costumes Of The 2000s,1,1,7,35,1,8,5,42,0
Blasting Into 2017: What’s in the Stars For Space Travel,1,2,7,34,2,9,4,41,0
Youâre using your freezer wrong â hereâs the right way to stock frozen food,1,2,1,61,6,13,0,62,0
App Smart | Instant Photo Collages - Video - NYTimes.com,1,3,9,34,4,9,0,43,0
Drop Everything: Psy Released Two Insane New Music Videos,1,1,9,39,1,8,0,48,0
Indonesia justice: Foreign tourists in Gili island 'walk of shame',1,2,3,51,3,9,0,54,0
Tell Us About The Funniest Thing You've Done While High,1,1,10,35,1,9,0,45,0
Only 1-in-25 UK Muslims Believe Al Qaeda Carried Out 9/11 Attacks,1,2,10,36,3,10,6,46,0
Viewpoint: The 'delicious spectacle' of President Trump,1,3,4,42,3,6,0,46,0
This May Be The Single Most Legendary Selfie Ever Taken In India,1,1,12,41,0,11,0,53,0
This Hijab Barbie Instagram Account Is Beyond Inspiring,1,1,8,40,0,7,0,48,0
Wales v Belgium: Euro 2016 qualifier – as it happened,1,3,3,35,2,9,4,38,0
21 amazing photos that show what life is like in the coldest inhabited town on earth,1,2,0,67,0,15,2,67,0
19 Small Awards Anyone With Anxiety Deserves To Receive,1,1,8,37,0,8,2,45,0
What Percent Teenager Are You,1,1,5,20,0,4,0,25,0
Jesse Watters: Under Armour Should ‘Rip Up’ Steph Curry’s Contract After Criticizing Company for Trump Support,1,3,15,76,4,15,0,91,0
Are You Taylor Swift Or Becky,1,1,6,18,0,5,0,24,0
"Frank Luntz: Obama on a ‘FU Tour,’ Trying to ‘Settle Scores’ With Republicans",1,3,11,48,6,12,0,59,0
15 Of The Best Ways To Actually Dress Your Body Type,1,1,10,30,0,10,2,40,0
My friend stole her boyfriend from my sister – should I snub their wedding?,1,3,2,58,2,13,0,60,0
24 Pictures People Under 5'8 Will Simply Never Understand,1,1,7,37,1,8,4,44,0
26 Clever Products That Will Make Your Office So Much Better,1,1,10,38,0,10,2,48,0
How I regularly book round-trip international flights for less than $400,1,3,2,55,2,10,3,57,0
This Actress Had An Insanely Beautiful $31 Million Wedding,1,1,8,39,1,8,2,47,0
36 Times TV Blessed Us With Man Candy In 2015,1,1,9,21,0,9,6,30,0
"Avid Photographer & Marathon Runner, Here Are 10 Important Facts About N Chandrasekaran, New Tata Sons Chief",1,3,15,72,3,16,2,87,0
"Hey Guys, Ted Mosby Is In India",1,1,7,17,1,6,0,24,0
Friendly Reminder That Victoria Beckham Used To Dress Like This In The '00s,1,1,12,48,1,12,2,60,0
Can You Pass This Challenging Timed Food Quiz?,1,2,8,30,1,7,0,38,0
Nightclub responds brilliantly to a woman's racist rant The list,1,3,2,52,1,9,0,54,0
13 Pets Who Don't Understand How Cute They Are,1,1,8,27,1,8,2,35,0
We Know Your Personality Based On Your Birth Season,1,1,9,34,0,8,0,43,0
Mysterious ‘rogue planet’ floating through space may be even odder than we thought,1,3,1,67,2,12,0,68,0
13 Gifts You Hated As A Kid But Totally Want Now,1,1,10,26,0,10,2,36,0
"Young Thug Reading The Lyrics To His Song ""Best Friend"" Is Everything",1,1,12,44,2,11,0,56,0
Damien Hirst: Treasures from the Wreck of the Unbelievable review – a titanic return,1,3,5,64,2,13,0,69,0
You Should Definitely Sign Up For Our Daily Dog Newsletter,1,1,10,39,0,9,0,49,0
22 Products The World Never Asked For,1,3,6,23,0,6,2,29,0
Can You Really Match A Shirt And Tie,1,1,8,21,0,7,0,29,0
17 Reasons Why Older Leo DiCaprio Is Better Than Young Leo DiCaprio,1,1,13,41,0,11,2,54,0
"Giraffes now facing extinction, warn conservationists ",1,3,1,46,1,6,0,47,0
"Who Said It: The ""Bob's Burgers"" Edition",1,1,7,23,4,6,0,30,0
15 Winter Breakfasts Guaranteed To Sooth Your Soul,1,1,7,34,0,7,2,41,0
Here's How A World Champion Runner Actually Eats And Trains,1,1,10,39,1,9,0,49,0
Behind One Of The Most Shocking Movie Endings Of The Year,1,1,11,36,0,10,0,47,0
"Gorsuch, Rockefeller, Brady: Your Monday Evening Briefing ",1,3,7,41,3,7,0,48,0
"Here's What Chai Really Is, To Settle The Score About This Tea Once And For All",1,3,16,46,2,15,0,62,0
Oreo Rice Is Either The Best Or Worst Thing Ever,1,1,10,29,0,9,0,39,0
Steven Avery Sent Handwritten Letters To Local News Stations From Prison,1,1,11,51,0,10,0,62,0
23 Ridiculously Cool Toys That Kids And Adults Will Enjoy,1,1,9,37,0,9,2,46,0
6 Items That Totally Overreact To Being Microwaved,1,3,7,35,0,7,1,42,0
"Presumably tired of picking on foreigners, the Daily Mail has found a new target The list",1,3,4,69,1,15,0,73,0
"A Trump Ally in Congress Warns His State, California, to Make Nice ",1,3,10,43,2,12,0,53,0
When You Miss Your Ex's Dog,1,1,6,15,1,5,0,21,0
Report: Obama Intel Officials Used ‘Russia Blackmail’ Claims to Warn Israel About Trusting Trump  ,1,3,13,67,3,15,0,80,0
Why Heart Attacks Are Striking Healthy Young Women,1,2,8,35,0,7,0,43,0
New on Your Dinner Tab: a Labor Surcharge,1,3,6,27,1,7,0,33,0
Your Playbook If U.S. and China Don't Clash,1,3,8,25,3,7,0,33,0
Man jailed over Perth Prison Kinder Egg cocaine plot,1,2,5,39,0,8,0,44,0
"20 Things You've Always Wanted To Know About The 12th Doctor, As Told By Peter Capaldi",1,1,14,51,2,15,4,65,0
Could Nutella really cause cancer? Here's what you need to know,1,3,3,48,2,10,0,51,0
"This Infographic Makes That All-Male ""Vanity Fair"" Photo Even Worse",1,1,11,44,3,9,0,55,0
Garrett Hedlund Has Just Become Even More Perfect,1,1,8,34,0,7,0,42,0
Palm Beach confidential: inside Trump's super-rich south Florida social set,1,3,4,59,3,9,0,63,0
All The Big Winners From The 2017 Grammy Awards Find the winners for all 84 categories here.,1,2,9,60,1,16,6,69,0
13 Lyrics That Made Us Cry In 2015,1,1,6,15,0,7,6,21,0
The Biggest Winners And Losers In Movies In 2015,1,1,8,28,0,8,4,36,0
21 Amazing Gifts For People Who Are Totally Obsessed With Their Hair,1,1,11,44,0,11,2,55,0
18 Photos That Will Bring Back Memories For People Who Grew Up In Miami,1,1,13,43,0,13,2,56,0
"Parents, is staying in a loveless relationship for your kids worth considering?",1,3,1,65,2,11,0,66,0
58 Things That Mildly Annoy Anyone Who Lives With Someone Messy,1,1,10,41,0,10,2,51,0
17 Very Real Struggles Of Christmas With Divorced Parents,1,1,8,39,0,8,2,47,0
For Everyone Who's Standing By Kesha,1,1,6,24,1,5,0,30,0
If Spam Comments Were Motivational Posters,1,1,6,31,0,5,0,37,0
21 Ways To Make Your Life Infinitely Better In 2017,1,3,8,28,0,9,6,36,0
"I Let Twitter Run My Life For A Day, And Here's What Happened",1,1,13,34,2,12,0,47,0
Apparently Chance The Rapper Is Going To Be On Kanye's New Album,1,1,12,40,1,11,0,52,0
This Woman Made A Photo Series About Every Stage Of Her Mastectomy,1,1,12,43,0,11,0,55,0
Poll: Who Do You Think Rey Actually Is,1,1,8,22,1,7,0,30,0
Rumsfeld says story mischaracterized his views on Iraq. What did he really say — or mean?,1,3,3,68,3,15,0,71,0
The Trouble With Screenshorts,1,2,4,22,0,3,0,26,0
This Charity Is Transforming Hospitalized Kids Into Superheroes,1,1,8,48,0,7,0,56,0
Remember The Iconic Sequoia Tree In California That You Could Drive Through? It Has Collapsed!,1,3,15,63,2,14,0,78,0
MashReads Podcast: 'The Shining' perfectly understands your winter cabin fever,1,2,5,61,3,9,0,66,0
22 Stylish Products Every Reindeer Lover Needs In Their Life,1,1,9,40,0,9,2,49,0
"Uber blocks employees at work from chatting on a popular anonymous app, the app's developer says",1,3,1,78,2,15,0,79,0
People Tell Us Their Weirdest Groupon Purchases,1,1,7,34,0,6,0,41,0
"YouTuber Tyler Oakley's Big, Incredibly Profitable Adventure",1,1,8,44,2,6,0,52,0
13 Things All Minnesotans Are Born Knowing How To Do,1,1,9,32,0,9,2,41,0
12 Reasons You're Not As Happy As You Should Be,1,3,9,26,1,9,2,35,0
Tech treasure in your attic? Here's a quick guide ,1,3,2,37,2,9,0,39,0
How Many Of These Defunct English Football Grounds Have You Been To,1,1,12,44,0,11,0,56,0
16 Luscious Italian Words And Phrases You Need In Your Life,1,1,10,37,0,10,2,47,0
17 Hilarious Tweets About Flying That Will Make You Laugh Out Loud,1,1,11,42,0,11,2,53,0
"Doomsday Clock Moves 30 Seconds Closer To Midnight, We Are Just Two-And-A-Half Minutes Away From Apocalypse!",1,3,18,68,5,15,2,86,0
Can You Identify The Christmas Movie By Its Netflix Description,1,1,10,44,0,9,0,54,0
A Dog Is Starring In The Best Elf On The Shelf Photos Of 2015,1,1,13,31,0,13,4,44,0
These Inspiring Quotes By Famous Athletes Will Inspire You To Push Your Limits,1,3,13,53,0,12,0,66,0
Here's What Happened When Americans Were Given 10 Minutes To Describe Everything British,1,1,12,61,1,12,2,73,0
24 Cats Who Have No Idea What This World Is About,1,1,10,27,0,10,2,37,0
Om Swami Is The Most Outrageous Person On Bigg Boss 10 And Here's Why He Needs To Be Eliminated,1,2,18,56,1,18,2,74,0
I Spent A Week Trying To Be A More Assertive Woman In The Workplace,1,1,14,40,0,13,0,54,0
15 Times Tina Fey And Amy Poehler Ruled The Golden Globes,1,1,10,35,0,10,2,45,0
Here are the odds on the 2020 presidential election (from Elizabeth Warren to Kanye West),1,3,5,64,2,14,4,69,0
Did Rihanna And Drake Just Shoot A Music Video For Her New Album,1,1,13,39,0,12,0,52,0
"People Think Jay Z Is Taking Shots at Drake on ""Shining""",1,3,9,35,2,10,0,44,0
19 Of The Most Lol-Worthy Tumblr Posts About Dating,1,1,9,31,1,8,2,40,0
Little Girls Confidently Give Women Advice On How To Text Their Crush,1,1,12,46,0,11,0,58,0
21 Undeniable Reasons Fall Is The Best Time Of Year,1,1,9,31,0,9,2,40,0
Which Weasley Should Be Your Best Friend,1,1,7,27,0,6,0,34,0
Morgan StanleyVoice: How Some Startups Reach Billion-Plus Valuations In 2 Years [Video],1,3,13,58,4,11,1,71,0
'You may as well kill us': Human cost of India's meat ban,1,3,3,39,4,11,0,42,0
Which Warwick Rower Should You Be Dating Based On Your Favorite Disney Movie,1,1,13,51,0,12,0,64,0
Why the Syrian Chemical Weapons Problem Is So Hard to Solve ,1,3,9,40,0,11,0,49,0
How Many Of These British Desserts Have You Tried,1,1,9,32,0,8,0,41,0
18 Of The Most Cringeworthy Lyrics From 2015,1,1,6,25,0,7,6,31,0
5 Mistakes You Make When You Don't Know What You Want To Do Next,1,3,13,36,1,13,1,49,0
We Know Which Celeb You Resemble Most Based On These Three Questions,1,1,12,45,0,11,0,57,0
How Many James Bond Films Have You Seen,1,1,8,24,0,7,0,32,0
This Truly Is The Ugliest Moment Of Your Life,1,1,9,28,0,8,0,37,0
A Six-Figure Income May Not Shield You From a Shock,1,3,10,31,1,9,0,41,0
Here's why you should never deep-fry a frozen turkey,1,2,1,41,2,8,0,42,0
21 Tweets About Thanksgiving That Are Way Too Real,1,1,8,32,0,8,2,40,0
Speech and Debate review – tech-savvy kids battle with a phoney adult world,1,3,2,59,2,12,0,61,0
Check out these epic Christmas lights synced to AC/DC's 'Thunderstruck',1,3,7,51,4,9,0,58,0
Can You Identify The Janet Jackson Music Video From A Single Screengrab,1,1,12,48,0,11,0,60,0
39 Songs You Need In Your Life This January,1,1,8,25,0,8,2,33,0
The 25 Funniest Things Ever Snapchatted,1,1,5,27,0,5,2,32,0
38 Times James Blunt Was The Trolliest Troll Of All Twitter Trolls,1,1,11,42,0,11,2,53,0
Blake Lively And Ryan Reynolds Continue To Be Actual Relationship Goals,1,1,11,50,0,10,0,61,0
Bet You Can't Name The Horror Movie Scream Queen From Her Scream,1,1,12,40,1,11,0,52,0
These are the world's drunkest countries The list,1,2,2,39,1,7,0,41,0
"39 Thoughts I Have Every Time I Watch ""Love It Or List It"" On HGTV",1,1,17,31,2,14,2,48,0
"Second Mexican Journalist Murdered in One Week, Juarez Cartel Implicated",1,2,9,53,1,9,0,62,0
Why General Motors Has Already Lost to Tesla,1,2,7,30,0,7,0,37,0
Trump inauguration: Full text of new president's speech,1,2,2,44,2,7,0,46,0
A Bar In Kerala Just Made A 250m-Long Maze Wall To Beat Supreme Court's 500m Rule,1,2,15,43,2,15,6,58,0
Chicago Bulls' memorial for former GM hit an odd snag when they wore their sleeved jerseys,1,3,4,70,1,15,0,74,0
How English sounds to people who don't speak English The list,1,2,4,46,1,10,0,50,0
17 Truths Only People Who Adore Wine Could Possibly Understand,1,2,9,42,0,9,2,51,0
Investigation: Is Kim Kardashian Literally The Funniest Person Alive,1,1,9,50,1,8,0,59,0
Oscar-Nominated Movie Posters With White Actors Removed,1,1,8,40,1,6,0,48,0
What to Cook This Week ,1,2,4,14,0,5,0,18,0
How Well Do You Remember What Pixar Characters Look Like,1,1,10,37,0,9,0,47,0
15 Boozy Cake Pops To Up Your Dessert Game,1,1,8,24,0,8,2,32,0
Terrifying Fact: NSYNC Is Now 20 Years Old,1,1,11,21,1,7,2,32,0
PCOS: The diet that can help treat the little-understood fertility problem,1,3,5,57,2,10,0,62,0
These Simple Kitchen Hacks Will Make Your Groceries Last So Much Longer,1,2,12,48,0,11,0,60,0
Andrew Clements' top 10 classical CDs of 2016,1,3,4,27,1,7,6,31,0
There's a secret message buried inside Nintendo's new $60 console,1,2,2,49,3,9,2,51,0
"This First Look At ""Lip Sync Battle"" Season 2 Proves It's Going To Get Even Better",1,1,15,48,3,15,1,63,0
Kevin Hart Tried To Go For A Run In Canada And Couldn't Handle The Icy Streets,1,1,16,46,1,15,0,62,0
Queen RiRi Might Be Dating Travis Scott,1,1,8,25,0,6,0,33,0
13 essential items you never thought to donate to those in need,1,3,0,50,0,11,2,50,0
How To Turn Your Bad News Into A Career Win,1,3,10,24,0,9,0,34,0
Just 15 Really Funny Tumblr Posts About Being A Dog Person,1,1,10,36,0,10,2,46,0
21 Things That Will Only Make Sense If You Have A Colicky Baby,1,1,12,36,0,12,2,48,0
13 Apps That Might Make Dating Less Horrible,1,1,7,28,0,7,2,35,0
"""I consider myself black,"" says white woman who posed as an African American",1,3,3,58,3,12,0,61,0
"Conway: Had This Been a Race for the Popular Vote, Trump Would Have Won That Too",1,3,13,50,2,15,0,63,0
"As he nears a 2016 bid, Louisiana’s Bobby Jindal hits political bottom",1,3,4,49,2,11,4,53,0
Can We Pickle That,1,1,4,11,0,3,0,15,0
Obama’s Last Full Day On Job Filled With Nostalgia and Thank You Calls,1,2,12,45,1,12,0,57,0
Inside The Design Of The World's Most Beautiful Tiny House,1,2,10,38,1,9,0,48,0
Which Guy Is A Better Boyfriend,1,1,6,20,0,5,0,26,0
What happens with your stuff after you die,1,3,1,34,0,7,0,35,0
‘BBC Dad’ on Going Viral: ‘This Is Now the First Line in My Obituary’ ,1,3,13,38,5,14,0,51,0
18 Times Google Translate Failed So Hard It Won,1,1,8,29,0,8,2,37,0
A Rescued Piglet And Kitten Are Best Friends And It's Totally Adorable,1,1,12,46,1,11,0,58,0
23 Times Ed Sheeran Was Really Fucking Nice,1,1,7,27,0,7,2,34,0
"18 ""Star Wars"" Cast Photos That Will Awaken The Force Within You",1,1,11,38,2,11,2,49,0
Fan Grabs Foul Ball Barehanded While Wearing a GoPro,1,3,9,35,0,8,0,44,0
5 crafty ways to keep thieves from stealing your packages,1,3,0,47,0,9,1,47,0
What's Your Horoscope For The Week Of October 12,1,1,8,29,1,8,2,37,0
"Another Round, Episode 25: Stop Telling Women To Smile",1,1,8,34,2,8,2,42,0
Katie Levitre gets game ball for watching game in labor,1,3,2,44,0,9,0,46,0
Which Classic Rock Band Are You Based On Your Birthstone,1,1,10,37,0,9,0,47,0
26 Photos That Every Perfectionist Will Find Pleasing,1,1,7,37,0,7,2,44,0
CNN’s Borger: Today Was ‘the Worst and Most Perilous Day’ of Trump’s ‘Young Presidency’,1,3,13,54,7,13,0,67,0
26 Misconceptions All Bi People Want To Set Straight,1,1,8,34,0,8,2,42,0
People Are Losing Their Minds Over This Chloë Grace Moretz Doppelgänger,1,3,11,50,0,10,0,61,0
Twitter users can now share the lists of users they block,1,2,1,46,0,10,0,47,0
"India Tests Its Most Formidable Missile, Agni V + 5 News Stories You Need To Read Today",1,3,15,53,2,16,1,68,0
A Public Safety Reminder To Throw Out Old Singing Birthday Cards,1,1,11,43,0,10,0,54,0
Wales v Belgium: Euro 2016 qualifier – as it happened,1,2,3,35,2,9,4,38,0
The Startup That Helps Green Startups Clinch Deals,1,3,8,35,0,7,0,43,0
Pentagon recommends sending 400 additional US troops to Iraq ,1,2,4,45,0,9,3,49,0
"Are You Lying When You Say You ""Love"" Kale",1,1,9,23,2,8,0,32,0
"A luxury music festival where tickets cost up to $12,000 turned into a nightmare â here's what happened",1,2,1,77,5,17,5,78,0
Rick and Morty: how the world's most ingenious animation punk'd its fans,1,3,2,56,3,11,0,58,0
How To Get an Authentic Experience Every Time You Travel,1,3,9,38,0,9,0,47,0
Booze Vs. Weed: Which Is Superior,1,1,6,20,2,5,0,26,0
Chicago Review of Books Editor Says MILO’s Words Could Inspire Terrorism,1,3,13,48,1,10,0,61,0
These DIY Fruit Waters Will Make You Feel Amazing,1,1,11,30,0,8,0,41,0
5 ways Apple can get back in the game in 2017,1,2,1,29,0,10,5,30,0
"Dating apps are making people less picky, study claims",1,2,1,44,1,8,0,45,0
39 Essex Sentences That Will Confuse The Fuck Out Of Everyone Else,1,1,11,42,0,11,2,53,0
Here's exactly what to say in 10 of the most awkward moments you'll have in a new relationship,1,2,1,72,2,17,2,73,0
I wear these computer glasses every day even though I have perfect vision â here's why,1,3,2,68,3,15,0,70,0
What To Do When You Sleep Next To Someone Who Is Too Warm,1,1,13,32,0,12,0,45,0
Rebel Wilson Just Unashamedly Hit On Idris Elba At The BAFTAs,1,1,15,36,0,10,0,51,0
26 Pictures That Will Ruin Your Weekend,1,2,6,25,0,6,2,31,0
Venezuela’s Mysterious Stock Inflow Is Leaving Traders Perplexed,1,3,8,48,1,7,0,56,0
Report: Trump Deporting 4K Somali Migrants,1,3,6,29,1,5,1,35,0
21 People Who Couldn't Give A Fuck About Christmas,1,1,8,31,1,8,2,39,0
"The Montreal Canadiens Sang A Beautifully Bad Version Of ""Let It Go""",1,1,12,43,2,11,0,55,0
Watch These Dads Read Inspiring Affirmations They Wrote For Their Daughters,1,3,11,54,0,10,0,65,0
21 Things Only Brutally Honest Women Will Understand,1,1,7,36,0,7,2,43,0
"25 Hottest TV Sex Scenes Of 2015, Ranked From Worst To Best",1,1,11,30,1,11,6,41,0
We Played Telephone Pictionary And It Got Weird Quick,1,1,9,36,0,8,0,45,0
Kim Kardashian surrounds herself with the Northern lights in a triumphant return,1,3,3,66,0,11,0,69,0
This Ballerina Bride Photoshoot Is Simply Stunning,1,1,7,37,0,6,0,44,0
Last Words: Eureka O'Hara Reflects On Her Time On ‘RuPaul’s Drag Race’,1,3,14,40,5,11,0,54,0
5 ways Apple can get back in the game in 2017,1,3,1,29,0,10,5,30,0
19 Gifts For The Naughtiest Mom You Know,1,1,7,24,0,7,2,31,0
10 International Companies Offering Remote Jobs In 2017,1,3,6,36,0,7,6,42,0
What It's Like Explaining Depression To Your Asian Parents,1,1,9,40,1,8,0,49,0
Paul Ryan: Trump Will Have the Funding to Build Border Wall,1,2,9,39,1,10,0,48,0
Schumer to Trump: Stop the Name-Calling,1,3,5,27,2,5,0,32,0
"Sussanne And I Aren’t Trying To Set Any Example, Says Hrithik Roshan On His Friendship With Her",1,3,17,60,2,16,0,77,0
19 Surprising Confessions From People Who Married For Money,1,1,8,41,0,8,2,49,0
"When all news is ‘fake,’ whom do we trust?",1,3,1,29,4,8,0,30,0
"If you blinked during Apple's WWDC keynote, you missed the HealthKit and HomeKit updates",1,2,10,63,2,13,0,73,0
Cold Therapy? Maybe Better Save Your Money ,1,3,7,28,1,7,0,35,0
The Best Tumblr Posts About Dating In 2015,1,1,7,24,0,7,4,31,0
Ombre was the biggest design trend of 2016,1,3,1,30,0,7,4,31,0
5 Easy DIY Tips You Really Need To Try,1,2,10,19,0,8,1,29,0
Are These Women More Than Just Friends,1,1,7,25,0,6,0,32,0
An Inside Look at the White House’s Christmas Decorations,1,3,7,41,1,8,0,48,0
Here's how to make the perfect Old Fashioned cocktail,1,3,3,41,1,8,0,44,0
A simple illustration reveals everything you need to know about the connection between Trump and Russia,1,3,3,85,0,15,0,88,0
18 Truths Everyone Without A Squad Knows About,1,1,7,30,0,7,2,37,0
What Does Your Favorite Thing About The Fall Say About You,1,1,11,37,0,10,0,48,0
Why Every Millennial Should Consider Funding A Roth IRA,1,3,11,36,0,8,0,47,0
The Internet Is Freaking Out Over This Woman's Shirt,1,1,9,34,1,8,0,43,0
Don’t Call It a ‘Tesla Killer’ — But the Lucid Electric Car Might Be Exactly That,1,2,13,49,4,15,0,62,0
The man behind India's '$74m wedding',1,3,2,24,4,5,2,26,0
23 Things That Are Metal As Fuck,1,1,6,18,0,6,2,24,0
20 Signs You Grew Up In Miami During The '90s,1,1,8,23,1,9,4,31,0
9 Reasons Rey Is Totally Not A Skywalker,1,1,7,25,0,7,1,32,0
This French Artist Is Covering India's Walls With Some Amazing Graffiti,1,1,11,49,1,10,0,60,0
22 Shoppers Who Made A Hard And Important Decision,1,1,8,32,0,8,2,40,0
65 Brutally Honest Questions You Secretly Want To Ask On A First Date,1,1,12,43,0,12,2,55,0
Everything You Need To Know About Riz Ahmed,1,1,8,28,0,7,0,36,0
"NBA Prospect Emmanuel Mudiay Shows Off Athleticism, Skills in Predraft Workout",1,3,12,55,1,10,0,67,0
There’s A Deadly ‘Power Rangers’ Curse That You Didn’t Know About,1,3,11,40,4,10,0,51,0
The 21 Most Uncle Things That Ever Happened,1,1,7,27,0,7,2,34,0
Tesla has finally begun producing batteries at its massive Gigafactory,1,3,2,59,0,9,0,61,0
"The ""Fantastic Beasts"" Teaser Trailer Has Finally Arrived",1,1,8,40,2,7,0,48,0
5 Whatsapp hacks you need to master immediately The list,1,3,2,44,0,9,1,46,0
Meryl Streep Uses Lifetime Achievement Award Speech to Bash Donald Trump,1,3,10,52,0,10,0,62,0
Watch Gorillaz Debut New 'Humanz' Album in Its Entirety at Secret London Show,1,2,11,52,2,12,0,63,0
22 Times Elf On The Shelf Went Way Too Far,1,1,9,22,0,9,2,31,0
The 13 best memes of 2016,1,2,1,13,0,5,6,14,0
Seriously Can You Guess How Old Maggie Smith Is,1,1,9,30,0,8,0,39,0
We Can Tell Whether You Had Sex This Morning With One Simple Question,1,1,13,44,0,12,0,57,0
18 Reasons Every Woman Should Follow Poet Rupi Kaur On Instagram,1,1,10,42,0,10,2,52,0
A String Quartet Performed During A Traffic Jam And Calmed Everyone's Rage,1,1,12,50,1,11,0,62,0
Pogue’s Basics: Have your iPhone announce your calls,1,3,4,39,2,7,0,43,0
Alien: Covenant and Prometheus link revealed in new CinemaCon footage,1,3,5,54,1,9,0,59,0
Kim Jong Nam Killing Caught on Video   ,1,3,6,24,0,9,0,30,0
Tell Us About Yourself(ie): Erica Ash,1,1,6,23,3,5,0,29,0
Driver loses car in parking garage -- for six months,1,3,1,40,2,9,0,41,0
Are You An Assassin Or A Templar,1,1,7,19,0,6,0,26,0
15 Things People Who Talk To Themselves Will Understand,1,1,8,37,0,8,2,45,0
"People Are Glittering Their Armpits, Even Though Glitter Is The Worst",1,1,11,47,1,10,0,58,0
Nikki Haley Leads Walkout on UN Nuclear Weapons Ban Meeting,1,2,10,40,0,9,0,50,0
Do You Have Seasonal Allergies Or A Dybbuk,1,1,8,27,0,7,0,35,0
31 Things Anyone Who Owned A PlayStation In The '90s Will Remember,1,1,11,39,1,11,4,50,0
"Who Was Actually The Worst ""Gilmore Girls"" Suitor",1,1,8,32,2,7,0,40,0
This Is Why Men Can Never Find A Damn Thing,1,1,10,24,0,9,0,34,0
Which Oscar-Nominated Actor Should You Hook Up With Based On One Question,1,1,13,48,1,11,0,61,0
A Bunch Of '90s Supermodels Just Totally Destroyed This New Fashion Campaign,1,1,11,51,1,11,2,62,0
CNN’s Fake News Gets Trump-Hating Politico Reporter Fired,1,3,11,37,2,7,0,48,0
21 Totally Delicious Things You Can Do With Leftover Turkey,1,1,9,39,0,9,2,48,0
These Are Julia Louis-Dreyfus' Best Emmy Looks Over The Years,1,1,11,39,2,9,0,50,0
Dying Man's Last Request of a Cigarette and Glass of Wine Granted by Hospital,1,3,9,54,1,13,0,63,0
This Deleted Scene From 'Dear Zindagi' Will Tell You Why Closures Are Important In Life,1,2,15,56,2,14,0,71,0
Are You More Barry Allen Or Oliver Queen,1,1,8,25,0,7,0,33,0
Braces Can Be Beautiful. Here’s Proof.,1,2,6,24,3,5,0,30,0
"Exclusive - Trump border 'wall' to cost $21.6 billion, take 3.5 years to build: internal report",1,3,2,65,8,15,5,67,0
"25 jobs where you can earn more than $100,000 a year",1,3,0,32,2,10,8,32,0
Can You Spot The Difference Between Kate Bush And An Actual Bush,1,1,12,41,0,11,0,53,0
Firebrand Wilders Leads Ahead of Dutch Elections,1,3,6,36,0,6,0,42,0
This moment between 2 quiz show contestants is so gloriously awkward,1,2,1,56,0,10,1,57,0
17 Just Great Looking Dogs,1,1,4,16,0,4,2,20,0
Initial jobless claims fell by more than expected,1,3,1,41,0,7,0,42,0
Which Period Of Human History Do You Belong To,1,1,9,29,0,8,0,38,0
Tablet Reveals the 25 Coolest Hotels in the World,1,3,5,34,0,8,2,39,0
Indians Are Protesting Child Marriage With The Hashtag #StrengthToSayNo,1,1,12,50,1,8,0,62,0
European Championship Qualifying - ESPN FC,1,3,9,27,1,5,0,36,0
How To Handle A Food Thief,1,1,6,15,0,5,0,21,0
18 Facts That Will Make Any Indian Feel Old,1,1,8,25,0,8,2,33,0
8 ways we've changed since the last time we had a new president,1,3,0,49,1,12,1,49,0
Apple unveils Apple Music streaming service,1,2,3,35,0,5,0,38,0
Comedy's Next Great Leading Man,1,1,5,21,1,4,0,26,0
24 Totally Wild Fast Food Items We Need Immediately,1,1,8,33,0,8,2,41,0
David Beckham Immortalized His Daughters Drawing With A New Tattoo,1,1,10,47,0,9,0,57,0
Do You Know How Much Your Old Toys Are Worth,1,1,10,25,0,9,0,35,0
7 Last-Minute Halloween Costumes You Can Make Right Now,1,1,9,36,1,8,1,45,0
"17 Times Nick From ""New Girl"" Was You Hating People",1,1,9,29,2,9,2,38,0
"Friendly Reminder that ""Last Christmas"" by Jimmy Eat World Is The Best Christmas Song In Existence",1,1,14,67,2,15,0,81,0
DHS Secretary John Kelly: ‘Marijuana Is Not a Factor in the Drug War’,1,3,12,42,3,12,0,54,0
How I Learned There's More Than One Way To Have Gay Sex,1,1,12,31,1,11,0,43,0
17 Things Kanye West Could've Named His New Album,1,1,8,30,1,8,2,38,0
16 Struggles All Smokers Can Relate To,1,1,6,24,0,6,2,30,0
What % Lucky Are You?,1,3,4,11,2,4,0,15,0
The Six Girls You Date On Tinder,1,1,7,19,0,6,0,26,0
Women's sport proves the best buy for business,1,2,1,37,1,7,0,38,0
18 Things Every Beer Drinker Needs To Know,1,1,7,26,0,7,2,33,0
What Kind Of Pasta Should You Eat With Aziz Ansari,1,1,10,31,0,9,0,41,0
The 2017 Oscars by the Numbers [Video],1,3,4,22,2,6,4,26,0
The 18 biggest breakthroughs for self-driving cars expected by 2030,1,3,1,50,1,9,6,51,0
"NYT’s Alcindor: Democrats ‘Sound Somewhat Confused,’ Don’t Have ‘Clear Leader’",1,2,12,49,8,9,0,61,0
13 Of The Most Iconic Playboy Covers Of All Time,1,1,9,28,0,9,2,37,0
Jennifer Lawrence Hates New Year's Eve For The Same Reason We All Do,1,1,13,42,1,12,0,55,0
Dumb Things Patients Told Their Doctors,1,1,6,28,0,5,0,34,0
"18 Pictures That Will Make Students Laugh, Then Cry",1,3,8,32,1,8,2,40,0
"Here's How Much Fun I Had On The ""Harry Potter"" Studio Tour",1,1,12,33,3,11,0,45,0
The Queen just made history with this milestone,1,3,2,38,0,7,0,40,0
There's A Hidden Cards Against Humanity Card And People Are Just Finding It,1,1,13,49,1,12,0,62,0
How Many Of These Classic Coming-Of-Age Movies Have You Seen,1,1,12,37,2,9,0,49,0
41 Romantic Ideas To Elevate Your Engagement Pictures,1,1,7,37,0,7,2,44,0
Celebrities and Their Christmas Trees: 2016 Edition,1,3,5,35,1,6,4,40,0
19 Things Anyone Who's Best Friends With Their Mum As An Adult Will Understand,1,1,13,49,1,13,2,62,0
'Overwatch' reveals one of its playable characters is on the autism spectrum,1,3,1,62,2,11,0,63,0
The 2017 Investment Guide: Trumponomics,1,2,4,26,1,4,4,30,0
Zhou Yongkang trial exposes Chinese officials' links with mystic,1,3,3,52,1,8,0,55,0
"Judge Denies Bond for Chicago Suspects Charged With Hate Crimes, Kidnapping",1,3,10,54,1,10,0,64,0
Business Insiderâs 2016 Car of the Year: The 15 finalists,1,2,5,36,3,9,6,41,0
Dem Rep Cleaver: ‘I’ve Been Getting All Kinds of Hate Phone Calls’ for Deciding To Attend Inauguration,1,3,15,67,4,16,0,82,0
"What's Your Favorite ""American Horror Story"" Quote Of All Time",1,1,10,40,3,9,0,50,0
"Kevin O'Connell, Oscar's Biggest Loser, Finally Wins on 21st Try [Video]",1,3,10,44,6,10,2,54,0
How Many '00s British Singers Can You Remember,1,1,7,29,1,7,2,36,0
"35 Awesome Reasons To Visit Denver, Colorado",1,1,6,29,1,6,2,35,0
18 Unbelievably Rude Texts From Your Anxiety,1,1,6,30,0,6,2,36,0
"Blake Lively, Viola Davis, Ashley Graham, and More Gorgeous, Smart Celebs Hit the Time 100 Gala",1,2,13,60,4,15,3,73,0
Someone Created A Meme Coloring Book And It’s Everything We Never Knew We Needed,1,2,14,52,1,13,0,66,0
9 Of Your Scariest Cable Horror Stories,1,1,6,26,0,6,1,32,0
Here’s Who’s Winning (And Losing) At WrestleMania 33,1,3,8,31,4,7,2,39,0
How to Beat the Bots ,1,3,3,13,0,5,0,16,0
3 Refugees Living In The UK Cook Their Favourite Meals From Home,1,1,12,40,0,11,1,52,0
"Chol Marial, 14, Stands 7 Feet 3 And Is So Above It All On Basketball Court",1,2,13,41,2,15,4,54,0
"No, the customer is not 'always right': Why you should be nice to retail staff",1,3,2,58,4,14,0,60,0
24 Pictures That Will Make Runners Laugh Then Put On Their Sneakers,1,1,11,43,0,11,2,54,0
24 Things That Were Cool In Middle School But Definitely Aren't Now,1,1,11,42,1,11,2,53,0
Chrissy Teigen Loves Pie So Much She Started Crying While Eating It,1,1,12,44,0,11,0,56,0
Signs You Grew Up In Louisiana,1,1,6,19,0,5,0,25,0
5 Ways To Turn Junk Food Into Classy Cocktails,1,1,8,29,0,8,1,37,0
Stolen baby found alive in South Carolina 18 years on,1,2,3,39,0,9,2,42,0
How a New Yorker became the face of anti-Trump protests,1,3,4,41,1,9,0,45,0
Can You Identify The Ariana Grande Music Video By Its Screencap,1,1,11,42,0,10,0,53,0
"Which Rare Cat From ""Neko Atsume"" Are You Based On Your Zodiac",1,1,12,37,2,11,0,49,0
America's hottest investment product is about to go global,1,2,1,48,1,8,0,49,0
Men Have Evidently Rediscovered Headbands And It's Horrifying,1,1,8,45,1,7,0,53,0
"The First Trailer For Netflix's ""The Get Down"" Is Here And It's Incredible",1,1,13,45,4,12,0,58,0
What's The Best Drinking Game,1,1,5,19,1,4,0,24,0
"Which ""Pretty Little Liars"" Hunk Should Be Your Valentine Based On Your Zodiac",1,1,13,51,2,12,0,64,0
10 Amazing Candid Wedding Moments You Won't Believe Were Captured On Camera,1,1,11,50,1,11,2,61,0
"Which Winner Of ""RuPaul's Drag Race"" Are You",1,1,9,25,3,7,0,34,0
These Could Be The Coolest Baby Names In 2016,1,1,8,25,0,8,4,33,0
"Presumably tired of picking on foreigners, the Daily Mail has found a new target The list",1,2,4,69,1,15,0,73,0
35 Things That Are Totally Memory Triggers For '80s Kids,1,1,8,34,1,9,4,42,0
"Can You Name These ""Great British Bake Off"" Winners",1,1,9,32,2,8,0,41,0
"11 Questions Latinos Get Around The Holidays, Answered",1,1,7,37,1,7,2,44,0
"22 Times The Internet Perfectly Understood ""Degrassi""",1,1,6,37,2,6,2,43,0
"Savage AF Kid Starts Fire, Takes Shots at Trump on Live Television",1,3,11,43,1,11,0,54,0
19 Things All Families With Only Three People In Them Know,1,1,10,36,0,10,2,46,0
17 Pictures That Are Perfect If You're Obsessed With Fried Chicken,1,1,10,43,1,10,2,53,0
22 Mouthwatering Foods You Won't Believe Contain Alcohol,1,1,7,39,1,7,2,46,0
Dieses Video ist nicht verfügbar. This little girl shows how to do the best bottle flip ever!,1,2,3,72,2,16,0,75,0
27 Actually Good Ideas,1,1,3,14,0,3,2,17,0
Realestate | Yahoo News - Latest News & Headlines,1,2,6,32,3,8,0,38,0
"Akshay Kumar Shares Another Heartfelt Video, Pitches A Way To Help Martyrs This Republic Day",1,3,15,62,1,14,0,77,0
Waters: We Have to ‘Do the Investigation’ to Find Evidence to Impeach Trump,1,2,9,51,3,12,0,60,0
These insane vans for CEOs redefine the meaning of working on the go,1,3,4,52,0,12,0,56,0
Emma Watson Just Perfectly Called Out Sexism In The Film Industry,1,1,11,44,0,10,0,55,0
'Bachelor In Paradise' Season 2 Cast Revealed,1,2,6,30,2,6,1,36,0
How Well Do You Know The Earth,1,1,7,17,0,6,0,24,0
This Is How To Make Your Very Own Harry Potter Feast,1,3,11,31,0,10,0,42,0
Which 2005 Hit Song Matches Your Zodiac Sign,1,1,7,26,0,7,4,33,0
24 Pictures That Prove That There Is Nothing Cats Won't Sit On,1,1,11,37,1,11,2,48,0
Are You More Millennial Or Gen X,1,1,7,19,0,6,0,26,0
"April the giraffe is finally, *finally* giving birth. For real this time.",1,3,2,55,5,11,0,57,0
How Much Of A Night Person Are You,1,1,8,19,0,7,0,27,0
7 Lessons Small Businesses Can Learn From Tech Startups,1,3,8,38,0,8,1,46,0
People Are Not Taking The Demise Of The Twitter Fave Well,1,1,11,36,0,10,0,47,0
25 Of Our Deepest Desires,1,1,4,15,0,4,2,19,0
This Couple Successfully Cloned Their Dog After He Died,1,1,9,38,0,8,0,47,0
This Playlist Will Hopefully Help Get You Through The Next Four Years,1,3,12,46,0,11,0,58,0
12 Times Dwight Schrute Was Just Too Much,1,1,7,25,0,7,2,32,0
"So, Uh... There's Gonna Be A Bollywood Movie About A Guy Whose Dick Turns To Gold",1,1,16,45,5,15,0,61,0
Can We Guess How Long You’ll Keep Your Resolution?,1,3,9,31,2,8,0,40,0
An Indestructible Coffee Machine for Extreme Caffeine,1,3,6,41,0,6,0,47,0
Can You Guess The Premier League Club From Just Their Socks,1,1,11,38,0,10,0,49,0
6 USB-C accessories that'll let your new MacBook actually connect to stuff,1,2,6,54,2,11,1,60,0
"How Well Do You Remember The ""One Tree Hill"" Finale",1,1,10,30,2,9,0,40,0
Find The Right Credit Card The Right Way,1,3,8,25,0,7,0,33,0
Great white shark attacks boat in real life Jaws moment,1,3,2,44,0,9,0,46,0
"Which Doctor From ""Doctor Who"" Had The Best Look",1,1,9,29,2,8,0,38,0
A Group Of People In Nepal Are Expressing Their Plight Using The Hashtag #MadhesSpeaks,1,1,15,57,1,13,0,72,0
What Is Your Stripper Song,1,1,5,17,0,4,0,22,0
Meet the sexbots: The contenders in the £20 BILLION race to create an AI sex doll that can chat and 'never says no',1,2,11,76,4,22,2,87,0
The curious cases and unsolved mysteries that perplexed us in 2016,1,3,1,51,0,10,4,52,0
33 Shirts You Need To Own Immediately,1,1,6,23,0,6,2,29,0
The World's Billionaires 2017,1,3,3,18,1,3,4,21,0
The Secret to a Happy Marriage? Two Master Bedrooms,1,2,7,35,1,8,0,42,0
17 Things That Are Basically A Workout,1,1,6,24,0,6,2,30,0
Pinterest Is Actually A Porn Director's Best Friend,1,1,8,35,1,7,0,43,0
"27 Moments From ""The Simpsons"" That Always Make You Ugly Cry",1,1,10,36,2,10,2,46,0
Why Silicon Valley Is So Nervous About H-1B Reform,1,2,10,30,1,8,1,40,0
‘Full House’ Creator Purchases Original Tanner House in San Francisco,1,3,9,49,2,9,0,58,0
"Which Doctor From ""Doctor Who"" Is The Best",1,1,8,25,2,7,0,33,0
Literally Just 23 Great Jokes,1,1,4,19,0,4,2,23,0
"Get Excited For A Second Season Of ""Master Of None""",1,1,10,30,2,9,0,40,0
N.B.A. Finals: Golden State Warriors Get Mad and Pull Even With Cleveland Cavaliers ,1,3,14,53,4,13,0,67,0
The 19-year-old Dunkin' Donuts worker behind Ashley Judd's viral #NastyWoman poem,1,3,7,57,5,10,2,64,0
27 Times Men Needed To Be Stopped In 2015,1,1,7,20,0,8,6,27,0
Critical LastPass security hole would allow hackers to steal your passwords,1,3,3,62,0,10,0,65,0
"Pelosi: Barring Illegal Immigrants From Citizenship Is ‘Just Not Respectful, And Not Worthy of Our Country’",1,2,15,73,4,15,0,88,0
7 Things I Wish Someone Had Told Me About Being In Love When You're Bipolar,1,1,14,45,1,14,1,59,0
Russia: Fall and rise in 25 years,1,3,2,22,1,6,2,24,0
These Are the Most Popular States for Retirees to Move To,1,2,8,39,0,10,0,47,0
The Bear/Dog Creature That Stumped The Internet Has Been Identified,1,1,11,46,1,9,0,57,0
Booze Up Your Leftover Halloween Candy,1,1,6,27,0,5,0,33,0
Your Favorite '90s Pop-Punk Anthem Has Been Recreated In This Amazing Video,1,1,12,48,2,11,2,60,0
9 Boner Hacks You Never Knew You Needed,1,1,7,24,0,7,1,31,0
"911 caller asks for ride home, gets arrested ",1,3,0,33,1,8,3,33,0
How Fall Are You,1,1,4,9,0,3,0,13,0
What New Thing Should You Try In 2016,1,1,7,19,0,7,4,26,0
Donald Trump is 'gaslighting' all of us,1,3,2,29,2,6,0,31,0
Couples Watch Themselves Kiss In Slow Motion,1,1,7,31,0,6,0,38,0
16 Adorable Corgi Sploots To Get You Out Of Any Rut,1,1,10,29,0,10,2,39,0
"Do You Remember The Iconic Shabooya Scene From ""Bring It On: All Or Nothing""",1,1,14,46,3,13,0,60,0
Your best pictures from the week,1,3,1,26,0,5,0,27,0
This literature map of the world is simply brilliant The list,1,2,2,49,0,10,0,51,0
'Broadchurch' is the best British crime show you're not watching,1,3,2,50,3,9,0,52,0
We Know Your Relationship Status Based On Your Zodiac Sign,1,1,10,39,0,9,0,49,0
"Marketers, Creative Ad Execs Adjust to Video Ads With No Sound - CMO Today",1,3,14,45,2,13,0,59,0
Gujarat Couple Decides To Go For Family Planning... After Having 17 Kids!,1,2,11,45,4,11,2,56,0
How A Gay Porn Star And Rapper Became Vine Famous And Then Liveblogged His Arrest On Facebook,1,1,17,60,0,16,0,77,0
Zsa Zsa Gabor: The Prototype of the Famous-for-Being-Famous Celebrity,1,3,9,48,4,8,0,57,0
How 'Jeopardy!' writers come up with the clues,1,3,2,34,3,7,0,36,0
These Are the Best- and Worst-Performing Airlines in the World,1,2,7,44,2,9,0,51,0
"Sanders to Trump: Promise the American People You Will Not Cut Social Security, Medicare or Medicaid",1,2,13,70,2,15,0,83,0
"I Just Noticed This About ""Easy A"" And My Mind Is Blown",1,3,12,30,2,11,0,42,0
This Color Test Will Determine Your Sexual Fetish,1,1,8,34,0,7,0,42,0
WTF Is Up With These Freakishly Realistic Cat Bags,1,1,11,31,0,8,0,42,0
17 People You Won't Believe Are Somehow Older Than Ted Cruz,1,1,10,36,1,10,2,46,0
Everything You Need To Know About 'Dragon Ball Super',1,2,9,34,2,8,0,43,0
This Classic '80s Trend is About to Make a Huge Comeback,1,2,7,36,1,10,2,43,0
All Amy Adams Has To Do Is Walk And It Looks Like She's In A Shampoo Commercial,1,1,17,45,1,16,0,62,0
Tape Contouring Is About To Be Either Your New Favorite Thing Or A Total Waste Of Office Supplies,1,1,18,62,0,17,0,80,0
What's Your Favorite Boozy Holiday Drink,1,1,6,28,1,5,0,34,0
'Star Wars: The Last Jedi' trailer: What does it all mean?,1,3,6,37,5,10,0,43,0
'The 100' Season 4 trailer is epic and terrifying,1,3,2,33,2,8,4,35,0
This Disney Show For Preschoolers Is Teaching Kids About Consent,1,1,10,45,0,9,0,55,0
For Everyone Who Is Absolutely Floored By Ciara's Look Right Now,1,1,11,42,1,10,0,53,0
14 Confessions From Single Dads That Are Heartwarming And Heartbreaking,1,1,9,51,0,9,2,60,0
"Choose Your Path To See If You Can Survive The Fire Swamp From ""The Princess Bride""",1,1,16,50,2,15,0,66,0
We Got Mac Lovers To Try A PC And This Is What Happened,1,1,14,29,0,12,0,43,0
18 Things Only People Who Love Workout Classes Will Know,1,1,9,36,0,9,2,45,0
Do You Eat These Things In One Or Two Bites?,1,2,10,24,1,9,0,34,0
President Trump Delivers First Address to Congress: Celebs React,1,3,8,47,1,8,0,55,0
"Which ""The Maze Runner"" Character Are You",1,1,7,26,2,6,0,33,0
22 Objects People Have Actually Lost In Their Ass,1,1,8,31,0,8,2,39,0
16 Adorable Items That'll Bring Out Your Inner Leslie Knope,1,1,9,38,1,9,2,47,0
Guide to men's boots: the wish list – in pictures,1,3,1,36,3,9,0,37,0
"Men, Stephen King Has A Really Important Message For You",1,1,10,36,1,9,0,46,0
This 6-Point Guide Will Help You Ace Your Selfie Game Even In Low Light At Night,1,2,16,47,1,15,1,63,0
Meeting a Lebanese drug lord,1,3,2,22,0,4,0,24,0
"How Far Would You Make It On ""The Bachelor""",1,1,9,24,2,8,0,33,0
Can You Find The Genitalia Hidden In This Crossword,1,1,9,34,0,8,0,43,0
Sanders: ‘The Way the Democratic Party Has Been Run for Decades Has Not Worked’,1,3,12,51,3,13,0,63,0
"Are You Warm-Hearted Or A Cold, Hard Bitch?",1,3,9,24,3,7,0,33,0
'The Voice' Crowns Season 11 Winner,1,3,5,21,2,5,2,26,0
We Know Which Obscure Cereal Mascot You Are Based On Three Questions,1,1,12,45,0,11,0,57,0
Watch This Jet-Powered Exosuit Turn Inventor into Real-Life Iron Man,1,2,11,46,2,9,0,57,0
Brutal Knockout Leaves MMA Fighter Stiff as a Board on the Canvas,1,3,10,44,0,11,0,54,0
This Actress Chopped Off All Her Hair For The Most Inspiring Reason,1,1,12,44,0,11,0,56,0
Will Catalonia try to secede from Spain this year?,1,3,3,38,1,8,0,41,0
19 Cuddly Toys That Totally Understand Your Hangover Right Now,1,1,9,42,0,9,2,51,0
"After Her Photographer Was A No-Show For Her Wedding, This Bride Received A Surprise Of A Lifetime",1,1,18,62,2,16,0,80,0
How Jeb Bush’s campaign ran off course before it even began,1,3,3,45,1,10,0,48,0
23 Things You Learn From Following Kylie Jenner's Instagram,1,1,8,40,1,8,2,48,0
Bet You Never Thought You Could Eat Cauliflower Like This,1,1,10,38,0,9,0,48,0
19 People Who Have Reached Peak Fuckboy,1,1,6,25,0,6,2,31,0
"Finland Launches Experiment That Will Give 2,000 People Free Money Until 2019",1,3,10,47,1,11,8,57,0
19 Tweets About Tinder That'll Actually Make You Laugh,1,1,8,35,1,8,2,43,0
"You'll Never Guess What The ""E"" In Chuck E. Cheese Stands For",1,1,12,34,4,11,0,46,0
Why Arsenal need Zlatan Ibrahimovic,1,2,4,27,0,4,0,31,0
Which Adorable Animal Eating Adorable Animal Are You And Your BFF,1,1,13,42,0,10,0,55,0
23 Stocking Fillers For The Beauty Addict In Your Life,1,1,9,34,0,9,2,43,0
LaVar Ball Is a Genius,1,2,5,13,0,4,0,18,0
"Is Adele married? Singer thanks ""husband"" at Grammys",1,2,4,38,3,7,0,42,0
8 Best Things About Being Chinese-American,1,1,6,29,1,5,1,35,0
"Who Is Your ""Vampire Diaries"" BFF",1,1,8,18,2,5,0,26,0
"26 Important Lessons The Next Generation Will Learn From ""Harry Potter""",1,1,10,47,2,10,2,57,0
World's biggest dinosaur footprint found in 'Australia's Jurassic Park',1,2,4,55,4,8,0,59,0
Top Flickr photos of 2016,1,2,2,15,0,4,4,17,0
Can You Guess Someone's Hogwarts House From One Selfie,1,1,9,36,1,8,0,45,0
23 Food Things You'll Only Get If You're Chinese,1,1,8,28,2,8,2,36,0
Tell Us Your Stories About Sexism In College,1,1,8,29,0,7,0,37,0
A Gaza ‘Tunnel Millionaire’ Falls on Hard Times ,1,2,7,31,2,8,0,38,0
Why waking up in the night is natural: People regularly use to have two periods of sleep and do tasks in between ,1,3,2,88,1,22,0,90,0
30 Things You Need To Cook In November,1,1,7,22,0,7,2,29,0
"21 Times The ""Why You Always Lying"" Meme Was The Best Meme Of 2015",1,1,12,33,2,13,6,45,0
"From Adele to Katy Perry, This Is Why Hollywood Is So Obsessed With Crystals",1,3,13,49,1,13,0,62,0
"Try To Keep Your Chill, But Colin Farrell's Hair Is Turning Daddy Gray",1,1,13,43,2,12,0,56,0
26 Times Ryan Reynolds' Tweets Made You Laugh Out Loud,1,1,9,33,1,9,2,42,0
The Greatest Late Night Snacks From Around the World,1,2,8,36,0,8,0,44,0
"Sonu Nigam Remains Firm On His Stand, Tweets He's Against The Use Of Loudspeaker & Not Religion",1,3,16,60,3,16,0,76,0
Fake News from CNN: Legal Expert Says Schumer’s Attacks on Trump’s Pick to Head HHS ‘Are Entirely About Politics’,1,3,20,70,5,18,0,90,0
This dad makes the most amazing Disney princess costumes for his daughter,1,3,2,60,0,11,0,62,0
15 Times Donald Trump Was Anyone Who's Ever Thrown Up,1,1,9,32,1,9,2,41,0
This is the golden age of D.C. sports stars hanging out with puppies,1,3,3,51,2,12,0,54,0
From the window lean to the head banger: The 10 best positions for sleeping on a plane,1,3,2,65,1,16,2,67,0
A conspiracy theory-spreading website now has a seat in the White House briefing room,1,2,3,68,1,13,0,71,0
Sweet 16 Big Board: Ranking the tourney's best draft prospects,1,3,4,45,2,9,2,49,0
Can You Name These Sondheim Musicals By Their Characters,1,1,9,39,0,8,0,48,0
24 Shamelessly Sexual Valentine's Day Cards,1,1,5,30,1,5,2,35,0
You Won't Be Able To Stop Watching This Mesmerising Rangoli Video,1,1,11,43,1,10,0,54,0
The biodegradable paper airplane that could revolutionize humanitarian aid,1,3,1,65,0,8,0,66,0
This Woman Finding Out Her High School Crush Has A Hot New Girlfriend Is All Of Us,1,1,17,49,0,16,0,66,0
Which Disney Channel Halloween Movie Is Your All-Time Favorite,1,1,10,43,1,8,0,53,0
The Hill Removes Article About Islam and Lindsay Lohan After Pressure from Islamic Advocates,1,3,12,67,0,13,0,79,0
This Tipsy Nail Art Tutorial Is The Only One You'll Ever Need,1,1,12,37,1,11,0,49,0
CBREVoice: Winning The War For Talent: Why Location Matters,1,3,13,36,2,8,0,49,0
A Bunch Of Corgis Had A Tea Party To Celebrate The Queen's Historic Reign,1,1,14,45,1,13,0,59,0
"James Mattis, John Kelly Confirmed as Defense Secretary, Homeland Security Secretary",1,3,10,62,2,10,0,72,0
Which NHL Player Should You Date Based On Three Questions,1,1,12,36,0,9,0,48,0
Quiz: Is this a real headline or a satirical one from Trump's 100 days?,1,3,3,49,3,13,3,52,0
Student Claims He Was Suspended for Challenging Muslim Professor’s Teaching That Jesus Wasn’t Crucified,1,2,13,75,2,13,0,88,0
"Jeremy Corbyn is suddenly the fastest gun in the west, but he's firing at all the wrong targets",1,2,2,74,2,17,0,76,0
Do you have any cosmetic surgery regrets?,1,2,1,33,1,6,0,34,0
What Your Hometown Friends On Facebook Need To Hear,1,1,9,34,0,8,0,43,0
The Advocate Calls for More Gun Control: Legal Guns No Different Than Illegal Guns,1,3,13,55,1,13,0,68,0
Which Best Picture Winner Should You Watch Based On Your Emoji Preference,1,1,12,50,0,11,0,62,0
Airlines Swim in Cash But Leave Airport Workers High and Dry,1,3,9,41,0,10,0,50,0
"Take A Look At The Newest ""Real Housewives Of Atlanta"" Taglines",1,1,11,40,2,10,0,51,0
Tell Us Your Most Embarrassing Teenage Moment,1,1,7,32,0,6,0,39,0
19 Pictures That Are Too Real For Anyone Who's Asked For The Wi-Fi Password,1,1,14,44,2,13,2,58,0
NBA Superstar Stephen Curry Opens Up About His Life As A Dad,1,1,14,35,0,11,0,49,0
Searching for the Origins of the Universe in the Earth’s Driest Desert,1,3,6,52,1,11,0,58,0
"You Need To See Gigi Hadid Naked On The Cover Of French ""Vogue""",1,1,13,36,2,12,0,49,0
Donald Trump’s Cabinet Picks Disagree With President-Elect on Some Key Issues,1,3,11,54,2,10,0,65,0
Is sushi healthy?,1,3,1,13,1,2,0,14,0
People Drink Hurricanes For The First Time,1,1,7,29,0,6,0,36,0
How To Make A Chicken Tender Like A Fucking Adult,1,1,10,30,0,9,0,40,0
You Could Have a Yahoo Account and Not Know It,1,3,8,29,0,9,0,37,0
This Mattress Has A Built-In Pet Bed Because The Snuggle Is Real,1,1,13,39,1,11,0,52,0
How Much Do You Know About British Food,1,1,8,24,0,7,0,32,0
19 Expert Parenting Tips Every Parent Needs,1,1,6,29,0,6,2,35,0
10 Amazing Cooking Hacks That Can Make Your Life Way Healthier,1,3,10,40,0,10,2,50,0
This Refugee Developed Smart Jewelry To Protect Women From Assault,1,2,10,47,0,9,0,57,0
18 Ways To Upgrade Instant Noodles That'll Change Your College Dorm Life,1,1,11,47,1,11,2,58,0
"Rey's Bread In ""The Force Awakens"" Took Three Months To Make",1,1,11,36,3,10,0,47,0
How to Survive the Longest Flight in the World,1,3,5,33,0,8,0,38,0
Here's How Jamie Oliver Turns A Healthy Smoothie Into Pancakes,1,1,10,42,1,9,0,52,0
A YouTube Chef Makes the M&M-Covered Spaghetti Breakfast From 'Elf',1,3,12,42,4,9,0,54,0
This Is What Happened When Teachers Found Out What Students Really Thought About Them,1,1,14,58,0,13,0,72,0
Which Type Of Swearer Are You,1,1,6,18,0,5,0,24,0
"Woman's New Year's ""detox"" goes horribly wrong",1,3,3,33,4,6,0,36,0
Galleries Weird and wonderful religious relics,1,3,2,39,0,5,0,41,0
"23 Signs You're Hopelessly Obsessed With ""New Girl""",1,1,7,32,3,7,2,39,0
Is This Celeb A Teen Or Not,1,1,7,14,0,6,0,21,0
23 Things People Wish They'd Done In Their Twenties,1,1,8,32,1,8,2,40,0
How Much Do You Actually Know About Ancient Technology,1,1,9,37,0,8,0,46,0
A Definitive Ranking Of The Mario Brothers By Sexiness,1,1,9,37,0,8,0,46,0
We Pitted These Budget And Luxury Dry Shampoos Against Each Other And Here's What Happened,1,1,15,60,1,14,0,75,0
22 Pictures That Prove Drunk You Is The Absolute Worst,1,1,9,34,0,9,2,43,0
How Big A Scotch Whisky Fan Are You,1,1,8,20,0,7,0,28,0
"This Tiny Detail You Might've Missed In ""DDLJ"" Makes The Movie A Tragedy",1,1,16,41,3,12,0,57,0
"South Park Reveals The Canadian Alphabet And It's About Time, Guy",1,1,11,42,2,10,0,53,0
Donald Trump: Media Doesn’t Cover Large Crowds During March for Life,1,3,10,46,2,10,0,56,0
What Do You Want To Know About Tyler Ford,1,1,9,24,0,8,0,33,0
This Is How Real Parents Get Their Kids To Sleep,1,1,10,29,0,9,0,39,0
18 Times Dylan Sprouse Was The Absolute Best Person On Twitter,1,1,10,40,0,10,2,50,0
22 Of The Most Powerful Images Of Marriage Equality In 2015,1,1,9,34,0,10,6,43,0
The Next U.S. Elections Are Happening Sooner Than You Might Think,1,3,12,41,2,10,0,53,0
June Intelligent Oven Might Be A Better Cook Than You,1,2,10,34,0,9,0,44,0
12 Headlines From 2015 That Are 100% Actually True,1,1,6,26,1,8,9,32,0
"Which ""Bridesmaids"" Character Should Be Your Maid Of Honor",1,1,9,39,2,8,0,48,0
Here's the real money-maker for the Internet of Things,1,3,3,41,2,8,0,44,0
A Look At Approximately How Many Inches Harry Styles' Hair Grew In 2015,1,1,12,42,1,12,4,54,0
Susan Sarandon: ‘My Sexual Orientation Is Up For Grabs’,1,3,9,35,3,8,0,44,0
Are You Worse At Email Than Everyone Else,1,1,8,26,0,7,0,34,0
My Mom And I Went To A Taylor Swift Concert And It Was Pure Magic,1,1,15,36,0,14,0,51,0
Do You Hold Your Pencil The Proper Way?,1,3,8,23,1,7,0,31,0
The top 50 hospitals that gouge patients the most,1,3,1,38,0,8,2,39,0
Epic Fail: Rachel Maddow Mocked After Dragging Out Trump Tax ‘Scoop’,1,3,11,44,3,10,0,55,0
Kendall Jenner And Gigi Hadid (aka KenGi) Are The Ultimate Friendship Goals,1,1,12,50,2,11,0,62,0
22 Gifts Your Dude Will Actually Want For Valentine’s Day,1,3,9,36,1,9,2,45,0
21 Pictures That Will Only Slightly Piss You Off,1,2,8,30,0,8,2,38,0
Winter Is Undoubtedly The Best Season Of Them All,1,1,9,32,0,8,0,41,0
"I Taught Nicole Kidman Hindi And We Played Cricket, Says 'Lion' Actor Sunny Pawar",1,3,14,51,3,13,0,65,0
I’ve hit a sleep wall and I’m seeing double,1,2,2,31,2,8,0,33,0
17 Tinder Profiles That Will Make You Fall In Laughter,1,1,9,34,0,9,2,43,0
18 Cosy AF Bath Goals,1,1,5,10,0,4,2,15,0
A genuinely believable CGI actor? It won’t be long,1,2,5,35,2,8,0,40,0
"I met my fiancee on Tinder. Yes, Tinder.",1,3,4,26,3,7,0,30,0
Kanye West Reschedules Yeezy Season 5 Debut After Criticism From CFDA Boss,1,3,14,48,0,11,1,62,0
These Couples Who Met Online Revisit Their First Conversations,1,1,9,45,0,8,0,54,0
Here's How To Make An Insane Deep Dish Cookie,1,1,9,27,1,8,0,36,0
26 Confessions About Canada's New Prime Minister,1,1,6,33,1,6,2,39,0
11 Insanely Sexy Moves That Literally Every Man Loves,1,1,8,35,0,8,2,43,0
Gauri Khan Shares The First Glimpse Of Ranbir Kapoor's Swanky New Bachelor Pad,1,3,13,52,1,12,0,65,0
Police: Suspect Killed While Attacking AZ Trooper was in US ‘Illegally’,1,3,11,47,3,10,0,58,0
"India's Men Need Paternity Leave As Much As Women Need Maternity Leave, Here's Why",1,2,14,52,3,13,0,66,0
22 Questions Not To Ask Your Queer Relatives This Christmas,1,1,9,39,0,9,2,48,0
Which Nicholas Sparks Movie Best Describes Your Love Life,1,1,9,40,0,8,0,49,0
This Year-End Mashup Of 98 Songs Is Fucking Fantastic,1,1,9,33,1,8,2,42,0
21 Tweets About Getting Old That Are Funny Because They're True,1,1,10,40,1,10,2,50,0
"A Lake In Australia Turns Pink, Looks Good In Pictures But Isn't Advisable For Swimming",1,2,15,56,2,14,0,71,0
Christmas Sees Bloody Gang War In Mexico Which Left 13 Dead Including Six Beheaded,1,3,13,54,0,13,2,67,0
Donald Trump Managed to Make Oscars Screw-Up About Him,1,2,9,36,1,8,0,45,0
Why This Mom Is Certain Her C-Section Scar Makes Her A 'Badass Mama',1,3,14,39,3,12,0,53,0
34 Dressed-Up Animals Who Already Won Halloween,1,1,7,31,1,6,2,38,0
Hundreds of Thousands of Demonstrators Attend Women’s March on Washington,1,3,7,56,1,9,0,63,0
This Two-Question Quiz Will Tell You Which Scary Movie To Watch,1,1,12,40,1,10,0,52,0
Vogue and now Gucci: fashion takes steps outside a whitewashed world,1,3,2,55,1,10,0,57,0
"A Bunch Of Men Made Pinterests Of Their Dream Weddings And It's Super Cute, Bro",1,1,15,48,2,14,0,63,0
9 Jokes That'll Make Biswa Kalyan Rath Your New Favourite Comedian,1,1,10,44,1,10,1,54,0
Why is it hard to say 'no' in Turkey?,1,3,2,24,3,8,0,26,0
The 300-Year Quest to Make a Foolproof £1 Coin,1,2,6,26,2,8,4,32,0
P!nk Wrote Ellen Degeneres A Super Sweet New Theme Song,1,1,10,35,1,9,0,45,0
"This New Graphic Novel Is A Stunning, Honest Meditation On Loss",1,3,11,41,1,10,0,52,0
How Much Of America Do You Actually Like,1,1,8,25,0,7,0,33,0
Pizza Hut Hot Dog Bites Pizza Is The Pizza America Deserves,1,3,11,38,0,10,0,49,0
21 Hilariously Unapologetic Confessions From Chipotle Addicts,1,1,6,47,0,6,2,53,0
Drake Is A Low-Key One Direction Stan,1,1,8,22,1,6,0,30,0
19 Internet Hacks Every Student Should Know,1,1,6,29,0,6,2,35,0
A 15-minute quiz can give you a scientifically accurate assessment of your personality,1,3,1,70,1,12,2,71,0
"In Fake News Era, Facebook Still Struggling With Bogus Ads",1,3,10,38,1,9,0,48,0
Southeast Asian walking fish lives up to its name,1,3,2,39,0,8,0,41,0
"5 Easy, Healthy Habits That Anyone Can Take Up",1,1,8,28,1,8,1,36,0
This Woman Wore A Patriotic Hijab On Fox News And People Are Freaking Out,1,1,14,46,0,13,0,60,0
Snap is now selling Snapchat Spectacles online — but there's a catch,1,3,3,52,2,11,0,55,0
Got a hacked Yahoo account? Here's what you should do,1,3,3,39,2,9,0,42,0
"'Inspiring, determined, kind': Who are these London schoolgirls describing?",1,3,3,58,6,8,0,61,0
Grandmas Get Magical Disney Princess Makeovers,1,1,6,35,0,5,0,41,0
These Two Tests Will Reveal One Good And One Bad Truth About You,1,1,13,39,0,12,0,52,0
Here's How 10 People Visualize Their Depression,1,1,6,32,1,6,2,38,0
Blind date: ‘There was more to him than met the eye’,1,3,2,37,3,10,0,39,0
"16 Snapchats Only ""Friends"" Fans Will Understand",1,1,6,32,2,6,2,38,0
Polish Christmas advert about grandfather who learns English touches hearts around the world,1,2,3,77,0,12,0,80,0
"14 ""Hunger Games"" Questions That Are Impossible To Answer",1,1,8,37,2,8,2,45,0
61 Thoughts Everyone Has When Going For A Poo At The Office,1,1,11,35,0,11,2,46,0
Snoop Dogg - the next CEO of Twitter?,1,2,6,22,2,7,0,28,0
Only A Spelling Genius Can Get Over 10 On This Timed Quiz,1,3,11,33,0,11,2,44,0
It's Mid-October And There Was Already A Snowstorm In Ontario,1,1,11,39,2,9,0,50,0
VMwareVoice: How The Cloud Helped A School District Handle A Texas-Sized Growth Spurt,1,2,16,55,2,12,0,71,0
We Know What Object You'd Stick Up Your Butt Based On Your Zodiac,1,1,13,39,1,12,0,52,0
23 Things All Sisters Who Went To The Same School Know,1,1,10,32,0,10,2,42,0
Weird Questions Gay Couples Get,1,1,5,22,0,4,0,27,0
17 Mouthwatering Ways To Have A Love Affair With Strawberries,1,1,9,41,0,9,2,50,0
Are You More 2015 Or 1502,1,1,4,8,0,5,8,12,0
"27 Times ""Top Gear"" Made You Laugh Like Hell",1,1,8,24,2,8,2,32,0
How Trump has changed the Oval Office so far,1,3,4,32,0,8,0,36,0
Can You Guess What These Sexy Halloween Costumes Are Called,1,1,10,40,0,9,0,50,0
28 Of The Most Canadian Crimes Ever Committed,1,1,7,29,0,7,2,36,0
This Ink Blot Test Will Reveal Your Secret Motivation,1,1,9,36,0,8,0,45,0
17 Easy Ways To Do Your Makeup If You Don't Know WTF You're Doing,1,1,15,33,2,13,2,48,0
These Stunning Wedding Photos Will Actually Make Your Jaw Drop,1,1,10,43,0,9,0,53,0
This 23-Year-Old Went Blind In One Eye After Wearing Cheap Color Contacts,1,1,13,45,2,11,2,58,0
Donald Trump With A Man Bun Will Haunt You To The Grave,1,1,12,32,0,11,0,44,0
What Your Favorite Part Of A Man's Face Says About You,1,1,11,32,1,10,0,43,0
24 Academic Tweets That Will Make You Laugh And Then Cry,1,1,10,34,0,10,2,44,0
5 things to do by New Year's Eve to lower your tax bill,1,3,3,38,1,12,1,41,0
"'Vicious, evil': Escaped murderers among the worst of the worst at infamous NY lockup ",1,2,4,64,4,14,0,68,0
How Adulthood Happens ,1,2,3,16,0,3,0,19,0
This man wore a suit to meet his new nephew because ‘first impressions matter’ The list,1,3,2,68,2,15,0,70,0
Loyola Prof Calls Cops on Student Wearing His Police Uniform,1,3,9,42,0,9,0,51,0
How Sensitive Are You,1,1,4,14,0,3,0,18,0
Everyone Is Freaking Out About These Downright Magical Airbnbs,1,1,9,45,0,8,0,54,0
Exclusive—NFL Great Burgess Owens: The Left Destroyed Strong Black Communities,1,3,13,54,2,9,0,67,0
"Donald Trump, Quebec City, Patriots: Your Monday Evening Briefing ",1,2,9,45,3,9,0,54,0
What happens when narcissists become parents,1,3,1,38,0,5,0,39,0
The 23 Most Important Movie Questions Of 2015,1,1,6,26,0,7,6,32,0
"Barbara Walters Told Bradley Cooper To His Face That She Finds Him ""Screwable""",1,1,13,51,2,12,0,64,0
Just how much trouble is Michael Flynn in?,1,3,3,31,1,7,0,34,0
10 Ridiculously Hot Doctors Guaranteed To Give You A Fever,1,1,9,38,0,9,2,47,0
"Britney Spears Fan Pranks Southwest Airlines, Receives the Perfect Response",1,3,9,56,1,9,0,65,0
Can You Match The Halloween Costume To The TV Show,1,1,11,30,0,9,0,41,0
"Can You Guess These Classic ""Star Wars"" Creatures",1,1,8,32,2,7,0,40,0
"Hot 100 Chart Moves: Katy Perry, James Arthur & Lorde Hit New Heights",1,3,11,40,3,12,3,51,0
21 Things You'll Understand If You And Your Best Friend Are Massive Trolls,1,1,12,47,1,12,2,59,0
19 Body-Positive Books You'll Want To Read With Your Daughter,1,1,10,38,2,9,2,48,0
"Which Chanel From ""Scream Queens"" Are You",1,1,7,26,2,6,0,33,0
21 Borderline Orgasmic Experiences For Anyone Who Loves Cleaning,1,1,8,46,0,8,2,54,0
Can You Guess If These Are Sex Toys Or Just Regular Shit,1,1,12,33,0,11,0,45,0
What's Something That You Only Understand If You Have A Sister,1,1,11,40,1,10,0,51,0
Less Meat Doesn't Mean Cheaper: The Tricky Menu Economics Of Veggie-Focused Restaurants,1,3,13,60,3,11,0,73,0
25 Gifts For The Future Revolutionary In Your Life,1,1,8,32,0,8,2,40,0
"Jamie And Claire Are Looking Damn Good In ""Outlander"" Season 2",1,1,10,39,2,10,1,49,0
The Top-Selling Albums of 2016,1,3,4,17,1,4,4,21,0
What is Dodd-Frank? And is Trump about to cause another financial crisis?,1,3,5,54,3,11,0,59,0
Diane Keaton Running To Get Froyo Is Diane Keaton Living Her Best Life,1,1,13,45,0,12,0,58,0
"Judge Considers Ordering President Donald Trump to Double 50,000 Refugee Inflow to the United States",1,3,11,69,1,14,5,80,0
Adele Absolutely Nailed Singing A Nicki Minaj Record,1,1,8,37,0,7,0,45,0
Spotify Executive Confirmed as British Victim of Sweden Terror Attack,1,3,8,52,0,9,0,60,0
"How Well Do You Remember Nicki's Verse In ""Monster""",1,1,9,31,3,8,0,40,0
"I'm Homeless, But I'm Not",1,1,5,13,3,4,0,18,0
23 Awesome Gifts To Help Your Stoner Best Friend Get Totally Baked,1,1,11,42,0,11,2,53,0
19 Things All '90s Kids Will Do When They're Old,1,1,8,25,2,9,4,33,0
DRAMATIC VIDEO: FL Police Officer Saves Toddler's Life in Tax Office  Insider,1,3,23,40,2,12,0,63,0
Anna Camp And Skylar Astin Are Engaged So Everything Is Finally Right In The World,1,1,15,53,0,14,0,68,0
Zsa Zsa Gabor knew femininity was a performance. She played it perfectly,1,3,4,56,1,11,0,60,0
19 Reasons Why Christopher Lee Was A Pretty Amazing Human Being,1,3,10,41,0,10,2,51,0
22 Books Every Twentysomething Guy Needs To Read,1,1,7,32,0,7,2,39,0
23 Reasons To Never Eat Breakfast,1,1,5,21,0,5,2,26,0
This Lamborghini Looks Like A Pizza Because Why The Hell Not,1,1,11,39,0,10,0,50,0
Ed Sheeran Has Broken His Social Media Silence And OMG Is 2016 Saved?,1,2,14,38,1,12,4,52,0
"Are You More ""Cinderella"" Or ""Maleficent""",1,1,6,26,4,5,0,32,0
"The Clueless American's Guide To ""The Great British Bake Off""",1,1,10,39,3,9,0,49,0
Are Night Owls Better Off Changing Their Sleep Patterns to Be Healthier?,1,3,11,49,1,11,0,60,0
48 Genuinely Insane Facts About The Kardashians,1,1,6,33,0,6,2,39,0
Béisbol Life: A season-long celebration of Latino ballplayers,1,3,4,48,2,7,0,52,0
Can You Name The TV Show Based Off One GIF,1,1,13,20,0,9,0,33,0
These Eight Secret Waterfalls Will Make Your Next Vacation Magic,1,3,10,45,0,9,0,55,0
Miley Cyrus posed nude with a pig on the cover of 'Paper Magazine',1,3,4,48,2,12,0,52,0
Two charts that show how people's attitudes to sex have changed in the past 10 years The list,1,3,2,71,1,17,2,73,0
"How Well Do You Remember The ""One Semester Of Spanish Love Song""",1,1,12,39,2,11,0,51,0
15 Things Only Super-Disciplined People Will Understand,1,1,7,39,1,6,2,46,0
Just Three Per Cent of Newly Arrived Migrants Have Found Work,1,3,10,41,0,10,0,51,0
Eight foods to superpower your immune system,1,3,1,37,0,6,0,38,0
Here Are 4 Borderline Genius Waffles You Need To Try,1,1,9,33,0,9,1,42,0
"Mahira Khan's Video Goes Viral, Virat-Anushka Are NOT Engaged And More From Entertainment",1,3,16,58,3,12,0,74,0
20 Problems Only Cosplayers Will Understand,1,1,5,31,0,5,2,36,0
Kylie Jenner Has Mint Green Hair,1,1,6,21,0,5,0,27,0
Do You Actually Prefer Appetizers Or Dessert,1,1,7,31,0,6,0,38,0
6 things to do if you want to wake up before 6 a.m. feeling refreshed,1,3,0,51,2,14,2,51,0
"Can You Match The ""Game Of Thrones"" Quote To The Character Who Said It",1,1,14,41,2,13,0,55,0
The Pope's Security Guys Weirdly Look Just Like Neil Patrick Harris And Alec Baldwin,1,1,14,56,1,13,0,70,0
Can You Guess The Disney Movie Based On The Beautiful Screencap?,1,3,11,42,1,10,0,53,0
I’m concerned that my children are no longer employable,1,3,1,45,1,8,0,46,0
"Pak Arrests More 'Indian Spies', BBC Banned From National Parks For Five Years And Other Must Reads",1,3,19,61,3,16,0,80,0
22 Characters From Your Childhood You Forgot You Hated,1,1,8,36,0,8,2,44,0
11 Cats Freaking Out About Cucumbers,1,1,5,24,0,5,2,29,0
"Parents Abandon Kids At Railway Station, A Policeman Gives Them A New Life",1,2,13,48,1,12,0,61,0
Here's The Moment Justin Bieber And Hailey Baldwin Met For The First Time In 2009,1,1,14,48,1,14,4,62,0
Make the Marlins a winner? Don't ever doubt Derek Jeter,1,3,5,39,2,9,0,44,0
How Pope Francis Became the Leader of the Global Left,1,3,7,37,0,9,0,44,0
This Latina Beauty Queen Was Just Named The New Face Of Revlon,1,1,12,39,0,11,0,51,0
21 People On The One Thing They'd Change About Hollywood,1,1,9,35,1,9,2,44,0
Literally Just A Bunch Of Funny Tweets About Celine Dion,1,1,10,37,0,9,0,47,0
WikiLeaks Explained: How Vulnerable Are You to Hackers? ,1,2,8,38,2,8,0,46,0
The traditional cures threatening Myanmar's wildlife – in pictures,1,3,2,54,2,8,0,56,0
"CBS’s Dickerson: Lack of Trust In the Media Is Not Because of Trump, Press Ruined Its Reputation ‘On Its Own’",1,3,19,66,5,19,0,85,0
FBI Captures 'Top 10 Most Wanted' Fugitive In Los Angeles,1,2,11,33,2,9,2,44,0
This One Trick Let's You Add Live Photos to Instagram,1,3,9,34,1,9,0,43,0
"18 Celebs You Totally Forgot Were On ""Gilmore Girls""",1,1,8,32,2,8,2,40,0
Portrait of Ronald Reagan Defaced During Break-In at GOP Office in North Carolina,1,3,13,55,1,12,0,68,0
Republicans divided over how to help people buy health insurance,1,2,1,54,0,9,0,55,0
"Despite the negative stigma, payday loans are not much different from credit cards",1,2,1,68,1,12,0,69,0
The War for Your Tax Return Heats Up,1,3,7,22,0,7,0,29,0
"When the Sun Sets Early, It’s a Race to Prepare for Shabbat ",1,3,8,38,2,12,0,46,0
18 Moving Photos From Vigils For Paris Held Across Canada,1,1,9,37,0,9,2,46,0
31 Ways You Know You're DEFINITELY a DC Native,1,1,17,18,1,8,2,35,0
14 Easy Ways to Save Money This Spring,1,3,6,23,0,7,2,29,0
17 Snow Day Recipes You Can Cook (or Drink) Right Now,1,1,9,30,2,10,2,39,0
25 Things You'll Only Get If You're Obsessed With Baths,1,1,9,33,2,9,2,42,0
"Tanmay Bhat's Honest Apology To Sachin,Farhan-Adhuna Granted A Divorce And More From Ent",1,3,15,58,3,12,0,73,0
Shia LaBeouf Moves Anti-Trump Art Exhibit to Albuquerque,1,2,9,39,1,7,0,48,0
21 Disney GIFs That'll Ruin Your Whole Entire Childhood,1,1,10,34,1,8,2,44,0
It's 2016 And Martha Stewart Is Still Fucking Killing It On Twitter,1,1,11,40,1,11,4,51,0
Which Anna Kendrick Tweet Are You Based On Your Zodiac Sign,1,1,11,38,0,10,0,49,0
18 British TV Shows That Sadly Didn't Return In 2015,1,1,9,27,1,9,6,36,0
This Is How 23 Countries Feel About Transgender Rights,1,2,8,36,0,8,2,44,0
"According To Taylor Swift's Twitter Faves, She And Calvin Harris Are Probably Still Together",1,1,14,63,2,13,0,77,0
14 People Share What It's Like To Be Divorced At A Young Age,1,1,12,33,1,12,2,45,0
"How Well Do You Remember ""A Goofy Movie""",1,1,8,23,2,7,0,31,0
New year's resolutions: How to lose the fat and get fit for free,1,3,2,48,2,12,0,50,0
"20 Times ""Civilization V"" Made You Act Uncivil",1,1,7,28,2,7,2,35,0
Krampus Is The Terrifying Holiday Movie You Didn't Know You Needed,1,1,11,44,1,10,0,55,0
18 Genius Ways To Eat Cheese For Every Meal,1,1,8,25,0,8,2,33,0
Fools' Gold: How A Controversial Hit Discovery Channel Show Went From Boom To Bust,1,1,14,53,2,13,0,67,0
How diabolical are the Teen Choice Awards? Look at what happened with One Direction and Zayn Malik.,1,3,9,72,2,16,0,81,0
Tax-Smart Bond Swapping,1,3,4,16,1,2,0,20,0
17 Easy Dinners That You Can Cook And Eat For A Whole Week,1,3,12,32,0,12,2,44,0
EXCLUSIVE: American Eyewitness Account of Paris Terrorist Attack,1,3,15,41,1,7,0,56,0
PewDiePie claims YouTube contacted him over deleting his account,1,3,5,51,0,8,0,56,0
Angelina Jolie And Brad Pitt's New Movie Is About Liking To Watch,1,1,12,41,1,11,0,53,0
"The One Hot Canadian Everyone Forgets On Their ""Hot Canadians"" List",1,1,11,44,2,10,0,55,0
"LeBron James, Stephen Curry lead ASG starters; Russell Westbrook left out",1,2,10,51,2,10,0,61,0
Psychologists have identified 10 factors that explain why and how we fall in love,1,3,1,65,0,13,2,66,0
It's Time We Realize Britney Spears Is Actually God,1,1,9,33,1,8,0,42,0
Credit-Card Thieves Move Online as Chips Thwart In-Store Fraud,1,3,10,42,2,8,0,52,0
Where Is The Best Taco You've Ever Had In Your Life,1,1,11,29,1,10,0,40,0
"What ""No Name"" Product Are You Actually",1,1,7,24,2,6,0,31,0
5 Things We Hope to See From Lorde's 'Saturday Night Live' Appearance,1,2,10,44,3,11,1,54,0
"Which ""The Emperor's New Groove"" Character Are You",1,1,8,32,3,7,0,40,0
How Keen Are You,1,1,4,9,0,3,0,13,0
"Remember When David Bowie Was On ""SpongeBob Squarepants?""",1,1,9,38,3,7,0,47,0
Author Rainbow Rowell Chooses Between Good And Evil In This Epic Game Of Would You Rather,1,1,16,58,0,15,0,74,0
Google’s Next Project: Fixing Congested Cities - Digits,1,2,7,38,3,7,0,45,0
How To Balance A Full-Time Job And Founding A Company,1,3,11,32,1,9,0,43,0
"Getting on, or getting on with it: life in an OAP hotspot",1,3,4,40,2,11,0,44,0
Animals Who Know Our Daily Struggles,1,1,6,25,0,5,0,31,0
14 Badass Historical Women To Name Your Daughters After,1,1,8,37,0,8,2,45,0
19 Fluffy Puppies Who Might Actually Be Bears,1,1,7,29,0,7,2,36,0
IS in Afghanistan: How successful has the group been?,1,3,4,39,2,8,0,43,0
This Red Line Test Will Show How Honest You Are,1,1,10,28,0,9,0,38,0
'Clean Sleeping' Is Expected To Be The Biggest Health Rage Of 2017,1,3,11,38,2,11,4,49,0
Here’s why sadness can make you physically sick The list,1,3,2,44,1,9,0,46,0
"If You're Not Ready To File Your Taxes, Here's How To Get An Extension",1,3,14,40,3,13,0,54,0
"Unlike Their House Colleagues, These Senate Democrats Are Attending Trump’s Inauguration",1,3,11,65,2,10,0,76,0
Supreme Court relives a horrific murder that shocked Washington decades ago,1,3,3,62,0,10,0,65,0
"Inside London's Bone Archive, Where The Dead We Dig Up Go To Live",1,1,13,38,2,12,0,51,0
8 Struggles Of Being A New Yorker In L.A,1,1,9,21,1,8,1,30,0
Nate Silver: ‘There Really Was a Liberal Media Bubble’,1,3,8,35,3,8,0,43,0
This app wants to warn undocumented immigrants of raids in Trump's America,1,3,3,59,1,11,0,62,0
23 Pictures That Will Make All Responsible Adults Extremely Angry,1,1,9,45,0,9,2,54,0
"Drag Queens Play ""Fuck, Marry, Kill"" With Republican Candidates",1,1,9,42,4,8,0,51,0
Why This Lingerie Photo of Two ‘Very Different’ Best Friends Is Important [Video],1,3,12,53,4,12,0,65,0
Non-Americans: How Should You Celebrate U.S. Thanksgiving,1,1,9,38,4,6,0,47,0
32 Times Tumblr Truly Nailed Your Star Sign In 2015,1,1,8,28,0,9,6,36,0
"After the US, far right says 2017 will be the year Europe wakes up",1,2,4,44,1,13,4,48,0
These Are the 25 Best-Paying Jobs in the Country,1,3,6,31,1,8,2,37,0
We Know Your Favorite Pop Star Based On Your Zodiac Sign,1,1,11,35,0,10,0,46,0
12 Dumb Ways To Drink A Beer,1,1,6,14,0,6,2,20,0
7 wearables saving babies' lives around the world,1,3,0,40,1,7,1,40,0
Want an Army-Green Rolex? Hire a Watch ‘Modder’,1,2,7,29,4,7,0,36,0
How Well Do You Remember WWF In The Early '90s,1,1,11,23,1,9,2,34,0
Molly Is 16. Her Justin Bieber Is Bernie Sanders,1,1,8,29,1,8,2,37,0
26 Pictures That Are Way Too Real For Millennials,1,1,8,31,0,8,2,39,0
We Know What Movie Scares You The Most,1,1,8,23,0,7,0,31,0
How women are using their Tinder matches to scam money off men,1,3,2,49,0,11,0,51,0
Paying for President Trump's Travel and Security Costs ,1,3,6,40,1,8,0,46,0
15 Ways To Make Cheap Wine Insanely Drinkable,1,1,7,29,0,7,2,36,0
3 reasons why half of American workers are not using their vacation time,1,3,1,58,0,12,1,59,0
21 Outfits 2000s Girls Lusted After,1,1,4,20,0,5,6,24,0
'One Million Moms' Throws Fit Over Mag's Choice To Include Same-Sex Parents,1,3,13,47,4,11,0,60,0
I Went To Lauren Conrad's Fashion Show And Lived Out My High School Fantasy,1,1,14,47,1,13,0,61,0
17 Shania Twain Lyrics That Will Guide You To Self-Acceptance,1,1,10,39,1,9,2,49,0
17 Incredibly Lazy But Totally Tasty Noche Buena Recipes,1,1,8,38,0,8,2,46,0
Is This Girl In A Girl Group,1,1,7,15,0,6,0,22,0
9 Illustrated Tweets Guaranteed To Make You LOL,1,1,9,30,0,7,1,39,0
This Baby Got Really Confused When He Was Babysat By His Dad's Twin,1,1,13,41,1,12,0,54,0
"23 Times ""Hunger Games"" Fans Dominated Tumblr",1,1,6,29,2,6,2,35,0
Matt McGorry And Dascha Polanco From OITNB Reunited At The Emmys And People Freaked Out,1,1,20,53,0,14,0,73,0
21 Kitchen Upgrades That You Can Actually Do Yourself,1,1,8,35,0,8,2,43,0
12 Things Cubans View Differently,1,1,4,23,0,4,2,27,0
Why Verizon's future could hinge on an $80 billion legacy cable company,1,3,2,54,2,11,2,56,0
Confused 3-year-old has some serious questions about Easter traditions,1,3,2,57,2,8,1,59,0
Captivating slow motion footage shows moment lightning strikes a beach,1,2,1,60,0,9,0,61,0
Are You Really A Mermaid,1,1,5,15,0,4,0,20,0
31 Insane After-Christmas Sales To Shop Right Now,1,1,8,31,1,7,2,39,0
18 Breathtaking Mexican Treats That Will Make You Drool Uncontrollably,1,1,9,50,0,9,2,59,0
CNN’s Cuomo: Susan Rice Story a ‘Fake Scandal’,1,3,9,26,4,7,0,35,0
18 Ghostly Treats That'll Take Your Halloween Party To The Next Level,1,1,11,44,1,11,2,55,0
European debt crisis: It's not just Greece that's drowning in debt,1,3,3,50,3,10,0,53,0
The Weeknd Says Taylor Swift Wouldn't Stop Petting His Hair At A Party,1,1,13,44,1,12,0,57,0
31 Totally Adorable Holiday DIYs,1,1,6,20,0,4,2,26,0
Can you really die of a broken heart?,1,3,1,28,1,7,0,29,0
"An 18-Year-Old Instagram Star Says Her ""Perfect Life"" Was Actually Making Her Miserable",1,1,14,55,4,12,2,69,0
I Did 8 Exercise Videos In One Day And Barely Survived,1,1,10,33,0,10,1,43,0
This poster of celebrities the world has lost in 2016 is just heartbreaking The list,1,3,2,64,0,14,4,66,0
We Know If You Got What You Wanted For Christmas,1,1,10,29,0,9,0,39,0
The Best and Worst of Oscars 2017 ,1,3,4,19,0,7,4,23,0
9 Surprising Ways You're Wasting Money Without Realizing It,1,3,8,41,1,8,1,49,0
Belgian astronomers who found planetary system named it after beer,1,3,1,56,0,9,0,57,0
"Do You Remember The Pilot Episode Of ""Bob's Burgers""",1,1,9,32,3,8,0,41,0
Did You Adopt A Pet This Year,1,1,7,16,0,6,0,23,0
Celebrities and Their Christmas Trees: 2016 Edition,1,2,5,35,1,6,4,40,0
Spicer: Sanctuary Cities ‘Have the Blood of Dead Americans on Their Hands’,1,3,9,51,3,11,0,60,0
Watch This Jet-Powered Exosuit Turn Inventor into Real-Life Iron Man,1,3,11,46,2,9,0,57,0
Remembering North Korea's Christian martyrs,1,3,4,34,1,4,0,38,0
27 Things To Help You Take The Best Shower Of Your Life,1,3,11,31,0,11,2,42,0
Are You More Bailee Madison Or Hailee Steinfeld,1,1,8,32,0,7,0,40,0
Poorly Drawn Lines Is Now A Book And It's Just Wonderful,1,1,11,34,1,10,0,45,0
15 Of The Most Creative College Essay Prompts From 2015,1,1,8,32,0,9,6,40,0
Turkey threatens Netherlands with diplomatic sanctions for acting like 'Nazi remnants',1,3,3,71,2,10,0,74,0
Here's Why You Get All Red When You Have Sex,1,1,10,24,1,9,0,34,0
Make Cauliflower and Broccoli More Compelling ,1,3,5,35,0,6,0,40,0
"Which Badass Female From ""Star Wars: The Force Awakens"" Are You",1,1,11,39,3,10,0,50,0
Betty White: 95 Things You Need to Know About the Birthday Girl [Video],1,3,10,44,3,12,2,54,0
26 Tweets That Catholics Will Find Sinfully Funny,1,1,7,33,0,7,2,40,0
Sarah Silverman Mistakes Construction Markings for Swastikas,1,3,6,48,0,6,0,54,0
Apple's New iPhone Update Is Making Everybody Look Thirsty AF,1,1,11,40,1,9,0,51,0
Disney Princesses Breastfeeding In Public,1,1,5,32,0,4,0,37,0
"Strippers answer the only question you really want to know, and it's pretty surprising The list",1,3,2,76,2,15,0,78,0
Real-life horror at Kong: Skull Island Vietnam premiere,1,2,5,41,2,7,0,46,0
16 Times Calum Hood Was The King Of Instagram,1,1,8,27,0,8,2,35,0
19 Husbands Who Failed So Hard They Almost Won,1,1,8,28,0,8,2,36,0
5 Great Books To Read This December,1,1,6,22,0,6,1,28,0
In search of the dream greenhouse: how Instagram has given glasshouses a new life,1,3,2,65,1,13,0,67,0
These Gluten-Free Blender Muffins Are The Perfect Make-Ahead Breakfast,1,1,11,49,2,8,0,60,0
Russia Appears To Defend Michael Flynn With Super-Weird Message On Twitter,1,2,12,51,1,10,0,63,0
22 Reasons Why Eggs Should Be Banished From This Earth,1,1,9,34,0,9,2,43,0
Goldman Sachs Is About To Swallow Donald Trump,1,3,8,31,0,7,0,39,0
5 Smart Ways To Pull Yourself Together,1,3,6,25,0,6,1,31,0
Mariah's 'All I Want for Christmas Is You': The Gift That Keeps on Giving,1,3,12,44,4,13,0,56,0
Just Some Guys In England Driving A Tank To The Gas Station,1,2,12,36,0,11,0,48,0
24 Struggles Only People Who Have Gone Through Finals Week Will Understand,1,1,11,50,0,11,2,61,0
People Are Swooning Over This Husband’s Gift To His Makeup-Loving Wife,1,3,12,46,2,10,0,58,0
10 Of The Strangest Compliments Ever Received,1,1,6,31,0,6,2,37,0
23 fascinating diagrams reveal how to negotiate with people around the world,1,2,0,63,0,11,2,63,0
"Wilson, Weatherill, Wyatts: The winners and losers of the week in politics",1,3,4,56,3,11,0,60,0
23 YA Novels From The '00s Everyone Will Recognize,1,1,8,29,1,8,4,37,0
"24 Times ""Skyrim"" Was Accidentally Hilarious",1,1,5,30,2,5,2,35,0
Which House Plant Are You Least Likely To Kill?,1,3,9,29,1,8,0,38,0
"Wanted: Someone to travel in luxury around world - for £8,000 a month ",1,3,2,47,4,13,4,49,0
The 20 Most Iconic AIM Away Messages Of All Time,1,1,11,26,0,9,2,37,0
We Asked John Waters For Dating Tips And He Said It's OK To Sleep With Assholes,1,1,17,46,1,15,0,63,0
Here's What It's Like To Visit An Actual Paper Town,1,1,10,30,2,9,0,40,0
The 100 Most Important Puppy Photos Of All Time,1,2,8,28,0,8,3,36,0
The CEO of Dippin' Dots just responded to 5 years of angry tweets from Trump's press secretary,1,2,7,68,2,16,1,75,0
17 Lohanthony Tweets That Will Speak To Your Soul,1,1,8,31,0,8,2,39,0
Artists Pay Tribute To David Bowie,1,1,6,23,0,5,0,29,0
An Exhibition In France Is Celebrating Two Centuries Of Pioneering Women Photographers,1,1,12,63,0,11,0,75,0
Feathers fly as pillow war overtakes downtown Los Angeles,1,3,3,46,0,8,0,49,0
What the failed Obamacare repeal means for tax reform,1,3,2,43,0,8,0,45,0
Here's Six Amazing Tricks To Get The Most Out Of Your Wardrobe,1,1,12,38,1,11,0,50,0
The man with a titanium chest,1,3,1,23,0,5,0,24,0
Why Does Mount Rushmore Exist? ,1,2,5,20,1,5,0,25,0
12 Waffle Maker Snacks You Should Make Immediately,1,1,7,34,0,7,2,41,0
25 Race Training Tips From Actual Runners Who Have Been There,1,1,10,39,0,10,2,49,0
"14,474 People Contract HIV Through Blood Transfusions, Government Denies",1,3,10,47,2,8,5,57,0
The I Can't Escape Pumpkin Spice Puzzle,1,1,7,25,1,6,0,32,0
14 things successful people do in the first week of a new job,1,3,0,47,0,12,2,47,0
26 Hilarious Reasons People Actually Cried While Drunk,1,1,7,38,0,7,2,45,0
"Jimmy Fallon Beautifully Performed Drake's ""Hotline Bling"" As Bob Dylan",1,1,10,49,3,9,0,59,0
"Fake Antibiotics Being Sold Containing Flour, Starch And Paracetamol",1,2,9,50,1,8,0,59,0
18 Secrets Coffee Lovers Will Never Tell You,1,1,7,28,0,7,2,35,0
IRS Audit Traps & 5 Ways To Steer Clear,1,2,9,20,1,8,1,29,0
People Are Pretty Obsessed With This Guy’s Bob Ross Birthday Party,1,3,11,44,1,10,0,55,0
Here's How To Make The Ultimate Pinterest Face Mask,1,1,9,33,1,8,0,42,0
Which Punny Valentine's Day Card Should You Give Based On Your Zodiac,1,1,12,45,1,11,0,57,0
"We Need To Talk About The Truly Iconic Naomi Clark From ""90210""",1,1,11,34,2,11,5,45,0
"Watch E! News Now Season 2016 Excerpt Free Online - Top Duets from Real-Life Couples, Ranked | Yahoo View",1,3,16,62,5,18,4,78,0
Globalist Le Pen Rival Promises to ‘Emancipate’ Migrant Communities,1,3,8,49,2,8,0,57,0
"The ""Broad City"" Season 3 Trailer Is Here And It's Funny AF",1,1,12,32,3,11,1,44,0
These 17 Inappropriate Pumpkins Will Make You Feel Things,1,1,8,39,0,8,2,47,0
"Was May 21, 2005, The Darkest Day In Fashion History",1,1,8,27,2,9,6,35,0
Which Disney Pet Are You,1,1,5,15,0,4,0,20,0
"Ohio Woman Rescued From a Neighbor’s Pit, Police Say ",1,3,8,34,2,9,0,42,0
Who Said It: Hillary Clinton Or Claire Underwood,1,1,8,32,1,7,0,40,0
What Do I Do About My Selfish Friends? ,1,3,8,22,1,8,0,30,0
We Know What Season You Were Born In Based On Random Questions,1,1,12,39,0,11,0,51,0
What Donald Trump Doesn't Want You To Know About His Twitter Followers,1,3,12,46,1,11,0,58,0
"Thank you for your support, which is more important now than ever",1,2,1,52,1,11,0,53,0
"How Well Do You Actually Remember ""10 Things I Hate About You""",1,1,11,36,2,11,2,47,0
"Which ""Agents Of S.H.I.E.L.D."" Organization Do You Affiliate With",1,1,14,35,8,8,0,49,0
Three Tech Trends That Will Impact Small Business Lending ,1,3,9,40,0,9,0,49,0
Large asteroid to hurtle past Earth on April 19,1,3,3,34,0,8,2,37,0
"16 Times Pam From ""True Blood"" Was A Master Of Sass",1,1,10,27,2,10,2,37,0
33 Cute Accessories That’ll Melt Even The Coldest Heart,1,3,8,36,1,8,2,44,0
Do White People Get Stressed Talking About Race,1,1,8,32,0,7,0,40,0
Are You More Tinker Bell Or Belle,1,1,7,20,0,6,0,27,0
What Cis People Say To Trans People Vs. What We Hear,1,1,11,30,1,10,0,41,0
7 Simple Ways To Make This Week A Little Less Shitty,1,1,10,31,0,10,1,41,0
From Amy Jackson's Sizzling Dance To Ziva Dhoni's Guest Appearance: A-Z Of The Indian Premier League 2017,1,3,17,64,4,16,4,81,0
"We Know Your Fave ""1989"" Song Based On The Calvin Harris You Choose",1,1,12,37,2,12,4,49,0
Dem Rep Lewis: I Don’t See Trump as ‘A Legitimate President’ ‘There Was a Conspiracy on the Part of the Russians’,1,3,15,72,6,20,0,87,0
Can You Guess Which Celebrities Tweeted These Holiday-Themed Tweets,1,1,10,48,1,8,0,58,0
Mariah Carey Is Getting Her Own MAC Collection And It Is Incredible,1,1,14,42,0,11,0,56,0
29 Of The Most Ridiculous Ways People Injured Themselves As Kids,1,1,10,42,0,10,2,52,0
Gainor: ‘Terrifying’ That Media Are Talking Openly About Assassinating Trump,1,3,10,54,3,9,0,64,0
16 Relatable Situations For Anyone With A Nosy Uncle Or Aunty,1,1,10,39,0,10,2,49,0
Stephen Curry Pokes Fun at Daughter Riley's Postgame Antics on 'Family Guy',1,2,10,51,3,11,0,61,0
The Sun criticises Newcastle's reporter blacklist with special back page,1,2,3,59,1,9,0,62,0
Cool teen builds soda machine in empty locker,1,3,1,37,0,7,0,38,0
21 Adorable Things You Need If Pigs Are Your Favorite,1,1,9,33,0,9,2,42,0
"Which ""New Girl"" Character Should Be Your Roommate",1,1,8,33,2,7,0,41,0
Pinball Craftsman Hits Bumpers Building a Sought-After Machine,1,2,8,46,1,7,0,54,0
"MAFIA EU: Farage Blasts Bloc’s ‘Vindictive, Nasty’ Demands’",1,2,13,33,6,7,0,46,0
Here's Everything Your Shape Says About You,1,1,7,29,1,6,0,36,0
This Purple Line Test Will Determine What Your Sex Style Is,1,1,11,38,0,10,0,49,0
How to Get the Benefits of Fasting With Less Deprivation,1,3,7,40,0,9,0,47,0
Who Said It: Disney Princess Vs. Kardashian Edition,1,1,8,34,2,7,0,42,0
"A Day After Attack, Grief Turns to Anger for Egypt’s Christian Minority ",1,3,10,48,2,12,0,58,0
Which Hogwarts House Does Each Kardashian Belong In,1,1,8,36,0,7,0,44,0
"Super Bowl 2017 movie trailers: What to expect, from Ghost in the Shell and Fast and Furious 8 to Transformers 5",1,3,8,76,2,20,6,84,0
TX Gov Abbott: I Will Sign Legislation That Could Put Sheriffs of Sanctuary Cities in Jail,1,3,15,59,1,15,0,74,0
Which Canadian Celebrity Should You Marry Based On Your Zodiac Sign,1,1,11,46,0,10,0,57,0
People Live In Solitary Confinement For 24 Hours,1,1,7,32,0,7,2,39,0
Pretend To Buy Some Jewellery And We'll Guess How Old You Are,1,3,12,37,1,11,0,49,0
NFL Prospect Missed Out on Winning an Island Because He Wore Nike Cleats Instead of adidas,1,3,14,61,0,15,0,75,0
The thing you always suspected about your dog is actually true The list,1,3,2,57,0,12,0,59,0
Do You Know The Inspiration For These Famous Songs,1,1,9,33,0,8,0,42,0
23 Reasons Why The Great British Bake Off Is The Best Show On Netflix,1,3,13,41,0,13,2,54,0
5 ways to get your credit score out of the dumps,1,3,0,37,0,10,1,37,0
Watch Live: White House Welcomes New England Patriots,1,3,8,37,1,7,0,45,0
24 People Who Have Simply Stopped Caring,1,1,6,26,0,6,2,32,0
This woman worries her ex will kill her when he leaves prison. A law won’t let her have a Taser.,1,3,3,71,3,19,0,74,0
"ATTENTION, WORLD: India Has Once Again Aced No-Shave November",1,1,22,28,3,8,0,50,0
"Randy Howard, country singer, dies a country song death",1,2,2,43,2,8,0,45,0
28 Vines That Will Remind You Life Is Not (Always) Terrible,1,1,10,35,2,10,2,45,0
21 Unexpected Things You Can Make In A Rice Cooker,1,1,9,30,0,9,2,39,0
17 Pictures That Are Too Real For People Who Hate Group Chats,1,1,11,37,0,11,2,48,0
This Is What Your $10 Ikea Lack Table Looks Like Inside,1,1,10,32,1,10,2,42,0
The 46 Most Powerful Photos Of 2016,1,2,5,18,0,6,6,23,0
"France Just Made Every Citizen An Organ Donor, Unless They Opt Out",1,3,12,42,1,11,0,54,0
42 Slightly Gross Things All Female Best Friends Have Secretly Done,1,2,10,45,0,10,2,55,0
Disney Princesses As Damn Rocks,1,1,5,22,0,4,0,27,0
The Best and Worst U.S. Cities for Retirement,1,2,7,29,2,7,0,36,0
You Can Make Dinner For A Week With $25,1,1,8,20,1,8,2,28,0
Here comes CPI...,1,2,4,8,3,2,0,12,0
15 Dogs Who Are Having Their Greatest Birthday Ever,1,1,8,33,0,8,2,41,0
"Here's What The Cast Of ""The Fresh Prince Of Bel Air"" Are Doing Now",1,1,14,37,3,13,0,51,0
Dieses Video ist nicht verfügbar.,1,3,2,26,1,4,0,28,0
Kate Hudson And Jimmy Fallon Played A Perfect Game Of Dubsmash Together,1,1,12,48,0,11,0,60,0
Let These Hot Guys Help You Count Down The Days 'Til Christmas,1,1,12,38,1,11,0,50,0
Which Signature Dance Move Are You,1,1,6,23,0,5,0,29,0
Uber Gives Restless Employees a Way to Cash Out,1,3,7,32,0,8,0,39,0
This Bernie Sanders Impression Out-Bernies The Real Bernie,1,1,9,41,1,7,0,50,0
7 Things Americans Love That Were Invented By Immigrants,1,3,8,39,0,8,1,47,0
Cardboard baby boxes could allow safe sleep for babies,1,3,1,45,0,8,0,46,0
"Why this penis is on a subway seat, making people uncomfortable",1,3,1,51,1,10,0,52,0
I Lived According To DJ Khaled's Incredible Snapchat For A Day,1,1,12,39,1,10,0,51,0
8 of the Most Popular Instavideos of 2016 [Video],1,3,4,30,2,8,5,34,0
17 Things You Can't Get Away With If You're Not An Only Child,1,3,12,33,2,12,2,45,0
Models Were 69-Ing During A Fashion Show And It Was Really Something,1,1,12,42,1,11,2,54,0
News Revealed: The world’s most – and least – punctual airlines,1,3,3,46,4,10,0,49,0
BuzzFeed Crossword: Don't Get Emotional,1,1,6,27,2,4,0,33,0
"Average British woman spends £70,000 on her appearance in a lifetime, research finds",1,3,2,62,3,12,5,64,0
Pak's Passport Officer Thinks There Are 31 Days In Feb & Internet Is Having Fun At His Expense!,1,3,16,57,3,17,2,73,0
"Eddie Redmayne Said Filming ""Fantastic Beasts"" Was The Most Wonderful Experience",1,1,11,57,2,10,0,68,0
"We Know Which ""Pitch Perfect"" Character You Are Based On Your Zodiac",1,1,12,43,2,11,0,55,0
People Are Tweeting Hilarious Made-Up Muslim Facts With #1in5Muslims,1,1,10,46,2,8,2,56,0
29 Old School Black Actors Who Were Absolute Stunners,1,3,8,35,0,8,2,43,0
Campaign Asks Women to Grow Body Hair for Antiviolence Awareness,1,2,8,47,0,9,0,55,0
Man Dies After Being Sucked Into Plane Engine At Mumbai Airport,1,1,11,42,0,10,0,53,0
"Ned Ryun: Trump Knows Media Will Hate Him Anyway, ‘So Why Not Go Big?’",1,3,14,38,5,13,0,52,0
Is This Cover Art From A Kanye West Or Coldplay Album,1,1,11,32,0,10,0,43,0
"22 Pieces Of Winter Fashion Advice, As Told By Cats",1,1,9,30,1,9,2,39,0
People Try Balut For The First Time,1,1,7,22,0,6,0,29,0
Here's What It's Actually Like To Be With The Victoria's Secret Angels IRL,1,1,15,44,3,12,0,59,0
5 Things For New Investors To Know Before Investing In Marijuana Stocks,1,3,11,48,0,11,1,59,0
The Internet Has Decided That Jeremy Corbyn Is A Massive Lad,1,1,11,39,0,10,0,50,0
27 Times There Was A Glitch In The Matrix,1,1,8,23,0,8,2,31,0
30 Powerful Pictures That Defined American History,1,3,6,36,0,6,2,42,0
How Vine Stars Are Thriving Even After The Platforms Death,1,3,10,39,0,9,0,49,0
What surprises foreigners about the US - Business Insider,1,2,5,43,1,8,0,48,0
9 Times Michael Scott Knew Exactly How You Feel About Adulthood,1,1,10,42,0,10,1,52,0
National Photographic Portrait Prize finalists share the stories behind the pictures,1,2,4,70,0,10,0,74,0
Make This Delicious Dessert With Apples And Ice Cream And Create Instant Happiness,1,1,13,57,0,12,0,70,0
"12 Signs You're Actually Buddy From ""Elf""",1,1,6,24,3,6,2,30,0
Donald Trump Floats Boeing Proposal to Counter Lockheed Martin’s F-35,1,3,9,47,2,9,2,56,0
The Biggest Money Mistakes We Make—Decade by Decade,1,3,8,35,1,7,0,43,0
Holocaust remembrance on Yom HaShoa a journey of dealing with intergenerational trauma,1,3,4,71,0,11,0,75,0
GOP’s hunt for new Trump donors drove millions to low-profile firm,1,2,4,50,2,10,0,54,0
"9 Christmas ""Would You Rather"" Questions That Are Impossible To Answer",1,1,10,47,2,10,1,57,0
Alibaba's Jack Ma Donates $20 Million To Fund A Scholarship Program As A Mark Of Friendship,1,3,15,57,2,15,2,72,0
Donald Trump's 10 weirdest ever facial expressions The list,1,3,3,45,1,8,2,48,0
23 Times Halloween Satisfied All Your Baby-Craving Needs,1,1,8,38,1,7,2,46,0
"Uber blocks employees at work from chatting on a popular anonymous app, the app's developer says",1,2,1,78,2,15,0,79,0
33 Sneakers That Will Make You Want To Throw Out Your Heels,1,1,11,35,0,11,2,46,0
This food recycler will turn your food scraps into fertilizer,1,2,1,51,0,9,0,52,0
"Mother, daughter die in grisly Czech sauna accident",1,3,2,41,1,7,0,43,0
There Are So Many More Penis Emojis Now,1,1,8,24,0,7,0,32,0
Stares and stripes: Can you tell how many zebras are in this photograph? You'll need to look very closely...,1,3,3,81,6,18,0,84,0
20 Pictures That Will Make Absolutely No Sense If You've Never Been To A Target,1,1,14,48,1,14,2,62,0
New York Times Authority on ‘Fake News’: Aide to Disgraced Financier Jon Corzine,1,3,11,54,3,12,0,65,0
Got money problems? The frugal movement might be for you,1,3,2,44,1,9,0,46,0
Can You Navigate A Day With Depression,1,1,7,25,0,6,0,32,0
The 24 Best Television Moments Of 2015,1,1,5,21,0,6,6,26,0
Winning Powerball Ticket Worth $435 Million Sold In Indiana,1,3,8,39,1,8,3,47,0
18 Easy And Decadent Desserts For People Obsessed With Chocolate,1,1,9,44,0,9,2,53,0
Find Your Style With BuzzFeed's Health & Beauty Newsletter,1,1,9,39,2,8,0,48,0
What Misconceptions About Antidepressants Are You Sick Of Hearing,1,1,9,48,0,8,0,57,0
"Under Rex Tillerson, Exxon Mobil Forged Its Own Path Abroad ",1,3,10,39,1,10,0,49,0
19 Things You'll Understand If You're Slightly Obsessed With Masturbating,1,1,9,51,2,9,2,60,0
Man Dies When Car Plunges from New Orleans Parking Garage,1,2,9,39,0,9,0,48,0
Will This Kill You,1,1,4,11,0,3,0,15,0
"New laws changing Britain in 2016 and 2017, from smoking and motoring to employment",1,3,2,59,1,13,8,61,0
Denzel Washington on fake news and information overload,1,3,2,46,0,7,0,48,0
Brandon Spikes released by New England Patriots,1,2,5,36,0,6,0,41,0
23 Things That Were Ridiculously Valuable At School But Are Worthless Now,1,1,11,49,0,11,2,60,0
Families take the lead in MH370 mystery,1,3,3,27,0,6,3,30,0
Henry Cavill announces role in 'Mission: Impossible 6' in the cheekiest possible way,1,3,4,64,3,12,1,68,0
"Shoveling Snow Can Kill Men, Canadian Study Finds",1,3,8,33,1,7,0,41,0
Best photos of the day: a Tokyo ride and a Vatican portrait,1,2,3,44,1,11,0,47,0
How Do You Get Rid Of Those Annoying Gray Hairs,1,1,10,28,0,9,0,38,0
"Roommates Played Very Honest Game Of ""Truth Or Drink""",1,1,9,34,2,8,0,43,0
How Do You Deal With Anxiety In College,1,1,8,24,0,7,0,32,0
Nepal transgender model dazzles India,1,2,2,31,0,4,0,33,0
21 Of The Most Difficult Choices You'll Make In 2015,1,1,8,28,1,9,6,36,0
What's The Worst White Elephant Gift You've Ever Ended Up With,1,1,11,39,2,10,0,50,0
HuffPo Removes Article on Banning White Men from Voting After Discovering Author Doesn’t Exist,1,3,13,67,1,13,0,80,0
22 Medieval Satans Who Are Just Having A Really Bad Day,1,1,10,33,0,10,2,43,0
Why don't Japanese drivers buy US cars?,1,2,4,27,2,6,0,31,0
"Matthew Lewis Plays A Hilarious Game Of ""Would You Rather""",1,1,10,37,2,9,0,47,0
Mike Barnicle: ‘This President Has Been Scandal-Free’,1,3,8,35,4,6,0,43,0
16 Faces Anyone Who's Painfully Single Will Recognize Immediately,1,1,8,46,1,8,2,54,0
"Illegal Immigration Fell 67 Percent under Trump, Says Fmr. Border Chief",1,2,9,48,2,10,2,57,0
A Universe of Bubbles in Every Champagne Bottle ,1,2,6,34,0,8,0,40,0
24 Realities Of Your Halloween,1,1,4,20,0,4,2,24,0
Green v Mundine: How two blokes outsmarted Foxtel and why it should get on board,1,3,4,61,1,14,0,65,0
"21 Times ""Catastrophe"" Perfectly Summed Up Life In Your Thirties",1,1,9,42,2,9,2,51,0
"How Well Do You Really Know The Lyrics To ""Beauty School Dropout"" From ""Grease""",1,1,14,48,4,13,0,62,0
"Film-maker ‘Punched, Kicked, Choked’ in Migrant No-Go Zone",1,3,8,37,6,7,0,45,0
"Team MMA Is the Weirdest Thing You'll See—No Seriously, Check It Out",1,3,14,40,3,11,0,54,0
18 Times Kelly Kapoor Perfectly Captured The Struggle That Is Life,1,1,10,44,0,10,2,54,0
Jimmy Fallon's Puppies Predicted The Broncos Will Win The Super Bowl,1,1,11,46,1,10,0,57,0
Here's the difference between a psychopath and a sociopath,1,3,1,48,1,8,0,49,0
"On eve of Royal Ascot, racing world’s attention turns to new doping fear",1,3,3,55,2,12,0,58,0
Show Us The Best Handmade Gifts Your Kids Have Given You,1,1,11,35,0,10,0,46,0
Morgan Freeman Is Really Old And Other Fun Facts,1,1,9,31,0,8,0,40,0
17 Words That Mean Something Completely Different To Long-Distance BFFs,1,1,12,47,1,9,2,59,0
Movies I Loved Before My Feminism Made Me Love Them Less,1,1,11,35,0,10,0,46,0
This Man Is All Of Us When We Really Gotta Pee On The Plane,1,1,14,32,0,13,0,46,0
When Your Friend Is A Coffee Snob,1,1,7,20,0,6,0,27,0
The shameful reason many grandparents are lonely? They're scared to tell their selfish children how they feel,1,3,2,89,2,16,0,91,0
The man who has President Trump's ear,1,3,3,27,1,6,0,30,0
Ruby Rose And Justin Bieber Wore Matching Outfits At The MTV EMAs,1,1,16,38,0,11,0,54,0
15 TV Shows And Movies That Came Back From The Dead In 2015,1,1,12,29,0,12,6,41,0
Is skipping breakfast bad for us? New study finds links with heart disease and obesity,1,3,2,69,1,14,0,71,0
19 Things People Living With Depression Want You To Know,1,1,9,36,0,9,2,45,0
17 Sticky And Sweet Strawberry Treats That'll Make Your Mouth Water,1,1,10,44,1,10,2,54,0
19 Clever Appetizers Guaranteed To Impress Your Party Guests,1,1,8,42,0,8,2,50,0
"Here‘s How to Lose Weight in Just 2 Weeks, Says Fitness Blogger",1,3,9,40,2,11,1,49,0
19 Times Pop Culture Was Embarrassingly Offensive In 2015,1,1,7,36,0,8,6,43,0
I Confronted The Most Humiliating Thing In My Teen Diary,1,1,10,37,0,9,0,47,0
"The ""Rocky Horror Picture Show"" Cast Reunited And It Feels So Good",1,1,12,41,2,11,0,53,0
17 Real-Life Milestones For Socially Awkward People,1,1,7,35,1,6,2,42,0
"Biden: ‘My Party Did Not Talk About’ Maintaining Middle Class, ‘Angry White Men’ Who Voted for Trump Aren’t Racist",1,3,18,71,7,18,0,89,0
Obama Administration Allows Anti-Israel UN Resolution Against Settlements to Pass,1,3,11,60,1,9,0,71,0
The Casey Anthony trial is dissected again in a new documentary this weekend. But why?,1,3,4,66,2,14,0,70,0
Mom surrounded by alcohol cannot believe this Christmas puzzle miracle,1,3,2,59,0,9,0,61,0
How Do You Get Freaky Sharp Concentration,1,1,7,28,0,6,0,35,0
"The Catalina Wine Mixer From ""Step Brothers"" Is Actually Happening",1,1,10,45,2,9,0,55,0
Which Top 2015 Song Are You Based On Your Zodiac Sign,1,1,10,29,0,10,4,39,0
"Adam Driver Is Bringing Emo Kylo Ren Vibes To ""SNL""",1,1,12,28,2,9,0,40,0
"These Eight Men Own More Money Than 3.7 Billion People, That's Half Of The World Put Together",1,2,16,56,3,16,2,72,0
19 Reasons British Fast Food Is Way Better Than American Fast Food,1,1,11,42,0,11,2,53,0
15 Obnoxious Texts Your Glasses Would Send You,1,1,7,30,0,7,2,37,0
The Atlantic VP: ‘Democratization’ of News via the Internet Left People ‘Overwhelmed with Information’,1,2,11,73,5,13,0,84,0
The Definitive Ranking Of The Best '90s Comedies,1,3,7,31,1,7,2,38,0
Twitter direct message 140 character limit being lifted in July,1,2,2,49,0,9,3,51,0
What's My Tax Bracket?,1,3,4,13,2,3,0,17,0
Which Rihanna Album Are You Actually,1,1,6,25,0,5,0,31,0
"North Carolina, Berlin, Delta: Your Thursday Briefing ",1,2,7,37,3,7,0,44,0
"First ""Allegiant"" Trailer Still Has Tris And Four Making Out A Lot",1,1,12,41,2,11,0,53,0
John Clarke dies: Your favourite Clarke and Dawe sketches,1,3,5,43,1,8,0,48,0
Zimbabwe is paying people $5 for 175 quadrillion Zimbabwe dollars,1,3,2,49,1,9,4,51,0
"I Was A Weatherman For A Day, And This Is What I Learned",1,1,13,30,1,12,0,43,0
17 Photos That Offer A Rare Look At North Korea's Interiors,1,1,10,36,1,10,2,46,0
Best and riskiest moves for every team's 2017 NFL draft class,1,3,4,42,1,10,4,46,0
"Fed Up With Boring Humans, A Town Is Trying To Elect This Cat As Mayor",1,1,15,40,1,14,0,55,0
"Having Diarrhea, As Told By Donald Trump",1,1,7,26,1,6,0,33,0
17 Things Everyone With Strong Eyebrows Knows To Be True,1,1,9,36,0,9,2,45,0
21 Dogs With Books Who Are Too Cute For Words,1,1,9,25,0,9,2,34,0
You Haven't Lived Until You've Tried Champurrado,1,1,7,33,2,6,0,40,0
"Fuck, Marry, Kill: Same Actor, Different Characters",1,1,7,34,4,6,0,41,0
"KASSAM at CPAC Slams Establishment Media: ‘I’ve Been to Sweden, You Guys Just Don’t Get it!’",1,3,21,49,7,15,0,70,0
"New year, old debt? How to cut those credit balances and get ahead of higher rates",1,3,2,63,2,15,0,65,0
Do You Belong With Harry Styles Or Zayn Malik,1,1,9,28,0,8,0,37,0
Is This A Real Lipstick Shade Or Am I Messing With You,1,1,12,31,0,11,0,43,0
21 Products For People Who Are Completely Obsessed With Poodles,1,1,9,43,0,9,2,52,0
This Easy Hack Lets You Play Music On YouTube WHILE Using Other Apps On Your iPhone,1,1,21,47,0,15,0,68,0
Which '90s Nickelodeon Character Should Be Your BFF,1,1,9,32,1,7,2,41,0
"Which Of Scully From ""X-Files"" Outfits Are You Based On Your Star Sign",1,1,14,41,3,12,0,55,0
"Would You Be A Hero Or Villain In ""Once Upon A Time""",1,1,12,27,2,11,0,39,0
33 First Times Every Woman Has Experienced,1,3,6,28,0,6,2,34,0
17 Times The Mom On Clarissa Was A Goddamn Style Icon,1,1,10,31,0,10,2,41,0
Best Returns Since 1900 Came From These Markets: Chart,1,3,8,33,1,8,4,41,0
"SRK Meets MNS Chief Raj Thackeray, Aamir Khan Sheds His Serious Image & More From Ent",1,3,19,49,2,15,0,68,0
Christmas Vs. Jewish Christmas: Which Will Win,1,1,7,31,2,6,0,38,0
Do People Look Like Their Names?,1,3,6,20,1,5,0,26,0
Celebs Try To Guess Other Celebs By Their Butt,1,1,9,29,0,8,0,38,0
Initial jobless claims unexpectedly fall,1,2,1,35,0,4,0,36,0
How Much Of A Whovian Are You,1,1,7,16,0,6,0,23,0
21 Realistic Plans We've Got For The Winter,1,1,7,26,1,7,2,33,0
"Udaipur Boy Kalpit Veerval Tops IIT Entrance Rankings, Scores 100% In JEE Mains",1,3,16,46,2,12,3,62,0
Technology could redefine the doctor-patient relationship,1,3,1,50,1,5,0,51,0
"27 Parents' Reactions To ""Netflix And Chill""",1,1,6,27,3,6,2,33,0
"For Anyone Who Watched ""Master Of None"" Just For Denise",1,1,10,34,2,9,0,44,0
"Do You Know The Lyrics To ""Hotline Bling"" By Drake",1,1,10,29,2,9,0,39,0
"Here's what it's like to interview for the CIA, from people who have done it",1,3,4,55,3,14,0,59,0
Our TV Pet Peeves: 10 Things That Really Make Us Nuts,1,3,11,29,1,10,2,40,0
Can You Guess The Rihanna Music Video By Its YouTube Comment,1,1,12,38,0,10,0,50,0
22 Things People Who Are Bad At Expressing Their Feelings Know To Be True,1,1,13,45,0,13,2,58,0
How Erdoğan’s ruthless drive for more power is shaking a divided Europe,1,2,3,56,1,11,0,59,0
A Roman Sarcophagus Is Rescued from Humble Duty as a Flower Pot ,1,3,9,43,0,12,0,52,0
"Mary Berry Delivered One Of The Best Sexual Innuendos On ""Bake Off"" So Far",1,1,14,45,2,13,0,59,0
Tesla just began rolling out its new and improved Autopilot â here's what you need to know,1,2,2,71,3,16,0,73,0
"Donald Trump Wants A Muslim ""Watch List"" So We Made One For Him",1,1,13,36,2,12,0,49,0
‘Game of Thrones’ reveals its Season 7 summer release date,1,3,3,43,2,9,1,46,0
17 Pictures You'll Only Appreciate If You're Ready For Christmas,1,1,9,42,2,9,2,51,0
Sword-Wielding Man Dressed as The Joker Was Arrested in Virginia,1,2,9,45,1,9,0,54,0
"Sanders to Trump: Promise the American People You Will Not Cut Social Security, Medicare or Medicaid",1,3,13,70,2,15,0,83,0
Jerry Brown: ‘We’re Not Going to Bring Stupid Lawsuits’ Against Trump Wall,1,3,11,48,4,11,0,59,0
Why Australia's AAA credit rating is doomed,1,2,5,31,1,6,0,36,0
The 43 Best Drunken Eats In College Towns Across America,1,1,9,36,0,9,2,45,0
What's Your Weird Phobia,1,1,4,16,1,3,0,20,0
How Romance's Hottest Writing Duo Turned Fanfic Into A Career,1,1,10,41,1,9,0,51,0
13 Young Creatives From London To Look Out For In 2016,1,1,9,29,0,10,6,38,0
Amy Schumer Held A Cup In New York And It Was Great,1,1,12,28,0,11,0,40,0
What Should Your Signature British Insult Be,1,1,7,31,0,6,0,38,0
How Are You Feeling Right Now,1,1,6,18,0,5,0,24,0
17 Things You Should Know Before Trying To Get A Bigger Butt,1,1,11,36,0,11,2,47,0
Pricey New Drug Promises Eczema Relief,1,3,6,27,0,5,0,33,0
What's The Funniest Yik Yak Post You've Seen This Year,1,1,10,33,2,9,0,43,0
This Was What The World Looked Like 30 Years Ago,1,1,9,28,0,9,2,37,0
President Obama cites triumphs of his administration in final speech,1,3,2,57,0,9,0,59,0
"18 Gorgeous Santas That'll Make You Wanna Say ""Ho, Ho, Ho""",1,1,10,31,5,10,2,41,0
How Many Of These '90s Toys Were On Your Christmas List,1,1,10,32,1,10,2,42,0
How To Cash In On The $1 Billion Gift Card Aftermarket,1,3,10,32,1,10,1,42,0
Newborn Abducted From Hospital Bed Set To Reunite With Her Family After 18 Years!,1,2,13,52,1,13,2,65,0
43 Things That Mildly Irritate Everyone Who Goes To The Gym,1,1,10,37,0,10,2,47,0
19 Christmas Shibas Who Are So Ready For The Holidays,1,1,9,33,0,9,2,42,0
This Color Test Will Determine Your Secret Sexual Desire,1,1,9,39,0,8,0,48,0
Celebrate World Gin Day with these easy cocktails,1,3,4,38,0,7,0,42,0
Who's The Next Canadian Power Couple,1,1,6,24,1,5,0,30,0
We Tried Edible Body Paint And It Was Grosser Than You Ever Imagined,1,1,13,43,0,12,0,56,0
Are You More Serena Van Der Woodsen Or Hannah Horvath,1,1,10,34,0,9,0,44,0
Brilliant Italian Dishes You Haven't Tried Before,1,2,7,35,1,6,0,42,0
21 Reasons You Should Date A Canadian,1,1,6,23,0,6,2,29,0
12 Special Educators Told Us Why They Teach Children With Special Needs,1,1,11,47,0,11,2,58,0
We're One Step Closer To Finding The Holy Grail Of Exoplanets,1,3,11,39,1,10,0,50,0
Prepping for Paris: Watch as Boeing's Dreamliner puts on amazing show ,1,3,5,52,2,11,0,57,0
Are You A Real Human Being Or A Department Store Mannequin Come To Life,1,1,14,44,0,13,0,58,0
Here Are All The Winners At The 2016 Golden Globes,1,1,9,28,0,9,4,37,0
Texas Woman Sentenced to 8 Years in Prison for Illegal Voting,1,3,7,43,0,10,1,50,0
How to participate in the Women's Strike if you can't skip work,1,2,3,47,2,11,0,50,0
18 Brutally Honest Confessions From A Club Promoter,1,1,7,35,0,7,2,42,0
What Is The Smartest Ingredient Swap You Use In The Kitchen,1,1,11,38,0,10,0,49,0
Trump truck: What the US President was doing while his health care bill was pulled from Congress floor,1,3,6,78,1,17,0,84,0
How Pope Francis is about to reshape the climate discussion,1,2,3,47,0,9,0,50,0
17 Videos That Prove Kids Are Basically Just Drunk Adults,1,1,9,37,0,9,2,46,0
17 You Know If You And Your Partner Are Basically The Same Person,1,1,12,39,0,12,2,51,0
18 Confessions From People Waiting Until Marriage To Have Sex,1,1,9,41,0,9,2,50,0
Forget Kobe Beef: These Are the Cult Steaks Everybody Wants Right Now,1,3,11,46,1,11,0,57,0
5 People Reveal What Happens Behind The Perfect Instagram,1,1,8,40,0,8,1,48,0
"17 Times The ""This Is Thirty"" Hashtag Pretty Much Nailed It",1,1,10,35,2,10,2,45,0
"From Star Wars To Shopkins, These Are The Hottest Toys Of The Holiday Season",1,3,14,48,1,13,0,62,0
A champion of 'unofficial countryside',1,3,1,31,2,4,0,32,0
16 Wikipedia Pages That Will Change The Way You See The Universe,1,1,11,40,0,11,2,51,0
What Happens When A French Guy Has To Guess Between French And American Wine And Cheese,1,1,16,56,0,15,0,72,0
"'Genuine leaders are in short supply', Joe Biden tells Justin Trudeau in Canada",1,3,6,58,3,12,0,64,0
Amanda Seyfried's Dog Is Actually Regina George,1,1,7,33,1,6,0,40,0
21 Drunk Conversations Every Girl Has Had At Least Once,1,1,9,35,0,9,2,44,0
How Peace Between Afghanistan and the Taliban Foundered ,1,3,6,42,0,8,0,48,0
How Washington state became the epicenter of resistance to Trump’s agenda,1,3,3,59,1,10,0,62,0
Can You Find The Taylor Swift Songs Hidden In This Crossword,1,1,11,39,0,10,0,50,0
The 10 Commandments of the Tuxedo,1,2,3,23,0,5,2,26,0
Your New Favorite Song Has Been Chosen By An Algorithm,1,3,10,35,0,9,0,45,0
Make Cinnamon Donut Holes At Home Like A Pro,1,1,9,27,0,8,0,36,0
Some of the biggest names in the hedge fund industry are planning to invest in a hot new fund,1,3,1,74,0,18,0,75,0
How Coachella Gained Lady Gaga After Losing Beyonce,1,3,8,36,0,7,0,44,0
"Adam Saleh: YouTube star 'wasn't speaking Arabic on phone when kicked off Delta flight', passenger claims",1,3,6,79,5,15,0,85,0
"Who divorced, who married and who took a gay lover? Love Actually: what happened next, according to fan fiction",1,2,3,86,4,18,0,89,0
"No Drama, But Selena Gomez Is The Pop Princess We Need And Deserve",1,1,13,40,1,12,0,53,0
7 People Influencing Canadian Style Today,1,2,5,30,0,5,1,35,0
Is the United Airlines man being smeared in the media even the right David Dao? It shouldn't matter,1,3,6,74,2,17,0,80,0
12 Disneyland Treats You Can Only Indulge In During The Holidays,1,1,10,42,0,10,2,52,0
This Woman Voted For Trump But Now The Government Is Deporting Her Husband,1,3,13,49,0,12,0,62,0
17 Cats Who Are Obviously Planning A Murder,1,1,7,27,0,7,2,34,0
26 Students Who Killed The Homecoming Style Game,1,1,7,32,0,7,2,39,0
17 Times Pop Culture Gave A Nod To Black Colleges,1,1,9,29,0,9,2,38,0
"How Well Do You Remember Clark Griswold's Rant In ""Christmas Vacation?""",1,1,11,46,4,10,0,57,0
Charles Oakley Blasts Charles Barkley Over LeBron James Comments,1,3,10,46,0,8,0,56,0
"9 ways the new ""Beauty and the Beast"" is different from the original",1,3,2,51,2,12,1,53,0
This Is How 23 Countries Feel About Transgender Rights,1,3,8,36,0,8,2,44,0
People Got Thirsty For Novak Djokovic At The MTV EMAs,1,1,14,30,0,9,0,44,0
When The Doctor Needs To See Your Penis,1,1,8,24,0,7,0,32,0
What People Say To Someone Who Is Single Vs. What They Hear,1,1,12,35,1,11,0,47,0
The Billionaire Sports Team Owners Almanac 2017,1,3,6,31,0,6,4,37,0
The XX Factor: Inside The Fight To Reinvent Financial Advice For Women,1,2,13,45,1,11,0,58,0
33 Studio Ghibli Cakes That Are Guaranteed To Blow You Away,1,1,10,37,0,10,2,47,0
This Guy Decorated An Entire Subway Car To Propose To His Girlfriend,1,1,12,45,0,11,0,57,0
23 Things To Buy That One Weirdo Who Loves Winter,1,1,9,29,0,9,2,38,0
These BFFs Are Slaying Internet Fashion,1,1,8,26,0,5,0,34,0
A Shortcut To Hogwarts Has Been Spotted In Montreal,1,1,9,34,0,8,0,43,0
Blake Griffin Punched A Dude In The Head,1,1,8,25,0,7,0,33,0
15 Hot Ginger Men Who Will Sexually Awaken You,1,1,8,28,0,8,2,36,0
Woman sues fake news site for stealing her identity to promote its posts,1,3,1,59,0,12,0,60,0
"A timeline of Obama's best jokes, from red-hot zingers to corny puns",1,3,2,52,3,11,0,54,0
Kellyanne Conway's Glamour Shot Spotted by Eagle-Eyed Twitter Users,1,3,9,48,2,8,0,57,0
The Story Of A Woman Who Might Be Posing As Black Totally Owned The Internet,1,3,15,47,0,14,0,62,0
Migrant Stabs Christian Woman Because She Was Reading Bible,1,3,9,42,0,8,0,51,0
19 Food Trucks You Need To Visit In India,1,1,8,23,0,8,2,31,0
There's A Part Of Your Facebook Profile You Might Have Forgotten People Can See,1,1,14,51,1,13,0,65,0
This 4-year-old made an unlikely friend at the grocery store,1,2,1,47,2,9,1,48,0
Simple Bread Pudding Recipe - NYT Cooking,1,3,8,26,1,6,0,34,0
Jimmy Kimmel Burns Jared Kushner's Foreign Policy Cred In One Line,1,3,11,44,1,10,0,55,0
12 Oversized Animals From Your Childhood,1,1,5,28,0,5,2,33,0
Do You Own Your Dog Or Does Your Dog Own You,1,1,11,23,0,10,0,34,0
Indiana Kellogg’s Snacks Plant Expected to Close by September,1,3,7,45,1,8,0,52,0
India's First Transgender Band Just Released Their First Song And It Will Leave You Speechless,1,1,15,64,1,14,0,79,0
The Biggest Mystery Of Thanksgiving Has Been Solved,1,1,8,36,0,7,0,44,0
A Girl Just Shut Down Her Complicated Math Homework With This Hilarious Response,1,1,13,55,0,12,0,68,0
24 mind-blowing facts about Warren Buffett and his $70 billion fortune,1,3,2,52,2,10,4,54,0
"Jimmy Fallon Is Getting His Own Ride At Universal Based On The ""Tonight Show""",1,1,14,48,2,13,0,62,0
You didn’t know it but Trump’s America might be explained best by a poet,1,3,3,54,2,13,0,57,0
10 people afflicted by the failure of Trumpcare,1,3,1,37,0,7,2,38,0
Can You Pick The Right Guy,1,1,6,15,0,5,0,21,0
What you need to know about NATO as Trump meets with its secretary general ,1,3,6,55,0,14,0,61,0
Pew Survey: Police Support Gun Rights over Gun Control by 3 to 1 Margin,1,2,9,46,1,13,2,55,0
25 Insanely Fun Kitchen Tools You Need Immediately,1,1,7,34,0,7,2,41,0
Are You Cool Enough To Be A USA Freedom Kid At The Trump Rally,1,1,16,33,0,13,0,49,0
Texas Man and His Dog Found Dead After Becoming Trapped Inside Car,1,2,11,44,0,11,0,55,0
22 Brutally Honest Confessions From A Bra Fitter,1,1,7,32,0,7,2,39,0
"Rishi Kapoor's Tweet Gets Massively Trolled, Twinkle Khanna's 43rd Birthday & More From Ent!",1,2,12,60,5,13,2,72,0
22 Times Science Was Actually Straight-Up Magic,1,1,7,31,1,6,2,38,0
Guardians of the Galaxy 2: Which character was meant to die in the first film?,1,3,3,58,2,14,1,61,0
18 Things All Gin Drinkers Need In Their Life,1,1,8,27,0,8,2,35,0
The 15 most-wanted types of employees on LinkedIn,1,3,3,36,1,7,2,39,0
If Hogwarts Were A College,1,1,5,17,0,4,0,22,0
This Leaked Star Wars Art Might Reveal New Details From The Film,1,1,12,41,0,11,0,53,0
A Navy SEAL explains why you should end a shower with cold water,1,2,6,46,0,12,0,52,0
"Just because your kids are headed off to college, it doesn’t mean they’ll graduate",1,3,1,65,3,13,0,66,0
What Do You Wish You Knew About Penises Before You Touched One,1,1,12,39,0,11,0,51,0
27 Hotties From YA Novels Who'll Make You Thirsty AF,1,1,11,29,1,9,2,40,0
Renters Now Rule Half of U.S. Cities,1,3,7,21,2,6,0,28,0
A Line Of Studio Ghibli Clothing Just Dropped And It's Magical,1,1,11,40,1,10,0,51,0
Tell Us The Creepiest Thing A Child Has Ever Said To You,1,1,12,33,0,11,0,45,0
Koran Verse Denying Jesus Was Son of God Sung in Scottish Cathedral,1,2,10,46,0,11,0,56,0
Liam Hemsworth Is Trying To Destroy Us All With His Instagram,1,1,11,40,0,10,0,51,0
"Bryan Cranston Tried To Send DVDs Of ""Breaking Bad"" To The International Space Station",1,1,16,55,2,13,0,71,0
"27 Types Of Drunk You've Definitely Been, As Told By The Sims",1,1,11,35,2,11,2,46,0
"Who Would Be Your BFF On ""Scream Queens""",1,1,10,21,2,7,0,31,0
The insane end of the Oscars sent a false message about racial progress,1,3,2,57,0,12,0,59,0
The 11 Types Of Kids We All Grew Up With,1,1,9,20,0,9,2,29,0
22 Times Emilia Clarke's Instagram Made You Wish She Was Your BFF,1,1,13,38,1,11,2,51,0
10 Gin Cocktails With 4 Ingredients Or Fewer,1,1,6,28,0,7,3,34,0
Taylor Swift's Cat Olivia Benson  Chewed Up An Award Belonging To The Real Life Olivia Benson,1,1,16,60,1,16,0,76,0
Everything You Need to Know About the Executive Order on Sanctuary Cities ,1,3,9,53,0,12,0,62,0
This is going to be harder than Donald Trump expected,1,3,3,41,0,9,0,44,0
"Dem Sen Murphy: ‘Clinton Shouldn’t Have Lost to Donald Trump, Period,’ Russians Aren’t ‘Sympathizers’ of the GOP",1,2,16,71,9,16,0,87,0
"British woman, 22, forgoes heart, lung transplants to finish bucket list   ",1,3,1,56,3,13,2,57,0
"Inside The Most OMG Scene In ""Creed""",1,1,9,19,2,6,0,28,0
18 American Girl Books That Literally Saved Your Life Growing Up,1,1,10,42,0,10,2,52,0
Miss World is the biggest beauty pageant you’ve never heard of. What’s it doing in Washington?,1,2,4,71,4,15,0,75,0
Watch These Lesbians Give Gay Men Wardrobe Makeovers,1,1,8,37,0,7,0,45,0
17 Really Stupid Things You Should Stop Saying To Women With Natural Hair In 2016,1,1,13,48,0,14,6,61,0
21 Pictures People Not In College Will Never Understand,1,1,8,37,0,8,2,45,0
Are You Meeting Your #squadgoals,1,1,4,23,1,4,0,27,0
Man Uses Obituary To Ask People Not To Vote For Donald Trump,1,1,12,37,0,11,0,49,0
29 movies you have to see this holiday season,1,3,0,35,0,8,2,35,0
An Artist Drew Disney Men As Justin Bieber And The Outcome Is Glorious,1,1,13,45,0,12,0,58,0
19 Memes About Periods That Are Too Fucking Real,1,2,8,30,0,8,2,38,0
Women Got Transformed Into Telenovela Stars And Looked Dramatic AF,1,1,11,46,0,9,0,57,0
Watch Asif Confess What It's Like When A Breakup With Your Best Friend Becomes A Massive Meme,1,1,17,59,1,16,0,76,0
Dog Heroically Escapes From Vet And Takes Vet With Him,1,1,10,35,0,9,0,45,0
Husband Tries To Go Bra Shopping For His Wife,1,1,9,28,0,8,0,37,0
What will Trump administration push for in first 100 days?,1,2,2,43,1,9,3,45,0
We Know Your Favorite Singer Based On Your Zodiac Sign,1,1,10,35,0,9,0,45,0
How Employable Are You Actually?,1,3,5,22,1,4,0,27,0
22 Mouthwatering Things You Can Do With Cheese,1,1,7,30,0,7,2,37,0
18 Parents Who Are Tired Of Their Children's Facebook Shit,1,1,9,37,1,9,2,46,0
"2017: New year, same weird stuff in Parliament House",1,3,3,35,2,8,4,38,0
16 Reasons You Should Take A Shath Every Day,1,1,8,26,0,8,2,34,0
Trying To Keep A Plant Alive,1,1,6,17,0,5,0,23,0
Storms Have Unveiled A Shipwreck From The 1930s In California,1,1,9,39,0,9,4,48,0
WATCH: People Ignore Woman With Her Head Stuck in NYC Subway Doors  Insider,1,2,18,43,1,13,0,61,0
"13 ""Grease: Live"" Secrets I Learned While Sitting In The Audience",1,1,10,40,3,10,2,50,0
Would You Time Travel To The Past Or Future,1,1,9,26,0,8,0,35,0
"21 Completely Genius Ways To Cook Boneless, Skinless Chicken Breasts",1,1,9,47,1,9,2,56,0
38 Cheap Pairs Of Shoes That Look Like A Million Bucks,1,1,10,32,0,10,2,42,0
Trump Drops Effort to Block Texas’ Voter ID Law,1,3,9,29,1,8,0,38,0
Parents Text With Emojis For The First Time,1,1,8,28,0,7,0,36,0
27 Products For People Who Are Completely Obsessed With Books,1,1,9,41,0,9,2,50,0
"What D.C. posts on Twitter versus what everybody else posts on Twitter, visualized",1,2,5,62,3,12,0,67,0
Kit Harington Judging Jon Snow Impersonators Is Better Than Winter Finally Coming,1,3,12,58,0,11,0,70,0
Answer These Three Questions And We'll Tell You What Type Of Book You Should Read,1,1,15,51,1,14,0,66,0
This geyser erupting on a frigid day will make your winter solstice,1,2,1,55,0,11,0,56,0
"Which ""Jane The Virgin"" Character Are You Based On Your Zodiac Sign",1,1,12,42,2,11,0,54,0
18 Things All Caribbean Latinos Can Agree On,1,1,7,28,0,7,2,35,0
High street shops secretly track customers using smartphones ,1,2,1,52,0,8,0,53,0
Can We Ban Shitty Stock Photos Of People Playing Video Games,1,1,11,39,0,10,0,50,0
Can You Identify A Pop Hit Music Video By A Single Screen Shot,1,1,13,37,0,12,0,50,0
Here's why you should never deep-fry a frozen turkey,1,3,1,41,2,8,0,42,0
Are we heading toward another subprime mortgage crisis?,1,3,1,46,1,7,0,47,0
16 Times Ralph Wiggum Perfectly Embodied The Dating Struggle,1,1,8,42,0,8,2,50,0
How to achieve the 'Oscars look',1,3,2,23,2,5,0,25,0
Jesus May Not Have Walked Jerusalem’s Via Dolorosa: Scholars,1,3,9,41,2,8,0,50,0
"So That Disgustingly Real, Viral ""Scrotum Backpack"" Is Officially Going On Sale",1,1,12,53,3,11,0,65,0
NCAA Bracketology 2017: Real-Time Seed and Region Projections for All 68 Teams,1,2,12,47,2,11,6,59,0
27 Moms Who Are Trolls At Heart,1,1,6,17,0,6,2,23,0
Third grader has no time for your silly homework nonsense,1,3,1,47,0,9,0,48,0
"Uh, Spiders Could Eat All Of Us In A Year, Just In Case You Were Wondering",1,3,16,41,2,15,0,57,0
19 Secrets Television Runners Will Never Tell You,1,1,7,33,0,7,2,40,0
A collection of rare photos features men of the late 1800s in surprisingly intimate embraces,1,3,1,73,0,14,4,74,0
"The Trans-Themed Episode Of ""How To Get Away With Murder"" Was Actually Really Great",1,1,15,52,3,13,0,67,0
What Should Your Resolution Be For 2016,1,1,6,23,0,6,4,29,0
Chelsea Handler blames Trump's presidency on the Kardashians,1,2,4,48,1,7,0,52,0
"Bill O’Reilly accuser reveals identity, feels ‘triumphant’ he won't return to Fox News ",1,3,5,64,5,13,0,69,0
These Are the Best Luxury-Car Instagram Feeds to Follow in 2017,1,3,8,40,1,10,4,48,0
2 startups are combining to fix a problem with Wall Street stock research,1,3,2,58,0,12,1,60,0
For Anyone Who Considers Themselves A Monster Of Lady Gaga's,1,1,10,40,1,9,0,50,0
I had two children 15 years apart,1,3,1,24,0,6,2,25,0
Tom Hardy Explained Why He Shut Down That Reporter Who Asked About His Sexuality,1,1,14,53,0,13,0,67,0
"Prince Charles Urges Brits To Think Of Muhammad This Christmas, Speaks Out Against ‘Aggressive Populism’",1,3,15,72,3,14,0,87,0
This Overprotective Dad Made Good On His Warning To His Daughter's Homecoming Date,1,1,13,56,1,12,0,69,0
"Here's What Happened When I Tried Five ""Easy"" And ""Cheap"" Office DIYs",1,1,14,39,5,11,0,53,0
21 Gifts To Give Yourself When Adulting Is Too Hard,1,1,9,31,0,9,2,40,0
This Photographer Tied A Model Up In Shark-Infested Waters And It Was More Beautiful Than Scary,1,1,17,62,1,15,0,79,0
Instagram Is Launching a Redesigned Website with Bigger Photos,1,2,7,47,0,8,0,54,0
19 Texts That Are Way Too Real For Anyone Who's A Little Bit Greedy,1,1,13,38,1,13,2,51,0
17 Jokes Guaranteed To Make Arsenal Fans Laugh,1,1,7,30,0,7,2,37,0
Here's Proof That Brining Your Turkey Is Stupid And Wrong,1,1,10,37,1,9,0,47,0
Report: Former Jeb Bush Staffer Considered for Top Education Post,1,2,9,46,1,9,0,55,0
This song naming all 270 London underground stations is pretty epic,1,3,2,52,0,10,3,54,0
What Are You Tired Of Hearing At Thanksgiving,1,1,8,30,0,7,0,38,0
Trump's big EPA website change should make you furious,1,2,4,41,1,8,0,45,0
"BAMN Organizer Yvette Felarca: ‘Fascist’ MILO Is Starting ‘Movement of Genocide,’ Must be Stopped",1,3,18,60,6,13,0,78,0
"Ivanka Trump: Opening Border to Syrian Refugees ‘Has To Be Part of the Discussion,’ Won’t Be Enough By Itself",1,2,16,70,5,18,0,86,0
14 Scrumptious Fall Recipes That Use Exactly One Can Of Pumpkin,1,1,10,41,0,10,2,51,0
Who Is Your Christmas Movie Nemesis,1,1,6,24,0,5,0,30,0
How Cameroon's Indomitable Lions roared again,1,3,4,35,1,5,0,39,0
19 Ways To Stay Gluten-Free This Holiday Season,1,1,8,29,1,7,2,37,0
Man Surrenders to Face Charges in J.P. Morgan Cyberattack,1,2,8,39,2,8,0,47,0
21 Things You'll Just Get If You Only Wear Black,1,1,9,27,1,9,2,36,0
This designer clothing line is stylish ... and bulletproof,1,2,1,46,3,8,0,47,0
How George Michael’s Wham! baffled Communist China and inspired its youth,1,2,6,55,2,10,0,61,0
19 Hilarious Tweets About Kids That Will Make You Laugh Out Loud,1,1,11,40,0,11,2,51,0
Celebs Ate Just As Much As You On Thanksgiving,1,1,9,29,0,8,0,38,0
What happens if you don't file your tax return?,1,2,1,36,2,8,0,37,0
Rose McGowan Defends Comments Criticizing Caitlyn Jenner's Understanding of Womanhood,1,1,10,65,1,9,0,75,0
If Presidential Candidates Were Reimagined As Valentine's Day Cards,1,1,9,49,1,8,0,58,0
From The Great Escape to Sholay: what makes a film a national favourite?,1,3,5,53,2,12,0,58,0
The Easiest Horcrux Quiz You'll Ever Take,1,1,7,27,1,6,0,34,0
15 Things You Shouldn't Say To Bostonians,1,1,6,26,1,6,2,32,0
She was on course for stardom. Then she entrusted her career to USA Swimming,1,3,6,56,1,13,0,62,0
17 Times Chris Pratt And Anna Faris Were The Funniest Parents On Twitter,1,3,12,46,0,12,2,58,0
17 Photos Women With Small Feet Can Relate To,1,1,8,27,0,8,2,35,0
How A 28-Year-Old Got Fired Then Built A $500K-A-Month Business While Traveling The World,1,3,17,49,5,13,5,66,0
22 Pictures That Are Way Too Real For Risk Players,1,1,9,30,0,9,2,39,0
"13 Things to Know About the Charts This Week: Ed Sheeran Is No. 1 on Artist 100, Hot 100 & Billboard 200",1,3,13,54,4,21,12,67,0
Carrie Brownstein And Amy Poehler Just Spontaneously Helped A Couple Get Married,1,1,12,57,0,11,0,69,0
"Two Women Get Into Wild Brawl In Walmart Shampoo Aisle, Child Joins In",1,2,13,44,1,12,0,57,0
Supreme Court nominee Neil Gorsuch was just tripped up by a horse-sized duck,1,2,4,59,1,12,0,63,0
How To Stretch $20,1,1,3,9,1,3,2,12,0
26 Times P.K. Subban Scored A Hat Trick On Your Heart,1,1,11,28,2,10,2,39,0
"What Does It Mean To ""Hook Up"" With Someone",1,1,9,24,2,8,0,33,0
Animated map reveals the most popular pizza chains in every state,1,2,1,54,0,10,0,55,0
22 Photos That Show Just How Insane '90s Rave Culture Really Was,1,1,10,38,1,11,4,48,0
Cut-back crew for ISS launch,1,2,4,19,1,4,0,23,0
What Does Your Name Say About Your Personality,1,1,8,31,0,7,0,39,0
This '13 Reasons Why' Actor Became A Meme For Being Too Grown And Sexy,1,2,13,40,2,13,2,53,0
How Many U.S. State Capitals Do You Know,1,1,9,22,2,7,0,31,0
Critics Say Trump Appointees Can Dodge a Huge Tax Bill. That’s Not the Case. ,1,3,12,48,3,14,0,60,0
Jeff Immelt on Dealing With Trump and Globalization,1,2,6,38,0,7,0,44,0
The Dark Side Of Medical Marijuana's Miracle Drug,1,1,8,33,1,7,0,41,0
18 Hilarious Memes About Tamales That Are Way Too Real,1,1,9,34,0,9,2,43,0
This Is How Dwayne Johnson Spent His Valentine's Day,1,1,9,34,1,8,0,43,0
Does Anyone Know What Dreamforce Actually Is,1,1,7,31,0,6,0,38,0
Newsweek: Donald Trump Channels Steve Bannon in Inaugural Address,1,2,8,48,1,8,0,56,0
Which Pop Princess Are You Based On Your Birth Month,1,1,10,33,0,9,0,43,0
24 Low-Carb Spaghetti Squash Recipes That Are Actually Delicious,1,1,9,44,1,8,2,53,0
I Went To Sephora And Asked Them To Make Me Look Like Kylie Jenner,1,1,14,39,0,13,0,53,0
QUIZ: Do you know why these brands chose their famous colors?,1,3,5,44,2,10,0,49,0
Vivica A. Fox Appears To Suggest That 50 Cent May Be Gay,1,1,11,31,1,11,2,42,0
Speaker Ryan’s Last-Minute Changes Mean GOP Must Pass RyanCare to Know What’s in It,1,3,16,51,3,13,0,67,0
Let's Find Out How Floridian You Really Are,1,1,8,27,1,7,0,35,0
17 Surprisingly Good Places To Find Cute Clothes For Work,1,1,9,37,0,9,2,46,0
9 tricks for remembering everything you read,1,3,0,37,0,6,1,37,0
29 Tweets About Being A Lesbian That Will Make You Laugh Every Time,1,1,12,41,0,12,2,53,0
'Bambi' rescued from frozen lake,1,2,1,25,2,4,0,26,0
13 Swoonworthy TV Wedding Vows That You Will Want To Steal For Your Big Day,1,1,15,44,0,14,2,59,0
33 Slightly Unexpected But Awesome Things You Should Be Thankful For,1,1,10,46,0,10,2,56,0
"A Designer Store Told A Woman To ""Go To The Gym"" When She Asked For A Ghagra In Her Size",1,1,20,47,2,19,0,67,0
16 Men Who Dominated Makeup In 2016,1,3,5,18,0,6,6,23,0
Tropical cyclones explained,1,3,1,24,0,2,0,25,0
Catcher elbows runners trying to score - ESPN Video,1,2,6,36,1,8,0,42,0
31 Hilarious Tweets About Eating Healthy That Will Get You Every Time,1,1,11,45,0,11,2,56,0
This Freestyle Crossword Is For Everyone Who Loves Pop Culture,1,1,10,43,0,9,0,53,0
This Dog Is Not Ready To Share His Humans With A Gross Baby,1,1,13,34,0,12,0,47,0
L.A. Olympics CEO: Trump More Helpful than Obama,1,3,10,28,3,7,0,38,0
Guys Transform Into Pinups,1,1,4,19,0,3,0,23,0
The Best Places To Retire Without A Car,1,3,8,24,0,7,0,32,0
Does Black Ever Crack? -- Guess These Black Celebs Ages,1,1,9,34,3,9,0,43,0
3 Dips You Need To Make For Game Day,1,1,8,19,0,8,1,27,0
The best high-paying job in every state in 2017,1,3,1,33,1,8,4,34,0
What Type Of Donut Are You Based On Your Birth Month,1,1,11,31,0,10,0,42,0
This Is What It's Like To Live With Schizophrenia,1,1,9,31,1,8,0,40,0
A Case For Sleeping In,1,1,5,13,0,4,0,18,0
A key way millennial homeowners differ from other generations,1,3,1,52,0,8,0,53,0
Which Female Disney Character Are You,1,1,6,26,0,5,0,32,0
"Whole Foods Wanted to Be More Than a Supermarket, and Therein Lies the Problem ",1,3,10,54,1,14,0,64,0
Slacktivist thank you: 'SNL' has a song for people who tweet from the toilet,1,3,4,56,3,13,0,60,0
People Are Trolling Sean Spicer on Venmo With Hilarious Requests,1,2,9,46,0,9,0,55,0
50 Things No One Tells You About Becoming A Parent,1,3,9,30,0,9,2,39,0
The Electoral College Meets Monday. Here’s What to Expect. ,1,3,8,39,3,9,0,47,0
Chris Hemsworth Looks Completely Unrecognisable After Dramatic Weight Loss For Movie Role,1,1,12,66,0,11,0,78,0
Earl Hays Press: Where Hollywood gets fake money and newspapers,1,3,5,48,1,9,0,53,0
You Truly Are 100% Emo If You Can Finish These Lyrics,1,2,10,29,1,10,3,39,0
31 Of The Most Dog Things To Ever Happen,1,1,8,22,0,8,2,30,0
Powerful images show what it’s like to read when you have dyslexia,1,2,1,53,1,11,0,54,0
"Chris Rock Promises The Oscars Will Be Full Of Drunk, Disappointed People",1,1,12,49,1,11,0,61,0
This Video Shows What Happens When Single People End Up On Awkward Blind Dates,1,1,14,51,0,13,0,65,0
Is this mysterious rumbling coming from Metro? Listen for yourself,1,2,3,53,1,9,0,56,0
"This Surat Tea Seller Just Redefined 'Black Tea' For Us, I-T Seizes Rs 400 Crores And Jewellery From Him",1,3,19,60,4,18,3,79,0
Here's exactly what to say in 10 of the most awkward moments you'll have in a new relationship,1,3,1,72,2,17,2,73,0
15 Autumn-Themed Cocktails That'll Totally Warm You Up,1,1,8,35,2,7,2,43,0
The new course getting more women into Australian politics,1,3,2,48,0,8,0,50,0
"How to score some of the best Super Bowl deals on TVs, pizza, and more",1,2,5,49,2,14,0,54,0
5 Ridiculously Simple DIYs You Need To Try This Month,1,1,11,32,0,9,1,43,0
Which Famous BFFs Are You And Your Bestie,1,1,10,24,0,7,0,34,0
16 Ways To Teach Your Kids About David Bowie (And The World),1,1,11,34,2,11,2,45,0
Scientific Santa Facts That Will Ruin Christmas,1,1,7,34,0,6,0,41,0
"Which ""Adventure Time"" Character Matches Your Zodiac Sign",1,1,8,40,2,7,0,48,0
What Sex Move Should You Try On Your Man Tonight,1,1,10,29,0,9,0,39,0
Joy Behar Says Trump Has ‘Mental Illness’ — ‘Not Right in the Head’,1,2,10,40,5,12,0,50,0
Destinations Everything you need to know about visiting Antarctica,1,3,3,55,0,8,0,58,0
27 Reasons To Love Peanut Butter More Than You Already Do,1,1,10,35,0,10,2,45,0
16 Times Chewbacca Was You At The Club,1,1,7,22,0,7,2,29,0
Tracing where President Trump gets some of his news ,1,3,3,40,0,9,0,43,0
Only A True Millennial Can Pass This Spelling Test,1,3,9,33,0,8,0,42,0
Gay Drama Teacher Responds Perfectly After A Mother Pulls Her Kids From His Class,1,1,14,54,0,13,0,68,0
"Hockey, weed and taxes? 11 Canadian stereotypes debunked",1,3,2,43,2,7,2,45,0
Which Disney Quote Do You Need To Hear Today,1,1,9,27,0,8,0,36,0
Beyond the Chokehold: The Path to Eric Garner’s Death ,1,2,7,36,2,9,0,43,0
"Rachel Maddow Airs Headline Linking Venezuelan Protests to Trump, Retracts Online",1,3,10,60,1,10,0,70,0
16 Super-Helpful Charts That Teach You How To Actually Work Out,1,1,11,39,1,10,2,50,0
What's Your Favorite Celebrity Couple Moment Of All Time,1,1,9,38,1,8,0,47,0
18 Gift Ideas For People Obsessed With Fluffy Things,1,1,8,34,0,8,2,42,0
These Questions Will Tell You Which U.S. City You Belong In,1,1,12,35,2,10,0,47,0
7 People Influencing Canadian Style Today,1,3,5,30,0,5,1,35,0
"How Well Do You Know The Lyrics To Wonka's ""Pure Imagination""",1,1,11,37,3,10,0,48,0
29 Of The Most Beautiful TV Quotes Of All Time,1,3,10,25,0,9,2,35,0
16 Things Dermatologists Want You To Know About Your Skin,1,1,9,37,0,9,2,46,0
"23 Hilarious ""Toy Story"" Moments That'll Make You Laugh Every Time",1,1,10,41,3,10,2,51,0
Watch E! News Now Season 2016 Excerpt Free Online - Best of 2016: Movies That Totally Made Us Ugly Cry | Yahoo View,1,3,18,63,4,22,8,81,0
This Coloring Book For Adults Will Make You Feel Young Again,1,1,11,39,0,10,0,50,0
17 Things All Twentysomethings Who Watched BET Will Never Forget,1,1,11,42,0,9,2,53,0
One of the most ‘annoying things’ on the entire planet just turned 20 The list,1,3,2,58,2,14,2,60,0
"23 Reasons Why ""The Princess Bride"" Is The Most Important Movie In Your Life",1,1,13,46,2,13,2,59,0
17 Boozy Crock Pot Cocktails,1,1,4,18,0,4,2,22,0
The global warming conference where skeptics think they're winning the debate,1,2,1,65,1,10,0,66,0
16 Customer Complaints Guaranteed To Make You Laugh,1,1,7,35,0,7,2,42,0
No fairytale ending: 'Magic beans' grow to reveal secret message telling you 'It's over' ,1,2,3,66,6,14,0,69,0
"Apple said to be secretly working on diabetes ""holy grail""",1,3,1,46,2,9,0,47,0
The Luxury in Tom Ford’s Nocturnal Animals Will Terrify and Seduce You,1,3,10,48,1,11,0,58,0
Behind The Scenes Of Bloomberg Businessweek's Epic Explanation Of Code,1,3,10,50,1,9,0,60,0
People Are Rushing To Get Critical Prescriptions Out Of Fear Over Obamacare Repeal,1,3,13,57,0,12,0,70,0
"Prince Has Joined Instagram And He Might Be A ""Scandal"" Fan",1,1,11,36,2,10,0,47,0
Ann Coulter: Obama Should Testify Under Oath on Trump Campaign Surveillance,1,3,10,54,1,10,0,64,0
"19 Times India Was Way, Way More Gender Progressive In 2015",1,1,9,33,1,10,6,42,0
"Is Finland’s basic universal income a solution to automation, fewer jobs and lower wages?",1,3,2,71,3,13,0,73,0
The Danger Of True Stories Becoming Quirky Indie Dramedies,1,1,9,41,0,8,0,50,0
There Are So Many Goats In This Tree And No One Knows Why,1,1,13,32,0,12,0,45,0
"Holiday cookie bakers, here’s your secret weapon: 1 dough, 5 fabulous results",1,2,1,59,4,11,2,60,0
1 Trip To Trader Joe's + $20 = 5 Easy Vegan Dinners,1,1,7,25,4,11,4,32,0
Pumpernickel The Mini-Pig Will Give You Life,1,1,8,29,1,6,0,37,0
Everything You Need To Know About Kim Kardashian And Amber Rose's Selfie,1,1,12,48,1,11,0,60,0
Can We Guess Your Age By Your Technology Preferences?,1,3,9,35,1,8,0,44,0
Which 2016 Movie Should You See Based On Your Favorite 2015 Song,1,1,10,35,0,11,8,45,0
NCAA Tournament 2017: Ranking the Top Performers Through the First Round,1,3,11,46,1,10,4,57,0
"Mike Hall's death won't be last time tragedy unfolds via Google Maps, expert says",1,3,4,61,3,13,0,65,0
Pete Rose defends legal gambling: 'Who am I hurting?',1,3,4,37,4,8,0,41,0
Reports: Donald Trump Selects Retired General John Kelly for DHS Head,1,3,12,46,1,10,0,58,0
The Movies That Made Us Love And Hate Sequels In 2015,1,1,10,29,0,10,4,39,0
Can You Name These Adorable Instagram-Famous Pets,1,1,8,34,1,6,0,42,0
26 Annoying “House Hunters” Moments That Piss You Off Every Time,1,3,10,40,2,10,2,50,0
This Year’s IRS Audits Are Bad News for the Rich,1,2,10,28,1,9,0,38,0
Clemson Tigers 'Get Back' Coach Puts in Work During the Offseason,1,2,9,44,2,10,0,53,0
The Rock Posts Unique Leg Workout Video on Instagram,1,2,8,36,0,8,0,44,0
19 Struggles You'll Recognise If You Really Love Food,1,1,8,34,1,8,2,42,0
Everyone's Confused Why Sting Is Performing The NBA All-Star Halftime Show In Toronto,1,1,16,55,2,12,0,71,0
19 Illustrations That Sum Up Being In A Relationship When You Have ADHD,1,1,15,42,0,12,2,57,0
Child Rapist Deported to Ecuador,1,3,4,24,0,4,0,28,0
"If Social Media Ever Gets You Down, This Pop Song Is For You",1,1,13,34,1,12,0,47,0
John Hurt dead: 143 roles compressed into four minutes from The Elephant Man and Alien to Harry Potter,1,3,8,73,1,17,3,81,0
Why 2017 is the year to visit Kathmandu,1,3,2,26,0,7,4,28,0
Why Can't Some People Smell Asparagus in Their Pee?,1,3,8,33,2,8,0,41,0
Top-Ranked Olympic Skier Gus Kenworthy Comes Out As Gay With ESPN Cover,1,1,16,43,1,11,0,59,0
Who Said It: Gene Belcher Or Chris Griffin,1,1,8,26,1,7,0,34,0
This Mash-Up Video Will Have You Crying Nostalgic Tears For 1994,1,1,11,38,1,10,4,49,0
21 Delectable Subscription Boxes Foodies Will Totally Love,1,1,7,42,0,7,2,49,0
An Eight-Months Pregnant Bridesmaid Went Into Labor The Morning Of Her Friend's Wedding,1,1,14,59,2,12,0,73,0
Liam Payne's Shirtless Selfie Is Causing Mass Hysteria,1,1,8,38,1,7,0,46,0
Why Five-Star Hotels Are Incredibly Cheap in Portugal,1,3,8,37,1,7,0,45,0
16 Easy And Delicious Recipes That Are Completely Turkey-Free,1,1,9,41,1,8,2,50,0
47 Movies That Helped People Cope During Their Depression,1,1,8,39,0,8,2,47,0
Meet The Chinese Company That Wants To Be The Intel Of Personalized Medicine,1,3,13,51,0,12,0,64,0
21 Tweets About Makeup That Will Make You Laugh Every Time,1,1,10,36,0,10,2,46,0
This Guy Filmed A Music Video From His Wrist And It's Amazing,1,1,12,37,1,11,0,49,0
'The Astronaut Wives Club' Sneak Peek: Cue the Spotlight [Video],1,3,9,41,5,9,0,50,0
18 Things Every Rom-Com Fan Needs In Their Life,1,1,9,27,1,8,2,36,0
Ask Your Employers To Let You Take A Power Nap For 20 Minutes Because It Can Help Boost Your Creativity,1,3,19,63,0,19,2,82,0
Lou Gehrig’s Fixer-Upper Awaits a Buyer for the Long Run ,1,3,8,37,2,10,0,45,0
‘Our House Is Down!’: Heartbreaking 911 Calls From Families Killed in Texas Floods,1,2,11,52,4,12,3,63,0
Which Spice Girl Are You Based On Your Zodiac Sign,1,1,10,31,0,9,0,41,0
Kinky AF Map Reveals the Most Popular Sex Toy in Each State,1,2,11,37,0,11,0,48,0
"What Makes ""Butch"" Hot",1,1,4,13,2,3,0,17,0
In memoriam: Those we lost in 2016 ,1,3,2,21,1,7,4,23,0
This device will dramatically improve your WiFi signal and speeds throughout your home,1,3,3,71,0,12,0,74,0
These Cheesy Brisket Totchos Are The Ultimate Snack,1,1,8,36,0,7,0,44,0
We Bet You Can't Solve These Basic Geometry Problems,1,1,9,34,1,8,0,43,0
KFC Is Now Making Pizzas On Fried Chicken And We Tried One So You Don't Have To,1,1,19,43,1,16,0,62,0
21 Quotes From YA Heroines That'll Make You Feel Unstoppable,1,1,10,38,1,9,2,48,0
We Know Your Age Based On Your Taste In Men,1,1,10,24,0,9,0,34,0
"20 Times Paget Brewster From ""Criminal Minds"" Was The Best Person On Twitter",1,1,12,48,2,12,2,60,0
A Definitive List Of The Badass Queer Women You Crushed On In 2015,1,1,12,38,0,12,4,50,0
"The 22 Best ""Rain Drop, Drop Top"" Tweets",1,3,7,21,3,7,2,28,0
These Sounds Will Confuse Your Brain,1,1,6,25,0,5,0,31,0
All the ways you could lose your seat on an airplane,1,3,1,41,0,10,0,42,0
"OMG, Tina Fey And Amy Poehler's Movie ""Sisters"" Has A New Poster",1,1,14,35,4,11,0,49,0
Find Out What You Should Watch On Netflix This February,1,1,10,36,0,9,0,46,0
17 Hairdresser Struggles Every Black Girl Knows To Be True,1,1,9,38,0,9,2,47,0
'You didn't even go in hard': The day a dad ruined junior football,1,2,2,48,4,12,0,50,0
This Is *Probably* How El Chapo Will Escape Prison Next,1,1,10,34,2,9,0,44,0
13 Harry Potter Fan Theories That Will Totally Blow Your Mind,1,1,10,39,0,10,2,49,0
Super Bowl LI: What You Need To Know,1,3,9,19,1,7,0,28,0
30 Moments That Made Us Proud In 2015,1,1,6,18,0,7,6,24,0
"This Mother Was Shocked When Her Facebook Post About ""Parent Sex"" Went Viral",1,1,13,49,2,12,0,62,0
Here's What Women Worked Out In Over The Past 100 Years,1,1,10,31,1,10,3,41,0
We Know How You'll Embarrass Yourself Today Based On Your Zodiac,1,1,11,42,1,10,0,53,0
10 Bold New Hair Color Trends You Should Try In 2016,1,1,9,27,0,10,6,36,0
34 Cosplayers Who Slayed MCM London Comic Con 2015,1,1,9,27,0,8,6,36,0
Take A Deep Dive Into This Disgustingly Adorable Relationship,1,1,9,44,0,8,0,53,0
14 Ways To Actually Resolve Conflicts With Your Friends,1,1,8,37,0,8,2,45,0
The best way to get rid of germs when washing your hands,1,2,1,44,0,11,0,45,0
18 Gifts That Will Definitely Make Your Cat Love You More,1,1,10,35,0,10,2,45,0
Are You More Laura Or Carmilla,1,1,6,19,0,5,0,25,0
Top Bartenders Reveal Their Favorite Winter Cocktail Recipes,1,3,8,45,0,7,0,53,0
29 Faces All Highly Sensitive People Will Immediately Recognize,1,1,8,45,0,8,2,53,0
Prince Harry tries the old 'shoulder tap' prank on a schoolboy - and fails spectacularly The list,1,2,3,75,3,16,0,78,0
Kylie Jenner's Lip Kit Sold Out In 30 Seconds And People Everywhere Are Enraged,1,1,13,50,1,13,2,63,0
17 Gifts Every ShondaLand Fan Will Love,1,1,7,24,0,6,2,31,0
32 Things That Literally Everyone Has Done Before In Their Life,1,3,10,41,0,10,2,51,0
WTF Is Online Dating Slang,1,1,7,15,0,4,0,22,0
Watch E! News Now Season 2016 Excerpt Free Online - Inside Kris Jenner's Holiday Home | Yahoo View,1,3,15,58,4,17,4,73,0
Asia's Best Universities In 2017,1,3,4,19,1,4,4,23,0
What's The Most Savage Thing Your Grandma Has Ever Said To You,1,1,12,38,1,11,0,50,0
Islamic State Teen Jailed For Attacking Jewish Teacher in France,1,2,9,46,0,9,0,55,0
Sherlock season 4 episode 2 review: Benedict Cumberbatch's detective drama takes a dark turn,1,3,3,72,2,13,2,75,0
This Is What Over 100 Years Of Girl Scouts Looks Like,1,1,10,30,0,10,3,40,0
This Girl Looks So Much Like Taylor Swift It Will Freak You Out,1,1,13,38,0,12,0,51,0
31 DIYs To Help You Throw The Best Slumber Party Ever,1,1,12,29,0,10,2,41,0
26 Times Trans People Ruled In 2015,1,1,5,18,0,6,6,23,0
"Donald Trump, NATO, Boeing: Your Thursday Briefing ",1,2,10,31,3,7,0,41,0
Which Vegetable Are You,1,1,4,16,0,3,0,20,0
How Funny Are You Actually,1,1,5,17,0,4,0,22,0
"The Cast Of ""High School Musical"" Reunited At Vanessa Hudgens' Halloween Party",1,1,12,52,3,11,0,64,0
"Hillary Clinton Joins Instagram, Posts Funny Pic, People Get Mad",1,2,10,43,2,9,0,53,0
"Hyderabad Blasts Case: Yasin Bhatkal, 4 Other Indian Mujahideen Operatives Sentenced To Death",1,2,12,66,2,12,1,78,0
"Kendrick Lamar Performed A Brand New Song On ""The Tonight Show""",1,1,11,40,2,10,0,51,0
"G-7 Leaders Grapple With Stronger Action Against Russia, Islamic State",1,3,10,48,2,9,1,58,0
"Police Shoot Tear Gas to Disperse Hot 97 Summer Jam Crowds, 61 Arrested",1,3,10,44,1,12,4,54,0
21 Things You'll Understand If You've Ever Been To The Cheesecake Factory,1,1,11,47,2,11,2,58,0
Do You Recognize These Famous Lips,1,1,6,23,0,5,0,29,0
Texas Border Couple Admits to Pimping Minors,1,2,6,32,0,6,0,38,0
Why it’s a big deal that Lauren Alaina has the No. 1 song on country radio,1,3,4,52,2,15,1,56,0
"Internet Expansion Could Cause Earth's Orbit To Fill With Dangerous Space Junk, Warn Experts",1,3,14,63,2,13,0,77,0
Do You Recognize These 2015 Chart Toppers,1,1,6,25,0,6,4,31,0
FAKE NEWS: CNBC Cites Left-Wing Politifact in Clinton Russian Uranium Story,1,3,20,43,2,10,0,63,0
16 Words To Think Differently About In 2016,1,1,6,24,0,7,6,30,0
21 Extremely Important Trash Pandas,1,1,4,25,0,4,2,29,0
6 Morning Rituals That Will Make You Productive All Day,1,3,9,36,0,9,1,45,0
"Celebrities Explain ""Netflix And Chill"" On The Emmys Red Carpet",1,1,10,42,2,9,0,52,0
"Is Adele married? Singer thanks ""husband"" at Grammys",1,3,4,38,3,7,0,42,0
25 WTF Photos That Made The News In 2015,1,1,9,17,0,8,6,26,0
Disney Quote Pickup Lines,1,1,4,18,0,3,0,22,0
"Sarah Michelle Gellar Reveals Her Mysterious New ""Star Wars Rebels"" Role",1,1,11,49,2,10,0,60,0
18 Things Everyone Who Dates A Makeup Addict Knows,1,1,8,32,0,8,2,40,0
Which Male Disney Character Are You,1,1,6,24,0,5,0,30,0
South Africa: The Manenberg school which is top of the class,1,2,4,45,1,10,0,49,0
Which lucky locations will have a white Christmas this year?,1,3,2,48,1,9,0,50,0
27 Times Riley Curry Was Too Darn Cute In 2015,1,1,8,23,0,9,6,31,0
Let's Try Some Improv In The Comments Section,1,1,8,29,1,7,0,37,0
12 Celebrities With Powerpuff Girl Eyes,1,1,5,27,0,5,2,32,0
"There Are About 450 Terrorists In J&K, Mostly 'Locals' And It Is A Matter Of Concern For Security Agencies",1,3,19,62,4,18,3,81,0
"GOP Sen Cotton: If Dems Filibuster, ‘Republicans Will Do What We Must’ to Confirm Gorsuch",1,3,16,55,4,14,0,71,0
The Year of Conquering Negative Thinking ,1,3,5,30,0,6,0,35,0
This 28-Day Challenge Will Get You To Actually Start Working Out,1,1,11,40,1,10,2,51,0
Should You Change Your Investments Under President Trump?,1,2,8,41,1,7,0,49,0
17 Ways To Have An Amazing Valentine's Day All By Yourself,1,1,10,35,1,10,2,45,0
Are You Superstitious Enough To Turn Around After This Black Cat Crosses Your Path,1,1,14,55,0,13,0,69,0
Find Out Your Horoscope For The Week Of October 5,1,1,9,30,0,9,1,39,0
Rick Perry thinks America needs a president who’s served in the military. Will voters agree?,1,3,4,71,3,14,0,75,0
This Video Perfectly Captures The Tragedy Of When Your SO Hates Your Favorite TV Show,1,1,17,54,0,14,0,71,0
5 survival myths that could get you killed,1,3,0,34,0,7,1,34,0
Holiday travel season comes to end with series of head-scratching incidents,1,3,1,63,1,10,0,64,0
"Mike Morell, Cited in ‘Russia Hacking’ Stories, Works for Longtime Clinton Aide Phillippe Reines",1,3,12,67,4,13,0,79,0
This Is Why Your Pancakes Never Come Out Fluffy,1,2,9,30,0,8,0,39,0
32 Tweets About Being Single Guaranteed To Make You Laugh,1,1,9,37,0,9,2,46,0
Mid-'00s Chris Pratt Was The Best Chris Pratt And Here's Why,1,1,11,34,3,10,2,45,0
15 Depressing Meals That Will Make You Cry Into Your Ketchup-Topped Spaghetti,1,1,12,51,1,11,2,63,0
Automate Me: How to use Gmail templates to answer emails quicker,1,3,4,49,1,10,0,53,0
"21 Confessions From The Biggest ""Gilmore Girls"" Fans In The World",1,1,10,41,2,10,2,51,0
"Meet Jill, The Most Adorable Squirrel On Instagram",1,1,8,34,1,7,0,42,0
21 Tweets That Perfectly Capture Your Personal Relationship To Kraft Dinner,1,1,10,53,0,10,2,63,0
99 Games We Want To Play If Sony Brings A PS2 Emulator To The PS4,1,1,16,31,0,14,4,47,0
"12 Undeniable Reasons Denise Hemphill Is The Best Character On ""Scream Queens""",1,1,11,52,2,11,2,63,0
Colbert Breaks Down Why Vaping Is So Hot Right Now,1,1,10,31,0,9,0,41,0
25 Vanities That Are Basically Porn For Makeup Addicts,1,1,8,36,0,8,2,44,0
17 Things That Are Too Real For People Who Always Drop Their Phone,1,1,12,40,0,12,2,52,0
16 Images Of Life In 2007,1,3,4,10,0,5,6,14,0
22 Puns That Went WAY Too Far,1,3,8,13,0,6,2,21,0
Curious world of North Korea's exports – from badger furs to 'strength pills',1,3,3,58,4,12,0,61,0
Donald Trump: ‘Nobody Believes’ Susan Rice,1,3,6,28,3,5,0,34,0
CREDIT SUISSE: Here are the 'danger signals' for a stock market top that we're watching,1,3,13,56,4,14,0,69,0
17 Struggles That Are All Too Real For Anyone Who Grew Up With Strict Parents,1,1,14,47,0,14,2,61,0
"Sharpton: Bernie Sanders Lost Black Voters Because He Couldn’t See Difference Between Main Street, MLK Blvd",1,2,18,71,3,15,0,89,0
What Kind Of Roommate Are You Actually,1,1,7,25,0,6,0,32,0
Harry Potter Is Real: Researcher Uncovers Real-Life Professor Snape At Welsh University,1,1,13,61,2,11,0,74,0
I Joined Tinder And All I Got Were These Stupid Best Friends,1,1,12,37,0,11,0,49,0
"Watch Out, Corporate Learning: Here Comes Disruption",1,3,7,37,2,6,0,44,0
The iPhone 8’s most important new feature was finally just confirmed,1,3,2,54,1,10,1,56,0
When Do Women Decide To Have Sex,1,1,7,19,0,6,0,26,0
29 Gifts That Help Empower Women All Over The World,1,1,9,31,0,9,2,40,0
"Old-School ""Star Wars"" Characters Ranked By Hotness",1,1,8,34,3,6,0,42,0
"Blue State Blues: Thank You, President-Elect Trump, for Saving Israel",1,3,10,46,4,9,0,56,0
"Can You Identify These Cars From ""Grand Theft Auto: Vice City""",1,1,11,38,3,10,0,49,0
What Happens When Everyday People Re-Create Iconic Fashion Ads,1,1,10,43,1,8,0,53,0
Trans Artists Made These Stunning Posters For Trans Day Of Remembrance,1,1,11,49,0,10,0,60,0
Here's The Story Of How A Half-Naked Drunk Dude Flooded Rogers Centre,1,1,13,43,2,11,0,56,0
"Facebook, Mozilla, Others Launch $14 Million ‘News Integrity’ Fund",1,3,8,43,5,8,2,51,0
15 best children's books of all time,1,2,0,27,1,6,2,27,0
This Photo Of A Real Deer Posing Next To A Fake Reindeer Is Too Adorable,1,1,15,43,0,14,0,58,0
Watch Tina Fey as Felicity Jones' Only Hope in 'SNL' Opening Monologue,1,3,12,44,3,11,0,56,0
21 Photos That Won't Make Sense If You Weren't A Mid-'00s Teen,1,1,11,32,4,11,4,43,0
21 Things Everyone With A Vagina Should Know About Kegels,1,1,9,37,0,9,2,46,0
22 Reasons Why Zellers Was Actually Better Than Target,1,1,8,36,0,8,2,44,0
15 Of The Best Football Celebrations Of All Time,1,1,8,30,0,8,2,38,0
Lana Del Rey’s New ‘Lust For Life’ Album: Here’s What We Know So Far,1,3,14,36,5,13,0,50,0
Which TV Character Should You Be For Halloween This Year,1,1,11,36,0,9,0,47,0
Goldman Sachs Alum Turns to Virtual Reality to Sell $57 Million Mansion,1,2,9,48,1,11,2,57,0
How Much Do You Really Know About Vance Joy,1,1,9,26,0,8,0,35,0
Here's What You Actually Need To Know About Growing Out Your Hair,1,1,12,41,1,11,0,53,0
You Won't Believe How Many Sharks Are Swimming Off Florida Right Now,1,1,12,44,1,11,0,56,0
An Edited (But Very Long) List of Things Kanye West Said In 2016,1,3,11,35,2,12,4,46,0
Trump’s False Autism Claims Could Have Serious Consequences For People With The Condition,1,2,13,63,1,12,0,76,0
I Quit Sugar For 30 Days And This Is What Happened,1,2,10,28,0,10,2,38,0
18 Truths For People Who Love Wine,1,1,6,20,0,6,2,26,0
18 Things Any Girl The Same Height As Her Boyfriend Knows,1,1,10,35,0,10,2,45,0
‘Not My President’s Day’: Thousands Protest at Anti-Trump Rallies Across U.S.,1,3,12,48,7,10,0,60,0
"How Well Do You Know Kristen Wiig's ""SNL"" Characters",1,1,11,30,3,8,0,41,0
22 Drool-Worthy Instagrams To Follow This Year,1,1,7,30,1,6,2,37,0
"Drop Everything And Watch The Super Empowering Trailer Of ""Parched"" Now",1,1,11,48,2,10,0,59,0
12 Everyday Activities That Might Actually Be Good For You,1,1,9,38,0,9,2,47,0
Women With These 20 Job Titles Are The Happiest At Work,1,3,10,33,0,10,2,43,0
"Which ""The Office"" GIF Are You Based On Your Least Favorite Quality",1,1,14,40,2,11,0,54,0
"Eight Good Things That Happened in 2016 (Yes, Really)",1,3,7,31,3,8,4,38,0
Apple CarPlay is going wireless,1,3,3,24,0,4,0,27,0
Lily Allen Lost a Twitter Row with Tommy Robinson and Is Now Threatening Legal Action,1,3,12,59,0,14,0,71,0
Pippa and the party to end all parties,1,3,1,30,0,7,0,31,0
25 Pictures That Prove Pumpkin Spice Has Gone Too Far,1,1,9,33,0,9,2,42,0
Is there a link between climate change and diabetes?,1,3,1,42,1,8,0,43,0
This portable smart scooter might be better than your car,1,2,1,47,0,9,0,48,0
21 Pictures That Are Way Too Real For People Who Are Always Tired,1,1,12,39,0,12,2,51,0
1 Dress 5 Holiday Styles,1,1,3,15,0,4,2,18,0
Can You Identify These Meryl Streep Movies By Their IMDb Descriptions,1,1,13,46,0,10,0,59,0
This App Is Like Tinder for Weed,1,3,6,20,0,6,0,26,0
Vin Diesel Shut Down Body Shamers With A Single Instagram,1,1,10,38,0,9,0,48,0
How to Get the Best Deals for Christmas at the Last Minute - Yahoo,1,3,8,44,1,13,0,52,0
20 Hit Songs That Literally Sound Exactly The Same,1,3,8,32,0,8,2,40,0
23 Signs You're Obsessed With Cat Collecting,1,1,6,29,1,6,2,35,0
19 Wildly Adorable Products You Definitely Need In Your Life,1,1,9,40,0,9,2,49,0
28 Adorable Christmas Pajamas For The Whole Family,1,3,7,34,0,7,2,41,0
Stephen Colbert touchingly eulogizes Don Rickles on 'Late Show',1,3,6,47,2,8,0,53,0
Piece of cake – we escaped corporate life to launch a fintech app,1,3,1,51,1,12,0,52,0
22 Of The Best Peanut Butter Baby Vines Of 2015,1,1,8,24,0,9,6,32,0
26 Incredible Things For People Who Love Yellow,1,1,7,31,0,7,2,38,0
Stevie Wonder Took James Corden On The Best Carpool Karaoke Ride Ever,1,1,12,46,0,11,0,58,0
23 Tweets About Lawyers And Trials That Will Make You Laugh Out Loud,1,1,12,42,0,12,2,54,0
The Uruguayan jail where inmates set up shop,1,3,2,35,0,7,0,37,0
Should You Get Drunk On Wine With Kathie Lee Or Hoda,1,1,11,31,0,10,0,42,0
25 Of The Most Embarrassing Things People Have Done At The Doctor's Office,1,1,12,47,1,12,2,59,0
16 Boozy Ways To Ring In The New Year,1,1,8,19,0,8,2,27,0
Kellyanne Conway has the worst response when asked about her lies The list,1,3,3,59,0,12,0,62,0
Billionaire Steve Schwarzman warns of next financial crisis,1,3,3,49,0,7,0,52,0
We Know If You Have An iPhone Or Android Based On Your Favorite Fast Food Restaurant,1,1,16,53,0,15,0,69,0
Parseltongue Problems,1,1,2,18,0,1,0,20,0
Which Michelle Obama Will We Get When She Leaves the White House? ,1,3,11,42,1,12,0,53,0
Which Nirvana Song Are You Based On Your Zodiac Sign,1,1,10,33,0,9,0,43,0
24 First Date Rules For Straight Men Who Don't Want To Die Alone,1,1,12,37,1,12,2,49,0
Get Set For A Desi Version Of 'Fifty Shades Of Grey' In This Web Series By Vikram Bhatt!,1,2,18,50,3,17,0,68,0
19 Anti-Memes For People Who Have Evolved Past Memes,1,3,9,32,1,8,2,41,0
Only True New Jerseyans Will Ace This Quiz,1,1,8,27,0,7,0,35,0
53 Things That Mildly Thrill British People,1,1,6,29,0,6,2,35,0
Steve Irwin's son Robert shows he's a chip off the old block on Tonight Show,1,3,5,55,2,14,0,60,0
Rob Thomas Apologizes After Trying To Make A Joke About Black Australians,1,1,12,50,0,11,0,62,0
Survey: 28 Percent of Federal Workers May Quit Their Jobs Once Trump Assumes Office,1,3,12,55,1,13,2,67,0
18 Quick Workouts That'll Help You Exercise Pretty Much Anywhere,1,1,9,43,1,9,2,52,0
18 Times The Internet Told The Truth About Grandmas,1,1,8,33,0,8,2,41,0
The Try Guys Imitate Each Other,1,1,6,20,0,5,0,26,0
Which languages should children be learning to get ahead?,1,3,1,47,1,8,0,48,0
Workers Slam ‘Insensitive’ Plea to Chip In for Director’s Sailing Boat,1,3,9,48,3,10,0,57,0
17 Painful Mascara Moments Every Woman Will Recognize,1,1,7,37,0,7,2,44,0
Where's The Best Place You've Ever Celebrated New Year's In The U.S,1,1,13,39,4,11,0,52,0
"London’s commuters have been tracked, and this is what we learned The list",1,3,2,58,2,12,0,60,0
11 Things You Shouldn't Let Get You Down,1,1,7,23,1,7,2,30,0
21 Cookies You Need To Make For The Holidays,1,1,8,26,0,8,2,34,0
What Does Your Sleeping Position Say About Your Love Life,1,1,10,38,0,9,0,48,0
Ra-ra-ah-ah-ah: The 7 Best Lady Gaga Songs for Karaoke,1,3,7,33,5,8,1,40,0
"Goodbye to teenage kicks: in a ridiculous world, fashion gets serious",1,3,1,56,2,10,0,57,0
The 25 Funniest Tweets From 2015 About Being A Grown-Ass Adult,1,1,10,35,1,10,6,45,0
27 Pictures That Will Make Way Too Much Sense To College Students,1,1,11,41,0,11,2,52,0
"Y'all, The New ""Zelda"" Game Is So Freakin' Fun",1,3,9,24,5,8,0,33,0
"Drake, Election, Jays: Canada Is Overwhelmed And Winning At Everything Tonight",1,1,11,54,3,10,0,65,0
If Motivational Posters Were Tweets,1,1,5,26,0,4,0,31,0
DBS BankVoice: Five Skills Every Millennial Needs To Get Ahead At Work,1,3,15,43,1,11,0,58,0
Gay couple who were technically father and (adoptive) son allowed to marry,1,2,1,60,2,11,0,61,0
The Guys Of NSYNC React To Adele Shattering Their Sales Record,1,1,15,37,0,10,0,52,0
The Cutest Treat For Halloween Are These Mummy Nutter Butters,1,1,10,42,0,9,0,52,0
This Redditor is trolling the Conservatives with these sneaky websites,1,3,3,58,0,9,0,61,0
What is the 'hairy blob' or globster found on the Philippines shore?,1,3,2,52,3,11,0,54,0
"How to Hack Room Service, and Other Travel Tips From Curtis Stone",1,3,10,43,1,11,0,53,0
Tell Us How You Feel About These Pictures And We'll Tell You How Big Of A Perfectionist You Are,1,1,19,57,1,18,0,76,0
BuzzFeed Crossword: It's Freestyle Time,1,1,6,27,2,4,0,33,0
"Yes, a Teenager Dabbed in Front of Paul Ryan ",1,2,6,29,1,9,0,35,0
How Mean Are You Really,1,1,5,14,0,4,0,19,0
"Ryan Reynolds Surprises Mega ""Deadpool"" Fan With Tickets To NYC Premiere",1,1,13,47,2,10,0,60,0
'The Big Bang Theory' will continue to haunt your television for years to come,1,2,4,59,2,13,0,63,0
23 Of The Most Ridiculously Hilarious Rumours That Went Around Schools,1,1,10,48,0,10,2,58,0
15 Waters That Must Be Stopped,1,1,5,18,0,5,2,23,0
19 Amazingly Delicious Sweets Subscription Boxes To Sign Up For ASAP,1,3,13,43,0,10,2,56,0
CNN Had a Problem. Donald Trump Solved It. ,1,3,9,24,2,8,0,33,0
Obama Deploying Dozen-Strong Team to ‘Keep Tabs’ on Trump Administration,1,2,9,51,3,9,0,60,0
Women Discuss Crushing On Friends,1,1,5,24,0,4,0,29,0
CBREVoice: How To Turn Your Workplace Into A Desired Destination,1,2,14,40,1,9,0,54,0
"Which Of The Six Merry Murderesses From ""Chicago"" Are You",1,1,10,36,2,9,0,46,0
"Rasmussen: 82 Percent of Republicans, 54 Percent of Independents Back Trump’s Refugee Moratorium",1,3,9,68,3,12,4,77,0
Politicians love the ‘left-behind’ cliche. It masks their own failure,1,3,2,54,4,9,0,56,0
Reese Witherspoon Thinks Elle Woods Should Be A Supreme Court Justice,1,1,11,48,0,10,0,59,0
Nas Receives W.E.B. Du Bois Medal At Harvard University,1,1,11,33,3,8,0,44,0
7 Easy Dinners That Are Tasty AF,1,1,7,18,0,6,1,25,0
So Yeah Taco Bell Has Drive Through Signs That Look Like Giant Penises,1,1,13,45,0,12,0,58,0
"Can You Finish These Quotes From ""Elf""",1,1,7,23,2,6,0,30,0
This Is Why Ramen Has Never Looked So Good,1,1,9,25,0,8,0,34,0
Isn't She Lovely,1,1,3,10,1,2,0,13,0
10 Top Fashion Tips From Stylish Plus-Size Guys,1,1,8,29,1,7,2,37,0
21 Gifts For The Gwyneth Paltrow In Your Life,1,3,8,27,0,8,2,35,0
Are Emojis Words,1,1,3,11,0,2,0,14,0
Suspect in Kim Jong-nam assassination posed in flowery bikini at motor show,1,3,3,60,1,11,0,63,0
Donald Trump Has Found Something Mysterious For Rudy Giuliani To Do,1,2,11,46,0,10,0,57,0
18 True Crime Conspiracy Theories That’ll Creep You Out,1,3,8,36,1,8,2,44,0
"3 Irish moms try weed for the first time, carnage ensues",1,3,1,43,1,10,1,44,0
What Does The Week Of September 14 Have In Store For You,1,1,11,32,0,11,2,43,0
7 Dark Disney Origin Stories That Will Ruin Your Childhood,1,1,9,39,0,9,1,48,0
24 Things Miley Cyrus Does Now That Hannah Montana Would Never Have Done,1,1,12,46,0,12,2,58,0
Sessions: ‘I Have Not Met With Any Russians at Any Time to Discuss Any Political Campaign’,1,3,14,58,3,15,0,72,0
Acting AG Sally Yates: Justice Department Won’t Defend Trump’s Immigration Order,1,3,12,55,3,10,0,67,0
5 things to watch for in a new travel ban,1,3,0,31,0,9,1,31,0
This Vet Saved A Dog's Life And Helped Him See Again,1,1,11,30,1,10,0,41,0
21 Comments That Prove Nicki Minaj's Instagram Fans Have Lost It,1,1,10,41,1,10,2,51,0
Dr. Sebastian Gorka to Astroturf Protesters: You Are ‘Victims of Fake News’,1,3,10,50,4,11,0,60,0
These Pictures Are Proof That Some People Are The Worst,1,1,10,36,0,9,0,46,0
Which ’00s Trend Must Go?,1,3,4,13,2,4,2,17,0
Proof Human Bodies Are Weird,1,1,5,19,0,4,0,24,0
19 Of The Cringiest Facebook Posts In The History Of Cringe,1,1,10,37,0,10,2,47,0
"The Cast Of ""Gilmore Girls"" In Their First Episode, Last Episode, And Now",1,1,13,44,4,12,0,57,0
How Well Do You Know The Zodiac Symbols,1,1,8,24,0,7,0,32,0
Quantum Physics Tells Us Our Fate Is Not Written In The Stars,1,3,12,38,0,11,0,50,0
"19 People Who Probably Should've Just Asked, ""Do You Want To Go To Prom?""",1,2,13,40,5,13,2,53,0
Talking To Your Self-Esteem,1,1,5,18,1,3,0,23,0
Copper Prices Zigzagged Wildly When Almost No One Was Trading,1,2,10,42,0,9,0,52,0
"Why Tony Robbins, Steve Case, Magic Johnson and others invested millions in this pro gaming team",1,2,7,72,2,15,0,79,0
UC Berkeley Investigates Alleged Employee Who Assaulted MILO Fan During Riot,1,3,15,51,0,10,0,66,0
Families take the lead in MH370 mystery,1,2,3,27,0,6,3,30,0
The movie and TV quotes that everyone gets wrong The list,1,3,4,43,0,10,0,47,0
"48 Lessons My Younger, 21-Year-Old Sister Taught Me",1,1,8,29,3,7,4,37,0
These Kittens Got Together For The Cutest Playtime Ever,1,1,9,38,0,8,0,47,0
What's The Best Place To Buy Affordable Jewelry Online,1,1,9,36,1,8,0,45,0
Tyron Woodley: Race a factor in status as 'worst-treated' UFC champ,1,2,6,47,4,10,0,53,0
"18 Things You Didn't Know About ""While You Were Sleeping""",1,1,9,34,3,9,2,43,0
The 20 Worst Times To Make Eye Contact,1,1,7,22,0,7,2,29,0
WikiLeaks Explained: How Vulnerable Are You to Hackers? ,1,3,8,38,2,8,0,46,0
Serious Question: Is This Nicolas Cage Or Scrooge,1,1,8,33,1,7,0,41,0
20 Christmas Dachshunds Who Are Totally Ready For The Holidays,1,1,9,42,0,9,2,51,0
"If You Can Get 10/10 On This Quiz, You Must Work At Dunder-Mifflin",1,2,13,34,3,12,4,47,0
Eight ways technology impacted your life in 2016,1,3,1,36,0,7,4,37,0
Woman battling cancer stunned by diner's amazing act of kindness,1,3,1,53,1,9,0,54,0
Here are 7 Easy Ways To Get Better At Making Food,1,1,9,29,0,10,1,38,0
22 Things Anyone Who Has Ever Had A Cell Phone Will Get,1,1,11,31,0,11,2,42,0
"Cheap, Pre-Fab Hobbit Houses Are A Thing And They're Whimsical AF",1,1,13,39,3,10,0,52,0
Which TV Family Should You Spend Christmas With,1,1,9,31,0,7,0,40,0
"When KJo Played Down Kangana’s Nepotism Remarks, Oscars 2017 Full Winner List And More From Entertainment",1,3,16,68,2,15,4,84,0
These Illustrations Show What It Feels Like To Have A Migraine,1,1,11,41,0,10,0,52,0
A Sincere Ode To Uno From Everyone Who Has Ever Existed,1,1,11,34,0,10,0,45,0
What's The Best Thing You've Seen As A Veterinarian,1,1,9,32,2,8,0,41,0
Australian rugby player Ben Ross snaps his arm live on air during an arm wrestle with Wendell Sailor,1,3,5,78,0,17,0,83,0
How Much Do You Really Love Your Dog,1,1,8,21,0,7,0,29,0
39 Pictures For Anyone Who Is Just Sad,1,1,7,22,0,7,2,29,0
Here's The Biggest Halloween Costume For Each Year Of The '90s,1,1,10,38,2,10,2,48,0
Kids Explain How Boys And Girls Act In Third Grade,1,1,10,31,0,9,0,41,0
19 Things Only Bridal Stylists Will Understand,1,1,6,32,0,6,2,38,0
How Deadpool Are You,1,1,4,13,0,3,0,17,0
27 Tweets That'll Speak To Every Britney Spears Fan's Soul,1,1,9,36,2,9,2,45,0
Bolivian monastery accepts four-legged friar,1,3,1,38,1,4,0,39,0
Flashback: Chuck Schumer Considered Refugee Pause in 2015,1,3,6,39,1,7,4,45,0
Here's How Quantum Computing Will Change The World,1,3,8,34,1,7,0,42,0
Poor woman got her hand stuck in a toilet so badly that she had to call the police,1,3,1,64,0,17,0,65,0
"25 Reasons We Need Sookie St. James In The ""Gilmore Girls"" Revival",1,1,11,39,3,11,2,50,0
23 Recipes That Prove No Meal Is Complete Without Fluff,1,1,9,35,0,9,2,44,0
Saints Running Back Mark Ingram Takes Down 600 Pound Boar,1,3,9,36,0,9,3,45,0
Very brave men wrangle a giant snake out of a car engine,1,3,1,44,0,11,0,45,0
So It Looks Like Taylor Swift And Calvin Harris Maybe Aren't Broken Up After All,1,1,15,50,1,14,0,65,0
"30 Things You Need To Know About ""Baby Daddy"" Star Chelsea Kane",1,1,11,37,2,11,2,48,0
12 Very Obvious Facts That Will Make You Strangely Happy,1,3,9,36,0,9,2,45,0
54 Lady Gaga Lyrics For When You Need A Fire Instagram Caption,1,1,11,38,0,11,2,49,0
Sonakshi Sinha's Knee Looks Like Satish Shah's Face,1,1,8,34,2,7,0,42,0
36 Regular People Who Look So Much Like Celebs It's Crazy,1,1,10,34,1,10,2,44,0
What Marvel Movie Are You Most Looking Forward To,1,1,9,32,0,8,0,41,0
What It's Like To Kiss Another Woman For The First Time,1,1,11,33,1,10,0,44,0
Scientists Are Sharing Their Unusual Bucket Lists On Twitter,1,1,9,43,0,8,0,52,0
How Crappy Is Your Roommate,1,1,5,18,0,4,0,23,0
SAPVoice: One Solution That Turns Shipping Delays To Your Advantage,1,2,13,44,1,9,0,57,0
We Know Which Member Of Your Friend Group You Are Based On Your Zodiac Sign,1,1,15,46,0,14,0,61,0
"People Who Are Always Cold, How Do You Stay Warm",1,1,10,28,1,9,0,38,0
Sex Dolls That Talk Back ,1,2,5,15,0,5,0,20,0
17 Subtle Ways To Make Your Home Creepy AF,1,1,9,23,0,8,2,32,0
Obama: ‘Latte Sippin’ Democrats Need to Show Up,1,3,7,30,3,7,0,37,0
When You Completely F@#% Up Your Makeup,1,1,7,23,3,6,0,30,0
These Guys Wore Heels For A Day And Felt The Pain,1,1,11,28,0,10,0,39,0
"Sushant Singh Rajput's Drastic Transformation, Tulsi-Parvati's Epic Selfie And More From Ent",1,3,13,64,4,11,0,77,0
18 Things You'll Only Understand If You Live In A Lazy House,1,1,11,35,1,11,2,46,0
Can You Identify These Celebrities By Their Smiles,1,1,8,35,0,7,0,43,0
Who Should Win Artist of the Year at the 2017 Billboard Latin Music Awards? Vote!,1,3,10,51,2,14,4,61,0
"After a toddler accidentally shot and killed his older sister, a family’s wounds run deep",1,3,1,72,2,14,0,73,0
CNN’s Don Lemon on Chicago Torture Video: ‘I Don’t Think It Was Evil’,1,3,14,38,5,12,0,52,0
These Simple Kitchen Hacks Will Make Your Groceries Last So Much Longer,1,3,12,48,0,11,0,60,0
Read This If You Just Got An iPhone For Christmas,1,1,10,30,0,9,0,40,0
Joseph Jakubowski manhunt: Fugitive purportedly writes letter threatening violence on Easter Sunday ,1,2,5,82,1,12,0,87,0
14 Couples Who Are Definitely Breaking Up,1,1,6,27,0,6,2,33,0
No-show for Prince William and Prince Harry at traditional Christmas Eve football match,1,3,7,67,1,12,0,74,0
"29 Of The Most Perfect Comebacks That Ever Happened On ""Friends""",1,1,10,40,2,10,2,50,0
Steve Kerr: Don't think LaVar Ball's remarks are 'helping' his kids,1,3,6,46,5,10,0,52,0
Enya Heard You Were Stressed Out And Released A Soothing New Song To Help,1,1,14,46,0,13,0,60,0
Things I Wish Someone Had Told Me About Being Emotionally Abused,1,1,11,43,0,10,0,54,0
The Chinese burger designed by Asia's 'best female chef',1,2,3,42,3,8,0,45,0
Today's Good Nice Horoscope For All Humans,1,1,7,28,1,6,0,35,0
Are You More Into Netflix Or More Into Chilling,1,1,9,30,0,8,0,39,0
Evocative Photos Highlight New Zealand's Largest Street Gang,1,2,8,44,1,7,0,52,0
Look At This Amazing Cat Who Goes On Adventures,1,1,9,30,0,8,0,39,0
What Animal Matches Your Birth Month,1,1,6,25,0,5,0,31,0
Van Morrison: 30 essential songs,1,2,2,23,1,4,2,25,0
"The First Trailer For ""I Am Cait"" Season 2 Is Here",1,1,10,27,2,10,1,37,0
"When To Expect Your W-2, 1099 & More Tax Forms In 2017 (And What To Do If They're Missing)",1,3,16,41,6,18,9,57,0
22 Reasons Costco Is America's Greatest Achievement,1,1,6,36,1,6,2,42,0
What Unnatural Color Should You Dye Your Hair,1,1,8,30,0,7,0,38,0
The Great Mystery Behind Tesla’s Rally ,1,3,6,26,1,6,0,32,0
How Many Kinds Of French Fries Have You Actually Eaten,1,1,10,35,0,9,0,45,0
7 Expert Shopping Tips That’ll Save You Money,1,3,7,29,1,7,1,36,0
Top Gear Has Seven Presenters Now And People Are Taking The Piss,1,1,12,41,0,11,0,53,0
12 Real AF Sex Situations That Will Make You Cringe,1,2,10,30,0,9,2,40,0
Apple CarPlay is going wireless,1,2,3,24,0,4,0,27,0
Can You Guess The Music Video Featuring Nicki Minaj From Its Screenshot,1,1,12,48,0,11,0,60,0
15 Sickeningly Adorable Celebrity Couple Tweets In Honor Of Valentine's Day,1,1,10,52,1,10,2,62,0
"Before Blaming Russia, Hillary Clinton’s Campaign Conspired to ‘Elevate’ Trump",1,2,9,56,4,9,0,65,0
42 Celebrities Who Are Supporting The Women’s March,1,3,7,34,1,7,2,41,0
13 Apps That'll Make Your iPhone-Android Relationship So Much Better,1,1,10,45,2,9,2,55,0
"Katie Holmes Says ""Dawson's Creek"" Is Too '90s For A Reboot",1,1,10,33,4,10,2,43,0
"Which ""Family Guy"" Moment Makes You Laugh Every Time",1,1,9,33,2,8,0,42,0
These GIFs Of Chris Evans Pretending He Can't Do A Push-Up Are So Important,1,1,17,43,2,13,0,60,0
15 Ways Muslims Can Feel Just A Little More OK Right Now,1,3,12,31,0,11,2,43,0
Why women marched against a Conservative MP as well as Donald Trump,1,2,6,50,0,11,0,56,0
This Groom Surprised His Grandma In The Hospital On His Wedding Day,1,1,12,44,0,11,0,56,0
Here's What Happens When You Order A Large Pizza Just For Yourself,1,1,12,42,1,11,0,54,0
22 Little Things Teenage Girls Were Obsessed With Doing In 2004,1,1,9,38,0,10,6,47,0
This Woman Fights the Scammers After Your Parents’ Money,1,3,8,39,1,8,0,47,0
"Ordinance On Jallikattu, Court Observation On Murthal Rape And Other Must Read Stories",1,2,13,60,1,12,0,73,0
Portraits Of Cats Shaking Themselves Clean Is All You Need To See Today,1,1,13,46,0,12,0,59,0
Here 17 Gifts For Food-Obsessed People That Are Under $25 On Amazon,1,1,11,39,2,11,4,50,0
A Vanity Fair  Photo Of Late-Night TV Hosts Is Getting Quite A Response From People,1,1,17,50,1,15,0,67,0
Can You Identify What Chocolates These Were Before We Smashed Them,1,1,11,45,0,10,0,56,0
"England's Smallest Castle Is For Sale, And It Looks Like The House Of Our Dreams",1,3,15,49,2,14,0,64,0
37 Of The Best Memes About Canada On The Internet,1,1,9,29,0,9,2,38,0
Remember Lionel Messi's 5-Year-Old Afghan Fan? He Finally Got To Meet His Idol,1,2,14,47,4,12,1,61,0
How '13 Reasons Why' is different than other YA adaptations,1,2,5,41,2,9,2,46,0
14 Texts Socially Anxious People Send At Parties,1,1,7,32,0,7,2,39,0
17 jobs Amy Schumer does better than you,1,3,2,29,0,7,2,31,0
How Trump abortion funding cuts could affect Africa,1,3,3,41,0,7,0,44,0
Is the United Airlines man being smeared in the media even the right David Dao? It shouldn't matter,1,2,6,74,2,17,0,80,0
We Know What Funny Cat GIF You Need To See Today,1,1,13,25,0,10,0,38,0
Evan McMullin: Attacks on Susan Rice ‘Orchestrated Distraction’ by White House,1,2,10,55,3,10,0,65,0
Can You Pass This Basic Mars Quiz,1,1,7,20,0,6,0,27,0
This Emoji Test Will Determine What You Need In 2016,1,1,9,30,0,9,4,39,0
These were the most complained about UK ads of 2016,1,3,3,35,0,9,4,38,0
Sextacles: How Snapchat's new Spectacles are being used in the sack,1,2,4,51,2,10,0,55,0
Happy Birthday To The Most Iconic Carefree Woman On The Planet,1,1,11,41,0,10,0,52,0
Migrant Stabs Bouncer at Gay Nightclub After Being Refused Entry,1,2,9,46,0,9,0,55,0
This Word Test Will Reveal If You Think With Your Head Or Your Heart,1,3,14,41,0,13,0,55,0
Will You Be Fooled By These Basic Science Questions,1,1,9,34,0,8,0,43,0
13 Confessions About Big Butts That Will Surprise You,1,1,8,35,0,8,2,43,0
19 Gifts Every Booze Lover Needs To Ask For This Year,1,1,10,31,0,10,2,41,0
These are the weirdest things you'll find in Russia's 'patriotic theme park' The list,1,2,3,65,4,13,0,68,0
Facebook Live attack: Four Chicago accused denied bail,1,2,4,42,1,7,0,46,0
Hilary Duff's New Purple Hair Is Gorgeous,1,1,7,27,1,6,0,34,0
23 Gifts That Will Make All Makeup Lovers Swoon,1,1,8,29,0,8,2,37,0
20 Things That Will Make Your Breakup Hurt So Much Less,1,1,10,33,0,10,2,43,0
How President Trump Could Bring About A Safer Greater World Peace,1,2,11,44,0,10,0,55,0
23 Wonderful Ways To Eat Cake This Winter,1,1,7,25,0,7,2,32,0
Cher Destroys Donald Trump In One Little Tweet,1,1,8,31,0,7,0,39,0
"'They're sold like shoes': Cambodia's building boom built on slave labour, report says",1,2,2,66,6,12,0,68,0
"Odell Beckham Jr. Lets Loose, Dances with Colts Mascot at Pro Bowl",1,3,10,43,2,11,0,53,0
Here's What Your Favourite British Heart-Throbs Looked Like A Decade Ago,1,1,12,48,2,10,0,60,0
26 Pros And Cons Of Living With Your Significant Other,1,1,9,34,0,9,2,43,0
18 Things People Who Live Alone Will Never Understand,1,1,8,35,0,8,2,43,0
22 Home Decor Pieces That Will Make You Wish You Were Dead,1,1,11,34,0,11,2,45,0
11 Shibas Who Keep Getting Stuck In Things,1,1,7,26,0,7,2,33,0
How to Build Instant Rapport in an Interview,1,3,5,32,0,7,0,37,0
27 Things That Always Happen In The Office During Christmas,1,1,9,39,0,9,2,48,0
15 Christmas Emojis You Could Definitely Use Right Now,1,1,8,36,0,8,2,44,0
Which Dessert Should Be Your Valentine Based On Your Zodiac Sign,1,1,11,43,0,10,0,54,0
18 Insanely Delicious Vegan Christmas Cookies Santa Would Approve Of,1,1,9,48,0,9,2,57,0
Lawyers: Trump has to sell DC hotel before taking office,1,3,4,42,1,9,0,46,0
17 Incredibly Helpful Charts For Cooking Thanksgiving Dinner,1,1,7,44,0,7,2,51,0
"You Must Watch The Cast Of ""Downton Abbey"" Reenact A Scene With American Accents",1,1,14,51,2,13,0,65,0
Which Video Game Princess Are You,1,1,6,22,0,5,0,28,0
17 Times The Internet Perfectly Summed Up Being A Cancer,1,1,9,36,0,9,2,45,0
Twitter Skewered Steve Harvey For Announcing The Wrong Miss Universe Winner,1,1,11,54,0,10,0,65,0
9 Surprising Ways You're Wasting Money Without Realizing It,1,2,8,41,1,8,1,49,0
Here's How People In Nine Countries Like To Get Drunk,1,1,10,33,1,9,0,43,0
15 Things Everyone With A Great Memory Will Understand,1,1,8,36,0,8,2,44,0
17 Ways To Look Like A '90s Dream Babe,1,1,7,18,1,8,4,25,0
"Escaped murderers may be headed to Vermont, authorities say  ",1,2,2,48,1,10,0,50,0
9 Confessions That Will Make You Glad You're Single,1,1,8,33,1,8,1,41,0
24 Beautifully Stunning Models Who Aren’t Kendall Jenner,1,3,7,39,1,7,2,46,0
Missy Elliott's New Video Is Everything You've Ever Wanted And More,1,1,11,44,2,10,0,55,0
NASA Just Released A Breathtaking Photo Of Southern India Taken From Space,1,1,15,48,0,11,0,63,0
Animal Control Investigated Kylie Jenner Over Her Dogs' Weight,1,1,9,44,1,8,0,53,0
An Entire Stadium Cheered For This 2-Year-Old,1,3,8,28,2,6,1,36,0
"Which Character From ""Awkward"" Are You",1,1,6,25,2,5,0,31,0
The #MissUniverseIntro Hashtag Proves Filipinos Take Beauty Pageants To A Whole New Level,1,1,15,61,1,12,0,76,0
Here’s What Separates Casey Affleck from Nate Parker,1,3,7,37,1,7,0,44,0
GFs Shaved Their BFs' Faces... And Blood Was Everywhere,1,1,11,32,4,8,0,43,0
This Runner Is Getting Noticed For Inspiring People To Run At Any Size,1,1,13,45,0,12,0,58,0
One Man Dead in Shooting Near Filming of a Boosie Badazz Music Video,1,2,10,46,0,12,0,56,0
"Demonetisation Is Illegal, Journalists Twitter Accounts Hacked And Other Must Read Stories",1,2,12,66,1,11,0,78,0
Guy Doing Handstand Push-Ups on Stack of Dumbbells Is Latest Person to Film Super-Dangerous Gym Stunt,1,2,15,69,2,15,0,84,0
Payback Potential As Australian Prime Minister's 'Dumb Deal' Earns Trump Tongue-Lashing,1,3,12,61,4,10,0,73,0
Is Lipstick Toxic? Gwyneth Paltrow Thinks So,1,3,7,30,1,6,0,37,0
What Is A Lumbersexual,1,1,4,15,0,3,0,19,0
Which Nutella Dessert Are You Based On Your Birth Month,1,1,10,36,0,9,0,46,0
"16 ""SpongeBob SquarePants"" Moments That Went Right Over Your Head As A Kid",1,1,14,44,2,12,2,58,0
28 Photos That Will Give You Serious Relationship Goals,1,1,8,37,0,8,2,45,0
24 Spectacular Coincidences That Will Make You Question Reality,1,1,8,45,0,8,2,53,0
Problems Only Book Lovers Understand,1,1,5,27,0,4,0,32,0
Historian who predicted Donald Trump would win presidency forecasts that he will be impeached,1,3,3,77,0,13,0,80,0
20 Reasons Marty McFly Is The Flyest Guy,1,1,8,23,0,7,2,31,0
14 Ways To Transform A Potato,1,1,5,17,0,5,2,22,0
Here's Why You Really Shouldn't Try The New Starbucks Unicorn Drink,1,3,11,44,2,10,0,55,0
We Tried On The Most Perverted Men's Halloween Costumes,1,1,9,37,1,8,0,46,0
The best TV and film Easter eggs of the year,1,2,4,31,0,9,0,35,0
How Queen Elizabeth Uses Her Purse to Send Secret Signals to her Staff [Video],1,3,11,52,2,13,0,63,0
"You Can Now Buy A Working, Adult-Sized Little Tikes Car",1,1,11,33,2,9,0,44,0
'Drugs fix room is like my second home',1,2,1,29,2,7,0,30,0
How 'Split' pulled off its incredible twist ending â and where it goes next,1,3,2,58,4,13,0,60,0
Leonard Fournette 12 pounds lighter at pro day,1,3,2,35,0,7,2,37,0
14 Scandalous Teacher Confessions,1,1,3,25,0,3,2,28,0
Muffler Man Returns! And We Cannot Wait To See Who Will He Take Down This Season!,1,2,16,48,2,15,0,64,0
Awe-inspiring photos of Earth remind us just what's at stake,1,2,2,47,2,9,0,49,0
"9 ""Game Of Thrones"" Fan Theories That Make The Show Better",1,1,10,35,2,10,1,45,0
"50 Things You Probably Didn't Know About ""Love Actually""",1,1,8,35,3,8,2,43,0
Obama’s Organizing for Action Throws Fire Sale: 60% Off ‘Don’t Tread on My Obamacare’ Bumper Sticker,1,2,13,64,6,15,2,77,0
23 Pictures That Prove We’re Living In The Damn Future,1,2,9,33,1,9,2,42,0
Gloria Steinem's Dedication In Her New Book Is Incredibly Moving,1,1,10,44,1,9,0,54,0
Are Wall Street Banks Doing Enough to Prevent Shoddy Chinese IPOs?,1,2,12,43,1,10,0,55,0
21 Coffee Hacks To Step Your Game Up Immensely,1,2,8,28,0,8,2,36,0
Someone At The All India Bakchod Office Has Lost Their Damn Mind,1,1,12,41,0,11,0,53,0
This Is What Holiday Shopping Looked Like Way Before Black Friday,1,1,11,44,0,10,0,55,0
"How to shear a sheep, and win",1,3,1,21,1,6,0,22,0
Some Terrible Things Happened During One Of The Holiest Weeks Of The Year,1,3,13,48,0,12,0,61,0
"'Rogue' national park Twitter account wasn't so rogue after all, emails show",1,2,2,59,4,11,0,61,0
"This Is What Powerline From ""A Goofy Movie"" Looks Like Now",1,1,11,35,2,10,0,46,0
"The ""Gotham"" Cast Gender-Swaps Iconic Batman Characters",1,1,8,38,3,6,0,46,0
14 Mind-Blowing Shaadi Outfit Ideas For Every Lazy Girl,1,1,9,35,1,8,2,44,0
We Know Your Best And Worst Qualities Based On One Question,1,1,11,38,0,10,0,49,0
Which Artist Is Winning 2016 So Far? Vote!,1,3,7,22,2,7,4,29,0
Friendly Reminder That Joseph Gordon-Levitt Was The Most Adorable Child,1,1,11,50,1,9,0,61,0
Let Robots Teach Our Kids? Here’s Why That Isn’t Such a Bad Idea,1,3,12,37,3,12,0,49,0
Everything You Need To Know About Our New Favorite Supermodel,1,1,10,42,0,9,0,52,0
25 Famous Women on Waxing and Shaving,1,3,4,25,0,6,2,29,0
Prison Phone Rates: The Ripoff Continues,1,3,6,28,1,5,0,34,0
School warning: What parents need to know about the 'eraser challenge',1,3,2,55,3,10,0,57,0
"Nixon Tried to Spoil Johnson’s Vietnam Peace Talks in ’68, Notes Show ",1,3,9,44,3,12,2,53,0
23 Fast-Food Items You'll Never See Again In Your Life,1,1,10,31,2,9,2,41,0
12 Times Tumblr Got Weird AF About Zodiac Signs,1,1,9,28,0,8,2,37,0
How Far Would You Make It In The Hunger Games,1,1,10,26,0,9,0,36,0
Here's What Iconic Movie Posters Looks Like Without Their Words,1,1,10,43,1,9,0,53,0
26 Times Taylor Swift Was You AF,1,1,7,17,0,6,2,24,0
Hunt for Berlin Suspect Ends in Gunfire on an Italian Plaza ,1,3,7,42,0,11,0,49,0
Make your donation to the Telegraph Christmas Appeal 2016,1,3,4,41,0,8,4,45,0
"9 WTF Questions ""Double, Double, Toil And Trouble"" Left Unanswered",1,1,11,41,4,9,1,52,0
Macron - not the only young achiever,1,3,1,28,1,6,0,29,0
There's a very good reason to tweet emoji at Google right now,1,2,2,47,1,11,0,49,0
"Which ""The Vampire Diaries"" Character Are You Based On Your Zodiac Sign",1,1,12,46,2,11,0,58,0
Which Coast Of The United States Is Actually The Best,1,1,10,34,0,9,0,44,0
Odd Lots: What Sneakers Can Tell You About How Financial Markets Work,1,3,12,45,1,11,0,57,0
How Apple’s new music service compares to what’s out there right now,1,3,2,53,2,11,0,55,0
10 Reasons Marriage Can Be Better The Second Time Around,1,3,9,36,0,9,2,45,0
Are You An Introvert Or A Wintrovert,1,1,7,23,0,6,0,30,0
What Would The TV Show Of Your Life Be Like,1,1,11,23,0,9,0,34,0
Anne Hathaway Shared An Empowering Photo When Paparazzi Tried To Take Pictures Of Her Baby Bump,1,1,16,64,0,15,0,80,0
Can You Answer These Basic Questions About Michigan,1,1,8,36,0,7,0,44,0
22 Times Russell Brand Was Actually Really Fucking Funny,1,1,8,38,0,8,2,46,0
Amazon’s Third-Party Sellers Get Ripped Off By Hackers,1,3,9,36,2,7,0,45,0
Plan A Day At Disneyland And We'll Tell You Which Disney Princess You Are,1,3,14,45,1,13,0,59,0
A Beaver Somehow Ended Up Herding Cattle On A Saskatchewan Ranch,1,3,11,43,0,10,0,54,0
The 16 Best Movies and Television Shows About High School Football,1,2,9,45,0,10,2,54,0
Can You Tell The Difference Between Shawn And Aaron Ashmore,1,1,10,40,0,9,0,50,0
19 Things That Happen When You Have The Sunday Scaries,1,1,9,34,0,9,2,43,0
"Send in the bern unit, Bernie Sanders just poured the hot fire bern sauce all over Trump on Twitter",1,3,5,75,1,18,0,80,0
Firefighters can see through smoke with new thermal mask,1,3,1,47,0,8,0,48,0
"The ""Growing Up With My Name"" Hashtag Captures What It's Like Having A Unique Name",1,1,15,50,3,14,0,65,0
"Justin Bieber Dropped A ""Hotline Bling"" Remix And It Will Give You So Much Life",1,1,15,48,2,14,0,63,0
10 Geographically Remote Places to Get Away From It All,1,3,8,36,0,9,2,44,0
Here's the Full List of 2017 Academy Awards Nominees,1,3,6,33,1,8,4,39,0
This joke about Donald Trump is extremely rude and we don't condone it even a little The list,1,2,4,71,1,17,0,75,0
People Are Really Pissed That Taylor Swift Won Album Of The Year,1,1,12,41,0,11,0,53,0
We Know Which 2016 Movie You're Most Excited To See Based On One Question,1,1,13,42,1,13,4,55,0
Less-educated Middle-age US Whites Dying Younger Than Others,1,3,9,42,2,7,0,51,0
"Indian Man Who Groped A Lady On US Bound Flight, Begged Her To Forgive Him For The Sake Of His Kids In A 6-Page Letter",1,2,26,65,2,24,1,91,0
"Bollywood Bids Goodbye To Om Puri, Justin Bieber To Perform In India This Year And More From Ent!",1,2,18,60,2,17,0,78,0
32 Impossibly Delicate Engagement Rings That Are Utter Perfection,1,1,8,47,0,8,2,55,0
A Guy Surprised His Girlfriend With Corgis And It's The Best Thing Ever,1,1,13,45,1,12,0,58,0
Trump presidency: Opponents boosted by 'rage donation',1,3,2,43,3,6,0,45,0
19 Food Truths Only Texans Would Understand,1,1,6,29,0,6,2,35,0
19 Hideaways Where You Can Clear Your Head In London,1,1,9,32,0,9,2,41,0
People Get The Tattoos They Regret Covered Up,1,1,8,30,0,7,0,38,0
The New Genre Of Trans Women's Memoirs: Lives Beyond Our Identities,1,1,11,44,2,10,0,55,0
"Hollywood Director Joss Whedon Sexualizes, Mocks Young Cancer Survivors Meeting with Paul Ryan",1,3,12,69,1,12,0,81,0
35 Fucking Infuriating Things That Happen In Every Rom-Com,1,3,9,38,1,8,2,47,0
Do You Suck At Being Canadian,1,1,6,18,0,5,0,24,0
The non-apology of the year award goes to Nobel scientist who thinks women just cry all the time,1,3,2,76,1,17,0,78,0
American Airlines Unveils a Cheaper Ticket with a Big Catch: Here’s What You Need to Know,1,2,12,60,2,15,0,72,0
New Cases of FGM Reported Every Hour in UK,1,3,10,24,0,8,0,34,0
How Much British History Do You Actually Know,1,1,8,30,0,7,0,38,0
This Is What Happens At New York Fashion Week's Biggest Queer Runway Show,1,1,13,47,1,12,0,60,0
Justin Bieber Stormed Offstage Because His Fans Wouldn't Let Him Wipe The Floor,1,1,13,53,1,12,0,66,0
19 Snapchats Every Girl Who Shops At Target Has Sent,1,1,9,32,0,9,2,41,0
Revealed: The unexpected and unwanted ingredients in your food - from beef in yoghurt to BONES in your sugar,1,3,7,81,2,18,0,88,0
Shah Rukh Khan’s Opinion On Women Empowerment Is What Everyone Needs To Read Right Now!,1,3,15,56,2,14,0,71,0
Kevin Durant Finally Settles the Longstanding Debate of What Height He Really Is,1,3,11,57,0,12,0,68,0
Ashley Graham Still Loves Naked Dresses,1,3,6,28,0,5,0,34,0
This Graphic Novel Perfectly Describes What It's Like To Be A Teenage Girl,1,1,13,48,1,12,0,61,0
Reporter instantly regrets attempting to broadcast beside a large puddle,1,3,1,62,0,9,0,63,0
Dear People Who Aren't Doing Sober January,1,1,7,28,1,6,0,35,0
"Hey Indians, With Just One Question We Can Tell You If You're A Monster",1,1,14,42,2,13,0,56,0
The 21 Craziest Fan Theories Of 2015,1,1,5,19,0,6,6,24,0
When You Fart At Work,1,1,5,12,0,4,0,17,0
How to Get Patients to Take More Control of Their Medical Decisions,1,3,9,47,0,11,0,56,0
Trump’s To-Do List: What to Expect From an Unexpected President,1,2,9,42,3,9,0,51,0
"Daniel Radcliffe Got All Nostalgic About ""Harry Potter"" And It's Completely Adorable",1,1,12,58,3,11,0,70,0
23 Pictures People Who Haven't Worked Retail Will Never Understand,1,1,9,45,1,9,2,54,0
Watch How Dramatically Makeup Trends Have Changed Throughout History,1,1,9,51,0,8,0,60,0
That Oscars screw-up could have been avoided with this one design change,1,3,2,58,1,11,0,60,0
"Schwarzenegger Quits ‘Celebrity Apprentice’ After One Season, Cites Show’s ‘Baggage’",1,3,10,59,6,9,0,69,0
"What Are The Funniest Cold Opens From ""The Office""",1,1,9,31,2,8,0,40,0
"Taylor Swift Is Being Sued For $42 Million Over The Lyrics To ""Shake It Off""",1,1,14,43,3,14,2,57,0
Here's How To Wrap A Present Like An Actual Adult,1,1,10,29,1,9,0,39,0
60 Minutes' odd journey to North Korean border,1,3,3,33,1,7,2,36,0
Controversial Boxer Tyson Fury Stripped Of Heavyweight Title Just Two Weeks After Winning It,1,1,14,65,0,13,0,79,0
Find Out How Far You Can Drive Your Car on Empty,1,2,10,28,0,10,0,38,0
"24 Times Daisy Ridley Was As Badass In Real Life As She Is In ""Star Wars""",1,1,15,39,2,15,2,54,0
Me Before You Is The Movie That's Going To Emotionally Wreck You,1,1,12,40,1,11,0,52,0
Britney Spears Continues To Perform While Having A Wardrobe Malfunction,1,1,10,52,0,9,0,62,0
Internet Reacts to Cavaliers' Matthew Dellavedova's Huge Game 3 vs. Warriors,1,2,8,54,3,10,1,62,0
8 Ways To Style Your Hair For The Gym That Are Actually Awesome,1,1,12,38,0,12,1,50,0
'Halt and Catch Fire' Episode 2: Mutiny in a man's world,1,2,5,36,4,10,1,41,0
Which Mario Are You Based On Your Zodiac Sign,1,1,9,28,0,8,0,37,0
"Can You Guess The ""Friends"" Episode From The Food",1,1,9,30,2,8,0,39,0
We Know Which Sailor Scout You Actually Are,1,3,8,28,0,7,0,36,0
"Football Aside, Tom Brady Takes Some Really Cute Dad Pics",1,1,10,37,1,9,0,47,0
Buffalo Wild Wings Had to Be Behind Marreese Speights' NBA Finals Missed Dunk,1,3,14,50,1,12,0,64,0
Police: Suspect Killed While Attacking AZ Trooper was in US ‘Illegally’,1,2,11,47,3,10,0,58,0
Can We Guess What You Hate Most Based On How You Swear,1,1,12,31,0,11,0,43,0
Make your guess: How will the Republican health-care bill fare?,1,3,3,48,3,9,0,51,0
"'Famine mannequins', and 7 other times women's high street shops got it totally wrong",1,3,1,66,4,13,1,67,0
15 Of The Absolute Best WWE Matches Of 2015,1,1,9,20,0,8,6,29,0
"Which Mikaelson Sibling From ""The Originals"" Should Be Your BFF",1,1,12,40,2,9,0,52,0
"50,000 People Have Visited This Uber Parody Website That Lets You ""Hire A Hitman""",1,1,13,47,3,13,5,60,0
Watch The Heartbreaking Moment This Raccoon Accidentally Drops His Candy In A Puddle,1,1,13,59,0,12,0,72,0
This Powerful Video Of 6 Women Sharing Their Real Life Stories Will Make You Sit Up And Take Notice,1,3,18,62,0,18,1,80,0
"19 Tweets About Ikea That’ll Make You Say, “Yup, Every Damn Time”",1,3,11,36,5,11,2,47,0
14 Problems Only Overly Nice People Have,1,1,6,26,0,6,2,32,0
"5-Year-Old Loses Part Of Her Finger In An Accident In School, 300 Parents Storm Premises",1,2,15,52,3,14,4,67,0
Can You Guess Which Number Comes Next In The Sequence,1,1,10,34,0,9,0,44,0
Sundance review: 'Ingrid Goes West' is the Instagram horrorshow you fear most,1,3,5,58,3,11,0,63,0
Will Dishonesty Kill Cleantech?,1,2,4,23,1,3,0,27,0
These Are the Most Popular States for Retirees to Move To,1,3,8,39,0,10,0,47,0
The Power of Simple Life Changes to Prevent Heart Disease ,1,3,8,40,0,10,0,48,0
The 27 Most Exciting Books Coming In 2016,1,1,6,22,0,7,6,28,0
21 Faces Anyone Who Works Weekends Knows Too Well,1,1,8,31,0,8,2,39,0
24 Catholic Tweets That Will Make You Laugh So Hard You’ll Have To Go To Confession,1,3,15,50,1,15,2,65,0
"17 ""The West Wing"" Trivia Questions Only True Fans Will Be Able To Answer",1,1,13,43,2,13,2,56,0
18 Things You Probably Don't Know About Working In Santa's Grotto,1,1,10,41,2,10,2,51,0
What's Your Secret Personality,1,1,4,22,1,3,0,26,0
Women Should Not Give Haircuts To Their BFFs... But These Women Did,1,1,14,39,3,11,0,53,0
19 Pictures That Are Way Too Real After A Night Out,1,1,10,29,0,10,2,39,0
Here's the real cost of the '12 days of Christmas',1,3,2,34,3,9,2,36,0
Why goats have weird eyes,1,3,1,20,0,4,0,21,0
Penelope Cruz And Javier Bardem Were The Ultimate Fangirls On Stage With U2,1,1,13,49,0,12,1,62,0
Here Are 19 Insanely Popular Crock Pot Recipes,1,1,7,30,0,7,2,37,0
"23 Things For Anyone Whose Love For ""30 Rock"" Never Died",1,1,9,31,2,10,4,40,0
Man buried alive speaks from beyond the grave,1,3,1,37,0,7,0,38,0
11 Vegan Thanksgiving Sides That Are As Healthy As They Are Delicious,1,1,11,45,0,11,2,56,0
The shocking stories that led Louisiana to ban charging rape victims hefty medical fees,1,2,2,72,0,13,0,74,0
"NFLPA Uses Muslim Ban Hash Tag, Addresses Questions as if Muslim Ban is a Real Thing",1,3,16,52,1,15,0,68,0
16 Excellent Movies To Watch On Netflix That Were Directed By Women,1,1,11,43,0,11,2,54,0
Slovenia is honoring its beloved Melania Trump with her own wine,1,2,3,51,0,10,0,54,0
"17 Facts About ""Robot Chicken"" And Seth Green's Stop-Motion Studio",1,1,10,41,4,9,2,51,0
This spreadsheet full of texts people want to send to their exes is really something special,1,3,1,76,0,15,0,77,0
"How the 20,699-word iTunes T&Cs became this year's hottest graphic novel",1,2,4,49,4,10,5,53,0
Here Are The Stores That Are Actually Closed On Thanksgiving Day,1,1,11,43,0,10,0,54,0
"Trump’s Policy Reversals, in His Own Words ",1,3,6,28,2,7,0,34,0
This Bride Eating A Burger At A Hockey Game In Her Wedding Dress Is All Of Us,1,1,17,44,0,16,0,61,0
New year's resolutions: How to lose the fat and get fit for free,1,2,2,48,2,12,0,50,0
These Are The Healthy Recipes That Won 2015,1,1,7,25,0,7,4,32,0
The Industries Where People Stay In Their Jobs The Longest,1,3,10,39,0,9,0,49,0
How to End the Year on a Positive Financial Note,1,3,6,33,0,9,0,39,0
21 Completely Engrossing Fan Fictions You Won't Be Able To Stop Reading,1,1,11,46,1,11,2,57,0
The place where children can be very unlucky with their names,1,2,1,50,0,10,0,51,0
Who Should Be Your First Celebrity Hookup,1,1,7,28,0,6,0,35,0
19 Tweets About Hanukkah That Will Make You Laugh Out Loud,1,1,10,36,0,10,2,46,0
"Aarhus, Denmark: what to see, plus the best restaurants, bars and hotels",1,2,2,55,4,11,0,57,0
Got a sweet tooth? Why waiting 25 seconds removes a craving for chocolate,1,3,2,56,1,12,2,58,0
How Do You Know a Populist When You See One?: QuickTake Q&A,1,2,13,32,3,11,0,45,0
26 Things You Know If You're Slightly Obsessed With Candles,1,1,9,38,1,9,2,47,0
23 Soccer Players Who Forgot How To Human,1,1,7,25,0,7,2,32,0
Pakistan Finally Starts To Build Its First Warship + 5 Other Major Stories From Today,1,2,13,56,1,14,1,69,0
3 Types Of Awful Co-Workers And How To Deal With Each,1,2,11,30,1,10,1,41,0
25 Of The Best Places To Buy Inexpensive Home Decor Online,1,3,10,36,0,10,2,46,0
What to Cook This Week ,1,3,4,14,0,5,0,18,0
21 Of The Worst Things You Can Say To Someone With A Unique Name,1,1,13,36,0,13,2,49,0
25 Ridiculously Romantic Moments That Made Us Cry In 2015,1,1,8,34,0,9,6,42,0
Could There Be a Law Against Excessive Business Travel?,1,3,8,38,1,8,0,46,0
Geraldo Rivera: ‘Nordstrom’s Stabbed Ivanka in the Back’,1,3,6,39,4,7,0,45,0
19 Jokes About “Mr. Brightside” That Are Guaranteed To Make You Laugh,1,2,11,42,3,11,2,53,0
Judge Who Blocked Trump’s Refugee Order Praised for ‘Firm Moral Compass’ ,1,3,10,49,3,11,0,59,0
28 Ways To Add Extra Flavor To Everything You Cook,1,1,9,30,0,9,2,39,0
"When a ghost becomes a zombie: The dating phenomenon, in one screenshot",1,3,2,56,2,11,0,58,0
The Grammys Stop Fighting the Future With 2017 Nominees,1,3,7,36,0,8,4,43,0
Ellen DeGeneres Had Adele Record Her Voicemail Greeting And It's Perfection,1,1,12,52,1,10,0,64,0
Super PACs explained,1,3,4,14,0,2,0,18,0
"‘Fun Home’ takes home five Tonys, including for best musical",1,2,3,45,3,9,0,48,0
"This Guy Shared His Distraught Ex Classmate's Story & We Bet, That You'll Know Someone Like Her",1,3,16,59,4,16,0,75,0
The 28 most expensive homes for sale in the US right now,1,3,3,40,0,11,2,43,0
This 22-year-old is already an engineer with Nasa. What have you done with your life? The list,1,3,4,68,4,16,2,72,0
Camra National Pub of the Year 2017: Yorkshire pub saved from closure by community wins top award,1,3,5,71,1,16,4,76,0
5 gutsy highlights from Carrie Fisher's one-woman show,1,2,2,42,2,7,1,44,0
How Do You Resolve Conflicts In Your Friendships,1,1,8,33,0,7,0,41,0
Aleppo Evacuations Halted as Rebels Open Fire on Convoy,1,3,7,40,0,8,0,47,0
Can You Pass The Cookie Tin Test,1,1,7,19,0,6,0,26,0
HBCU Homecoming Do's And Don'ts,1,1,8,17,2,4,0,25,0
Here's The Evolution Of Barbie's Face Over 56 Years,1,1,8,31,2,8,2,39,0
"2015-2016 Revealed A Strict Side Of Censor Board, 135 Hindi Films Were Given 'A' Certificate!",1,2,13,50,5,14,11,63,0
Which Hogwarts Houses Do These Disney Princes Belong In,1,1,9,38,0,8,0,47,0
Hear Sean Lennon and Willow Smith Sing a Song Co-Written by Carrie Fisher,1,3,11,49,1,12,0,60,0
'I believe my husband was poisoned',1,2,1,27,2,5,0,28,0
Only A Geography Genius Will Get 50/50 On This State Capitals Quiz,1,2,11,39,1,11,4,50,0
19 Times Tumblr Had Hilariously Perfect Timing,1,1,6,32,0,6,2,38,0
17 Dramatic Celebrity Eyebrow Evolutions Of 2015,1,1,5,31,0,6,6,36,0
'Desperate' Australian couples unable to leave Cambodia with surrogate babies,1,2,3,63,2,9,0,66,0
Obama White House Refuses to Call Trump ‘Legitimate’ President,1,3,8,44,2,8,0,52,0
Here's How To Actually Start Lifting Weights,1,1,7,30,1,6,0,37,0
Planned Parenthood Donated to California AGs Behind Investigation of Videomakers,1,3,9,62,0,9,0,71,0
"31 Of The Most Important Moments From The ""Friends"" Reunion",1,1,9,37,2,9,2,46,0
Is Kale Life-Changing Or A Total Disgrace,1,1,8,26,1,6,0,34,0
"What Would Your ""Game Of Thrones"" Name Be",1,1,8,24,2,7,0,32,0
17 Products That Prove You're Raising Your Kids In The Damn Future,1,1,11,41,1,11,2,52,0
"Miley Cyrus’ Next Album Is Going To Be Weird, Y’all",1,3,10,29,3,9,0,39,0
Can We Guess What Chore You Need To Do Based On Your Zodiac Sign,1,1,14,37,0,13,0,51,0
Are Baby Carrots as Healthful as Other Carrots? ,1,3,6,33,1,8,0,39,0
Trevor Noah has a theory about why Trump won't throw the Nationals' opening pitch,1,3,4,62,2,13,0,66,0
21 Minimalist Products That Might Turn You On,1,1,7,29,0,7,2,36,0
Here’s What Therapists Want You To Know About Being Politically Active,1,2,11,48,1,10,0,59,0
"21 Computer Games That Will Make Every ‘90s Girl Say, “Holy Fuck, I Loved Playing That”",1,3,14,49,5,15,4,63,0
"At Least 13,000 Hanged in Mass Executions at Syrian Prison: Amnesty International",1,3,9,54,2,11,5,63,0
The 25 Most Fab Celebrity Looks Of 2015,1,1,6,20,0,7,6,26,0
Men Talk About Crushes On Friends,1,1,6,22,0,5,0,28,0
"The Cast Of ""Sherlock"" In The Victorian Age Vs. 2016",1,1,9,27,3,9,4,36,0
The man behind India's '$74m wedding',1,2,2,24,4,5,2,26,0
14 Times People Turned Into Emojis At The Munk Debate,1,1,9,33,0,9,2,42,0
Austerity At The Big Fat Indian Wedding? Bill Seeks To Limit The Spending To Rs 5 Lakh Introduced In Lok Sabha,1,3,20,68,1,20,1,88,0
22 Dogs Who Just Found Their Forever Homes,1,1,7,26,0,7,2,33,0
Gluten-free diets linked to reduced risk of type 2 diabetes,1,3,1,47,1,9,1,48,0
Student creates enormous 'Simpsons' portrait on his college's wintry lawn,1,2,2,59,3,9,0,61,0
"""Jurassic World"" uses bad science - Business Insider",1,2,4,38,3,7,0,42,0
29 Frightfully Genius Ideas For The Spookiest Slumber Party Ever,1,1,9,44,0,9,2,53,0
"John Boyega Completely Lost His Shit When He Watched Himself In The ""Star Wars: The Force Awakens"" Trailer",1,1,18,68,3,17,0,86,0
"34 Reasons Cersei Is The Most Badass ""Game Of Thrones"" Character",1,1,10,40,2,10,2,50,0
What Trump’s Early Days Tell Us About His Path Forward,1,3,10,34,1,9,0,44,0
Pantone Chose Two Colors Of The Year To Represent ~Gender Fluidity~,1,1,11,44,2,10,0,55,0
14 Things We Learned From Caitlyn Jenner’s ‘20/20’ Interview [Video],1,3,8,39,6,9,6,47,0
18 Faces People Who Have Received A Dick Pic Will Immediately Recognise,1,1,11,47,0,11,2,58,0
33 Hilarious Reasons People Actually Cried On Their Period,1,1,8,40,0,8,2,48,0
14 Times You Silently Judge People,1,1,5,22,0,5,2,27,0
12 Moments That Are Too Real For Anyone With An Abuelita,1,1,10,34,0,10,2,44,0
Kendrick Lamar Revealed Title Of His New Album 'DAMN.' Over A Week Ago,1,3,16,39,3,12,0,55,0
Does Putin Still Favor Sidekick Medvedev?,1,2,6,29,1,5,0,35,0
16 Delicious Plantain Recipes That Will Make Your Life Better,1,1,9,41,0,9,2,50,0
13 More Accurate Album Titles,1,1,4,19,0,4,2,23,0
"Which Character From ""The Incredibles"" Are You",1,1,7,31,2,6,0,38,0
Salted Coffee: Is It Less Bitter,1,1,6,20,1,5,0,26,0
How Can You Lose 50+ Pounds,1,1,5,14,1,5,2,19,0
"A ""Pretty Little Liars"" Movie Might Actually Be Coming To Theaters",1,1,11,43,2,10,0,54,0
This portable smart scooter might be better than your car,1,3,1,47,0,9,0,48,0
Here's what pilots look out for when they're passengers The list,1,3,2,50,2,10,0,52,0
"20 Holiday Makeup Looks, Because Sometimes a Girl Needs Options",1,3,8,43,1,9,2,51,0
"A luxury music festival where tickets cost up to $12,000 turned into a nightmare â here's what happened",1,3,1,77,5,17,5,78,0
19 Things Only People Who Don't Drink Coffee Understand,1,1,8,36,1,8,2,44,0
TIME reveals 100 Most Influential People of 2017 — check out full list,1,2,7,43,1,12,7,50,0
"Strangers living ""around the corner"" from each other discover they're sisters",1,3,1,63,3,10,0,64,0
"Who Is Alexander Acosta? Trump Labor Nominee Supports Amnesty, Cheap Foreign Labor",1,3,12,57,2,11,0,69,0
How People Really See You,1,1,5,16,0,4,0,21,0
Net Neutrality Critic Ajit Pai Named New FCC Chairman,1,3,11,34,0,8,0,45,0
We Know What Your Art Major Should Be Based On This Color Test,1,3,13,37,0,12,0,50,0
Here's What You Should Know About Kate DiCamillo's New Novel,1,1,11,38,2,9,0,49,0
Cuffing Season Is Coming,1,1,4,17,0,3,0,21,0
28 Things You’ll Only Understand If You Have A Labrador,1,3,9,34,1,9,2,43,0
How to Protect Against Tax-ID Theft ,1,2,7,22,1,6,0,29,0
Can You Get Through This Post Without Becoming Sexually Attracted To Cheese,1,1,12,52,0,11,0,64,0
Little Kid Breaks Opponent's Ankles with Nasty Crossover,1,2,7,41,1,7,0,48,0
Your sofa can give you CANCER: Materials used to fireproof settees are linked to a 74% rise in thyroid tumours,1,3,8,79,2,19,2,87,0
15 Beloved TV Shows We Said Goodbye To In 2015,1,1,9,22,0,9,6,31,0
3 things every man should avoid wearing this winter,1,3,0,42,0,8,1,42,0
Jaromir Jagr: Florida Panthers winger moves second behind Wayne Gretzky,1,2,6,55,1,9,0,61,0
Second Detroit Doctor Busted in Female Genital Mutilation Ring,1,3,8,46,0,8,0,54,0
"The Russians Hacked Democrats’ Plans to Cheat in the General Election, Too",1,3,9,52,2,11,0,61,0
"Young Thug's Video For ""Wyclef Jean"" Isn't What You'd Expect",1,2,10,36,5,9,0,46,0
Can We Guess Your Age And Where You Live Based On Your Taste In Music,1,1,15,40,0,14,0,55,0
Oscars 2017: Truth behind 'Envelopegate' emerges,1,3,3,33,3,5,4,36,0
"No silly human, you may not take this cat's hard-earned money",1,3,1,47,3,10,0,48,0
A Surprise Snowstorm Turned This Couple's Wedding Into A Winter Wonderland,1,1,11,52,1,10,0,63,0
Hunger Games Stars Honor Paris Victims With Mockingjay Pins,1,1,9,42,0,8,0,51,0
Is This Kendall Jenner Falling On Her Literal Head?,1,3,9,33,1,8,0,42,0
Saturday Night Live Proved Adele Is The Only One Who Can Unite Us All,1,1,14,42,0,13,0,56,0
Here Are the Wealthiest Zip Codes in Every State,1,3,7,33,0,8,0,40,0
People Are Pretending To Faint In Front Of Their Dogs To See How They React,1,1,15,46,0,14,0,61,0
10 Quizzes To Take With Your Family This Holiday Season,1,1,9,35,0,9,2,44,0
We Know What Funny Dog GIF You Need To See Based On Your Zodiac,1,1,16,34,0,13,0,50,0
9 Things You Never Knew About The Fabulous Angela Bassett,1,1,9,38,0,9,1,47,0
"Ezekiel Elliott laments pace of NFL's probe, wants 'closure'",1,2,5,43,4,8,0,48,0
7 Insanely Cool Halloween Treats That You Can Actually Make,1,1,9,40,0,9,1,49,0
16 Snapchats All Long Distance BFFs Have Sent,1,1,9,27,0,7,2,36,0
19 Quick And Healthy Salmon Dinners That Anybody Can Make,1,1,9,37,0,9,2,46,0
Steyn: Expect More Beating-Type Incidents as Long as the Left Is Invested in Identity Politics,1,3,12,66,2,14,0,78,0
Did Shia LaBeouf Or James Franco Do This Crazy Thing?,1,3,11,32,1,9,0,43,0
The 17 Most Hilarious Tweets About Astrology From 2015,1,1,7,33,0,8,6,40,0
16 Facts That Don't Sound Right But Are Actually True,1,1,9,32,1,9,2,41,0
11 Times When You Can't Even,1,1,5,15,1,5,2,20,0
I tried 23andMe's new genetics test â and now I know why the company caused such a stir,1,3,3,64,3,17,2,67,0
Democrats Bet on Buyer’s Remorse In Trump Speech Response,1,3,8,40,1,8,0,48,0
Warren Buffett: America Will Be Fine Under Trump,1,3,8,32,1,7,0,40,0
18 Ways You Know You're The Mom Of Your Friend Group,1,1,10,29,1,10,2,39,0
12 Charts Everyone Who's Ever Drank Alcohol Will Understand,1,1,8,40,1,8,2,48,0
"We Played ""Never Have I Ever"" With Tamar And Adrienne From ""The Real""",1,1,13,40,4,12,0,53,0
Survey Points to Challenges NATO Faces Over Russia ,1,3,10,33,0,8,0,43,0
"These three ""killer apps"" could help humans colonize Mars",1,3,2,45,2,8,0,47,0
The look on this man's face in Melania Trump's latest tweet is actually perfect,1,3,3,61,2,13,0,64,0
We Know How Addicted You Are To Social Media Based On One Question,1,1,13,41,0,12,0,54,0
Lawyer: Racist Note Given To Black Waitress is Fake,1,3,8,34,1,8,0,42,0
Are there toxins in your fast food packaging?,1,3,1,36,1,7,0,37,0
You Deserve It,1,1,3,9,0,2,0,12,0
23 Things Every Black Person Who Grew Up In The South Knows To Be True,1,1,14,40,0,14,2,54,0
23 Perfect Gifts For Anyone Obsessed With Butts,1,1,7,31,0,7,2,38,0
‘Pantsuit Nation’: Hillary Facebook Group Gets Book Deal — and Some Members Are Livid,1,3,12,56,4,13,0,68,0
41 Dollar-Store Hacks Every Parent Should Know About,1,1,8,34,1,7,2,42,0
23 Accidental Google Image Searches That’ll Make You Pee A Little,1,3,10,42,1,10,2,52,0
"As Japan Battles Deflation, a Bitter Legacy Looms",1,2,7,34,1,7,0,41,0
Can We Tell If Your Phone Screen Is Cracked,1,1,9,26,0,8,0,35,0
5 Things We Hope to See From Lorde's 'Saturday Night Live' Appearance,1,3,10,44,3,11,1,54,0
"Risky behavior declines with age, and gray matter may explain why",1,2,1,53,1,10,0,54,0
An Expert Take on Performing Under Pressure,1,2,6,31,0,6,0,37,0
20 Times Conan O'Brien Completely Owned Twitter,1,1,7,31,1,6,2,38,0
"When it comes to Israel, stakes are high for Jared Kushner",1,3,4,43,1,10,0,47,0
Trump’s approval hits a new low of 36 percent — but that’s not the bad news,1,3,1,54,3,15,2,55,0
Which 2015 Pop Hit Are You,1,1,5,12,0,5,4,17,0
These Random Questions Will Determine Your Sexual Vibe,1,1,8,39,0,7,0,47,0
Best Albums of 2017 So Far: 27 Staff Picks,1,3,6,21,1,8,6,27,0
"New Day, weekdays 6-9am ET Mom fights back against anti-Clinton meme using daughter's picture",1,3,6,68,4,13,2,74,0
22 Nature Photos Taken In 2015 That Will Blow You Away,1,1,9,29,0,10,6,38,0
24 Times The Internet Couldn't Handle The Apple Pencil,1,1,8,35,1,8,2,43,0
The Daily Show's Jordan Klepper is getting a late night spinoff series,1,3,5,53,1,11,0,58,0
Watch Live: Briefing with Attorneys of United Airlines Passenger Forced off Plane,1,3,9,60,1,11,0,69,0
Pope Francis: ‘Muslim Terrorism Does Not Exist’,1,2,7,31,3,6,0,38,0
"Swami Om Threatens Bigg Boss Makers, SRK Teases Fans With 'O Zalima' Teaser And More From Ent",1,3,19,55,3,16,0,74,0
Here's What Really Happens to Professional Athletes After They Retire,1,3,9,50,1,9,0,59,0
9 Charts All Makeup Lovers Can Totally Relate To,1,1,8,31,0,8,1,39,0
Did You Actually Have Sex On Your Wedding Night,1,1,9,30,0,8,0,39,0
Here Is One Direction Singing One Direction In A Car With James Corden,1,1,13,45,0,12,0,58,0
High School Softball Catcher Gets Away with Leveling Pair of Baserunners,1,3,9,53,0,10,0,62,0
What is it with Trump and handshakes? This is getting awkward,1,3,3,47,1,10,0,50,0
The Top Myths About Sun Protection,1,2,6,23,0,5,0,29,0
"Definitive Proof ""Titanic"" And ""Peter Pan"" Are Almost The Same Movie",1,1,11,43,4,10,0,54,0
"Britney Spears Dances To ""Hello,"" Makes Adele Relevant Again",1,1,9,40,3,8,0,49,0
Africa's top shots: 8-13 April 2017,1,2,2,18,3,5,7,20,0
How Well Do You Really Know These Champions League Clubs' Logos,1,1,11,41,1,10,0,52,0
This Is What It's Like To Have Hypochondria,1,1,8,27,1,7,0,35,0
Can You Beat The 2015 Taylor Swift Challenge,1,1,7,26,0,7,4,33,0
61 Impossibly Tiny And Tasteful Tattoos,1,1,5,27,0,5,2,32,0
100 Years Of Family Dinner,1,1,4,15,0,4,3,19,0
Netanyahu: ‘All Signs’ Indicate Jerusalem Truck Terrorist was ‘Backer of Islamic State’,1,3,10,61,5,11,0,71,0
18 Charts That Will Speak To Anyone Who's Nailing This Whole Healthy Thing,1,1,12,47,1,12,2,59,0
Tons of juice flood Russian town after factory accident,1,2,2,45,0,8,0,47,0
"17 ""Nude"" Beauty Products That Actually Look Amazing On Brown Skin Tones",1,1,11,46,2,11,2,57,0
"That Rainbow Bagel Store Has Shut Down ""Indefinitely""",1,1,8,36,2,7,0,44,0
These Kahlua Fudge Brownies Just Want To Be Loved,1,1,9,32,0,8,0,41,0
Thoughts Everyone Has In Public Bathrooms,1,1,6,30,0,5,0,36,0
18 Wacky 'Star Wars' Gifts,1,3,4,14,2,4,2,18,0
32 Of The Year's Most Amazing Science Pictures,1,1,7,29,1,7,2,36,0
"Tebow Launches Several Homers in Batting Practice, During First Day of Mets Spring Training",1,3,12,65,1,13,0,77,0
"We Know Who You Should Date, Based On Your Favorite Color",1,1,11,35,1,10,0,46,0
Women Discuss Kissing On First Dates,1,1,6,25,0,5,0,31,0
Rex Tillerson: What Trump's top diplomat really believes,1,3,4,43,2,7,0,47,0
Can You Name These Disney Villains By Just Looking At Their Hands,1,1,12,42,0,11,0,54,0
Poll: What's The Best Karaoke Song Of All Time,1,1,9,27,2,8,0,36,0
BBC Presenter Given Warning after Saying Transgender People Can Never Be ‘Real Women’,1,2,14,57,2,12,0,71,0
7 of the most expensive degrees in the world,1,3,0,35,0,8,1,35,0
19 times nature was completely terrifying in 2016,1,2,0,36,0,7,6,36,0
How Many Of These Food Network Stars Would You Sleep With,1,1,11,36,0,10,0,47,0
"Chelsea Handler Shares Her Own Experiences With Drugs In ""Chelsea Does""",1,1,11,48,2,10,0,59,0
21 Hot Guys Who Agree This Week Totally Sucked,1,1,8,28,0,8,2,36,0
Which TV Bromance Are You And Your BFF,1,1,11,20,0,7,0,31,0
A Dutch Organization Is Providing Free Abortions For Women In Zika-Affected Regions,1,1,13,58,1,11,0,71,0
21 Jokes That Are Hilariously Accurate For Anyone Who Loves Food Network,1,3,11,48,0,11,2,59,0
How Howard Schultz Earned More Than Half a Billion Dollars in Nine Years,1,3,11,49,0,12,0,60,0
17 Of The Most Infuriatingly Unrealistic Cliches Used In Movies,1,1,9,43,0,9,2,52,0
The 6 Countries You Must Visit Since Their Currencies Got Cheap Last Year,1,3,12,48,0,12,1,60,0
20 Things The World Wouldn't Have If Black People Didn't Exist,1,1,10,38,2,10,2,48,0
Biggest Celebrity Feuds of 2016,1,3,3,20,0,4,4,23,0
"How Well Do You Remember ""Scream 2""",1,1,6,20,2,6,1,26,0
27 DIY Jewelry Projects That Are Actually Easy,1,1,9,28,0,7,2,37,0
"Real or not? There's a new Mickey Mantle, Rangers won't make the playoffs",1,2,5,52,4,12,0,57,0
"17 Cats On Craigslist That Will Make You Go ""Me""",1,1,9,26,2,9,2,35,0
People Spoon With Professional Cuddlers For The First Time,1,1,9,41,0,8,0,50,0
"Feast Your Eyes On This Really Cute ""Mr. Robot"" Gag Reel",1,1,11,32,3,10,0,43,0
16 Delightful Family Holiday Traditions From Around The World,1,1,8,43,0,8,2,51,0
'We're not going to be silent': Why scientists are marching this weekend,1,3,2,55,4,11,0,57,0
These Two Places In India Are Already Living PM Modi's Dream Of Cashless Economy,1,3,15,51,1,13,0,66,0
Hidden treasures: Why Chinese ceramics sell for millions,1,2,3,45,1,7,0,48,0
13 Insanely Delicious Reasons Not To Light Any Fireworks This Diwali,1,1,10,46,0,10,2,56,0
This Sick Dad Surprised His Daughter By Making It To Her Cross-Country Wedding,1,2,14,51,1,12,0,65,0
Why The Hole Is The Best New Emoji,1,1,8,19,0,7,0,27,0
Why I Hate Camping,1,1,4,11,0,3,0,15,0
24 Situations That Will Make You Cringe Until You Cry,1,1,9,33,0,9,2,42,0
The Stages Of An All-Nighter,1,1,6,17,1,4,0,23,0
PewDiePie taught YouTube a valuable lesson,1,2,5,32,0,5,0,37,0
Pentagon to NATO: ‘We Want Everyone to Pay Their Fair Share’,1,3,12,35,3,10,0,47,0
NBA star apologizes to everyone but the person he screamed at,1,3,3,48,0,10,0,51,0
If Canadians Were Honest On Snapchat,1,1,6,25,0,5,0,31,0
21 Precious Moments Every Close Mother And Daughter Share,1,1,8,39,0,8,2,47,0
"Which Hogwarts Houses Do The Characters Of ""Hamilton"" Belong In",1,1,10,42,2,9,0,52,0
"I'm An Atheist, But I'm Not",1,1,6,13,3,5,0,19,0
"This Is How You Do Waffles, That's All",1,1,8,21,2,7,0,29,0
21 Awesome '80s Girls Toys That Are Worth A Small Fortune Now,1,1,10,35,1,11,4,45,0
Can You Identify The 2016 Movie By The Comment On Its YouTube Trailer,1,1,13,40,0,12,4,53,0
This One Trick Let's You Add Live Photos to Instagram,1,2,9,34,1,9,0,43,0
Models Are Fashion’s Secret Social-Media Weapons,1,2,7,34,2,5,0,41,0
The difference between the UK and US in 14 pictures The list,1,2,6,41,0,11,2,47,0
These 18 big websites fail the space-bar scrolling test,1,3,1,43,1,8,2,44,0
I Ate At The Spiciest Ramen Shop In Tokyo And Actually Turned Red,1,1,13,40,0,12,0,53,0
How Trudeau Is (Kind of) Legalizing Pot in Canada,1,3,7,32,2,8,0,39,0
Phil and Jeanie -- basketball's ultimate power couple -- call it quits,1,3,2,52,5,11,0,54,0
15 Snapchats Only People From California's Central Valley Would Send,1,1,9,47,1,9,2,56,0
Which BuzzFeed Violet Character Are You,1,1,7,27,0,5,0,34,0
Posh Spice And Nicki Minaj Praised Adele For Her Epic Covers,1,1,11,39,0,10,0,50,0
"USF Basketball Team Accidentally Leaves Troy Holston, Geno Thorpe at Airport",1,2,12,53,1,10,0,65,0
Katy Perry new song 2017: You can listen to ‘Chained to the Rhythm’ now but you’ll have to work for it,1,3,5,69,4,20,4,74,0
Advice Revealed: The worst airline baggage charges (including £78 for a backpack),1,3,3,61,4,11,2,64,0
From Caitlyn Jenner to a Brooklyn High School ,1,2,6,32,0,8,0,38,0
Kittens Trying To Wear Hats And Failing Is Insanely Cute,1,1,10,37,0,9,0,47,0
14 Weird But Wonderful Antique Girls' Books,1,1,6,28,1,6,2,34,0
80 Katy Perry Lyrics That Make Seriously Perfect Instagram Captions,1,1,9,47,0,9,2,56,0
This Is What A Donald Trump Coloring Book For Adults Looks Like,1,1,12,40,0,11,0,52,0
What Trump's Libertarian Pals Don't Understand About The FDA -- Or Reality,1,3,13,46,4,11,0,59,0
19 Reasons To Be Thankful For Your Dog,1,1,7,22,0,7,2,29,0
World's first penis transplant patient is set to become a FATHER after announcing his girlfriend is pregnant,1,3,7,84,1,16,0,91,0
India May Not Be Able To Buy Defence Equipment From Russia Because Of US Sanctions,1,3,16,52,0,14,0,68,0
You Won't Believe Who Trump Dressed As for 'Superhero' Costume Party  Insider,1,3,11,51,3,12,0,62,0
"12 Perfect Vacations You Can Take In India To Detox, Disconnect, And Get Refreshed",1,1,13,52,2,13,2,65,0
These 40 cars prove Geneva is the best auto show in the world,1,2,2,45,0,12,2,47,0
Ed Westwick Showed Up To An Emmys Party Looking Like The Chuck Bass Of Your Dreams,1,1,16,51,0,15,0,67,0
Station Wagons Are Back to Cure SUV Fatigue,1,2,9,27,0,7,0,36,0
Here’s Where London Bankers Are Moving After Brexit,1,3,8,35,1,7,0,43,0
Stimulating Facts About The G-Spot,1,1,6,23,1,4,0,29,0
How to Improve Your Productivity at Work - Business Guides ,1,3,7,41,1,10,0,48,0
Chris Hemsworth Is Grappling With No Longer Being The Sexiest Man Alive,1,1,12,48,0,11,0,60,0
President Trump's 'Obamacare nightmare' in his own words,1,3,3,43,3,7,0,46,0
Voices From Rural America on Why (or Why Not) to Go to College ,1,3,9,39,2,13,0,48,0
The 20 best tech jobs in America right now,1,3,2,30,0,8,2,32,0
25 Indie Albums That Are Still Amazing 10 Years Later,1,1,8,32,0,9,4,40,0
24 Times Dogs Were Too Good For Us,1,1,7,18,0,7,2,25,0
Florida Continued To Be The Worst In 2015,1,1,7,23,0,7,4,30,0
"Will Ferrell Is Now An Exotic Animal Expert For ""The Late Show""",1,1,12,38,2,11,0,50,0
What life’s like when your children never grow up,1,3,1,39,1,8,0,40,0
27 Positions Every Single Person Has Been In Before,1,1,8,33,0,8,2,41,0
Here's The Epic Road Trip That Lets You Spend The Whole Year In 70-Degree Weather,1,1,15,48,2,14,2,63,0
YouTube Hoaxster Adam Saleh Claims Delta Flight Booted Him for ‘Speaking Arabic’,1,3,12,55,2,11,0,67,0
This Artist Has Perfectly Reimagined Disney Animals With Human Personalities,1,1,10,57,0,9,0,67,0
Why an X-Men comic has ignited political debate in Indonesia,1,3,4,46,1,9,0,50,0
DNC Chair Perez: Trump Immigration Order a ‘Racist’ Action Against Muslims,1,3,12,49,3,10,0,61,0
What Was Your Name In Your Previous Life,1,1,8,25,0,7,0,33,0
31 Of The Most Heartwarming Books You’ll Ever Read,1,2,8,31,1,8,2,39,0
Wendy Williams Attempts To Guess 16 Terrible Celebrity Paintings,1,1,8,46,0,8,2,54,0
10 Comics Only Servers Will Understand,1,1,5,26,0,5,2,31,0
Kendall Jenner Shared A Photo Of Her Boob On Instagram,1,1,10,35,0,9,0,45,0
Tens of thousands marched for science. Now what?,1,3,2,37,2,7,0,39,0
Should Australians be able to opt out of Medicare? This professor thinks so,1,3,4,58,1,12,0,62,0
Gwyneth Paltrow Offers Tips on Achieving ‘Orgasm Equality’,1,2,7,42,2,7,0,49,0
This American Was Shocked When His Facebook Post About England Went Viral,1,1,12,50,0,11,0,62,0
19 People Who Prove Rainbow Eyebrows Are Insanely Gorgeous,1,1,8,40,0,8,2,48,0
It's 2015 And These Words Should Be Added To The Dictionary Now,1,1,11,36,1,11,4,47,0
How Many Of These Halloween Movies Have You Actually Seen,1,1,10,38,0,9,0,48,0
Watch Footage Of Two Sikh Men Unraveling Their Turbans To Rescue Four Drowning Boys,1,1,14,56,0,13,0,70,0
"Move over hipsters, here comes the ""yuccie""",1,2,1,33,3,6,0,34,0
19 Tweets About Tea That Will Speak To Your Soul,1,1,9,28,0,9,2,37,0
Can We Talk About How Woke Matt McGorry Was In 2015,1,1,11,26,0,10,4,37,0
9 Insanely Smart Shopping Hacks To Help You Win Black Friday,1,1,10,39,0,10,1,49,0
16 Things Dudes Need To Stop Wearing In 2016,1,1,7,23,0,8,6,30,0
"Meet Diane Warren, Whose Songs You've Been Ruining At Karaoke For Years",1,1,12,46,2,11,0,58,0
Which Hogwarts House Would You Sort These Politicians Into,1,1,9,41,0,8,0,50,0
Do You Actually Give No Fucks,1,1,6,18,0,5,0,24,0
The map of the world according to where prostitution is legal The list,1,2,2,56,0,12,0,58,0
The Dystopia Project: 'It Can't Happen Here' -- and it hasn't yet,1,3,7,40,7,11,0,47,0
Asking For Help In A System That Doesn't Speak Your Language,1,1,11,38,1,10,0,49,0
"When using headphones to listen to music, how loud is too loud for kids?",1,2,1,56,2,13,0,57,0
The 19 Wildest Fanfics People Couldn't Stop Reading In 2015,1,1,8,35,1,9,6,43,0
We Know Your Favorite Holiday Tradition Based On This One Question,1,1,11,45,0,10,0,56,0
Benedict Cumberbatch Imitated An Otter And Then Punched A Teddy Bear,1,1,11,47,0,10,0,58,0
Obama Administration Scraps Entry-Exit Tracking System for Migrants from Muslim Countries,1,2,10,68,1,10,0,78,0
17 People Who Have Literally No Idea What They're Getting For Christmas,1,1,11,46,1,11,2,57,0
"Shahid-Mira's Cute Banter, Dangal's National Anthem Leaves Twitterati In A Fix & More From Ent!",1,2,15,60,6,14,0,75,0
Four ways technology is transforming the museum experience,1,3,1,50,0,7,0,51,0
"Here Are The New Queens Of ""RuPaul's Drag Race"" Season 8",1,1,11,31,3,10,1,42,0
Naomi Campbell Posed Nude For A Magazine And It Is Everything,1,1,11,40,0,10,0,51,0
Brutally honest ad for a 2002 Oldsmobile brings the internet infinite joy,1,2,2,56,0,11,4,58,0
19 Shameless Things That Happen When You Become Obsessed With A Band,1,1,11,44,0,11,2,55,0
Philadelphians reeling over city's new sugary drink tax,1,2,1,46,1,7,0,47,0
19 Weird AF Questions That Actually Kinda Make Sense,1,2,9,33,0,8,2,42,0
I Tried Living Like Ina Garten For A Week To Become A Better Spouse,1,1,14,40,0,13,0,54,0
Hannah Hart Volunteered With Kittens And It Was Too Adorable,1,1,10,41,0,9,0,51,0
Investment Guide 2017,1,3,2,13,0,2,4,15,0
19 Things Every Eyeliner Addict Knows To Be True,1,1,8,30,0,8,2,38,0
Lady Gaga Shows Companies How To Make A Comeback,1,3,9,31,0,8,0,40,0
Facts You May Not Know About This Day In History,1,1,10,29,0,9,0,39,0
This Is How Old Some Of Your Favorite TV And Movie Characters Will Be In 2016,1,1,16,42,0,15,4,58,0
Doing this turns children into narcissists The list,1,2,2,42,0,7,0,44,0
NBA Player Power Rankings: B/R's Top 30 Shooting Guards at the Halfway Point,1,2,13,46,3,12,2,59,0
We Rated 16 Of 2015's Celebrity Thirst Traps,1,1,6,24,1,7,6,30,0
"It's Official, Neil Nitin Mukesh To Play Aamir Khan's Role In Dil Chahta Hai. Wait, What?",1,3,16,52,6,15,0,68,0
"Teachers, What's The Best Halloween Costume You've Ever Had",1,1,9,39,3,8,0,48,0
Here's What YouTubers Have To Say About Mental Health,1,1,10,34,1,8,0,44,0
7 Insanely Easy Organizing Tricks You'll Actually Want To Try,1,1,9,41,1,9,1,50,0
15 Mistakes You're Making When Trying To Lose Weight,1,3,8,33,1,8,2,41,0
Zhou Yongkang trial exposes Chinese officials' links with mystic,1,2,3,52,1,8,0,55,0
12 Things Salvadoran Americans Are Tired Of Hearing,1,1,7,35,0,7,2,42,0
21 Pictures That Are Too Real For People Who Hate Driving,1,1,10,35,0,10,2,45,0
"8 Habits That Make Millennials Stressed, Anxious And Unproductive",1,3,8,47,1,8,1,55,0
For Everyone That Fell In Love With Niall Horan In 2015,1,1,10,31,0,10,4,41,0
23 Things Only '90s Kids Had On Their Christmas Lists,1,1,8,31,1,9,4,39,0
"In Past 50 Days, 22 Militants Killed In J&K But We Lost 26 Soldiers + 5 Other Stories Of The Day",1,3,17,49,3,20,7,66,0
Chickens Come Home to Roost: Massive Layoffs Predicted for ESPN Broadcasters,1,2,12,53,1,10,0,65,0
"16 Times ""This Is England '90"" Made You Feel All The Feelings",1,1,10,33,3,11,4,43,0
Netanyahu: ‘Signs’ UN May Attempt Another Anti-Israel Resolution Within Weeks,1,2,12,52,4,9,0,64,0
Here’s the real story about the Churchill bust in the Oval Office,1,2,4,49,1,11,0,53,0
This Person Might Have Robbed Graves And Tumblr Is Going Insane,1,1,11,42,0,10,0,53,0
If The Avengers Looked Like They Originally Did In The Comics,1,1,11,40,0,10,0,51,0
"If you blinked during Apple's WWDC keynote, you missed the HealthKit and HomeKit updates",1,3,10,63,2,13,0,73,0
13 Stages Of Getting Over The One That Got Away,1,1,9,27,0,9,2,36,0
21 Hilarious Tweets About TV That Will Make You Laugh Every Time,1,1,12,39,0,11,2,51,0
22 Pictures People Without Roommates Will Never Understand,1,1,7,42,0,7,2,49,0
Only Johnny Manziel could conduct an illegal workout with a CFL team,1,2,6,51,0,11,0,57,0
U of Michigan Professor Claims that the English Language Is ‘Sexist’,1,3,8,48,2,10,0,56,0
"What's The Best ""Yahoo Answers"" Question You've Ever Seen",1,1,9,36,4,8,0,45,0
23 Things Only Pregnant Women Will Find Funny,1,1,7,29,0,7,2,36,0
Penn State President Claims MILO Creating ‘Anti-Free Speech Movement’,1,3,13,45,3,8,0,58,0
18 Ways You Can Help A Loved One Going Through A Hard Time,1,1,12,32,0,12,2,44,0
21 Insanely Hot Dishes Guaranteed To Spice Up Your Life,1,1,9,35,0,9,2,44,0
5 Dads and Their Awesomely Bad Dance Moves [Video],1,3,7,32,2,8,1,39,0
Lilly Singh: How a 28-year old Canadian rapped and vlogged her way into the Youtuber millionaire's club,1,2,5,77,3,16,2,82,0
17 Easy Steps To Wow Your Lover This Valentine's Day,1,1,9,31,1,9,2,40,0
Jennifer Lawrence Has Never Looked Better Than She Did Last Night,1,1,11,44,0,10,0,55,0
Extreme Phone Pinching Is Possibly The Most Nerve-Racking Internet Craze Yet,1,1,12,53,1,10,0,65,0
Here's What You Should Watch On Netflix During The Blizzard,1,1,10,39,1,9,0,49,0
"Do You Know The Lyrics To ""Hello"" By Adele",1,1,9,23,2,8,0,32,0
17 Things You Should Never Say To A Female Football Fan,1,1,10,33,0,10,2,43,0
"Kris Jenner Swims Around In A Pool To ""Trap Queen"" For LOVE Magazine",1,1,16,38,2,12,0,54,0
When And How You Should Ask For A Raise: The Dos And Don'ts,1,3,13,32,2,12,0,45,0
Girl who lost all her hair dazzles with inspiring response at school ,1,3,1,56,0,12,0,57,0
These Are (Probably) The Biggest Parenting Trends Of 2016,1,1,8,35,2,8,4,43,0
"Best Christmas movies on Netflix, including Die Hard and Home Alone",1,3,7,49,1,10,0,56,0
"21 Gifts For The ""Sims"" Addict In Your Life",1,1,8,23,2,8,2,31,0
"Republicans, Flynn, Syria: Your Thursday Evening Briefing ",1,3,7,41,3,7,0,48,0
Stop Messing With Your Ears,1,3,5,18,0,4,0,23,0
George Takei Is Still Waiting For Donald Trump To Come See His Musical,1,1,13,45,0,12,0,58,0
"7 Earth-Size Planets Orbit Dwarf Star, NASA and European Astronomers Say ",1,3,13,46,2,11,1,59,0
29 Pairs Of Impossibly Gorgeous Heels To Wear On Your Wedding Day,1,1,11,41,0,11,2,52,0
18 People Who Forgot There Was Already A Word For That,1,1,10,32,0,10,2,42,0
This 'Game of Thrones' statue is the stuff nightmares are made of,1,2,3,49,2,11,0,52,0
9 Hand Signs That Will Make Your Everyday Life Easier,1,1,9,34,0,9,1,43,0
23 Adorably Awkward Things Shawn Mendes Tweeted In 2015,1,1,7,34,0,8,6,41,0
"For more than a year, this woman lived in a $1.2 million home with her sister’s corpse",1,2,1,63,4,16,2,64,0
21 Vines That Will Make You Question Your Entire Existence,1,1,9,38,0,9,2,47,0
Here's How To Actually Get Rid Of Acne All Over Your Body,1,1,12,33,1,11,0,45,0
"Brady Campaign to Donald Trump: We Don’t Need Your Prayers, We Need Gun Control",1,3,13,50,3,13,0,63,0
Gender Politics: Which Sex Said It,1,1,6,22,1,5,0,28,0
New Year: The best photos from around the world,1,3,3,35,1,8,0,38,0
Mark Levin on Trump Wiretapping Claims: ‘The Evidence Is Overwhelming’,1,3,9,49,3,9,0,58,0
Can You Name The Movie From Its Most Commonly Used Words,1,1,11,35,0,10,0,46,0
What to do when your child has an allergy emergency,1,3,1,41,0,9,0,42,0
Top 50 EDM Love Songs of All Time,1,2,8,16,0,7,2,24,0
HEALTHCARE EXPERT: Hereâs how to avoid getting hit with surprise medical bills,1,3,17,49,3,11,0,66,0
7 Other Times French Montana Put His Foot In His Mouth,1,3,10,33,0,10,1,43,0
This Food Test Will Tell You If You're A True Los Angeles Foodie,1,1,13,38,1,12,0,51,0
The Most Successful People In Business Do This,1,3,8,31,0,7,0,39,0
"Ten Arrested, Including Four Illegal Aliens, After ‘Savage’ Gang-Related Killing of Maryland Teen",1,3,13,67,5,12,0,80,0
"Your Self Care Routine Should Include BuzzFeed's ""Another Round"" Podcast",1,1,11,49,3,9,0,60,0
One thing Wall Street interns value more than which bank they get into - Business Insider,1,3,5,68,1,15,0,73,0
Sex Dolls That Talk Back ,1,3,5,15,0,5,0,20,0
Why Facebook tracks internet outages around the world,1,2,2,44,0,7,0,46,0
How Well Do You Know Carrie Underwood,1,1,7,24,0,6,0,31,0
Which Newly Revealed Wizard School Should You Study Abroad At,1,1,10,42,0,9,0,52,0
Can We Guess Your Name Based On Your Taste In Men,1,1,11,28,0,10,0,39,0
"Fliers, Do You Know Your Rights? ",1,3,6,19,2,6,0,25,0
Saul Williams On The Politics Of Race And Poetry In America,1,1,11,38,0,10,0,49,0
60 Thoughts You Have When You Try To Knit A Present,1,1,10,29,0,10,2,39,0
Lucky Charms With Just The Marshmallows Are Actually A Real Thing,1,1,11,44,0,10,0,55,0
Which Famous Vampire Should You Date Based On Your Zodiac Sign,1,1,11,41,0,10,0,52,0
Cara Delevingne And Annie Clark Together At London Fashion Week Will Literally Make Your Heart Ache With Joy,1,1,18,73,0,17,0,91,0
The social media problems gripping our girls,1,3,1,37,0,6,0,38,0
This Inkblot Test Will Reveal Your Actual Issues,1,2,8,33,0,7,0,41,0
Report: More Americans Between 18 and 34 Live with Parents Than Spouse,1,3,8,46,1,11,4,54,0
11-Year-Old Girl And Her Dog Heroically Save A Mother Goat And Her Baby From Dying In The Snow!,1,2,19,54,3,17,2,73,0
No let-up in Cyprus bird poaching,1,3,2,25,1,5,0,27,0
Sudden Weather Change Brings Snowstorm To UAE And Other Gulf States,1,3,13,44,0,10,0,57,0
"We Know Which ""Love Actually"" Character You Should Hook Up With",1,1,11,40,2,10,0,51,0
33 Questions White People Have For White People,1,1,7,31,0,7,2,38,0
Which Social Network Should You Be Using Based On Your Mood,1,1,11,38,0,10,0,49,0
Watch These Skeptics Try And Remain Calm In A Haunted Asylum,1,1,11,39,0,10,0,50,0
Couples Review Each Other's Credit Card Statements,1,1,7,36,1,6,0,43,0
Fighting Trump? Your best weapon is the one you least expect,1,2,3,46,1,10,0,49,0
Which Disney Channel Show Do You Actually Like Better,1,1,9,36,0,8,0,45,0
17 Celebrities Who Opened Up About Mental Health In 2015,1,1,8,33,0,9,6,41,0
The Dude Who Followed His Girlfriend Around The World Just Photographed Their Wedding Perfectly,1,3,14,68,0,13,0,82,0
15 Mistakes You're Making When Trying To Lose Weight,1,2,8,33,1,8,2,41,0
"This Adult Coloring Book Will Have You Screaming Where Are My Crayons?!""",1,1,12,46,3,11,0,58,0
MILO Announces New Media Venture,1,3,8,20,0,4,0,28,0
Report: Ivanka Trump Met Secretly with Planned Parenthood CEO,1,3,10,42,1,8,0,52,0
Is It Medically Possible To Lick A G-Spot,1,1,9,24,1,7,0,33,0
8 Stages Every Driver Goes Through On Their Morning Commute,1,1,9,40,0,9,1,49,0
19 Faces Everyone Makes When They Have A Cold,1,1,8,27,0,8,2,35,0
This Man With Down Syndrome Totally Transformed Himself To Compete In A Bodybuilding Contest,1,1,14,65,0,13,0,79,0
29 Halloween Costumes You Can Make With Three Things Or Fewer,1,1,10,39,0,10,2,49,0
ICE Rounds Up 44 Criminal Aliens in Texas Capital,1,3,9,30,0,8,2,39,0
"For Everyone Who Secretly Hates ""Friends""",1,1,6,28,2,5,0,34,0
17 Ways To Keep Your Kid Safe This Halloween,1,1,8,26,0,8,2,34,0
Desiigner Can't Help But Crack Up During Hilarious Interview With Nardwuar,1,2,11,52,1,10,0,63,0
These Celebrities Got Festive As Fuck When They Stopped By Our Jingle Ball Photo Booth,1,1,15,57,0,14,0,72,0
Your Horoscope For The Week Of November 30,1,1,7,26,0,7,2,33,0
These 21 Aerial Views Of Cities From Around The World Are Beyond Magical!,1,3,12,46,1,12,2,58,0
32 Online Shops Based In The Southwest You Should Be Shopping At,1,1,11,40,0,11,2,51,0
29 Hilarious Fake Books About Social Media That Need To Exist,1,1,10,39,0,10,2,49,0
Should You Be An Actor Or A Singer,1,1,8,19,0,7,0,27,0
28 Things About Scotland That Will Surprise Everyone,1,1,7,36,0,7,2,43,0
Who Said It: Leslie Knope Or Amy Poehler,1,1,8,24,1,7,0,32,0
"Shamrocks, snakes and stereotypes!",1,3,1,28,2,3,0,29,0
17 Alleged Mexican Cartel Operatives Charged in Colorado,1,2,6,41,0,7,2,47,0
29 Songs That Will Remind You Of Your High School Sweetheart,1,1,10,38,0,10,2,48,0
This Grandma Who Looks Like Scarlett Johansson Just Got Invited To Get Drunk With Her,1,2,15,56,0,14,0,71,0
Struggles You Only Discover In Your First Same-Sex Relationship,1,1,10,44,1,8,0,54,0
Twitter Is Losing Its Mind Over This Really Sexist Poll Conducted By The Times Of India,1,1,16,56,0,15,0,72,0
"The Cast Of ""It's Always Sunny In Philadelphia"", Then Vs Now",1,1,11,35,4,10,0,46,0
What 2015 Thing Should You Be For Halloween,1,1,7,25,0,7,4,32,0
Tom Fletcher Announced He's To Be A Dad Again In The Most Awesomely Amazing Way,1,1,15,49,1,14,0,64,0
"One Thing That You've Definitely Never Noticed In ""Love Actually""",1,1,10,43,3,9,0,53,0
9 Fanfiction Pairings We Ship Even Harder Around Valentines Day,1,1,9,44,0,9,1,53,0
"Oscars 2017: 10 things you need to know, from the epic mix-up to Viola Davis’s speech",1,3,3,57,4,15,6,60,0
Here's A Kid That Will Motivate You To Make It To The Gym Today,1,1,14,35,1,13,0,49,0
Beastie Boys’ Ad-Rock Donating Proceeds from Sales of Vegan Shoes to Planned Parenthood,1,3,11,62,2,12,0,73,0
The Government Is Trying to Shut Down the Cannabis Cup,1,3,8,37,0,9,0,45,0
"25 Times ""It's Always Sunny"" Made You Laugh Uncontrollably",1,1,8,37,3,8,2,45,0
What's Really Going On With Your Late-Night Bathroom Trips,1,2,10,38,2,8,0,48,0
This Graphic Novel Perfectly Captures The Struggles Of Being An Indian Woman,1,1,12,53,0,11,0,65,0
What's The Strangest Thing You've Ever Put In Your Butt,1,1,10,34,2,9,0,44,0
Viewpoint: Is inequality about to get unimaginably worse?,1,2,2,46,2,7,0,48,0
"13 Things to Know About the Charts This Week: Ed Sheeran Is No. 1 on Artist 100, Hot 100 & Billboard 200",1,2,13,54,4,21,12,67,0
25 Vintage Photos Of Wild NYE Parties Of The Past,1,1,11,27,0,9,2,38,0
23 Things You'll Only Understand If You're The Mum Of Your Friend Group,1,1,12,43,2,12,2,55,0
"Eat Peppers, Live Longer? ",1,3,4,16,2,4,0,20,0
How Well Do You Know Fast Food Menu Items,1,1,9,24,0,8,0,33,0
"Americans Reveal The Funniest, Most Bizarre Experiences They've Had In India",1,1,11,53,2,10,0,64,0
Here's How To Try Black Tap Milkshakes Without Spending $15,1,1,9,37,2,9,2,46,0
Behold The Most Terrifying Mascot To Ever Exist,1,1,8,32,0,7,0,40,0
"Society Could Collapse In A Decade, Predicts Math Historian",1,3,9,41,1,8,0,50,0
We Know What Will Piss You Off This Thanksgiving Based On Your Zodiac,1,1,13,44,0,12,0,57,0
"If You Could Be Straight, Would You",1,1,7,21,1,6,0,28,0
"Several Indians Came Together To Send This Message Called ""Dear Terrorists""",1,1,11,52,2,10,0,63,0
The 10 hottest housing markets for 2017,1,3,1,26,0,6,6,27,0
Politico Scoop: Eric Trump Killed Two Deer,1,2,7,28,1,6,0,35,0
"Here's A Clever Thing You Never Noticed About ""Beauty And The Beast"" And ""Aladdin""",1,1,14,50,5,13,0,64,0
Michael Moore: Trump ‘Has No Right To Enter’ White House,1,2,10,34,3,9,0,44,0
Eva Longoria Took The BuzzFeed Spelling Test And Here's What Happened,1,1,12,46,1,10,0,58,0
"What Percentage Kardashian Are You, Based On 3 Questions",1,1,8,38,1,8,1,46,0
"Here's What ""Harry Potter"" Characters' Eyes Are Actually Supposed To Look Like",1,1,12,51,4,11,0,63,0
EU Lawmaker Says News Publishers’ Rights Proposal Should Be Dropped ,1,3,11,46,1,10,0,57,0
We're about to learn everything we've wanted to know about tech's most secretive company,1,3,1,71,3,13,0,72,0
"NYT’s Alcindor: Democrats ‘Sound Somewhat Confused,’ Don’t Have ‘Clear Leader’",1,3,12,49,8,9,0,61,0
21 Feelings Everyone Who Has Ever Stepped Foot In A School Knows,1,1,11,40,0,11,2,51,0
21 Times Renato Nicoli Sampaio's Instagram Made You Beyond Thirsty,1,1,9,45,1,9,2,54,0
Feel Better Than Ever With The BuzzFeed Health & Beauty Newsletter,1,1,11,44,1,10,0,55,0
8 Slightly Gross Facts That Will Make You Very Aware Of Your Mouth,1,1,12,41,0,12,1,53,0
"Baby Eats Bacon For The First Time, Reaches Peak Satisfaction",1,1,10,41,1,9,0,51,0
Beauty guru got her followers to troll guys using this makeup tool,1,3,1,54,0,11,0,55,0
2016’s Box-Office Winners and Losers,1,2,4,22,2,4,4,26,0
New York’s de Blasio Retreats on Claim That Donald Trump Caused Anti-Semitic Threats,1,2,12,58,2,12,0,70,0
Someone Made A Trump-Putin Facebook Friend Anniversary Video,1,3,9,43,1,7,0,52,0
We Know Your Zodiac Sign Based On Which Cat You Choose,1,1,11,33,0,10,0,44,0
13 Guys Who Contour Better Than You,1,1,6,21,0,6,2,27,0
"Do You Know The Correct Plural Form Of ""Octopus""",1,1,9,29,2,8,0,38,0
22 Pure And Kind Posts That Will Soothe Your Troubled Soul,1,3,10,36,0,10,2,46,0
Inside T's Beauty Issue,1,2,4,15,1,3,0,19,0
"The next time you're thinking of planning a quirky first date, don't",1,3,1,53,3,11,0,54,0
"Black Friday Shopper Camps Out For Entire Week, Is Not Fucking Around",1,1,12,45,1,11,0,57,0
"Your smartphone knows a lot about you, but what about your mental health?",1,3,1,58,2,12,0,59,0
The ‘Ideal Choice’ — Donald Trump Confirms Gen. John Kelly for DHS Secretary,1,3,13,47,4,12,0,60,0
"12 Reasons Pete Davidson Is The Most Relatable ""SNL"" Cast Member",1,1,12,38,2,10,2,50,0
Radioactive Wild Boars Are Out Here Causing Chaos,1,3,8,34,0,7,0,42,0
Which Disney Couple Are You And Your Significant Other Based On Your Zodiac,1,1,13,50,0,12,0,63,0
How Neil Gorsuch became Donald Trump's Supreme Court nominee,1,3,7,44,1,8,0,51,0
A Motorcyclist Grabbed An Unsuspecting Girl's Feet On The Freeway And It's The Best,1,1,14,54,2,13,0,68,0
13 Sushi-Themed Gifts Perfect For Anyone Obsessed With Food,1,1,9,39,1,8,2,48,0
Behar: Trump’s Limited Vocabulary ‘Appeals to People Who Are Afraid of Things’,1,3,10,53,4,11,0,63,0
23 Celebrity Couples We Loved And Lost In 2015,1,1,7,25,0,8,6,32,0
"Can You Identify These Characters From ""Recess""",1,1,7,32,2,6,0,39,0
"Who Do You Think The ""Scream Queens"" Killer Is",1,1,9,27,2,8,0,36,0
Literally Just 24 Tweets About 2015,1,1,4,20,0,5,6,24,0
Learning to celebrate failure at a young age led to this billionaire's success,1,3,1,64,1,12,0,65,0
Boston Bombing Survivor to Marry the Firefighter Who Rescued Her ,1,3,8,47,0,10,0,55,0
'Avengers: Infinity War' — The Marvel Favorite Peter Dinklage Could Play,1,2,10,48,4,10,0,58,0
"Rudy Gobert to Jazz: Make winning plays, worry less about stats",1,3,4,47,2,10,0,51,0
Zayn Malik Has Grey Hair Now And People Are Losing Their Damn Minds,1,1,13,42,0,12,0,55,0
31 Beautiful Posters That Will Teach You A Damn Thing,1,1,9,33,0,9,2,42,0
"Politico Scoop: Donald Trump May Be 6′ 2″, Not 6′ 3″",1,3,7,25,6,10,4,32,0
Which Fictional Character Are You Based On Your Taste In Music,1,1,11,41,0,10,0,52,0
"25 Times ""10 Things I Hate About You"" Made You Fall Madly In Love",1,1,12,34,2,13,4,46,0
A 29-Year-Old Just Attracted Five Former Top Credit Suisse Real Estate Bankers To His Firm,1,3,16,56,2,14,2,72,0
"Please, Everyone, Stop Saying ""Squad Goals""",1,1,6,28,4,5,0,34,0
7 Small Changes To Try This Week,1,3,6,19,0,6,1,25,0
11 Startling Boob Confessions,1,1,3,21,0,3,2,24,0
"Sunny-SRK's Item Song From Raees, Kareena-Taimur's Morphed Photo Goes Viral And More From Ent",1,3,18,57,5,13,0,75,0
Strange noises in Sweden thought to be caused by Northern Lights,1,3,4,50,0,10,0,54,0
It Only Took 7 Seconds For This Kylie Jenner Appearance To Get Really Awkward,1,3,13,50,0,13,1,63,0
13 Of The Most Glorious Made-Up Words From Literature,1,1,9,33,1,8,2,42,0
"27 Times ""Fresh Prince Of Bel-Air"" Was The Funniest Show Ever Made",1,1,12,38,3,11,2,50,0
Are You More Cara Delevingne Or Taylor Swift,1,1,8,29,0,7,0,37,0
9 Demon Dogs That Want To Haunt Your Dreams And Eat Your Soul,1,1,12,36,0,12,1,48,0
This Groom Saved A Guest's Life At His Wedding,1,1,9,28,1,8,0,37,0
33 Everyday Words With Hilariously Punny Double Meanings,1,1,7,40,0,7,2,47,0
3 Ways To Be A Better Investor In 2017,1,3,7,18,0,8,5,25,0
21 Cozy Sanctuaries To Shelter You From Adulthood,1,1,7,33,0,7,2,40,0
"Can You Guess The Celebrity By The ""VPL""",1,1,10,21,2,7,0,31,0
Sherlock season 4 episode 2 review: Benedict Cumberbatch's detective drama takes a dark turn,1,2,3,72,2,13,2,75,0
"Deep in the Amazon, a Remarkable Beach (and Ant-Eating) Experience ",1,3,7,46,4,10,0,53,0
31 Accessories Every ’90s Girl Will Recognize,1,3,5,29,1,6,4,34,0
How Do Victoria's Secret Angels Unwind After the Show? [Video],1,2,9,40,4,9,0,49,0
Retirement Rules,1,3,2,13,0,1,0,15,0
How this tech incubator started by Google is tackling the world's biggest geopolitical issues online,1,3,2,83,1,14,0,85,0
Why Only Americans Are Interested in the Hunt for Alien Life,1,3,8,42,0,10,0,50,0
Why Umbrellas Are Just The Worst,1,1,6,21,0,5,0,27,0
How Swedish class reacted to migrant visit,1,3,2,34,0,6,0,36,0
"Donald Trump Issues New Immigration Order, Legal Challenges Remain Likely",1,2,10,53,1,9,0,63,0
These Valentine's Day Stories Prove That It's Maybe The Worst Day Of The Year,1,1,14,48,2,13,0,62,0
Could You Be A Barista?,1,3,5,13,1,4,0,18,0
For Everyone Who Looks Hella Drunk In Pics,1,1,8,27,0,7,0,35,0
Divorce and marriage by age charts - Business Insider,1,3,3,41,1,8,0,44,0
The most powerful passports in the world,1,3,1,33,0,6,0,34,0
France Votes: An Hour-by-Hour Guide to the Presidential Election,1,3,8,45,3,8,0,53,0
We Need To Talk About Justin Bieber's Hair,1,1,8,26,1,7,0,34,0
"Markelle Fultz hopes to be No. 1 pick, expects rivalry with Lonzo Ball in NBA",1,3,8,52,2,14,1,60,0
Which Cheap American Beer Are You,1,1,6,22,0,5,0,28,0
17 Creepy Videos That Will Send A Chill Down Your Spine,1,1,10,33,0,10,2,43,0
"Meet Wheelchair Bound Harman Sidhu, The Man Behind Supreme Court’s Order Of Liquor Ban Along Our Highways",1,3,17,70,2,16,0,87,0
"Here's What The ""Toy Story"" Voice Actors Look Like In Real Life",1,1,12,37,3,11,0,49,0
24 Incredibly Useful iPhone Apps,1,1,4,22,0,4,2,26,0
"Dear World, You're RUINING Indian Food, Please Stop",1,1,14,27,3,7,0,41,0
Only Solve This Crossword If You Remember The Pre-iPhone Era,1,1,11,39,1,9,0,50,0
22 Tumblr Posts That Will Make Former Emo Kids Cry With Laughter,1,1,11,40,0,11,2,51,0
Here Are Some Things The Sikh Community Wants You To Know,1,1,11,36,0,10,0,47,0
Climate change is going to be very bad for the global economy,1,2,1,49,0,11,0,50,0
"The ABCs According To ""Friends""",1,1,7,18,2,4,0,25,0
Rachel Dolezal’s Brother Facing Charges Of Sex Assault Against Minor,1,2,10,48,1,9,0,58,0
Someone Please Buy Me This Caffeinated Bracelet Immediately,1,1,8,44,0,7,0,52,0
There’s Finally A Movie That Gets ’90s Nostalgia Right,1,3,8,34,2,8,2,42,0
18 Times Leonardo DiCaprio Out-Leo DiCaprio'd Himself,1,1,9,34,2,6,2,43,0
The Complete Beginner's Guide To Big Data In 2017,1,3,8,28,1,8,4,36,0
4 Simple Ways Women Can Help Women Succeed In Business,1,3,9,35,0,9,1,44,0
"Taylor Swift And Haim Danced Flawlessly While Nelly Sang ""Hot In Herre"" On The 1989 World Tour",1,1,16,56,2,16,4,72,0
Can You Identify Which Disney Channel Movie Each Celebrity Was In,1,1,11,44,0,10,0,55,0
Nine things we’ve learnt in one month on Facebook Messenger,1,3,3,46,1,9,0,49,0
Here's Why Bad Boys Are Always Sexier,1,1,7,23,1,6,0,30,0
Can We Guess How Many People You Kissed In 2015,1,1,9,25,0,9,4,34,0
Can You Find The Boner Hidden In These Bones?,1,3,9,27,1,8,0,36,0
Science News Top five science books of 2016,1,3,3,29,0,7,4,32,0
19 Things You Probably Never Knew About Nightmares,1,1,7,34,0,7,2,41,0
"Cat Marnell lost her job and almost overdosed on heroin. Then, she wrote a memoir.",1,3,3,62,3,14,0,65,0
20 tweets from Cher that will help you remember 2016 in a better light,1,3,1,50,0,13,6,51,0
21 Chill Gifts To Get You Through The Holiday Season,1,1,9,32,0,9,2,41,0
"Theresa May was 'right' to sack me, says Michael Gove",1,3,4,37,3,9,0,41,0
"Which ""Harry Potter"" Character Should You Marry Based On Your Zodiac",1,1,11,45,2,10,0,56,0
Who Tweeted It? Donald Trump Vs. Kim Kardashian,1,1,8,30,2,7,0,38,0
This Was What The World Was Like The Last Time Someone Sold Over 2 Million Albums In One Week,1,1,18,56,0,18,1,74,0
Donald Trump's press secretary Sean Spicer's Daft Punk tweets resurface,1,2,6,54,2,9,0,60,0
69 Excellent Indie Records You May Have Missed In 2015,1,1,8,31,0,9,6,39,0
Journeys Through Trans Masculinity,1,1,4,27,0,3,0,31,0
"Which Terrain From Taylor Swift's ""Out Of The Woods"" Music Video Are You",1,1,13,44,3,12,0,57,0
"Dude, You Can Actually Rent These Entire Islands On Airbnb",1,1,10,38,1,9,0,48,0
"If You’re Behind on Retirement Savings, Here’s How to Catch Up",1,3,9,40,3,10,0,49,0
This Woman Sneaking Pictures Of The Rock's Butt Is Human Goals,1,3,11,40,1,10,0,51,0
This Model Had The Perfect Response When A Reporter Asked What She'd Eat After A Fashion Show,1,1,17,59,1,16,0,76,0
This Test Will Determine What Other People Find Attractive About You,1,1,11,47,0,10,0,58,0
"17 Young Adult Novels You Should Read, Based On Your Favorite Literary Classics",1,1,12,52,1,12,2,64,0
"Kylie Jenner's Resolution For 2016 Is Literally To ""Realize Stuff""",1,1,9,41,3,9,4,50,0
"New ""Carpool Karaoke"" prime time special coming in May",1,2,4,40,2,8,0,44,0
"Thane Call Centre Scam Mastermind Arrested, After Air India, FIA Lifts Ban On Gaikwad And Other Must Reads",1,2,20,67,2,17,0,87,0
33 Things Russia Does Differently Than Everywhere Else On Earth,1,1,9,43,0,9,2,52,0
The Emoji Keyboard Has Arrived,1,1,5,21,0,4,0,26,0
Gays Ask Lesbians About Sex,1,1,5,18,0,4,0,23,0
Three TSA Agents Arrested for Drug Smuggling Ring at San Francisco International Airport,1,3,13,63,0,12,0,76,0
13 Things The Guy Who's Not Bernie Sanders Or Hillary Clinton Looked Like During The #DemDebate,1,1,16,60,2,15,2,76,0
13 Horror Games That Will Actually Scare You,1,1,7,28,0,7,2,35,0
Nigeria 'gay wedding' bust leads to charges,1,2,1,34,2,6,0,35,0
Teeth under attack from 'healthy' snacks: The growing problem is one that many dentists are failing to treat ,1,2,2,86,3,18,0,88,0
Six Chinese Billionaires Spring Up With Delivery Fortunes Worth $47 Billion,1,2,10,52,1,10,2,62,0
18 Confessions That Reveal What It's Like To Live With OCD,1,1,12,33,1,10,2,45,0
12 Ridiculously Cool Playgrounds That’ll Make You Want To Be A Kid Again,1,3,12,45,1,12,2,57,0
Want To Call It Frisco? Ask The Hells Angels,1,1,9,26,1,8,0,35,0
ABC’s ‘Black-ish’: ‘A Vote for Trump is a Vote for Racism’ (Video),1,3,10,36,9,11,0,46,0
This Food Test Will Determine If You're Actually From Pennsylvania,1,1,10,46,1,9,0,56,0
American Kids Tried Dinners From Around The World And Their Reactions Were Next Level,1,1,14,58,0,13,0,72,0
28 Photos That Prove We're Living In The Darkest Possible Timeline,1,1,10,43,1,10,2,53,0
19 Stealthy Products That'll Protect All Your Things,1,1,7,35,1,7,2,42,0
40 Suggestions For Posh Spice's Replacement In The Spice Girls Reunion,1,1,10,47,1,10,2,57,0
Why the Williams sisters can thank each other for their success,1,3,2,51,0,10,0,53,0
"How The ""Cash Me Ousside"" Teen Defies Expectations For White Girls",1,2,11,43,2,10,0,54,0
5 hotels with fascinating past lives,1,2,0,30,0,5,1,30,0
Beauty: your hair regime doesn’t have to be hard work,1,3,1,41,2,9,0,42,0
Brzezinski: Is Trump Admin ‘Trying to Create a Dictatorship?’,1,2,7,42,4,8,0,49,0
Men Describe Their Dream Wedding,1,1,5,23,0,4,0,28,0
Ten exhibitions to see in 2017,1,3,1,20,0,5,4,21,0
11 Awards All Nurses Deserve,1,1,4,18,0,4,2,22,0
11 Things You Really Need To Know About Those Annoying Bumps On Your Arms,1,1,13,45,0,13,2,58,0
A Dad Halted His Daughter's Wedding So Her Stepdad Could Help Give Her Away,1,1,14,47,1,13,0,61,0
Rand Paul Wants Susan Rice Before Congress,1,3,7,29,0,6,0,36,0
One Quality That Sets Successful Parents Apart,1,2,7,33,0,6,0,40,0
"23 ""SpongeBob SquarePants"" GIFs That Perfectly Sum Up Life",1,1,12,34,2,8,2,46,0
24 Brutally Honest Confessions From A Sex Therapist,1,2,7,35,0,7,2,42,0
"7 'New' Features Apple Just Stole From Microsoft, Google, and Itself",1,2,9,44,4,10,1,53,0
Going for a Run Could Extend Your Life,1,3,6,25,0,7,0,31,0
Gorka: Story That Secretary of State Tillerson Refuses Eye Contact with Diplomats Is ‘Fake News’,1,3,13,66,3,14,0,79,0
Soulja Boy Taunts Chris Brown Over Karrueche Restraining Order,1,3,9,45,0,8,0,54,0
14 Drive-Thru Workers Who Are 100% Done,1,1,6,20,2,6,5,26,0
"Not Only Donald Trump Loves to Tweet, Economists Flock to It Too",1,3,10,42,1,11,0,52,0
What's The Weirdest Sexual Question Your Parents Have Ever Asked You,1,1,11,46,1,10,0,57,0
These Buffalo Chicken Potstickers Are Dope AF And So Easy To Make,1,1,13,41,0,11,0,54,0
"KASSAM at CPAC Slams Establishment Media: ‘I’ve Been to Sweden, You Guys Just Don’t Get it!’",1,2,21,49,7,15,0,70,0
"A Brazilian Football Referee Is Breaking The Internet, Here's What Is Going On",1,3,13,51,2,12,0,64,0
Why one food executive is pledging $25 million to fight his own industry,1,3,1,56,1,12,2,57,0
"The Justin Bieber Sports Curse Is Definitely Real, and It Just Claimed Its Latest Victim",1,3,14,59,1,14,0,73,0
97 Of The Best Things In The World,1,1,7,18,0,7,2,25,0
Here's How People LOL Differently Around The World,1,1,10,32,1,7,0,42,0
The 32 Dumbest Things That Happened In 2015,1,1,6,24,0,7,6,30,0
These Are The Products That Have Been Trending On Amazon This Week,1,1,12,43,0,11,0,55,0
Amazon changes name of Westminster Tube station to 'Webminster',1,3,4,49,2,8,0,53,0
Destinations The greatest National Trust properties – according to the experts,1,3,4,63,1,10,0,67,0
"18 Wikipedia Pages That’ll Make You Say ""Fuck, That’s Interesting""",1,2,9,41,5,9,2,50,0
34 Amazing Ways To Use Your Halloween Candy,1,1,7,27,0,7,2,34,0
Here Are The Best Places To Get Your Underwear,1,1,9,29,0,8,0,38,0
22 Reasons Samoyeds Are THE Animal Of 2016,1,1,8,21,0,7,6,29,0
Youngest in class twice as likely to take ADHD medication,1,3,5,43,0,9,0,48,0
Ars Technica: White House Fails to Make Case that Russian Hacking Tampered with Election,1,3,11,63,1,13,0,74,0
18 Cleaning Tips That'll Save You So Much Money,1,3,8,28,1,8,2,36,0
23 Online Stores You Still Have Time To Order From,1,1,9,30,0,9,2,39,0
"Why So Many Americans Don't 'Believe' In Evolution, Climate Change And Vaccines",1,3,12,52,4,11,0,64,0
CAUGHT ON VIDEO: World's Grinch-iest Vandal Tries To Kill Frosty The Snowman,1,3,22,40,3,11,0,62,0
New Hampshire family plans bucket list for 9-year-old with terminal brain tumor ,1,3,2,63,2,12,1,65,0
Here's How To Actually Detox After Eating All The Things,1,1,10,36,1,9,0,46,0
Brie Larson Reflects On Powerful Oscars Moment You Totally Missed,1,3,10,46,0,9,0,56,0
This Guy Plowed Snow On An ATV While Wearing A Bikini Because New Brunswick,1,2,16,46,0,13,0,62,0
21 Food-Inspired Dog Names That Are Actually Really Cute,1,1,9,36,1,8,2,45,0
9 Signs That You're An Ambivert,1,3,5,19,1,5,1,24,0
A map of the world's drunkest countries The list,1,3,2,37,1,8,0,39,0
"Dakota Johnson Says That She Is Proud Of ""Fifty Shades Of Grey""",1,1,12,38,2,11,0,50,0
"Which ""The Lord Of The Rings"" Character Should Be Your Wingman",1,1,11,39,2,10,0,50,0
A woman found a shirt tucked in her windscreen - and she has a serious warning for everyone The list,1,3,2,78,1,19,0,80,0
Selfridges invents coffee spread containing espresso shots,1,3,1,51,0,6,0,52,0
Show Us The Most Simple Halloween Costume You've Ever Worn,1,1,10,38,1,9,0,48,0
Blake Lively's Lifestyle Brand Is Going To Heaven,1,1,8,33,1,7,0,41,0
8 Tips for staying productive when you’re never in the office (HP Australia),1,3,4,56,3,12,1,60,0
The 10 tech trends that will be in CES 2017,1,3,4,24,0,9,6,28,0
Are These Eastern European Cities Or Made Up Words,1,1,9,33,0,8,0,42,0
The Atlantic VP: ‘Democratization’ of News via the Internet Left People ‘Overwhelmed with Information’,1,3,11,73,5,13,0,84,0
Alec Baldwin: ‘Thoughtless Pig’ Voicemail to Daughter Gets ‘Thrown’ in My Face Every Day,1,2,12,58,5,13,0,70,0
This Canadian Teenager With Autism Is The Inspiration We All Need,1,1,11,44,0,10,0,55,0
Pope Francis Tells Mothers to ‘Go Ahead and Breastfeed’ Children in Church,1,3,9,52,2,11,0,61,0
12 '90s Cartoons That Will Be Over Two Decades Old In 2016,1,1,9,29,1,11,8,38,0
"Waiter-less, cashier-less restaurant is the stuff of the future",1,2,1,51,3,8,0,52,0
22 Jokes About Motivation That Will Make You Laugh Then Cry,1,3,10,37,0,10,2,47,0
"31 Posts That Prove ""Harry Potter"" Has The Funniest Fans",1,1,9,34,2,9,2,43,0
Stephen Curry Pokes Fun at Daughter Riley's Postgame Antics on 'Family Guy',1,3,10,51,3,11,0,61,0
Do You Remember The Characters In “Zootopia”?,1,3,7,29,3,6,0,36,0
Did Russell Westbrook Tell a Teammate Not to Talk to Kevin Durant After Thunder/Warriors Game?,1,3,13,65,2,14,0,78,0
People Try Making Pinterest Hanukkah Crafts,1,1,6,32,0,5,0,38,0
"Logan: Fox premiere 40 minutes of Wolverine 3, early reactions are overwhelmingly positive",1,3,3,70,2,12,3,73,0
13 Reasons Twinkle Khanna And Akshay Kumar Are Bollywood's Cutest Couple,1,1,10,49,1,10,2,59,0
Is Your Local Sears or Macy’s Store Closing? Check This List,1,3,10,38,2,10,0,48,0
Non-verbal boy's special bond with deaf dog captured in heartwarming photo,1,3,1,61,2,10,0,62,0
"30 Things You Need To Know About Mike ""The Miz"" Mizanin",1,1,10,31,2,10,2,41,0
9 Photos Of Oscar Isaac Proudly Gazing At His Golden Globe,1,1,10,37,0,10,1,47,0
Is This Lady The Worst Babysitter In The World,1,1,9,29,0,8,0,38,0
"66 Thoughts I Had While Watching Season 5, Episode 9 Of “Game Of Thrones”",1,3,11,42,3,13,4,53,0
"I Spent 45 Minutes In The ""Bigg Boss"" House And Here's What I Learned",1,1,13,38,3,13,2,51,0
Find Out Your Horoscope For The Week Of Nov. 2,1,1,9,26,1,9,1,35,0
12 Charts Everyone Who Has Lived In A Dorm Will Understand,1,1,10,36,0,10,2,46,0
18 Things That Happen When You're A Gay Fresher,1,1,8,28,1,8,2,36,0
Alec Baldwin Denies ‘SNL’ Impression Helped Trump Win,1,3,10,34,2,7,0,44,0
This Guy Proposed To His Girlfriend While On A Roller Coaster And Caught The Whole Thing On Camera,1,1,18,63,0,17,0,81,0
"27 Vintage Pictures Of Austin From Way Before It Was ""Cool""",1,1,10,35,2,10,2,45,0
The truth behind the world's most reliable IQ test The list,1,3,4,44,1,10,0,48,0
These 9 states are where taxpayers get the most for their tax dollars,1,2,1,55,0,12,1,56,0
29 Books Every '90s Kid Will Immediately Recognize,1,1,6,32,1,7,4,38,0
See If You Can Get An 8/10 On This Celebrity Siblings Quiz,1,3,11,32,1,11,3,43,0
Trump is now destroying a healthy health-care system,1,3,1,43,1,7,0,44,0
"Watch Sourav Ganguly Play Gully Cricket On Streets Of Kolkata, That Too Right-Handed!",1,3,14,56,3,12,0,70,0
We Know Your Relationship Status Based On One Question,1,1,9,37,0,8,0,46,0
"Tacky weddings: Marriage proposals, dance routines and asking guests for money",1,3,2,64,2,10,0,66,0
"Rand: Rice Committed a Crime, ‘Did Something That’s Devastating’",1,3,8,43,5,8,0,51,0
25 One-Dish Meal Ideas That Aren't Pasta,1,1,7,23,2,6,2,30,0
"Mark Zuckerberg Is Running A Political Campaign, Just Not For Elected Office",1,3,12,52,1,11,0,64,0
There's a huge problem with this Donald Trump tweet The list,1,3,4,45,1,10,0,49,0
Teen who crashed into BMW finds out why honesty is the best policy,1,2,4,50,0,12,0,54,0
21 Of The Most Powerful Photos Of This Week,1,1,8,25,0,8,2,33,0
21 Insanely Easy Single-Dish Meals That Will Change Your Life,1,1,10,39,1,9,2,49,0
If you have any of these foods in your fridge you're posh The list,1,3,2,50,1,13,0,52,0
5 survival myths that could get you killed,1,2,0,34,0,7,1,34,0
30 Chilling Photos From The Attack On Pearl Harbor,1,1,8,32,0,8,2,40,0
The secret of Namibia's 'fairy circles' may be explained at last,1,3,2,49,3,10,0,51,0
What rumors about a new screen on the next iPhone could actually mean for you,1,3,2,61,0,14,0,63,0
"Russia should reinstate the monarchy and appoint PUTIN as royal emperor, says influential Moscow churchman ",1,3,7,84,1,15,0,91,0
"This 87-Year-Old May Be The Best, Most Canadian Neighbour In Canada",1,1,12,40,3,10,2,52,0
"Prince Harry: ""I always wanted to be a Gurkha, but the opportunity never arose""",1,2,4,58,4,13,0,62,0
18 Easy And Delicious One-Pan Breakfasts,1,1,6,26,1,5,2,32,0
Here's Some UNBEARABLY Cute Footage Of Ranveer And Deepika To Remind You How Alone You Are,1,1,25,49,1,15,0,74,0
"Guys, ""America's Next Top Model"" Is Returning To TV",1,1,10,29,4,8,0,39,0
"Which Character From ""The IT Crowd"" Are You",1,1,9,25,2,7,0,34,0
Are You Jar Jar Binks Or J. J. Abrams,1,1,9,18,2,8,0,27,0
"These Songs by Beyonce, Justin Timberlake & More Might Just Save Your Life",1,3,11,49,2,12,0,60,0
A Lifetime of New York Sports Misery in Just One Year,1,2,9,34,0,10,0,43,0
"If You Were A Herb, What Would Your Name Be",1,1,10,23,1,9,0,33,0
"The First Episode Of ""A Series Of Unfortunate Events"" Has A Surprise Ending",1,3,13,48,2,12,0,61,0
Kendrick Lamar Revealed Title Of His New Album 'DAMN.' Over A Week Ago,1,2,16,39,3,12,0,55,0
Your Playbook If U.S. and China Don't Clash,1,2,8,25,3,7,0,33,0
Here's why fish and chips could soon be replaced with squid and chips,1,3,1,55,1,12,0,56,0
Which Celebrity BFFs Are You And Your Best Friend Based On One Question,1,1,15,44,0,12,0,59,0
"This Honda is the most affordable, high-tech car you can buy",1,3,2,46,2,10,0,48,0
Are These Pills Grey Or Red And Blue,1,1,8,21,0,7,0,29,0
23 Times Tumblr Cleverly Explained What Being Genderqueer Means,1,1,8,45,0,8,2,53,0
Ways your technology is already spying on you,1,3,1,37,0,7,0,38,0
This company wants you to bring your dog to work,1,2,1,38,0,9,0,39,0
26 Things That Will Only Make Sense To Ungirly Girls,1,1,9,32,0,9,2,41,0
The new Interior secretary rode a horse to work because why not,1,3,2,50,0,11,0,52,0
"HuffPost What's Working Honor Roll: The Case For Teaching Students Emotional Skills, Not Just Academic Ones",1,2,17,72,3,15,0,89,0
DELINGPOLE: NOAA Scandal Gives Trump The Perfect Excuse To Drain The Climate Swamp,1,2,25,44,1,12,0,69,0
17 Chilling Confessions From People Who Have Been Stalked By Their Exes,1,1,11,47,0,11,2,58,0
Selena Gomez Shuts Down Body Shamers For Criticizing Her Weight,1,1,10,44,0,9,0,54,0
16 Times Unnecessary Censorship Made Sports Dirty As Heck,1,1,8,39,0,8,2,47,0
22 Of JoJo's Best Tweets,1,1,5,12,1,4,2,17,0
These Are The Costumes That Won Halloween This Year,1,1,9,34,0,8,0,43,0
The Unhappiest Jobs Of 2017,1,2,4,15,0,4,4,19,0
People Are Disappointed By Kanye's Slut-Shaming Of Amber Rose,1,1,10,41,2,8,0,51,0
Model Reveals Cellulite in Target's Newest Swimsuit Campaign,1,2,7,45,1,7,0,52,0
"Yahoo hack: How to know if your account has been breached, and what to do next",1,2,2,59,2,15,0,61,0
"I, A Person Horrible At Eyeliner, Tried Pinterest Eyeliner Tips",1,1,10,42,2,9,0,52,0
'Why didn't baby Jesus zap him?': 15 of the funniest Outnumbered moments,1,3,3,51,5,11,2,54,0
23 Questions You Probably Have For Lesbian Movies,1,3,7,33,0,7,2,40,0
"All The Bakers Dance In The Turkish Version Of ""Bake Off""",1,1,11,34,2,10,0,45,0
Stargazing guide: Look up and see these 10 things in April Featured Stories Additional stories,1,2,6,71,1,14,2,77,0
21 Unbelievably Delicious Things You Can Do To Cookie Dough,1,1,9,39,0,9,2,48,0
A 9-Year-Old Boy With Cerebral Palsy Won Everton's Goal Of The Month Contest And The Whole Thing Is Amazing,1,1,20,65,3,18,1,85,0
"Which Season Of ""Buffy The Vampire Slayer"" Is Your Soul",1,1,10,34,2,9,0,44,0
"Billy On The Street Talks Pizza Rat Being Gay, Donald Trump's Anus-Mouth, And Other Hilarious Hot Topics",1,1,18,66,4,16,0,84,0
What Was The Most Amazing Thing That Happened At Your Wedding,1,1,11,40,0,10,0,51,0
Student Mob Shuts Down ‘Blue Lives Matter’ Lecture at Claremont McKenna College,1,3,12,54,2,11,0,66,0
"Nadiya's Speech At The End Of ""Bake Off"" Was So Incredibly Moving",1,1,12,39,3,11,0,51,0
Amber Tamblyn reveals baby name via Hillary Clinton humble-brag,1,3,4,50,1,8,0,54,0
Watch One Man Transform Into Five Women Through Makeup,1,1,9,37,0,8,0,46,0
Is skipping breakfast bad for us? New study finds links with heart disease and obesity,1,2,2,69,1,14,0,71,0
21 Times Tumblr Users Perfectly Summed Up Your Relationship Goals,1,1,9,45,0,9,2,54,0
"18 Things You Really, Really Shouldn't Do",1,1,6,25,2,6,2,31,0
You Need Beer-Battered Chicken Tikka Popcorn In Your Life,1,1,10,38,1,8,0,48,0
Barbie battles Star Wars and Hatchimals at the register,1,3,4,43,0,8,0,47,0
"A History Of ""Frisco"" In Headlines",1,1,6,21,2,5,0,27,0
24 Iconic Moments From Craig David's Instagram In 2015,1,1,7,32,1,8,6,39,0
ESPN's NFL MVP Poll: Derek Carr takes top spot,1,2,13,23,2,8,0,36,0
Dem Sen Gillibrand: ‘Ultimately’ Gorsuch Will Be Confirmed By the Senate,1,3,10,49,3,10,0,59,0
21 Things We Did In 2015 That'll Look So Fucking Weird In 10 Years,1,1,11,33,1,13,8,44,0
18 Euphoric Moments For Twentysomethings Who Are Basically Grandmas,1,1,8,49,0,8,2,57,0
Why some top companies are ditching degree requirements,1,2,1,47,0,7,0,48,0
What to expect from E3 2015,1,2,2,15,0,5,5,17,0
Can You Pass This Really Tricky Spelling Test,1,1,8,30,0,7,0,38,0
Wriddhiman Saha Proves To Be A Thorn In The Flesh Of The Aussies With A Fluent Hundred,1,3,17,53,0,16,0,70,0
What Dystopian Movie Universe Do You Belong In?,1,3,8,31,1,7,0,39,0
"15 ""Geordie Shore"" Quotes As Inspirational Posters",1,1,6,34,2,6,2,40,0
This Inkblot Test Knows What Job You Should Actually Have,1,1,10,38,0,9,0,48,0
Marceline The Vampire Queen Ranks Her 13 Favorite Vampires,1,1,8,40,0,8,2,48,0
This Little Guy Got His Tooth Pulled Out By A Drone And It's Totally Awesome,1,1,15,46,1,14,0,61,0
Forget the iPhone 7 â here are 13 reasons the next iPhone will blow everyone away,1,3,3,60,2,15,3,63,0
Ashley Graham Still Loves Naked Dresses,1,2,6,28,0,5,0,34,0
England call up Somerset’s Craig Overton as cover for Chris Jordan,1,3,6,49,1,10,0,55,0
Baku 2015 organisers to investigate alcohol claims after athletes hit by bus,1,2,1,60,0,11,4,61,0
We Know Why You're Single Based On Your Zodiac Sign,1,1,10,31,1,9,0,41,0
19 People Who Got The Worst Secret Santa Gifts In History,1,3,10,35,0,10,2,45,0
What Role Would You Play In A Bank Heist,1,1,9,23,0,8,0,32,0
The Surprising Personality Trait That Nail Biters Have In Common,1,3,10,45,0,9,0,55,0
"Jessica Chastain Is The Best Part Of ""Crimson Peak""",1,1,9,32,2,8,0,41,0
"Pay Up, Slowpokes: More States Fine Drivers Who Dawdle in the Left Lane",1,2,11,46,2,12,0,57,0
Which New Pop Singer Should You Obsess Over,1,1,8,28,0,7,0,36,0
How does Australia match up with the U.S. women ahead of opener?,1,2,4,46,3,11,0,50,0
The 19 Creepiest And Weirdest Things Children Have Actually Said,1,1,9,44,0,9,2,53,0
Here's Why Those Jumping Wedding Photos Are A Terrible Idea,1,1,10,39,1,9,0,49,0
"The Best Place To Get Pie In Every State, According To Yelp",1,2,12,35,1,11,0,47,0
Is Someone More Likely To Stop And Talk To A Stranger If They're Dressed Attractively,1,1,15,55,1,14,0,70,0
"16 Questions That Are Really Hard For ""Skins"" Fans To Answer",1,1,10,36,2,10,2,46,0
People With A Fear Of Dogs Meet Pit Bull Puppies,1,1,10,29,0,9,0,39,0
This 22-Year-Old College Student Became The World Champ Of Beer Miles,1,1,12,43,2,10,2,55,0
Thor Meets A Friend From Work In This New Teaser Trailer Of Thor Ragnarok,1,3,14,46,0,13,0,60,0
Financially Fit,1,3,2,12,0,1,0,14,0
"'They're sold like shoes': Cambodia's building boom built on slave labour, report says",1,3,2,66,6,12,0,68,0
19 Pictures That Prove Man Buns Have Gone Too Far,1,1,9,29,0,9,2,38,0
Goys Try Latkes,1,1,3,10,0,2,0,13,0
17 Things Canadians Have Tried To Smuggle Over The Border,1,1,9,37,0,9,2,46,0
Alexander Rossi Is American Racing’s Next Big Thing,1,3,8,35,1,7,0,43,0
Did Matthew Dellavedova Dive at Draymond Green's Knees in NBA Finals Game 3?,1,2,12,49,2,12,1,61,0
15 Embarrassing Situations Every Lightweight Drinker Has Been In,1,1,8,46,0,8,2,54,0
Dwyane Wade compares game of Jimmy Butler to LeBron James',1,2,7,41,1,9,0,48,0
16 Beautiful Quotes That Will Inspire You,1,1,6,27,0,6,2,33,0
"What's The Absolute Best Song From Adele's ""25""",1,1,7,27,4,7,2,34,0
Meet the Former Pro Surfer Who Has Helped 7 Million People Get Clean Water,1,3,12,48,0,13,1,60,0
The Bold Way Tegan And Sara Are Supporting LGTBQ Women And Girls,1,3,16,37,0,11,0,53,0
"Which ""Steven Universe"" Character Are You",1,1,6,28,2,5,0,34,0
13 Perfect Holiday Gifts For The Horror Fan In Your Life,1,1,10,34,0,10,2,44,0
What '00s Hit Best Describes Your Love Life,1,1,7,26,1,7,2,33,0
The states where Americans are incorrectly declared dead every year,1,2,2,56,0,9,0,58,0
"No Scales, No Measuring Cups: Learning To Cook Caribbean-Style",1,1,10,41,3,8,0,51,0
11 Charts That Will Speak To Everyone Who Fucking Loves Sleep,1,1,10,39,0,10,2,49,0
"Puff, Puff, Pass: Wiz Khalifa's Highest Lyrics",1,3,7,29,4,6,0,36,0
Winning at the freelance life: how to be happy,1,3,1,36,1,8,0,37,0
Music Box session #7 - Little Cub,1,3,4,20,2,6,1,24,0
Everything You Need To Know About Google’s New Smartwatches,1,3,9,41,1,8,0,50,0
'Snake On A Plane' Just Happened In Real Life,1,3,9,26,2,8,0,35,0
27 Times Chris Pratt Ruined Men For You In 2016,1,3,8,24,0,9,6,32,0
Apple reveals new Music app to rival Spotify,1,3,3,34,0,7,0,37,0
This Genius iPhone Trick Will Help You Clear Your Entire Inbox,1,1,11,41,0,10,0,52,0
Why You Should Love Your Scars,1,1,6,19,0,5,0,25,0
How Well Do You Actually Know Prince Eric,1,1,8,26,0,7,0,34,0
Touch of Faith - Video - NYTimes.com,1,2,6,21,3,6,0,27,0
How Big Is GE Capital? It Depends,1,2,8,18,1,6,0,26,0
Pakistan honour killings continue despite tough new laws,1,2,1,48,0,7,0,49,0
These 3D-Printed Permanent Hairpieces Are Making Waves For Cancer Survivors,1,1,11,53,1,9,1,64,0
"Liquor Shops Along Highways Shut, Indian Student Assaulted In Poland And Other Must Read Stories",1,2,15,66,1,14,0,81,0
This Child Used Her Sleeping Mother's Fingerprint to Buy $250 Worth of Pokemon Gear,1,3,11,54,2,13,3,65,0
The difference between Donald Trump and Justin Trudeau in two pictures The list,1,3,6,61,0,12,0,67,0
Reaction to Trump's top diplomat pick,1,2,2,29,1,5,0,31,0
Conor McGregor Could Make a Sh*t Ton of Money in Floyd Mayweather Fight,1,3,11,47,1,12,0,58,0
This Might Just Be The Ultimate Newborn Photo Shoot,1,1,9,34,0,8,0,43,0
"17 Tweets About ""The Force Awakens"" That Will Make You Laugh Your Ass Off",1,1,13,43,2,13,2,56,0
McDonald's: 1955 Vs. Now,1,1,4,10,3,3,4,14,0
US Prepares to Seek Arrest of Julian Assange,1,2,7,30,0,7,0,37,0
"This Woman Owns A T-Shirt With The Entire Script To ""Bee Movie"" On It And People Are Losing Their Minds",1,1,21,60,3,19,0,81,0
"14 Times ""Ginger Snaps"" Perfectly Summed Up Your Teen Girl Angst",1,1,10,40,2,10,2,50,0
7 Times Shannen Doherty Inspired Us to Never Give Up [Video],1,2,9,38,2,10,1,47,0
"Every Line Helen Mirren Says In ""The Fate Of The Furious""",1,3,11,34,2,10,0,45,0
11 Halloween Costumes For Deeply Single People,1,1,6,32,0,6,2,38,0
"NBA Player Manages to Make $500,000 by Refusing to Shoot During Team's Final 4 Games",1,3,12,48,3,14,7,60,0
This Calming Picture Test Will Reveal What People Really Like About You,1,3,12,48,0,11,0,60,0
Washington is in line for a huge shipment of political theater,1,3,1,51,0,10,0,52,0
28 Things Every Person Hates That They Do But Does Anyway,1,2,10,35,0,10,2,45,0
Science explores why certain songs give you pleasure,1,3,1,44,0,7,0,45,0
Ted Cruz Calls for $14 Billion Seized from ‘El Chapo’ to Fund Border Wall,1,3,10,45,3,13,2,55,0
Susan Rice: Donald Trump ‘Stone Cold Crazy’ for Appointing Steve Bannon to NSC,1,2,13,50,3,12,0,63,0
22 Ways To Make It Easier To Get Married When Your Parents Are Divorced,1,1,13,43,0,13,2,56,0
Filipino Food Is the Next Big Thing—Again,1,3,7,27,1,6,0,34,0
People Try Novelty Astronaut Desserts For The First Time,1,1,9,39,0,8,0,48,0
Is global financial giant PwC to blame for the Oscars mix-up?,1,3,4,45,2,10,0,49,0
Twilight of the Rock Gods,1,2,3,18,0,4,0,21,0
21 Gifts For The Gwyneth Paltrow In Your Life,1,2,8,27,0,8,2,35,0
How Well Do You Actually Know The World Junior Hockey Championship,1,1,11,45,0,10,0,56,0
A Man Had His Body Photoshopped In 18 Countries To Examine Global Beauty Standards,1,1,13,54,0,13,2,67,0
Mexico City metro installs 'penis seat' to stop sexual harassment of women ,1,3,2,59,2,12,0,61,0
Put down that energy drink! - CNN Video,1,2,5,25,2,7,0,30,0
Francisco Lindor Is Trying to Save Baseball from Itself,1,3,7,40,0,8,0,47,0
8 Down-To-The-Wire Tax Tips,1,3,6,14,3,3,1,20,0
A Couple Refused To Call Off Their Wedding Despite The Blizzard,1,1,11,42,0,10,0,53,0
"Video: Women Freed from Islamic State Burn Face Veils, Smoke Cigarettes",1,3,10,49,2,10,0,59,0
This Is What Happens When A Blizzard Strikes On Your Wedding Day,1,1,12,41,0,11,0,53,0
Can You Identify These Christmas Movies By Their Covers,1,1,9,38,0,8,0,47,0
Watch: SNL Pays Tribute to Obama — ‘Don’t Go!’,1,2,9,23,6,8,0,32,0
Here's A Veggie-Filled Snack Even Picky Eaters Will Love,1,1,10,36,2,8,0,46,0
Sex education was a lie. You can get pregnant if you're pregnant The list,1,3,3,55,2,13,0,58,0
"Nick Young Talks Kendrick Lamar's Best Album, Kobe Trashing His Sneakers And The Origins Of ""Swaggy P""",1,3,17,65,4,16,0,82,0
25 Things Every College Student Should Know About Dealing With Social Anxiety,1,1,11,53,0,11,2,64,0
"In the New Year, More Cuddling ",1,3,5,19,1,6,0,24,0
Le Pen Maintains First Round Lead in Latest Polling,1,2,8,35,0,8,0,43,0
Animal shelter celebrates their empty kennels with a joyous video,1,2,1,55,0,9,0,56,0
17 Cats Who Can't Hide Their Christmas Cheer Any Longer,1,1,9,34,1,9,2,43,0
Which Member Of Olivia Pope And Associates Are You,1,1,9,33,0,8,0,42,0
What Kind Of Ambivert Are You,1,1,6,18,0,5,0,24,0
"Build Your Ideal Breakfast And We'll Tell You If You're More Type A, B, Or C",1,3,16,41,4,15,0,57,0
18 Times Hannah Hart And Ingrid Nilsen Set The Bar Too High For Couples Everywhere,1,1,14,52,0,14,2,66,0
This Privileged Crossword Says Everything About The Patriarchy,1,1,8,47,0,7,0,55,0
Could young blood revive memory in the aging brain?,1,3,1,41,1,8,0,42,0
Drake's Mom Was Extra Adorable At Her Birthday Celebration Last Night,1,1,11,47,1,10,0,58,0
"31 Facts You Probably Don't Know About ""Edward Scissorhands""",1,1,8,39,3,8,2,47,0
6 Theories As To Why Zayn Malik And Gigi Hadid Were In A Car Together,1,1,14,40,0,14,1,54,0
15 Times Paris Geller Was Brutally Honest,1,1,6,27,0,6,2,33,0
"Hey, Guys, What's A ""Cheese Stick""",1,1,6,18,5,5,0,24,0
"Can You Spot The Real ""Star Wars"" Character From The Fake",1,1,11,34,2,10,0,45,0
A Minute With Kendall Jenner And Her Wax Figure,1,1,9,30,0,8,0,39,0
These Microscopic Videos Will Make Your Skin Crawl In A Good Way,1,1,12,41,0,11,0,53,0
Mercedes has formed a new alliance to develop robot taxis,1,3,1,47,0,9,0,48,0
26 Pictures That Prove Cats Are Actually Assholes,1,1,7,33,0,7,2,40,0
NYT Calls for Transgender Education in Emergency Rooms,1,2,8,39,0,7,0,47,0
24 Memes That Are Too Good For This World,1,2,8,23,0,8,2,31,0
Kylie Jenner Reportedly Dumped Tyga On His Birthday,1,1,8,36,0,7,0,44,0
People Have A Lot Of Feelings About Tom Daley's Insane Frying Pan,1,1,12,41,1,11,0,53,0
32 Products Every Elephant Lover Needs In Their Home,1,1,8,34,0,8,2,42,0
"Are You More Elle Woods From ""Legally Blonde"" Or Sandy Olsson From ""Grease""",1,1,13,46,4,12,0,59,0
Who pays what? ATO names large companies that paid zero tax in 2014-15,1,2,4,46,2,12,6,50,0
27 Tweets About Starbucks That'll Actually Make You Laugh,1,1,8,38,1,8,2,46,0
37 Life-Changingly Useful Websites You Should Know About,1,1,8,38,1,7,2,46,0
This Man Has Been Sending Letters To The Ocean For 12 Years,1,1,11,35,0,11,2,46,0
19 Beautiful Places In Scotland That Give People All The Feels,1,1,10,40,0,10,2,50,0
Jerusalem Truck Terrorist’s Sister: We’re Thankful To Allah For His ‘Saintly’ Death,1,3,12,55,5,11,0,67,0
Beyond Pizzagate: These are the real conspiracies,1,3,3,39,1,6,0,42,0
Why Parents and Doctors Should Think About A.D.H.D. in Preschool ,1,2,11,40,4,10,0,51,0
27 Wedding Ideas For Mermaids Getting Married,1,1,6,31,0,6,2,37,0
Here's How To Break Up With a Friend Like a Damn Adult,1,1,10,32,1,11,0,42,0
How Lazy Are You And Your S.O,1,1,8,14,1,6,0,22,0
NBA Player Power Rankings: B/R's Top 30 Centers at the Halfway Point,1,3,12,40,3,11,2,52,0
"This Cover Of Drake's ""Hotline Bling"" Is Really, Really Good",1,1,10,37,4,9,0,47,0
The White House is a smoke machine when it comes to Russia,1,3,4,43,0,11,0,47,0
16 Celebrities You Had No Idea Were British,1,1,7,27,0,7,2,34,0
17 Insane Christmas Decorations You Won't Believe Actually Exist,1,1,8,45,1,8,2,53,0
25 Children Have Been Selected From Across India For The Revered National Bravery Awards,1,3,13,60,0,13,2,73,0
These Insane Sandcastle Hotels Really Exist And You Can Actually Stay In Them,1,1,13,52,0,12,0,65,0
"How A 9-Year-Old Rape Survivor, Living With Her Mother On The Streets, Nailed Her Rapist In Court",1,3,18,58,4,16,1,76,0
"How Well Do You Remember These Important Dates From ""Harry Potter?""",1,1,11,43,3,10,0,54,0
16 Extraordinary Black Trans Leaders You Need To Know,1,1,8,35,0,8,2,43,0
GOP lawmaker suffers medical emergency near House floor,1,3,4,44,0,7,0,48,0
"Man accused of violent carjacking involving woman, two children in Lockyer Valley remanded in custody",1,3,3,83,1,14,0,86,0
Can You Make It Through This Post Without Drooling,1,1,9,33,0,8,0,42,0
An Open Letter To Anyone Who's Ever Tweeted Anything Mean About The Rock,1,1,13,46,1,12,0,59,0
The Moments That Turned Charlie Murphy Into a Comedy Legend,1,3,9,41,0,9,0,50,0
Here's the reason United Airlines can kick you off your flight,1,3,3,48,1,10,0,51,0
What's The Best PB&J in LA? - Feast Mode Hunger Squad,1,1,12,27,4,10,0,39,0
We Can Determine If You're A Good Driver Or Not In Three Questions,1,1,13,40,1,12,0,53,0
What Discontinued Fast Food Item Do You Miss The Most,1,1,10,34,0,9,0,44,0
Can You Identify These United States Leaders,1,1,7,31,0,6,0,38,0
Ranking Every Ex-Boyband Song From The Last 20 Years From Really Awful To Really Great,1,3,15,54,1,14,2,69,0
24 Problems You Only Have If You Live In Scotland,1,1,9,29,0,9,2,38,0
Reaction to Trump's top diplomat pick,1,3,2,29,1,5,0,31,0
"7 Essays To Read: Preventing Suicide, Crowdfunding Adoptions, And Being Single",1,1,10,54,3,10,1,64,0
"Ranveer-Deepika's New Year Plans, Salman Beats SRK And More From The World Of Entertainment",1,2,17,58,3,13,0,75,0
13 Men's Rights Activists Share Their Messages For Feminists,1,1,8,41,1,8,2,49,0
Put on your party shoes – it’s time for political hedonism,1,3,1,45,2,10,0,46,0
When Your BFF Gives The Best Dating Advice,1,1,10,25,0,7,0,35,0
Taylor Swift Is Having The Best 2016 So Far,1,1,8,23,0,8,4,31,0
"A Deaf Couple Had An Open Discussion About Love, Sex, And 46 Years Together",1,1,13,45,2,13,2,58,0
8 retailers that are shrinking across America,1,3,1,37,0,6,1,38,0
29 Times #BlackGirlMagic Was More Than Just A Hashtag In 2015,1,1,11,33,1,10,6,44,0
"Do You Remember The Lyrics To ""You Belong With Me"" By Taylor Swift",1,1,13,39,2,12,0,52,0
21 Adorable Fox Products You Need In Your Life,1,1,8,28,0,8,2,36,0
Make These Easy Chicken Fajita Quesadillas At Home,1,1,8,35,0,7,0,43,0
The World Now Knows Jake Gyllenhaal's Real Height Thanks To Conan,1,1,11,43,1,10,0,54,0
21 Skincare Products That Might Help With Acne,1,3,7,30,0,7,2,37,0
"Preacher Locked Up, Charged with Hate Crime for Quoting Bible to Gay Teen",1,3,10,50,1,12,0,60,0
17 Reasons Tina Belcher Is The Best Role Model For Young Girls,1,1,11,38,0,11,2,49,0
BuzzFeed Crossword: Son Of A,1,1,6,17,1,4,0,23,0
"Look At This ""Burping"" Black Hole",1,1,6,20,2,5,0,26,0
10 Recipes To Save Your Sanity,1,1,5,18,0,5,2,23,0
This Sorting Hat Quiz Tells You The House You Definitely Wouldn't Be In,1,1,13,45,1,12,0,58,0
Man arrested after Twitter message urges people to 'Jo Cox an MP',1,2,6,46,2,11,0,52,0
21 People Making The Most Of This Gift Called Life,1,1,9,30,0,9,2,39,0
How carbs are good for your brain: Why pasta and bread lower the risk of dementia and cognitive decline ,1,3,2,82,1,19,0,84,0
6 Types Of People You Meet At A Holiday Party,1,1,9,26,0,9,1,35,0
17 Fitness Tips That Will Actually Make You Psyched To Work Out,1,2,11,39,0,11,2,50,0
Someone Calculated How Rich Harry Potter Was And The Answer Is Surprising,1,1,12,50,0,11,0,62,0
Ava DuVernay Just Slayed An Elle Magazine Cover And It's Breathtaking,1,1,12,46,1,10,0,58,0
This Cute Baby Kangaroo Is So Excited For His Treat And We Can't Handle It,1,1,15,44,1,14,0,59,0
We Know Your Zodiac Sign Based On Your Favorite Songs,1,1,10,34,0,9,0,44,0
19 Of The Best Food Trucks In Los Angeles,1,1,8,23,0,8,2,31,0
People Are Mourning David Bowie On Twitter And It's Both Moving And Heartbreaking,1,1,13,55,1,12,0,68,0
"Jayalalithaa's Health, Modi Wins 'Person Of The Year' Award And Other Must Read Stories",1,3,14,56,4,13,0,70,0
Should You Actually Move To Canada,1,1,6,23,0,5,0,29,0
Nasa announces press conference on 'discovery beyond our solar system' ,1,3,1,58,2,10,0,59,0
Life for gays in the Israeli military just got easier,1,2,2,42,0,9,0,44,0
These kids toys have very detailed genitalia and people want to know why The list,1,2,2,65,0,14,0,67,0
23 Things You'll Get If You Hate Men But Are Also Attracted To Them,1,2,13,38,1,13,2,51,0
Asylum Seekers Suspected of Killing Child To Receive Cash Payouts from Swedish Government,1,3,11,66,0,12,0,77,0
21 Things Everyone Obsessed With CVS Knows To Be True,1,1,11,31,0,9,2,42,0
These 40 cars prove Geneva is the best auto show in the world,1,3,2,45,0,12,2,47,0
How Well Do You Know Katniss Everdeen,1,1,7,24,0,6,0,31,0
"Police: Four Women Arrested for Spraying Anti-Trump, Anti-Police Graffiti in North Carolina",1,3,12,64,4,11,0,76,0
Chris Evans Goes Full Captain America on Former KKK Leader David Duke,1,3,13,45,0,11,0,58,0
"McCain: Trump ‘Has a Point,’ Dossier Leak Was ‘Totally Wrong’",1,3,10,36,6,9,0,46,0
"In 2016’s politics and pop culture, women came up against limits created by men",1,2,1,59,2,13,4,60,0
"Unsurprisingly, Celebrities Were Not Impressed With Donald Trump's Press Conference",1,3,10,62,2,9,0,72,0
This Brave Guy Is Going Viral After Taking A Selfie While His Wife Was Giving Birth,1,1,16,52,0,15,0,68,0
Signs You Overthink Everything,1,1,4,23,0,3,0,27,0
Which Perpetually Miserable Disney Character Are You Really,1,1,8,44,0,7,0,52,0
"Trump’s latest comments stoke talk of a new nuclear arms race, while his press secretary tries to explain",1,3,1,85,2,17,0,86,0
The average wage for almost every job in America - Business Insider,1,3,4,51,1,11,0,55,0
Escaped Chibok Girl on Anniversary of Abduction by Boko Haram: ‘Bring Those Girls Back’,1,2,11,60,3,13,0,71,0
"16 Perfect Tweets About Gender That Will Make You Whisper “Yes, Thank You” Under Your Breath",1,3,15,57,3,15,2,72,0
"Gus Kenworthy's Instagram Photos Are So Good, He Might Have Second Career As A Photographer",1,1,15,60,2,14,0,75,0
'Dear White People' trailer sparks backlash as Netflix faces claims of racism,1,3,4,60,2,11,0,64,0
A woman ordered canaries to brighten her home. The USPS delivered a box of ‘bird carnage.’,1,3,6,65,4,15,0,71,0
Destinations Inside North Korea: fascinating images of the world's most secretive state,1,2,4,70,2,11,0,74,0
19 People Confess Their College Regrets,1,1,5,27,0,5,2,32,0
WATCH: Man Uses Catlike Reflexes to Catch Falling Toddler  Insider,1,3,13,42,1,10,0,55,0
"Aziz Ansari Is Vacationing In India With His Dad, And The Instagrams Are Hilarious",1,1,14,54,1,13,0,68,0
"Stop Everything, The Cast of “Harry Potter” Have A Group Chat",1,3,10,38,3,10,0,48,0
See the Reactions to Chris Brown's Appearance on 'Black-ish',1,3,6,42,4,8,0,48,0
Harvard Law School is making a major change to its admissions policy,1,2,3,54,0,11,0,57,0
What Is Stressing These People Out,1,1,6,23,0,5,0,29,0
"70,000 Evacuated in Greece as WWII Bomb Found",1,3,8,24,1,7,5,32,0
We Need To Talk About Mandy Moore,1,1,7,20,0,6,0,27,0
Big Power Flexing Muscle Boosts Risk for Green Energy Markets,1,3,9,43,0,9,0,52,0
29 Questions I Have For Couples Who Share Social Media Accounts,1,1,10,41,0,10,2,51,0
24 Of The Most Motivational Celebrity Tweets Of All Time,1,1,9,36,0,9,2,45,0
"This Couple Did A ""La La Land"" Engagement Shoot And It’s Pretty Cute",1,3,13,40,3,12,0,53,0
A Regular Guy Trained Like An FBI Agent For A Day And Actually Nailed It,1,1,17,41,0,14,0,58,0
Here's The Complete List Of David Bowie's 100 Favorite Books,1,1,9,37,2,9,3,46,0
9 Reasons Why You Need To Travel Solo At Least Once In Your Lifetime!,1,2,13,41,1,13,1,54,0
This Man Built A Kayak For His Dogs And It'll Give You Serious Squad Goals,1,1,15,44,1,14,0,59,0
29 Times Tom Hardy Was Goddamn Human Perfection In 2015,1,1,8,32,0,9,6,40,0
21 Moments Anyone Who Has Been Day Drunk Will Recognize,1,1,9,35,0,9,2,44,0
69 Facts You Probably Didn't Know About The Spice Girls,1,1,9,34,1,9,2,43,0
This Story Of A Cancer Survivor Getting Her First Haircut Goes From Zero To Feels Real Fast,1,1,17,58,0,16,0,75,0
Two More ‘Significant Arrests’ in Westminster Terror Investigation,1,3,7,50,2,7,0,57,0
Which Romance Film And Ice Cream Combo Are You Based On Your Zodiac,1,1,13,42,0,12,0,55,0
Is Your iPhone Really Frying Your Brain? Five Things You Need To Know,1,2,13,43,1,12,0,56,0
Analysis: Why Voting Rights Advocates Are Worried About a Trump Voter Fraud Probe,1,2,12,56,1,12,0,68,0
We Recreated The Sexiest Photos On Instagram And Here's What Happened,1,1,11,47,1,10,0,58,0
Trump Administration Solicits Border Wall Proposals from Contractors,1,2,7,54,0,7,0,61,0
When Hate Speech Comes To Campus,1,1,6,21,0,5,0,27,0
11 Most Memorable Pop Culture Moments of 2016 ,1,2,5,27,0,8,6,32,0
How Stereotypically Dad Is Your Dad,1,1,6,24,0,5,0,30,0
18 Hilarious Reactions To Netflix Launching In India,1,1,7,36,0,7,2,43,0
Samantha Bee Had The Perfect Reaction To Vanity Fair's All-Male Comedy Cover,1,1,13,50,2,11,0,63,0
American Gods: Who is Wednesday? Meet the deities in Starz's drama,1,3,6,47,3,10,0,53,0
How Well Do You Remember Ted Mosby's Girlfriends? Part 1,1,1,9,35,2,9,1,44,0
"This Duet Cover Of Adele's ""Hello"" Will Give You Intense Goosebumps",1,1,11,43,3,10,0,54,0
"$50,000 Reward for Facebook Killer as Manhunt Goes ‘National’",1,3,6,38,4,8,5,44,0
What Was The Most Ridiculous Sex Rumour That Went Around Your School,1,1,12,45,0,11,0,57,0
Ranking the top 10 hoop shoe ads of all time,1,3,1,32,0,9,2,33,0
Brewery gives time off for new puppy parents,1,3,1,36,0,7,0,37,0
"Which Character From ""National Treasure"" Are You",1,1,7,33,2,6,0,40,0
This Is What Disney Villains Would Look Like In Real Life,1,1,11,36,0,10,0,47,0
People Try An Existential Haunted House,1,1,6,28,0,5,0,34,0
Fresh Fruit Sushi,1,1,3,12,0,2,0,15,0
Why Does the Cable-TV Bundle Exist Anyway?,1,3,8,26,2,6,0,34,0
35 Meatless Monday Recipes For People Who Hate Tofu,1,1,8,33,0,8,2,41,0
Why Trump’s order to cut government regulation is even bolder than it seems,1,3,2,60,1,12,0,62,0
12 Moments That Prove Queer Teens Totally Won 2016,1,2,7,29,0,8,6,36,0
20 Best K-Pop Songs of 2016: Critic's Picks,1,2,6,21,3,7,6,27,0
We Need To Talk About Guys Wearing Basketball Shorts,1,1,9,35,0,8,0,44,0
Disney Goes Gay in ‘Beauty and the Beast’ Remake,1,3,6,32,2,8,0,38,0
Tell Us About The Life-Changing Product That Helped Your Adult Acne,1,1,12,44,1,10,0,56,0
This Muslim Professor Is Offering To Treat People To A Pork Meal To Stand Up Against Intolerance,1,1,17,63,0,16,0,80,0
Trump Era Invites a Bolder Hollywood Red Carpet ,1,3,7,33,0,8,0,40,0
'They escorted me as if I were a terrorist',1,2,2,31,2,8,0,33,0
10 Truths Eurasians Know Too Well,1,1,5,21,0,5,2,26,0
"Ex-teacher Admits to Sleepover With Student, Playing Strip Basketball With Others",1,3,10,59,2,10,0,69,0
5 Last-Minute Gifts Ideas For Music Loving Sneakerheads,1,2,8,38,1,7,1,46,0
21 Budget-Friendly Adventures Worth Taking In The New Year,1,1,9,38,1,8,2,47,0
It Sounds Like Taylor Swift Responded To Kanye West In Her Grammys Speech,1,1,13,48,0,12,0,61,0
"Perrie Edwards Recreated Britney's ""Baby One More Time"" And It's Perfect",1,1,11,47,4,10,0,58,0
Dick Costolo tweet after resignation - Business Insider,1,3,4,43,1,7,0,47,0
Can We Guess Your Favorite Avril Lavigne Song Based On Your Zodiac,1,1,12,43,0,11,0,55,0
39 British Men Who Want To Rip Off Your Clothes Right Now,1,2,11,33,0,11,2,44,0
Airport expansion: Heathrow v Gatwick,1,3,3,29,1,4,0,32,0
Protomartyr's Joe Casey Isn't Too Old For Indie Rock,1,1,9,33,2,8,0,42,0
Bangladesh Family: ‘Vogue’ Model Killed for Refusing to Wear Islamic Garments,1,2,9,55,3,10,0,64,0
Fasten up: readers' photos on the theme of attach,1,2,1,38,2,8,0,39,0
Facebook is about to announce its fourth-quarter earnings â hereâs what to expect,1,3,1,67,5,12,0,68,0
Red Alert Politics: MILO Will Outsell Hillary Clinton,1,2,11,34,1,7,0,45,0
11 Signs You Actually Have Senioritis,1,1,5,25,0,5,2,30,0
"Which Is Better: ""Hocus Pocus"" Or ""Halloweentown""",1,1,7,31,5,6,0,38,0
Can You Make It Through This Girl Scout Cookie Face Off?,1,3,11,34,1,10,0,45,0
Which TV mum are you?,1,3,3,13,1,4,0,16,0
17 Facebook Life Events That Are Actually Worth Bragging About,1,1,9,42,0,9,2,51,0
21 Songs You Grinded To Five Years Ago,1,1,7,22,0,7,2,29,0
"21 Real, Frustrating, And Neverending Struggles Of Being A Tidy Student",1,1,10,47,2,10,2,57,0
Reading American cities: books about Honolulu,1,2,3,36,1,5,0,39,0
"33 Badass ""Scream Queens"" GIFs For Every Possible Scream-Worthy Situation",1,1,12,47,3,9,2,59,0
Just A Reminder That Keira Knightley Used To Dress Like This,1,1,11,39,0,10,0,50,0
Attorney General Jeff Sessions : ‘I Will Recuse Myself’ If Necessary,1,3,10,45,3,10,0,55,0
Which country should you live in based on your zodiac sign,1,1,1,47,0,10,0,48,0
55 Delicious Desserts For People Who Hate Chocolate,1,1,7,35,0,7,2,42,0
Emma Watson's New Haircut Is Literally The Definition Of Flawless,1,1,10,45,1,9,0,55,0
New planet discovered by 15-year-old intern,1,2,1,33,2,5,2,34,0
Here Are Some Of The Most Powerful Images From Airport Protests Across The US,1,2,15,49,0,13,0,64,0
Show Us Your White Ink Tattoos,1,1,6,19,0,5,0,25,0
Captain America Actor Gives Tom Brady ‘A Pass’ For Supporting Trump,1,3,11,44,2,10,0,55,0
What Was The Worst Netflix And Chill You've Experienced,1,1,9,37,1,8,0,46,0
Was Darth Vader’s ‘Rogue One’ pun forced? Many Star Wars fans find it disturbing.,1,3,8,55,5,13,0,63,0
25 Feminist Songs That Always Make You Feel Like A Boss,1,1,10,33,0,10,2,43,0
17 Celebrities Who Opened Up About Mental Health In 2016,1,2,8,33,0,9,6,41,0
15 Great Pieces Of Relationship Advice From Books,1,1,7,33,0,7,2,40,0
Can We Guess What Month You Were Born With A Single Question,1,1,12,37,0,11,0,49,0
Things Nobody Told Me About Depression,1,1,6,27,0,5,0,33,0
This What Your Snapchat Story Would Have Looked Like Ten Years Ago,1,1,12,43,0,11,0,55,0
17 People Who Just Want To GOP Debate And Chill,1,1,11,25,0,9,2,36,0
What to Expect in U.K. Markets When May Pulls Brexit Trigger,1,3,10,38,2,10,0,48,0
"PSA: There's A Chrome Extension That Blocks ""Star Wars"" Spoilers",1,1,12,39,4,9,0,51,0
The 50p coins that could be worth £100s,1,3,1,25,1,7,5,26,0
This is what pilots do when their brakes fail and they're coming in to land The list,1,3,2,65,1,16,0,67,0
21 Pictures That Accurately Describe What It's Like To Be Alive,1,1,10,40,1,10,2,50,0
Why is Walmart buying up brands?,1,3,2,24,1,5,0,26,0
18 Baby Rhinos Learning How To Rhino,1,1,6,22,0,6,2,28,0
A Pigeon Ate A Rat Just Like That Other Rat Ate A Pizza,1,1,13,30,0,12,0,43,0
What to look out for in Africa during 2017,1,3,2,28,0,8,4,30,0
7 Weeknight Dinners That Everybody Will Love,1,1,6,31,0,6,1,37,0
Thierry Henry Reacted Brilliantly To Brendan Rodgers Getting Sacked And It Became A Huge Meme,1,1,15,64,0,14,0,79,0
What Size Mattress Do You And Your Partner Need,1,1,9,30,0,8,0,39,0
Stargazing guide: Look up and see these 10 things in April Featured Stories Additional stories,1,3,6,71,1,14,2,77,0
Theresa May visited a school in Copeland today and it really didn't go well The list,1,3,4,64,1,15,0,68,0
24 Reasons Cara Delevigne Is The Boss Of Instagram,1,1,8,32,0,8,2,40,0
9 people who discovered just how terrible their exes really are The list,1,2,1,58,0,12,1,59,0
17 Reasons All Women Should Have Long Hair,1,1,7,26,0,7,2,33,0
Pakistan 'honour': Tracing the final steps of a woman searching for love,1,2,2,56,3,11,0,58,0
Who Said It: Donald Trump Or Jack Donaghy,1,1,8,25,1,7,0,33,0
Can You Guess What Happens When You Try To Eat 50 McDonald's Nuggets In 5 Minutes,1,1,15,47,1,15,3,62,0
Do You Have A Secret Dark Side That Would Surprise People,1,1,11,36,0,10,0,47,0
This Pizza Test Will Reveal Why You’re Still Single,1,3,9,33,1,8,0,42,0
21 Magical Places In The South You Won't Believe Actually Exist,1,1,10,40,1,10,2,50,0
"A three-day wedding celebration? Do learn some restraint, says Country Life",1,2,4,58,3,10,0,62,0
Annie Lennox: 'AIDS Isn't Over...We Still Have a Long Way to Go',1,3,14,32,7,11,0,46,0
Take This Quiz And It'll Reveal Something Actually Factual About You,1,1,11,46,1,10,0,57,0
We Got A Bunch Of Strangers To Give Us Their Netflix Log-In,1,1,13,34,1,11,0,47,0
How Bad At Flirting Are You Actually,1,1,7,23,0,6,0,30,0
Tech Startups Woo Investors With Unconventional Financial Metrics — but Do Numbers Add Up?,1,3,12,63,2,13,0,75,0
US truck driver 'loses his marbles' on Indiana highway,1,2,3,41,2,8,0,44,0
45 Things I Wish Someone Had Told Me About Antidepressants,1,1,9,38,0,9,2,47,0
"Why ""What's Up?"" Is The Most Awkward Question In Existence",1,1,10,35,4,9,0,45,0
13 Bollywood Moments That Changed The Face Of Swimwear In India,1,1,10,41,0,10,2,51,0
Which Pop Star Are You Based On Your Zodiac Sign,1,1,10,29,0,9,0,39,0
"17 Confessions From The Biggest ""American Horror Story"" Fans",1,1,8,40,2,8,2,48,0
19 People You Know Are Definitely Dead Now,1,1,7,26,0,7,2,33,0
Sarah Silverman Mistakes Construction Markings for Swastikas,1,2,6,48,0,6,0,54,0
"Make In India Cars Crash Tested Again, Results Not Very Pretty",1,3,11,40,1,10,0,51,0
These Two Pictures Perfectly Sum Up What's Wrong With Indian Beauty Standards,1,1,12,53,1,11,0,65,0
49 Gross Things Most Girls Secretly Enjoy,1,3,6,27,0,6,2,33,0
James Corden Suggests A New Catchphrase For America's Economy,1,3,9,43,1,8,0,52,0
"My Long, Exhausting Summer Of Street Harassment Is Over",1,1,9,37,1,8,0,46,0
How this tech incubator started by Google is tackling the world's biggest geopolitical issues online,1,2,2,83,1,14,0,85,0
Young Thug Wears a Dress on the 'Jeffery' Cover,1,3,6,31,2,8,0,37,0
27 Gifts For People Who Care More About Food Than They Do You,1,1,12,35,0,12,2,47,0
Trump Era Invites a Bolder Hollywood Red Carpet ,1,2,7,33,0,8,0,40,0
15 Things You Just Might Have In Common With Helga Pataki,1,1,10,35,0,10,2,45,0
"Do You Remember The Opening Of Charlie Chaplin's ""The Great Dictator"" Speech",1,1,12,50,3,11,0,62,0
Mads Mikkelsen Is Fucking Amazing At Dancing,1,3,7,31,0,6,0,38,0
Do You Remember The Characters In “Zootopia”?,1,2,7,29,3,6,0,36,0
This Heartwarming Photo Captures The Moment An Elderly Couple Helped A Young Man Tie His Tie,1,1,16,61,0,15,0,77,0
"Carrie Fisher's Daughter Is In The New ""Star Wars"" Movie Rocking Leia Buns",1,1,13,46,3,12,0,59,0
Modi's New Year Plans With All Of India + 5 More Stories You Need To Read Today,1,2,15,45,2,16,1,60,0
35 Very Important Questions I Need Yoshi To Answer Right Now,1,1,10,38,0,10,2,48,0
16 GIFs That Will Ruin Your Childhood,1,1,8,21,0,6,2,29,0
"If ""Friends"" Was Set In The USSR",1,1,10,14,2,6,0,24,0
How the Humble Taco Inspired a $750 Mexican Meal,1,3,6,30,1,8,3,36,0
Paris bans cars registered before year 2000 in bid to combat city pollution,1,2,1,58,0,12,4,59,0
31 Questions We Have For Gynecologists,1,1,5,26,0,5,2,31,0
Steven Spielberg's 'Jurassic Park' decision that changed movies forever,1,3,4,56,3,8,0,60,0
"7 Reasons To Listen To BuzzFeed's New Podcast ""The Tell Show""",1,1,11,36,3,10,1,47,0
The Best College Football Players You've Never Heard of,1,3,8,38,1,8,0,46,0
What Type Of Thanksgiving Turkey Should You Make,1,1,8,33,0,7,0,41,0
The woman running 40 marathons in 40 days,1,3,1,29,0,7,4,30,0
Trump and Pence Keeping Pro-Life Promises in First 100 Days,1,3,8,38,1,9,3,46,0
19 Times Tumblr Totally Nailed What Texting Is Like,1,1,8,33,0,8,2,41,0
Trump Supporters Inadvertently Show How Easily Misinformation Spreads Online,1,2,9,59,0,8,0,68,0
StubHub finally gets social,1,3,2,22,0,3,0,24,0
We Tracked Down The Guy In One Of Canada's Greatest Memes,1,1,11,35,1,10,0,46,0
Zac Efron Is Taking Swim Lessons And There Are Photos,1,1,10,34,0,9,0,44,0
Who Is The Most Iconic Diva Of All Time,1,1,9,22,0,8,0,31,0
The Coretta Scott King letter Elizabeth Warren was trying to read,1,3,6,49,0,10,0,55,0
Celebrity Halloween Costumes: 2015 Edition,1,1,4,29,1,4,4,33,0
Meet the Woman Who Claims to Have the Most Tinder Matches Ever,1,2,9,42,0,11,0,51,0
Chairman Zhang's flatpack skyscrapers   ,1,2,2,31,4,6,0,33,0
Modernizing The U.S. Army Could Make Nuclear War With Russia Less Likely,1,3,13,46,2,11,0,59,0
"Can You Identify These ""The Simpsons"" Characters By Their Feet",1,1,10,41,2,9,0,51,0
Durant's return to OKC a reunion made for the NBA,1,3,7,32,1,9,0,39,0
36 Happy Dogs For The Sad People Out There,1,1,8,24,0,8,2,32,0
Here’s What We Know About Trump’s Mexico Wall,1,3,8,28,2,7,0,36,0
"How to Accumulate ""Soft Skills"" to Complement Your MBA | Ashford University",1,3,11,50,3,11,0,61,0
Which Current Disney Channel Show Are You,1,1,7,28,0,6,0,35,0
"As Womadelaide turns 25, what counts as 'world music'?",1,3,2,38,4,8,2,40,0
1 Indian + 1 Indian = Unrelatable: Television's Race Equations,1,1,6,41,4,9,2,47,0
The Most Popular Bar In Every State In 2015,1,1,8,23,0,8,4,31,0
Daylight Savings Is The Literal Worst And No One Is Talking About It,1,1,13,43,0,12,0,56,0
These Goldfish Tea Bags Are The Friends You Never Knew You Needed,1,1,12,42,0,11,0,54,0
Miller: We Have Provided ‘Enormous’ Evidence of Voter Fraud,1,2,8,40,3,8,0,48,0
This person shut down a Twitter troll so hard even J.K. Rowling approved,1,3,5,53,2,12,0,58,0
15 Weird Things You Never Knew There Were Words For,1,1,9,31,0,9,2,40,0
"Doug Keeps On Doing That Whole Murder Thing In The New ""House Of Cards"" Trailer",1,1,15,48,2,14,0,63,0
We Know Your New Year's Eve Plans Based On Your Favorite 2015 Song,1,1,12,37,1,12,4,49,0
We Can Guess Your Eye Color With Just Three Questions,1,1,10,34,0,9,0,44,0
15 Vampire Recipes That'll Make Your Halloween Party An Instant Success,1,1,10,48,1,10,2,58,0
The 20 Weirdest Couples Of The Early(ish) 2000s,1,1,6,26,2,7,6,32,0
"In its first attempt at Brexit negotiations, the UK made a fool of itself – and there's more of this to come",1,3,4,80,3,21,0,84,0
5 Fall Beauty Trends You Can Rock Right Now [Video],1,3,9,30,2,9,1,39,0
27 Signs We've Reached Peak Kale,1,1,5,19,1,5,2,24,0
12 Ways To Get That Bacon Fix Without Giving Yourself Cancer,1,1,10,38,0,10,2,48,0
How to make a British business sound 'hip' – add the word Brooklyn,1,3,3,48,3,12,0,51,0
Here Are All The Parts Of A Corgi You Need To Know,1,1,12,27,0,11,0,39,0
We Know Your S.O.'s Zodiac Sign Based On Your Favourite Things,1,1,12,37,3,10,0,49,0
Short sellers are piling into Tesla,1,3,2,28,0,5,0,30,0
This Mom Shared What Her Body Looked Like Just 24 Hours After Giving Birth,1,1,13,46,0,13,2,59,0
Some People Think Gigi Hadid Kinda Looks Like Fergie,1,1,9,35,0,8,0,44,0
These Earbuds Give You Superhuman Hearing -- And Could Treat Autism & PTSD,1,3,14,45,3,12,0,59,0
19 Pictures That Are Way Too Real During Finals,1,1,8,29,0,8,2,37,0
'Bambi' rescued from frozen lake,1,3,1,25,2,4,0,26,0
12 Things No Woman Should Ever Feel Bad About,1,1,8,27,0,8,2,35,0
"Pre-suasion: How to influence people to give you a job, according to a psychologist",1,3,2,65,3,13,0,67,0
19 Things Anyone With Shitty Nails Will Understand,1,1,7,34,0,7,2,41,0
"India's Men Need Paternity Leave As Much As Women Need Maternity Leave, Here's Why",1,3,14,52,3,13,0,66,0
26 Charts That Will Actually Make You A Happier Person,1,1,9,34,0,9,2,43,0
How Well Do You Know Spanglish From Spanish,1,1,8,28,0,7,0,36,0
"I Tried Those Backless, Strapless Bras To See If They Were Actually Worth It",1,2,14,48,1,13,0,62,0
These will be the 32 most powerful economies in the world by 2050,1,3,1,46,0,12,6,47,0
PSA For Women: Not Everyone Is Going To Like You And That's OK,1,1,16,32,2,12,0,48,0
Inside The Natural History Museum's Wonderfully Creepy Room Of Things In Jars,1,1,12,53,1,11,0,65,0
Keep the belief in Santa alive and well with this Chrome extension,1,3,3,52,0,11,0,55,0
18 Moments Of Incredible Humanity During The Chennai Rains,1,1,8,40,0,8,2,48,0
18 Confessions From Men Who Call Themselves Feminists,1,1,7,37,0,7,2,44,0
How '13 Reasons Why' is different than other YA adaptations,1,3,5,41,2,9,2,46,0
11 Iconic George Michael Recordings That You Absolutely Must Listen To,1,3,10,48,0,10,2,58,0
"In A Rare Move, Supreme Court Allows 24-Week Pregnant Woman To Abort",1,2,12,41,2,11,2,53,0
"If ""American Me"" Quotes Were Inspirational Posters",1,1,7,35,2,6,0,42,0
Celebrity Holiday Cards 2016,1,2,3,18,0,3,4,21,0
"7 Essays To Read: Smoking To Get Sober, Asian Pseudonyms, And Loneliness",1,1,11,46,3,11,1,57,0
23 Words Everyone Should Stop Saying Immediately,1,1,6,34,0,6,2,40,0
Investment Guide 2017,1,2,2,13,0,2,4,15,0
"Isaiah Thomas Tweets Emoji, Everyone Obsesses over Meaning",1,3,7,43,1,7,0,50,0
29 Signs You're Actually A Witch,1,1,5,19,1,5,2,24,0
This Former Binge-Eater Is Taking A Stand Against Fat-Shamers With Her Yoga,1,1,14,48,2,11,0,62,0
"Raisins Are The Fucking Worst, Let's Ban Them Forever",1,1,9,34,2,8,0,43,0
How Well Do You Know Christmas Movie Titles,1,1,8,28,0,7,0,36,0
This transcript of Donald Trump's victory rally should terrify anyone with a reading age over 12 The list,1,3,4,81,1,17,2,85,0
Get creeped out by this tense trailer for the new WikiLeaks documentary,1,3,3,57,0,11,0,60,0
GOLDMAN: Here are our biggest fears for 2017,1,3,8,24,1,7,4,32,0
"The $206 Phone Case Kendall Jenner, Hailey Baldwin, and Other Models Are Obsessed With",1,3,12,55,3,13,3,67,0
We Have To Talk About Selena Gomez Right Now,1,1,9,27,0,8,0,36,0
17 Pictures Of Ben Folds And His Glasses,1,1,7,24,0,7,2,31,0
"Which ""Hunger Games: Mockingjay, Part 2"" Character Are You",1,1,8,37,4,8,1,45,0
Watch an Artist Carve a Hotel Suite Out of Ice in One Minute,1,2,9,39,0,12,0,48,0
34 Online Shops Based In The Southeast You Should Be Shopping At,1,1,11,40,0,11,2,51,0
"Republican Party, Megyn Kelly, Titanic: Your Wednesday Briefing ",1,3,8,45,3,8,0,53,0
"We Know Your Favorite ""Game Of Thrones"" Character Based On Your Favorite Taylor Swift Look",1,1,15,59,2,14,0,74,0
"Here's How To Actually Heal Your Dry, Chapped Lips",1,1,9,31,2,8,0,40,0
"Pizza Lovers Rejoice, Someone Invented A Necklace That Holds A Pizza Slice In",1,1,13,51,1,12,0,64,0
These 8 men are richer than 3.6 billion people combined,1,2,1,41,1,9,3,42,0
When Adele Releases A New Song,1,1,6,19,0,5,0,25,0
25 Faces Everyone Who's Home For Thanksgiving Will Recognize,1,1,8,41,1,8,2,49,0
Russell Westbrook Dodges Questions About Kevin Durant in a Hilarious Way,1,3,9,53,0,10,0,62,0
8 Super Romantic Ways To Tell Someone You Love Them,1,1,9,32,0,9,1,41,0
Australia's forgotten pantsuit pioneer,1,3,1,33,1,3,0,34,0
Arkansas Faces Another Hurdle in Upcoming 8 Executions — Finding Witnesses,1,3,8,54,1,10,1,62,0
"The Internet Can't Stop Sharing This Insane Tabla Cover Of ""How Deep Is Your Love""",1,1,15,50,3,14,0,65,0
Youâre using your freezer wrong â hereâs the right way to stock frozen food,1,3,1,61,6,13,0,62,0
How Well Do You Know The iPhone Battery Indicator,1,1,9,32,0,8,0,41,0
14 Retro Adverts That Would Never Be Published Today,1,1,8,34,0,8,2,42,0
Quiz: How well do you know your Disney sports movies?,1,3,3,39,2,9,0,42,0
Woman Buys 23-Pound Lobster Named 'King Louie' to Set Him Free - Yahoo,1,2,11,41,4,12,2,52,0
Can You Guess Which Celebrity This Tweet Belongs To,1,1,9,34,0,8,0,43,0
15 Times The Onion Proved Humanity Is Too Predictable,1,1,8,35,0,8,2,43,0
Scottish independence referendum: what Nicola Sturgeon said and what she really meant ,1,3,3,70,1,12,0,73,0
Would the End of Tipping Mean the End of Good Service?,1,2,7,36,1,10,0,43,0
In pictures: Kenyans share their dinner to save livestock,1,3,2,46,1,8,0,48,0
26 Infuriating Things That Happen In All Horror Movies,1,3,8,36,0,8,2,44,0
We Bet You Can't Solve This Really Hard Geometry Problem,1,1,10,36,1,9,0,46,0
21 Things Everyone Obsessed With Forever 21 Knows To Be True,1,1,9,37,0,10,4,46,0
These badass women exercising to Maya Angelou's poetry is all the inspiration you need today,1,3,3,74,1,14,0,77,0
"How Well Do You Actually Know Belle From ""Beauty And The Beast""",1,1,12,38,2,11,0,50,0
Cop Whose House Burned Down Gets Christmas Surprise From Randy Travis  Insider,1,3,12,54,0,12,0,66,0
"17 Questions That Are Impossible For All ""Harry Potter"" Fans To Answer",1,1,11,44,2,11,2,55,0
"South Carolina's Twitter Trolls Duke After Loss, Posts Link to 'DidDukeWin.com'",1,3,12,52,5,10,0,64,0
Travel Truths The truth about oxygen masks on planes,1,3,3,41,0,8,0,44,0
What Christmas Carol Should You Sing Based On Your Zodiac Sign,1,1,11,41,0,10,0,52,0
Which Disney Villain Are You Based On Your Zodiac Sign,1,1,10,35,0,9,0,45,0
What Does Your Favorite Comedian Say About Your Personality Type,1,1,10,45,0,9,0,55,0
Cab Driver Praises John Elway Without Realizing He's in Back Seat,1,2,10,44,1,10,0,54,0
This Website Will Tell You If Your Favorite Bands Are Emo Or Not,1,1,13,39,0,12,0,52,0
What happens if you don't file your tax return?,1,3,1,36,2,8,0,37,0
"Can We Guess How Often You Say The Word ""Fuck""",1,1,10,25,2,9,0,35,0
22 Pieces Of Beautifully Minimalist Geometric Jewellery,1,1,6,41,0,6,2,47,0
A Beaver Somehow Ended Up Herding Cattle On A Saskatchewan Ranch,1,2,11,43,0,10,0,54,0
Facebook video helps man find the woman who saved his life,1,3,1,47,0,10,0,48,0
This ancient Greek memory test can help you remember where you left your keys The list,1,2,3,68,0,15,0,71,0
We're Launching Our First Ever Series On iTunes,1,1,8,31,1,7,0,39,0
This Guy's Comics Hilariously Sum Up The Truth About Being A Parent,1,1,12,43,1,11,0,55,0
Meet The Body-Positive Artist Who's Giving Trolls A Taste Of Their Own Medicine,1,1,14,51,2,12,0,65,0
19 cocktails you've probably never heard of but should start drinking immediately,1,3,0,67,1,11,2,67,0
Magicians Play Magic: The Gathering,1,1,5,25,1,4,0,30,0
Why This Mom Is Certain Her C-Section Scar Makes Her A 'Badass Mama',1,2,14,39,3,12,0,53,0
"23 Thoughts We Had While Watching ""Yuri!!! On Ice"" For The First Time",1,3,12,38,5,12,2,50,0
This Cute Cat Makes It Hard To Leave The House,1,1,10,27,0,9,0,37,0
Take a look at what employees at companies like Facebook and LinkedIn do for fun in the office,1,3,4,73,0,17,0,77,0
Snack Bars Push the Price Envelope and Find Consumers Don’t Push Back ,1,3,10,47,1,12,0,57,0
The Risk of Rising Consumer Borrowing ,1,2,5,27,0,6,0,32,0
Here's What You Should Eat For Dinner Tonight,1,1,8,29,1,7,0,37,0
17 Beautifully Designed Mermaid Tattoos,1,1,4,29,0,4,2,33,0
7 Easy Things You Can Do To Improve Your Life,1,1,9,26,0,9,1,35,0
11 Slightly Horrifying Facts That Will Stop You Biting Your Nails,1,1,10,43,0,10,2,53,0
14 Times Canada Completely Ruined Your Halloween,1,1,6,34,0,6,2,40,0
Which Hogwarts Houses Do These '90s Nickelodeon Characters Belong In,1,1,9,47,1,9,2,56,0
"18 Times Cory And Topanga Set The Relationship Bar Way, Way Too High",1,1,12,41,1,12,2,53,0
13 Celebrity #TBT Photos You May Have Missed This Week,1,1,11,31,1,9,2,42,0
"15 Times ""Broad City"" Was The Best Part Of 2015",1,1,8,22,2,9,6,30,0
14 Green Smoothies For People Who Can Still Taste The Kale,1,1,10,36,0,10,2,46,0
The Amazing Origin Of Cotton Candy Raccoon Has Finally Been Revealed,1,1,11,47,0,10,0,58,0
21 Hilariously Weird Phobias You Wouldn't Believe People Have,1,1,8,42,1,8,2,50,0
We Need To Talk About Snoke,1,1,6,16,0,5,0,22,0
"Another Round, Episode 30: Frimfram Fittlesworth",1,1,5,34,2,5,2,39,0
Donald Trump tweeted about International Women's Day and everyone's making the same joke,1,3,5,69,2,12,0,74,0
"Guess How Many Times Gigi Hadid Touched Her Hair In ""How Deep Is Your Love""",1,1,15,44,2,14,0,59,0
29 Gifts Only True Makeup Addicts Will Appreciate,1,3,7,33,0,7,2,40,0
Answer This One Question And We'll Determine If You're Really From Texas,1,1,12,47,2,11,0,59,0
11 Moments Everyone Who's Met A Fuckboy Will Understand,1,1,8,36,1,8,2,44,0
Behar: Hillary Supporters Are ‘Sore Losers’ — Trump Didn’t Win ‘Legitimately’,1,3,10,50,7,10,0,60,0
23 People Who Should Not Have Tweeted In 2015,1,1,7,24,0,8,6,31,0
Police Officer Who Spoke out on Migrant Crime Now Under Investigation for Racial Hatred,1,3,11,63,0,13,0,74,0
18 Maps That Will Change How You See The World,1,1,9,26,0,9,2,35,0
Why are liberals now cheerleading a warmongering Donald Trump?,1,3,3,50,1,8,0,53,0
24 mind-blowing facts about Warren Buffett and his $70 billion fortune,1,2,2,52,2,10,4,54,0
"How Well Do You Remember Chapter One Of ""Stranger Things""?",1,3,10,36,3,9,0,46,0
Surprising Beauty Hacks Using Coffee Grounds,1,1,6,33,0,5,0,39,0
‘The Americans’: Why a TV show about the Cold War is more relevant than ever [Video],1,3,8,56,5,15,0,64,0
"Who, What, Why: How do dogs donate blood?",1,3,4,26,4,7,0,30,0
Indian army cancels recruitment exams after 'leak',1,3,1,41,2,6,0,42,0
"In 100 Days, Trump Has Found 29 Ways To Screw Regular Americans",1,3,10,36,1,11,5,46,0
This New Manicure Trend Will Turn Your Manicure Into An Aquarium,1,3,11,43,0,10,0,54,0
Amazon’s Flying Warehouse Idea Isn’t Even Its Biggest Challenge,1,3,9,44,2,8,0,53,0
"A Lot Of People Think The Gray-Haired Reporter In ""Making A Murderer"" Is Hot",1,1,15,45,3,13,0,60,0
17 Life-Changing Ways To Eat An Oreo,1,1,7,20,1,6,2,27,0
Letters from Africa: Nigeria's art of flowery language,1,3,3,42,2,7,0,45,0
24 Desserts Guaranteed To Make Caramel Lovers Drool,1,1,7,35,0,7,2,42,0
Women Who Love Wine,1,1,4,12,0,3,0,16,0
19 Things Only Sensible People Will Relate To,1,1,7,29,0,7,2,36,0
22 Photos That Prove Black Girls Have Been Magic For A Long Time,1,1,12,38,0,12,2,50,0
10 Christmas Movie Drinking Games You'll Want To Play This Year,1,1,10,40,1,10,2,50,0
Cosmetics Crooks Steal $4.5M in Eye Shadow From Warehouse: LAPD,1,3,12,37,3,9,2,49,0
Chinese Carmakers Think They Can Finally Win America Over With an SUV,1,3,13,45,0,11,0,58,0
Super Bowl LI quiz: Should you root for the Falcons or Patriots?,1,3,7,44,2,11,0,51,0
2017 NFL Mock Draft: Matt Miller's Final 7-Round Predictions,1,3,10,34,3,8,5,44,0
Airbnb offers free housing to those hit by Trump ban,1,3,2,41,0,9,0,43,0
These beer gardens are the best places to finally welcome spring,1,3,1,53,0,10,0,54,0
This Is What Using The Huge iPad Pro Is Actually Like,1,1,11,32,0,10,0,43,0
What Are Some Crazy Smart Tricks That Save You Money,1,1,10,33,0,9,0,43,0
17 Things All Lazy Couples Will Just Get,1,1,7,24,0,7,2,31,0
19 Contacts Everyone Has In Their Phone,1,1,6,25,0,6,2,31,0
"Joel Embiid Gives Rihanna a Shoutout, Says He Loves Her",1,3,9,36,1,9,0,45,0
This 'Game of Thrones' statue is the stuff nightmares are made of,1,3,3,49,2,11,0,52,0
Charles Oakley Blasts Charles Barkley Over LeBron James Comments,1,2,10,46,0,8,0,56,0
23 Unforgettable Things All '00s Teens Did Every Autumn,1,1,7,35,1,8,4,42,0
18 Of The Most Important New Year's Resolutions Stated In Five Words,1,1,11,43,1,11,2,54,0
How to Beat the Bots ,1,2,3,13,0,5,0,16,0
Kim Kardashian Accidentally Shared A Retouched Selfie And The Original,1,1,10,51,0,9,0,61,0
24 Hilarious Products That Just Might Make You Pee Your Pants,1,2,10,39,0,10,2,49,0
"How J.P. Morgan Won, Then Lost, Indonesia’s Business ",1,3,9,31,5,8,0,40,0
I got bumped from a flight. Then I sued,1,3,3,27,1,8,0,30,0
30 Early 2000s Country Songs That Will Make Your Day Better,1,1,9,34,0,10,6,43,0
26 Incredibly Cozy Dorms You'd Actually Want To Live In,1,1,9,34,1,9,2,43,0
15 Delectable Overnight Oats That Are Totally Worth Getting Out Of Bed For,1,1,12,48,0,12,2,60,0
21 People Who Trolled Gordon Ramsay With Their Shitty Food Tweets,1,3,10,43,0,10,2,53,0
12 Christmas Movies Streaming on Netflix That Don't Suck,1,2,7,38,1,8,2,45,0
The Drinking Water In This Town Turned Bright Pink And It Was Weird,1,3,13,42,0,12,0,55,0
We Need To Talk About Gigi Hadid For Like 10 Seconds,1,1,10,30,0,10,2,40,0
Internet Can't Keep Calm Over Absconder Vijay Mallya's Arrest And Bail Within 3 Hours!,1,3,13,56,3,13,1,69,0
Jason Derulo Just Performed On A Hoverboard At The EMAs And It Was Glorious,1,1,16,46,0,13,0,62,0
We Know Which Taylor Swift Hairstyle Would Look Best On You,1,1,11,38,0,10,0,49,0
What will season's first marquee weekend reveal?,1,3,1,39,2,6,0,40,0
Here's What Happened When I Made A Three-Course Meal Using Just A Microwave,1,1,14,47,2,12,0,61,0
Quebec mosque attack: Student Alexandre Bissonnette charged,1,3,4,48,1,6,0,52,0
How Well Do You Remember The 2015 Oscars,1,1,7,22,0,7,4,29,0
The Beauty Trends You’re Going to See Everywhere This Fall,1,2,9,39,1,9,0,48,0
Here’s Why Dozens of Celebrities Are Making the ‘W’ Sign [Video],1,2,9,40,5,10,0,49,0
22 Times Tumblr Accurately Summed Up Lesbian Dating,1,1,7,35,0,7,2,42,0
Only Johnny Manziel could conduct an illegal workout with a CFL team,1,3,6,51,0,11,0,57,0
NYT: Amnesty Is the ‘Only Long-Term Solution’,1,2,9,26,4,6,0,35,0
21 Questions Every Single Person In L.A. Has Asked Themselves,1,1,10,38,2,9,2,48,0
People Try Making Pinterest Christmas Crafts,1,1,6,33,0,5,0,39,0
13 Haikus Only Single People Will Relate To,1,1,7,27,0,7,2,34,0
"Watch the Full Pre-Credits 'Deadpool 2' Teaser, Courtesy Ryan Reynolds",1,2,9,47,4,9,1,56,0
'I'm allergic to my husband',1,3,1,20,3,4,0,21,0
A Brief History Of Lori Petty's Red Carpet Style,1,1,9,30,1,8,0,39,0
19 Problems Teenagers Who Over-Straightened Their Hair Had,1,1,8,40,1,7,2,48,0
"Want to be neighbors with the Obamas, Ivanka Trump and Jeff Bezos? Here’s what it will cost you.",1,3,7,68,4,17,0,75,0
Here's What Happens When A Woman Tries To Buy Female Condoms In India,1,1,13,43,1,12,0,56,0
Survey: Most Americans lack savings to cover emergencies,1,3,3,45,1,7,0,48,0
15 Vagina Horror Stories That'll Send Shivers Down Your Spine,1,1,9,40,1,9,2,49,0
"Listen To Ariana Grande's New EP ""Christmas & Chill""",1,1,9,31,4,8,0,40,0
When It's Too Late To Say Something,1,1,7,21,1,6,0,28,0
"Donald Trump Meets With Big-Pharma, Vows ‘Big-Time’ Price Changes",1,2,11,41,5,8,0,52,0
What An American Naval Drone Could Tell Us About The Future Of U.S.-China Relations,1,2,16,51,3,13,0,67,0
Transgender Activist: Preference for Kids’ Single-Sex Shower Rooms is ‘Prejudiced’,1,2,9,59,5,9,0,68,0
Photos that could only happen in Jordan: News & Videos about Photos that could only happen in Jordan - CNN iReport,1,3,10,81,3,20,0,91,0
8 Moments All Butch Lesbians Know Too Well,1,1,7,27,0,7,1,34,0
Donald Trump is just par for the course,1,3,2,30,0,7,0,32,0
Here's Why Some Tax Refunds Are Delayed In 2017,1,3,8,26,1,8,4,34,0
A Gay Man Wrote This Heartbreaking Letter To His Parents When They Didn't Come To His Wedding,1,1,17,59,1,16,0,76,0
A bagel started a brawl on a train and it was terrifying The list,1,3,2,50,0,13,0,52,0
Deal of the Week: Akzo Nobel Fends Off PPG,1,3,9,24,1,8,0,33,0
Miner Bo Copley: Trump’s executive order on climate is ‘a good start’ [Video],1,3,5,54,6,12,0,59,0
Quebec mosque attack: Student Alexandre Bissonnette charged,1,2,4,48,1,6,0,52,0
This teenager was walking for hours to and from work — until a police stop changed his life,1,3,1,72,1,17,0,73,0
The 40 Biggest Duets Of All Time,1,3,6,18,0,6,2,24,0
How Well Do You Actually Know Cher Horowitz,1,1,8,28,0,7,0,36,0
We Know Your Zodiac Sign Based On Which Picture Of Zayn Malik You Choose,1,1,14,45,0,13,0,59,0
"How Well Do You Know The Lyrics To ""Rudolph The Red-Nosed Reindeer""",1,1,13,40,3,11,0,53,0
This Is How Virat Kohli Won Michael Clarke's Heart By Attending Phil Hughes' Funeral,1,2,14,55,2,13,0,69,0
How Fast Food Wrapping And Packaging Can Be Bad For Your Health,1,3,12,40,0,11,0,52,0
What we learned at Sean Spicer's first briefing,1,3,3,36,1,7,0,39,0
30 Halloween Costumes That Put All Of Us To Shame,1,1,9,29,0,9,2,38,0
What's Your HBCU Love Story,1,1,8,14,1,4,0,22,0
The names of the women 'most likely' to get pregnant in 2017 The list,1,3,2,48,2,13,4,50,0
Chinese Actress Sued for Her Intense Stare,1,2,6,30,0,6,0,36,0
Gift Guide: 10 hottest toys under $50,1,2,2,23,2,6,4,25,0
"A Woman's Viral Video Of Her Heartbreaking Experience With A Cashier Isn't True, Wal-Mart Says",1,1,16,60,4,14,0,76,0
What's Your Horoscope For December,1,1,5,24,1,4,0,29,0
15 Wash Day Struggles Only Women With Natural Hair Will Understand,1,1,10,44,0,10,2,54,0
Material World   ,1,3,2,11,0,4,0,13,0
The 25 most expensive ZIP codes in America,1,3,5,28,0,7,2,33,0
Cancer-Stricken ‘Jeopardy!’ Contestant Dies One Week Before Episode Airs [Video],1,3,11,54,6,9,0,65,0
33 Times Celebrities Stood Up For Feminism In 2015,1,1,7,29,0,8,6,36,0
We Know Which TV Couple You Are Based On Your Favorite Lush Bath Bar,1,1,15,40,0,13,0,55,0
"Twentysomethings, Can You Make It Through This Post Without Getting Turned On",1,1,12,53,1,11,0,65,0
Five Innovations That Could Transform Air Travel,1,2,7,35,0,6,0,42,0
Students Claim Objective ‘Truth’ Is a ‘White Supremacist’ Myth,1,3,8,42,4,8,0,50,0
Are You More Meredith Grey Or Meredith Grey,1,1,8,28,0,7,0,36,0
I Learned To Drink Goddamn Gin And You Can Too,1,1,10,27,0,9,0,37,0
21 Geekiest Pickup Lines,1,1,3,16,0,3,2,19,0
This 'Rogue One' Actor Made Sure He Wasn't Another Jar Jar Binks,1,3,12,38,3,11,0,50,0
Watch This Guy Age From 12 To 20 Years Old In Two Minutes With This Incredible Selfie Time Lapse,1,1,17,57,0,18,4,74,0
"Which Hogwarts Houses Do These ""HIMYM"" Characters Belong In",1,1,13,36,2,8,0,49,0
Should You Marry Kocoum,1,1,4,16,0,3,0,20,0
Do You Actually Know The Difference Between Mary-Kate And Ashley?,1,3,11,43,2,9,0,54,0
23 Ways To Get Your Shit Together In 2016,1,1,7,20,0,8,6,27,0
"My friend was dying. As his doctor, I had to tell him the truth.",1,3,3,45,3,13,0,48,0
"College Kids, What Gift Do You Really Want For Christmas",1,1,10,36,1,9,0,46,0
The Most Important Member Of The Beckham Household Has Joined Instagram,1,1,11,50,0,10,0,61,0
PROMO: Toyota and Photographer Anthony Supreme Get to Know the Unknown,1,2,12,47,1,10,0,59,0
"Donte Stallworth: Athletes, Actors ‘Precisely’ Who Should Lead Political Discussion",1,3,10,60,4,9,0,70,0
Bad Job Interview? Ask for a Do-Over,1,3,6,22,2,6,0,28,0
6 Tricks To Mastering Conflict,1,3,4,21,0,4,1,25,0
"How Many Of These ""Harry Potter"" Characters Can You Name",1,1,10,35,2,9,0,45,0
21 Wonderful Coats That Are Completely Perfect For Spring,1,1,8,39,0,8,2,47,0
Which Quentin Tarantino Leading Lady Are You,1,1,7,31,0,6,0,38,0
Which Economies Will Grow And Which Ones Will Fail Over Next Three Years,1,3,13,47,0,12,0,60,0
19 Things Every Vegetarian Must Eat Before They Die,1,1,8,33,0,8,2,41,0
What Does Your Go-To Beverage Say About Your ~Thirst~,1,1,10,32,3,8,0,42,0
'Lack of diversity' among Scottish school heads,1,3,2,37,2,6,0,39,0
‘The New Celebrity Apprentice’ is missing something — and it isn’t just Trump,1,3,5,56,4,12,0,61,0
Reminder: Donald Trump Was Stunned By Stone Cold Steve Austin In Wwe,1,1,12,44,1,11,0,56,0
Your Guide to Republicans’ Scramble for Health-Care Votes,1,3,7,41,2,7,0,48,0
"£120,000: That's how much a good night's sleep is worth ",1,3,1,34,5,10,6,35,0
"How Well Do You Remember ""Hook""",1,1,6,18,2,5,0,24,0
This Video Will Make You Rethink All Your First World Problems,1,1,11,41,0,10,0,52,0
Chicago Police Board Chair: Windy City Needs Federal Help to Turn Tide on Crime,1,3,12,53,1,13,0,65,0
What Type Of Drunk Will You Be On New Years Eve?,1,3,11,26,1,10,0,37,0
"Al Gore: Global Warming a ‘Principal’ Cause of the Syrian Civil War, Brexit",1,3,10,49,4,12,0,59,0
Is Your BFF A Big Baby,1,1,8,9,0,5,0,17,0
Your Favorite Food Can Tell You About What Your Money's Worth,1,3,11,39,1,10,0,50,0
Can You Identify The Disney Princess From A Blob Of Colors,1,1,11,37,0,10,0,48,0
"8 Of Your Worst Questions, Answered With Science",1,1,7,32,1,7,1,39,0
13 Life-Changing Items To Add To Your Kitchen In 2017,1,3,9,28,1,9,6,37,0
'Jurassic World' a worthy successor to 'Jurassic Park'?| Latest News Videos ,1,3,7,52,6,11,0,59,0
"Black Widow And The Hulk Are Adorable In This ""LEGO Marvel's Avengers"" Cutscene",1,1,16,48,3,12,0,64,0
Topshop’s Graphic Tee Has a Major Typo,1,3,6,25,1,6,0,31,0
34 Eye Opening Photos Of The Great Depression,1,1,7,29,0,7,2,36,0
People are very worried by this video of Donald Trump The list,1,2,4,47,0,11,0,51,0
Are You Dope Or Nope,1,1,5,11,0,4,0,16,0
Catholic high school could make millions on Snap public offering ,1,2,2,53,0,10,0,55,0
Equity 101: 3 Things Every Founder Needs To Know Before Giving Away A Piece Of Their Startup,1,3,15,56,1,16,4,71,0
"Morgan Freeman: Trump a Winner, I Hope Will Be ‘Good President’",1,3,10,39,4,10,0,49,0
"People Judged Me On My Weight Post-Pregnancy, Says Shilpa Shetty On Fat-Shaming Of New Mothers",1,2,17,60,3,14,0,77,0
24 Confessions Topshop Staff Will Never Tell You,1,1,7,32,0,7,2,39,0
The Identity Of The Mystery Girl Who Took Everyone On An Adventurous Ride Revealed. Here's What Happened,1,3,17,69,2,16,0,86,0
How the âperfect bodyâ for men has changed over the last 150 years,1,3,1,50,4,12,3,51,0
27 Underrated Hair Products That Actually Work,1,1,6,32,0,6,2,38,0
Which Fucking Weird Erotic Novel Best Describes Your Love Life,1,1,10,43,0,9,0,53,0
We tried all six new Frappuccino flavors so you don’t have to,1,2,2,47,1,11,0,49,0
10 Of The Most Embarrassing “Would You Rather” Questions,1,3,8,36,2,8,2,44,0
Which Mumford And Sons Album Are You,1,1,7,23,0,6,0,30,0
"Social media, celebrities, and transgender youth",1,3,1,40,2,5,0,41,0
Take It Back To The '90s With These Nostalgic AF Pancakes,1,1,11,33,1,10,2,44,0
"13 Things That Are Much Bigger Threats To America Than ""Refugee Terrorists""",1,3,11,49,2,11,2,60,0
'Spy from suburbia': Pensioner's secret life revealed after bomb scare,1,3,2,55,4,9,0,57,0
You Will Actually Die From How Mind-Blowing The New Circle K Logo Is,1,1,14,41,1,12,0,55,0
Netflix Reinvents Reality TV by Making Same Show Six Times,1,2,10,39,0,9,0,49,0
Five Predictions for Political Tech and Social Media in 2017 - Washington Wire,1,3,8,53,1,12,4,61,0
The Associated Press Accidentally Linked To An Amazing Sassy Cat Video,1,1,11,49,0,10,0,60,0
People Who Fucking Hate Dressing Up For Halloween: You Are Not Alone,1,1,12,44,1,11,0,56,0
These cellphone carriers are about to make life harder for grandfathered unlimited-data users,1,3,1,79,1,12,0,80,0
The rapid spread of Australia's cane toad pests,1,3,2,37,1,7,0,39,0
"'Policemen without uniform' assaulting citizens in Belarus, protestors claim",1,2,2,63,3,8,0,65,0
"How Well Do You Know The Lyrics Of ""Bohemian Rhapsody""",1,1,10,33,2,9,0,43,0
Teens Watch '00s Music Videos For The First Time,1,1,8,29,1,8,2,37,0
Australian of the Year awards 2017: Who are the nominees?,1,3,3,39,2,9,4,42,0
"Tina Fey Would Like You To Know You Can See Both ""Star Wars"" And ""Sisters""",1,1,15,41,4,14,0,56,0
How to never touch anyone ever again,1,3,1,29,0,6,0,30,0
31 Halloween Costumes That Will Scare The Shit Out Of Your Friends,1,1,11,42,0,11,2,53,0
14 Surprising Confessions From People Who Are Deaf,1,1,7,34,0,7,2,41,0
Shout Out To People Who Eat Noodles On Thanksgiving,1,1,9,34,0,8,0,43,0
"Inside the cult of Secret Wedding Pinterest, where fiances are optional",1,2,4,56,1,10,0,60,0
12 Things Sunny Leone Has Said About Her Past Working In Adult Entertainment,1,1,12,50,0,12,2,62,0
16 Reasons Why Black Friday Is Garbage Compared To Boxing Day,1,1,10,39,0,10,2,49,0
An Adorable Animals Advent Calendar: December 9,1,1,6,33,1,6,1,39,0
"15 Times Lady Gaga's Outfits Slayed On ""American Horror Story: Hotel""",1,1,10,43,4,10,2,53,0
This Girl Cried When She Tried Pepsi For The First Time Because Life Is So Much Sometimes,1,1,17,56,0,16,0,73,0
17 Hilarious Ways People Found Out Santa Isn't Real,1,1,8,32,1,8,2,40,0
"If you do one thing today, don't click on this video The list",1,3,2,45,2,12,0,47,0
"13 ""Teen Wolf"" Questions That Are Impossible To Answer",1,1,8,34,2,8,2,42,0
What's Your Actual Name Based On Your Birth Month,1,1,9,31,1,8,0,40,0
"The 23 Best Lines From Fox Mulder On ""The X-Files""",1,1,10,26,3,9,2,36,0
33 Things About French People That Confuse The Fuck Out Of Everyone Else,1,1,12,46,0,12,2,58,0
15 Cringeworthy Romance Stories That'll Make You Glad You're Single,1,1,9,45,2,9,2,54,0
Tips for surviving switch to Daylight Saving Time - Yahoo,1,3,5,42,1,9,0,47,0
43 Things Bernie Sanders Is Probably Doing Today,1,1,7,32,0,7,2,39,0
Peak Delly: How a kid from country Victoria got his own signature shoe,1,2,4,53,1,12,0,57,0
The latest reported reason teams aren't signing Colin Kaepernick: His vegan diet,1,3,4,63,2,11,0,67,0
This Makeup Test Will Reveal A Truth About You,1,1,9,29,0,8,0,38,0
"This Is What ""Mean Girls"" Would Be Like If It Were Set In 2015",1,1,13,30,2,13,4,43,0
How to protect yourself from lightning strikes,1,3,1,39,0,6,0,40,0
"Jennifer Lopez Was Perfect On Jimmy Fallon's ""Ew!""",1,1,8,31,4,7,0,39,0
These Guys Sang Mariah Carey's Christmas Smash For A Great Reason,1,2,11,43,1,10,0,54,0
"Which Hogwarts Houses Do These ""Star Wars"" Characters Belong In",1,1,10,42,2,9,0,52,0
22 Times Animals Were You Just Trying To Live Your Life,1,1,10,33,0,10,2,43,0
What happens in the extremely unlikely scenario the Electoral College goes rogue?,1,3,3,66,1,11,0,69,0
This Color Swirl Test Will Determine Your Actual Personality Type,1,1,10,46,0,9,0,56,0
Bay Area Public Radio Mourns Obama’s ‘Food Legacy’,1,2,8,32,3,7,0,40,0
"Craving family time, I called everyone to the dinner table",1,3,2,46,1,9,0,48,0
Tesla just began rolling out its new and improved Autopilot â here's what you need to know,1,3,2,71,3,16,0,73,0
Fighting Trump? Your best weapon is the one you least expect,1,3,3,46,1,10,0,49,0
"So, ""American Horror Story: Hotel"" Looks Creepy AF",1,1,9,30,4,7,0,39,0
"After Fort Lauderdale Shooting, Rumor of Second Gunman Created Chaos ",1,3,9,49,1,10,0,58,0
28 Onion Headlines That Basically Sum Up Your Life,1,1,8,32,0,8,2,40,0
Bill Maher Has A Very Important Message For People Interviewing Donald Trump,1,3,12,53,0,11,0,65,0
"This Is What The Cast Of ""A Cinderella Story"" Looks Like Now",1,1,12,35,2,11,0,47,0
Mega Man Bosses Have Bizarre Names So Try To Guess Them,1,1,11,34,0,10,0,45,0
Two-Thirds of Americans Aren’t Putting Money in Their 401(k),1,2,7,38,4,8,3,45,0
21 Cute Dog Pictures To Help You Put Off Whatever You're Putting Off,1,1,12,41,1,12,2,53,0
Zimbabwe is paying people $5 for 175 quadrillion Zimbabwe dollars,1,2,2,49,1,9,4,51,0
Is Trump Tower Now The Worst Address In America?,1,3,9,30,1,8,0,39,0
"22 Fred And George Weasley Moments That'll Make You Laugh, Cry, And Everything In Between",1,1,14,56,3,14,2,70,0
A Hairstylist Gave A Bride With Cancer The Hair Of Her Dreams,1,1,12,38,0,11,0,50,0
This Celebrity Chef Wants To Change The Way You Eat In Business Class,1,3,13,44,0,12,0,57,0
How This 28-Year-Old Retired In NYC With A Net Worth Of More Than $2 Million,1,2,17,39,3,14,3,56,0
Can We Guess What You REALLY Want For Christmas,1,1,14,25,0,8,0,39,0
29 Gifts I Actually Really Want,1,1,5,19,0,5,2,24,0
How to Meditate - Well Guides ,1,3,4,19,1,6,0,23,0
No Actors Of Color Were Nominated For An Oscar This Year And People Are Pissed,1,1,15,49,0,14,0,64,0
"This Week's ""Showstopper"" Bake Off Was One Of The Most Nervewracking Television Moments This Year",1,1,15,65,3,14,0,80,0
Can You Name These Everyday Things,1,1,6,23,0,5,0,29,0
"It Looks Like Paris And Doyle Are Still Together In The ""Gilmore Girls"" Revival",1,1,14,50,2,13,0,64,0
Why The '90s Was A Horrible Decade And Your Nostalgia Is Clouding Your Judgment,1,1,13,50,1,13,2,63,0
33 Leslie Knope Quotes To Help You Live Your Best Life,1,1,10,32,0,10,2,42,0
Living without lungs for six days saves woman’s life,1,3,1,42,1,8,0,43,0
Why Trans Women Have Complicated Relationships With Halloween,1,1,8,46,0,7,0,54,0
Can You Figure Out What This Headline Says On The First Try,1,1,12,36,0,11,0,48,0
23 Infamous Mugshots From History,1,2,4,23,0,4,2,27,0
This Is What It Looks Like To Skateboard Down A Road At 70 MPH,1,1,15,32,0,13,2,47,0
"If The Bond Girl Age Gaps In ""James Bond"" Were Reversed",1,1,11,32,2,10,0,43,0
What % Lucky Are You?,1,2,4,11,2,4,0,15,0
16 Exciting And Creative Ways To Eat An Egg,1,1,8,25,0,8,2,33,0
"Here's What Happened When White Actors Were Told To ""Act Whiter""",1,1,11,40,3,10,0,51,0
"Kristen Stewart Has Some Advice For ""Star Wars"" Star Daisy Ridley",1,1,11,42,2,10,0,53,0
"If You Hate ""The Big Bang Theory"", This Tweet Will Make You Stand Up And Applaud",1,1,16,46,3,15,0,62,0
This Group Of Badass Women Just Killed The Menswear Game,1,1,10,37,0,9,0,47,0
Pornhub wants you to dress up like a panda and have sex. Really.,1,3,2,48,2,12,0,50,0
These Are the 10 Best Fashion Moments From Beyonce's 'B'Day Anthology Video Album',1,2,12,52,4,12,2,64,0
We Need To Talk About This Gigantic Stuffed Bear From Costco,1,1,11,39,0,10,0,50,0
Brooks: Trump ‘Making the Conclusion That the Populism and the Bannon-ism Is Not Working’,1,3,10,62,4,13,0,72,0
Helen Mirren Looked The Best She's Ever Looked Last Night,1,1,10,37,1,9,0,47,0
Ancient Chinese tomb-sweeping festival goes hi-tech,1,3,2,42,2,5,0,44,0
Golden Globes 2017: Watch Jimmy Fallon's star studded opening musical number,1,2,5,55,2,10,4,60,0
19 Stunningly Weird Pieces Of Anatomy Jewelry,1,1,6,31,0,6,2,37,0
Sam Smith Has Recorded The New James Bond Song,1,1,9,29,0,8,0,38,0
How A 28-Year-Old Who Retired With A $2 Million Net Worth Is Investing In 2017,1,3,14,40,3,14,7,54,0
"Behind The Scenes Casting Secrets From ""Gossip Girl,"" ""Arrow,"" And More",1,1,11,44,6,10,0,55,0
"Your Weekly Gossip Roundup: Shia LaBeouf Gets Arrested, Pippa Middleton Splits With Her Boyfriend, And More",1,1,17,72,3,15,0,89,0
21 Words You Don't Really Understand Unless You're From Florida,1,1,9,41,2,9,2,50,0
Can We Guess Who You Voted For,1,1,7,17,0,6,0,24,0
11 Of The Most Gender-Progressive Things That Have Already Happened In India In 2015,1,1,13,51,1,13,6,64,0
Grown Women Discuss Feminism With Hello Barbie,1,1,7,33,0,6,0,40,0
Do You Belong With John Boyega Or Oscar Isaac,1,1,9,28,0,8,0,37,0
"Adele's Classroom-Instruments Rendition Of ""Hello"" With Jimmy Fallon And The Roots Is Obviously Amazing",1,1,15,71,4,13,0,86,0
23 Plus-Size Gym Clothes You Won't Have To Sacrifice Your Style For,1,1,12,40,2,11,2,52,0
19 Sex Horror Stories That'll Make You Feel Better About Your Love Life,1,1,12,44,1,12,2,56,0
Middle manager who retired with a Reply All email tirade shows how not to quit a job,1,3,3,65,0,16,0,68,0
22 Struggles Every Small Girl With Big Feet Will Understand,1,1,9,39,0,9,2,48,0
Income Tax Raid In A Bank Of Maharashtra Branch Finds Rs 10 Crore In Stashed Cash In New Notes,1,3,18,56,0,18,2,74,0
Watch These Adults Review This Bizarre Kids' Toy,1,1,8,32,1,7,0,40,0
Nicolas Cage Is The Greatest Actor In The Universe,1,1,9,33,0,8,0,42,0
19 Things You'll Only Understand If You Suck At Makeup,1,1,9,33,1,9,2,42,0
Saving Edgecumbe's residents on the back of a lorry,1,3,2,40,1,8,0,42,0
"Benedict Cumberbatch Tells Theatre Audience ""Fuck The Politicians"" After ""Hamlet"" Performance",1,1,11,68,4,10,0,79,0
19 Reasons You Should Fall In Love With A Turkish Person,1,1,10,34,0,10,2,44,0
The '2 Kinds Of People' Tumblr Will Nail Your Personality Down In A Second,1,3,13,45,2,13,1,58,0
Holiday Getaways for Picky Procrastinators ,1,3,4,34,0,5,0,38,0
Are You More Matt Damon Or Ben Affleck,1,1,8,23,0,7,0,31,0
We Asked 20 People Why They Went To Black Colleges,1,1,9,30,0,9,2,39,0
Firefighters can see through smoke with new thermal mask,1,2,1,47,0,8,0,48,0
21 Things Every Second Semester College Senior Knows To Be True,1,1,10,41,0,10,2,51,0
You Have A Poot And We Want To See Them,1,1,10,20,0,9,0,30,0
One Quality That Sets Successful Parents Apart,1,3,7,33,0,6,0,40,0
"This Antiques Roadshow guest just discovered her family heirloom is worth £150,000",1,3,3,60,2,11,6,63,0
Get ready for another year of global tumult,1,3,1,35,0,7,0,36,0
British journalists are getting a lot of praise from Americans after their questions to Trump The list,1,3,4,82,0,16,0,86,0
Why This TV Show Featured Full-Frontal Male Nudity,1,1,10,32,1,7,0,42,0
29 Celebrity Weddings That Happened In 2015,1,1,5,26,0,6,6,31,0
"Most 'anti-aging' remedies are bogus, but here's what you should know about aging from 20s to your 60s",1,3,1,75,5,17,4,76,0
Which Pie Matches Your Zodiac Sign,1,1,6,23,0,5,0,29,0
How Italian Are You Really,1,1,5,17,0,4,0,22,0
We Know What You Want For Christmas Based On Your Zodiac Sign,1,1,12,38,0,11,0,50,0
This Woman Was Gifted A Karaoke Mic And Did The Absolute Most,1,3,12,38,0,11,0,50,0
25 Feared Dead After Schoolbus Hits Truck In UP + 5 More Stories From Today,1,2,13,44,1,14,3,57,0
"Govt Reacts To The Viral Video, Orders Probe Into The Suffering Of The Soldier, But Is It Enough?",1,3,18,59,3,17,0,77,0
"Is This A ""HIMYM"" Episode Title Or Just A Reference",1,1,14,26,2,9,0,40,0
27 Party Anthems From The Early '00s That Still Go Hard,1,1,9,31,1,10,4,40,0
This Guy's Beautiful Portraits Will Leave You Speechless,1,1,8,40,1,7,0,48,0
We Know If You're A Teenage Girl Based On A Single Question,1,1,12,35,1,11,0,47,0
There Is Coconut Everywhere,1,3,4,20,0,3,0,24,0
Adorable Red Panda Cubs Make Public Debut At Chicago Zoo,1,1,10,37,0,9,0,47,0
18 Things That Always Happen To People Who Hate New Year's Eve,1,1,11,37,1,11,2,48,0
15 Amazing Products That Will Change The Way You Sleep In 2016,1,1,10,35,0,11,6,45,0
"Literally Just 34 Hilarious Tweets About ""The Bachelor"" Finale",1,3,8,42,2,8,2,50,0
This Couple Canceled Their Wedding And Gave The Money To Syrian Refugees,1,1,12,49,0,11,0,61,0
Warren: I’m ‘Troubled’ by Obama Getting $400K from Wall Street,1,3,8,37,5,9,3,45,0
It took 10 minutes to explain to Trump that North Korea is 'complicated' The list,1,3,5,58,2,14,2,63,0
These Oreo Chocolate Chip Brownies Are Basically A Work Of Art,1,1,11,41,0,10,0,52,0
5 Gorgeous DIY Food Gifts No One Will Believe You Made,1,2,12,31,0,10,1,43,0
Labour in chaos: Tulip Siddiq resigns as Corbyn imposes whip barring MPs from blocking Article 50,1,2,7,72,1,15,2,79,0
"This Costume Competition Proves That ""Simpsons"" Fans Are The Best In The World",1,1,13,51,2,12,0,64,0
Can You Name The Stuff In Our Solar System,1,1,9,25,0,8,0,34,0
"Deepika Padukone Finds Comparisons With PC Bizarre, Says Their 'Worlds' Are Completely Different",1,3,14,67,3,12,0,81,0
"Kim Jong-un's wife is spotted, EIGHT MONTHS after disappearing from public view",1,3,13,52,3,11,0,65,0
Sri Lanka to Sell 80% Stake in Strategically Placed Harbor to Chinese - India Real Time,1,3,11,57,2,15,2,68,0
What we've learned so far from Sessions hearing,1,3,2,37,1,7,0,39,0
How an online fight about dogs became one of 2016’s greatest memes,1,3,1,49,1,11,4,50,0
How Many Lesbian Movies Can You Name From A Single Frame,1,1,11,35,0,10,0,46,0
28 Things Every Person Hates That They Do But Does Anyway,1,3,10,35,0,10,2,45,0
19 Of The Best Things That Ever Happened In A Grocery Store,1,1,11,35,0,11,2,46,0
16 Tweets About Spaghetti That Will Make You Laugh Out Loud,1,1,10,37,0,10,2,47,0
Xenomorphs are back in the first trailer for 'Alien: Covenant',1,3,3,47,3,9,0,50,0
16 Scary Movies You Need To See Before You Die,1,1,9,26,0,9,2,35,0
12 Times Badass Women Fought Ridiculously Sexist Dress Codes In 2015,1,1,9,43,0,10,6,52,0
"MP Cop Who Was Fat-Shamed By Shobhaa De, Undergoes Weight Loss Surgery In Mumbai",1,3,16,49,2,13,0,65,0
"What Combines Iron Maiden, Dinosaurs and Play Dates? Hevisaurus, the Heavy-Metal Sensation for Children",1,3,12,74,4,13,0,86,0
Guide Dog Puppies Are Being Trained With These Adorable Mini Harnesses,1,1,11,49,0,10,0,60,0
We Pranked A Bunch Of People By Dropping An iPhone In Front Of Them,1,1,14,40,0,13,0,54,0
"A DC Comic Called Pakistan's Language ""Pakistanian"" And Twitter Is Having A Field Day",1,1,15,54,3,13,0,69,0
"Disney Boss Says No Political Bias at ABC News and ESPN, Complaints ‘Completely Exaggerated’",1,2,17,59,3,13,0,76,0
"Teen investigative journalists oust shady principal, give us all hope for future",1,3,1,67,1,11,0,68,0
5 things Google's Pixel phone can do that the iPhone can't,1,2,3,42,2,10,1,45,0
19 Things All '90s Students From Newcastle Will Remember,1,1,7,36,1,8,4,43,0
What Happens When A Couple Reveals Their Sexual Fantasies To Each Other,1,1,12,48,0,11,0,60,0
18 Hangover Texts That Are Just Too Real,1,1,7,24,0,7,2,31,0
"Can You Name All Of The Characters From ""Big Hero 6""",1,1,10,29,2,10,1,39,0
"This Luxurious House Is Also The World's Safest, It Can Withstand A 20-Kiloton Nuclear Blast",1,3,15,58,3,14,2,73,0
Someone Remixed Lines From Holiday Movies Into An Epic Song,1,1,10,40,0,9,0,50,0
When Two Cartoonists Doodle On The Same Pages Madness Happens,1,1,10,42,0,9,0,52,0
6 Little Victories,1,1,2,13,0,2,1,15,0
26 Things You Haven't Cared About In 11 Years,1,1,7,25,1,8,4,32,0
The arrests of 6 Platinum Partners executives aren't much consolation for their alleged victims,1,3,3,77,1,13,1,80,0
Are You THAT Relative,1,1,7,11,0,3,0,18,0
These High School Boys Wore Dresses To School In Protest Of The Dress Code,1,1,14,47,0,13,0,61,0
15 Perfectly Reasonable Ways To Deal With Stress,1,1,7,32,0,7,2,39,0
A blueprint for resistance to Trump has emerged. Here’s what it looks like.,1,3,3,57,3,12,0,60,0
25 Delicious Bite-Size Treats Made With Wonton And Egg Roll Wrappers,1,1,11,44,1,10,2,55,0
The 8 best new features Apple added to your iPhone in iOS 10.3,1,3,5,40,1,12,4,45,0
"39 Of The Most Heartfelt, Relatable And Comforting Quotes And Lyrics About Depression",1,1,12,58,1,12,2,70,0
Are You More Cookie Monster Or Cookie Lyon,1,1,8,27,0,7,0,35,0
24 Books That Perfectly Match New York Fashion Week Looks,1,1,9,37,0,9,2,46,0
44 Insane President's Day Sales To Shop Right Now,1,1,8,30,1,8,2,38,0
17 Spot-On Gifts For Your Friend Who Hates Wearing Pants,1,1,10,34,1,9,2,44,0
We Know Your Favorite Color Based On Your Favorite Celebrity,1,1,10,41,0,9,0,51,0
"Ratan Tata Says He Is Lonely, Having A Painful Time Amid Ongoing Tussle With Cyrus Mistry",1,3,16,57,1,15,0,73,0
Kristen Bell Defends Celebrity Activism: I’m Not ‘Any Less Allowed to Share What I Believe’,1,3,14,59,4,14,0,73,0
What Is Your Sexiness Score,1,1,5,18,0,4,0,23,0
Google Just Found (Probably) The Most Dangerous Android Malware Ever Seen,1,2,11,50,2,10,0,61,0
What Do You Call The Thing That Holds Up Your Hair,1,1,11,29,0,10,0,40,0
"25 Tweets About ""Friends"" That'll Make You Laugh Every Time",1,1,9,36,3,9,2,45,0
Should we take our teenage children on a Mediterranean cruise?,1,3,2,50,1,9,0,52,0
UK beauty queen cured her severe acne with one simple diet trick,1,2,2,51,0,11,0,53,0
13 Indian Copywriters Who Owe Us An Explanation For These Ads,1,1,10,39,0,10,2,49,0
My Path To Trans Motherhood,1,1,5,18,0,4,0,23,0
One of the top hedge fund launches of the year has landed a big-name backer,1,3,1,59,1,14,0,60,0
27 Slightly Terrible Things That Happen Whenever You Go To Ikea,1,1,10,41,0,10,2,51,0
Here's the deal behind that viral parade of dancing children's characters,1,3,1,60,2,10,0,61,0
It’s not the internet’s fault you’re a jerk about politics,1,3,1,45,3,9,0,46,0
‘Everything is destroyed’: A deadly surge of violence strikes eastern Ukraine,1,2,3,61,3,10,0,64,0
Here's What Happens When Tater Tots And Cheeseburgers Join Forces,1,1,10,45,1,9,0,55,0
15 Bowls Of Soup That Will Make You Feel Better Immediately,1,1,10,37,0,10,2,47,0
16 signs you've 'made it' in America,1,3,1,24,3,6,2,25,0
How Adulthood Happens ,1,3,3,16,0,3,0,19,0
Does Facebook want to read your THOUGHTS? Secretive division may be developing a mind-reading device,1,2,11,73,2,14,0,84,0
This Color Test Will Reveal Your Primary Emotion,1,1,8,33,0,7,0,41,0
10 Things You Can Look Forward To This Winter,1,1,8,27,0,8,2,35,0
What's The Most Incredible Response You've Given To An Ex Who Texted You,1,1,13,45,2,12,0,58,0
"Conway: Had This Been a Race for the Popular Vote, Trump Would Have Won That Too",1,2,13,50,2,15,0,63,0
"Taiwan, Italy, Joe McKnight: Your Friday Evening Briefing ",1,3,9,38,3,8,0,47,0
The expat life is full of adventure — and loneliness,1,3,1,41,1,9,0,42,0
28 Times Yahoo Answers Lost Its Damn Mind In 2015,1,1,8,26,0,9,6,34,0
Bangladesh Family: ‘Vogue’ Model Killed for Refusing to Wear Islamic Garments,1,3,9,55,3,10,0,64,0
"Yazidi Activist: Islamic State Cut Open My Friend, Raped Her Baby, Then Raped Her",1,3,14,51,3,13,0,65,0
19 Struggles Of Growing Out Your Eyebrows,1,1,6,27,0,6,2,33,0
17 Things Couples In Open Relationships Need You To Know,1,3,9,36,0,9,2,45,0
"Do You Think Mariah Carey Is Actually The Bride From ""Kill Bill""",1,1,12,39,2,11,0,51,0
9 Women Share The Harsh Reality Of Living With Severe Acne,1,1,10,37,0,10,1,47,0
27 Happy Gifts For People Who Love Jamaica,1,1,7,26,0,7,2,33,0
The year in natural disasters,1,3,1,24,0,4,0,25,0
We Know How Old You Feel And How Old You Actually Are Based On Your Chinese Zodiac,1,1,17,49,0,16,0,66,0
Here's The Ultimate Playlist To Get You Through The Stages Of A Breakup,1,1,13,45,1,12,0,58,0
What Is Brody Jenner Trying To Say With This NSFW Cartoon,1,2,14,33,0,10,0,47,0
Amazon to Begin Accepting Food Stamps,1,2,5,27,0,5,0,32,0
How Cathy Are You,1,1,4,10,0,3,0,14,0
"Why ""Bridge Of Spies"" Is Going To Be Your Dad's Favorite Movie",1,1,12,36,3,11,0,48,0
How to raise your profile at work - and keep it there,1,3,1,40,1,11,0,41,0
Vote: Which finalist will win this year's Heisman?,1,3,3,37,3,7,0,40,0
19 Hilarious Tweets About Coachella That Will Make You Actually LOL,1,2,12,43,0,10,2,55,0
Here's What Actually Happens When You Eat Horrifying Vintage Recipes,1,1,10,48,1,9,0,58,0
Someone Found A Giant Dick-Shaped Icicle And It's Cool As Balls,1,1,12,39,2,10,0,51,0
"This Slow Cooker Pork Rice Bowl Is Quick, Easy, And Filling",1,1,11,36,2,10,0,47,0
These Cocaine Ads From The 1970s Prove The Past Is A Different World,1,1,12,40,0,12,4,52,0
"Who Can Use The N-Word, As Told By Black-Ish",1,1,11,22,3,8,0,33,0
WHO Superbug List: Enemy No. 1 Is Bug That Plagues Soldiers,1,2,12,34,2,10,1,46,0
Cheap Vs. Expensive Tequila Taste Test,1,1,6,26,1,5,0,32,0
Why Strategic Investment Isn't Always A Good Strategy For Startups,1,3,10,46,1,9,0,56,0
The most cringe-worthy quotes from CEO Travis Kalanick on Uber's sexist work culture,1,3,7,63,2,12,0,70,0
26 Penis Facts People Wish They Knew When They Were Younger,1,1,10,37,0,10,2,47,0
"Meet the Coach for Lady Gaga, Super Bowl Halftime Star",1,2,8,36,1,9,0,44,0
What YA Heroine Quote Inspires You,1,1,7,22,0,5,0,29,0
"After Years Of Visiting My Dad In Prison, We Are Now Friends",1,1,12,36,1,11,0,48,0
"This Is The Cast Of The New ""Jungle Book"" Movie",1,1,10,26,2,9,0,36,0
Can You Match These Adele Songs To Their Albums,1,1,9,30,0,8,0,39,0
Here's Everything You Need To Know About MOAB - The Biggest Non-Nuclear Bomb Ever Made,1,3,18,51,3,14,0,69,0
Are these the world's weirdest houses? 16 of the most unusual properties,1,3,1,56,2,11,2,57,0
16 Muslim Emojis That You Didn't Know You Needed,1,1,8,29,1,8,2,37,0
#FakeNews Website Uses Kushner’s Grandmother to Attack Trump,1,3,8,43,2,7,0,51,0
"12 Documentaries You Should Definitely Watch If You Liked ""Making A Murderer""",1,1,11,51,2,11,2,62,0
"Alex Trebek Got Tricked Into Saying ""Turd Ferguson"" On ""Jeopardy,"" So Our Work Here Is Done",1,1,16,55,5,15,0,71,0
A Mystery Glitch On Facebook Led To Two Strangers Meeting And Falling In Love,1,1,14,50,0,13,0,64,0
Which Of The Great Lakes Are You,1,1,7,19,0,6,0,26,0
10 Artists You Won’t Believe Have Never Won A Grammy For Album Of The Year,1,3,14,43,1,14,2,57,0
Matt Damon Taking Pictures Of His Daughters Is Every Dad Ever,1,1,11,40,0,10,0,51,0
Can You Identify The 2015 Music Video By Its YouTube Comment,1,1,11,35,0,10,4,46,0
28 Adorable Christmas Pajamas For The Whole Family,1,2,7,34,0,7,2,41,0
This Woman Taking A Picture With Reese Witherspoon In The Background Is All Of Us,1,1,15,52,0,14,0,67,0
This Physicist Shot Himself Underwater To See What Would Happen,1,1,10,44,0,9,0,54,0
"Unhappy With Officials' Presentation On Development Works, PM Modi Walks Out Of The Meeting Midway",1,2,16,66,2,14,0,82,0
How Good Is Your Knowledge Of Classic Football Rivalries,1,1,9,39,0,8,0,48,0
Can You Pass This Gross-Ass Bodily Fluid Quiz,1,1,9,28,1,7,0,37,0
Should I Delete Photos Of My Ex From Instagram,1,1,9,29,0,8,0,38,0
21 Truths All Drama BFFs Will Understand,1,1,8,24,0,6,2,32,0
38 Ways To Clean With Things You Have In Your Kitchen,1,1,10,31,0,10,2,41,0
What It Feels Like To Have PTSD,1,1,10,15,0,6,0,25,0
How Much Of A Pasta Lover Are You Actually,1,1,9,25,0,8,0,34,0
"19 Times Val From ""Dancing With The Stars"" Proved He Was Husband Material",1,1,12,45,2,12,2,57,0
53 Insanely Creative Matching Tattoo Ideas,1,1,5,30,0,5,2,35,0
These People Tried Candy From The Early 1900s And Loved It,1,1,10,34,0,10,4,44,0
You need these photos of Alicia Vikander as Lara Croft,1,3,5,40,0,9,0,45,0
Classic Christmas Movies Reimagined As Low-Budget Knockoffs,1,1,8,44,1,6,0,52,0
Do You ~Have~ To Invite That Person To Your Wedding,1,1,10,30,2,9,0,40,0
"For Anyone Harbouring Secret Lust For Kristian Bruun On ""Orphan Black""",1,1,11,47,2,10,0,58,0
23 Tumblr Posts That Hilariously Sum Up Having Boobs,1,1,8,34,0,8,2,42,0
We Know What Hair Color You Need To Rock This Fall,1,1,11,29,0,10,0,40,0
The Kemba Candidates: Which Teams Are Best Positioned for a Magical March Run?,1,3,11,53,2,12,0,64,0
"This Hilarious Woman Is Inserting Herself Into ""The Bachelor"" And It Is Glorious",1,1,13,53,2,12,0,66,0
Celebs Play The Blind Kissing Challenge,1,1,6,28,0,5,0,34,0
"Sushma Swaraj Takes No Nonsense, Slams A Man's Twitter Request To Get His Wife Transferred",1,3,15,59,2,14,0,74,0
17 Hilarious Bathroom Wall Messages That'll Make You Pee Your Pants,1,1,10,44,1,10,2,54,0
Northwestern MutualVoice: Don't Make This Common Investing Mistake,1,3,9,48,2,7,0,57,0
19 Tips To Make Your Bed Even More Cozy,1,1,8,21,0,8,2,29,0
This Skydiver Got Caught On A Plane After Jumping Out,1,1,10,34,0,9,0,44,0
8 Foods That Should Have Warning Labels,1,3,6,26,0,6,1,32,0
VMwareVoice: How The Cloud Helped A School District Handle A Texas-Sized Growth Spurt,1,3,16,55,2,12,0,71,0
"19 Impressive Facts About The Ocean That Will Make You Say ""Wow""",1,3,11,38,2,11,2,49,0
This Is Hands Down The Most Horrifying Couples Costume You Can Wear On Halloween,1,1,14,53,0,13,0,67,0
"Public Internet is supposed to lower prices. In Seattle, it could work too well.",1,3,4,60,3,13,0,64,0
Jackie Evancho Album Sales Skyrocket After Announcing Inauguration Performance,1,3,9,61,0,8,0,70,0
Trying to lose weight? The colder months might be the perfect time.,1,3,2,52,2,11,0,54,0
This Driving Quiz Will Determine If You're Actually From Los Angeles,1,1,11,46,1,10,0,57,0
15 Ways We Actually Express Ourselves,1,1,5,25,0,5,2,30,0
The Slick Rise Of Vintage Masculinity,1,1,6,26,0,5,0,32,0
"No, this Fisher-Price Happy Hour Playset isn't real",1,3,6,35,3,7,0,41,0
6 Women + 1 Spooky Lip Color,1,1,4,15,1,6,2,19,0
The 6 Financial Habits Of Mentally Strong People That You Can (And Should) Adopt Now,1,3,14,53,2,14,1,67,0
Girl Scout takes on the mantle of truth in advertising,1,2,2,43,0,9,0,45,0
"The derogatory internal nicknames of the Trump White House, ranked",1,3,4,52,1,9,0,56,0
"Why So Many Americans Don't 'Believe' In Evolution, Climate Change And Vaccines",1,2,12,52,4,11,0,64,0
25 Hilarious Tweets About Sending Nudes,1,3,5,27,0,5,2,32,0
A woman found a shirt tucked in her windscreen - and she has a serious warning for everyone The list,1,2,2,78,1,19,0,80,0
Why some top companies are ditching degree requirements,1,3,1,47,0,7,0,48,0
"I'm Not Antisocial, I Just Want To Be Alone",1,1,9,24,2,8,0,33,0
Jon Hamm FINALLY Won An Emmy Tonight And It Was Glorious,1,1,17,29,0,10,0,46,0
This man's blood has saved the lives of two million babies,1,3,1,46,1,10,0,47,0
21 Insanely Cute And Simple Dollar Store Halloween Costumes That Are Gifts From God,1,1,13,55,0,13,2,68,0
24 Underrated Tourist Attractions You Need To See Instead Of The Usual Ones,1,3,12,49,0,12,2,61,0
"Here's Our First Look At Kerry Washington As Anita Hill In ""Confirmation""",1,1,12,47,3,11,0,59,0
23 Movies You Should Definitely Watch After A Breakup,1,3,8,35,0,8,2,43,0
How Futuristic Are You,1,1,4,15,0,3,0,19,0
Sharks never sleep: There are scarier things at the beach than shark attacks,1,2,2,61,1,12,0,63,0
21 Embarrassing Liz Lemon Moments That'll Make You Feel Better About Your Own,1,1,12,50,1,12,2,62,0
DNC Deputy Chair Ellison: Obama Was Responsible for Some of the Party’s Failures In 2016,1,3,13,55,2,14,4,68,0
"This Mashup Of ""Hotline Bling"" With Wii Music Is Everything",1,1,10,38,2,9,0,48,0
15 Hits From 1996 That'll Make You Feel Old AF,1,1,9,21,1,9,6,30,0
Snowden files 'read by Russia and China': five questions for UK government,1,3,5,55,3,11,0,60,0
"The 17 Funniest Tweets About ""Harry Potter"" In 2015",1,1,7,28,2,8,6,35,0
7 Charity Organisations You Can Support That Are Delivering Aid To Syrians Amid War & Violence,1,2,14,63,1,15,1,77,0
Only Solve This Puzzle If You're Ready For An Intimate Challenge,1,1,11,42,1,10,0,53,0
"J.J. Abrams Broke His Back Trying To Save Harrison Ford On The Set Of ""Star Wars""",1,1,17,45,4,15,0,62,0
21 Women Who Can Teach You How To Slay,1,1,8,20,0,8,2,28,0
16 Memes That Will Turn 10 In 2017,1,3,5,14,0,7,8,19,0
"If The Cast Of ""Friends"" Were ""Game Of Thrones"" Houses",1,1,10,31,4,9,0,41,0
24 Photos That Will Make You Wish You Went To Mermaid School,1,1,11,36,0,11,2,47,0
22 Life Hacks So Incredibly Stupid They're Borderline Genius,1,1,8,41,1,8,2,49,0
"The Student With The Best ""Hello"" Cover Ever Just Did An Encore On ""Ellen""",1,1,14,43,4,13,0,57,0
Future's 'HNDRXX' on Pace for No. 1 Debut,1,3,10,19,4,7,1,29,0
"9 Fucking Ugly Tattoos Transformed Into Something New On ""Tattoo Fixers""",1,1,10,49,2,10,1,59,0
Can You Guess The Celebrity Just By Their Eyeliner,1,1,9,33,0,8,0,42,0
Non-verbal boy's special bond with deaf dog captured in heartwarming photo,1,2,1,61,2,10,0,62,0
Which Disney Prince Is Better Than The Rest,1,1,8,28,0,7,0,36,0
"Just try not to obsess over this giant, fluffy cat",1,3,1,39,1,9,0,40,0
The 22 Most Important Celebrity Tweets Of All Time,1,1,8,32,0,8,2,40,0
5 Fitness Goals Even The Busiest Entrepreneur Can Keep,1,3,8,37,0,8,1,45,0
This Woman And Puppy Who Have Both Lost An Eye Are Each Other's Kindred Spirits,1,1,15,49,1,14,0,64,0
Roots review: this remake is brutal and harrowing – but it needs to be,1,3,1,54,2,13,0,55,0
20 Times Urban Dictionary Straight Up Ruined Your Favorite Animals,1,1,9,46,0,9,2,55,0
19 Happy French Bulldogs Guaranteed To Make You Smile,1,1,8,35,0,8,2,43,0
13 Reasons Life Would Be Better In Halloweentown,1,1,7,32,0,7,2,39,0
Are These Smiths Lyrics Real Or Fake,1,1,7,23,0,6,0,30,0
Tyronn Lue on uneven Cavs' loss to Hawks: 'Games like this come back and bite you',1,3,5,58,4,15,0,63,0
How Tony Blair built a business empire in China,1,2,4,35,0,8,0,39,0
Harrowing video warns teens of danger of speaking to strangers online,1,3,1,58,0,10,0,59,0
Taylor Swift Was Maid Of Honor At Her BFF's Wedding And It'll Give You All The Feels,1,1,19,47,2,16,0,66,0
26 Little Things That Ruin Every Teacher’s Day,1,2,7,29,1,7,2,36,0
Russian fighter plane intercepting unarmed U.S. jet came within TEN FEET of mid-air collision,1,3,10,67,3,13,0,77,0
What Hilarious Name Should You Give Your Dog,1,1,8,29,0,7,0,37,0
You’re about to play U-Conn. in the women’s Final Four. This is what you tell yourself.,1,2,6,60,6,15,0,66,0
Here's Why Your Body Jerks Awake When You're Falling Asleep,1,1,10,38,2,9,0,48,0
13 Ideas For Budget-Friendly Beach Weekend Getaways For New Yorkers,1,1,10,45,1,9,2,55,0
The 22 Most Painfully Awkward Things That Happened In 2015,1,1,8,35,0,9,6,43,0
Do You Conform To The Majority,1,1,6,19,0,5,0,25,0
Gun-Controlled Chicago: Over 400 Shot Year-to-Date,1,3,7,31,4,5,3,38,0
Why Scottish politician Nicola Sturgeon has been called ‘the most dangerous woman in Britain’,1,2,5,73,2,13,0,78,0
Women Discuss Whether Men And Women Can Actually Be Friends,1,1,10,40,0,9,0,50,0
"25 Photos To Remind You How Hot Leonardo DiCaprio Was, Is, And Always Will Be",1,2,15,44,2,14,2,59,0
21 Dogs Who Will Make You Believe In Happiness,1,1,8,28,0,8,2,36,0
You can take the biggest step toward building wealth in 10 minutes at your computer,1,3,1,66,0,14,2,67,0
Facebook terms of service force users to tell site as soon as they change their phone number,1,3,1,75,0,16,0,76,0
17 Meatballs Having An Identity Crisis,1,1,5,26,0,5,2,31,0
"I Don't Need To Choose Between Black And White, And Neither Does My Hair",1,1,14,43,2,13,0,57,0
MICHAEL LEWIS: This is what terrifies me the most about Trump's presidency,1,3,14,47,2,11,0,61,0
"FOX: Trump Surveilled Before Nomination, Agencies with Info Blocked Nunes for Weeks",1,2,12,58,2,11,0,70,0
21 Things Only Former Baby Lesbians Understand,1,1,6,32,0,6,2,38,0
Woman Foolishly Tries to Take Selfie With Uncooperative Crocodile and Pays the Price for It,1,3,11,66,0,14,0,77,0
This 45-Year-Old Blind Man Climbed To Machu Picchu In Just 13 Hours,1,1,12,38,2,11,4,50,0
Everything You Need To Know About Taco Bell's New Fried Chicken Taco Shell,1,1,13,48,1,12,0,61,0
21 Secrets Infertile Women Won't Tell You,1,1,6,26,1,6,2,32,0
3 Ways To Make Spaghetti Squash Pasta,1,1,6,24,0,6,1,30,0
Northwestern MutualVoice: Starting Your Own Business? How to Choose Your Structure,1,3,11,59,2,10,0,70,0
Vogue's December Cover Features Bollywood Divas From Across Generations Looking Glorious AF,1,1,13,66,1,11,0,79,0
The Kardashian-Jenner Sisters Are Your Fave New Singing Group,1,1,10,42,1,8,0,52,0
This Is The Ultimate Reason Living In A City Is The Best,1,1,12,33,0,11,0,45,0
10 books that will make you a better person in 2017 The list,1,2,1,41,0,12,6,42,0
"The Crazy Story Of How ""Clue"" Went From Forgotten Flop To Cult Triumph",1,1,13,43,2,12,0,56,0
19 Extravagant Gifts You Totally Deserve This Year,1,1,7,34,0,7,2,41,0
Tampons Vs. Pads,1,1,3,10,1,2,0,13,0
Caught tech-handed: The criminals snared by their own stupidity,1,3,2,51,2,8,0,53,0
18 Pics That'll Make You  Miss Your Best Friend,1,1,8,27,1,9,2,35,0
16 Perfect Responses To The Indian Patriarchy,1,1,6,31,0,6,2,37,0
This Otter Is Just Relaxing And Enjoying Some Snacks,1,1,9,35,0,8,0,44,0
A Hand Model Explains What It Takes,1,1,7,22,0,6,0,29,0
27 Pictures All Gamers Will Find Funny,1,1,6,24,0,6,2,30,0
Tiny brain and greasy hair found INSIDE ovary of 16-year-old girl,1,2,7,44,2,10,2,51,0
24 Hilarious Products That Just Might Make You Pee Your Pants,1,3,10,39,0,10,2,49,0
"13 Plus-Size Women On Loving Themselves, No Matter What Haters Say",1,1,11,41,2,10,2,52,0
Movies and TV Shows to Stream if You’re Snowed In Today - NYT Watching Watching Logo Search,1,3,16,57,2,16,0,73,0
A Productive Person’s Guide to a Little Bit of LSD,1,2,9,31,1,9,0,40,0
Americans need to relearn how to fight about politics. Sitcoms are ready to help.,1,3,2,64,2,13,0,66,0
Immigration Officer Injured in Texas Sanctuary City,1,3,6,39,0,6,0,45,0
This Woman Cut Her Vagina While Trimming,1,1,7,27,0,6,0,34,0
27 Tweets About Anxiety That Will Make You Laugh Then Cry,1,1,10,35,0,10,2,45,0
Snoop Dogg wants to be Twitter's new CEO,1,3,6,26,1,7,0,32,0
What's Your Teen Name,1,1,4,13,1,3,0,17,0
17 Celebrity Couples Costumes That Ruled Halloween,1,1,6,36,0,6,2,42,0
This Story Of David Bowie Blasting MTV For Not Playing Black Artists Is Going Viral,1,1,17,52,0,14,0,69,0
"Olivia From ""The Bachelor"" Made It Off That Beach They Left Her On",1,1,13,39,2,12,0,52,0
I'm The Armless Archer And A Paralympic Silver Medalist,1,1,9,37,1,8,0,46,0
Kate Mara And Jamie Bell Are Probably Dating And They Are So Adorable,1,1,13,44,0,12,0,57,0
"15 habits of self-made millionaires, from a man who spent 5 years studying rich people",1,3,0,67,2,14,3,67,0
This Visual Test Will Determine If You’re An Optimist Or A Pessimist,1,2,12,44,1,11,0,56,0
"""Wire tapping"" and 11 other words and phrases Trump has tweeted in quotes",1,3,2,55,2,12,2,57,0
These Trafficking Victims Are Studying To Become Lawyers And Fight Injustice Against Others,1,3,13,66,0,12,0,79,0
"Super Bowl 2017 movie trailers: What to expect, from Ghost in the Shell and Fast and Furious 8 to Transformers 5",1,2,8,76,2,20,6,84,0
11 Jobs That Pay More Than $100K At The Best Places To Work In 2017,1,2,13,30,1,14,9,43,0
Watch 100 Years Of Women's Lingerie In Three Minutes,1,1,8,32,1,8,3,40,0
The man behind one of 2016's best documentaries has uncovered a disturbing new YouTube trend,1,3,3,70,1,14,4,73,0
"Which ""The Voice"" Team Would You Be On",1,1,8,21,2,7,0,29,0
"Here's What ""Goosebumps"" Would Look Like As A Musical",1,1,9,33,3,8,0,42,0
31 Fall Wedding Ideas You'll Want To Try Immediately,1,1,8,33,1,8,2,41,0
This Was Hilary Clinton's Response To The GOP Debate,1,1,11,32,1,8,0,43,0
Seattle Jogger Shares the 5 Self-Defense Tips She Drew On to Defeat Rapist,1,2,11,49,1,12,1,60,0
"Kristen Stewart Talks About Honesty, Privacy, And Her New Movie ""Equals""",1,1,11,47,4,10,0,58,0
Branson offers some dads one year leave on full pay,1,2,1,41,0,9,0,42,0
25 Fans Who Are More Genius Than The Players,1,1,8,26,0,8,2,34,0
'Lack of diversity' among Scottish school heads,1,2,2,37,2,6,0,39,0
This Badass Couple Just Raised The Bar On Engagement Photos,1,1,10,40,0,9,0,50,0
"See how Stanford overtook Harvard as the most selective college in the US, in one chart",1,3,5,66,1,15,0,71,0
34 Photos That Prove We're All Actually Living In A Video Game,1,1,11,37,1,11,2,48,0
Trump: ‘I’m a Nationalist and a Globalist’,1,2,4,28,4,6,0,32,0
Snap Is Said to Have Worked on a Drone ,1,3,6,24,0,9,0,30,0
Why the EU’s fuss over Trump’s ambassador pick? He’s perfectly cast,1,3,5,48,4,10,0,53,0
UC Berkeley to Offer Class on Fake Language from ‘Game of Thrones’,1,3,9,44,2,11,0,53,0
Syrian ceasefire deal: What we know,1,2,2,27,1,5,0,29,0
We tried the potato chips that prisoners are obsessed with â hereâs the verdict,1,3,1,65,4,13,0,66,0
Aziz Ansari's New Show Has Its First Trailer And It's Pretty Damn Great,1,1,13,44,2,12,0,57,0
"19 Times Leslie Knope Shut Down Sexism On ""Parks & Rec""",1,1,9,31,3,10,2,40,0
Can You Name ALL Of The Elements In The Periodic Table,1,1,13,31,0,10,0,44,0
What's The Most Profound Quote About Death,1,1,7,28,1,6,0,35,0
56 Thoughts I Had Watching Shia LaBeouf Watching Shia LaBeouf Movies,1,1,12,44,0,10,2,56,0
Horrifying Video Shows Teen Jumping to His Death in Snapchat Stunt Gone Wrong,1,3,11,54,0,12,0,65,0
The 10 hottest neighborhoods in America for 2017,1,3,2,33,0,7,6,35,0
21 Gifts For People Who Just Really Love Pugs,1,1,8,27,0,8,2,35,0
"What the Freedom Caucus wants in the GOP health-care bill, and why it’s not getting it",1,3,6,62,3,15,0,68,0
This Woman Is 110 Years Old Today And She Has Had ENOUGH,1,1,16,26,0,11,3,42,0
"Want to land a great job? Don't go on a 'gap yah', work at JD Sports",1,3,5,43,5,15,0,48,0
What Makes Us: 'Syd' - ESPN Video,1,3,9,14,4,6,0,23,0
How one entrepreneur came up with a million dollar water idea,1,2,1,50,0,10,0,51,0
‘The Wolfpack’ Tells How the Six Angulo Brothers Were Saved by the Movies,1,3,10,49,2,12,0,59,0
Obama: GOP ‘Afraid’ to Show America What They Will Replace Obamacare With,1,3,13,46,3,11,0,59,0
Here's 100 Years Of American Men And Women's Beauty,1,1,8,30,2,8,3,38,0
21 Things You'll Only Understand If You're The Tallest In Your Friend Group,1,1,12,47,2,12,2,59,0
Which Celeb *Actually* Won Halloween 2015,1,1,5,25,2,5,4,30,0
This monster machine that splits trees is incredibly satisfying to watch,1,2,1,61,0,10,0,62,0
"2015-2016 Revealed A Strict Side Of Censor Board, 135 Hindi Films Were Given 'A' Certificate!",1,3,13,50,5,14,11,63,0
17 Albums That Prove 2005 Was Actually The Golden Era Of Emo,1,1,10,33,0,11,6,43,0
We Know What Celebrity You Fantasize About,1,1,7,29,0,6,0,36,0
Do You Suffer From FOMO Or JOMO,1,1,13,12,0,6,0,25,0
'Dear White People' trailer sparks backlash as Netflix faces claims of racism,1,2,4,60,2,11,0,64,0
17 Things Plus-Size Women Can't Possibly Do,1,1,7,26,2,6,2,33,0
I Just Cannot Get Over This Surreal Hidden Beach,1,3,9,31,0,8,0,40,0
21 Times All Of Tumblr Was On Drugs,1,1,7,19,0,7,2,26,0
Students find key error on SATs given across U.S.,1,3,6,33,2,8,0,39,0
7 Easy Organizing Ideas You'll Actually Want To Try,1,1,8,33,1,8,1,41,0
Vogue China Photoshopped Gigi Hadid And People Are Pissed,1,1,9,40,0,8,0,49,0
Saturday morning fever: Getting drunk on bloody Marys and dancing in Louisiana at 8.30am,1,3,4,66,2,13,3,70,0
Can You Make It Through This Quiz Without Dying,1,1,9,30,0,8,0,39,0
17 Times Kourtney Kardashian Shut Down Her Own Family,1,1,8,35,0,8,2,43,0
Black People Learn About Kwanzaa,1,1,5,23,0,4,0,28,0
17 Outfits Sonam Kapoor Wore In 2015 That Only She Could Pull Off,1,1,11,36,0,12,6,47,0
"Justin Bieber Dies Like A Really, Really Pretty Death In The ""Zoolander 2"" Trailer",1,1,13,52,3,13,1,65,0
Serena Williams Was Just Named Sports Illustrated's Sportsperson Of The Year,1,1,11,54,1,10,0,65,0
This Recovering Anorexic Now Shares Bikini Pics Of Herself To Promote Body Positivity,1,1,13,60,0,12,0,73,0
These Google Calendar Tricks Will Get You Organized,1,1,8,36,0,7,0,44,0
"Shock Videos: Meet Ray Buckley, Who Might Actually Become the Chairman of the Democratic Party",1,3,12,66,2,14,0,78,0
This Crossword Is For Everyone Who's Obsessed With Taylor Swift,1,1,10,43,1,9,0,53,0
"Get Ready For Another Crazy Season Of ""House Of Cards""",1,1,10,33,2,9,0,43,0
There's a key risk in Europe that everybody is missing,1,3,2,42,1,9,0,44,0
17 Things Picky Eaters Don't Want To Hear At Thanksgiving,1,1,9,36,1,9,2,45,0
Store Your Bike in Style,1,3,4,16,0,4,0,20,0
19 Times Siblings Masterfully Recreated Their Childhood Photos,1,3,7,46,0,7,2,53,0
21 Beautiful And Unexpected Bridesmaid Dress Colors,1,1,6,37,0,6,2,43,0
19 Incredibly Rare Endangered Baby Animals,1,1,5,30,0,5,2,35,0
23 Dad Jokes Guaranteed To Make You Shake Your Head And Smile,1,1,11,37,0,11,2,48,0
Which Male Oscar Winner Is Your Soulmate,1,1,7,27,0,6,0,34,0
Would You Hook Up With These Ghosts,1,1,7,22,0,6,0,29,0
17 Of The Most Underrated National Parks In America,1,1,8,33,0,8,2,41,0
13 Reasons 2015 Was The Year Of The Period,1,1,7,21,0,8,6,28,0
18 Times Tumblr Users Joined Together To Be Hilarious,1,2,8,35,0,8,2,43,0
21 Photos That Perfectly Sum Up Grad School,1,1,7,27,0,7,2,34,0
Former ‘Apprentice’ Contestant Files Defamation Suit Against Trump ,1,3,8,49,2,8,0,57,0
Pigskin A Blanket: NFL Divisional Round Picks,1,1,9,29,1,6,0,38,0
20 Commercial Jingles '90s Kids Still Remember Every Lyric To,1,1,8,39,1,9,4,47,0
From mermaids and breast feeding mothers to a 'man fairy': The 69 new emoji coming to your phone this year,1,3,2,80,3,19,2,82,0
If Twentysomethings Solved Their Problems Like Video Game Characters,1,1,9,51,0,8,0,60,0
11 Roald Dahl Quotes That Will Inject A Little Magic Into Your Day,1,1,12,40,0,12,2,52,0
13 Terrible Photos People Took Of The Eclipse With Their Phones,1,1,10,41,0,10,2,51,0
McConnell: Trump’s Hopes to Get Along With the Russians ‘Will Be Dashed Pretty Quickly’,1,3,13,57,4,13,0,70,0
19 Painful Photos Every Short Guy Can Relate To,1,1,8,29,0,8,2,37,0
Bowl projections heading into the final playoff selections,1,3,1,50,0,7,0,51,0
The 16 Best Poetry Books Of 2015,1,1,5,15,0,6,6,20,0
"Sanders on Ryancare: ‘An Absolute Disaster,’ ‘a Disgrace’",1,3,6,38,6,7,0,44,0
Two men shoot giant fireworks at each other. For fun.,1,3,2,40,2,9,0,42,0
Cats The Musical Is Returning To Broadway,1,1,7,28,0,6,0,35,0
Who Said It: Cory Matthews Or Riley Matthews,1,1,8,28,1,7,0,36,0
What's in store for Europe in 2017? A look at possible scenarios,1,2,3,44,2,11,4,47,0
Portraits of 99 From Occupy Wall Street ,1,3,5,26,0,7,2,31,0
The B/R Q&A: Rob Manfred Wants MLB to 'Own the Next Generation' of Sports Fans,1,3,16,43,5,14,0,59,0
These Photoshoots From Canadian Black Student Groups Will Give You Serious Squad Goals,1,1,13,61,0,12,0,74,0
20 Times Emma Watson Shut Down Sexism In The Best Damn Way,1,1,11,34,0,11,2,45,0
"Sarah Jessica Parker Talks Being A Carrie, ""Hocus Pocus,"" And Her Love Of New York",1,1,15,49,4,14,0,64,0
"Game Of Thrones Drawn As ""Bob's Burgers"" Characters Is The Crossover You Need",1,1,13,49,3,12,0,62,0
David Tennant Lists 6 Key Things That'll (Hopefully) Make Everything OK,1,3,11,46,3,10,1,57,0
Can You Finish Every Single Quote In This “Titanic” Quiz?,1,3,10,35,3,9,0,45,0
John Travolta can't read teleprompter at Grammys ,1,3,3,38,1,7,0,41,0
14 Times Olly And Neil Milan Were The Cutest Couple On Twitter,1,1,11,38,0,11,2,49,0
Where Is Music Headed in 2017? Here's A Peek,1,3,7,23,2,8,4,30,0
CNNVerifizierter Account,1,2,5,18,0,1,0,23,0
Quiz: Can you spot the 'fake news' headlines about Donald Trump? ,1,2,4,46,4,11,0,50,0
An Investigation Into Drake’s Thirst For Female Comedians,1,3,8,41,1,7,0,49,0
Scottish independence referendum: what Nicola Sturgeon said and what she really meant ,1,2,3,70,1,12,0,73,0
19 Non-Princess Disney Costume Ideas For Halloween,1,1,7,34,1,6,2,41,0
I Went To The Sylvester Stallone Memorabilia Preview And Asked To Smell Rocky's Gloves,1,1,14,58,1,13,0,72,0
Kim Kardashian Instagrammed What Might Be The Most 2000s Photo Of All Time,1,1,12,46,0,12,4,58,0
This Guys Wants To Charge $11K For A Tiny View Of The Pope From His Window,1,1,16,40,1,15,2,56,0
Sumo's next superstars? Why Mongolia is a wrestling powerhouse,1,3,3,49,2,8,0,52,0
I Tried Wedgie Jeans So You Don't Have To,1,1,9,23,1,8,0,32,0
100 Disney Memes That Will Keep You Laughing For Hours,1,3,9,33,0,9,3,42,0
"The First Trailer For ""The BFG"" Is Positively Magical",1,1,11,32,2,8,0,43,0
Apple patent reveals unusual designs for iPhone-laptop hybrid ,1,3,2,51,1,8,0,53,0
Disruptive Innovation: Has It Reached Buzzword Status Yet?,1,3,8,41,2,7,0,49,0
We Know Your Age And State Based On Your Mani,1,2,10,26,0,9,0,36,0
The 5 Biggest Mistakes Millennials Are Making With Their Money,1,3,9,43,0,9,1,52,0
51 Pictures That Are Guaranteed To Make Every Teacher Laugh,1,3,9,39,0,9,2,48,0
14 Texts All Perpetually Cold People Have Sent,1,1,7,30,0,7,2,37,0
Watch This Hedgehog Get A Massage And Instantly Become Tickled,1,1,10,43,0,9,0,53,0
Can We Guess Your Taste In Men Based On Your Makeup,1,1,11,30,0,10,0,41,0
Not extinct: 'Jurassic Pork' report flags projects that survived earmark ban ,1,2,3,60,3,11,0,63,0
How Many Of These Zac Efron Films Have You Seen,1,1,10,28,0,9,0,38,0
ESPN Loses Over a Half Million Subscribers,1,3,9,27,0,6,0,36,0
18 Dreamy Gifts For Anyone Who Is Obsessed With Traveling,1,1,9,37,0,9,2,46,0
PPE: the Oxford degree with a lot to answer for,1,3,4,33,1,9,0,37,0
Virus lottery: What could be next epidemic?,1,3,2,33,2,6,0,35,0
Why Russia has two St. Patrick’s days this year,1,3,4,33,2,8,0,37,0
11 Things You Probably Didn’t Know The National Endowment For The Arts Helped Create,1,3,13,55,1,13,2,68,0
The ultimate Moscow quiz – have you been paying attention?,1,3,2,45,2,9,0,47,0
Celebrities In Ramen Is The Instagram You Never Knew You Needed,1,1,11,42,0,10,0,53,0
19 Phil Dunphy Dad Jokes That Are Guaranteed To Make You Laugh,1,1,11,38,0,11,2,49,0
10 U.S. jobs vanishing at an alarming rate,1,3,2,29,2,7,2,31,0
Tell Us About Yourself(ie): Tia Mowry,1,1,6,23,3,5,0,29,0
Duke The Disabled Dwarf Bull Who Uses A Wheelchair To Walk Needs A New Home,1,1,15,46,0,14,0,61,0
The Internet Is Freaking Out Over Remy Ma's Savage Nicki Minaj Diss Track,1,3,13,47,1,12,0,60,0
India serial killings: Could 'house of horrors' accused be innocent?,1,3,2,53,4,9,0,55,0
Tipping point: revealing the cities where exercise does more harm than good,1,3,1,62,1,11,0,63,0
"11 of the weirdest foods you should try, according to the internet The list",1,2,1,58,1,13,2,59,0
7 Famous People Share Their Wisdom On The Art Of Happiness,1,2,10,37,0,10,1,47,0
16 Memes You Need To Show Your Parents If They're Pressuring You To Get Married,1,1,14,48,1,14,2,62,0
7 Bizarre Facts You Didn't Know About This Week In History,1,1,10,36,1,10,1,46,0
"Your Children Will Be Taught That Nyle From ""America's Next Top Model"" Is The Hottest Man Ever",1,1,17,58,3,16,0,75,0
13 Tumblr Posts About The Marauders We Need To Be True,1,1,10,32,0,10,2,42,0
Watch this slow-motion pile up unfold on an icy Montreal street,1,2,2,50,1,10,0,52,0
A treasure hunter found 3 tons of sunken gold — and can’t leave jail until he says where it is,1,3,1,71,2,19,1,72,0
Kanye West Threw Kim Kardashian A Pregnancy Themed Surprise Birthday Party,1,1,11,53,0,10,0,64,0
22 Reasons We Still Weren't Ready For Hoverboards In 2015,1,1,8,33,1,9,6,41,0
People Are Relating Hard To This Teen’s Mom That Got Caught Taking A Selfie,1,3,14,47,1,13,0,61,0
Tyra Banks Announced The Birth Of Her First Child In The Most Adorable Way,1,1,14,47,0,13,0,61,0
How Deadly Is Your Kilowatt? We Rank The Killer Energy Sources,1,3,11,40,1,10,0,51,0
19 Hilarious Tweets About Having To Sit At The Kids' Table On Thanksgiving,1,1,12,47,1,12,2,59,0
The 10 social media sins that every over 40-year old needs to avoid,1,3,1,49,1,12,4,50,0
Which Forgotten Game App Are You,1,1,6,21,0,5,0,27,0
17 Fall Breakfasts That Will Satisfy Your Sweet Tooth,1,1,8,35,0,8,2,43,0
This Is How A Rumor That Drake Died Got Started,1,1,10,28,0,9,0,38,0
RBC WealthVoice: The Million-Dollar Guide To Estate Planning,1,3,12,39,2,7,0,51,0
40 Life Hacks From Disney Movies That Are Borderline Genius,1,1,9,39,0,9,2,48,0
28 Gooey Brownies That'll Change Your Life Forever,1,1,7,33,1,7,2,40,0
Only A Spelling Genius Can Get Over 10 On This Timed Quiz,1,2,11,33,0,11,2,44,0
Women: have you experienced a workplace problem?,1,3,1,39,2,6,0,40,0
21 Signs You Took High School Way Too Seriously,1,1,8,29,0,8,2,37,0
Can You Guess Which San Francisco Burrito This Is,1,1,9,32,0,8,0,41,0
Monopoly unveils new game pieces,1,3,1,27,0,4,0,28,0
The Tennis Racket,1,1,3,12,0,2,0,15,0
Frank Ocean Just Released Another New Song And People Are Losing It,1,2,12,44,0,11,0,56,0
"Which Dancer From Justin Bieber's ""Sorry"" Video Are You",1,1,9,35,3,8,0,44,0
"Joking About Mental Health Is Not A Good Look, Katy Perry",1,3,11,35,1,10,0,46,0
Secret Santas: Inside the hidden online world of St. Nicks,1,3,5,42,2,9,0,47,0
Which Zodiac Sign Are You Most Compatible With,1,1,8,31,0,7,0,39,0
Reliance Jio Promises Tariff Packs And 'Exciting New Offers' To Customers Very Soon,1,2,13,56,2,12,0,69,0
"Charlotte Rampling Calls Oscars Boycott ""Racist To White People""",1,1,9,45,2,8,0,54,0
Things That Happen On Thanksgiving When You Love Food,1,1,9,36,0,8,0,45,0
This Is What Halloween Looks Like Around The World,1,1,9,33,0,8,0,42,0
"Merkel Stands by Migrant Policy in New Year’s Speech, Says Germany Fights Terrorism with Compassion",1,3,12,71,2,14,0,83,0
Are You Middle Class Enough to Deserve a Health Care Tax Break? ,1,2,10,41,1,12,0,51,0
New York Architects Plan Enormous Skyscraper Hanging From An Asteroid In Space,1,3,12,55,0,11,0,67,0
Private Equity's Indian Trilemma,1,3,4,24,1,3,0,28,0
"Are You More Derek Shepherd Or Mark Sloan From ""Grey's Anatomy""",1,1,11,39,3,10,0,50,0
"Just like everyone on 'Game of Thrones,' Steve Bannon also thinks 'Winter is coming'",1,2,6,60,5,13,0,66,0
Donald Trump dismisses the United Nations as a 'club' for people to 'have a good time',1,3,4,63,4,15,0,67,0
"Shaggy Returns With The Ultimate Diss Track, ""GFY""",1,1,10,30,3,7,0,40,0
"After Brutally Killing A Kangaroo With Metal Pipe, Two Men Have Been Jailed In Australia",1,3,15,58,1,14,0,73,0
4 claims the Trump White House made about its travel ban that now look silly,1,3,3,58,0,14,1,61,0
26 Pregnant Women Who Totally Slayed Halloween,1,1,6,32,0,6,2,38,0
Here Are All The Taylor Swift References On One Direction's New Album,1,1,12,45,1,11,0,57,0
U.S. Car Makers Idle Plants Amid Oversupply Concerns ,1,3,9,34,2,8,0,43,0
Paris Hilton's Instagram Account Right Now Is Hilarious AF,1,1,10,39,1,8,0,49,0
Bill Maher Just Made A Very Serious Point About The Trump Administration 'Circus',1,2,13,54,2,12,0,67,0
"The New ""Star Wars: The Force Awakens"" Trailer Is Here To Give You Chills",1,1,14,43,3,13,0,57,0
Hong Kong Seaside Mansion Bought for Estimated $86 Million,1,2,7,40,1,8,2,47,0
11 Underrated Grammy Nominees You Should Add To Your Playlists,1,1,9,42,0,9,2,51,0
Report: Islamic State General Flees to Europe with 400 Soldiers Disguised as Refugees,1,3,9,60,1,12,3,69,0
"Hugh Brown photographs artisan miners in Pakistan, India, Bolivia and Indonesia",1,3,6,61,2,10,0,67,0
Just A Reminder That Demi Lovato Looks Fierce AF Right Now,1,1,12,36,0,10,0,48,0
This Is What It Feels Like When Your Favorite TV Show Is Ending,1,1,14,37,0,12,0,51,0
This $200 AI Will End Tennis Club Screaming Matches,1,3,9,30,1,8,3,39,0
"Do You Remember The Essay From ""The Breakfast Club?""",1,1,9,32,3,8,0,41,0
40 Of The Most Powerful Obama Moments Of 2015,1,1,7,24,0,8,6,31,0
Two airline bosses quit after 'drunk' pilot is caught on camera,1,3,1,50,2,10,0,51,0
If Disney Princesses Did Fall Activities,1,1,6,29,0,5,0,35,0
"This Mumbai Boy Has Scored 100% In SAT, ACT And He Wants To Become Finance Minister Of India",1,2,21,49,2,17,3,70,0
9 Slightly Disturbing Facts That Will Stop You From Cleaning Your Ears Ever Again,1,1,13,54,0,13,1,67,0
Schumer’s Dangerous Game: Senate Dems Confront Trump Having to Defend 23 Seats in 2018,1,3,10,55,2,13,6,65,0
What Do People Love About You The Most,1,1,8,23,0,7,0,31,0
Truck driver stops high-speed car chase,1,3,1,32,1,5,0,33,0
"13 Adam Hills Rants By On ""The Last Leg"" That Nailed It",1,1,11,29,2,11,2,40,0
Riots Engulf Italian Migrant Centre Following Asylum Seeker Death,1,3,9,48,0,8,0,57,0
Can We Guess What '90s Toy You Deserve For Christmas,1,1,9,31,1,9,2,40,0
Meet The Alia Bhatt Superfan Who's Going To Hilarious Lengths Just For A Reply From Her On Twitter,1,1,18,62,1,17,0,80,0
17 Jokes That Only The Smartest People Will Get,1,3,8,29,0,8,2,37,0
20 Bollywood Celebs Who Received Death Threats As A Price For Money & Stardom,1,2,12,49,1,13,2,61,0
Lea DeLaria Revisits Her Career Highlights,1,1,7,30,0,5,0,37,0
23 Hilarious Tumblr Posts That Show Just How Strange Canada Truly Is,1,1,11,44,0,11,2,55,0
"Which ""Star Wars: The Force Awakens"" Actor Should Be Your Best Friend",1,1,12,43,3,11,0,55,0
"Swedish Library Bans Factual Book on Immigration, Says Contents are ‘Contrary to Human Rights’",1,2,11,67,3,13,0,78,0
15 Delicious Cocktails That Actually Aren't Horrible For You,1,1,8,41,1,8,2,49,0
Tell Us About Yourself(ie): Eric Balfour,1,1,6,26,3,5,0,32,0
Guess The Pixar Character Based Only On Images Of Their Eyes,1,1,11,39,0,10,0,50,0
We Need To Talk About The Pussycat Dolls,1,1,8,25,0,7,0,33,0
'I felt lonely when I shared that photo': Social media v reality at Christmas,1,3,4,57,3,13,0,61,0
Bryce cheer? Why Harper will be a Yankee in 2019 ... and why he won't - Yankees Blog- ESPN,1,3,10,51,7,18,4,61,0
23 Times Marilyn Manson Was You AF,1,1,7,19,0,6,2,26,0
24 Times Ryan Reynolds Proved He Was The King Of Twitter,1,1,10,34,0,10,2,44,0
The 22 Most Hipster Things That Happened In 2015,1,1,7,27,0,8,6,34,0
"Do You Remember That Famous ""Love Actually"" Scene",1,1,8,32,2,7,0,40,0
Elliot Fletcher Breaks Boundaries As One Of Few Trans Actors On TV,1,3,13,42,0,11,0,55,0
6 Morning Rituals That Will Make You Productive All Day,1,2,9,36,0,9,1,45,0
"Which ""Star Wars: The Force Awakens"" Character Are You Based On Your Zodiac",1,1,13,47,3,12,0,60,0
23 Facts That Will Totally Fuck With Your Perception Of Time,1,3,10,38,0,10,2,48,0
OMG Winnie-The-Pooh Is Actually A Girl,1,1,10,21,2,5,0,31,0
6 Things You Should Make In Your Slow Cooker Immediately,1,1,9,37,0,9,1,46,0
12 Karaoke Songs That Are Perfect To Do With A Partner,1,1,10,32,0,10,2,42,0
If you have any of these symptoms you may have an anxiety disorder The list,1,3,2,59,0,14,0,61,0
15 Charts Anyone Who Has Taken A Shower Can Relate To,1,1,10,31,0,10,2,41,0
How Addicted To Facebook Are You,1,1,6,21,0,5,0,27,0
Someone Altered A Tomi Lahren Facebook Page To Support Michelle Obama And People Lost It,1,3,15,59,0,14,0,74,0
An Adorable Animals Advent Calendar: December 2,1,1,6,33,1,6,1,39,0
People Came Together To Help A Widowed Old Man Find A Fishing Buddy And It’s So Touching,1,2,17,54,1,16,0,71,0
13 Dogs Who Look Just Like The 2016 Presidential Candidates,1,1,8,36,0,9,6,44,0
Would You Rather?: Hot Guys Then Vs. Now,1,1,8,22,3,7,0,30,0
These Ten Trans People Just Got Their First IDs Under Colombia’s New Gender Rules,1,2,15,52,1,13,0,67,0
Rachel Maddow's Trump Tax Report Proves A Comedy Gold Mine For Late Night TV Hosts,1,3,16,51,1,14,0,67,0
MSNBC’s Ruhle to Warren: ‘You Guys Were In Power’ — Why Didn’t Things Improve for Regular Americans?,1,3,18,59,7,16,0,77,0
Coyotes fan rips into Mayor Weiers - ESPN Video,1,3,8,30,1,8,0,38,0
22 Jokes You Probably Shouldn’t Laugh At But Definitely Will,1,3,9,39,1,9,2,48,0
Here's DJ Khaled's Inspirational Advice For Jeb Bush,1,1,9,34,2,7,0,43,0
Porn Stars Teach Couples Secret Sex Moves,1,1,7,28,0,6,0,35,0
What is congressional immunity?,1,3,1,26,1,3,0,27,0
15 Vines Proving Harry Styles Has No Chill When He's Onstage,1,1,10,37,1,10,2,47,0
"Despite Decline in American Marriages, Couples Still Pay Most of Nation’s Taxes",1,3,10,56,2,11,0,66,0
America’s Troops Celebrate Christmas Around the World,1,3,6,40,1,6,0,46,0
14 Trends We're Hoping Will Happen In 2016,1,1,6,22,1,7,6,28,0
"They were once ‘one big, happy group.’ Now two teens are accused of killing another.",1,3,2,63,5,14,0,65,0
What The Hell Is Going On With Harry Styles And Gigi Hadid's Awkward Interaction At The AMAs,1,1,19,56,1,16,0,75,0
Why American Airstrikes Go Wrong ,1,2,5,23,0,5,0,28,0
"Marijuana Eases Pain, But Jury's Out On Other Health Benefits, Scientists Say",1,2,12,51,3,11,0,63,0
This Guy's Insane Beatboxing Skills Have To Be Seen To Be Believed,1,1,12,42,1,11,0,54,0
Can We Talk About How Creepy The Hug Emoji Is,1,1,10,26,0,9,0,36,0
"US Election 2016 Pill popping, post-it notes and hot dogs: How Americans are coping post-election",1,2,6,69,4,14,4,75,0
28 Hilarious People Who Gave No Fucks in 2015,1,1,6,25,0,8,6,31,0
Betsy DeVos Asked Twitter A Question. It Did Not Go Well.,1,3,12,33,2,10,0,45,0
15 Absolutely Brutal Texts From Your Social Anxiety,1,1,7,35,0,7,2,42,0
"""Get Out"" Won’t Have A 100% Rating On Rotten Tomatoes Ever Again",1,3,11,35,4,11,3,46,0
"See How Well You Know These ""Arrested Development"" Characters",1,1,9,42,2,8,0,51,0
Donald Trump got behind the wheel of a truck and everyone is making the same joke The list,1,2,3,70,0,17,0,73,0
Amazon has a new weapon in its war on brick-and-mortar retail (AMZN),1,3,5,48,4,11,0,53,0
"How to watch, what to watch, who to watch and what to say in March",1,3,2,48,2,14,0,50,0
10 Boozy Drinks For People Who Love Candy,1,1,7,25,0,7,2,32,0
"Which ""Glee"" Character Are You Based On Your Zodiac Sign",1,1,10,35,2,9,0,45,0
People are asking how they can become a 'professional anarchist' The list,1,3,2,58,2,11,0,60,0
What Type Of Disney Movie Character Would You Be,1,1,9,31,0,8,0,40,0
Notre Dame Students Complain After Mike Pence Announced as Commencement Speaker,1,3,10,59,0,10,0,69,0
Pick A Heart To Get A Positive Message Just For You,1,1,11,30,0,10,0,41,0
This Behind The Scenes Footage Of Ted Cruz's Campaign Is So Brilliantly Awkward,1,1,13,53,1,12,0,66,0
Are we willing to let Trump evolve?,1,2,2,26,1,6,0,28,0
Friends' plan to trick teacher with identical haircuts is the sweetest thing,1,3,1,63,1,11,0,64,0
Gay in Putin's Moscow: why the city is pinker than you think,1,3,3,44,2,11,0,47,0
9 Ways Kim Kardashian Is Doing Pregnancy Totally Differently This Time,1,1,10,49,0,10,1,59,0
17 Llamas Who Think They Are Better Than You,1,1,8,26,0,8,2,34,0
"YouTube's 10 most-viewed Christmas videos revealed, number 1 may leave you scratching your head",1,3,3,73,3,13,3,76,0
Stop What You're Doing And Worship These Matt Bomer Pictures,1,1,10,40,1,9,0,50,0
A Look into the Mind of Gen. James Mattis: 15 Quotes from Trump’s Secretary of Defense Pick,1,3,11,59,3,16,2,70,0
18 Tips To Bring Your Colouring To The Next Level,1,1,9,29,0,9,2,38,0
21 Of The Most Endearingly Dorky Old Facebook Posts From Justin Trudeau,1,1,11,47,0,11,2,58,0
"Finally, definitive proof that Obama’s a guy you’d want to get a beer with",1,3,2,56,3,13,0,58,0
"Kids Reenact The First Black Friday On ""Jimmy Kimmel Live""",1,1,10,37,2,9,0,47,0
Can You Match These Taylor Swift Songs To Their Albums,1,1,10,35,0,9,0,45,0
Science News Quiz: Could you pass Year 10 science?,1,3,5,33,2,8,2,38,0
Women's March: What drove people to join protests around the world this weekend?,1,2,3,62,3,12,0,65,0
A Dog Who Was Left At A Shelter Later Saw Her Family Come For A New Dog,1,3,17,38,0,16,0,55,0
‘Refuse Fascism’ Group Behind Berkeley Riot Received $50k from George Soros,1,2,9,51,3,10,2,60,0
26 Things French People Find Kind Of Strange About The U.S,1,1,11,34,1,10,2,45,0
14 Things PM Modi Said In His 'Mann Ki Baat'+5 Must Read Stories,1,2,13,33,3,12,3,46,0
24 Tweets That Will Make Every Nurse Laugh Out Loud,1,1,9,31,0,9,2,40,0
Here's What Everyone Wore To The Glamour Women Of The Year Awards,1,1,12,41,1,11,0,53,0
"Which Doctor From ""Grey's Anatomy"" Would Save Your Life",1,1,9,35,3,8,0,44,0
"We Got Drunk And Listened To Adele's New Album, And Things Got Emotional",1,1,13,45,2,12,0,58,0
These Are (Probably) The Hottest Parenting Trends Of 2017,1,3,8,35,2,8,4,43,0
This Is How You Actually Have A Happy Halloween,1,1,9,30,0,8,0,39,0
Thousands Are Sharing This Inspirational Story By An Amputee Who's A National Athlete,1,1,13,59,1,12,0,72,0
17 Secrets Your Hair Stylist Wants You To Know,1,1,8,28,0,8,2,36,0
Are You More Niall Horan Or Ed Sheeran,1,1,8,23,0,7,0,31,0
"Justin Trudeau Hosts An AMA On Quora, Posts His Own Picture To Prove It's Really Him",1,2,18,49,2,15,0,67,0
What's Your 2015 Name,1,1,3,10,1,3,4,13,0
Carmelo Anthony: Open to Phil's criticism but prefer 1-on-1 variety,1,3,4,48,4,9,2,52,0
18 Perfect Couple Halloween Costume Ideas For You And Your Girlfriend,1,1,10,47,0,10,2,57,0
15 Things Anyone With Endometriosis Needs You To Know,1,3,8,35,0,8,2,43,0
Vancouver Just Had The Cutest Yoga Class To Ever Exist,1,1,10,35,0,9,0,45,0
Honey Boo Boo Just Dropped The Most Cringeworthy Music Video Ever,1,1,11,44,0,10,0,55,0
This chart of elections since 1979 suggests the Tories are about to win a landslide The list,1,3,3,69,0,16,4,72,0
30 Hella Easy Ways To Seriously Transform Your Old Jeans,1,1,9,36,0,9,2,45,0
Swansea Bay's tidal lagoon - in 60 seconds,1,2,2,29,2,7,2,31,0
Trump’s Breezy Calls to World Leaders Leave Diplomats Aghast ,1,3,8,43,1,9,0,51,0
This Beautiful Comic Pays Tribute To Two-Spirit Indigenous People Lost To Violence,1,1,13,57,1,11,0,70,0
People Are Now Doing Hand Makeup And It's Actually Mesmerizing,1,1,10,42,1,9,0,52,0
Just 19 Hilarious Things Muslims On The Internet Have Blessed Us With,1,1,11,45,0,11,2,56,0
21 Of The Most Trolled Baby Names Of Our Time,1,3,9,25,0,9,2,34,0
Why Russia has two St. Patrick’s days this year,1,2,4,33,2,8,0,37,0
Slovenia vs England: How the players fared,1,3,3,32,1,6,0,35,0
13 Things You're Probably Doing Wrong,1,1,5,24,1,5,2,29,0
This Bride Treated Herself To McDonald's After Her Groom Went Paintballing At Their Wedding,1,1,15,62,1,13,0,77,0
This Is What A London Pigeon Actually Does All Day,1,1,10,31,0,9,0,41,0
This Video Perfectly Parodies '50s Propaganda About Lesbians,1,1,7,43,1,7,2,50,0
Women Were Given A Self-Love Beauty Routine And It Changed Everything,1,1,12,46,1,10,0,58,0
18 Stunning Christmas Cookies Guaranteed To Impress Your Family,1,1,8,45,0,8,2,53,0
We Tried To Cook And Eat The Monstrosity That Is An Emu Egg,1,1,13,34,0,12,0,47,0
23 Signs That Cannot Be Trusted,1,1,5,19,0,5,2,24,0
25 GIFs From 'Planet Earth II' That Show How Tragicomic Nature Can Be,1,3,15,38,2,12,2,53,0
24 Gorgeous DIYs That Go For The Gold,1,1,9,19,0,7,2,28,0
A Guy Who Lost It In A Road Rage Incident Is Now A Gigantic Meme,1,1,15,35,0,14,0,50,0
"Amul Does It Again, Gives A Most 'Engaging' Twist To Virat-Anushka's Engagement Rumor!",1,2,14,54,6,12,0,68,0
What Year Is This Celebrity Headline From,1,1,7,28,0,6,0,35,0
Magna Carta: Everything You Need to Know About the 800-Year-Old Document,1,3,10,46,3,10,3,56,0
"Which Iconic ""Clueless"" Outfit Are You Based On Your Zodiac",1,1,10,38,2,9,0,48,0
Marine Le Pen May Get a Lift From an Unlikely Source: The Far Left ,1,3,12,40,1,14,0,52,0
23 Tweets That Prove You Should Never Cross Cara Delevingne,1,1,9,39,0,9,2,48,0
"16 Times Tumblr Was Hilarious About ""The Hunger Games""",1,1,8,34,2,8,2,42,0
29 Gorgeous Ways To Make Your Winter Decor Look Expensive,1,1,9,37,0,9,2,46,0
21 Tiny Things That Really Annoy Tidy People,1,1,7,28,0,7,2,35,0
Why conservatives gave up fighting gay marriage,1,3,1,40,0,6,0,41,0
Watch This Flower Girl Absolutely School Her Dad On Weddings,1,1,10,41,0,9,0,51,0
The Cutest Dogs Of The 2016 Westminster Dog Show,1,1,8,28,0,8,4,36,0
"Ready, Set, Grovel! Desperate Runners Battle for Slots in Trendy Races",1,3,9,48,3,10,0,57,0
This Is What U.S. Presidents Would Look Like With Man Buns,1,1,12,34,2,10,0,46,0
Dabbing makes politicians look like a stunned circus bear,1,3,1,48,0,8,0,49,0
This Totally Awesome Clothing Line From Target Comes In Straight And Plus Sizes,1,1,13,54,0,12,0,67,0
11 Reasons That You Are Actually Matt Bellassai,1,1,7,31,0,7,2,38,0
"While There's Rush For White Money, Pune Industrialist Converts Rs 200 Crore Into Black. Really!",1,2,14,61,4,14,3,75,0
Should I Call My Friend Out for Her ‘Service Dog’ Scam? ,1,3,10,32,3,11,0,42,0
"You Have To Watch These Actors Hilariously Impersonate Cher From ""Clueless""",1,1,11,52,2,10,0,63,0
The Hardest 2015 Quiz You'll Take This Year,1,1,7,24,1,7,4,31,0
22 Times Cats Made No Sense,1,1,5,15,0,5,2,20,0
40 Easy DIYs That Will Instantly Upgrade Your Home,1,1,10,30,0,8,2,40,0
"23 Insanely Adorable Jamie Scott Quotes From ""One Tree Hill""",1,1,9,38,2,9,2,47,0
"14 Things You Never Noticed During The Opening Number From ""Beauty And The Beast""",1,1,13,51,2,13,2,64,0
The journeyman boxer: Fighting on the losing side,1,2,2,39,1,7,0,41,0
Child-sharing: Meet the straight female friends who've legally adopted together,1,3,2,65,3,9,0,67,0
Cold War photo sparks amazing coincidence on Reddit| Latest News Videos ,1,2,6,54,1,11,0,60,0
11 Everyday Problems Solved With The Power Of Perspective,1,1,8,39,0,8,2,47,0
Is The Economy Getting Better? The Answer Depends On Who You Voted For,1,3,13,44,1,12,0,57,0
Here’s Your Exclusive First Preview Of Mariah Carey’s New Website,1,2,10,44,2,9,0,54,0
How Well Do You Remember These PlayStation Games,1,1,9,32,0,7,0,41,0
Hotels Instagramagedon: inside the hotel with the world's most jaw-dropping (and photogenic) pool,1,3,2,78,5,12,0,80,0
17 Strikingly Beautiful Irish Baby Names That Are About To Take Over,1,1,11,44,0,11,2,55,0
16 People Who Took Their Love Of Hockey A Little Too Far,1,1,11,32,0,11,2,43,0
Google throws shade at Trump's 'Muslim ban' with a historical Doodle,1,3,4,51,3,10,0,55,0
35 Of The Best Gifts To Buy At H&M,1,3,9,14,1,8,2,23,0
Grandparents Give Love Advice,1,1,4,22,0,3,0,26,0
Rogue groin? When filming a 'Star Wars' movie went kind of NSFW,1,3,8,41,3,11,0,49,0
Harry Styles' Hand And Jimmy Kimmel's Butt Is Our New Favorite Celeb Couple,1,1,13,48,2,12,0,61,0
This New Movie Is A Tragic Love Story For The No-Labels Generation,1,1,13,41,1,11,0,54,0
"Dershowitz: If Ellison is Appointed DNC Chair, I Will Resign My Democratic Party Membership",1,3,15,61,2,13,0,76,0
"More Than 40 Shot, 11 Killed Over Christmas Weekend in Gun-Controlled Chicago",1,2,10,50,2,11,4,60,0
"Meet Blindy, The Inspirational Blind Penguin Who Is Looking For A New Home",1,1,13,48,1,12,0,61,0
"After Her Son's Tantrum at the Supermarket, This Mom Receives a Sweet Surprise From a Stranger",1,2,12,65,2,15,0,77,0
Hands on with the Positron Voyager VR cinema chair,1,3,5,37,0,8,0,42,0
Donald Trump announces abrupt change to US foreign policy,1,3,4,45,0,8,0,49,0
These 'vertical forests' could transform a Brussels wasteland into luxury apartments,1,2,2,70,2,10,0,72,0
Can You Speed Read,1,1,4,11,0,3,0,15,0
16 Texts Fetuses Wish They Could Send,1,1,6,23,0,6,2,29,0
Source: Impending Layoffs Send ESPN Talent Into ‘Panic of Biblical Proportions’,1,3,13,53,3,10,0,66,0
Can We Guess When You'll Get Married Based On Random Questions,1,1,11,40,1,10,0,51,0
Touchscreen use by toddlers linked to poor sleep patterns,1,3,1,48,0,8,0,49,0
GOP lawmaker suffers medical emergency near House floor,1,2,4,44,0,7,0,48,0
22 Super Annoying Things Every Woman Has To Deal With,1,1,9,33,0,9,2,42,0
How Apple’s new music service compares to what’s out there right now,1,2,2,53,2,11,0,55,0
"14 Times ""The Fresh Prince Of Bel-Air"" Was The Realest Show On TV",1,1,14,34,3,12,2,48,0
We Know What Will Happen To You In 2016 Based On Your Favorite TV Show,1,1,15,37,0,14,4,52,0
Nordstrom broke the curse of the Trump tweet,1,3,2,35,0,7,0,37,0
Watch 100 Years Of Brazilian Beauty In A Little Over A Minute,1,1,11,36,0,11,3,47,0
F5Voice: Three Ways Your Apps Make You Vulnerable,1,3,9,31,1,7,1,40,0
11 Signs You Have The Grit You Need To Succeed,1,3,9,26,0,9,2,35,0
This Rugby Fan's Super-Excited Reaction To Meeting Shane Williams Will Make You Grin Like A Fool,1,1,17,62,2,15,0,79,0
One Man Dead in Shooting Near Filming of a Boosie Badazz Music Video,1,3,10,46,0,12,0,56,0
How an entrepreneur stopped chasing every new idea so he could focus on one big goal,1,3,1,68,0,15,0,69,0
Are You Actually A Sapiosexual,1,1,5,21,0,4,0,26,0
Someone Literally Paid A Public Toilet In Madurai With A Rs 5 Cheque And It's Not Even Funny,1,3,17,56,1,17,1,73,0
The IRA Mistake You Can Fix After Tax Day,1,3,11,22,0,8,0,33,0
T.J. Miller Reacting To Super Bowl Commercials Is Hilarious,1,1,10,39,2,8,0,49,0
"Sonu Nigam Remains Firm On His Stand, Tweets He's Against The Use Of Loudspeaker & Not Religion",1,2,16,60,3,16,0,76,0
159 Disney Quotes For When You Need An Instagram Caption,1,1,9,35,0,9,3,44,0
Watch Your Favourite Comedians Perform For Their Toughest Audience Yet: 8-Year-Olds,1,1,12,57,3,10,1,69,0
Jamie Dornan Golfing Will Be Your Desktop Background For The Rest Of Your Life,1,1,14,51,0,13,0,65,0
"30 Things You Might Not Know About ""Galavant"" Star Luke Youngblood",1,1,10,42,2,10,2,52,0
Tom Hanks Reveals The Movies That Have Meant The Most To Him,1,1,12,37,0,11,0,49,0
7 Times Shannen Doherty Inspired Us to Never Give Up [Video],1,3,9,38,2,10,1,47,0
"Queen Tyra Banks Is Reprising Her Role In The Upcoming ""Life-Size"" Sequel",1,1,13,46,3,11,0,59,0
"Which ""Star Wars: The Force Awakens"" Hunk Is Your Soulmate",1,1,10,36,3,9,0,46,0
"Game Of Thrones Characters Drawn In ""Bob's Burgers"" Style",1,1,9,37,3,8,0,46,0
We Need To Talk About Pumpkin Spice,1,1,7,22,0,6,0,29,0
21 Things To Do In New York In The Fall,1,1,9,19,0,9,2,28,0
18 Iconic Kim Kardashian Tweets That Are Only 4 Words,1,1,8,33,0,9,3,41,0
Channing Tatum Is The Most Emo Guy At The Golden Globe Awards,1,1,12,38,0,11,0,50,0
"‘I have been fundamentally condemned to die in prison,’ a drug dealer wrote. Obama listened.",1,3,2,71,5,14,0,73,0
What Percent Blair Waldorf Are You Based On Your Zodiac Sign,1,1,11,39,0,10,0,50,0
"CNN Panics over French Election, Admits Le Pen Could Win",1,3,11,35,1,9,0,46,0
"Bad Blood: The Fastest, Most Furious Music Feuds of 2016",1,3,8,33,2,9,4,41,0
It took 100 years and 1 inspirational video for new NYC subway line to launch,1,2,4,55,0,14,4,59,0
Inside the little-known Monsanto campus where scientists are changing the way you eat,1,2,2,70,1,12,0,72,0
20 Gifts Only People Who Live On The Internet Will Appreciate,1,2,10,39,0,10,2,49,0
"Lupita Nyong'o Discusses #OscarsSoWhite, Inclusivity, And Progress",1,1,9,47,4,6,0,56,0
21 Tweets That Prove Your Brain Can Be A Real Dick Sometimes,1,1,11,36,0,11,2,47,0
Philippines: Duterte Not Appointing U.S. Envoy Because ‘I Don’t Feel Like Sending One’,1,3,14,54,6,12,0,68,0
Face transplant recipient overwhelmed by result,1,2,1,41,0,5,0,42,0
See James Bond's Style Evolution Over 60 Years,1,1,7,29,1,7,2,36,0
Santas Taste Test Reindeer,1,1,4,19,0,3,0,23,0
"This Is What The Kid Who Covered Gaga's ""Paparazzi"" Looks Like Now",1,1,12,40,3,11,0,52,0
European Establishment Tries New Election Tactic: Full Embrace of the EU,1,2,10,51,1,10,0,61,0
How To Make Friends According To Science,1,1,7,27,0,6,0,34,0
47 Of The Most Important Cher Tweets Of The Last Five Years,1,1,11,35,0,11,2,46,0
Literally Just 22 Really Funny Tumblr Posts,1,1,6,29,0,6,2,35,0
Taking on America's worst fears,1,2,2,24,1,4,0,26,0
The big mistake some anti-Trump protesters could be making,1,3,2,47,1,8,0,49,0
"Roland Martin: Trump ‘Hoodwinked, Bamboozled’ White Working-Class Voters",1,3,9,51,5,7,0,60,0
"This ""Hunger Games"" Interpretation Will Change The Way You See The Mockingjay",1,1,12,52,2,11,0,64,0
We Need To Discuss Global Treasure Alicia Vikander,1,1,8,35,0,7,0,43,0
2017 NBA Draft: Best-Case Scenario for Each Top Prospect,1,2,10,32,2,8,4,42,0
Nancy Pelosi: Obamacare Was ‘Bipartisan’ Legislation,1,3,6,38,3,5,0,44,0
GM Food - Cultivating Fear,1,3,5,16,1,4,0,21,0
Donald Trump Signals ‘Big Fat Beautiful Negotiation’ on House Healthcare Bill,1,3,10,55,2,10,0,65,0
Pan Dulce Is The Most Delicious Thing You Need To Try,1,1,11,32,0,10,0,43,0
A Bald Eagle Attacked Donald Trump During A Photo Shoot,1,1,10,36,0,9,0,46,0
24 Of The Most Badass Moments In History,1,1,7,24,0,7,2,31,0
NASA study reveals how much radiation REALLY hits you when you travel by plane,1,3,10,55,0,13,0,65,0
Woman jailed for helping Sabrina Moss' killer,1,3,3,35,1,6,0,38,0
Name That Disney Cat,1,1,4,13,0,3,0,17,0
"All 44 Places It's Possible To Have Sex In ""The Sims""",1,1,10,28,3,10,2,38,0
Trade Pacts Face Growing Pushback,1,3,5,24,0,4,0,29,0
Gun killings fell by 40% after Connecticut passed this law – so why are other US states not following its lead?,1,3,4,82,3,20,2,86,0
This woman got a snake stuck in her earlobe,1,3,1,34,0,8,0,35,0
Demi Moore Joins ‘Empire’ in Recurring Role,1,3,6,29,2,6,0,35,0
L.A. Olympics CEO: Trump More Helpful than Obama,1,2,10,28,3,7,0,38,0
These are the weirdest things you'll find in Russia's 'patriotic theme park' The list,1,3,3,65,4,13,0,68,0
21 Very Important Kitten Pictures You Need To See,1,1,8,31,0,8,2,39,0
Which Member Of EXO Are You,1,1,8,14,0,5,0,22,0
Twist of fate saves Brazilian football commentator's life,1,2,2,47,1,7,0,49,0
"‘Jeopardy’ Contestant Mispronounces ‘Tupac,’ Internet Goes Crazy [Video]",1,3,8,50,7,7,0,58,0
20 Heartbreaking Confessions From People With Asperger's Syndrome,1,1,7,48,1,7,2,55,0
"Which ""League Of Legends"" Yordle Are You",1,1,7,25,2,6,0,32,0
Kris Jenner Has Declared Scott Disick Her True Love,1,1,9,34,0,8,0,43,0
Why Italians Might Be Economic Losers in Era of Euro,1,2,8,35,0,9,0,43,0
Handle with care: readers' photos on the theme of tender,1,3,1,44,2,9,0,45,0
"Trump thinks something terrible happened in Sweden, so here come the IKEA and ABBA jokes",1,2,10,63,1,14,0,73,0
"What D.C. posts on Twitter versus what everybody else posts on Twitter, visualized",1,3,5,62,3,12,0,67,0
Professor: Stop Calling All People Who Disagree with You ‘White Supremacists’,1,3,10,54,3,10,0,64,0
Doctors say Florida stem cell clinic left 3 women blind,1,2,2,43,0,9,1,45,0
11 of the highest-paying jobs at the best companies in America,1,3,1,48,1,10,2,49,0
Shocking Police Officer Confessions,1,1,4,28,0,3,0,32,0
What Little Things Give You The Biggest Anxiety,1,1,8,32,0,7,0,40,0
Crazy Things People Used To Believe About Women In The 1800s,1,1,10,36,0,10,4,46,0
19 Times CVS Receipts Had No Chill,1,1,8,18,0,6,2,26,0
22 Easy Brunch Recipes To Make This Fall,1,1,7,24,0,7,2,31,0
Things Kim Kardashian Has Said That'd Be Weird If You Said Them,1,1,12,39,1,11,0,51,0
The Unlikely South American Capital You Need to Put on Your Bucket List,1,3,11,48,0,12,0,59,0
"11 Quotes That Prove ""Star Wars"" And ""The Princess Bride"" Are Basically The Same",1,1,13,48,4,13,2,61,0
11 Things That Hit Everyone Right In The Feels,1,1,8,28,0,8,2,36,0
How Rooster Teeth Started The Web's Longest-Running Series -- And Made A Business Out Of It,1,2,16,56,4,15,0,72,0
The money management business could reach 'a turning point' in 2017,1,3,1,50,2,10,4,51,0
Golfing With Trump? Better Leave Your Ego At the Clubhouse,1,3,9,39,1,9,0,48,0
Everyone thinks this Belle doll looks like Justin Bieber (and they're not wrong),1,3,4,61,3,12,0,65,0
"11 Internet Cartoons That Will Make You Feel ""Popeful""",1,1,8,34,2,8,2,42,0
Do You Know How Old Your Favorite Pop Star Was When They Released Their First Album,1,1,16,52,0,15,0,68,0
The March Madness 'news dump' that made us question everything,1,3,3,48,2,9,0,51,0
Meet The Sikh Rapper Looking To Change The World Through Hip-Hop,1,1,12,41,1,10,0,53,0
Rush Limbaugh: ‘The Media Did Not Make Donald Trump and They Can’t Destroy Him’,1,3,13,49,4,13,0,62,0
You Need To Stop What You're Doing And Rewatch Victoria Beckham's 2007 Reality Show,1,1,13,51,2,13,4,64,0
"After Promotions, Managers Must Learn to Shift Gears ",1,2,7,37,1,8,0,44,0
‘You can’t beat me!’: Dutch beatbox Champion challenges his baby niece to join in with him… with hilarious results ,1,3,3,87,6,19,0,90,0
Potterheads Try Fan Created Sweets,1,1,5,25,0,4,0,30,0
So What Is Kendrick Lamar Actually Dropping On April 7?,1,3,9,35,1,9,1,44,0
9 Things It's Still OK To Love Now That Tennis Is Ruined,1,1,12,31,1,11,1,43,0
Everything You Need To Know About The DNC Race,1,3,11,27,0,8,0,38,0
22 Of The Most Powerful Photos Of This Week,1,1,8,25,0,8,2,33,0
"How I Learned That To Stop Cheating, I Needed To Stop Being So Cynical",1,1,14,42,1,13,0,56,0
18 Halloween Struggles You'll Recognize If You're From A Hot Place,1,1,10,42,2,10,2,52,0
"How much protein do you REALLY need? Less than you think, a dietitian explains ",1,3,8,55,2,14,0,63,0
Poll: 60 Percent of Adults ‘Hopeful and Optimistic’ About America’s Future,1,3,8,50,4,10,2,58,0
How Ethan Embry Staged His Unlikely Comeback,1,1,7,31,0,6,0,38,0
11 Charts For When You Feel Bad About Your Body,1,1,9,27,0,9,2,36,0
Artistic Prom Dress That Student Painted on Her Own Will Make You ‘Scream’ [Video],1,3,13,52,4,13,0,65,0
10 incredible photos of defiance from history The list,1,2,1,43,0,8,2,44,0
"T.I. on Kanye West's Trump Meeting: 'What the F*ck You Doing, Man?'",1,3,11,36,9,11,0,47,0
20 Rising Web Development And Design Blogs To Follow In 2017,1,3,9,35,0,10,6,44,0
19 Texts All Twentysomethings Have Sent Their Dad,1,1,7,33,0,7,2,40,0
Carrie Fisher's Singing Voice: 5 Times She Shared Her Hidden Musical Side,1,3,11,48,2,11,1,59,0
10 Scary Movies As Viewed By Complete Cowards,1,1,7,29,0,7,2,36,0
"Would You Receive The Final Rose From ""Bachelor"" Ben Higgins",1,1,10,39,2,9,0,49,0
22 Struggles People Who Don't Wear Glasses Will Never Understand,1,1,9,43,1,9,2,52,0
"How Well Do You Remember The ""Sex And The City"" Finale",1,1,11,31,2,10,0,42,0
18 Decadent Cupcake Recipes That Are Better Than Sex,1,1,8,34,0,8,2,42,0
This Quiz Will Determine How You Drive,1,1,7,25,0,6,0,32,0
Here's What Happened When One Dude Tried Six Different Women's Hairstyles,1,1,11,50,2,10,0,61,0
How a half-billion-dollar statue is dividing India,1,3,2,40,2,6,0,42,0
News The world's safest - and least safe - airlines revealed,1,3,2,45,3,10,0,47,0
26 Adorable Products Every Dog Owner Needs,1,1,6,28,0,6,2,34,0
The Clean Person's Guide to a Messy Desk,1,3,6,26,1,7,0,32,0
"Buzzy, Newly Accessible Destinations, From the Canadian Arctic to Chengdu, China",1,2,9,58,3,10,0,67,0
The 2017 Investment Guide: Trumponomics,1,3,4,26,1,4,4,30,0
17 People Who Said The Wrong Thing At The Wrong Time,1,1,10,30,0,10,2,40,0
An Inside Look At Justin Timberlake's Bai Super Bowl Commercial,1,3,10,43,1,9,0,53,0
Steve O'Keefe Proves To Be India's Nemesis As Virat Kohli's Unbeaten Streak In Tests Comes To An End,1,3,19,61,3,17,0,80,0
Can You Handle An Evening Of Menstruation,1,1,7,28,0,6,0,35,0
Immigrants in the shadows in Austin: ‘Know your rights’ and plan for someone to care for your children,1,3,3,79,3,17,0,82,0
13 Reasons The Frozen Food Aisle Is The Most Depressing Place On Earth,1,1,12,44,0,12,2,56,0
16 Gifts For People Who Always Need To Charge Their Phone,1,3,10,35,0,10,2,45,0
Can We Predict How Much Time You Waste On Your Phone?,1,3,11,31,1,10,0,42,0
This Is What Medieval Europe's Most Epic Moments Looked Like,1,1,10,40,1,9,0,50,0
18 Horror Novels Every True Fan Should Read Before Watching The Movie Version,1,1,12,51,0,12,2,63,0
Send This To The Person Who Gives Bad Gifts,1,1,9,26,0,8,0,35,0
Snow stylish: an ice-cool fashion shoot – in pictures,1,2,1,41,3,8,0,42,0
19 Of The Creepiest News Stories From 2015,1,1,6,23,0,7,6,29,0
"If You Score 10/12 On This Great Lakes Quiz, You’re Probably From The Midwest",1,3,13,44,3,13,4,57,0
"This Kangaroo Is Kind Of Hot, Yeah",1,1,7,20,1,6,0,27,0
Should You Go On An Adventure With Ron Weasley Or Samwise Gamgee,1,1,12,41,0,11,0,53,0
Online dating is a total nightmare for farmers,1,2,1,38,0,7,0,39,0
71 Thoughts You Have If You Get Stupid Excited Over Seeing A Cool Dog,1,1,13,41,0,13,2,54,0
White House defends President Trump’s golf habit and argues it’s different from Obama’s,1,3,5,67,3,12,0,72,0
'Fresh Prince' blues cover would make Uncle Phil proud,1,2,4,40,2,8,0,44,0
Daniel Radcliffe Has Ditched The Hairy Potter Look,1,1,8,35,0,7,0,43,0
4 changes shoppers will see as they buy on their phones,1,2,0,44,0,10,1,44,0
17 Tumblr Posts You’ll Get If You Were Never All That Good At Math,1,3,13,37,1,13,2,50,0
5 Ways a Smart Assistant Can Transform Your Morning,1,3,7,35,0,8,1,42,0
57 Things That Happen The Morning After A One Night Stand,1,1,10,35,0,10,2,45,0
19 Times Tumblr Was Depressingly Accurate About Your Relationship With Money,1,1,10,54,0,10,2,64,0
How Much Of A Welsh Stereotype Are You,1,1,8,23,0,7,0,31,0
It's Time We Discussed How Dumbledore Totally Screwed Over The Slytherin House,1,1,12,54,1,11,0,66,0
18 Presentations That Would Make You Pay Attention In Class,1,1,9,39,0,9,2,48,0
13 Hashtags Too Real For Anyone Who Grew Up Catholic,1,1,9,32,0,9,2,41,0
Report: Miss World Threatens to Eject Anti-China Beauty Queen if She Speaks to Press,1,3,12,57,2,13,0,69,0
27 Tweets About Being Latino That Are Way Too Real,1,1,9,30,0,9,2,39,0
Russia Sanctions Explained: A Look at the Measures Donald Trump Could Roll Back ,1,3,11,55,1,13,0,66,0
TurboTax Wants to Do What? Share Your Tax Data,1,3,9,28,1,8,0,37,0
"19 Funny Chinese Dating Show Quotes That’ll Make You Say, “Me”",1,3,10,36,4,10,2,46,0
The 3 Longest Flights In The World Are Not For The Faint Of Heart,1,3,13,38,0,13,1,51,0
Summer movie preview: What to watch if you just want to see the best of the best,1,2,2,61,1,16,0,63,0
22 Emergency Items You Need Before That Huge Fucking Blizzard Hits,1,1,10,44,0,10,2,54,0
Toronto Finally Has A Cat Cafe And It's Even Cuter Than What You Imagine,1,1,14,44,1,13,0,58,0
'My mum is my angle': Hilarious tattoo fails show how things go badly wrong when the inker can't spell ,1,2,2,78,4,19,0,80,0
What US Music Festival Should You Attend This Year,1,1,10,32,0,8,0,42,0
11 Tragic Everyday Disappointments,1,1,3,26,0,3,2,29,0
27 Clever Ways To Remember All Your Shit,1,1,7,24,0,7,2,31,0
Lindsey Graham Warns Trump ‘Don’t Empower Russia’,1,2,7,33,3,6,0,40,0
29 Pictures That Will Give You Severe Flashbacks To The Late '90s And Early '00s,1,1,12,46,2,14,6,58,0
Can You Get Laid Tonight,1,1,5,15,0,4,0,20,0
Farage: ‘A Lot of Trump Voters Will Be Scratching Their Heads’ over Syria Airstrikes,1,3,12,56,3,13,0,68,0
These daily habits will make your brain happier â according to neuroscience,1,3,1,63,2,11,0,64,0
Body Positive Blogger Preaches ‘You Can’t Spell Cellulite Without U LIT’,1,3,13,46,3,10,0,59,0
"21 Times Angie Was The Best Part Of ""30 Rock""",1,1,8,22,2,9,4,30,0
11 Iconic Bollywood Magazine Covers That Would Have Broken The Internet,1,1,10,49,0,10,2,59,0
24 Things All Theme Park Lovers Will Understand,1,1,7,31,0,7,2,38,0
This Pesticide Is Prohibited in Britain. Why Is It Still Being Exported? ,1,3,11,48,2,12,0,59,0
Six Records That Show There Will Be Only One Don Bradman,1,3,11,35,0,10,0,46,0
18 Things That Are Only Funny To Musicians,1,1,7,26,0,7,2,33,0
23 Things Only Weave Addicts Will Understand,1,1,6,30,0,6,2,36,0
24 Things We Should All Just Stop Saying After Breakups,1,1,9,35,0,9,2,44,0
Tucker Carlson Takes Over Bill O'Reilly's Time Slot In More Ways Than One,1,3,14,45,2,12,0,59,0
Transgender Cub Scout Nails Why Donald Trump Is Wrong To Remove Protections For Trans Students,1,2,15,65,0,14,0,80,0
Trump's reversal on transgender bathroom directive: How we got here,1,3,2,54,2,9,0,56,0
"20 Times Frank Reynolds Was The Most Hilarious Character On ""It's Always Sunny""",1,1,12,50,3,12,2,62,0
21 Funny Texts That You Won’t Be Able To Get Through Without Laughing,1,3,12,42,1,12,2,54,0
The policemen who dressed as women to hide from IS,1,3,3,38,0,9,0,41,0
We Know Exactly Where You Live,1,1,6,19,0,5,0,25,0
We Know Which Country You're Going To Die In Based On One Question,1,1,13,40,1,12,0,53,0
32 Video Games You Have To Play Before You Die,1,1,9,26,0,9,2,35,0
"Can You Recognize The ""Steven Universe"" Character Based On Their Silhouette",1,1,11,52,2,10,0,63,0
Greek Zucchini Fritters Recipe - NYT Cooking,1,3,8,29,1,6,0,37,0
Watch Josh Hutcherson Try To Trip Jennifer Lawrence Up After She Fell Over,1,1,13,49,0,12,0,62,0
Feinstein: Trump ‘Splitting’ America Apart With ‘Blizzard of Executive Orders’,1,3,9,55,5,9,0,64,0
How to Boost Your Social Security Check by 85 Percent,1,2,7,35,0,9,2,42,0
"Can We Guess Your Age From These ""Would You Rather"" Questions",1,1,11,38,2,10,0,49,0
"The Earliest I've Said ""I Love You""",1,1,7,19,3,6,0,26,0
34 Wonderful Products For People Who Hate Clutter,1,1,7,33,0,7,2,40,0
What's The Best Part About Christmas In The Midwest,1,1,9,33,1,8,0,42,0
"If you want to end a relationship, this is how to do it The list",1,2,2,47,1,14,0,49,0
Explained: How memory works,1,3,2,21,1,3,0,23,0
Donald Trump In Famous Horror Movie Scenes Will Petrify You,1,1,10,40,0,9,0,50,0
Move Over Dubai: Doha Is About To Be The Middle East's Next Big Destination,1,3,14,46,2,13,0,60,0
These Guys Beatboxed With Siri To Create The Most Amazing Indian Classical Jam Ever,1,1,14,56,0,13,0,70,0
Why Rihanna & Lady Gaga Are Turning to Unknown Fashion Students for Fresh Looks,1,3,11,54,1,13,0,65,0
Should You Change Your Investments Under President Trump?,1,3,8,41,1,7,0,49,0
18 Times Miranda Hart Spoke The Absolute Truth,1,1,7,30,0,7,2,37,0
Here's Why Ditching Apple's iPhone Cord Changed My Life,1,1,9,36,2,8,0,45,0
"Video: Women Freed from Islamic State Burn Face Veils, Smoke Cigarettes",1,2,10,49,2,10,0,59,0
Animated map reveals the most popular pizza chains in every state,1,3,1,54,0,10,0,55,0
"Sharpton: Bernie Sanders Lost Black Voters Because He Couldn’t See Difference Between Main Street, MLK Blvd",1,3,18,71,3,15,0,89,0
22 Of My Chemical Romance's Most Unforgettable Moments,1,1,7,37,1,7,2,44,0
This Woman Wrote A Beautiful Facebook Post About Cancelling Her Wedding Because Of Dowry,1,1,14,61,0,13,0,75,0
Horchata Cold Brew Is A Thing And You Need To Try It ASAP,1,1,16,29,0,12,0,45,0
Put down that energy drink! - CNN Video,1,3,5,25,2,7,0,30,0
"What's Your Favorite Leslie Knope Quote From ""Parks And Recreation""",1,1,10,45,3,9,0,55,0
"Scott Disick Said He'd ""For Sure"" Kill Kim Kardashian In A Game Of ""F#@K, Marry, Kill""",1,1,17,45,9,15,0,62,0
"How Well Do You Remember ""The Walking Dead"" Season 1-3",1,1,9,31,3,9,2,40,0
22 Things You'll Understand If You're Slightly Obsessed With Lush,1,1,9,43,2,9,2,52,0
"Left-Wing ‘Anti-Hate’ SPLC Cheated Tax Laws, Says Legal Complaint",1,2,14,38,5,8,0,52,0
Watch the Cast of 'Stranger Things' Spit Bars at the Golden Globes,1,2,8,45,2,11,0,53,0
These New York Taxi Drivers Nailed Their Sexiest Poses For A Charity Pin Up Calendar,1,1,15,55,0,14,0,70,0
‘2016 Was Our Archduke Franz Ferdinand’ ,1,3,5,23,2,6,4,28,0
15 Totally Breathtaking Places You Won't Believe Are Real,1,1,8,38,1,8,2,46,0
Advantage: Tim Tebow? Bizarre batting behavior made us wonder,1,2,4,47,2,8,0,51,0
The top 10 best selling comic books of all time [Video],1,3,2,39,2,10,2,41,0
Will Moonlight beat La La land? Our final Oscars 2017 awards predictions,1,2,6,50,1,11,4,56,0
27 Studio Ghibli Tattoos That'll Make Your Heart Croon,1,1,8,35,1,8,2,43,0
This Fan Theory About Jar Jar Binks Will Blow Your Mind,1,1,11,34,0,10,0,45,0
We Know Which Raccoon GIF Will Make You Happy Based On Your Zodiac Sign,1,1,16,42,0,13,0,58,0
People Love This Guy’s Way To Solve Dinner Fights With His Girlfriend,1,3,12,45,1,11,0,57,0
19 Gorgeous Lingerie Sets That Will Make You Never Want To Wear Pants Again,1,1,13,47,0,13,2,60,0
13 Faces Every Tech CEO Who Goes To A Meeting With Donald Trump Will Immediately Recognize,1,2,17,56,0,15,2,73,0
42 Genius Tweets That Made British People Piss Themselves In 2015,1,1,9,40,0,10,6,49,0
Bizarre moment snake 'thief' stuffs python down his trousers at pet shop,1,3,1,58,2,11,0,59,0
13 Things Trans Women Are Sick Of Hearing,1,1,7,25,0,7,2,32,0
What I learned from filing my own taxes for the first time,1,2,2,45,0,11,0,47,0
19 Of The Most Hilarious Tweets About Ryan Gosling,1,1,8,32,0,8,2,40,0
75 Thoughts Every Runner Has While Running A Marathon,1,1,8,35,0,8,2,43,0
Here Are All of Ed Sheeran's Videos: Vote for Your Favorite,1,3,9,38,2,10,0,47,0
I Finally Found A TV Character Whose Depression Looks Like Mine,1,1,12,41,0,10,0,53,0
"Who Are the 8 Richest People? All Men, Mostly Americans",1,3,8,35,2,9,1,43,0
"Lea Michele Is Finding Life After ""Glee""",1,1,7,25,2,6,0,32,0
25 Of The Best Responses To The Super Blood Moon,1,1,9,28,0,9,2,37,0
We Know What Your Favorite Social Media Platform Is,1,1,9,34,0,8,0,43,0
Olympic gold medal-winning rower can't get a mortgage to buy his own home,1,3,1,58,2,12,0,59,0
Here's What Real Vegans Actually Eat,1,1,6,24,1,5,0,30,0
How ‘Jurassic World’ Created a Terrifying New Dinosaur,1,2,7,38,2,7,0,45,0
We Broke Into Our BFF's House Dressed Like Santa And Here's What Happened,1,1,15,44,2,12,0,59,0
13 Eye-Opening Facts That Reveal India's Massive Obsession With Engineering,1,1,10,52,2,9,2,62,0
9 Images Of Minnie Mouse As You've Never Seen Her Before,1,1,10,34,1,10,1,44,0
Is There Any Disney Prince Hotter Than Aladdin,1,1,8,31,0,7,0,39,0
Which Male Singer Is Your Ex Based On Birth Month,1,1,10,30,0,9,0,40,0
Fans Try Harry Potter Lipsticks,1,1,5,22,0,4,0,27,0
We Know If You'll Find Love On Tinder,1,1,8,21,1,7,0,29,0
19 Signs You And Your Best Friend Are Becoming The Same Person,1,1,11,38,0,11,2,49,0
How Much Crap Do You Have In Your Drawer Full Of Crap,1,1,12,30,0,11,0,42,0
What Would Your Life Be Like As A Lame Super Hero,1,1,11,28,0,10,0,39,0
"What you should talk about on a first date, according to research",1,3,1,52,1,11,0,53,0
Stephen Curry's Wife Zings Cavaliers Fans with Post About Sleeping Riley,1,2,10,51,1,10,0,61,0
Neville Longbottom Has Grown Himself A Big Ol' Moustache,1,1,9,38,1,8,0,47,0
"How Well Do You Know The Relationships In ""Love Actually""",1,1,10,36,2,9,0,46,0
24 Confessions Scottish People Have For Americans,1,1,6,35,0,6,2,41,0
39 Amazing Pop Songs You May Have Missed In 2015,1,1,8,25,0,9,6,33,0
Social Media Vs. Real Life,1,1,5,16,1,4,0,21,0
13 Must-Have High Street Products For Natural Hair,1,1,8,32,1,7,2,40,0
19 Tweets That Are Too Funny If You Love Beauty,1,1,9,27,0,9,2,36,0
Try Not To Die Watching Channing Tatum Whisper Sweet Nothings To A Stranger,1,1,13,50,0,12,0,63,0
Here's Proof That Everyone Is At Peak Attractiveness When They're 41,1,1,10,44,2,10,2,54,0
These Plus-Size Models Absolutely Slayed At Fashion Week,1,1,9,39,1,7,0,48,0
Bizarre deep-sea ghost shark caught on camera for first time,1,2,1,49,1,9,0,50,0
How Many Wes Craven Films Have You Seen,1,1,8,24,0,7,0,32,0
22 People Who Should Give Up On Flirting,1,1,7,24,0,7,2,31,0
David Einhorn's big idea for GM isn't winning many investors over (GM),1,3,6,49,4,11,0,55,0
Trump’s Approval Ratings Jump to 50 Percent,1,3,5,29,1,6,2,34,0
33 Weird Things You'll Find In Every British Person's Garage,1,1,9,38,2,9,2,47,0
23 Moments That Make You Feel Like A Real Adult,1,1,9,27,0,9,2,36,0
23 Brilliant Ingredient Swaps You Should Really Try,1,1,7,35,0,7,2,42,0
Mariah Carey's Insane Engagement Ring Belongs In A History Textbook,1,1,10,47,1,9,0,57,0
"A teen fired up Facebook Live from the highway. Moments later, everyone in her car was dead.",1,3,4,69,3,16,0,73,0
Sri Lanka to Sell 80% Stake in Strategically Placed Harbor to Chinese - India Real Time,1,2,11,57,2,15,2,68,0
"John Legend Beautifully Performed ""All Of Me"" At This Couple's Wedding",1,1,11,46,3,10,0,57,0
Adele's Album Cover Is Giving The Entire World Eyeliner Goals,1,1,10,41,1,9,0,51,0
15 Things Sex Therapists Really Want You To Know,1,1,8,30,0,8,2,38,0
23 Life-Changing Apps We Downloaded This Year,1,1,7,29,1,6,2,36,0
Jane Fonda Pitches ‘Trumpers’ Adult Diapers to ‘Help With All the Leaks’,1,2,10,47,4,11,0,57,0
There’s Already a Game Too Big to Install on the Nintendo Switch,1,3,8,44,1,11,0,52,0
21 Things You'll Only Understand If You Had Braces,1,1,8,31,1,8,2,39,0
"When it comes to Israel, stakes are high for Jared Kushner",1,2,4,43,1,10,0,47,0
"How Well Do You Remember ""The Princess Diaries 2: Royal Engagement""",1,1,10,43,3,10,1,53,0
6 Easy Holiday Gifts You Can Give Everyone In Your Squad,1,1,10,35,0,10,1,45,0
Limbaugh Calls Out Trump for Border Wall ‘Cave’ — ‘The Country Is Ready to Blame the Democrats’ for a Shutdown,1,3,14,72,5,19,0,86,0
21 Pieces Of Advice For Aspiring Writers,1,1,6,26,0,6,2,32,0
Can You Complete This Pop Culture Crossword,1,1,7,30,0,6,0,37,0
How are Australia's Syrian refugees coping?,1,2,3,33,2,5,0,36,0
Asos's Foreign Flair Can't Mask British Bother,1,3,7,31,2,6,0,38,0
"Gwyneth Paltrow’s Wellness Philosophy, in 10 Quotes",1,3,5,36,2,6,2,41,0
Here's A Look At 100 Years Of Wedding Gowns In Three Minutes,1,1,11,34,1,11,3,45,0
Bibi Netanyahu Makes Trump His Chump ,1,2,6,25,0,6,0,31,0
This woman saved a man’s life on their first date The list,1,2,2,44,1,11,0,46,0
These Lip Challenge Fails Were So Awful That They Actually Won 2015,1,1,11,41,0,11,4,52,0
'Creepy' photo collage gets Martin Shkreli suspended from Twitter ,1,3,4,51,2,9,0,55,0
This Is What Postpartum Depression Feels Like,1,1,7,32,0,6,0,39,0
What's in store for Europe in 2017? A look at possible scenarios,1,3,3,44,2,11,4,47,0
Would You Remove A Pot From The Head Of This Leopard,1,1,11,31,0,10,0,42,0
"Senators Schumer, Gillibrand Helped Indian Athlete Currently Charged with Sex Abuse to Enter U.S.",1,3,13,68,3,13,0,81,0
Poll: Do You Actually Work For The First Order,1,1,9,28,1,8,0,37,0
"This Thrilling Sprint Between A 99-Year Old Who Beat His 92-Year Old Rival, Proves That Age Is Indeed Just A Number",1,3,21,67,3,20,4,88,0
Zayn Malik Speaks Out in Revealing Billboard Cover Story: 'I'm Not Censoring Myself Anymore',1,3,13,62,4,13,0,75,0
Jacob Tremblay Cut The Line To Meet Leo DiCaprio At The SAG Awards,1,1,16,38,0,12,0,54,0
Kristen Stewart tells Colbert she brushed off Trump’s tweets about her,1,3,4,55,1,10,0,59,0
We Got A Bunch Of People Drunk And Then Had Them Try Drunk Food From Around The World,1,1,18,50,0,17,0,68,0
"Please, I'm Begging You, Tell Us Why You Like The Chainsmokers",1,3,11,38,3,10,0,49,0
This Incredible Lingerie Shoot Comes With A Body-Positive Message,1,1,10,46,1,8,0,56,0
"19 Gifts For People Who Are Slightly Obsessed With ""Minecraft""",1,1,9,40,2,9,2,49,0
So Apparently Selena Gomez And Niall Horan Made Out This Weekend,1,1,11,43,0,10,0,54,0
This Trans Guy Took A Selfie Every Day For Three Years To Show How His Face Changed,1,1,17,50,0,16,0,67,0
"How an unknown 25-year-old won an election spending $1,300 on Facebook promotion",1,3,2,57,4,11,6,59,0
Everything You Need To Know About Google’s New Smartwatches,1,2,9,41,1,8,0,50,0
Self-charging battery could put an end to your phone dying,1,2,1,47,1,9,0,48,0
Trump’s true ideology has been revealed,1,3,1,32,1,5,0,33,0
33 Badass Pictures From The Golden Age Of Tattoos,1,1,8,31,0,8,2,39,0
Katie Piper: Model left burned after acid attack shares tips on rebuilding confidence,1,2,3,69,1,12,0,72,0
Tell Us About Your Self(ie): Kym Whitley,1,1,7,24,3,6,0,31,0
Police: Chicago Torture Victim’s Parents Received Taunting Messages,1,3,8,50,2,7,0,58,0
This Group Of Friends Changed The Halloween Game With Their Coordinated Costumes,1,1,12,57,0,11,0,69,0
How dropping acid saved my life,1,3,1,25,0,5,0,26,0
How you can help the world's oceans stay pure and clean,1,2,1,43,1,10,0,44,0
Prosecutors: Most Inauguration Day Protesters Who Were Arrested Will Be Charged with Felony Rioting,1,2,13,72,1,13,0,85,0
What Christmas is like when you’ve just won £1m on a scratchcard,1,3,2,48,2,11,1,50,0
21 Delicious Dips You Won't Believe Are Only Three Ingredients,1,1,9,41,1,9,2,50,0
Labour in chaos: Tulip Siddiq resigns as Corbyn imposes whip barring MPs from blocking Article 50,1,3,7,72,1,15,2,79,0
Is This Burrito From Los Angeles Or New York City,1,1,10,30,0,9,0,40,0
American Airlines flight attendants want new uniforms recalled,1,3,2,53,0,7,0,55,0
"Guess The Celebrity From Their ""The Simpsons"" Cameo",1,1,8,34,2,7,0,42,0
Worried About the Privacy of Your Messages? Download Signal ,1,3,7,43,1,9,0,50,0
PaycomVoice: 3 Finance-Technology Skills CFOs Should Seek,1,3,10,38,2,6,1,48,0
"How Well Do You Remember The First Episode Of ""Friday Night Lights""",1,1,12,42,2,11,0,54,0
Will Amazon Revolutionize Shipping?,1,3,4,27,1,3,0,31,0
This Mac And Cheeseburger Is The Only Friend You Need,1,1,10,34,0,9,0,44,0
You'll Feel Really Dumb When You See How Simple Bagged Milk Is,1,1,12,38,1,11,0,50,0
If Disney Princesses Dressed As Themselves For Halloween,1,1,8,41,0,7,0,49,0
15 Texts Your Student Loans Are Dying To Send You,1,1,9,29,0,9,2,38,0
43 Important Pictures Of Me Watching The Livestream Of Shia LaBeouf Watching His Own Movies,1,1,15,60,0,14,2,75,0
Here's the latest Super Bowl champion who won't visit Trump's White House,1,3,6,53,3,11,0,59,0
What is Donald Trump doing for Christmas?,1,3,4,30,1,6,0,34,0
The 9 coolest tech products we saw at Mobile World Congress 2017,1,2,4,44,0,11,5,48,0
"5 Lit ""Empire"" Cocktails For Your Viewing Parties",1,1,7,32,2,7,1,39,0
Are You More Miranda Lambert Or Miranda Sings,1,1,8,30,0,7,0,38,0
"Trump Tweets, Vowing Obamacare Isn’t Safe Yet",1,2,7,30,2,6,0,37,0
"This Is The Real, Heartbreaking Story Behind That Viral Dog Bathing Video",1,1,12,49,1,11,0,61,0
Justin Bieber Admits He Still Loves Selena Gomez,1,1,8,33,0,7,0,41,0
Mayo Haters Taste Test,1,1,4,15,0,3,0,19,0
Portugal Is The Country Everybody Will Be Visiting In 2017,1,3,9,36,0,9,4,45,0
Wendy's And Burger King Got Into A Fight On Twitter,1,1,10,31,1,9,0,41,0
Here Are Things That People Actually Said About Muslims In 2015,1,1,10,39,0,10,4,49,0
These Pop-Up Dinners Are All About Empowering Women In The Restaurant Industry,1,1,13,53,1,11,0,66,0
23 Tweets From 2006 That Will Make You Feel Ancient,1,1,8,28,0,9,6,36,0
Doggy-Style Vs. Missionary: Can You Guess Your Partner's Favorite Sex Position,1,1,12,52,4,10,0,64,0
What Percent Night Owl Are You,1,1,6,19,0,5,0,25,0
12 Awkward Foreplay Confessions,1,1,3,23,0,3,2,26,0
NYT’s Thomas Friedman: ‘I Fear That a Lot of Americans Are Getting Addicted’ to Trump,1,3,14,53,4,14,0,67,0
What happened in Washington state after voters legalized recreational marijuana,1,3,2,68,0,9,0,70,0
Five Things Megyn Kelly's Move To NBC Tells Us About TV News In The Trump Era,1,3,19,42,1,15,0,61,0
'Overwatch' teases a possible new hero and it's (probably) not Doomfist,1,3,2,54,5,10,0,56,0
21 Life-Changing Health And Beauty Products You Should Try In 2016,1,1,10,39,1,10,6,49,0
"This Teen Ended Up On An ""Ugliest Girls"" Poll At Her School, But She Had The Best Response",1,1,18,52,3,17,0,70,0
"The 50 Most Hauntingly Beautiful Photos From ""The X-Files""",1,1,9,36,3,8,2,45,0
106 Unexpectedly Awesome Songs For Every Moment Of Your Wedding Day,1,1,10,44,0,10,3,54,0
Students Have A Legal Right To Safe Spaces,1,1,8,27,0,7,0,35,0
21 Of The Greatest Examples Of Fragile Masculinity In 2015,1,1,8,35,0,9,6,43,0
Here's A Look At 100 Years Of Halloween Costumes,1,1,8,28,1,8,3,36,0
Here's what the 'Game of Thrones' stars look like in real life,1,3,3,45,3,11,0,48,0
"How Well Do You Know ""When Harry Met Sally""",1,1,9,24,2,8,0,33,0
Rajat Kapoor Feels Movies Made In 1950s Were The Best That Indian Cinema Has Ever Seen!,1,3,15,52,1,15,4,67,0
The 21 Best Server Memes On The Internet,1,1,7,24,0,7,2,31,0
Hipster Santa Is The Coolest Santa You'll Ever Meet,1,1,9,33,1,8,0,42,0
How to Help Those Suffering Most in Syria's Civil War,1,3,8,35,1,9,0,43,0
18 Animals So Weird They're Probably Fake,1,1,6,26,1,6,2,32,0
President Trump Speaks to Supporters 'Without the Filter of the Fake News'  Insider,1,3,9,59,2,13,0,68,0
27 Little Things All People Obsessed With Makeup Are Guilty Of,1,1,10,40,0,10,2,50,0
We Know Your Favorite Comedian Based On Your Age,1,1,9,31,0,8,0,40,0
Syria: Six simple questions for a complicated conflict ,1,2,2,44,1,8,0,46,0
These Photos Of Drake Are So Hot You'll Have To Go To The Emergency Room,1,1,15,42,1,14,0,57,0
10 Of The Biggest Lies We Were Told In 2015,1,1,8,20,0,9,6,28,0
President Donald Trump Previews NAFTA Plan ‘over the Next Two Weeks’,1,3,13,43,2,10,0,56,0
"Ordinance On Jallikattu, Court Observation On Murthal Rape And Other Must Read Stories",1,3,13,60,1,12,0,73,0
Ebola is on the rise again â and the world is no better prepared for it than last year - Business Insider,1,3,3,80,3,21,0,83,0
27 Utterly Terrible Ways Food Was Actually Served In 2015,1,1,8,34,0,9,6,42,0
10 Reasons Why The World Must Do Something About South Sudan's Famine Right Now,1,2,13,50,1,13,2,63,0
"Which ""Harry Potter"" Villain Are You Based On Your Zodiac",1,1,10,36,2,9,0,46,0
Adrien Broner Arrest Video Released After Fighter Shot at in SUV,1,3,11,43,0,10,0,54,0
17 Of The Saddest Gingerbread Houses This Year,1,1,7,30,0,7,2,37,0
This Short Film About An Old Arranged-Married Couple Will Make You Cry And Smile,1,1,15,51,1,13,0,66,0
This Mesmerizing Food Quiz Will Reveal Where You Should Live,1,2,10,41,0,9,0,51,0
Corruption claims taint Ukraine military,1,3,2,34,0,4,0,36,0
"Which Musical Film Should You Watch Based On Your Favorite ""Glee"" Character",1,1,12,50,2,11,0,62,0
19 Confessions From Muslims After The Paris Attacks,1,1,7,35,0,7,2,42,0
What The Navient Lawsuit Means For Your Student Loans: Part 3,1,3,10,39,1,10,1,49,0
11 Valentine's gifts for your f*ck buddy,1,3,1,29,2,6,2,30,0
19 Sean Spicer Tweets That Will Really Make You Think,1,2,9,33,0,9,2,42,0
Are we willing to let Trump evolve?,1,3,2,26,1,6,0,28,0
"Just A Reminder That The ""Pinky & The Brain"" Christmas Special Will Make You Cry Every Time",1,1,16,56,3,16,0,72,0
Reality Check: Is Malmo the 'rape capital' of Europe?,1,3,5,36,4,8,0,41,0
We Know Your Personality And Age Based On Your Favorite TV Show,1,1,13,39,0,11,0,52,0
Airfare to these cities is expected to drop in 2017,1,3,1,37,0,9,4,38,0
Here's What It's Actually Like To Own A Fitbit,1,1,9,27,2,8,0,36,0
"Former Obama Speechwriter Rips CNN for Its ‘Stupid,’ ‘Bulls–t Factory’ Pro-Trump Pundits",1,3,14,56,7,11,0,70,0
I became my mother-in-law's carer - but I just couldn't handle the stress of the job,1,2,2,62,5,15,0,64,0
25 Times Chris Pratt And Anna Faris Proved Love Is Real In 2015,1,1,11,34,0,12,6,45,0
The little-known airline making travel to Mexico cheaper,1,3,2,46,1,7,0,48,0
An Exact Replica Of The Titanic Will Set Sail In 2018,1,1,10,29,0,10,4,39,0
"37 Things Cut From ""The Force Awakens""",1,1,6,22,2,6,2,28,0
"Health Care, Immigration Ban, North Korea: Your Tuesday Briefing ",1,3,9,44,3,9,0,53,0
For Everyone Who Would Rather Date A Cookie Than A Person,1,1,11,36,0,10,0,47,0
Investing In Water,1,3,3,13,0,2,0,16,0
Ecuador fines media for not publishing a story,1,3,1,38,0,7,0,39,0
19 Food Truths Only Chicagoans Will Understand,1,1,6,32,0,6,2,38,0
Why Theaster Gates took an ax to his own painting at the NGA,1,3,6,42,0,12,0,48,0
7 Foods to Moisturize Your Skin From the Inside Out,1,2,7,34,0,9,1,41,0
This Rolls-Royce Ghost comes with $100K worth of goodies,1,2,5,38,2,8,3,43,0
We Need To Talk About How Overwhelmingly Perfect Julianne Moore Is,1,1,11,45,0,10,0,56,0
What Your High Heels Are Doing To Your Feet,1,1,9,26,0,8,0,35,0
"How Obsessed With ""Game Of Thrones"" Are You",1,1,8,26,2,7,0,34,0
Ten Things A Good Manager Won't Ask Employees To Do,1,3,10,31,1,9,0,41,0
"Bollywood Bids Goodbye To Om Puri, Justin Bieber To Perform In India This Year And More From Ent!",1,3,18,60,2,17,0,78,0
13 All-Too-Real Texts From Your Bra,1,1,7,19,2,5,2,26,0
How Much Did You Love Minions In 2015,1,1,7,19,0,7,4,26,0
"Can You Name All Of Monica's Boyfriends From ""Friends""",1,1,9,34,3,8,0,43,0
18 Ways To Bring More Sandwiches Into Your Life,1,1,8,29,0,8,2,37,0
Chris Hemsworth Thinks It's Funny That Paparazzi Thought He Was Michael Fassbender,1,1,12,58,1,11,0,70,0
13 Parts Of Your Body You Didn't Know Had Names,1,1,9,26,1,9,2,35,0
She Nailed a Half-Court Shot and Almost Missed Her Boyfriend’s Proposal,1,3,10,49,2,10,0,59,0
NBA Commissioner Adam Silver Doubles Down on League’s Transgender Activism Stance,1,3,12,58,1,10,0,70,0
These 'vertical forests' could transform a Brussels wasteland into luxury apartments,1,3,2,70,2,10,0,72,0
Can We Guess What Kind Of Porn You Like,1,1,9,22,0,8,0,31,0
10 Awkward First Kiss Confessions,1,1,4,23,0,4,2,27,0
Hallmark’s Queen of Christmas,1,3,3,22,1,3,0,25,0
This Student’s Tweet Perfectly Sums Up Why Group Projects Are The Absolute Worst,1,3,13,54,1,12,0,67,0
"The Creator Of ""Master Of None"" Thanked Straight White Guys In His Acceptance Speech",1,1,14,55,2,13,0,69,0
How cheddar and cream cheese could give you breast cancer: Eating too much can raise the risk by 50% ,1,3,2,76,2,19,2,78,0
"23 Of Monica Geller's Most Iconic Lines On ""Friends""",1,1,8,31,3,8,2,39,0
Mona Lisa Gives A Perfect Reply To Karan Johar's Remark On Her Marriage Being A 'Fake',1,3,16,52,3,15,0,68,0
Jordan Spieth Scores a Quadruple Bogey in Masters' Opening Round,1,3,8,46,1,9,0,54,0
"Fmr UFC Fighter Tim Kennedy Reenlists, Credits Trump: The Military ‘Got Our Teeth Back’",1,3,16,54,4,13,0,70,0
Twitter direct message 140 character limit being lifted in July,1,3,2,49,0,9,3,51,0
13 Inspiring Roald Dahl Quotes Guaranteed To Brighten Your Day,1,1,9,42,0,9,2,51,0
25 Small Things That Are Actually Huge For People With Anxiety,1,1,10,40,0,10,2,50,0
This Baby Elf On The Shelf Is The Cutest Thing This Holiday Season,1,1,13,41,0,12,0,54,0
5 NBA Trades We Want to See Before the Deadline,1,2,9,28,0,9,1,37,0
Sit Down Right Now And Watch The Rock Hit The Quan,1,1,11,29,0,10,0,40,0
Which Pop Diva's Scent Should You Wear Based On Your Birthstone,1,1,11,41,1,10,0,52,0
Wiz Khalifa Showed Up To The Golden Globes Looking Classy As Hell,1,1,12,42,0,11,0,54,0
"11 Things You Need To Know About ""Room""",1,1,7,21,2,7,2,28,0
Mistletoe is actually a tree-killing parasite â here's how it became a Christmas icon,1,2,2,68,4,13,0,70,0
Wall Street is changing how it trades the world's hottest investment product,1,2,2,62,1,11,0,64,0
Scientists Find Surprising Link Between Birth Month And Disease Risk,1,2,10,49,0,9,0,59,0
"Here's The Trailer For ""Trolls"" Starring Anna Kendrick And Justin Timberlake",1,1,11,52,3,10,0,63,0
Thai Man Broadcasts Murder Of 11-Month-Old Daughter Live On Facebook Before Committing Suicide,1,3,14,64,2,12,2,78,0
17 Red Carpet Looks Of 2015 That Were Breathtaking,1,1,7,29,0,8,6,36,0
15 UnBEARable Animal Puns,1,1,7,13,0,3,2,20,0
22 Pictures That Prove We Just Don’t Deserve Animals,1,3,8,33,1,8,2,41,0
25 Things That Might Be Dead,1,1,5,16,0,5,2,21,0
Automate Me: How to use Gmail templates to answer emails quicker,1,2,4,49,1,10,0,53,0
Ventriloquist Dummies Are The Scariest Thing Ever,1,1,7,36,0,6,0,43,0
9 Sex Tips That Anyone With A Vagina Should Try,1,1,9,28,0,9,1,37,0
19 Creepy AF Halloween Makeup Ideas That Will Scar You Forever,1,1,11,39,0,10,2,50,0
My workout: ‘Netball gives me a massive buzz’,1,3,2,33,3,7,0,35,0
Why some Trump supporters are boycotting the new 'Star Wars' movie with #DumpStarWars,1,3,7,63,3,12,0,70,0
Which Emo Trinity Album Are You Based On Your Zodiac Sign,1,1,11,36,0,10,0,47,0
14 People Who Are Hating The New WhatsApp 'Stories' Feature As Much As You Are!,1,3,15,45,3,14,2,60,0
Watch This Transgender Teacher Comfort Her Gender-Nonconforming Student,1,1,9,54,1,7,0,63,0
Germans Purchase ‘Illegal Guns and Grenades’ to Defend Themselves from Migrants,1,3,8,59,2,10,0,67,0
17 Photos The World Needs To See To Understand How Beautiful Mumbai Really Is,1,1,13,49,0,13,2,62,0
"As Trump attacks John Lewis, here’s how freedom riders broke the chains of segregation",1,3,4,67,2,13,0,71,0
31 Of The Most Beautiful Movie Shots Of 2015,1,1,7,23,0,8,6,30,0
JPMorgan ChaseVoice: Leadership Lessons From The CEO Of JPMorgan Chase,1,3,17,43,1,9,0,60,0
15 Things Introverts Should Know About Planning A Wedding,1,1,8,39,0,8,2,47,0
"17 Hilarious American-Canadian Differences, According To Tumblr",1,1,7,46,2,6,2,53,0
Canadians Are Hilariously Confessing Their Most Un-Canadian Traits,1,1,9,49,1,7,0,58,0
Frank Gaffney: Leaders like Merkel Still ‘Scratching Their Heads’ over Motivations of Jihadis,1,3,10,68,3,12,0,78,0
Zoo Animals Around The World Are Opening Their Christmas Presents Early,1,1,11,50,0,10,0,61,0
"Carrie Fisher Was Considered To Play Sandy In ""Grease"" Before Olivia Newton-John",1,1,13,53,3,11,0,66,0
The Internet Can't Stop Memeing Randeep Hooda After His Massive Weight Loss,1,1,12,51,1,11,0,63,0
Pick A Pumpkin To Determine What You Should Do Halloween Night,1,1,11,41,0,10,0,52,0
11 Life Hacks All Lazy Girls Definitely Already Do,1,3,8,32,0,8,2,40,0
"We Know Your Favorite ""Harry Potter"" Character Based On Your Favorite Color",1,1,12,50,2,11,0,62,0
25 Amazingly Cool Gadget Gifts You May Want To Keep For Yourself,1,2,11,40,0,11,2,51,0
21 Yik Yaks From 2015 That Are Just Really Damn Funny,1,1,9,28,0,10,6,37,0
23 Couples Costumes That Will Give You Relationship Goals,1,1,8,39,0,8,2,47,0
Which Dog Breed Are You Based On Your Zodiac Sign,1,1,10,30,0,9,0,40,0
Our happy places: The vacation spots we call home,1,3,2,38,1,8,0,40,0
Can Trump and Congress Solve the Rubik’s Cube of Tax Reform? ,1,3,8,40,2,11,0,48,0
Route 45: Inside one of Obama's favourite diners,1,3,3,34,2,7,2,37,0
29 Times Chrissy Teigen Was Just Fucking Great,1,3,7,30,0,7,2,37,0
Are You More Jean-Ralphio Or Mona-Lisa Saperstein,1,1,9,32,2,6,0,41,0
"Here's How WeChat's Parent Company Tencent Celebrated New Year, With A Fake B*lowjob Game",1,2,15,57,4,13,0,72,0
A 15-minute quiz can give you a scientifically accurate assessment of your personality,1,2,1,70,1,12,2,71,0
35 People Who Failed So Hard It's Actually Perfect,1,1,8,31,1,8,2,39,0
Adults Sit On Santa's Lap For The First Time,1,1,9,26,1,8,0,35,0
Mark Wahlberg At The Beach Will Cause Your 2016 Sexual Awakening,1,1,10,40,0,10,4,50,0
"These Pussycat Panties Give A Whole New Meaning To ""Cute Underwear""",1,1,11,44,2,10,0,55,0
What Do Your Initials Say About You,1,1,7,22,0,6,0,29,0
Brit Awards 2017: When are they? How can I watch? Who is presenting and performing?,1,2,6,55,4,14,4,61,0
Is Selena Gomez Worth $10 Million? [Video],1,3,6,24,4,6,2,30,0
I Lived Without A Phone For One Week And Here's What I Learned,1,1,13,36,1,12,0,49,0
Can You Tell If This Is Chris Or Liam Hemsworth,1,1,10,28,0,9,0,38,0
These 9 states are where taxpayers get the most for their tax dollars,1,3,1,55,0,12,1,56,0
Can You Survive 30 Seconds Looking At These Really Hot Shirtless Hairy Chested Guys,1,1,13,55,0,13,2,68,0
Pope Francis Met The Obama Family Dogs At The White House,1,1,11,36,0,10,0,47,0
You Can Now Take Sriracha Everywhere With These On-The-Go Packets,1,1,12,42,2,9,0,54,0
"Democratic Party Is Losing Its Moderate Members, Says Gallup",1,3,9,42,1,8,0,51,0
19 Kids Who Will Grow Up To Change The World,1,1,9,24,0,9,2,33,0
What went so horribly wrong with Adele’s Grammy performance?,1,2,3,47,2,8,0,50,0
"22 Hilarious Pictures That Will Make You Go ""Same""",1,3,8,30,2,8,2,38,0
The German supermarket known for creating amazing viral ads has a new commercial about losing weight,1,2,2,83,0,15,0,85,0
Carrie Fisher Laid to Rest in Prozac Pill Urn,1,3,7,30,0,8,0,37,0
These Inception-Like Images Will Blow Your Mind,1,1,8,32,1,6,0,40,0
15 Fab Little Gifts Your Reddit Secret Santa Will Love,1,1,9,34,0,9,2,43,0
What Have You Had On A Pizza,1,1,7,15,0,6,0,22,0
Reviving This Law Would Mean the End of Megabanks: QuickTake Q&A,1,3,11,41,2,10,0,52,0
"Without Alan Rickman These ""Love Actually"" Scenes Wouldn't Have Been As Heartbreaking",1,1,12,59,3,11,0,71,0
This is how much a coffee date with Ivanka Trump will cost you,1,3,3,47,0,12,0,50,0
Islamic State Teen Jailed For Attacking Jewish Teacher in France,1,3,9,46,0,9,0,55,0
The Sexy Pizza Rat Halloween Costume Is Here And It Costs $89.95,1,1,11,36,2,11,4,47,0
31 Christmas Gifts You Totally Asked For In 2005,1,1,7,27,0,8,6,34,0
Red wine ingredient may improve health of obese men,1,2,1,42,0,8,0,43,0
We Know Your Feel-Good Song Based On Your Zodiac Sign,1,1,11,32,1,9,0,43,0
How to see every photo your friends have ever liked on Facebook ,1,2,2,50,0,12,0,52,0
22 Pictures That Are Too Real For People Who Hate Their Job,1,1,11,35,0,11,2,46,0
23 Things You'll Understand If You're 10 Years Older Than Your Sibling,1,1,10,43,2,11,4,53,0
Can You Guess The Mariah Carey Music Video By Its YouTube Comment,1,1,13,41,0,11,0,54,0
VP Pence at March for Life: Supreme Court Nominee Will Uphold God-Given Constitutional Liberties,1,2,14,67,2,13,0,81,0
"BMW's new 7 Series is the luxury car of the future, here today",1,3,4,43,2,12,1,47,0
Why you SHOULD be selfish at work: Helping others will lead to 'generosity burnout' and can damage your career,1,3,8,81,3,18,0,89,0
This Veterinarian Ate With A Neglected Dog In A Cage To Make Her Feel Comfortable,1,1,15,52,0,14,0,67,0
Lola the Cat Survives Migrant Crossing to Italy,1,3,6,34,0,7,0,40,0
Kylie Jenner Proves She Doesn't Wear Butt Pads By Showing Off Her Spanx,1,1,13,45,1,12,0,58,0
"24 Great Movies You Likely Missed This Year, But Should Totally See",1,1,11,42,1,11,2,53,0
Mark Cuban: Trump Is ‘Political Chemotherapy’ for the System,1,3,7,42,3,8,0,49,0
"24 Middle-Class Crisps That Went Way, Way Too Far",1,1,9,28,2,8,2,37,0
What I’m really thinking: the failed novelist,1,3,2,35,2,6,0,37,0
42 Questions We Still Have About The Logistics Of The Wizarding World,1,1,11,45,0,11,2,56,0
Which Famous Movie Sidekick Are You Based On Your Zodiac,1,1,10,37,0,9,0,47,0
Ukraine: Inside civilians' living nightmare,1,3,2,35,2,4,0,37,0
Social Media News You Need to Know: March 2017 Roundup,1,2,8,32,1,9,4,40,0
"What's Your Favorite Professor Snape Moment In ""Harry Potter?""",1,1,9,41,4,8,0,50,0
The Most Unique Looks at the 2017 Golden Globe Awards,1,3,7,33,0,9,4,40,0
DIY Halloween Porcelain Doll Makeup,1,1,7,24,0,4,0,31,0
Shah Rukh Khan’s Opinion On Women Empowerment Is What Everyone Needs To Read Right Now!,1,2,15,56,2,14,0,71,0
Which Christmas-Themed Horror Movie Should You Watch,1,1,8,37,1,6,0,45,0
Making Dough With Home Sharing: How A Small Pie Company Became Part Of The 'Airbnb Business Cycle',1,3,17,62,3,16,0,79,0
This Indian Soldier Taking Time Out To Share His Lunch With A Squirrel Is The Cutest Thing Ever,1,1,18,60,0,17,0,78,0
Can You Name The '90s R&B Track From A Single Screencap,1,1,11,30,2,10,2,41,0
17 Things Confident Plus-Size Women Have To Deal With,1,1,9,33,1,8,2,42,0
How the Flash Crash Trader’s $50 Million Fortune Vanished,1,3,7,38,2,8,2,45,0
Kate Hudson Joins List of Celebs Crushing on Jeff Bridges,1,3,8,40,0,9,0,48,0
Which Shondaland Hunk Should Be Your Valentine,1,1,7,33,0,6,0,40,0
These Are The Coolest Parenting Products Of 2015,1,1,7,30,0,7,4,37,0
10 Christmas food traditions you've never heard of,1,3,1,39,1,7,2,40,0
Gay student comes out to his parents with a brilliant yearbook quote,1,2,1,56,0,11,0,57,0
19 Struggles Of Being A Person Who Can't Burp,1,1,8,26,1,8,2,34,0
Brie Larson Reflects On Powerful Oscars Moment You Totally Missed,1,2,10,46,0,9,0,56,0
"Young Thug, 2 Chainz, Wiz Khalifa & PnB Rock ""Gang Up"" on New Track",1,2,12,36,5,13,1,48,0
The 23 Best Tinder Responses Of 2015,1,1,5,19,0,6,6,24,0
International Women's Day: Witty comebacks to sexist banter,1,3,4,46,2,7,0,50,0
"What NOT to say to someone with cancer, according to 6 patients",1,2,4,46,1,11,1,50,0
17 Photos That Prove Saskatoon Is Gorgeous As Heck,1,1,8,32,0,8,2,40,0
Here's what Nostradamus predicted about 2017 The list,1,2,3,38,1,7,4,41,0
4chan Finds and Desecrates Hidden Flagpole on Shia LaBeouf’s ‘He Will Not Divide Us’ Stream,1,3,13,60,3,14,1,73,0
Modi Isn't a Diamond's Best Friend,1,3,5,22,2,5,0,27,0
63 Things That Mildly Irritate British People On A Daily Basis,1,1,10,40,0,10,2,50,0
DNC Chair Brazile: Trump Victory ‘Tainted’ By Russian Intrusion,1,3,11,41,3,8,0,52,0
Katy Perry Hilariously Trolls Orlando Bloom's Instagram With Jennifer Aniston Joke,1,2,11,60,1,10,0,71,0
18 Photos Of Makeup That Will Make Every Girl Cringe,1,1,9,32,0,9,2,41,0
16 Words That Mean Something Completely Different At Target,1,1,8,41,0,8,2,49,0
21 Things That Happen When You Have A Really Massive Dog,1,1,10,34,0,10,2,44,0
PSA: Get To Japan And Visit The World's Biggest Fucking Fish Market,1,1,14,40,2,11,0,54,0
19 Pictures Of Dogs In Very Embarrassing Situations,1,1,7,35,0,7,2,42,0
This Indian Billionaire Is Trying To Save The World,1,1,9,34,0,8,0,43,0
A Lot Of People Are Upset About A YouTuber's Fat-Shaming Video,1,1,13,37,2,10,0,50,0
"After 72 years, historians have a new theory about Anne Frank",1,3,3,45,1,10,2,48,0
22 Dudes Tell Us About The Last Time They Cried,1,1,9,27,0,9,2,36,0
"Michelle And Barack Obama Are Proving That Yes, Retirement Really Is The Best Thing",1,3,14,55,1,13,0,69,0
Watch the world's first ever monster truck front flip. You know you'll love it.,1,2,2,60,4,13,0,62,0
Here Are The 12 Most Important Memes Of 2016,1,3,7,23,0,8,6,30,0
Which K-Pop Girl Group Should You Actually Be In,1,1,10,29,1,8,0,39,0
Which Renaissance Artist Should You Hook Up With,1,1,8,33,0,7,0,41,0
What Cheese Is Your Love Life,1,1,6,18,0,5,0,24,0
"The Cast Of ""Dr. Horrible's Sing-Along Blog"" Reunited",1,1,9,32,5,7,0,41,0
17 Songs That Are Older Than The Class Of 2019,1,1,8,23,0,9,6,31,0
"Which ""Breaking Bad"" Character Said These Famous Last Words",1,1,9,40,2,8,0,49,0
Drake and Jennifer Lopez Fuel Dating Rumors,1,3,6,31,0,6,0,37,0
These are the top 20 party cities in the US and Canada,1,3,4,37,0,11,2,41,0
"What Does Your Choice Of ""Candy Crush"" Candy Say About You",1,1,11,35,2,10,0,46,0
Can You Identify These Lush Bath Bombs,1,1,7,25,0,6,0,32,0
"In a Nod to ‘Gender Inclusivity,’ University of Minnesota Drops King & Queen From Homecoming Titles",1,2,12,68,4,15,0,80,0
"These are the fastest ways to make friends, according to one scientist The list",1,2,2,63,1,13,0,65,0
Only Solve This Crossword If You're Way Too Into Craft Beers,1,1,11,38,1,10,0,49,0
How ~Deep~ Are You,1,1,4,9,2,3,0,13,0
Would You Fuck An Alien,1,1,5,14,0,4,0,19,0
"The ""20 Minutes In, He Gives You That Look"" Puzzle",1,1,9,27,3,9,2,36,0
"After Her Dad Was Jailed & Mom Remarried, This 5YO Has Been Taking Care Of Her Grandmothers!",1,2,17,55,3,16,1,72,0
27 People Who Failed In 2016 Even More Than The Rest Of Us,1,3,11,29,0,12,6,40,0
The five foods you need to eat every day for a flatter stomach (including miso soup and BREAD),1,3,6,69,2,17,0,75,0
Few good alternatives to Palestinian state,1,2,2,35,0,5,0,37,0
This Grandma Had The Best Reaction To Taylor Swift Bringing Mick Jagger Out Onstage,1,1,14,56,0,13,0,70,0
What reporter Will Ockenden's metadata reveals about his life,1,3,3,49,1,8,0,52,0
"Another Kerala Man Hosts Lavish Wedding For Daughter, Recreates Delhi's Akshardham Temple",1,3,12,64,2,11,0,76,0
What's The Best Family Halloween Movie,1,1,6,26,1,5,0,32,0
18 Gentlemen Cats Who Have The Best Manners,1,1,7,27,0,7,2,34,0
The Hardest Emoji Quiz You'll Ever Take,1,1,7,25,1,6,0,32,0
"Now You Can Buy And Fail At Building A Bicycle From Ikea, Too",1,3,13,35,1,12,0,48,0
Jimmy Kimmel Asked People If They Were Ready For A 5.5 Equinox AKA Fall,1,1,15,40,1,13,2,55,0
This Guy Uses Swords And Fire To Cut Hair And It's Totally WTF,1,1,15,34,1,12,0,49,0
23 Slices Of Pizza That Will Sexually Awaken You,1,1,8,30,0,8,2,38,0
"15 ""Gossip Girl"" Trivia Questions Every True Fan Should Be Able To Answer",1,1,12,45,2,12,2,57,0
Kylie Jenner Was The Most Liked Kardashian-Jenner On Instagram In 2015,1,1,11,44,1,10,4,55,0
What Your Co-Workers On Facebook Need To Hear,1,1,9,28,1,7,0,37,0
"A Lot Of People Are Sharing This Powerful ""Doctor Who"" Speech About War",1,1,13,44,2,12,0,57,0
Can You Guess How Many Followers These Instafamous People Have,1,1,10,43,0,9,0,53,0
Do You Know Where These US TV Shows Are Set,1,1,12,22,0,9,0,34,0
Star Wars Fans Try CoverGirl's Makeup Line,1,1,8,27,1,6,0,35,0
Why Facebook’s AR announcement should excite iPhone fans,1,2,5,43,1,7,0,48,0
"25 Of The Best Moments In ""Elf"" That Will Get You Excited For Christmas",1,1,13,41,2,13,2,54,0
17 Signs You're An Adult But Also Still A Kid,1,3,9,24,1,9,2,33,0
"Blue State Blues: Thank You, President-Elect Trump, for Saving Israel",1,2,10,46,4,9,0,56,0
76 Things You'll Know After Three Years At University,1,1,8,34,1,8,2,42,0
We Know If You Have A Pet Based On Random Questions,1,1,11,30,0,10,0,41,0
27 Mario Myths That Happen To Be True,1,1,7,21,0,7,2,28,0
"Fareed Zakaria: Obama Admin ‘Largely Scandal-Free’ Operated ‘Under a Microscope, Because He Looked Different’",1,3,14,75,7,13,0,89,0
Boyfriends Choose Their Girlfriends' Halloween Costumes,1,1,6,43,1,5,0,49,0
Blake Lively And Ryan Reynolds Fell In Love On A Double Date With Other People,1,1,15,49,0,14,0,64,0
17 Pictures Of Dogs Just Doing Their Jobs,1,1,7,25,0,7,2,32,0
2 Chainz Pays Veteran's Rent For An Entire Year,1,1,8,29,1,8,1,37,0
How President Trump Could Bring About A Safer Greater World Peace,1,3,11,44,0,10,0,55,0
Brutal Knockout Leaves MMA Fighter Stiff as a Board on the Canvas,1,2,10,44,0,11,0,54,0
This 70-Year-Old Woman's Reason For Being Single Will Give You A Whole New Level Of Goals,1,1,17,52,3,15,2,69,0
"Lamar Odom Loves Kanye's New Album, According To Kim Kardashian",1,1,10,42,2,9,0,52,0
This monster machine that splits trees is incredibly satisfying to watch,1,3,1,61,0,10,0,62,0
22 Photos That Won't Make Sense To People With Perfect Nails,1,1,10,37,1,10,2,47,0
Gutfeld: Massive Bomb Sent the 'Mother of All Messages' to North Korea  Insider,1,3,10,53,3,13,0,63,0
"Techie Posts People's Details On Gay Sites, Gets Nabbed After Over 50 Victims Are Harassed",1,3,14,58,2,14,2,72,0
"27 Times The Netherlands Went Way, Way Too Far",1,1,8,27,1,8,2,35,0
What Underrated Baby Products Should Everyone Know About,1,1,8,41,0,7,0,49,0
17 Things Girls Only Tell Their Best Friends,1,1,7,28,0,7,2,35,0
Why you need to be watching HBO's 'Big Little Lies',1,3,7,32,3,9,0,39,0
10 Christmas food traditions you've never heard of,1,2,1,39,1,7,2,40,0
"Which ""X-Men"" Heroine Are You",1,1,6,16,3,4,0,22,0
Freezing lows will put blossoms at risk this weekend. Here’s how to protect them.,1,3,2,63,3,13,0,65,0
One Tokyo restaurant's success and failure is decided by pandas having sex,1,3,2,60,1,11,0,62,0
VIDEO: Officer Drives Over Woman as She Allegedly Shoots at Police,1,3,13,42,1,10,0,55,0
Uber and Lyft drivers share 14 things that they'd love to tell passengers but can't,1,3,2,63,2,14,2,65,0
Nyle DiMarco Will Make Your Thoughts NSFW For NYFW,1,1,16,26,0,8,0,42,0
How Do You Stay Fit In College,1,1,7,17,0,6,0,24,0
Why I Wait A Day Before I Debate My Faith In The Public Square,1,1,14,35,0,13,0,49,0
"Which Hybrid Hogwarts Houses Do These ""Harry Potter"" Characters Belong In",1,1,11,50,2,10,0,61,0
Musk’s Surprise Rapport With Trump Means 40% Rally for Tesla,1,2,8,39,2,9,2,47,0
Married Vs. Single: What's The Best First Date,1,1,8,28,3,7,0,36,0
19 Epic Cake Fails That Will Make You Laugh Every Single Time,1,1,11,37,0,11,2,48,0
Miss Piggy Opens Up About Split Of The Century And Life After Kermit,1,1,13,43,0,12,0,56,0
17 Confessions That Are Too Real For People Who Hate Partying,1,1,10,39,0,10,2,49,0
16 Times Taylor Swift Was Right About Everything In 2015,1,1,8,33,0,9,6,41,0
"Shhh! Don't tell anyone, but baseball is changing",1,3,2,37,3,7,0,39,0
24 Amazing Products To Let The World Know You're A Burger Fan,1,1,11,36,1,11,2,47,0
"Who Wears a $3,074 Bra?",1,2,3,9,3,4,4,12,0
Who Will Design Melania Trump’s Inaugural Ball Gown?,1,2,8,35,2,7,0,43,0
This Beautiful Poem Will Resonate With Anyone Living In A Place They Aren't From,1,1,14,52,1,13,0,66,0
31 Things To Do While You're Still Young,1,1,7,23,1,7,2,30,0
How Well Do You Know These Iconic Wedding Dresses,1,1,9,32,0,8,0,41,0
Do You Remember What Year These '90s Movies Were Released,1,1,9,36,1,9,2,45,0
Rand Paul: ‘Somebody Should Go To Jail’ For Trump Intel Leaks,1,2,11,37,3,10,0,48,0
"Henry Cavill Is So Hot, He Can Make You Think Turtlenecks Are Attractive",1,1,13,46,1,12,0,59,0
"This Starbucks Worker Fiercely Dropped It Like It Was Hot To The Weeknd's ""Can't Feel My Face""",1,1,17,57,4,16,0,74,0
How Well Do You Know Airport Codes,1,1,7,21,0,6,0,28,0
Which K-Pop Song Should You Listen To Based On Your Birth Month,1,1,13,38,1,11,0,51,0
23 Pictures That Will Make You Squirm And Then Laugh,1,3,9,32,0,9,2,41,0
15 Genius iPhone Accessories That'll Help Declutter Your Life,1,1,8,42,1,8,2,50,0
We Know How Much You Like Your Job,1,1,8,19,0,7,0,27,0
What Keeps You Motivated While Writing A Novel,1,1,8,31,0,7,0,39,0
25 Of The Most Beautiful College Campuses In The World,1,1,9,34,0,9,2,43,0
Body found in search for missing teen at Gold Coast water hole,1,3,3,48,0,11,0,51,0
We Know How You'd Spend The Powerball Jackpot,1,1,8,29,1,7,0,37,0
This County Flipped From Obama to Trump. How Do Voters Feel Now?,1,2,11,40,2,11,0,51,0
Dallas Cowboys Fan Gets The Best Revenge After Being Dumped By Text,1,3,12,44,0,11,0,56,0
The Single Best Way To Stay Motivated Every Single Day,1,3,10,35,0,9,0,45,0
Idaho Dems Exec Director: DNC Should Train People In ‘How to Shut Their Mouths If They’re White’,1,3,18,58,4,16,0,76,0
Why Debating and Befriending Tomi Lahren Isn’t Progress,1,3,7,40,1,7,0,47,0
Rosie O’Donnell Wants to Play Steve Bannon on ‘SNL’,1,3,10,30,3,8,0,40,0
Americans Try New Canadian Lays Flavors,1,1,6,28,0,5,0,34,0
Donald Trump: CNN Not ’Fake News’ — It’s Actually ‘Very Fake News’,1,3,13,35,7,11,0,48,0
"Did John Podesta Violate Federal Financial Disclosure Laws, Or Nah?",1,3,10,46,2,9,0,56,0
This Woman Looks Almost Identical To Megan Fox And It's Crazy As Hell,1,1,13,43,1,12,0,56,0
21 Photos Of Jake Gyllenhaal That Really Hit Home,1,1,8,31,0,8,2,39,0
29 Fairytale Places To Visit In Finland That Aren't Helsinki,1,1,9,39,1,9,2,48,0
Here's What Happens When You Turn A Pumpkin Spice Latte Into Pizza,1,1,12,42,1,11,0,54,0
‘Jurassic World’ is Feminist Because of the Dinosaurs,1,2,5,39,2,7,0,44,0
This One GIF Perfectly Explains Gender Inequality,1,1,9,34,0,6,0,43,0
'Homeland' Season 6 trailer definitely hits a little too close to home,1,3,2,54,2,11,1,56,0
22 Pictures That Men Will Just Never Ever Understand,1,3,8,34,0,8,2,42,0
21 Pictures Of Smiling Dogs Because Life Is Terrible,1,1,8,34,0,8,2,42,0
How To Wrap Up A Boring Conversation (Because We've All Been There),1,3,12,41,3,11,0,53,0
Google Home update allows Assistant to access 5 million new recipes,1,3,3,53,0,10,1,56,0
We Know If You're Santa Claus Based On One Question,1,1,10,31,1,9,0,41,0
18 Breathtakingly Photographic Locations In Wales,1,1,5,37,0,5,2,42,0
13 Cute Ways To Add More India To Your Everyday Wardrobe,1,1,10,34,0,10,2,44,0
Modi Sarkar Announces Lottery Scheme For Digital Payments + 5 More Stories From Today,1,2,12,58,1,13,1,70,0
Are You More Like Nelly Or Kelly Rowland,1,1,8,25,0,7,0,33,0
Allies Fear Trump Is Eroding America’s Moral Authority ,1,3,8,38,1,8,0,46,0
"15 Funny, Shocking, And Truly Weird Real-Life Coincidences",1,1,8,38,3,7,2,46,0
10 things the Samsung Galaxy S8 can do that the iPhone can't,1,3,4,41,1,11,3,45,0
Please Look At This Baby Zebra,1,1,6,19,0,5,0,25,0
"Are These Quotes From ""Home Alone"" Or ""Home Alone 2""",1,1,9,29,4,9,1,38,0
"10 Signs You're Totally Obsessed With ""Star Trek""",1,1,7,30,3,7,2,37,0
Which Cenobite Are You,1,1,4,15,0,3,0,19,0
Do You Interpret These Drawings The Same Way As Other People,1,1,11,39,0,10,0,50,0
Virtual Reality Is Bringing These Lost Worlds Back to Life,1,3,9,40,0,9,0,49,0
Apprehensive Putin Says No To 'Diplomatic Dog' Gifted By Japan's PM Shinzo Abe,1,2,14,49,3,12,0,63,0
13 Pictures Which Will Convince You To Get A Maa Tattoo In Hindi Right Now,1,1,14,44,0,14,2,58,0
19 Amazing Bowls Of Soup Guaranteed To Rock Your World,1,1,9,34,0,9,2,43,0
"A 7-Year-Old Girl Wrote A Letter To ""Google Boss"" Sundar Pichai, And He Replied Ever So Sweetly",1,3,18,55,5,16,1,73,0
26 Things People In A Relationship Will Never Ever Understand,1,1,9,41,0,9,2,50,0
This Number Test Will Determine Your Personality Type,1,1,8,38,0,7,0,46,0
"For 105-mph-throwing Michael Kopech, breaking the speed limit is well within his law",1,3,3,63,3,12,3,66,0
"12 Hacks To Make Netflix, Hulu And Amazon Prime Streaming Better",1,1,10,41,1,10,2,51,0
How Many Of These Michael Cera Movies Have You Seen,1,1,10,32,0,9,0,42,0
"Do You Know These Secondary ""Game Of Thrones"" Characters",1,1,9,37,2,8,0,46,0
Which Justin Bieber Song Is Your Life Anthem Based On Your Zodiac Sign,1,1,13,45,0,12,0,58,0
